county,office,candidate,party,precinct,mail_votes,early_votes,elec_day_votes,total_votes,district
Adair,Governor,Joe Dorman,DEM,10001,1,8,88,97,
Adair,Governor,Mary Fallin,REP,10001,7,3,91,101,
Adair,Governor,Kimberly Willis,IND,10001,0,0,3,3,
Adair,Governor,Richard Prawdzienski,IND,10001,0,0,2,2,
Adair,Lieutenant Governor,Cathy Cummings,DEM,10001,1,3,67,71,
Adair,Lieutenant Governor,Todd Lamb,REP,10001,7,8,116,131,
Adair,Superintendent of Public Instruction,John Cox,DEM,10001,7,9,122,138,
Adair,Superintendent of Public Instruction,Joy Hofmeister,REP,10001,0,1,64,65,
Adair,Commissioner of Labor,Mike Workman,DEM,10001,5,6,85,96,
Adair,Commissioner of Labor,Mark Costello,REP,10001,3,3,92,98,
Adair,U.S. Senate,Matt Silverstein,DEM,10001,0,1,48,49,
Adair,U.S. Senate,Jim Inhofe,REP,10001,8,9,137,154,
Adair,U.S. Senate,Aaron Delozier,IND,10001,0,0,0,0,
Adair,U.S. Senate,Ray Woods,IND,10001,0,0,0,0,
Adair,U.S. Senate,Joan Farr,IND,10001,0,0,1,1,
Adair,U.S. Senate,Connie Johnson,DEM,10001,1,2,53,56,
Adair,U.S. Senate,James Lankford,REP,10001,6,8,125,139,
Adair,U.S. Senate,Mark Beard,IND,10001,1,0,4,5,
Adair,U.S. House,Earl Everett,DEM,10001,0,1,31,32,02
Adair,U.S. House,Markwayne Mullin,REP,10001,7,10,145,162,02
Adair,U.S. House,Jon Douthitt,IND,10001,0,0,5,5,02
Adair,State House,Will Fourkiller,DEM,10001,8,9,145,162,86
Adair,State House,Tonya Teaney,REP,10001,0,2,41,43,86
Adair,Governor,Joe Dorman,DEM,10002,2,1,56,59,
Adair,Governor,Mary Fallin,REP,10002,1,4,101,106,
Adair,Governor,Kimberly Willis,IND,10002,0,0,3,3,
Adair,Governor,Richard Prawdzienski,IND,10002,0,0,1,1,
Adair,Lieutenant Governor,Cathy Cummings,DEM,10002,2,1,41,44,
Adair,Lieutenant Governor,Todd Lamb,REP,10002,0,4,120,124,
Adair,Superintendent of Public Instruction,John Cox,DEM,10002,3,2,88,93,
Adair,Superintendent of Public Instruction,Joy Hofmeister,REP,10002,0,3,73,76,
Adair,Commissioner of Labor,Mike Workman,DEM,10002,2,2,67,71,
Adair,Commissioner of Labor,Mark Costello,REP,10002,0,3,92,95,
Adair,U.S. Senate,Matt Silverstein,DEM,10002,1,2,41,44,
Adair,U.S. Senate,Jim Inhofe,REP,10002,2,3,116,121,
Adair,U.S. Senate,Aaron Delozier,IND,10002,0,0,1,1,
Adair,U.S. Senate,Ray Woods,IND,10002,0,0,2,2,
Adair,U.S. Senate,Joan Farr,IND,10002,0,0,1,1,
Adair,U.S. Senate,Connie Johnson,DEM,10002,1,1,36,38,
Adair,U.S. Senate,James Lankford,REP,10002,1,4,120,125,
Adair,U.S. Senate,Mark Beard,IND,10002,0,0,6,6,
Adair,U.S. House,Earl Everett,DEM,10002,1,0,28,29,02
Adair,U.S. House,Markwayne Mullin,REP,10002,2,5,130,137,02
Adair,U.S. House,Jon Douthitt,IND,10002,0,0,2,2,02
Adair,State House,Will Fourkiller,DEM,10002,2,3,119,124,86
Adair,State House,Tonya Teaney,REP,10002,0,2,41,43,86
Adair,Governor,Joe Dorman,DEM,10003,0,2,45,47,
Adair,Governor,Mary Fallin,REP,10003,3,4,55,62,
Adair,Governor,Kimberly Willis,IND,10003,0,0,3,3,
Adair,Governor,Richard Prawdzienski,IND,10003,0,0,1,1,
Adair,Lieutenant Governor,Cathy Cummings,DEM,10003,1,0,40,41,
Adair,Lieutenant Governor,Todd Lamb,REP,10003,2,6,64,72,
Adair,Superintendent of Public Instruction,John Cox,DEM,10003,0,2,61,63,
Adair,Superintendent of Public Instruction,Joy Hofmeister,REP,10003,3,4,43,50,
Adair,Commissioner of Labor,Mike Workman,DEM,10003,0,2,49,51,
Adair,Commissioner of Labor,Mark Costello,REP,10003,3,4,53,60,
Adair,U.S. Senate,Matt Silverstein,DEM,10003,0,0,33,33,
Adair,U.S. Senate,Jim Inhofe,REP,10003,3,6,67,76,
Adair,U.S. Senate,Aaron Delozier,IND,10003,0,0,1,1,
Adair,U.S. Senate,Ray Woods,IND,10003,0,0,2,2,
Adair,U.S. Senate,Joan Farr,IND,10003,0,0,1,1,
Adair,U.S. Senate,Connie Johnson,DEM,10003,0,0,35,35,
Adair,U.S. Senate,James Lankford,REP,10003,3,6,63,72,
Adair,U.S. Senate,Mark Beard,IND,10003,0,0,4,4,
Adair,U.S. House,Earl Everett,DEM,10003,0,0,28,28,02
Adair,U.S. House,Markwayne Mullin,REP,10003,3,6,72,81,02
Adair,U.S. House,Jon Douthitt,IND,10003,0,0,4,4,02
Adair,State House,Will Fourkiller,DEM,10003,1,3,63,67,86
Adair,State House,Tonya Teaney,REP,10003,2,3,41,46,86
Adair,Governor,Joe Dorman,DEM,10004,1,12,58,71,
Adair,Governor,Mary Fallin,REP,10004,2,7,87,96,
Adair,Governor,Kimberly Willis,IND,10004,0,0,4,4,
Adair,Governor,Richard Prawdzienski,IND,10004,0,0,3,3,
Adair,Lieutenant Governor,Cathy Cummings,DEM,10004,1,11,42,54,
Adair,Lieutenant Governor,Todd Lamb,REP,10004,2,8,109,119,
Adair,Superintendent of Public Instruction,John Cox,DEM,10004,3,15,99,117,
Adair,Superintendent of Public Instruction,Joy Hofmeister,REP,10004,0,4,53,57,
Adair,Commissioner of Labor,Mike Workman,DEM,10004,1,10,71,82,
Adair,Commissioner of Labor,Mark Costello,REP,10004,2,9,78,89,
Adair,U.S. Senate,Matt Silverstein,DEM,10004,1,7,34,42,
Adair,U.S. Senate,Jim Inhofe,REP,10004,2,12,114,128,
Adair,U.S. Senate,Aaron Delozier,IND,10004,0,0,1,1,
Adair,U.S. Senate,Ray Woods,IND,10004,0,0,0,0,
Adair,U.S. Senate,Joan Farr,IND,10004,0,0,2,2,
Adair,U.S. Senate,Connie Johnson,DEM,10004,1,5,40,46,
Adair,U.S. Senate,James Lankford,REP,10004,2,12,103,117,
Adair,U.S. Senate,Mark Beard,IND,10004,0,2,7,9,
Adair,U.S. House,Earl Everett,DEM,10004,1,6,21,28,02
Adair,U.S. House,Markwayne Mullin,REP,10004,2,13,124,139,02
Adair,U.S. House,Jon Douthitt,IND,10004,0,0,7,7,02
Adair,State House,Will Fourkiller,DEM,10004,3,18,117,138,86
Adair,State House,Tonya Teaney,REP,10004,0,1,35,36,86
Adair,Governor,Joe Dorman,DEM,10005,0,3,56,59,
Adair,Governor,Mary Fallin,REP,10005,2,0,59,61,
Adair,Governor,Kimberly Willis,IND,10005,0,0,4,4,
Adair,Governor,Richard Prawdzienski,IND,10005,0,0,1,1,
Adair,Lieutenant Governor,Cathy Cummings,DEM,10005,0,2,36,38,
Adair,Lieutenant Governor,Todd Lamb,REP,10005,2,1,83,86,
Adair,Superintendent of Public Instruction,John Cox,DEM,10005,0,3,92,95,
Adair,Superintendent of Public Instruction,Joy Hofmeister,REP,10005,2,0,27,29,
Adair,Commissioner of Labor,Mike Workman,DEM,10005,0,2,52,54,
Adair,Commissioner of Labor,Mark Costello,REP,10005,2,1,61,64,
Adair,U.S. Senate,Matt Silverstein,DEM,10005,0,2,27,29,
Adair,U.S. Senate,Jim Inhofe,REP,10005,2,1,86,89,
Adair,U.S. Senate,Aaron Delozier,IND,10005,0,0,1,1,
Adair,U.S. Senate,Ray Woods,IND,10005,0,0,1,1,
Adair,U.S. Senate,Joan Farr,IND,10005,0,0,1,1,
Adair,U.S. Senate,Connie Johnson,DEM,10005,0,2,34,36,
Adair,U.S. Senate,James Lankford,REP,10005,2,1,83,86,
Adair,U.S. Senate,Mark Beard,IND,10005,0,0,2,2,
Adair,U.S. House,Earl Everett,DEM,10005,0,1,19,20,02
Adair,U.S. House,Markwayne Mullin,REP,10005,2,2,97,101,02
Adair,U.S. House,Jon Douthitt,IND,10005,0,0,5,5,02
Adair,State House,Will Fourkiller,DEM,10005,0,3,98,101,86
Adair,State House,Tonya Teaney,REP,10005,2,0,23,25,86
Adair,Governor,Joe Dorman,DEM,10006,1,6,148,155,
Adair,Governor,Mary Fallin,REP,10006,0,6,125,131,
Adair,Governor,Kimberly Willis,IND,10006,0,0,12,12,
Adair,Governor,Richard Prawdzienski,IND,10006,0,0,4,4,
Adair,Lieutenant Governor,Cathy Cummings,DEM,10006,0,5,91,96,
Adair,Lieutenant Governor,Todd Lamb,REP,10006,1,7,198,206,
Adair,Superintendent of Public Instruction,John Cox,DEM,10006,1,5,208,214,
Adair,Superintendent of Public Instruction,Joy Hofmeister,REP,10006,0,7,84,91,
Adair,Commissioner of Labor,Mike Workman,DEM,10006,0,7,146,153,
Adair,Commissioner of Labor,Mark Costello,REP,10006,0,5,139,144,
Adair,U.S. Senate,Matt Silverstein,DEM,10006,0,5,68,73,
Adair,U.S. Senate,Jim Inhofe,REP,10006,1,7,210,218,
Adair,U.S. Senate,Aaron Delozier,IND,10006,0,0,4,4,
Adair,U.S. Senate,Ray Woods,IND,10006,0,0,7,7,
Adair,U.S. Senate,Joan Farr,IND,10006,0,0,1,1,
Adair,U.S. Senate,Connie Johnson,DEM,10006,0,5,81,86,
Adair,U.S. Senate,James Lankford,REP,10006,1,7,196,204,
Adair,U.S. Senate,Mark Beard,IND,10006,0,0,12,12,
Adair,U.S. House,Earl Everett,DEM,10006,0,4,49,53,02
Adair,U.S. House,Markwayne Mullin,REP,10006,1,8,233,242,02
Adair,U.S. House,Jon Douthitt,IND,10006,0,0,8,8,02
Adair,State House,Will Fourkiller,DEM,10006,1,7,230,238,86
Adair,State House,Tonya Teaney,REP,10006,0,5,63,68,86
Adair,Governor,Joe Dorman,DEM,10007,2,15,156,173,
Adair,Governor,Mary Fallin,REP,10007,1,4,153,158,
Adair,Governor,Kimberly Willis,IND,10007,0,0,9,9,
Adair,Governor,Richard Prawdzienski,IND,10007,0,0,2,2,
Adair,Lieutenant Governor,Cathy Cummings,DEM,10007,1,12,117,130,
Adair,Lieutenant Governor,Todd Lamb,REP,10007,2,7,203,212,
Adair,Superintendent of Public Instruction,John Cox,DEM,10007,3,16,221,240,
Adair,Superintendent of Public Instruction,Joy Hofmeister,REP,10007,0,3,98,101,
Adair,Commissioner of Labor,Mike Workman,DEM,10007,3,14,160,177,
Adair,Commissioner of Labor,Mark Costello,REP,10007,0,5,158,163,
Adair,U.S. Senate,Matt Silverstein,DEM,10007,1,14,95,110,
Adair,U.S. Senate,Jim Inhofe,REP,10007,2,5,219,226,
Adair,U.S. Senate,Aaron Delozier,IND,10007,0,0,1,1,
Adair,U.S. Senate,Ray Woods,IND,10007,0,0,3,3,
Adair,U.S. Senate,Joan Farr,IND,10007,0,0,3,3,
Adair,U.S. Senate,Connie Johnson,DEM,10007,0,13,109,122,
Adair,U.S. Senate,James Lankford,REP,10007,3,5,203,211,
Adair,U.S. Senate,Mark Beard,IND,10007,0,0,7,7,
Adair,U.S. House,Earl Everett,DEM,10007,0,12,61,73,02
Adair,U.S. House,Markwayne Mullin,REP,10007,3,7,247,257,02
Adair,U.S. House,Jon Douthitt,IND,10007,0,0,12,12,02
Adair,State House,Will Fourkiller,DEM,10007,3,13,249,265,86
Adair,State House,Tonya Teaney,REP,10007,0,6,74,80,86
Adair,Governor,Joe Dorman,DEM,10008,2,11,110,123,
Adair,Governor,Mary Fallin,REP,10008,0,4,133,137,
Adair,Governor,Kimberly Willis,IND,10008,0,2,6,8,
Adair,Governor,Richard Prawdzienski,IND,10008,0,0,2,2,
Adair,Lieutenant Governor,Cathy Cummings,DEM,10008,2,8,84,94,
Adair,Lieutenant Governor,Todd Lamb,REP,10008,0,9,167,176,
Adair,Superintendent of Public Instruction,John Cox,DEM,10008,2,15,161,178,
Adair,Superintendent of Public Instruction,Joy Hofmeister,REP,10008,0,2,90,92,
Adair,Commissioner of Labor,Mike Workman,DEM,10008,2,13,125,140,
Adair,Commissioner of Labor,Mark Costello,REP,10008,0,4,126,130,
Adair,U.S. Senate,Matt Silverstein,DEM,10008,2,8,64,74,
Adair,U.S. Senate,Jim Inhofe,REP,10008,0,9,180,189,
Adair,U.S. Senate,Aaron Delozier,IND,10008,0,0,2,2,
Adair,U.S. Senate,Ray Woods,IND,10008,0,0,5,5,
Adair,U.S. Senate,Joan Farr,IND,10008,0,0,1,1,
Adair,U.S. Senate,Connie Johnson,DEM,10008,2,11,81,94,
Adair,U.S. Senate,James Lankford,REP,10008,0,6,168,174,
Adair,U.S. Senate,Mark Beard,IND,10008,0,0,0,0,
Adair,U.S. House,Earl Everett,DEM,10008,2,4,42,48,02
Adair,U.S. House,Markwayne Mullin,REP,10008,0,13,203,216,02
Adair,U.S. House,Jon Douthitt,IND,10008,0,0,9,9,02
Adair,State House,Will Fourkiller,DEM,10008,2,15,205,222,86
Adair,State House,Tonya Teaney,REP,10008,0,2,51,53,86
Adair,Governor,Joe Dorman,DEM,10010,0,1,37,38,
Adair,Governor,Mary Fallin,REP,10010,0,5,47,52,
Adair,Governor,Kimberly Willis,IND,10010,0,0,4,4,
Adair,Governor,Richard Prawdzienski,IND,10010,0,0,1,1,
Adair,Lieutenant Governor,Cathy Cummings,DEM,10010,0,1,36,37,
Adair,Lieutenant Governor,Todd Lamb,REP,10010,0,4,53,57,
Adair,Superintendent of Public Instruction,John Cox,DEM,10010,0,6,65,71,
Adair,Superintendent of Public Instruction,Joy Hofmeister,REP,10010,0,0,25,25,
Adair,Commissioner of Labor,Mike Workman,DEM,10010,0,2,52,54,
Adair,Commissioner of Labor,Mark Costello,REP,10010,0,4,34,38,
Adair,U.S. Senate,Matt Silverstein,DEM,10010,0,0,30,30,
Adair,U.S. Senate,Jim Inhofe,REP,10010,0,6,56,62,
Adair,U.S. Senate,Aaron Delozier,IND,10010,0,0,1,1,
Adair,U.S. Senate,Ray Woods,IND,10010,0,0,0,0,
Adair,U.S. Senate,Joan Farr,IND,10010,0,0,2,2,
Adair,U.S. Senate,Connie Johnson,DEM,10010,0,1,31,32,
Adair,U.S. Senate,James Lankford,REP,10010,0,4,52,56,
Adair,U.S. Senate,Mark Beard,IND,10010,0,1,6,7,
Adair,U.S. House,Earl Everett,DEM,10010,0,0,15,15,02
Adair,U.S. House,Markwayne Mullin,REP,10010,0,6,67,73,02
Adair,U.S. House,Jon Douthitt,IND,10010,0,0,7,7,02
Adair,State House,Will Fourkiller,DEM,10010,0,5,70,75,86
Adair,State House,Tonya Teaney,REP,10010,0,1,20,21,86
Adair,Governor,Joe Dorman,DEM,10011,0,1,36,37,
Adair,Governor,Mary Fallin,REP,10011,3,2,28,33,
Adair,Governor,Kimberly Willis,IND,10011,0,0,3,3,
Adair,Governor,Richard Prawdzienski,IND,10011,0,0,1,1,
Adair,Lieutenant Governor,Cathy Cummings,DEM,10011,0,0,16,16,
Adair,Lieutenant Governor,Todd Lamb,REP,10011,3,3,50,56,
Adair,Superintendent of Public Instruction,John Cox,DEM,10011,1,1,51,53,
Adair,Superintendent of Public Instruction,Joy Hofmeister,REP,10011,2,2,18,22,
Adair,Commissioner of Labor,Mike Workman,DEM,10011,0,0,33,33,
Adair,Commissioner of Labor,Mark Costello,REP,10011,3,3,30,36,
Adair,U.S. Senate,Matt Silverstein,DEM,10011,0,0,17,17,
Adair,U.S. Senate,Jim Inhofe,REP,10011,3,3,47,53,
Adair,U.S. Senate,Aaron Delozier,IND,10011,0,0,2,2,
Adair,U.S. Senate,Ray Woods,IND,10011,0,0,1,1,
Adair,U.S. Senate,Joan Farr,IND,10011,0,0,2,2,
Adair,U.S. Senate,Connie Johnson,DEM,10011,0,1,18,19,
Adair,U.S. Senate,James Lankford,REP,10011,3,2,46,51,
Adair,U.S. Senate,Mark Beard,IND,10011,0,0,4,4,
Adair,U.S. House,Earl Everett,DEM,10011,0,0,10,10,02
Adair,U.S. House,Markwayne Mullin,REP,10011,3,3,54,60,02
Adair,U.S. House,Jon Douthitt,IND,10011,0,0,4,4,02
Adair,State House,Will Fourkiller,DEM,10011,1,1,48,50,86
Adair,State House,Tonya Teaney,REP,10011,2,2,21,25,86
Adair,Governor,Joe Dorman,DEM,10012,1,8,78,87,
Adair,Governor,Mary Fallin,REP,10012,4,5,140,149,
Adair,Governor,Kimberly Willis,IND,10012,0,0,5,5,
Adair,Governor,Richard Prawdzienski,IND,10012,0,0,3,3,
Adair,Lieutenant Governor,Cathy Cummings,DEM,10012,1,7,55,63,
Adair,Lieutenant Governor,Todd Lamb,REP,10012,4,6,170,180,
Adair,Superintendent of Public Instruction,John Cox,DEM,10012,4,8,134,146,
Adair,Superintendent of Public Instruction,Joy Hofmeister,REP,10012,1,5,92,98,
Adair,Commissioner of Labor,Mike Workman,DEM,10012,1,9,105,115,
Adair,Commissioner of Labor,Mark Costello,REP,10012,4,4,112,120,
Adair,U.S. Senate,Matt Silverstein,DEM,10012,1,7,49,57,
Adair,U.S. Senate,Jim Inhofe,REP,10012,4,6,170,180,
Adair,U.S. Senate,Aaron Delozier,IND,10012,0,0,1,1,
Adair,U.S. Senate,Ray Woods,IND,10012,0,0,1,1,
Adair,U.S. Senate,Joan Farr,IND,10012,0,0,2,2,
Adair,U.S. Senate,Connie Johnson,DEM,10012,0,7,57,64,
Adair,U.S. Senate,James Lankford,REP,10012,5,6,157,168,
Adair,U.S. Senate,Mark Beard,IND,10012,0,0,10,10,
Adair,U.S. House,Earl Everett,DEM,10012,0,5,41,46,02
Adair,U.S. House,Markwayne Mullin,REP,10012,5,8,175,188,02
Adair,U.S. House,Jon Douthitt,IND,10012,0,0,7,7,02
Adair,State House,Will Fourkiller,DEM,10012,5,8,155,168,86
Adair,State House,Tonya Teaney,REP,10012,0,5,69,74,86
Adair,Governor,Joe Dorman,DEM,10013,1,8,77,86,
Adair,Governor,Mary Fallin,REP,10013,5,11,99,115,
Adair,Governor,Kimberly Willis,IND,10013,0,0,5,5,
Adair,Governor,Richard Prawdzienski,IND,10013,0,0,2,2,
Adair,Lieutenant Governor,Cathy Cummings,DEM,10013,0,5,57,62,
Adair,Lieutenant Governor,Todd Lamb,REP,10013,5,14,125,144,
Adair,Superintendent of Public Instruction,John Cox,DEM,10013,4,9,125,138,
Adair,Superintendent of Public Instruction,Joy Hofmeister,REP,10013,2,10,58,70,
Adair,Commissioner of Labor,Mike Workman,DEM,10013,2,7,97,106,
Adair,Commissioner of Labor,Mark Costello,REP,10013,3,12,80,95,
Adair,U.S. Senate,Matt Silverstein,DEM,10013,0,4,47,51,
Adair,U.S. Senate,Jim Inhofe,REP,10013,6,14,131,151,
Adair,U.S. Senate,Aaron Delozier,IND,10013,0,0,2,2,
Adair,U.S. Senate,Ray Woods,IND,10013,0,0,2,2,
Adair,U.S. Senate,Joan Farr,IND,10013,0,1,1,2,
Adair,U.S. Senate,Connie Johnson,DEM,10013,0,7,55,62,
Adair,U.S. Senate,James Lankford,REP,10013,5,11,114,130,
Adair,U.S. Senate,Mark Beard,IND,10013,0,1,9,10,
Adair,U.S. House,Earl Everett,DEM,10013,0,3,28,31,02
Adair,U.S. House,Markwayne Mullin,REP,10013,6,16,146,168,02
Adair,U.S. House,Jon Douthitt,IND,10013,0,0,8,8,02
Adair,State House,Will Fourkiller,DEM,10013,6,14,142,162,86
Adair,State House,Tonya Teaney,REP,10013,0,5,41,46,86
Adair,Governor,Joe Dorman,DEM,10014,4,12,136,152,
Adair,Governor,Mary Fallin,REP,10014,2,4,101,107,
Adair,Governor,Kimberly Willis,IND,10014,0,1,9,10,
Adair,Governor,Richard Prawdzienski,IND,10014,0,1,3,4,
Adair,Lieutenant Governor,Cathy Cummings,DEM,10014,4,12,99,115,
Adair,Lieutenant Governor,Todd Lamb,REP,10014,2,6,150,158,
Adair,Superintendent of Public Instruction,John Cox,DEM,10014,5,17,176,198,
Adair,Superintendent of Public Instruction,Joy Hofmeister,REP,10014,1,1,75,77,
Adair,Commissioner of Labor,Mike Workman,DEM,10014,4,12,128,144,
Adair,Commissioner of Labor,Mark Costello,REP,10014,1,6,120,127,
Adair,U.S. Senate,Matt Silverstein,DEM,10014,4,12,76,92,
Adair,U.S. Senate,Jim Inhofe,REP,10014,2,5,167,174,
Adair,U.S. Senate,Aaron Delozier,IND,10014,0,0,3,3,
Adair,U.S. Senate,Ray Woods,IND,10014,0,0,2,2,
Adair,U.S. Senate,Joan Farr,IND,10014,0,1,4,5,
Adair,U.S. Senate,Connie Johnson,DEM,10014,3,10,94,107,
Adair,U.S. Senate,James Lankford,REP,10014,2,7,148,157,
Adair,U.S. Senate,Mark Beard,IND,10014,1,1,8,10,
Adair,U.S. House,Earl Everett,DEM,10014,3,4,49,56,02
Adair,U.S. House,Markwayne Mullin,REP,10014,3,14,194,211,02
Adair,U.S. House,Jon Douthitt,IND,10014,0,0,7,7,02
Adair,State House,Will Fourkiller,DEM,10014,5,16,199,220,86
Adair,State House,Tonya Teaney,REP,10014,1,2,53,56,86
Adair,Governor,Joe Dorman,DEM,10016,0,0,58,58,
Adair,Governor,Mary Fallin,REP,10016,2,1,171,174,
Adair,Governor,Kimberly Willis,IND,10016,0,0,3,3,
Adair,Governor,Richard Prawdzienski,IND,10016,0,0,0,0,
Adair,Lieutenant Governor,Cathy Cummings,DEM,10016,0,0,49,49,
Adair,Lieutenant Governor,Todd Lamb,REP,10016,2,1,181,184,
Adair,Superintendent of Public Instruction,John Cox,DEM,10016,0,0,92,92,
Adair,Superintendent of Public Instruction,Joy Hofmeister,REP,10016,2,1,139,142,
Adair,Commissioner of Labor,Mike Workman,DEM,10016,0,0,69,69,
Adair,Commissioner of Labor,Mark Costello,REP,10016,2,1,157,160,
Adair,U.S. Senate,Matt Silverstein,DEM,10016,0,0,47,47,
Adair,U.S. Senate,Jim Inhofe,REP,10016,2,1,181,184,
Adair,U.S. Senate,Aaron Delozier,IND,10016,0,0,0,0,
Adair,U.S. Senate,Ray Woods,IND,10016,0,0,1,1,
Adair,U.S. Senate,Joan Farr,IND,10016,0,0,2,2,
Adair,U.S. Senate,Connie Johnson,DEM,10016,0,0,45,45,
Adair,U.S. Senate,James Lankford,REP,10016,2,1,181,184,
Adair,U.S. Senate,Mark Beard,IND,10016,0,0,4,4,
Adair,U.S. House,Earl Everett,DEM,10016,0,0,29,29,02
Adair,U.S. House,Markwayne Mullin,REP,10016,2,1,191,194,02
Adair,U.S. House,Jon Douthitt,IND,10016,0,0,12,12,02
Adair,State House,Will Fourkiller,DEM,10016,1,0,100,101,86
Adair,State House,Tonya Teaney,REP,10016,1,1,129,131,86
Adair,Governor,Joe Dorman,DEM,10017,1,0,124,125,
Adair,Governor,Mary Fallin,REP,10017,4,8,203,215,
Adair,Governor,Kimberly Willis,IND,10017,0,0,11,11,
Adair,Governor,Richard Prawdzienski,IND,10017,0,0,5,5,
Adair,Lieutenant Governor,Cathy Cummings,DEM,10017,0,0,96,96,
Adair,Lieutenant Governor,Todd Lamb,REP,10017,5,8,244,257,
Adair,Superintendent of Public Instruction,John Cox,DEM,10017,3,0,173,176,
Adair,Superintendent of Public Instruction,Joy Hofmeister,REP,10017,2,8,166,176,
Adair,Commissioner of Labor,Mike Workman,DEM,10017,1,0,172,173,
Adair,Commissioner of Labor,Mark Costello,REP,10017,4,8,164,176,
Adair,U.S. Senate,Matt Silverstein,DEM,10017,2,0,84,86,
Adair,U.S. Senate,Jim Inhofe,REP,10017,3,8,242,253,
Adair,U.S. Senate,Aaron Delozier,IND,10017,0,0,3,3,
Adair,U.S. Senate,Ray Woods,IND,10017,0,0,6,6,
Adair,U.S. Senate,Joan Farr,IND,10017,0,0,7,7,
Adair,U.S. Senate,Connie Johnson,DEM,10017,0,0,96,96,
Adair,U.S. Senate,James Lankford,REP,10017,3,7,221,231,
Adair,U.S. Senate,Mark Beard,IND,10017,2,1,23,26,
Adair,U.S. House,Earl Everett,DEM,10017,0,0,63,63,02
Adair,U.S. House,Markwayne Mullin,REP,10017,5,8,259,272,02
Adair,U.S. House,Jon Douthitt,IND,10017,0,0,21,21,02
Adair,State House,Will Fourkiller,DEM,10017,3,1,204,208,86
Adair,State House,Tonya Teaney,REP,10017,2,7,135,144,86
Adair,Governor,Joe Dorman,DEM,10018,3,8,150,161,
Adair,Governor,Mary Fallin,REP,10018,0,1,224,225,
Adair,Governor,Kimberly Willis,IND,10018,0,0,10,10,
Adair,Governor,Richard Prawdzienski,IND,10018,0,0,7,7,
Adair,Lieutenant Governor,Cathy Cummings,DEM,10018,3,7,122,132,
Adair,Lieutenant Governor,Todd Lamb,REP,10018,0,2,265,267,
Adair,Superintendent of Public Instruction,John Cox,DEM,10018,3,7,251,261,
Adair,Superintendent of Public Instruction,Joy Hofmeister,REP,10018,0,2,142,144,
Adair,Commissioner of Labor,Mike Workman,DEM,10018,3,6,193,202,
Adair,Commissioner of Labor,Mark Costello,REP,10018,0,2,189,191,
Adair,U.S. Senate,Matt Silverstein,DEM,10018,3,6,103,112,
Adair,U.S. Senate,Jim Inhofe,REP,10018,0,3,269,272,
Adair,U.S. Senate,Aaron Delozier,IND,10018,0,0,4,4,
Adair,U.S. Senate,Ray Woods,IND,10018,0,0,5,5,
Adair,U.S. Senate,Joan Farr,IND,10018,0,0,11,11,
Adair,U.S. Senate,Connie Johnson,DEM,10018,3,6,109,118,
Adair,U.S. Senate,James Lankford,REP,10018,0,3,259,262,
Adair,U.S. Senate,Mark Beard,IND,10018,0,0,18,18,
Adair,U.S. House,Earl Everett,DEM,10018,2,2,55,59,02
Adair,U.S. House,Markwayne Mullin,REP,10018,1,7,320,328,02
Adair,U.S. House,Jon Douthitt,IND,10018,0,0,23,23,02
Adair,State House,Will Fourkiller,DEM,10018,3,9,310,322,86
Adair,State House,Tonya Teaney,REP,10018,0,0,86,86,86
Adair,Governor,Joe Dorman,DEM,10019,1,6,202,209,
Adair,Governor,Mary Fallin,REP,10019,1,3,312,316,
Adair,Governor,Kimberly Willis,IND,10019,0,0,27,27,
Adair,Governor,Richard Prawdzienski,IND,10019,0,0,11,11,
Adair,Lieutenant Governor,Cathy Cummings,DEM,10019,1,1,139,141,
Adair,Lieutenant Governor,Todd Lamb,REP,10019,1,8,406,415,
Adair,Superintendent of Public Instruction,John Cox,DEM,10019,1,5,321,327,
Adair,Superintendent of Public Instruction,Joy Hofmeister,REP,10019,1,4,225,230,
Adair,Commissioner of Labor,Mike Workman,DEM,10019,1,4,255,260,
Adair,Commissioner of Labor,Mark Costello,REP,10019,1,5,281,287,
Adair,U.S. Senate,Matt Silverstein,DEM,10019,0,1,116,117,
Adair,U.S. Senate,Jim Inhofe,REP,10019,2,8,406,416,
Adair,U.S. Senate,Aaron Delozier,IND,10019,0,0,6,6,
Adair,U.S. Senate,Ray Woods,IND,10019,0,0,15,15,
Adair,U.S. Senate,Joan Farr,IND,10019,0,0,6,6,
Adair,U.S. Senate,Connie Johnson,DEM,10019,0,1,130,131,
Adair,U.S. Senate,James Lankford,REP,10019,2,8,381,391,
Adair,U.S. Senate,Mark Beard,IND,10019,0,0,31,31,
Adair,U.S. House,Earl Everett,DEM,10019,0,0,66,66,02
Adair,U.S. House,Markwayne Mullin,REP,10019,2,9,455,466,02
Adair,U.S. House,Jon Douthitt,IND,10019,0,0,30,30,02
Adair,State House,Will Fourkiller,DEM,10019,2,9,390,401,86
Adair,State House,Tonya Teaney,REP,10019,0,0,154,154,86
Alfalfa,Governor,Joe Dorman,DEM,20110,2,3,47,52,
Alfalfa,Governor,Mary Fallin,REP,20110,1,8,83,92,
Alfalfa,Governor,Kimberly Willis,IND,20110,0,0,2,2,
Alfalfa,Governor,Richard Prawdzienski,IND,20110,0,0,1,1,
Alfalfa,Lieutenant Governor,Cathy Cummings,DEM,20110,2,0,12,14,
Alfalfa,Lieutenant Governor,Todd Lamb,REP,20110,1,10,122,133,
Alfalfa,Superintendent of Public Instruction,John Cox,DEM,20110,2,1,47,50,
Alfalfa,Superintendent of Public Instruction,Joy Hofmeister,REP,20110,1,8,87,96,
Alfalfa,Commissioner of Labor,Mike Workman,DEM,20110,2,1,24,27,
Alfalfa,Commissioner of Labor,Mark Costello,REP,20110,1,8,103,112,
Alfalfa,U.S. Senate,Matt Silverstein,DEM,20110,2,0,9,11,
Alfalfa,U.S. Senate,Jim Inhofe,REP,20110,1,10,123,134,
Alfalfa,U.S. Senate,Aaron Delozier,IND,20110,0,0,0,0,
Alfalfa,U.S. Senate,Ray Woods,IND,20110,0,0,2,2,
Alfalfa,U.S. Senate,Joan Farr,IND,20110,0,0,0,0,
Alfalfa,U.S. Senate,Connie Johnson,DEM,20110,2,0,11,13,
Alfalfa,U.S. Senate,James Lankford,REP,20110,1,10,120,131,
Alfalfa,U.S. Senate,Mark Beard,IND,20110,0,0,4,4,
Alfalfa,U.S. House,Frankie Robbins,DEM,20110,2,0,9,11,03
Alfalfa,U.S. House,Frank Lucas,REP,20110,1,10,125,136,03
Alfalfa,Governor,Joe Dorman,DEM,20120,1,5,32,38,
Alfalfa,Governor,Mary Fallin,REP,20120,6,11,83,100,
Alfalfa,Governor,Kimberly Willis,IND,20120,0,0,4,4,
Alfalfa,Governor,Richard Prawdzienski,IND,20120,0,0,0,0,
Alfalfa,Lieutenant Governor,Cathy Cummings,DEM,20120,1,1,13,15,
Alfalfa,Lieutenant Governor,Todd Lamb,REP,20120,6,15,104,125,
Alfalfa,Superintendent of Public Instruction,John Cox,DEM,20120,1,4,37,42,
Alfalfa,Superintendent of Public Instruction,Joy Hofmeister,REP,20120,6,11,80,97,
Alfalfa,Commissioner of Labor,Mike Workman,DEM,20120,1,2,29,32,
Alfalfa,Commissioner of Labor,Mark Costello,REP,20120,6,12,85,103,
Alfalfa,U.S. Senate,Matt Silverstein,DEM,20120,0,0,12,12,
Alfalfa,U.S. Senate,Jim Inhofe,REP,20120,6,16,101,123,
Alfalfa,U.S. Senate,Aaron Delozier,IND,20120,0,0,1,1,
Alfalfa,U.S. Senate,Ray Woods,IND,20120,0,0,1,1,
Alfalfa,U.S. Senate,Joan Farr,IND,20120,1,0,2,3,
Alfalfa,U.S. Senate,Connie Johnson,DEM,20120,0,1,11,12,
Alfalfa,U.S. Senate,James Lankford,REP,20120,6,15,102,123,
Alfalfa,U.S. Senate,Mark Beard,IND,20120,1,0,5,6,
Alfalfa,U.S. House,Frankie Robbins,DEM,20120,0,2,15,17,03
Alfalfa,U.S. House,Frank Lucas,REP,20120,7,14,102,123,03
Alfalfa,Governor,Joe Dorman,DEM,20140,0,14,85,99,
Alfalfa,Governor,Mary Fallin,REP,20140,0,20,141,161,
Alfalfa,Governor,Kimberly Willis,IND,20140,0,0,4,4,
Alfalfa,Governor,Richard Prawdzienski,IND,20140,0,0,2,2,
Alfalfa,Lieutenant Governor,Cathy Cummings,DEM,20140,0,5,31,36,
Alfalfa,Lieutenant Governor,Todd Lamb,REP,20140,1,30,199,230,
Alfalfa,Superintendent of Public Instruction,John Cox,DEM,20140,1,12,82,95,
Alfalfa,Superintendent of Public Instruction,Joy Hofmeister,REP,20140,0,21,150,171,
Alfalfa,Commissioner of Labor,Mike Workman,DEM,20140,0,6,68,74,
Alfalfa,Commissioner of Labor,Mark Costello,REP,20140,1,28,158,187,
Alfalfa,U.S. Senate,Matt Silverstein,DEM,20140,0,6,34,40,
Alfalfa,U.S. Senate,Jim Inhofe,REP,20140,1,29,187,217,
Alfalfa,U.S. Senate,Aaron Delozier,IND,20140,0,0,0,0,
Alfalfa,U.S. Senate,Ray Woods,IND,20140,0,0,7,7,
Alfalfa,U.S. Senate,Joan Farr,IND,20140,0,0,4,4,
Alfalfa,U.S. Senate,Connie Johnson,DEM,20140,0,6,29,35,
Alfalfa,U.S. Senate,James Lankford,REP,20140,1,29,196,226,
Alfalfa,U.S. Senate,Mark Beard,IND,20140,0,0,6,6,
Alfalfa,U.S. House,Frankie Robbins,DEM,20140,0,7,31,38,03
Alfalfa,U.S. House,Frank Lucas,REP,20140,1,28,200,229,03
Alfalfa,Governor,Joe Dorman,DEM,20220,5,6,86,97,
Alfalfa,Governor,Mary Fallin,REP,20220,2,15,163,180,
Alfalfa,Governor,Kimberly Willis,IND,20220,1,2,10,13,
Alfalfa,Governor,Richard Prawdzienski,IND,20220,0,0,2,2,
Alfalfa,Lieutenant Governor,Cathy Cummings,DEM,20220,4,2,36,42,
Alfalfa,Lieutenant Governor,Todd Lamb,REP,20220,4,22,225,251,
Alfalfa,Superintendent of Public Instruction,John Cox,DEM,20220,6,4,101,111,
Alfalfa,Superintendent of Public Instruction,Joy Hofmeister,REP,20220,2,18,159,179,
Alfalfa,Commissioner of Labor,Mike Workman,DEM,20220,5,4,81,90,
Alfalfa,Commissioner of Labor,Mark Costello,REP,20220,3,18,172,193,
Alfalfa,U.S. Senate,Matt Silverstein,DEM,20220,5,3,34,42,
Alfalfa,U.S. Senate,Jim Inhofe,REP,20220,2,18,214,234,
Alfalfa,U.S. Senate,Aaron Delozier,IND,20220,0,0,4,4,
Alfalfa,U.S. Senate,Ray Woods,IND,20220,0,0,3,3,
Alfalfa,U.S. Senate,Joan Farr,IND,20220,1,2,3,6,
Alfalfa,U.S. Senate,Connie Johnson,DEM,20220,5,1,36,42,
Alfalfa,U.S. Senate,James Lankford,REP,20220,3,22,220,245,
Alfalfa,U.S. Senate,Mark Beard,IND,20220,0,1,5,6,
Alfalfa,U.S. House,Frankie Robbins,DEM,20220,6,2,35,43,03
Alfalfa,U.S. House,Frank Lucas,REP,20220,2,22,223,247,03
Alfalfa,Governor,Joe Dorman,DEM,20230,2,1,66,69,
Alfalfa,Governor,Mary Fallin,REP,20230,5,2,114,121,
Alfalfa,Governor,Kimberly Willis,IND,20230,0,0,2,2,
Alfalfa,Governor,Richard Prawdzienski,IND,20230,0,0,3,3,
Alfalfa,Lieutenant Governor,Cathy Cummings,DEM,20230,1,0,30,31,
Alfalfa,Lieutenant Governor,Todd Lamb,REP,20230,6,3,155,164,
Alfalfa,Superintendent of Public Instruction,John Cox,DEM,20230,2,3,69,74,
Alfalfa,Superintendent of Public Instruction,Joy Hofmeister,REP,20230,5,0,116,121,
Alfalfa,Commissioner of Labor,Mike Workman,DEM,20230,2,0,44,46,
Alfalfa,Commissioner of Labor,Mark Costello,REP,20230,5,3,138,146,
Alfalfa,U.S. Senate,Matt Silverstein,DEM,20230,1,0,23,24,
Alfalfa,U.S. Senate,Jim Inhofe,REP,20230,6,3,151,160,
Alfalfa,U.S. Senate,Aaron Delozier,IND,20230,0,0,1,1,
Alfalfa,U.S. Senate,Ray Woods,IND,20230,0,0,9,9,
Alfalfa,U.S. Senate,Joan Farr,IND,20230,0,0,2,2,
Alfalfa,U.S. Senate,Connie Johnson,DEM,20230,1,0,25,26,
Alfalfa,U.S. Senate,James Lankford,REP,20230,6,3,152,161,
Alfalfa,U.S. Senate,Mark Beard,IND,20230,0,0,10,10,
Alfalfa,U.S. House,Frankie Robbins,DEM,20230,1,0,24,25,03
Alfalfa,U.S. House,Frank Lucas,REP,20230,6,3,162,171,03
Alfalfa,Governor,Joe Dorman,DEM,20310,1,3,95,99,
Alfalfa,Governor,Mary Fallin,REP,20310,2,5,141,148,
Alfalfa,Governor,Kimberly Willis,IND,20310,0,0,4,4,
Alfalfa,Governor,Richard Prawdzienski,IND,20310,0,0,2,2,
Alfalfa,Lieutenant Governor,Cathy Cummings,DEM,20310,0,0,29,29,
Alfalfa,Lieutenant Governor,Todd Lamb,REP,20310,3,8,212,223,
Alfalfa,Superintendent of Public Instruction,John Cox,DEM,20310,3,2,85,90,
Alfalfa,Superintendent of Public Instruction,Joy Hofmeister,REP,20310,0,4,156,160,
Alfalfa,Commissioner of Labor,Mike Workman,DEM,20310,0,1,56,57,
Alfalfa,Commissioner of Labor,Mark Costello,REP,20310,3,5,178,186,
Alfalfa,U.S. Senate,Matt Silverstein,DEM,20310,0,0,29,29,
Alfalfa,U.S. Senate,Jim Inhofe,REP,20310,3,8,204,215,
Alfalfa,U.S. Senate,Aaron Delozier,IND,20310,0,0,0,0,
Alfalfa,U.S. Senate,Ray Woods,IND,20310,0,0,7,7,
Alfalfa,U.S. Senate,Joan Farr,IND,20310,0,0,0,0,
Alfalfa,U.S. Senate,Connie Johnson,DEM,20310,0,1,26,27,
Alfalfa,U.S. Senate,James Lankford,REP,20310,3,5,208,216,
Alfalfa,U.S. Senate,Mark Beard,IND,20310,0,1,8,9,
Alfalfa,U.S. House,Frankie Robbins,DEM,20310,1,0,27,28,03
Alfalfa,U.S. House,Frank Lucas,REP,20310,2,8,214,224,03
Alfalfa,Governor,Joe Dorman,DEM,20330,10,5,61,76,
Alfalfa,Governor,Mary Fallin,REP,20330,20,4,146,170,
Alfalfa,Governor,Kimberly Willis,IND,20330,0,0,6,6,
Alfalfa,Governor,Richard Prawdzienski,IND,20330,0,0,1,1,
Alfalfa,Lieutenant Governor,Cathy Cummings,DEM,20330,2,1,15,18,
Alfalfa,Lieutenant Governor,Todd Lamb,REP,20330,28,8,199,235,
Alfalfa,Superintendent of Public Instruction,John Cox,DEM,20330,10,2,60,72,
Alfalfa,Superintendent of Public Instruction,Joy Hofmeister,REP,20330,20,7,154,181,
Alfalfa,Commissioner of Labor,Mike Workman,DEM,20330,8,2,41,51,
Alfalfa,Commissioner of Labor,Mark Costello,REP,20330,22,6,169,197,
Alfalfa,U.S. Senate,Matt Silverstein,DEM,20330,3,2,18,23,
Alfalfa,U.S. Senate,Jim Inhofe,REP,20330,27,7,190,224,
Alfalfa,U.S. Senate,Aaron Delozier,IND,20330,0,0,0,0,
Alfalfa,U.S. Senate,Ray Woods,IND,20330,0,0,3,3,
Alfalfa,U.S. Senate,Joan Farr,IND,20330,0,0,3,3,
Alfalfa,U.S. Senate,Connie Johnson,DEM,20330,3,1,17,21,
Alfalfa,U.S. Senate,James Lankford,REP,20330,27,8,189,224,
Alfalfa,U.S. Senate,Mark Beard,IND,20330,0,0,7,7,
Alfalfa,U.S. House,Frankie Robbins,DEM,20330,4,3,25,32,03
Alfalfa,U.S. House,Frank Lucas,REP,20330,26,6,186,218,03
Atoka,Governor,Joe Dorman,DEM,30001,2,26,137,165,
Atoka,Governor,Mary Fallin,REP,30001,4,40,169,213,
Atoka,Governor,Kimberly Willis,IND,30001,0,3,11,14,
Atoka,Governor,Richard Prawdzienski,IND,30001,0,0,2,2,
Atoka,Lieutenant Governor,Cathy Cummings,DEM,30001,2,27,112,141,
Atoka,Lieutenant Governor,Todd Lamb,REP,30001,4,42,203,249,
Atoka,Superintendent of Public Instruction,John Cox,DEM,30001,2,37,178,217,
Atoka,Superintendent of Public Instruction,Joy Hofmeister,REP,30001,4,30,140,174,
Atoka,Commissioner of Labor,Mike Workman,DEM,30001,2,32,122,156,
Atoka,Commissioner of Labor,Mark Costello,REP,30001,4,36,187,227,
Atoka,U.S. Senate,Matt Silverstein,DEM,30001,2,25,83,110,
Atoka,U.S. Senate,Jim Inhofe,REP,30001,4,43,222,269,
Atoka,U.S. Senate,Aaron Delozier,IND,30001,0,0,2,2,
Atoka,U.S. Senate,Ray Woods,IND,30001,0,0,5,5,
Atoka,U.S. Senate,Joan Farr,IND,30001,0,2,5,7,
Atoka,U.S. Senate,Connie Johnson,DEM,30001,2,24,89,115,
Atoka,U.S. Senate,James Lankford,REP,30001,3,44,213,260,
Atoka,U.S. Senate,Mark Beard,IND,30001,1,2,14,17,
Atoka,U.S. House,Earl Everett,DEM,30001,1,19,74,94,02
Atoka,U.S. House,Markwayne Mullin,REP,30001,4,48,236,288,02
Atoka,U.S. House,Jon Douthitt,IND,30001,1,1,10,12,02
Atoka,State Senate,Joe Hill,DEM,30001,2,29,132,163,6
Atoka,State Senate,Josh Brecheen,REP,30001,4,40,190,234,6
Atoka,State Senate,Vicki Gaylor,IND,30001,0,1,2,3,6
Atoka,Governor,Joe Dorman,DEM,30002,6,16,68,90,
Atoka,Governor,Mary Fallin,REP,30002,8,44,136,188,
Atoka,Governor,Kimberly Willis,IND,30002,0,3,7,10,
Atoka,Governor,Richard Prawdzienski,IND,30002,0,0,1,1,
Atoka,Lieutenant Governor,Cathy Cummings,DEM,30002,5,15,67,87,
Atoka,Lieutenant Governor,Todd Lamb,REP,30002,9,48,142,199,
Atoka,Superintendent of Public Instruction,John Cox,DEM,30002,6,30,106,142,
Atoka,Superintendent of Public Instruction,Joy Hofmeister,REP,30002,8,33,104,145,
Atoka,Commissioner of Labor,Mike Workman,DEM,30002,6,18,62,86,
Atoka,Commissioner of Labor,Mark Costello,REP,30002,8,44,143,195,
Atoka,U.S. Senate,Matt Silverstein,DEM,30002,5,11,38,54,
Atoka,U.S. Senate,Jim Inhofe,REP,30002,6,47,166,219,
Atoka,U.S. Senate,Aaron Delozier,IND,30002,2,2,3,7,
Atoka,U.S. Senate,Ray Woods,IND,30002,0,0,4,4,
Atoka,U.S. Senate,Joan Farr,IND,30002,0,2,2,4,
Atoka,U.S. Senate,Connie Johnson,DEM,30002,5,13,47,65,
Atoka,U.S. Senate,James Lankford,REP,30002,8,46,153,207,
Atoka,U.S. Senate,Mark Beard,IND,30002,1,3,9,13,
Atoka,U.S. House,Earl Everett,DEM,30002,6,10,32,48,02
Atoka,U.S. House,Markwayne Mullin,REP,30002,8,50,171,229,02
Atoka,U.S. House,Jon Douthitt,IND,30002,0,3,7,10,02
Atoka,State Senate,Joe Hill,DEM,30002,7,18,75,100,6
Atoka,State Senate,Josh Brecheen,REP,30002,7,43,137,187,6
Atoka,State Senate,Vicki Gaylor,IND,30002,0,2,1,3,6
Atoka,Governor,Joe Dorman,DEM,30003,0,22,88,110,
Atoka,Governor,Mary Fallin,REP,30003,3,25,73,101,
Atoka,Governor,Kimberly Willis,IND,30003,0,0,8,8,
Atoka,Governor,Richard Prawdzienski,IND,30003,1,0,1,2,
Atoka,Lieutenant Governor,Cathy Cummings,DEM,30003,0,22,71,93,
Atoka,Lieutenant Governor,Todd Lamb,REP,30003,4,24,94,122,
Atoka,Superintendent of Public Instruction,John Cox,DEM,30003,2,28,104,134,
Atoka,Superintendent of Public Instruction,Joy Hofmeister,REP,30003,2,18,64,84,
Atoka,Commissioner of Labor,Mike Workman,DEM,30003,0,22,86,108,
Atoka,Commissioner of Labor,Mark Costello,REP,30003,4,24,78,106,
Atoka,U.S. Senate,Matt Silverstein,DEM,30003,0,19,55,74,
Atoka,U.S. Senate,Jim Inhofe,REP,30003,3,28,109,140,
Atoka,U.S. Senate,Aaron Delozier,IND,30003,0,0,1,1,
Atoka,U.S. Senate,Ray Woods,IND,30003,0,0,0,0,
Atoka,U.S. Senate,Joan Farr,IND,30003,1,0,4,5,
Atoka,U.S. Senate,Connie Johnson,DEM,30003,0,19,57,76,
Atoka,U.S. Senate,James Lankford,REP,30003,4,26,99,129,
Atoka,U.S. Senate,Mark Beard,IND,30003,0,1,8,9,
Atoka,U.S. House,Earl Everett,DEM,30003,0,17,51,68,02
Atoka,U.S. House,Markwayne Mullin,REP,30003,4,30,111,145,02
Atoka,U.S. House,Jon Douthitt,IND,30003,0,0,6,6,02
Atoka,State Senate,Joe Hill,DEM,30003,0,22,78,100,6
Atoka,State Senate,Josh Brecheen,REP,30003,4,25,91,120,6
Atoka,State Senate,Vicki Gaylor,IND,30003,0,0,4,4,6
Atoka,Governor,Joe Dorman,DEM,30006,5,26,51,82,
Atoka,Governor,Mary Fallin,REP,30006,1,20,69,90,
Atoka,Governor,Kimberly Willis,IND,30006,0,2,8,10,
Atoka,Governor,Richard Prawdzienski,IND,30006,0,0,2,2,
Atoka,Lieutenant Governor,Cathy Cummings,DEM,30006,5,17,51,73,
Atoka,Lieutenant Governor,Todd Lamb,REP,30006,1,31,78,110,
Atoka,Superintendent of Public Instruction,John Cox,DEM,30006,5,28,66,99,
Atoka,Superintendent of Public Instruction,Joy Hofmeister,REP,30006,1,19,64,84,
Atoka,Commissioner of Labor,Mike Workman,DEM,30006,5,21,61,87,
Atoka,Commissioner of Labor,Mark Costello,REP,30006,1,25,67,93,
Atoka,U.S. Senate,Matt Silverstein,DEM,30006,5,15,32,52,
Atoka,U.S. Senate,Jim Inhofe,REP,30006,1,30,86,117,
Atoka,U.S. Senate,Aaron Delozier,IND,30006,0,0,2,2,
Atoka,U.S. Senate,Ray Woods,IND,30006,0,1,3,4,
Atoka,U.S. Senate,Joan Farr,IND,30006,0,2,6,8,
Atoka,U.S. Senate,Connie Johnson,DEM,30006,5,12,46,63,
Atoka,U.S. Senate,James Lankford,REP,30006,1,33,77,111,
Atoka,U.S. Senate,Mark Beard,IND,30006,0,2,6,8,
Atoka,U.S. House,Earl Everett,DEM,30006,5,14,23,42,02
Atoka,U.S. House,Markwayne Mullin,REP,30006,1,33,93,127,02
Atoka,U.S. House,Jon Douthitt,IND,30006,0,0,12,12,02
Atoka,State Senate,Joe Hill,DEM,30006,5,23,41,69,6
Atoka,State Senate,Josh Brecheen,REP,30006,1,25,81,107,6
Atoka,State Senate,Vicki Gaylor,IND,30006,0,1,8,9,6
Atoka,Governor,Joe Dorman,DEM,30007,0,23,118,141,
Atoka,Governor,Mary Fallin,REP,30007,2,21,154,177,
Atoka,Governor,Kimberly Willis,IND,30007,0,0,3,3,
Atoka,Governor,Richard Prawdzienski,IND,30007,0,0,3,3,
Atoka,Lieutenant Governor,Cathy Cummings,DEM,30007,0,14,104,118,
Atoka,Lieutenant Governor,Todd Lamb,REP,30007,2,30,174,206,
Atoka,Superintendent of Public Instruction,John Cox,DEM,30007,0,21,166,187,
Atoka,Superintendent of Public Instruction,Joy Hofmeister,REP,30007,2,23,115,140,
Atoka,Commissioner of Labor,Mike Workman,DEM,30007,0,15,114,129,
Atoka,Commissioner of Labor,Mark Costello,REP,30007,2,29,161,192,
Atoka,U.S. Senate,Matt Silverstein,DEM,30007,0,7,71,78,
Atoka,U.S. Senate,Jim Inhofe,REP,30007,2,36,198,236,
Atoka,U.S. Senate,Aaron Delozier,IND,30007,0,0,3,3,
Atoka,U.S. Senate,Ray Woods,IND,30007,0,1,3,4,
Atoka,U.S. Senate,Joan Farr,IND,30007,0,0,5,5,
Atoka,U.S. Senate,Connie Johnson,DEM,30007,0,11,82,93,
Atoka,U.S. Senate,James Lankford,REP,30007,2,32,176,210,
Atoka,U.S. Senate,Mark Beard,IND,30007,0,1,15,16,
Atoka,U.S. House,Earl Everett,DEM,30007,0,11,61,72,02
Atoka,U.S. House,Markwayne Mullin,REP,30007,2,33,209,244,02
Atoka,U.S. House,Jon Douthitt,IND,30007,0,0,7,7,02
Atoka,State Senate,Joe Hill,DEM,30007,0,13,112,125,6
Atoka,State Senate,Josh Brecheen,REP,30007,2,31,164,197,6
Atoka,State Senate,Vicki Gaylor,IND,30007,0,0,7,7,6
Atoka,Governor,Joe Dorman,DEM,30008,8,6,179,193,
Atoka,Governor,Mary Fallin,REP,30008,8,17,226,251,
Atoka,Governor,Kimberly Willis,IND,30008,0,0,7,7,
Atoka,Governor,Richard Prawdzienski,IND,30008,0,1,7,8,
Atoka,Lieutenant Governor,Cathy Cummings,DEM,30008,6,6,158,170,
Atoka,Lieutenant Governor,Todd Lamb,REP,30008,9,18,261,288,
Atoka,Superintendent of Public Instruction,John Cox,DEM,30008,8,7,251,266,
Atoka,Superintendent of Public Instruction,Joy Hofmeister,REP,30008,8,17,166,191,
Atoka,Commissioner of Labor,Mike Workman,DEM,30008,5,8,194,207,
Atoka,Commissioner of Labor,Mark Costello,REP,30008,11,16,218,245,
Atoka,U.S. Senate,Matt Silverstein,DEM,30008,5,4,119,128,
Atoka,U.S. Senate,Jim Inhofe,REP,30008,10,19,288,317,
Atoka,U.S. Senate,Aaron Delozier,IND,30008,1,0,5,6,
Atoka,U.S. Senate,Ray Woods,IND,30008,0,0,3,3,
Atoka,U.S. Senate,Joan Farr,IND,30008,0,1,2,3,
Atoka,U.S. Senate,Connie Johnson,DEM,30008,6,5,127,138,
Atoka,U.S. Senate,James Lankford,REP,30008,10,19,258,287,
Atoka,U.S. Senate,Mark Beard,IND,30008,0,0,25,25,
Atoka,U.S. House,Earl Everett,DEM,30008,6,4,113,123,02
Atoka,U.S. House,Markwayne Mullin,REP,30008,8,20,294,322,02
Atoka,U.S. House,Jon Douthitt,IND,30008,2,0,13,15,02
Atoka,State Senate,Joe Hill,DEM,30008,10,5,206,221,6
Atoka,State Senate,Josh Brecheen,REP,30008,8,19,216,243,6
Atoka,State Senate,Vicki Gaylor,IND,30008,0,0,5,5,6
Atoka,Governor,Joe Dorman,DEM,30009,3,39,100,142,
Atoka,Governor,Mary Fallin,REP,30009,3,30,111,144,
Atoka,Governor,Kimberly Willis,IND,30009,0,2,4,6,
Atoka,Governor,Richard Prawdzienski,IND,30009,0,0,0,0,
Atoka,Lieutenant Governor,Cathy Cummings,DEM,30009,3,28,87,118,
Atoka,Lieutenant Governor,Todd Lamb,REP,30009,3,42,125,170,
Atoka,Superintendent of Public Instruction,John Cox,DEM,30009,3,51,128,182,
Atoka,Superintendent of Public Instruction,Joy Hofmeister,REP,30009,3,20,84,107,
Atoka,Commissioner of Labor,Mike Workman,DEM,30009,4,36,100,140,
Atoka,Commissioner of Labor,Mark Costello,REP,30009,2,31,112,145,
Atoka,U.S. Senate,Matt Silverstein,DEM,30009,3,26,72,101,
Atoka,U.S. Senate,Jim Inhofe,REP,30009,3,43,142,188,
Atoka,U.S. Senate,Aaron Delozier,IND,30009,0,0,0,0,
Atoka,U.S. Senate,Ray Woods,IND,30009,0,0,1,1,
Atoka,U.S. Senate,Joan Farr,IND,30009,0,1,1,2,
Atoka,U.S. Senate,Connie Johnson,DEM,30009,2,27,77,106,
Atoka,U.S. Senate,James Lankford,REP,30009,4,40,132,176,
Atoka,U.S. Senate,Mark Beard,IND,30009,0,1,4,5,
Atoka,U.S. House,Earl Everett,DEM,30009,2,20,62,84,02
Atoka,U.S. House,Markwayne Mullin,REP,30009,4,47,147,198,02
Atoka,U.S. House,Jon Douthitt,IND,30009,0,2,5,7,02
Atoka,State Senate,Joe Hill,DEM,30009,3,35,90,128,6
Atoka,State Senate,Josh Brecheen,REP,30009,3,35,126,164,6
Atoka,State Senate,Vicki Gaylor,IND,30009,0,1,1,2,6
Atoka,Governor,Joe Dorman,DEM,30010,2,1,53,56,
Atoka,Governor,Mary Fallin,REP,30010,0,2,50,52,
Atoka,Governor,Kimberly Willis,IND,30010,0,0,6,6,
Atoka,Governor,Richard Prawdzienski,IND,30010,0,0,1,1,
Atoka,Lieutenant Governor,Cathy Cummings,DEM,30010,2,0,31,33,
Atoka,Lieutenant Governor,Todd Lamb,REP,30010,0,3,77,80,
Atoka,Superintendent of Public Instruction,John Cox,DEM,30010,2,1,70,73,
Atoka,Superintendent of Public Instruction,Joy Hofmeister,REP,30010,0,2,41,43,
Atoka,Commissioner of Labor,Mike Workman,DEM,30010,2,1,51,54,
Atoka,Commissioner of Labor,Mark Costello,REP,30010,0,2,55,57,
Atoka,U.S. Senate,Matt Silverstein,DEM,30010,2,0,23,25,
Atoka,U.S. Senate,Jim Inhofe,REP,30010,0,3,85,88,
Atoka,U.S. Senate,Aaron Delozier,IND,30010,0,0,1,1,
Atoka,U.S. Senate,Ray Woods,IND,30010,0,0,2,2,
Atoka,U.S. Senate,Joan Farr,IND,30010,0,0,0,0,
Atoka,U.S. Senate,Connie Johnson,DEM,30010,2,0,22,24,
Atoka,U.S. Senate,James Lankford,REP,30010,0,2,86,88,
Atoka,U.S. Senate,Mark Beard,IND,30010,0,1,3,4,
Atoka,U.S. House,Earl Everett,DEM,30010,2,0,22,24,02
Atoka,U.S. House,Markwayne Mullin,REP,30010,0,3,88,91,02
Atoka,U.S. House,Jon Douthitt,IND,30010,0,0,1,1,02
Atoka,State Senate,Curtis Mcdaniel,DEM,30010,2,0,54,56,5
Atoka,State Senate,Joseph Silk,REP,30010,0,3,56,59,5
Atoka,Governor,Joe Dorman,DEM,30011,6,64,217,287,
Atoka,Governor,Mary Fallin,REP,30011,9,68,215,292,
Atoka,Governor,Kimberly Willis,IND,30011,0,3,16,19,
Atoka,Governor,Richard Prawdzienski,IND,30011,0,0,7,7,
Atoka,Lieutenant Governor,Cathy Cummings,DEM,30011,4,49,173,226,
Atoka,Lieutenant Governor,Todd Lamb,REP,30011,9,80,272,361,
Atoka,Superintendent of Public Instruction,John Cox,DEM,30011,8,82,265,355,
Atoka,Superintendent of Public Instruction,Joy Hofmeister,REP,30011,6,50,182,238,
Atoka,Commissioner of Labor,Mike Workman,DEM,30011,3,55,207,265,
Atoka,Commissioner of Labor,Mark Costello,REP,30011,10,69,232,311,
Atoka,U.S. Senate,Matt Silverstein,DEM,30011,3,39,110,152,
Atoka,U.S. Senate,Jim Inhofe,REP,30011,10,89,324,423,
Atoka,U.S. Senate,Aaron Delozier,IND,30011,0,1,4,5,
Atoka,U.S. Senate,Ray Woods,IND,30011,0,1,5,6,
Atoka,U.S. Senate,Joan Farr,IND,30011,0,1,6,7,
Atoka,U.S. Senate,Connie Johnson,DEM,30011,3,44,134,181,
Atoka,U.S. Senate,James Lankford,REP,30011,9,79,280,368,
Atoka,U.S. Senate,Mark Beard,IND,30011,0,5,24,29,
Atoka,U.S. House,Earl Everett,DEM,30011,2,33,99,134,02
Atoka,U.S. House,Markwayne Mullin,REP,30011,11,99,332,442,02
Atoka,U.S. House,Jon Douthitt,IND,30011,0,1,17,18,02
Atoka,State Senate,Joe Hill,DEM,30011,7,53,184,244,6
Atoka,State Senate,Josh Brecheen,REP,30011,8,82,261,351,6
Atoka,State Senate,Vicki Gaylor,IND,30011,0,1,12,13,6
Atoka,Governor,Joe Dorman,DEM,30012,0,3,81,84,
Atoka,Governor,Mary Fallin,REP,30012,0,8,115,123,
Atoka,Governor,Kimberly Willis,IND,30012,0,1,6,7,
Atoka,Governor,Richard Prawdzienski,IND,30012,0,0,3,3,
Atoka,Lieutenant Governor,Cathy Cummings,DEM,30012,0,3,52,55,
Atoka,Lieutenant Governor,Todd Lamb,REP,30012,0,9,150,159,
Atoka,Superintendent of Public Instruction,John Cox,DEM,30012,0,6,115,121,
Atoka,Superintendent of Public Instruction,Joy Hofmeister,REP,30012,0,6,89,95,
Atoka,Commissioner of Labor,Mike Workman,DEM,30012,0,5,68,73,
Atoka,Commissioner of Labor,Mark Costello,REP,30012,0,6,127,133,
Atoka,U.S. Senate,Matt Silverstein,DEM,30012,0,1,43,44,
Atoka,U.S. Senate,Jim Inhofe,REP,30012,0,10,156,166,
Atoka,U.S. Senate,Aaron Delozier,IND,30012,0,0,2,2,
Atoka,U.S. Senate,Ray Woods,IND,30012,0,0,2,2,
Atoka,U.S. Senate,Joan Farr,IND,30012,0,1,4,5,
Atoka,U.S. Senate,Connie Johnson,DEM,30012,0,2,48,50,
Atoka,U.S. Senate,James Lankford,REP,30012,0,9,146,155,
Atoka,U.S. Senate,Mark Beard,IND,30012,0,1,9,10,
Atoka,U.S. House,Earl Everett,DEM,30012,0,2,31,33,02
Atoka,U.S. House,Markwayne Mullin,REP,30012,0,10,168,178,02
Atoka,U.S. House,Jon Douthitt,IND,30012,0,0,5,5,02
Atoka,State Senate,Curtis Mcdaniel,DEM,30012,0,6,82,88,5
Atoka,State Senate,Joseph Silk,REP,30012,0,6,124,130,5
Atoka,Governor,Joe Dorman,DEM,30013,0,7,93,100,
Atoka,Governor,Mary Fallin,REP,30013,3,3,98,104,
Atoka,Governor,Kimberly Willis,IND,30013,0,0,8,8,
Atoka,Governor,Richard Prawdzienski,IND,30013,0,0,3,3,
Atoka,Lieutenant Governor,Cathy Cummings,DEM,30013,0,6,67,73,
Atoka,Lieutenant Governor,Todd Lamb,REP,30013,3,4,134,141,
Atoka,Superintendent of Public Instruction,John Cox,DEM,30013,2,7,125,134,
Atoka,Superintendent of Public Instruction,Joy Hofmeister,REP,30013,1,3,78,82,
Atoka,Commissioner of Labor,Mike Workman,DEM,30013,0,5,89,94,
Atoka,Commissioner of Labor,Mark Costello,REP,30013,2,5,110,117,
Atoka,U.S. Senate,Matt Silverstein,DEM,30013,0,4,41,45,
Atoka,U.S. Senate,Jim Inhofe,REP,30013,3,6,151,160,
Atoka,U.S. Senate,Aaron Delozier,IND,30013,0,0,0,0,
Atoka,U.S. Senate,Ray Woods,IND,30013,0,0,4,4,
Atoka,U.S. Senate,Joan Farr,IND,30013,0,0,4,4,
Atoka,U.S. Senate,Connie Johnson,DEM,30013,0,4,56,60,
Atoka,U.S. Senate,James Lankford,REP,30013,3,6,132,141,
Atoka,U.S. Senate,Mark Beard,IND,30013,0,0,12,12,
Atoka,U.S. House,Earl Everett,DEM,30013,0,3,37,40,02
Atoka,U.S. House,Markwayne Mullin,REP,30013,3,7,153,163,02
Atoka,U.S. House,Jon Douthitt,IND,30013,0,0,10,10,02
Atoka,State Senate,Curtis Mcdaniel,DEM,30013,0,5,102,107,5
Atoka,State Senate,Joseph Silk,REP,30013,3,5,99,107,5
Atoka,Governor,Joe Dorman,DEM,30014,2,3,31,36,
Atoka,Governor,Mary Fallin,REP,30014,2,0,46,48,
Atoka,Governor,Kimberly Willis,IND,30014,0,0,0,0,
Atoka,Governor,Richard Prawdzienski,IND,30014,0,0,1,1,
Atoka,Lieutenant Governor,Cathy Cummings,DEM,30014,2,2,17,21,
Atoka,Lieutenant Governor,Todd Lamb,REP,30014,2,1,60,63,
Atoka,Superintendent of Public Instruction,John Cox,DEM,30014,2,3,52,57,
Atoka,Superintendent of Public Instruction,Joy Hofmeister,REP,30014,2,0,25,27,
Atoka,Commissioner of Labor,Mike Workman,DEM,30014,2,2,31,35,
Atoka,Commissioner of Labor,Mark Costello,REP,30014,2,1,42,45,
Atoka,U.S. Senate,Matt Silverstein,DEM,30014,2,2,11,15,
Atoka,U.S. Senate,Jim Inhofe,REP,30014,2,1,64,67,
Atoka,U.S. Senate,Aaron Delozier,IND,30014,0,0,1,1,
Atoka,U.S. Senate,Ray Woods,IND,30014,0,0,1,1,
Atoka,U.S. Senate,Joan Farr,IND,30014,0,0,0,0,
Atoka,U.S. Senate,Connie Johnson,DEM,30014,2,2,14,18,
Atoka,U.S. Senate,James Lankford,REP,30014,2,1,56,59,
Atoka,U.S. Senate,Mark Beard,IND,30014,0,0,4,4,
Atoka,U.S. House,Earl Everett,DEM,30014,2,2,12,16,02
Atoka,U.S. House,Markwayne Mullin,REP,30014,2,1,63,66,02
Atoka,U.S. House,Jon Douthitt,IND,30014,0,0,0,0,02
Atoka,State Senate,Curtis Mcdaniel,DEM,30014,2,2,29,33,5
Atoka,State Senate,Joseph Silk,REP,30014,2,1,44,47,5
Atoka,Governor,Joe Dorman,DEM,30015,0,4,20,24,
Atoka,Governor,Mary Fallin,REP,30015,1,2,25,28,
Atoka,Governor,Kimberly Willis,IND,30015,0,1,1,2,
Atoka,Governor,Richard Prawdzienski,IND,30015,0,0,0,0,
Atoka,Lieutenant Governor,Cathy Cummings,DEM,30015,0,3,23,26,
Atoka,Lieutenant Governor,Todd Lamb,REP,30015,1,4,23,28,
Atoka,Superintendent of Public Instruction,John Cox,DEM,30015,0,4,26,30,
Atoka,Superintendent of Public Instruction,Joy Hofmeister,REP,30015,0,3,19,22,
Atoka,Commissioner of Labor,Mike Workman,DEM,30015,0,3,27,30,
Atoka,Commissioner of Labor,Mark Costello,REP,30015,1,4,19,24,
Atoka,U.S. Senate,Matt Silverstein,DEM,30015,0,3,19,22,
Atoka,U.S. Senate,Jim Inhofe,REP,30015,1,4,28,33,
Atoka,U.S. Senate,Aaron Delozier,IND,30015,0,0,0,0,
Atoka,U.S. Senate,Ray Woods,IND,30015,0,0,0,0,
Atoka,U.S. Senate,Joan Farr,IND,30015,0,0,0,0,
Atoka,U.S. Senate,Connie Johnson,DEM,30015,0,1,20,21,
Atoka,U.S. Senate,James Lankford,REP,30015,1,4,26,31,
Atoka,U.S. Senate,Mark Beard,IND,30015,0,2,1,3,
Atoka,U.S. House,Earl Everett,DEM,30015,0,2,19,21,02
Atoka,U.S. House,Markwayne Mullin,REP,30015,1,5,28,34,02
Atoka,U.S. House,Jon Douthitt,IND,30015,0,0,0,0,02
Atoka,State Senate,Curtis Mcdaniel,DEM,30015,0,3,26,29,5
Atoka,State Senate,Joseph Silk,REP,30015,1,4,20,25,5
Atoka,Governor,Joe Dorman,DEM,30016,0,0,0,0,
Atoka,Governor,Mary Fallin,REP,30016,0,0,0,0,
Atoka,Governor,Kimberly Willis,IND,30016,0,0,0,0,
Atoka,Governor,Richard Prawdzienski,IND,30016,0,0,0,0,
Atoka,Lieutenant Governor,Cathy Cummings,DEM,30016,0,0,0,0,
Atoka,Lieutenant Governor,Todd Lamb,REP,30016,0,0,0,0,
Atoka,Superintendent of Public Instruction,John Cox,DEM,30016,0,0,0,0,
Atoka,Superintendent of Public Instruction,Joy Hofmeister,REP,30016,0,0,0,0,
Atoka,Commissioner of Labor,Mike Workman,DEM,30016,0,0,0,0,
Atoka,Commissioner of Labor,Mark Costello,REP,30016,0,0,0,0,
Atoka,U.S. Senate,Matt Silverstein,DEM,30016,0,0,0,0,
Atoka,U.S. Senate,Jim Inhofe,REP,30016,0,0,0,0,
Atoka,U.S. Senate,Aaron Delozier,IND,30016,0,0,0,0,
Atoka,U.S. Senate,Ray Woods,IND,30016,0,0,0,0,
Atoka,U.S. Senate,Joan Farr,IND,30016,0,0,0,0,
Atoka,U.S. Senate,Connie Johnson,DEM,30016,0,0,0,0,
Atoka,U.S. Senate,James Lankford,REP,30016,0,0,0,0,
Atoka,U.S. Senate,Mark Beard,IND,30016,0,0,0,0,
Atoka,U.S. House,Earl Everett,DEM,30016,0,0,0,0,02
Atoka,U.S. House,Markwayne Mullin,REP,30016,0,0,0,0,02
Atoka,U.S. House,Jon Douthitt,IND,30016,0,0,0,0,02
Atoka,State Senate,Joe Hill,DEM,30016,0,0,0,0,6
Atoka,State Senate,Josh Brecheen,REP,30016,0,0,0,0,6
Atoka,State Senate,Vicki Gaylor,IND,30016,0,0,0,0,6
Atoka,Governor,Joe Dorman,DEM,30017,0,0,0,0,
Atoka,Governor,Mary Fallin,REP,30017,0,0,0,0,
Atoka,Governor,Kimberly Willis,IND,30017,0,0,0,0,
Atoka,Governor,Richard Prawdzienski,IND,30017,0,0,0,0,
Atoka,Lieutenant Governor,Cathy Cummings,DEM,30017,0,0,0,0,
Atoka,Lieutenant Governor,Todd Lamb,REP,30017,0,0,0,0,
Atoka,Superintendent of Public Instruction,John Cox,DEM,30017,0,0,0,0,
Atoka,Superintendent of Public Instruction,Joy Hofmeister,REP,30017,0,0,0,0,
Atoka,Commissioner of Labor,Mike Workman,DEM,30017,0,0,0,0,
Atoka,Commissioner of Labor,Mark Costello,REP,30017,0,0,0,0,
Atoka,U.S. Senate,Matt Silverstein,DEM,30017,0,0,0,0,
Atoka,U.S. Senate,Jim Inhofe,REP,30017,0,0,0,0,
Atoka,U.S. Senate,Aaron Delozier,IND,30017,0,0,0,0,
Atoka,U.S. Senate,Ray Woods,IND,30017,0,0,0,0,
Atoka,U.S. Senate,Joan Farr,IND,30017,0,0,0,0,
Atoka,U.S. Senate,Connie Johnson,DEM,30017,0,0,0,0,
Atoka,U.S. Senate,James Lankford,REP,30017,0,0,0,0,
Atoka,U.S. Senate,Mark Beard,IND,30017,0,0,0,0,
Atoka,U.S. House,Earl Everett,DEM,30017,0,0,0,0,02
Atoka,U.S. House,Markwayne Mullin,REP,30017,0,0,0,0,02
Atoka,U.S. House,Jon Douthitt,IND,30017,0,0,0,0,02
Atoka,State Senate,Joe Hill,DEM,30017,0,0,0,0,6
Atoka,State Senate,Josh Brecheen,REP,30017,0,0,0,0,6
Atoka,State Senate,Vicki Gaylor,IND,30017,0,0,0,0,6
Atoka,Governor,Joe Dorman,DEM,30018,0,0,0,0,
Atoka,Governor,Mary Fallin,REP,30018,0,0,0,0,
Atoka,Governor,Kimberly Willis,IND,30018,0,0,0,0,
Atoka,Governor,Richard Prawdzienski,IND,30018,0,0,0,0,
Atoka,Lieutenant Governor,Cathy Cummings,DEM,30018,0,0,0,0,
Atoka,Lieutenant Governor,Todd Lamb,REP,30018,0,0,0,0,
Atoka,Superintendent of Public Instruction,John Cox,DEM,30018,0,0,0,0,
Atoka,Superintendent of Public Instruction,Joy Hofmeister,REP,30018,0,0,0,0,
Atoka,Commissioner of Labor,Mike Workman,DEM,30018,0,0,0,0,
Atoka,Commissioner of Labor,Mark Costello,REP,30018,0,0,0,0,
Atoka,U.S. Senate,Matt Silverstein,DEM,30018,0,0,0,0,
Atoka,U.S. Senate,Jim Inhofe,REP,30018,0,0,0,0,
Atoka,U.S. Senate,Aaron Delozier,IND,30018,0,0,0,0,
Atoka,U.S. Senate,Ray Woods,IND,30018,0,0,0,0,
Atoka,U.S. Senate,Joan Farr,IND,30018,0,0,0,0,
Atoka,U.S. Senate,Connie Johnson,DEM,30018,0,0,0,0,
Atoka,U.S. Senate,James Lankford,REP,30018,0,0,0,0,
Atoka,U.S. Senate,Mark Beard,IND,30018,0,0,0,0,
Atoka,U.S. House,Earl Everett,DEM,30018,0,0,0,0,02
Atoka,U.S. House,Markwayne Mullin,REP,30018,0,0,0,0,02
Atoka,U.S. House,Jon Douthitt,IND,30018,0,0,0,0,02
Atoka,State Senate,Curtis Mcdaniel,DEM,30018,0,0,0,0,5
Atoka,State Senate,Joseph Silk,REP,30018,0,0,0,0,5
Atoka,Governor,Joe Dorman,DEM,30019,1,2,14,17,
Atoka,Governor,Mary Fallin,REP,30019,1,1,12,14,
Atoka,Governor,Kimberly Willis,IND,30019,0,1,0,1,
Atoka,Governor,Richard Prawdzienski,IND,30019,0,0,1,1,
Atoka,Lieutenant Governor,Cathy Cummings,DEM,30019,0,2,14,16,
Atoka,Lieutenant Governor,Todd Lamb,REP,30019,2,2,12,16,
Atoka,Superintendent of Public Instruction,John Cox,DEM,30019,0,3,15,18,
Atoka,Superintendent of Public Instruction,Joy Hofmeister,REP,30019,2,1,12,15,
Atoka,Commissioner of Labor,Mike Workman,DEM,30019,0,2,12,14,
Atoka,Commissioner of Labor,Mark Costello,REP,30019,2,2,15,19,
Atoka,U.S. Senate,Matt Silverstein,DEM,30019,0,2,10,12,
Atoka,U.S. Senate,Jim Inhofe,REP,30019,2,2,14,18,
Atoka,U.S. Senate,Aaron Delozier,IND,30019,0,0,0,0,
Atoka,U.S. Senate,Ray Woods,IND,30019,0,0,0,0,
Atoka,U.S. Senate,Joan Farr,IND,30019,0,0,3,3,
Atoka,U.S. Senate,Connie Johnson,DEM,30019,0,2,10,12,
Atoka,U.S. Senate,James Lankford,REP,30019,2,2,15,19,
Atoka,U.S. Senate,Mark Beard,IND,30019,0,0,2,2,
Atoka,U.S. House,Earl Everett,DEM,30019,0,1,9,10,02
Atoka,U.S. House,Markwayne Mullin,REP,30019,2,3,16,21,02
Atoka,U.S. House,Jon Douthitt,IND,30019,0,0,2,2,02
Atoka,State Senate,Joe Hill,DEM,30019,1,0,12,13,6
Atoka,State Senate,Josh Brecheen,REP,30019,1,2,14,17,6
Atoka,State Senate,Vicki Gaylor,IND,30019,0,2,1,3,6
Beaver,Governor,Joe Dorman,DEM,40011,1,0,25,26,
Beaver,Governor,Mary Fallin,REP,40011,2,5,98,105,
Beaver,Governor,Kimberly Willis,IND,40011,0,0,1,1,
Beaver,Governor,Richard Prawdzienski,IND,40011,0,0,1,1,
Beaver,Lieutenant Governor,Cathy Cummings,DEM,40011,1,0,9,10,
Beaver,Lieutenant Governor,Todd Lamb,REP,40011,2,5,115,122,
Beaver,Superintendent of Public Instruction,John Cox,DEM,40011,2,1,32,35,
Beaver,Superintendent of Public Instruction,Joy Hofmeister,REP,40011,1,4,92,97,
Beaver,Commissioner of Labor,Mike Workman,DEM,40011,1,0,15,16,
Beaver,Commissioner of Labor,Mark Costello,REP,40011,2,5,105,112,
Beaver,U.S. Senate,Matt Silverstein,DEM,40011,1,0,9,10,
Beaver,U.S. Senate,Jim Inhofe,REP,40011,2,5,115,122,
Beaver,U.S. Senate,Aaron Delozier,IND,40011,0,0,1,1,
Beaver,U.S. Senate,Ray Woods,IND,40011,0,0,0,0,
Beaver,U.S. Senate,Joan Farr,IND,40011,0,0,0,0,
Beaver,U.S. Senate,Connie Johnson,DEM,40011,1,0,6,7,
Beaver,U.S. Senate,James Lankford,REP,40011,2,5,115,122,
Beaver,U.S. Senate,Mark Beard,IND,40011,0,0,3,3,
Beaver,U.S. House,Frankie Robbins,DEM,40011,0,0,9,9,03
Beaver,U.S. House,Frank Lucas,REP,40011,3,5,116,124,03
Beaver,Governor,Joe Dorman,DEM,40013,0,0,12,12,
Beaver,Governor,Mary Fallin,REP,40013,5,3,64,72,
Beaver,Governor,Kimberly Willis,IND,40013,0,0,0,0,
Beaver,Governor,Richard Prawdzienski,IND,40013,0,0,3,3,
Beaver,Lieutenant Governor,Cathy Cummings,DEM,40013,0,0,5,5,
Beaver,Lieutenant Governor,Todd Lamb,REP,40013,5,3,74,82,
Beaver,Superintendent of Public Instruction,John Cox,DEM,40013,3,1,22,26,
Beaver,Superintendent of Public Instruction,Joy Hofmeister,REP,40013,2,2,56,60,
Beaver,Commissioner of Labor,Mike Workman,DEM,40013,0,1,13,14,
Beaver,Commissioner of Labor,Mark Costello,REP,40013,4,1,64,69,
Beaver,U.S. Senate,Matt Silverstein,DEM,40013,0,0,3,3,
Beaver,U.S. Senate,Jim Inhofe,REP,40013,5,3,74,82,
Beaver,U.S. Senate,Aaron Delozier,IND,40013,0,0,1,1,
Beaver,U.S. Senate,Ray Woods,IND,40013,0,0,1,1,
Beaver,U.S. Senate,Joan Farr,IND,40013,0,0,0,0,
Beaver,U.S. Senate,Connie Johnson,DEM,40013,0,0,3,3,
Beaver,U.S. Senate,James Lankford,REP,40013,5,3,75,83,
Beaver,U.S. Senate,Mark Beard,IND,40013,0,0,1,1,
Beaver,U.S. House,Frankie Robbins,DEM,40013,0,0,4,4,03
Beaver,U.S. House,Frank Lucas,REP,40013,5,3,75,83,03
Beaver,Governor,Joe Dorman,DEM,40023,1,20,128,149,
Beaver,Governor,Mary Fallin,REP,40023,18,54,312,384,
Beaver,Governor,Kimberly Willis,IND,40023,0,0,14,14,
Beaver,Governor,Richard Prawdzienski,IND,40023,1,0,9,10,
Beaver,Lieutenant Governor,Cathy Cummings,DEM,40023,0,8,47,55,
Beaver,Lieutenant Governor,Todd Lamb,REP,40023,20,66,409,495,
Beaver,Superintendent of Public Instruction,John Cox,DEM,40023,7,25,166,198,
Beaver,Superintendent of Public Instruction,Joy Hofmeister,REP,40023,13,49,290,352,
Beaver,Commissioner of Labor,Mike Workman,DEM,40023,4,11,79,94,
Beaver,Commissioner of Labor,Mark Costello,REP,40023,16,60,374,450,
Beaver,U.S. Senate,Matt Silverstein,DEM,40023,1,9,41,51,
Beaver,U.S. Senate,Jim Inhofe,REP,40023,18,65,401,484,
Beaver,U.S. Senate,Aaron Delozier,IND,40023,0,0,1,1,
Beaver,U.S. Senate,Ray Woods,IND,40023,1,0,10,11,
Beaver,U.S. Senate,Joan Farr,IND,40023,0,0,7,7,
Beaver,U.S. Senate,Connie Johnson,DEM,40023,1,8,43,52,
Beaver,U.S. Senate,James Lankford,REP,40023,18,66,393,477,
Beaver,U.S. Senate,Mark Beard,IND,40023,1,0,21,22,
Beaver,U.S. House,Frankie Robbins,DEM,40023,1,7,48,56,03
Beaver,U.S. House,Frank Lucas,REP,40023,19,66,412,497,03
Beaver,Governor,Joe Dorman,DEM,40025,0,0,36,36,
Beaver,Governor,Mary Fallin,REP,40025,4,2,83,89,
Beaver,Governor,Kimberly Willis,IND,40025,0,0,3,3,
Beaver,Governor,Richard Prawdzienski,IND,40025,0,0,2,2,
Beaver,Lieutenant Governor,Cathy Cummings,DEM,40025,0,0,22,22,
Beaver,Lieutenant Governor,Todd Lamb,REP,40025,4,2,103,109,
Beaver,Superintendent of Public Instruction,John Cox,DEM,40025,0,0,51,51,
Beaver,Superintendent of Public Instruction,Joy Hofmeister,REP,40025,4,2,69,75,
Beaver,Commissioner of Labor,Mike Workman,DEM,40025,0,0,25,25,
Beaver,Commissioner of Labor,Mark Costello,REP,40025,4,2,93,99,
Beaver,U.S. Senate,Matt Silverstein,DEM,40025,0,0,19,19,
Beaver,U.S. Senate,Jim Inhofe,REP,40025,4,2,99,105,
Beaver,U.S. Senate,Aaron Delozier,IND,40025,0,0,2,2,
Beaver,U.S. Senate,Ray Woods,IND,40025,0,0,2,2,
Beaver,U.S. Senate,Joan Farr,IND,40025,0,0,4,4,
Beaver,U.S. Senate,Connie Johnson,DEM,40025,0,0,20,20,
Beaver,U.S. Senate,James Lankford,REP,40025,4,2,97,103,
Beaver,U.S. Senate,Mark Beard,IND,40025,0,0,7,7,
Beaver,U.S. House,Frankie Robbins,DEM,40025,0,0,19,19,03
Beaver,U.S. House,Frank Lucas,REP,40025,4,2,106,112,03
Beaver,Governor,Joe Dorman,DEM,40026,1,1,8,10,
Beaver,Governor,Mary Fallin,REP,40026,0,1,25,26,
Beaver,Governor,Kimberly Willis,IND,40026,0,1,1,2,
Beaver,Governor,Richard Prawdzienski,IND,40026,0,0,0,0,
Beaver,Lieutenant Governor,Cathy Cummings,DEM,40026,1,1,3,5,
Beaver,Lieutenant Governor,Todd Lamb,REP,40026,0,2,31,33,
Beaver,Superintendent of Public Instruction,John Cox,DEM,40026,1,0,16,17,
Beaver,Superintendent of Public Instruction,Joy Hofmeister,REP,40026,0,2,17,19,
Beaver,Commissioner of Labor,Mike Workman,DEM,40026,1,0,3,4,
Beaver,Commissioner of Labor,Mark Costello,REP,40026,0,3,30,33,
Beaver,U.S. Senate,Matt Silverstein,DEM,40026,1,1,1,3,
Beaver,U.S. Senate,Jim Inhofe,REP,40026,0,2,29,31,
Beaver,U.S. Senate,Aaron Delozier,IND,40026,0,0,1,1,
Beaver,U.S. Senate,Ray Woods,IND,40026,0,0,3,3,
Beaver,U.S. Senate,Joan Farr,IND,40026,0,0,0,0,
Beaver,U.S. Senate,Connie Johnson,DEM,40026,1,1,1,3,
Beaver,U.S. Senate,James Lankford,REP,40026,0,2,29,31,
Beaver,U.S. Senate,Mark Beard,IND,40026,0,0,4,4,
Beaver,U.S. House,Frankie Robbins,DEM,40026,1,1,1,3,03
Beaver,U.S. House,Frank Lucas,REP,40026,0,2,33,35,03
Beaver,Governor,Joe Dorman,DEM,40031,0,3,29,32,
Beaver,Governor,Mary Fallin,REP,40031,4,7,112,123,
Beaver,Governor,Kimberly Willis,IND,40031,0,0,7,7,
Beaver,Governor,Richard Prawdzienski,IND,40031,0,1,4,5,
Beaver,Lieutenant Governor,Cathy Cummings,DEM,40031,0,1,11,12,
Beaver,Lieutenant Governor,Todd Lamb,REP,40031,4,10,138,152,
Beaver,Superintendent of Public Instruction,John Cox,DEM,40031,0,5,54,59,
Beaver,Superintendent of Public Instruction,Joy Hofmeister,REP,40031,4,6,96,106,
Beaver,Commissioner of Labor,Mike Workman,DEM,40031,1,2,17,20,
Beaver,Commissioner of Labor,Mark Costello,REP,40031,3,9,129,141,
Beaver,U.S. Senate,Matt Silverstein,DEM,40031,0,2,8,10,
Beaver,U.S. Senate,Jim Inhofe,REP,40031,4,8,132,144,
Beaver,U.S. Senate,Aaron Delozier,IND,40031,0,0,4,4,
Beaver,U.S. Senate,Ray Woods,IND,40031,0,1,6,7,
Beaver,U.S. Senate,Joan Farr,IND,40031,0,0,1,1,
Beaver,U.S. Senate,Connie Johnson,DEM,40031,0,1,9,10,
Beaver,U.S. Senate,James Lankford,REP,40031,4,9,126,139,
Beaver,U.S. Senate,Mark Beard,IND,40031,0,1,15,16,
Beaver,U.S. House,Frankie Robbins,DEM,40031,0,1,18,19,03
Beaver,U.S. House,Frank Lucas,REP,40031,4,10,134,148,03
Beaver,Governor,Joe Dorman,DEM,40033,0,2,76,78,
Beaver,Governor,Mary Fallin,REP,40033,5,11,295,311,
Beaver,Governor,Kimberly Willis,IND,40033,0,0,7,7,
Beaver,Governor,Richard Prawdzienski,IND,40033,0,0,8,8,
Beaver,Lieutenant Governor,Cathy Cummings,DEM,40033,0,0,46,46,
Beaver,Lieutenant Governor,Todd Lamb,REP,40033,5,13,339,357,
Beaver,Superintendent of Public Instruction,John Cox,DEM,40033,0,4,175,179,
Beaver,Superintendent of Public Instruction,Joy Hofmeister,REP,40033,5,9,213,227,
Beaver,Commissioner of Labor,Mike Workman,DEM,40033,0,2,57,59,
Beaver,Commissioner of Labor,Mark Costello,REP,40033,5,11,323,339,
Beaver,U.S. Senate,Matt Silverstein,DEM,40033,0,1,30,31,
Beaver,U.S. Senate,Jim Inhofe,REP,40033,5,12,325,342,
Beaver,U.S. Senate,Aaron Delozier,IND,40033,0,0,10,10,
Beaver,U.S. Senate,Ray Woods,IND,40033,0,0,10,10,
Beaver,U.S. Senate,Joan Farr,IND,40033,0,0,9,9,
Beaver,U.S. Senate,Connie Johnson,DEM,40033,0,0,28,28,
Beaver,U.S. Senate,James Lankford,REP,40033,5,11,341,357,
Beaver,U.S. Senate,Mark Beard,IND,40033,0,2,18,20,
Beaver,U.S. House,Frankie Robbins,DEM,40033,0,0,37,37,03
Beaver,U.S. House,Frank Lucas,REP,40033,5,13,350,368,03
Beckham,Governor,Joe Dorman,DEM,50111,6,38,165,209,
Beckham,Governor,Mary Fallin,REP,50111,8,23,220,251,
Beckham,Governor,Kimberly Willis,IND,50111,0,1,11,12,
Beckham,Governor,Richard Prawdzienski,IND,50111,0,0,5,5,
Beckham,Lieutenant Governor,Cathy Cummings,DEM,50111,5,23,97,125,
Beckham,Lieutenant Governor,Todd Lamb,REP,50111,9,39,302,350,
Beckham,Superintendent of Public Instruction,John Cox,DEM,50111,5,41,186,232,
Beckham,Superintendent of Public Instruction,Joy Hofmeister,REP,50111,9,21,211,241,
Beckham,Commissioner of Labor,Mike Workman,DEM,50111,6,28,150,184,
Beckham,Commissioner of Labor,Mark Costello,REP,50111,7,33,230,270,
Beckham,U.S. Senate,Matt Silverstein,DEM,50111,4,22,87,113,
Beckham,U.S. Senate,Jim Inhofe,REP,50111,10,40,297,347,
Beckham,U.S. Senate,Aaron Delozier,IND,50111,0,0,3,3,
Beckham,U.S. Senate,Ray Woods,IND,50111,0,0,7,7,
Beckham,U.S. Senate,Joan Farr,IND,50111,0,0,5,5,
Beckham,U.S. Senate,Connie Johnson,DEM,50111,5,20,95,120,
Beckham,U.S. Senate,James Lankford,REP,50111,8,40,294,342,
Beckham,U.S. Senate,Mark Beard,IND,50111,0,1,10,11,
Beckham,U.S. House,Frankie Robbins,DEM,50111,4,18,72,94,03
Beckham,U.S. House,Frank Lucas,REP,50111,10,42,329,381,03
Beckham,State Senate,Kevin Black,DEM,50111,9,47,263,319,26
Beckham,State Senate,Darcy Jech,REP,50111,5,15,137,157,26
Beckham,Governor,Joe Dorman,DEM,50112,3,17,79,99,
Beckham,Governor,Mary Fallin,REP,50112,6,14,121,141,
Beckham,Governor,Kimberly Willis,IND,50112,0,0,7,7,
Beckham,Governor,Richard Prawdzienski,IND,50112,0,0,0,0,
Beckham,Lieutenant Governor,Cathy Cummings,DEM,50112,3,7,56,66,
Beckham,Lieutenant Governor,Todd Lamb,REP,50112,6,24,150,180,
Beckham,Superintendent of Public Instruction,John Cox,DEM,50112,3,16,104,123,
Beckham,Superintendent of Public Instruction,Joy Hofmeister,REP,50112,5,15,101,121,
Beckham,Commissioner of Labor,Mike Workman,DEM,50112,3,10,85,98,
Beckham,Commissioner of Labor,Mark Costello,REP,50112,5,19,120,144,
Beckham,U.S. Senate,Matt Silverstein,DEM,50112,3,7,44,54,
Beckham,U.S. Senate,Jim Inhofe,REP,50112,6,23,155,184,
Beckham,U.S. Senate,Aaron Delozier,IND,50112,0,0,2,2,
Beckham,U.S. Senate,Ray Woods,IND,50112,0,0,4,4,
Beckham,U.S. Senate,Joan Farr,IND,50112,0,0,2,2,
Beckham,U.S. Senate,Connie Johnson,DEM,50112,3,4,52,59,
Beckham,U.S. Senate,James Lankford,REP,50112,4,26,150,180,
Beckham,U.S. Senate,Mark Beard,IND,50112,2,1,6,9,
Beckham,U.S. House,Frankie Robbins,DEM,50112,3,5,39,47,03
Beckham,U.S. House,Frank Lucas,REP,50112,6,26,169,201,03
Beckham,State Senate,Kevin Black,DEM,50112,4,18,121,143,26
Beckham,State Senate,Darcy Jech,REP,50112,5,13,87,105,26
Beckham,Governor,Joe Dorman,DEM,50115,1,16,23,40,
Beckham,Governor,Mary Fallin,REP,50115,2,26,30,58,
Beckham,Governor,Kimberly Willis,IND,50115,0,0,1,1,
Beckham,Governor,Richard Prawdzienski,IND,50115,0,0,2,2,
Beckham,Lieutenant Governor,Cathy Cummings,DEM,50115,0,6,13,19,
Beckham,Lieutenant Governor,Todd Lamb,REP,50115,3,36,42,81,
Beckham,Superintendent of Public Instruction,John Cox,DEM,50115,2,17,30,49,
Beckham,Superintendent of Public Instruction,Joy Hofmeister,REP,50115,1,24,25,50,
Beckham,Commissioner of Labor,Mike Workman,DEM,50115,0,14,20,34,
Beckham,Commissioner of Labor,Mark Costello,REP,50115,3,24,32,59,
Beckham,U.S. Senate,Matt Silverstein,DEM,50115,1,5,11,17,
Beckham,U.S. Senate,Jim Inhofe,REP,50115,2,35,43,80,
Beckham,U.S. Senate,Aaron Delozier,IND,50115,0,1,0,1,
Beckham,U.S. Senate,Ray Woods,IND,50115,0,0,2,2,
Beckham,U.S. Senate,Joan Farr,IND,50115,0,0,0,0,
Beckham,U.S. Senate,Connie Johnson,DEM,50115,1,3,12,16,
Beckham,U.S. Senate,James Lankford,REP,50115,2,38,41,81,
Beckham,U.S. Senate,Mark Beard,IND,50115,0,1,2,3,
Beckham,U.S. House,Frankie Robbins,DEM,50115,0,4,14,18,03
Beckham,U.S. House,Frank Lucas,REP,50115,3,38,41,82,03
Beckham,State Senate,Kevin Black,DEM,50115,3,22,28,53,26
Beckham,State Senate,Darcy Jech,REP,50115,0,19,28,47,26
Beckham,Governor,Joe Dorman,DEM,50141,5,7,146,158,
Beckham,Governor,Mary Fallin,REP,50141,9,16,298,323,
Beckham,Governor,Kimberly Willis,IND,50141,0,1,12,13,
Beckham,Governor,Richard Prawdzienski,IND,50141,0,0,7,7,
Beckham,Lieutenant Governor,Cathy Cummings,DEM,50141,3,2,89,94,
Beckham,Lieutenant Governor,Todd Lamb,REP,50141,11,22,369,402,
Beckham,Superintendent of Public Instruction,John Cox,DEM,50141,3,4,137,144,
Beckham,Superintendent of Public Instruction,Joy Hofmeister,REP,50141,11,20,324,355,
Beckham,Commissioner of Labor,Mike Workman,DEM,50141,3,5,115,123,
Beckham,Commissioner of Labor,Mark Costello,REP,50141,10,19,335,364,
Beckham,U.S. Senate,Matt Silverstein,DEM,50141,2,1,61,64,
Beckham,U.S. Senate,Jim Inhofe,REP,50141,12,23,375,410,
Beckham,U.S. Senate,Aaron Delozier,IND,50141,0,0,4,4,
Beckham,U.S. Senate,Ray Woods,IND,50141,0,0,9,9,
Beckham,U.S. Senate,Joan Farr,IND,50141,0,0,7,7,
Beckham,U.S. Senate,Connie Johnson,DEM,50141,2,2,59,63,
Beckham,U.S. Senate,James Lankford,REP,50141,12,22,387,421,
Beckham,U.S. Senate,Mark Beard,IND,50141,0,0,13,13,
Beckham,U.S. House,Frankie Robbins,DEM,50141,2,0,55,57,03
Beckham,U.S. House,Frank Lucas,REP,50141,12,24,403,439,03
Beckham,State Senate,Kevin Black,DEM,50141,8,9,261,278,26
Beckham,State Senate,Darcy Jech,REP,50141,5,15,199,219,26
Beckham,Governor,Joe Dorman,DEM,50231,4,1,78,83,
Beckham,Governor,Mary Fallin,REP,50231,5,1,135,141,
Beckham,Governor,Kimberly Willis,IND,50231,0,0,6,6,
Beckham,Governor,Richard Prawdzienski,IND,50231,0,0,1,1,
Beckham,Lieutenant Governor,Cathy Cummings,DEM,50231,3,1,37,41,
Beckham,Lieutenant Governor,Todd Lamb,REP,50231,6,1,183,190,
Beckham,Superintendent of Public Instruction,John Cox,DEM,50231,3,1,71,75,
Beckham,Superintendent of Public Instruction,Joy Hofmeister,REP,50231,6,1,146,153,
Beckham,Commissioner of Labor,Mike Workman,DEM,50231,3,1,53,57,
Beckham,Commissioner of Labor,Mark Costello,REP,50231,6,1,158,165,
Beckham,U.S. Senate,Matt Silverstein,DEM,50231,2,1,35,38,
Beckham,U.S. Senate,Jim Inhofe,REP,50231,7,1,177,185,
Beckham,U.S. Senate,Aaron Delozier,IND,50231,0,0,2,2,
Beckham,U.S. Senate,Ray Woods,IND,50231,0,0,4,4,
Beckham,U.S. Senate,Joan Farr,IND,50231,0,0,0,0,
Beckham,U.S. Senate,Connie Johnson,DEM,50231,3,1,27,31,
Beckham,U.S. Senate,James Lankford,REP,50231,6,1,186,193,
Beckham,U.S. Senate,Mark Beard,IND,50231,0,0,4,4,
Beckham,U.S. House,Frankie Robbins,DEM,50231,1,1,29,31,03
Beckham,U.S. House,Frank Lucas,REP,50231,9,1,191,201,03
Beckham,State Senate,Kevin Black,DEM,50231,4,1,135,140,26
Beckham,State Senate,Darcy Jech,REP,50231,5,1,84,90,26
Beckham,Governor,Joe Dorman,DEM,50232,0,0,29,29,
Beckham,Governor,Mary Fallin,REP,50232,2,1,37,40,
Beckham,Governor,Kimberly Willis,IND,50232,0,0,2,2,
Beckham,Governor,Richard Prawdzienski,IND,50232,0,0,0,0,
Beckham,Lieutenant Governor,Cathy Cummings,DEM,50232,0,0,15,15,
Beckham,Lieutenant Governor,Todd Lamb,REP,50232,2,1,53,56,
Beckham,Superintendent of Public Instruction,John Cox,DEM,50232,0,0,29,29,
Beckham,Superintendent of Public Instruction,Joy Hofmeister,REP,50232,2,1,39,42,
Beckham,Commissioner of Labor,Mike Workman,DEM,50232,0,0,20,20,
Beckham,Commissioner of Labor,Mark Costello,REP,50232,2,1,47,50,
Beckham,U.S. Senate,Matt Silverstein,DEM,50232,0,0,10,10,
Beckham,U.S. Senate,Jim Inhofe,REP,50232,2,1,56,59,
Beckham,U.S. Senate,Aaron Delozier,IND,50232,0,0,0,0,
Beckham,U.S. Senate,Ray Woods,IND,50232,0,0,2,2,
Beckham,U.S. Senate,Joan Farr,IND,50232,0,0,0,0,
Beckham,U.S. Senate,Connie Johnson,DEM,50232,0,0,10,10,
Beckham,U.S. Senate,James Lankford,REP,50232,2,1,56,59,
Beckham,U.S. Senate,Mark Beard,IND,50232,0,0,2,2,
Beckham,U.S. House,Frankie Robbins,DEM,50232,0,0,10,10,03
Beckham,U.S. House,Frank Lucas,REP,50232,2,1,58,61,03
Beckham,State Senate,Kevin Black,DEM,50232,1,0,48,49,26
Beckham,State Senate,Darcy Jech,REP,50232,1,1,20,22,26
Beckham,Governor,Joe Dorman,DEM,50235,9,11,320,340,
Beckham,Governor,Mary Fallin,REP,50235,23,20,516,559,
Beckham,Governor,Kimberly Willis,IND,50235,0,0,28,28,
Beckham,Governor,Richard Prawdzienski,IND,50235,0,0,10,10,
Beckham,Lieutenant Governor,Cathy Cummings,DEM,50235,5,6,195,206,
Beckham,Lieutenant Governor,Todd Lamb,REP,50235,28,25,675,728,
Beckham,Superintendent of Public Instruction,John Cox,DEM,50235,7,9,298,314,
Beckham,Superintendent of Public Instruction,Joy Hofmeister,REP,50235,26,22,571,619,
Beckham,Commissioner of Labor,Mike Workman,DEM,50235,5,10,250,265,
Beckham,Commissioner of Labor,Mark Costello,REP,50235,28,21,609,658,
Beckham,U.S. Senate,Matt Silverstein,DEM,50235,7,5,141,153,
Beckham,U.S. Senate,Jim Inhofe,REP,50235,26,25,694,745,
Beckham,U.S. Senate,Aaron Delozier,IND,50235,0,0,7,7,
Beckham,U.S. Senate,Ray Woods,IND,50235,0,0,15,15,
Beckham,U.S. Senate,Joan Farr,IND,50235,0,0,5,5,
Beckham,U.S. Senate,Connie Johnson,DEM,50235,3,7,165,175,
Beckham,U.S. Senate,James Lankford,REP,50235,28,24,684,736,
Beckham,U.S. Senate,Mark Beard,IND,50235,2,0,23,25,
Beckham,U.S. House,Frankie Robbins,DEM,50235,3,5,135,143,03
Beckham,U.S. House,Frank Lucas,REP,50235,30,25,738,793,03
Beckham,State Senate,Kevin Black,DEM,50235,18,18,547,583,26
Beckham,State Senate,Darcy Jech,REP,50235,14,13,331,358,26
Beckham,Governor,Joe Dorman,DEM,50242,1,3,79,83,
Beckham,Governor,Mary Fallin,REP,50242,1,2,94,97,
Beckham,Governor,Kimberly Willis,IND,50242,0,0,4,4,
Beckham,Governor,Richard Prawdzienski,IND,50242,0,0,0,0,
Beckham,Lieutenant Governor,Cathy Cummings,DEM,50242,1,2,47,50,
Beckham,Lieutenant Governor,Todd Lamb,REP,50242,1,3,129,133,
Beckham,Superintendent of Public Instruction,John Cox,DEM,50242,1,3,88,92,
Beckham,Superintendent of Public Instruction,Joy Hofmeister,REP,50242,1,2,86,89,
Beckham,Commissioner of Labor,Mike Workman,DEM,50242,0,1,68,69,
Beckham,Commissioner of Labor,Mark Costello,REP,50242,1,3,98,102,
Beckham,U.S. Senate,Matt Silverstein,DEM,50242,1,1,39,41,
Beckham,U.S. Senate,Jim Inhofe,REP,50242,1,4,132,137,
Beckham,U.S. Senate,Aaron Delozier,IND,50242,0,0,0,0,
Beckham,U.S. Senate,Ray Woods,IND,50242,0,0,1,1,
Beckham,U.S. Senate,Joan Farr,IND,50242,0,0,4,4,
Beckham,U.S. Senate,Connie Johnson,DEM,50242,1,1,35,37,
Beckham,U.S. Senate,James Lankford,REP,50242,1,4,136,141,
Beckham,U.S. Senate,Mark Beard,IND,50242,0,0,4,4,
Beckham,U.S. House,Frankie Robbins,DEM,50242,0,1,29,30,03
Beckham,U.S. House,Frank Lucas,REP,50242,2,4,147,153,03
Beckham,State Senate,Kevin Black,DEM,50242,1,4,100,105,26
Beckham,State Senate,Darcy Jech,REP,50242,1,1,75,77,26
Beckham,Governor,Joe Dorman,DEM,50320,1,6,120,127,
Beckham,Governor,Mary Fallin,REP,50320,6,9,160,175,
Beckham,Governor,Kimberly Willis,IND,50320,0,2,9,11,
Beckham,Governor,Richard Prawdzienski,IND,50320,0,0,5,5,
Beckham,Lieutenant Governor,Cathy Cummings,DEM,50320,2,4,85,91,
Beckham,Lieutenant Governor,Todd Lamb,REP,50320,5,12,203,220,
Beckham,Superintendent of Public Instruction,John Cox,DEM,50320,1,10,146,157,
Beckham,Superintendent of Public Instruction,Joy Hofmeister,REP,50320,6,7,148,161,
Beckham,Commissioner of Labor,Mike Workman,DEM,50320,3,6,126,135,
Beckham,Commissioner of Labor,Mark Costello,REP,50320,4,10,157,171,
Beckham,U.S. Senate,Matt Silverstein,DEM,50320,1,4,71,76,
Beckham,U.S. Senate,Jim Inhofe,REP,50320,5,12,210,227,
Beckham,U.S. Senate,Aaron Delozier,IND,50320,1,0,2,3,
Beckham,U.S. Senate,Ray Woods,IND,50320,0,0,7,7,
Beckham,U.S. Senate,Joan Farr,IND,50320,0,1,2,3,
Beckham,U.S. Senate,Connie Johnson,DEM,50320,1,3,74,78,
Beckham,U.S. Senate,James Lankford,REP,50320,5,14,211,230,
Beckham,U.S. Senate,Mark Beard,IND,50320,1,0,5,6,
Beckham,U.S. House,Frankie Robbins,DEM,50320,1,2,70,73,03
Beckham,U.S. House,Frank Lucas,REP,50320,6,14,222,242,03
Beckham,State Senate,Kevin Black,DEM,50320,3,12,182,197,26
Beckham,State Senate,Darcy Jech,REP,50320,4,5,113,122,26
Beckham,Governor,Joe Dorman,DEM,50330,3,3,58,64,
Beckham,Governor,Mary Fallin,REP,50330,0,10,145,155,
Beckham,Governor,Kimberly Willis,IND,50330,0,0,4,4,
Beckham,Governor,Richard Prawdzienski,IND,50330,0,0,3,3,
Beckham,Lieutenant Governor,Cathy Cummings,DEM,50330,0,1,27,28,
Beckham,Lieutenant Governor,Todd Lamb,REP,50330,3,12,182,197,
Beckham,Superintendent of Public Instruction,John Cox,DEM,50330,1,5,66,72,
Beckham,Superintendent of Public Instruction,Joy Hofmeister,REP,50330,2,8,142,152,
Beckham,Commissioner of Labor,Mike Workman,DEM,50330,1,3,41,45,
Beckham,Commissioner of Labor,Mark Costello,REP,50330,2,8,163,173,
Beckham,U.S. Senate,Matt Silverstein,DEM,50330,1,1,15,17,
Beckham,U.S. Senate,Jim Inhofe,REP,50330,2,12,188,202,
Beckham,U.S. Senate,Aaron Delozier,IND,50330,0,0,1,1,
Beckham,U.S. Senate,Ray Woods,IND,50330,0,0,3,3,
Beckham,U.S. Senate,Joan Farr,IND,50330,0,0,0,0,
Beckham,U.S. Senate,Connie Johnson,DEM,50330,0,1,10,11,
Beckham,U.S. Senate,James Lankford,REP,50330,3,12,193,208,
Beckham,U.S. Senate,Mark Beard,IND,50330,0,0,6,6,
Beckham,U.S. House,Frankie Robbins,DEM,50330,0,3,19,22,03
Beckham,U.S. House,Frank Lucas,REP,50330,3,11,188,202,03
Beckham,State Senate,Kevin Black,DEM,50330,1,4,109,114,26
Beckham,State Senate,Darcy Jech,REP,50330,2,9,100,111,26
Beckham,Governor,Joe Dorman,DEM,50332,10,5,210,225,
Beckham,Governor,Mary Fallin,REP,50332,8,12,407,427,
Beckham,Governor,Kimberly Willis,IND,50332,0,0,12,12,
Beckham,Governor,Richard Prawdzienski,IND,50332,0,0,3,3,
Beckham,Lieutenant Governor,Cathy Cummings,DEM,50332,4,0,113,117,
Beckham,Lieutenant Governor,Todd Lamb,REP,50332,15,17,518,550,
Beckham,Superintendent of Public Instruction,John Cox,DEM,50332,5,2,224,231,
Beckham,Superintendent of Public Instruction,Joy Hofmeister,REP,50332,14,14,409,437,
Beckham,Commissioner of Labor,Mike Workman,DEM,50332,3,1,170,174,
Beckham,Commissioner of Labor,Mark Costello,REP,50332,15,14,446,475,
Beckham,U.S. Senate,Matt Silverstein,DEM,50332,4,1,97,102,
Beckham,U.S. Senate,Jim Inhofe,REP,50332,15,16,520,551,
Beckham,U.S. Senate,Aaron Delozier,IND,50332,0,0,0,0,
Beckham,U.S. Senate,Ray Woods,IND,50332,0,0,3,3,
Beckham,U.S. Senate,Joan Farr,IND,50332,0,0,7,7,
Beckham,U.S. Senate,Connie Johnson,DEM,50332,3,1,104,108,
Beckham,U.S. Senate,James Lankford,REP,50332,16,16,523,555,
Beckham,U.S. Senate,Mark Beard,IND,50332,0,0,5,5,
Beckham,U.S. House,Frankie Robbins,DEM,50332,1,1,88,90,03
Beckham,U.S. House,Frank Lucas,REP,50332,18,16,543,577,03
Beckham,State Senate,Kevin Black,DEM,50332,15,12,389,416,26
Beckham,State Senate,Darcy Jech,REP,50332,3,5,248,256,26
Beckham,Governor,Joe Dorman,DEM,50333,3,5,195,203,
Beckham,Governor,Mary Fallin,REP,50333,10,13,316,339,
Beckham,Governor,Kimberly Willis,IND,50333,0,1,22,23,
Beckham,Governor,Richard Prawdzienski,IND,50333,1,0,6,7,
Beckham,Lieutenant Governor,Cathy Cummings,DEM,50333,4,2,106,112,
Beckham,Lieutenant Governor,Todd Lamb,REP,50333,10,17,426,453,
Beckham,Superintendent of Public Instruction,John Cox,DEM,50333,6,5,195,206,
Beckham,Superintendent of Public Instruction,Joy Hofmeister,REP,50333,7,14,339,360,
Beckham,Commissioner of Labor,Mike Workman,DEM,50333,4,3,148,155,
Beckham,Commissioner of Labor,Mark Costello,REP,50333,9,15,369,393,
Beckham,U.S. Senate,Matt Silverstein,DEM,50333,2,3,83,88,
Beckham,U.S. Senate,Jim Inhofe,REP,50333,10,16,426,452,
Beckham,U.S. Senate,Aaron Delozier,IND,50333,0,0,6,6,
Beckham,U.S. Senate,Ray Woods,IND,50333,1,0,9,10,
Beckham,U.S. Senate,Joan Farr,IND,50333,1,0,6,7,
Beckham,U.S. Senate,Connie Johnson,DEM,50333,5,2,108,115,
Beckham,U.S. Senate,James Lankford,REP,50333,9,16,415,440,
Beckham,U.S. Senate,Mark Beard,IND,50333,0,1,11,12,
Beckham,U.S. House,Frankie Robbins,DEM,50333,3,3,86,92,03
Beckham,U.S. House,Frank Lucas,REP,50333,11,16,449,476,03
Beckham,State Senate,Kevin Black,DEM,50333,10,11,350,371,26
Beckham,State Senate,Darcy Jech,REP,50333,4,8,188,200,26
Beckham,Governor,Joe Dorman,DEM,50343,1,13,27,41,
Beckham,Governor,Mary Fallin,REP,50343,4,12,63,79,
Beckham,Governor,Kimberly Willis,IND,50343,0,0,0,0,
Beckham,Governor,Richard Prawdzienski,IND,50343,0,0,0,0,
Beckham,Lieutenant Governor,Cathy Cummings,DEM,50343,1,7,19,27,
Beckham,Lieutenant Governor,Todd Lamb,REP,50343,3,18,71,92,
Beckham,Superintendent of Public Instruction,John Cox,DEM,50343,3,15,39,57,
Beckham,Superintendent of Public Instruction,Joy Hofmeister,REP,50343,1,9,51,61,
Beckham,Commissioner of Labor,Mike Workman,DEM,50343,1,12,29,42,
Beckham,Commissioner of Labor,Mark Costello,REP,50343,2,13,60,75,
Beckham,U.S. Senate,Matt Silverstein,DEM,50343,1,9,12,22,
Beckham,U.S. Senate,Jim Inhofe,REP,50343,3,16,75,94,
Beckham,U.S. Senate,Aaron Delozier,IND,50343,0,0,1,1,
Beckham,U.S. Senate,Ray Woods,IND,50343,0,0,1,1,
Beckham,U.S. Senate,Joan Farr,IND,50343,0,0,0,0,
Beckham,U.S. Senate,Connie Johnson,DEM,50343,1,10,13,24,
Beckham,U.S. Senate,James Lankford,REP,50343,3,14,77,94,
Beckham,U.S. Senate,Mark Beard,IND,50343,0,1,0,1,
Beckham,U.S. House,Frankie Robbins,DEM,50343,1,8,18,27,03
Beckham,U.S. House,Frank Lucas,REP,50343,3,17,74,94,03
Beckham,State Senate,Kevin Black,DEM,50343,2,14,42,58,26
Beckham,State Senate,Darcy Jech,REP,50343,2,11,48,61,26
Blaine,Governor,Joe Dorman,DEM,60002,3,4,165,172,
Blaine,Governor,Mary Fallin,REP,60002,5,5,255,265,
Blaine,Governor,Kimberly Willis,IND,60002,0,0,10,10,
Blaine,Governor,Richard Prawdzienski,IND,60002,0,0,1,1,
Blaine,Lieutenant Governor,Cathy Cummings,DEM,60002,1,2,56,59,
Blaine,Lieutenant Governor,Todd Lamb,REP,60002,7,7,375,389,
Blaine,Superintendent of Public Instruction,John Cox,DEM,60002,2,6,156,164,
Blaine,Superintendent of Public Instruction,Joy Hofmeister,REP,60002,6,3,269,278,
Blaine,Commissioner of Labor,Mike Workman,DEM,60002,1,3,108,112,
Blaine,Commissioner of Labor,Mark Costello,REP,60002,7,6,312,325,
Blaine,U.S. Senate,Matt Silverstein,DEM,60002,1,2,34,37,
Blaine,U.S. Senate,Jim Inhofe,REP,60002,7,7,379,393,
Blaine,U.S. Senate,Aaron Delozier,IND,60002,0,0,1,1,
Blaine,U.S. Senate,Ray Woods,IND,60002,0,0,12,12,
Blaine,U.S. Senate,Joan Farr,IND,60002,0,0,5,5,
Blaine,U.S. Senate,Connie Johnson,DEM,60002,2,2,46,50,
Blaine,U.S. Senate,James Lankford,REP,60002,5,5,363,373,
Blaine,U.S. Senate,Mark Beard,IND,60002,1,2,19,22,
Blaine,U.S. House,Frankie Robbins,DEM,60002,3,3,36,42,03
Blaine,U.S. House,Frank Lucas,REP,60002,5,6,394,405,03
Blaine,State Senate,Kevin Black,DEM,60002,1,2,68,71,26
Blaine,State Senate,Darcy Jech,REP,60002,7,7,360,374,26
Blaine,Governor,Joe Dorman,DEM,60007,2,2,147,151,
Blaine,Governor,Mary Fallin,REP,60007,6,6,205,217,
Blaine,Governor,Kimberly Willis,IND,60007,0,0,9,9,
Blaine,Governor,Richard Prawdzienski,IND,60007,0,0,1,1,
Blaine,Lieutenant Governor,Cathy Cummings,DEM,60007,2,2,78,82,
Blaine,Lieutenant Governor,Todd Lamb,REP,60007,6,6,285,297,
Blaine,Superintendent of Public Instruction,John Cox,DEM,60007,3,3,154,160,
Blaine,Superintendent of Public Instruction,Joy Hofmeister,REP,60007,5,5,210,220,
Blaine,Commissioner of Labor,Mike Workman,DEM,60007,4,2,115,121,
Blaine,Commissioner of Labor,Mark Costello,REP,60007,4,5,243,252,
Blaine,U.S. Senate,Matt Silverstein,DEM,60007,1,2,66,69,
Blaine,U.S. Senate,Jim Inhofe,REP,60007,7,5,281,293,
Blaine,U.S. Senate,Aaron Delozier,IND,60007,0,0,1,1,
Blaine,U.S. Senate,Ray Woods,IND,60007,0,0,6,6,
Blaine,U.S. Senate,Joan Farr,IND,60007,0,0,7,7,
Blaine,U.S. Senate,Connie Johnson,DEM,60007,2,2,72,76,
Blaine,U.S. Senate,James Lankford,REP,60007,6,6,277,289,
Blaine,U.S. Senate,Mark Beard,IND,60007,0,0,11,11,
Blaine,U.S. House,Frankie Robbins,DEM,60007,2,2,72,76,03
Blaine,U.S. House,Frank Lucas,REP,60007,6,6,291,303,03
Blaine,State Senate,Kevin Black,DEM,60007,3,2,110,115,26
Blaine,State Senate,Darcy Jech,REP,60007,5,6,251,262,26
Blaine,Governor,Joe Dorman,DEM,60010,1,1,81,83,
Blaine,Governor,Mary Fallin,REP,60010,8,12,120,140,
Blaine,Governor,Kimberly Willis,IND,60010,0,1,9,10,
Blaine,Governor,Richard Prawdzienski,IND,60010,0,0,2,2,
Blaine,Lieutenant Governor,Cathy Cummings,DEM,60010,1,1,51,53,
Blaine,Lieutenant Governor,Todd Lamb,REP,60010,8,13,161,182,
Blaine,Superintendent of Public Instruction,John Cox,DEM,60010,1,3,105,109,
Blaine,Superintendent of Public Instruction,Joy Hofmeister,REP,60010,8,11,106,125,
Blaine,Commissioner of Labor,Mike Workman,DEM,60010,1,2,81,84,
Blaine,Commissioner of Labor,Mark Costello,REP,60010,8,12,125,145,
Blaine,U.S. Senate,Matt Silverstein,DEM,60010,1,1,39,41,
Blaine,U.S. Senate,Jim Inhofe,REP,60010,8,13,167,188,
Blaine,U.S. Senate,Aaron Delozier,IND,60010,0,0,1,1,
Blaine,U.S. Senate,Ray Woods,IND,60010,0,0,4,4,
Blaine,U.S. Senate,Joan Farr,IND,60010,0,0,1,1,
Blaine,U.S. Senate,Connie Johnson,DEM,60010,1,1,46,48,
Blaine,U.S. Senate,James Lankford,REP,60010,8,13,155,176,
Blaine,U.S. Senate,Mark Beard,IND,60010,0,0,9,9,
Blaine,U.S. House,Frankie Robbins,DEM,60010,1,2,40,43,03
Blaine,U.S. House,Frank Lucas,REP,60010,8,12,171,191,03
Blaine,State Senate,Kevin Black,DEM,60010,1,2,63,66,26
Blaine,State Senate,Darcy Jech,REP,60010,8,12,146,166,26
Blaine,Governor,Joe Dorman,DEM,60011,0,11,65,76,
Blaine,Governor,Mary Fallin,REP,60011,2,17,68,87,
Blaine,Governor,Kimberly Willis,IND,60011,0,0,0,0,
Blaine,Governor,Richard Prawdzienski,IND,60011,1,0,3,4,
Blaine,Lieutenant Governor,Cathy Cummings,DEM,60011,0,9,68,77,
Blaine,Lieutenant Governor,Todd Lamb,REP,60011,3,19,67,89,
Blaine,Superintendent of Public Instruction,John Cox,DEM,60011,1,14,85,100,
Blaine,Superintendent of Public Instruction,Joy Hofmeister,REP,60011,2,13,51,66,
Blaine,Commissioner of Labor,Mike Workman,DEM,60011,0,13,74,87,
Blaine,Commissioner of Labor,Mark Costello,REP,60011,3,12,57,72,
Blaine,U.S. Senate,Matt Silverstein,DEM,60011,0,7,56,63,
Blaine,U.S. Senate,Jim Inhofe,REP,60011,3,19,76,98,
Blaine,U.S. Senate,Aaron Delozier,IND,60011,0,0,1,1,
Blaine,U.S. Senate,Ray Woods,IND,60011,0,0,0,0,
Blaine,U.S. Senate,Joan Farr,IND,60011,0,2,2,4,
Blaine,U.S. Senate,Connie Johnson,DEM,60011,0,6,63,69,
Blaine,U.S. Senate,James Lankford,REP,60011,3,22,66,91,
Blaine,U.S. Senate,Mark Beard,IND,60011,0,0,6,6,
Blaine,U.S. House,Frankie Robbins,DEM,60011,0,7,64,71,03
Blaine,U.S. House,Frank Lucas,REP,60011,3,20,71,94,03
Blaine,State Senate,Kevin Black,DEM,60011,1,11,62,74,26
Blaine,State Senate,Darcy Jech,REP,60011,2,15,73,90,26
Blaine,Governor,Joe Dorman,DEM,60012,7,29,175,211,
Blaine,Governor,Mary Fallin,REP,60012,19,64,374,457,
Blaine,Governor,Kimberly Willis,IND,60012,0,3,11,14,
Blaine,Governor,Richard Prawdzienski,IND,60012,0,0,5,5,
Blaine,Lieutenant Governor,Cathy Cummings,DEM,60012,4,15,105,124,
Blaine,Lieutenant Governor,Todd Lamb,REP,60012,22,80,458,560,
Blaine,Superintendent of Public Instruction,John Cox,DEM,60012,12,43,243,298,
Blaine,Superintendent of Public Instruction,Joy Hofmeister,REP,60012,14,52,316,382,
Blaine,Commissioner of Labor,Mike Workman,DEM,60012,4,28,168,200,
Blaine,Commissioner of Labor,Mark Costello,REP,60012,21,62,383,466,
Blaine,U.S. Senate,Matt Silverstein,DEM,60012,1,12,80,93,
Blaine,U.S. Senate,Jim Inhofe,REP,60012,25,80,458,563,
Blaine,U.S. Senate,Aaron Delozier,IND,60012,0,0,2,2,
Blaine,U.S. Senate,Ray Woods,IND,60012,0,3,6,9,
Blaine,U.S. Senate,Joan Farr,IND,60012,0,1,13,14,
Blaine,U.S. Senate,Connie Johnson,DEM,60012,1,14,86,101,
Blaine,U.S. Senate,James Lankford,REP,60012,25,81,458,564,
Blaine,U.S. Senate,Mark Beard,IND,60012,0,1,13,14,
Blaine,U.S. House,Frankie Robbins,DEM,60012,1,17,90,108,03
Blaine,U.S. House,Frank Lucas,REP,60012,24,79,472,575,03
Blaine,State Senate,Kevin Black,DEM,60012,4,31,139,174,26
Blaine,State Senate,Darcy Jech,REP,60012,21,64,422,507,26
Blaine,Governor,Joe Dorman,DEM,60016,0,3,26,29,
Blaine,Governor,Mary Fallin,REP,60016,1,13,66,80,
Blaine,Governor,Kimberly Willis,IND,60016,0,1,2,3,
Blaine,Governor,Richard Prawdzienski,IND,60016,0,0,0,0,
Blaine,Lieutenant Governor,Cathy Cummings,DEM,60016,0,0,13,13,
Blaine,Lieutenant Governor,Todd Lamb,REP,60016,1,17,81,99,
Blaine,Superintendent of Public Instruction,John Cox,DEM,60016,0,7,40,47,
Blaine,Superintendent of Public Instruction,Joy Hofmeister,REP,60016,1,10,54,65,
Blaine,Commissioner of Labor,Mike Workman,DEM,60016,0,5,26,31,
Blaine,Commissioner of Labor,Mark Costello,REP,60016,1,12,62,75,
Blaine,U.S. Senate,Matt Silverstein,DEM,60016,0,0,11,11,
Blaine,U.S. Senate,Jim Inhofe,REP,60016,1,17,79,97,
Blaine,U.S. Senate,Aaron Delozier,IND,60016,0,0,1,1,
Blaine,U.S. Senate,Ray Woods,IND,60016,0,0,0,0,
Blaine,U.S. Senate,Joan Farr,IND,60016,0,0,2,2,
Blaine,U.S. Senate,Connie Johnson,DEM,60016,0,4,12,16,
Blaine,U.S. Senate,James Lankford,REP,60016,1,12,80,93,
Blaine,U.S. Senate,Mark Beard,IND,60016,0,1,3,4,
Blaine,U.S. House,Frankie Robbins,DEM,60016,0,0,13,13,03
Blaine,U.S. House,Frank Lucas,REP,60016,1,17,82,100,03
Blaine,State Senate,Kevin Black,DEM,60016,0,3,17,20,26
Blaine,State Senate,Darcy Jech,REP,60016,1,13,77,91,26
Blaine,Governor,Joe Dorman,DEM,60017,2,1,179,182,
Blaine,Governor,Mary Fallin,REP,60017,1,2,187,190,
Blaine,Governor,Kimberly Willis,IND,60017,0,0,14,14,
Blaine,Governor,Richard Prawdzienski,IND,60017,0,0,4,4,
Blaine,Lieutenant Governor,Cathy Cummings,DEM,60017,1,1,125,127,
Blaine,Lieutenant Governor,Todd Lamb,REP,60017,1,2,258,261,
Blaine,Superintendent of Public Instruction,John Cox,DEM,60017,2,2,205,209,
Blaine,Superintendent of Public Instruction,Joy Hofmeister,REP,60017,1,1,179,181,
Blaine,Commissioner of Labor,Mike Workman,DEM,60017,0,3,168,171,
Blaine,Commissioner of Labor,Mark Costello,REP,60017,2,0,206,208,
Blaine,U.S. Senate,Matt Silverstein,DEM,60017,0,1,90,91,
Blaine,U.S. Senate,Jim Inhofe,REP,60017,2,2,272,276,
Blaine,U.S. Senate,Aaron Delozier,IND,60017,0,0,6,6,
Blaine,U.S. Senate,Ray Woods,IND,60017,0,0,7,7,
Blaine,U.S. Senate,Joan Farr,IND,60017,0,0,8,8,
Blaine,U.S. Senate,Connie Johnson,DEM,60017,1,1,109,111,
Blaine,U.S. Senate,James Lankford,REP,60017,2,2,252,256,
Blaine,U.S. Senate,Mark Beard,IND,60017,0,0,24,24,
Blaine,U.S. House,Frankie Robbins,DEM,60017,0,1,108,109,03
Blaine,U.S. House,Frank Lucas,REP,60017,2,2,277,281,03
Blaine,State Senate,Kevin Black,DEM,60017,1,2,170,173,26
Blaine,State Senate,Darcy Jech,REP,60017,2,1,210,213,26
Blaine,Governor,Joe Dorman,DEM,60020,5,0,50,55,
Blaine,Governor,Mary Fallin,REP,60020,2,0,126,128,
Blaine,Governor,Kimberly Willis,IND,60020,0,0,2,2,
Blaine,Governor,Richard Prawdzienski,IND,60020,0,0,1,1,
Blaine,Lieutenant Governor,Cathy Cummings,DEM,60020,1,0,26,27,
Blaine,Lieutenant Governor,Todd Lamb,REP,60020,6,0,150,156,
Blaine,Superintendent of Public Instruction,John Cox,DEM,60020,3,0,75,78,
Blaine,Superintendent of Public Instruction,Joy Hofmeister,REP,60020,4,0,103,107,
Blaine,Commissioner of Labor,Mike Workman,DEM,60020,1,0,40,41,
Blaine,Commissioner of Labor,Mark Costello,REP,60020,6,0,128,134,
Blaine,U.S. Senate,Matt Silverstein,DEM,60020,1,0,22,23,
Blaine,U.S. Senate,Jim Inhofe,REP,60020,6,0,154,160,
Blaine,U.S. Senate,Aaron Delozier,IND,60020,0,0,0,0,
Blaine,U.S. Senate,Ray Woods,IND,60020,0,0,0,0,
Blaine,U.S. Senate,Joan Farr,IND,60020,0,0,0,0,
Blaine,U.S. Senate,Connie Johnson,DEM,60020,1,0,23,24,
Blaine,U.S. Senate,James Lankford,REP,60020,6,0,149,155,
Blaine,U.S. Senate,Mark Beard,IND,60020,0,0,5,5,
Blaine,U.S. House,Frankie Robbins,DEM,60020,1,0,24,25,03
Blaine,U.S. House,Frank Lucas,REP,60020,6,0,152,158,03
Blaine,State Senate,Kevin Black,DEM,60020,3,0,38,41,26
Blaine,State Senate,Darcy Jech,REP,60020,4,0,138,142,26
Blaine,Governor,Joe Dorman,DEM,60022,0,2,9,11,
Blaine,Governor,Mary Fallin,REP,60022,0,4,21,25,
Blaine,Governor,Kimberly Willis,IND,60022,0,0,3,3,
Blaine,Governor,Richard Prawdzienski,IND,60022,0,0,1,1,
Blaine,Lieutenant Governor,Cathy Cummings,DEM,60022,0,0,3,3,
Blaine,Lieutenant Governor,Todd Lamb,REP,60022,0,6,31,37,
Blaine,Superintendent of Public Instruction,John Cox,DEM,60022,0,2,10,12,
Blaine,Superintendent of Public Instruction,Joy Hofmeister,REP,60022,0,4,24,28,
Blaine,Commissioner of Labor,Mike Workman,DEM,60022,0,1,10,11,
Blaine,Commissioner of Labor,Mark Costello,REP,60022,0,4,23,27,
Blaine,U.S. Senate,Matt Silverstein,DEM,60022,0,0,1,1,
Blaine,U.S. Senate,Jim Inhofe,REP,60022,0,6,30,36,
Blaine,U.S. Senate,Aaron Delozier,IND,60022,0,0,2,2,
Blaine,U.S. Senate,Ray Woods,IND,60022,0,0,0,0,
Blaine,U.S. Senate,Joan Farr,IND,60022,0,0,0,0,
Blaine,U.S. Senate,Connie Johnson,DEM,60022,0,2,3,5,
Blaine,U.S. Senate,James Lankford,REP,60022,0,4,31,35,
Blaine,U.S. Senate,Mark Beard,IND,60022,0,0,0,0,
Blaine,U.S. House,Frankie Robbins,DEM,60022,0,0,3,3,03
Blaine,U.S. House,Frank Lucas,REP,60022,0,6,30,36,03
Blaine,State Senate,Kevin Black,DEM,60022,0,2,6,8,26
Blaine,State Senate,Darcy Jech,REP,60022,0,4,27,31,26
Bryan,Governor,Joe Dorman,DEM,70003,1,10,199,210,
Bryan,Governor,Mary Fallin,REP,70003,3,17,178,198,
Bryan,Governor,Kimberly Willis,IND,70003,0,0,18,18,
Bryan,Governor,Richard Prawdzienski,IND,70003,0,1,4,5,
Bryan,Lieutenant Governor,Cathy Cummings,DEM,70003,1,10,156,167,
Bryan,Lieutenant Governor,Todd Lamb,REP,70003,3,18,240,261,
Bryan,Superintendent of Public Instruction,John Cox,DEM,70003,1,9,215,225,
Bryan,Superintendent of Public Instruction,Joy Hofmeister,REP,70003,3,19,187,209,
Bryan,Commissioner of Labor,Mike Workman,DEM,70003,1,8,159,168,
Bryan,Commissioner of Labor,Mark Costello,REP,70003,3,20,230,253,
Bryan,U.S. Senate,Matt Silverstein,DEM,70003,0,6,133,139,
Bryan,U.S. Senate,Jim Inhofe,REP,70003,3,20,250,273,
Bryan,U.S. Senate,Aaron Delozier,IND,70003,0,0,3,3,
Bryan,U.S. Senate,Ray Woods,IND,70003,0,0,6,6,
Bryan,U.S. Senate,Joan Farr,IND,70003,0,2,10,12,
Bryan,U.S. Senate,Connie Johnson,DEM,70003,0,9,128,137,
Bryan,U.S. Senate,James Lankford,REP,70003,3,19,243,265,
Bryan,U.S. Senate,Mark Beard,IND,70003,1,0,26,27,
Bryan,U.S. House,Earl Everett,DEM,70003,0,7,113,120,02
Bryan,U.S. House,Markwayne Mullin,REP,70003,2,20,256,278,02
Bryan,U.S. House,Jon Douthitt,IND,70003,1,1,30,32,02
Bryan,State Senate,Joe Hill,DEM,70003,2,12,211,225,6
Bryan,State Senate,Josh Brecheen,REP,70003,2,16,186,204,6
Bryan,State Senate,Vicki Gaylor,IND,70003,0,0,9,9,6
Bryan,Governor,Joe Dorman,DEM,70004,4,25,227,256,
Bryan,Governor,Mary Fallin,REP,70004,5,17,185,207,
Bryan,Governor,Kimberly Willis,IND,70004,0,1,20,21,
Bryan,Governor,Richard Prawdzienski,IND,70004,0,0,9,9,
Bryan,Lieutenant Governor,Cathy Cummings,DEM,70004,5,17,188,210,
Bryan,Lieutenant Governor,Todd Lamb,REP,70004,4,26,250,280,
Bryan,Superintendent of Public Instruction,John Cox,DEM,70004,6,25,236,267,
Bryan,Superintendent of Public Instruction,Joy Hofmeister,REP,70004,3,19,198,220,
Bryan,Commissioner of Labor,Mike Workman,DEM,70004,6,20,206,232,
Bryan,Commissioner of Labor,Mark Costello,REP,70004,3,24,222,249,
Bryan,U.S. Senate,Matt Silverstein,DEM,70004,4,14,128,146,
Bryan,U.S. Senate,Jim Inhofe,REP,70004,5,27,281,313,
Bryan,U.S. Senate,Aaron Delozier,IND,70004,0,1,9,10,
Bryan,U.S. Senate,Ray Woods,IND,70004,0,0,12,12,
Bryan,U.S. Senate,Joan Farr,IND,70004,0,0,6,6,
Bryan,U.S. Senate,Connie Johnson,DEM,70004,3,15,142,160,
Bryan,U.S. Senate,James Lankford,REP,70004,5,27,268,300,
Bryan,U.S. Senate,Mark Beard,IND,70004,1,2,25,28,
Bryan,U.S. House,Earl Everett,DEM,70004,4,13,131,148,02
Bryan,U.S. House,Markwayne Mullin,REP,70004,5,24,280,309,02
Bryan,U.S. House,Jon Douthitt,IND,70004,0,6,25,31,02
Bryan,State Senate,Joe Hill,DEM,70004,6,23,245,274,6
Bryan,State Senate,Josh Brecheen,REP,70004,3,18,186,207,6
Bryan,State Senate,Vicki Gaylor,IND,70004,0,2,10,12,6
Bryan,Governor,Joe Dorman,DEM,70005,8,21,224,253,
Bryan,Governor,Mary Fallin,REP,70005,9,32,209,250,
Bryan,Governor,Kimberly Willis,IND,70005,0,0,13,13,
Bryan,Governor,Richard Prawdzienski,IND,70005,0,0,9,9,
Bryan,Lieutenant Governor,Cathy Cummings,DEM,70005,8,16,175,199,
Bryan,Lieutenant Governor,Todd Lamb,REP,70005,9,36,275,320,
Bryan,Superintendent of Public Instruction,John Cox,DEM,70005,10,22,239,271,
Bryan,Superintendent of Public Instruction,Joy Hofmeister,REP,70005,7,30,213,250,
Bryan,Commissioner of Labor,Mike Workman,DEM,70005,8,16,171,195,
Bryan,Commissioner of Labor,Mark Costello,REP,70005,8,34,274,316,
Bryan,U.S. Senate,Matt Silverstein,DEM,70005,8,16,133,157,
Bryan,U.S. Senate,Jim Inhofe,REP,70005,9,35,302,346,
Bryan,U.S. Senate,Aaron Delozier,IND,70005,0,0,3,3,
Bryan,U.S. Senate,Ray Woods,IND,70005,0,0,5,5,
Bryan,U.S. Senate,Joan Farr,IND,70005,0,1,10,11,
Bryan,U.S. Senate,Connie Johnson,DEM,70005,6,15,149,170,
Bryan,U.S. Senate,James Lankford,REP,70005,10,36,282,328,
Bryan,U.S. Senate,Mark Beard,IND,70005,0,0,21,21,
Bryan,U.S. House,Earl Everett,DEM,70005,7,15,125,147,02
Bryan,U.S. House,Markwayne Mullin,REP,70005,10,37,306,353,02
Bryan,U.S. House,Jon Douthitt,IND,70005,0,0,23,23,02
Bryan,State Senate,Joe Hill,DEM,70005,10,21,223,254,6
Bryan,State Senate,Josh Brecheen,REP,70005,7,31,227,265,6
Bryan,State Senate,Vicki Gaylor,IND,70005,0,1,10,11,6
Bryan,Governor,Joe Dorman,DEM,70008,8,18,235,261,
Bryan,Governor,Mary Fallin,REP,70008,7,37,207,251,
Bryan,Governor,Kimberly Willis,IND,70008,0,1,8,9,
Bryan,Governor,Richard Prawdzienski,IND,70008,0,0,5,5,
Bryan,Lieutenant Governor,Cathy Cummings,DEM,70008,7,15,158,180,
Bryan,Lieutenant Governor,Todd Lamb,REP,70008,8,40,294,342,
Bryan,Superintendent of Public Instruction,John Cox,DEM,70008,9,18,237,264,
Bryan,Superintendent of Public Instruction,Joy Hofmeister,REP,70008,6,36,217,259,
Bryan,Commissioner of Labor,Mike Workman,DEM,70008,8,17,178,203,
Bryan,Commissioner of Labor,Mark Costello,REP,70008,7,36,262,305,
Bryan,U.S. Senate,Matt Silverstein,DEM,70008,10,13,126,149,
Bryan,U.S. Senate,Jim Inhofe,REP,70008,5,41,322,368,
Bryan,U.S. Senate,Aaron Delozier,IND,70008,0,0,2,2,
Bryan,U.S. Senate,Ray Woods,IND,70008,0,1,3,4,
Bryan,U.S. Senate,Joan Farr,IND,70008,0,0,5,5,
Bryan,U.S. Senate,Connie Johnson,DEM,70008,8,10,132,150,
Bryan,U.S. Senate,James Lankford,REP,70008,7,43,302,352,
Bryan,U.S. Senate,Mark Beard,IND,70008,0,2,18,20,
Bryan,U.S. House,Earl Everett,DEM,70008,8,12,127,147,02
Bryan,U.S. House,Markwayne Mullin,REP,70008,7,42,309,358,02
Bryan,U.S. House,Jon Douthitt,IND,70008,0,2,16,18,02
Bryan,State Senate,Joe Hill,DEM,70008,10,18,231,259,6
Bryan,State Senate,Josh Brecheen,REP,70008,5,38,225,268,6
Bryan,State Senate,Vicki Gaylor,IND,70008,0,0,4,4,6
Bryan,Governor,Joe Dorman,DEM,70010,0,18,107,125,
Bryan,Governor,Mary Fallin,REP,70010,1,9,134,144,
Bryan,Governor,Kimberly Willis,IND,70010,0,0,4,4,
Bryan,Governor,Richard Prawdzienski,IND,70010,1,0,0,1,
Bryan,Lieutenant Governor,Cathy Cummings,DEM,70010,0,12,80,92,
Bryan,Lieutenant Governor,Todd Lamb,REP,70010,2,15,160,177,
Bryan,Superintendent of Public Instruction,John Cox,DEM,70010,0,18,124,142,
Bryan,Superintendent of Public Instruction,Joy Hofmeister,REP,70010,2,9,120,131,
Bryan,Commissioner of Labor,Mike Workman,DEM,70010,0,12,94,106,
Bryan,Commissioner of Labor,Mark Costello,REP,70010,2,14,144,160,
Bryan,U.S. Senate,Matt Silverstein,DEM,70010,0,9,68,77,
Bryan,U.S. Senate,Jim Inhofe,REP,70010,1,17,170,188,
Bryan,U.S. Senate,Aaron Delozier,IND,70010,0,1,1,2,
Bryan,U.S. Senate,Ray Woods,IND,70010,1,0,4,5,
Bryan,U.S. Senate,Joan Farr,IND,70010,0,0,1,1,
Bryan,U.S. Senate,Connie Johnson,DEM,70010,0,11,72,83,
Bryan,U.S. Senate,James Lankford,REP,70010,1,16,159,176,
Bryan,U.S. Senate,Mark Beard,IND,70010,1,0,12,13,
Bryan,U.S. House,Earl Everett,DEM,70010,0,7,58,65,02
Bryan,U.S. House,Markwayne Mullin,REP,70010,1,19,176,196,02
Bryan,U.S. House,Jon Douthitt,IND,70010,1,1,8,10,02
Bryan,State Senate,Joe Hill,DEM,70010,0,18,110,128,6
Bryan,State Senate,Josh Brecheen,REP,70010,2,8,134,144,6
Bryan,State Senate,Vicki Gaylor,IND,70010,0,1,4,5,6
Bryan,Governor,Joe Dorman,DEM,70011,1,1,72,74,
Bryan,Governor,Mary Fallin,REP,70011,1,2,47,50,
Bryan,Governor,Kimberly Willis,IND,70011,0,0,2,2,
Bryan,Governor,Richard Prawdzienski,IND,70011,0,0,0,0,
Bryan,Lieutenant Governor,Cathy Cummings,DEM,70011,1,1,59,61,
Bryan,Lieutenant Governor,Todd Lamb,REP,70011,0,2,61,63,
Bryan,Superintendent of Public Instruction,John Cox,DEM,70011,0,1,71,72,
Bryan,Superintendent of Public Instruction,Joy Hofmeister,REP,70011,0,2,49,51,
Bryan,Commissioner of Labor,Mike Workman,DEM,70011,1,0,62,63,
Bryan,Commissioner of Labor,Mark Costello,REP,70011,0,3,58,61,
Bryan,U.S. Senate,Matt Silverstein,DEM,70011,0,1,40,41,
Bryan,U.S. Senate,Jim Inhofe,REP,70011,2,2,75,79,
Bryan,U.S. Senate,Aaron Delozier,IND,70011,0,0,2,2,
Bryan,U.S. Senate,Ray Woods,IND,70011,0,0,1,1,
Bryan,U.S. Senate,Joan Farr,IND,70011,0,0,2,2,
Bryan,U.S. Senate,Connie Johnson,DEM,70011,0,0,51,51,
Bryan,U.S. Senate,James Lankford,REP,70011,0,3,65,68,
Bryan,U.S. Senate,Mark Beard,IND,70011,1,0,5,6,
Bryan,U.S. House,Earl Everett,DEM,70011,0,1,44,45,02
Bryan,U.S. House,Markwayne Mullin,REP,70011,2,2,72,76,02
Bryan,U.S. House,Jon Douthitt,IND,70011,0,0,4,4,02
Bryan,State Senate,Joe Hill,DEM,70011,0,1,61,62,6
Bryan,State Senate,Josh Brecheen,REP,70011,2,2,59,63,6
Bryan,State Senate,Vicki Gaylor,IND,70011,0,0,2,2,6
Bryan,Governor,Joe Dorman,DEM,70013,2,6,148,156,
Bryan,Governor,Mary Fallin,REP,70013,5,7,159,171,
Bryan,Governor,Kimberly Willis,IND,70013,0,1,2,3,
Bryan,Governor,Richard Prawdzienski,IND,70013,0,0,2,2,
Bryan,Lieutenant Governor,Cathy Cummings,DEM,70013,2,6,101,109,
Bryan,Lieutenant Governor,Todd Lamb,REP,70013,5,8,202,215,
Bryan,Superintendent of Public Instruction,John Cox,DEM,70013,3,7,162,172,
Bryan,Superintendent of Public Instruction,Joy Hofmeister,REP,70013,4,7,141,152,
Bryan,Commissioner of Labor,Mike Workman,DEM,70013,3,6,120,129,
Bryan,Commissioner of Labor,Mark Costello,REP,70013,4,8,178,190,
Bryan,U.S. Senate,Matt Silverstein,DEM,70013,2,6,62,70,
Bryan,U.S. Senate,Jim Inhofe,REP,70013,5,8,238,251,
Bryan,U.S. Senate,Aaron Delozier,IND,70013,0,0,2,2,
Bryan,U.S. Senate,Ray Woods,IND,70013,0,0,2,2,
Bryan,U.S. Senate,Joan Farr,IND,70013,0,0,4,4,
Bryan,U.S. Senate,Connie Johnson,DEM,70013,3,6,67,76,
Bryan,U.S. Senate,James Lankford,REP,70013,4,8,215,227,
Bryan,U.S. Senate,Mark Beard,IND,70013,0,0,15,15,
Bryan,U.S. House,Earl Everett,DEM,70013,3,6,61,70,02
Bryan,U.S. House,Markwayne Mullin,REP,70013,4,8,241,253,02
Bryan,U.S. House,Jon Douthitt,IND,70013,0,0,7,7,02
Bryan,State Senate,Joe Hill,DEM,70013,4,6,110,120,6
Bryan,State Senate,Josh Brecheen,REP,70013,3,7,197,207,6
Bryan,State Senate,Vicki Gaylor,IND,70013,0,1,4,5,6
Bryan,Governor,Joe Dorman,DEM,70014,1,7,86,94,
Bryan,Governor,Mary Fallin,REP,70014,0,8,104,112,
Bryan,Governor,Kimberly Willis,IND,70014,0,1,6,7,
Bryan,Governor,Richard Prawdzienski,IND,70014,0,0,3,3,
Bryan,Lieutenant Governor,Cathy Cummings,DEM,70014,1,5,59,65,
Bryan,Lieutenant Governor,Todd Lamb,REP,70014,0,11,138,149,
Bryan,Superintendent of Public Instruction,John Cox,DEM,70014,1,8,97,106,
Bryan,Superintendent of Public Instruction,Joy Hofmeister,REP,70014,0,8,99,107,
Bryan,Commissioner of Labor,Mike Workman,DEM,70014,1,6,78,85,
Bryan,Commissioner of Labor,Mark Costello,REP,70014,0,8,119,127,
Bryan,U.S. Senate,Matt Silverstein,DEM,70014,1,6,45,52,
Bryan,U.S. Senate,Jim Inhofe,REP,70014,0,9,146,155,
Bryan,U.S. Senate,Aaron Delozier,IND,70014,0,1,0,1,
Bryan,U.S. Senate,Ray Woods,IND,70014,0,0,3,3,
Bryan,U.S. Senate,Joan Farr,IND,70014,0,0,4,4,
Bryan,U.S. Senate,Connie Johnson,DEM,70014,1,6,58,65,
Bryan,U.S. Senate,James Lankford,REP,70014,0,7,126,133,
Bryan,U.S. Senate,Mark Beard,IND,70014,0,1,14,15,
Bryan,U.S. House,Earl Everett,DEM,70014,1,3,45,49,02
Bryan,U.S. House,Markwayne Mullin,REP,70014,0,12,150,162,02
Bryan,U.S. House,Jon Douthitt,IND,70014,0,1,3,4,02
Bryan,State Senate,Joe Hill,DEM,70014,1,9,85,95,6
Bryan,State Senate,Josh Brecheen,REP,70014,0,6,110,116,6
Bryan,State Senate,Vicki Gaylor,IND,70014,0,1,3,4,6
Bryan,Governor,Joe Dorman,DEM,70015,4,9,211,224,
Bryan,Governor,Mary Fallin,REP,70015,5,7,149,161,
Bryan,Governor,Kimberly Willis,IND,70015,0,0,7,7,
Bryan,Governor,Richard Prawdzienski,IND,70015,0,0,3,3,
Bryan,Lieutenant Governor,Cathy Cummings,DEM,70015,5,6,144,155,
Bryan,Lieutenant Governor,Todd Lamb,REP,70015,4,9,215,228,
Bryan,Superintendent of Public Instruction,John Cox,DEM,70015,4,9,213,226,
Bryan,Superintendent of Public Instruction,Joy Hofmeister,REP,70015,5,7,151,163,
Bryan,Commissioner of Labor,Mike Workman,DEM,70015,4,5,172,181,
Bryan,Commissioner of Labor,Mark Costello,REP,70015,5,11,182,198,
Bryan,U.S. Senate,Matt Silverstein,DEM,70015,1,5,125,131,
Bryan,U.S. Senate,Jim Inhofe,REP,70015,8,11,238,257,
Bryan,U.S. Senate,Aaron Delozier,IND,70015,0,0,2,2,
Bryan,U.S. Senate,Ray Woods,IND,70015,0,0,3,3,
Bryan,U.S. Senate,Joan Farr,IND,70015,0,0,2,2,
Bryan,U.S. Senate,Connie Johnson,DEM,70015,3,5,122,130,
Bryan,U.S. Senate,James Lankford,REP,70015,6,11,228,245,
Bryan,U.S. Senate,Mark Beard,IND,70015,0,0,13,13,
Bryan,U.S. House,Earl Everett,DEM,70015,1,4,118,123,02
Bryan,U.S. House,Markwayne Mullin,REP,70015,8,12,238,258,02
Bryan,U.S. House,Jon Douthitt,IND,70015,0,0,8,8,02
Bryan,State Senate,Joe Hill,DEM,70015,4,8,193,205,6
Bryan,State Senate,Josh Brecheen,REP,70015,5,8,174,187,6
Bryan,State Senate,Vicki Gaylor,IND,70015,0,0,6,6,6
Bryan,Governor,Joe Dorman,DEM,70017,2,2,157,161,
Bryan,Governor,Mary Fallin,REP,70017,3,4,95,102,
Bryan,Governor,Kimberly Willis,IND,70017,0,1,9,10,
Bryan,Governor,Richard Prawdzienski,IND,70017,0,0,5,5,
Bryan,Lieutenant Governor,Cathy Cummings,DEM,70017,1,1,126,128,
Bryan,Lieutenant Governor,Todd Lamb,REP,70017,4,6,140,150,
Bryan,Superintendent of Public Instruction,John Cox,DEM,70017,2,2,144,148,
Bryan,Superintendent of Public Instruction,Joy Hofmeister,REP,70017,3,5,119,127,
Bryan,Commissioner of Labor,Mike Workman,DEM,70017,0,1,133,134,
Bryan,Commissioner of Labor,Mark Costello,REP,70017,5,6,129,140,
Bryan,U.S. Senate,Matt Silverstein,DEM,70017,0,1,85,86,
Bryan,U.S. Senate,Jim Inhofe,REP,70017,5,6,160,171,
Bryan,U.S. Senate,Aaron Delozier,IND,70017,0,0,4,4,
Bryan,U.S. Senate,Ray Woods,IND,70017,0,0,8,8,
Bryan,U.S. Senate,Joan Farr,IND,70017,0,0,9,9,
Bryan,U.S. Senate,Connie Johnson,DEM,70017,0,1,92,93,
Bryan,U.S. Senate,James Lankford,REP,70017,5,6,149,160,
Bryan,U.S. Senate,Mark Beard,IND,70017,0,0,20,20,
Bryan,U.S. House,Earl Everett,DEM,70017,0,0,77,77,02
Bryan,U.S. House,Markwayne Mullin,REP,70017,5,7,169,181,02
Bryan,U.S. House,Jon Douthitt,IND,70017,0,0,19,19,02
Bryan,State Senate,Joe Hill,DEM,70017,0,2,156,158,6
Bryan,State Senate,Josh Brecheen,REP,70017,5,5,105,115,6
Bryan,State Senate,Vicki Gaylor,IND,70017,0,0,5,5,6
Bryan,Governor,Joe Dorman,DEM,70018,5,10,238,253,
Bryan,Governor,Mary Fallin,REP,70018,8,15,243,266,
Bryan,Governor,Kimberly Willis,IND,70018,0,0,15,15,
Bryan,Governor,Richard Prawdzienski,IND,70018,0,0,6,6,
Bryan,Lieutenant Governor,Cathy Cummings,DEM,70018,5,3,174,182,
Bryan,Lieutenant Governor,Todd Lamb,REP,70018,8,22,320,350,
Bryan,Superintendent of Public Instruction,John Cox,DEM,70018,6,8,238,252,
Bryan,Superintendent of Public Instruction,Joy Hofmeister,REP,70018,7,16,255,278,
Bryan,Commissioner of Labor,Mike Workman,DEM,70018,6,6,198,210,
Bryan,Commissioner of Labor,Mark Costello,REP,70018,7,18,281,306,
Bryan,U.S. Senate,Matt Silverstein,DEM,70018,5,2,123,130,
Bryan,U.S. Senate,Jim Inhofe,REP,70018,8,23,360,391,
Bryan,U.S. Senate,Aaron Delozier,IND,70018,0,0,7,7,
Bryan,U.S. Senate,Ray Woods,IND,70018,0,0,6,6,
Bryan,U.S. Senate,Joan Farr,IND,70018,0,0,6,6,
Bryan,U.S. Senate,Connie Johnson,DEM,70018,6,2,147,155,
Bryan,U.S. Senate,James Lankford,REP,70018,7,21,316,344,
Bryan,U.S. Senate,Mark Beard,IND,70018,0,2,28,30,
Bryan,U.S. House,Earl Everett,DEM,70018,5,3,122,130,02
Bryan,U.S. House,Markwayne Mullin,REP,70018,8,22,356,386,02
Bryan,U.S. House,Jon Douthitt,IND,70018,0,0,20,20,02
Bryan,State Senate,Joe Hill,DEM,70018,6,9,246,261,6
Bryan,State Senate,Josh Brecheen,REP,70018,7,16,249,272,6
Bryan,State Senate,Vicki Gaylor,IND,70018,0,0,11,11,6
Bryan,Governor,Joe Dorman,DEM,70019,0,7,167,174,
Bryan,Governor,Mary Fallin,REP,70019,6,20,168,194,
Bryan,Governor,Kimberly Willis,IND,70019,1,1,5,7,
Bryan,Governor,Richard Prawdzienski,IND,70019,0,0,3,3,
Bryan,Lieutenant Governor,Cathy Cummings,DEM,70019,0,5,132,137,
Bryan,Lieutenant Governor,Todd Lamb,REP,70019,7,23,210,240,
Bryan,Superintendent of Public Instruction,John Cox,DEM,70019,0,9,185,194,
Bryan,Superintendent of Public Instruction,Joy Hofmeister,REP,70019,7,19,156,182,
Bryan,Commissioner of Labor,Mike Workman,DEM,70019,0,7,147,154,
Bryan,Commissioner of Labor,Mark Costello,REP,70019,7,21,192,220,
Bryan,U.S. Senate,Matt Silverstein,DEM,70019,0,4,99,103,
Bryan,U.S. Senate,Jim Inhofe,REP,70019,7,24,238,269,
Bryan,U.S. Senate,Aaron Delozier,IND,70019,0,0,0,0,
Bryan,U.S. Senate,Ray Woods,IND,70019,0,0,2,2,
Bryan,U.S. Senate,Joan Farr,IND,70019,0,0,4,4,
Bryan,U.S. Senate,Connie Johnson,DEM,70019,0,6,109,115,
Bryan,U.S. Senate,James Lankford,REP,70019,7,22,218,247,
Bryan,U.S. Senate,Mark Beard,IND,70019,0,0,11,11,
Bryan,U.S. House,Earl Everett,DEM,70019,0,3,96,99,02
Bryan,U.S. House,Markwayne Mullin,REP,70019,7,25,236,268,02
Bryan,U.S. House,Jon Douthitt,IND,70019,0,0,8,8,02
Bryan,State Senate,Joe Hill,DEM,70019,0,8,183,191,6
Bryan,State Senate,Josh Brecheen,REP,70019,7,19,160,186,6
Bryan,State Senate,Vicki Gaylor,IND,70019,0,1,2,3,6
Bryan,Governor,Joe Dorman,DEM,70020,0,3,106,109,
Bryan,Governor,Mary Fallin,REP,70020,4,6,177,187,
Bryan,Governor,Kimberly Willis,IND,70020,0,0,6,6,
Bryan,Governor,Richard Prawdzienski,IND,70020,0,0,3,3,
Bryan,Lieutenant Governor,Cathy Cummings,DEM,70020,0,3,101,104,
Bryan,Lieutenant Governor,Todd Lamb,REP,70020,4,6,185,195,
Bryan,Superintendent of Public Instruction,John Cox,DEM,70020,1,3,121,125,
Bryan,Superintendent of Public Instruction,Joy Hofmeister,REP,70020,2,6,166,174,
Bryan,Commissioner of Labor,Mike Workman,DEM,70020,0,3,107,110,
Bryan,Commissioner of Labor,Mark Costello,REP,70020,4,6,181,191,
Bryan,U.S. Senate,Matt Silverstein,DEM,70020,0,3,71,74,
Bryan,U.S. Senate,Jim Inhofe,REP,70020,4,6,211,221,
Bryan,U.S. Senate,Aaron Delozier,IND,70020,0,0,0,0,
Bryan,U.S. Senate,Ray Woods,IND,70020,0,0,4,4,
Bryan,U.S. Senate,Joan Farr,IND,70020,0,0,4,4,
Bryan,U.S. Senate,Connie Johnson,DEM,70020,0,2,87,89,
Bryan,U.S. Senate,James Lankford,REP,70020,4,6,183,193,
Bryan,U.S. Senate,Mark Beard,IND,70020,0,1,17,18,
Bryan,U.S. House,Earl Everett,DEM,70020,0,2,73,75,02
Bryan,U.S. House,Markwayne Mullin,REP,70020,4,6,207,217,02
Bryan,U.S. House,Jon Douthitt,IND,70020,0,1,8,9,02
Bryan,State Senate,Joe Hill,DEM,70020,0,3,111,114,6
Bryan,State Senate,Josh Brecheen,REP,70020,4,6,172,182,6
Bryan,State Senate,Vicki Gaylor,IND,70020,0,0,8,8,6
Bryan,Governor,Joe Dorman,DEM,70021,2,20,159,181,
Bryan,Governor,Mary Fallin,REP,70021,7,28,190,225,
Bryan,Governor,Kimberly Willis,IND,70021,0,0,9,9,
Bryan,Governor,Richard Prawdzienski,IND,70021,0,0,3,3,
Bryan,Lieutenant Governor,Cathy Cummings,DEM,70021,2,16,115,133,
Bryan,Lieutenant Governor,Todd Lamb,REP,70021,7,32,245,284,
Bryan,Superintendent of Public Instruction,John Cox,DEM,70021,3,22,180,205,
Bryan,Superintendent of Public Instruction,Joy Hofmeister,REP,70021,6,26,178,210,
Bryan,Commissioner of Labor,Mike Workman,DEM,70021,2,16,144,162,
Bryan,Commissioner of Labor,Mark Costello,REP,70021,6,31,214,251,
Bryan,U.S. Senate,Matt Silverstein,DEM,70021,2,14,76,92,
Bryan,U.S. Senate,Jim Inhofe,REP,70021,7,34,272,313,
Bryan,U.S. Senate,Aaron Delozier,IND,70021,0,0,3,3,
Bryan,U.S. Senate,Ray Woods,IND,70021,0,0,5,5,
Bryan,U.S. Senate,Joan Farr,IND,70021,0,0,5,5,
Bryan,U.S. Senate,Connie Johnson,DEM,70021,2,16,94,112,
Bryan,U.S. Senate,James Lankford,REP,70021,6,30,254,290,
Bryan,U.S. Senate,Mark Beard,IND,70021,0,0,10,10,
Bryan,U.S. House,Earl Everett,DEM,70021,2,12,86,100,02
Bryan,U.S. House,Markwayne Mullin,REP,70021,7,34,261,302,02
Bryan,U.S. House,Jon Douthitt,IND,70021,0,1,10,11,02
Bryan,State Senate,Joe Hill,DEM,70021,4,24,189,217,6
Bryan,State Senate,Josh Brecheen,REP,70021,5,24,171,200,6
Bryan,State Senate,Vicki Gaylor,IND,70021,0,0,5,5,6
Bryan,Governor,Joe Dorman,DEM,70022,8,0,207,215,
Bryan,Governor,Mary Fallin,REP,70022,4,6,278,288,
Bryan,Governor,Kimberly Willis,IND,70022,0,0,9,9,
Bryan,Governor,Richard Prawdzienski,IND,70022,1,0,11,12,
Bryan,Lieutenant Governor,Cathy Cummings,DEM,70022,10,0,167,177,
Bryan,Lieutenant Governor,Todd Lamb,REP,70022,3,6,332,341,
Bryan,Superintendent of Public Instruction,John Cox,DEM,70022,9,1,218,228,
Bryan,Superintendent of Public Instruction,Joy Hofmeister,REP,70022,4,5,284,293,
Bryan,Commissioner of Labor,Mike Workman,DEM,70022,8,0,185,193,
Bryan,Commissioner of Labor,Mark Costello,REP,70022,3,6,311,320,
Bryan,U.S. Senate,Matt Silverstein,DEM,70022,7,0,125,132,
Bryan,U.S. Senate,Jim Inhofe,REP,70022,5,6,365,376,
Bryan,U.S. Senate,Aaron Delozier,IND,70022,0,0,2,2,
Bryan,U.S. Senate,Ray Woods,IND,70022,1,0,8,9,
Bryan,U.S. Senate,Joan Farr,IND,70022,0,0,6,6,
Bryan,U.S. Senate,Connie Johnson,DEM,70022,10,0,135,145,
Bryan,U.S. Senate,James Lankford,REP,70022,3,6,337,346,
Bryan,U.S. Senate,Mark Beard,IND,70022,0,0,25,25,
Bryan,U.S. House,Earl Everett,DEM,70022,6,0,125,131,02
Bryan,U.S. House,Markwayne Mullin,REP,70022,6,6,366,378,02
Bryan,U.S. House,Jon Douthitt,IND,70022,1,0,13,14,02
Bryan,State Senate,Joe Hill,DEM,70022,8,0,210,218,6
Bryan,State Senate,Josh Brecheen,REP,70022,4,6,292,302,6
Bryan,State Senate,Vicki Gaylor,IND,70022,1,0,7,8,6
Bryan,Governor,Joe Dorman,DEM,70023,0,1,87,88,
Bryan,Governor,Mary Fallin,REP,70023,1,2,90,93,
Bryan,Governor,Kimberly Willis,IND,70023,0,0,3,3,
Bryan,Governor,Richard Prawdzienski,IND,70023,0,0,3,3,
Bryan,Lieutenant Governor,Cathy Cummings,DEM,70023,0,1,77,78,
Bryan,Lieutenant Governor,Todd Lamb,REP,70023,1,2,102,105,
Bryan,Superintendent of Public Instruction,John Cox,DEM,70023,0,1,101,102,
Bryan,Superintendent of Public Instruction,Joy Hofmeister,REP,70023,1,2,79,82,
Bryan,Commissioner of Labor,Mike Workman,DEM,70023,0,1,87,88,
Bryan,Commissioner of Labor,Mark Costello,REP,70023,1,2,87,90,
Bryan,U.S. Senate,Matt Silverstein,DEM,70023,0,1,54,55,
Bryan,U.S. Senate,Jim Inhofe,REP,70023,1,2,120,123,
Bryan,U.S. Senate,Aaron Delozier,IND,70023,0,0,2,2,
Bryan,U.S. Senate,Ray Woods,IND,70023,0,0,4,4,
Bryan,U.S. Senate,Joan Farr,IND,70023,0,0,1,1,
Bryan,U.S. Senate,Connie Johnson,DEM,70023,0,1,73,74,
Bryan,U.S. Senate,James Lankford,REP,70023,1,2,100,103,
Bryan,U.S. Senate,Mark Beard,IND,70023,0,0,7,7,
Bryan,U.S. House,Earl Everett,DEM,70023,0,1,58,59,02
Bryan,U.S. House,Markwayne Mullin,REP,70023,1,2,116,119,02
Bryan,U.S. House,Jon Douthitt,IND,70023,0,0,7,7,02
Bryan,State Senate,Joe Hill,DEM,70023,0,1,83,84,6
Bryan,State Senate,Josh Brecheen,REP,70023,1,2,97,100,6
Bryan,State Senate,Vicki Gaylor,IND,70023,0,0,3,3,6
Bryan,Governor,Joe Dorman,DEM,70025,4,15,234,253,
Bryan,Governor,Mary Fallin,REP,70025,9,14,235,258,
Bryan,Governor,Kimberly Willis,IND,70025,0,1,19,20,
Bryan,Governor,Richard Prawdzienski,IND,70025,0,0,8,8,
Bryan,Lieutenant Governor,Cathy Cummings,DEM,70025,5,9,181,195,
Bryan,Lieutenant Governor,Todd Lamb,REP,70025,8,21,316,345,
Bryan,Superintendent of Public Instruction,John Cox,DEM,70025,5,14,231,250,
Bryan,Superintendent of Public Instruction,Joy Hofmeister,REP,70025,8,16,259,283,
Bryan,Commissioner of Labor,Mike Workman,DEM,70025,5,9,195,209,
Bryan,Commissioner of Labor,Mark Costello,REP,70025,8,18,290,316,
Bryan,U.S. Senate,Matt Silverstein,DEM,70025,4,12,132,148,
Bryan,U.S. Senate,Jim Inhofe,REP,70025,9,17,342,368,
Bryan,U.S. Senate,Aaron Delozier,IND,70025,0,0,4,4,
Bryan,U.S. Senate,Ray Woods,IND,70025,0,0,8,8,
Bryan,U.S. Senate,Joan Farr,IND,70025,0,1,8,9,
Bryan,U.S. Senate,Connie Johnson,DEM,70025,5,9,159,173,
Bryan,U.S. Senate,James Lankford,REP,70025,8,20,310,338,
Bryan,U.S. Senate,Mark Beard,IND,70025,0,0,23,23,
Bryan,U.S. House,Earl Everett,DEM,70025,5,9,134,148,02
Bryan,U.S. House,Markwayne Mullin,REP,70025,8,20,335,363,02
Bryan,U.S. House,Jon Douthitt,IND,70025,0,1,22,23,02
Bryan,State Senate,Joe Hill,DEM,70025,6,13,209,228,6
Bryan,State Senate,Josh Brecheen,REP,70025,7,17,268,292,6
Bryan,State Senate,Vicki Gaylor,IND,70025,0,0,20,20,6
Bryan,Governor,Joe Dorman,DEM,70026,0,11,111,122,
Bryan,Governor,Mary Fallin,REP,70026,3,5,130,138,
Bryan,Governor,Kimberly Willis,IND,70026,0,0,3,3,
Bryan,Governor,Richard Prawdzienski,IND,70026,0,0,2,2,
Bryan,Lieutenant Governor,Cathy Cummings,DEM,70026,0,5,78,83,
Bryan,Lieutenant Governor,Todd Lamb,REP,70026,3,11,164,178,
Bryan,Superintendent of Public Instruction,John Cox,DEM,70026,0,9,114,123,
Bryan,Superintendent of Public Instruction,Joy Hofmeister,REP,70026,3,7,128,138,
Bryan,Commissioner of Labor,Mike Workman,DEM,70026,0,8,77,85,
Bryan,Commissioner of Labor,Mark Costello,REP,70026,3,8,160,171,
Bryan,U.S. Senate,Matt Silverstein,DEM,70026,0,3,51,54,
Bryan,U.S. Senate,Jim Inhofe,REP,70026,3,12,183,198,
Bryan,U.S. Senate,Aaron Delozier,IND,70026,0,1,2,3,
Bryan,U.S. Senate,Ray Woods,IND,70026,0,0,1,1,
Bryan,U.S. Senate,Joan Farr,IND,70026,0,0,5,5,
Bryan,U.S. Senate,Connie Johnson,DEM,70026,0,3,57,60,
Bryan,U.S. Senate,James Lankford,REP,70026,3,12,174,189,
Bryan,U.S. Senate,Mark Beard,IND,70026,0,1,9,10,
Bryan,U.S. House,Earl Everett,DEM,70026,0,3,54,57,02
Bryan,U.S. House,Markwayne Mullin,REP,70026,3,13,179,195,02
Bryan,U.S. House,Jon Douthitt,IND,70026,0,0,9,9,02
Bryan,State Senate,Joe Hill,DEM,70026,0,7,106,113,6
Bryan,State Senate,Josh Brecheen,REP,70026,3,9,131,143,6
Bryan,State Senate,Vicki Gaylor,IND,70026,0,0,8,8,6
Bryan,Governor,Joe Dorman,DEM,70027,0,18,216,234,
Bryan,Governor,Mary Fallin,REP,70027,8,34,272,314,
Bryan,Governor,Kimberly Willis,IND,70027,0,1,10,11,
Bryan,Governor,Richard Prawdzienski,IND,70027,0,0,4,4,
Bryan,Lieutenant Governor,Cathy Cummings,DEM,70027,0,12,153,165,
Bryan,Lieutenant Governor,Todd Lamb,REP,70027,8,40,344,392,
Bryan,Superintendent of Public Instruction,John Cox,DEM,70027,0,19,219,238,
Bryan,Superintendent of Public Instruction,Joy Hofmeister,REP,70027,8,34,275,317,
Bryan,Commissioner of Labor,Mike Workman,DEM,70027,0,15,184,199,
Bryan,Commissioner of Labor,Mark Costello,REP,70027,8,36,308,352,
Bryan,U.S. Senate,Matt Silverstein,DEM,70027,0,10,109,119,
Bryan,U.S. Senate,Jim Inhofe,REP,70027,8,44,375,427,
Bryan,U.S. Senate,Aaron Delozier,IND,70027,0,0,6,6,
Bryan,U.S. Senate,Ray Woods,IND,70027,0,0,8,8,
Bryan,U.S. Senate,Joan Farr,IND,70027,0,0,4,4,
Bryan,U.S. Senate,Connie Johnson,DEM,70027,0,13,125,138,
Bryan,U.S. Senate,James Lankford,REP,70027,8,39,355,402,
Bryan,U.S. Senate,Mark Beard,IND,70027,0,0,17,17,
Bryan,U.S. House,Earl Everett,DEM,70027,0,10,103,113,02
Bryan,U.S. House,Markwayne Mullin,REP,70027,8,42,374,424,02
Bryan,U.S. House,Jon Douthitt,IND,70027,0,0,17,17,02
Bryan,State Senate,Joe Hill,DEM,70027,0,21,228,249,6
Bryan,State Senate,Josh Brecheen,REP,70027,8,34,268,310,6
Bryan,State Senate,Vicki Gaylor,IND,70027,0,0,8,8,6
Bryan,Governor,Joe Dorman,DEM,70028,3,12,171,186,
Bryan,Governor,Mary Fallin,REP,70028,0,10,186,196,
Bryan,Governor,Kimberly Willis,IND,70028,0,1,4,5,
Bryan,Governor,Richard Prawdzienski,IND,70028,0,2,8,10,
Bryan,Lieutenant Governor,Cathy Cummings,DEM,70028,2,7,116,125,
Bryan,Lieutenant Governor,Todd Lamb,REP,70028,1,18,244,263,
Bryan,Superintendent of Public Instruction,John Cox,DEM,70028,2,13,187,202,
Bryan,Superintendent of Public Instruction,Joy Hofmeister,REP,70028,1,12,175,188,
Bryan,Commissioner of Labor,Mike Workman,DEM,70028,2,12,157,171,
Bryan,Commissioner of Labor,Mark Costello,REP,70028,1,11,199,211,
Bryan,U.S. Senate,Matt Silverstein,DEM,70028,2,6,86,94,
Bryan,U.S. Senate,Jim Inhofe,REP,70028,1,17,263,281,
Bryan,U.S. Senate,Aaron Delozier,IND,70028,0,0,1,1,
Bryan,U.S. Senate,Ray Woods,IND,70028,0,1,10,11,
Bryan,U.S. Senate,Joan Farr,IND,70028,0,1,3,4,
Bryan,U.S. Senate,Connie Johnson,DEM,70028,2,8,96,106,
Bryan,U.S. Senate,James Lankford,REP,70028,1,13,241,255,
Bryan,U.S. Senate,Mark Beard,IND,70028,0,3,24,27,
Bryan,U.S. House,Earl Everett,DEM,70028,2,6,80,88,02
Bryan,U.S. House,Markwayne Mullin,REP,70028,1,17,263,281,02
Bryan,U.S. House,Jon Douthitt,IND,70028,0,2,18,20,02
Bryan,State Senate,Joe Hill,DEM,70028,2,16,159,177,6
Bryan,State Senate,Josh Brecheen,REP,70028,1,8,207,216,6
Bryan,State Senate,Vicki Gaylor,IND,70028,0,1,7,8,6
Bryan,Governor,Joe Dorman,DEM,70029,0,6,80,86,
Bryan,Governor,Mary Fallin,REP,70029,0,0,27,27,
Bryan,Governor,Kimberly Willis,IND,70029,0,0,1,1,
Bryan,Governor,Richard Prawdzienski,IND,70029,0,0,3,3,
Bryan,Lieutenant Governor,Cathy Cummings,DEM,70029,0,4,68,72,
Bryan,Lieutenant Governor,Todd Lamb,REP,70029,0,0,41,41,
Bryan,Superintendent of Public Instruction,John Cox,DEM,70029,0,6,80,86,
Bryan,Superintendent of Public Instruction,Joy Hofmeister,REP,70029,0,0,28,28,
Bryan,Commissioner of Labor,Mike Workman,DEM,70029,0,3,69,72,
Bryan,Commissioner of Labor,Mark Costello,REP,70029,0,1,37,38,
Bryan,U.S. Senate,Matt Silverstein,DEM,70029,0,3,52,55,
Bryan,U.S. Senate,Jim Inhofe,REP,70029,0,1,55,56,
Bryan,U.S. Senate,Aaron Delozier,IND,70029,0,0,1,1,
Bryan,U.S. Senate,Ray Woods,IND,70029,0,0,1,1,
Bryan,U.S. Senate,Joan Farr,IND,70029,0,0,2,2,
Bryan,U.S. Senate,Connie Johnson,DEM,70029,0,3,55,58,
Bryan,U.S. Senate,James Lankford,REP,70029,0,2,49,51,
Bryan,U.S. Senate,Mark Beard,IND,70029,0,0,5,5,
Bryan,U.S. House,Earl Everett,DEM,70029,0,3,44,47,02
Bryan,U.S. House,Markwayne Mullin,REP,70029,0,1,62,63,02
Bryan,U.S. House,Jon Douthitt,IND,70029,0,0,2,2,02
Bryan,State Senate,Joe Hill,DEM,70029,0,5,83,88,6
Bryan,State Senate,Josh Brecheen,REP,70029,0,1,27,28,6
Bryan,State Senate,Vicki Gaylor,IND,70029,0,0,1,1,6
Bryan,Governor,Joe Dorman,DEM,70033,3,29,375,407,
Bryan,Governor,Mary Fallin,REP,70033,16,43,446,505,
Bryan,Governor,Kimberly Willis,IND,70033,0,1,11,12,
Bryan,Governor,Richard Prawdzienski,IND,70033,0,0,5,5,
Bryan,Lieutenant Governor,Cathy Cummings,DEM,70033,1,21,223,245,
Bryan,Lieutenant Governor,Todd Lamb,REP,70033,18,52,609,679,
Bryan,Superintendent of Public Instruction,John Cox,DEM,70033,3,29,372,404,
Bryan,Superintendent of Public Instruction,Joy Hofmeister,REP,70033,16,42,454,512,
Bryan,Commissioner of Labor,Mike Workman,DEM,70033,2,22,269,293,
Bryan,Commissioner of Labor,Mark Costello,REP,70033,16,50,539,605,
Bryan,U.S. Senate,Matt Silverstein,DEM,70033,1,19,188,208,
Bryan,U.S. Senate,Jim Inhofe,REP,70033,17,54,627,698,
Bryan,U.S. Senate,Aaron Delozier,IND,70033,0,0,7,7,
Bryan,U.S. Senate,Ray Woods,IND,70033,1,0,9,10,
Bryan,U.S. Senate,Joan Farr,IND,70033,0,0,5,5,
Bryan,U.S. Senate,Connie Johnson,DEM,70033,1,19,183,203,
Bryan,U.S. Senate,James Lankford,REP,70033,17,53,614,684,
Bryan,U.S. Senate,Mark Beard,IND,70033,0,0,31,31,
Bryan,U.S. House,Earl Everett,DEM,70033,1,19,165,185,02
Bryan,U.S. House,Markwayne Mullin,REP,70033,16,52,638,706,02
Bryan,U.S. House,Jon Douthitt,IND,70033,0,1,27,28,02
Bryan,State Senate,Joe Hill,DEM,70033,2,31,393,426,6
Bryan,State Senate,Josh Brecheen,REP,70033,17,42,444,503,6
Bryan,State Senate,Vicki Gaylor,IND,70033,0,0,5,5,6
Caddo,Governor,Joe Dorman,DEM,80012,2,6,126,134,
Caddo,Governor,Mary Fallin,REP,80012,1,2,37,40,
Caddo,Governor,Kimberly Willis,IND,80012,0,0,3,3,
Caddo,Governor,Richard Prawdzienski,IND,80012,0,0,1,1,
Caddo,Lieutenant Governor,Cathy Cummings,DEM,80012,1,5,108,114,
Caddo,Lieutenant Governor,Todd Lamb,REP,80012,2,3,58,63,
Caddo,Superintendent of Public Instruction,John Cox,DEM,80012,2,6,115,123,
Caddo,Superintendent of Public Instruction,Joy Hofmeister,REP,80012,1,2,51,54,
Caddo,Commissioner of Labor,Mike Workman,DEM,80012,1,5,115,121,
Caddo,Commissioner of Labor,Mark Costello,REP,80012,2,3,50,55,
Caddo,U.S. Senate,Matt Silverstein,DEM,80012,1,5,96,102,
Caddo,U.S. Senate,Jim Inhofe,REP,80012,2,3,64,69,
Caddo,U.S. Senate,Aaron Delozier,IND,80012,0,0,1,1,
Caddo,U.S. Senate,Ray Woods,IND,80012,0,0,2,2,
Caddo,U.S. Senate,Joan Farr,IND,80012,0,0,2,2,
Caddo,U.S. Senate,Connie Johnson,DEM,80012,1,5,97,103,
Caddo,U.S. Senate,James Lankford,REP,80012,2,3,65,70,
Caddo,U.S. Senate,Mark Beard,IND,80012,0,0,5,5,
Caddo,U.S. House,Frankie Robbins,DEM,80012,1,5,92,98,03
Caddo,U.S. House,Frank Lucas,REP,80012,2,3,74,79,03
Caddo,State Senate,Kevin Black,DEM,80012,1,6,120,127,26
Caddo,State Senate,Darcy Jech,REP,80012,2,2,45,49,26
Caddo,State House,David Perryman,DEM,80012,2,6,133,141,56
Caddo,State House,Chuck Utsler,REP,80012,1,2,33,36,56
Caddo,Governor,Joe Dorman,DEM,80022,5,13,123,141,
Caddo,Governor,Mary Fallin,REP,80022,2,18,75,95,
Caddo,Governor,Kimberly Willis,IND,80022,0,0,3,3,
Caddo,Governor,Richard Prawdzienski,IND,80022,0,1,0,1,
Caddo,Lieutenant Governor,Cathy Cummings,DEM,80022,3,12,104,119,
Caddo,Lieutenant Governor,Todd Lamb,REP,80022,5,20,96,121,
Caddo,Superintendent of Public Instruction,John Cox,DEM,80022,5,17,133,155,
Caddo,Superintendent of Public Instruction,Joy Hofmeister,REP,80022,3,15,67,85,
Caddo,Commissioner of Labor,Mike Workman,DEM,80022,5,15,119,139,
Caddo,Commissioner of Labor,Mark Costello,REP,80022,3,17,79,99,
Caddo,U.S. Senate,Matt Silverstein,DEM,80022,3,12,93,108,
Caddo,U.S. Senate,Jim Inhofe,REP,80022,4,20,101,125,
Caddo,U.S. Senate,Aaron Delozier,IND,80022,0,0,0,0,
Caddo,U.S. Senate,Ray Woods,IND,80022,0,0,4,4,
Caddo,U.S. Senate,Joan Farr,IND,80022,1,0,1,2,
Caddo,U.S. Senate,Connie Johnson,DEM,80022,4,12,90,106,
Caddo,U.S. Senate,James Lankford,REP,80022,4,19,105,128,
Caddo,U.S. Senate,Mark Beard,IND,80022,0,1,4,5,
Caddo,U.S. House,Frankie Robbins,DEM,80022,4,12,88,104,03
Caddo,U.S. House,Frank Lucas,REP,80022,4,20,111,135,03
Caddo,State Senate,Kevin Black,DEM,80022,6,14,127,147,26
Caddo,State Senate,Darcy Jech,REP,80022,2,18,74,94,26
Caddo,State House,David Perryman,DEM,80022,8,19,148,175,56
Caddo,State House,Chuck Utsler,REP,80022,0,13,53,66,56
Caddo,Governor,Joe Dorman,DEM,80031,2,12,87,101,
Caddo,Governor,Mary Fallin,REP,80031,4,5,41,50,
Caddo,Governor,Kimberly Willis,IND,80031,0,0,5,5,
Caddo,Governor,Richard Prawdzienski,IND,80031,0,0,1,1,
Caddo,Lieutenant Governor,Cathy Cummings,DEM,80031,2,8,74,84,
Caddo,Lieutenant Governor,Todd Lamb,REP,80031,4,8,60,72,
Caddo,Superintendent of Public Instruction,John Cox,DEM,80031,2,14,89,105,
Caddo,Superintendent of Public Instruction,Joy Hofmeister,REP,80031,2,3,44,49,
Caddo,Commissioner of Labor,Mike Workman,DEM,80031,2,12,80,94,
Caddo,Commissioner of Labor,Mark Costello,REP,80031,2,5,53,60,
Caddo,U.S. Senate,Matt Silverstein,DEM,80031,2,5,67,74,
Caddo,U.S. Senate,Jim Inhofe,REP,80031,4,12,63,79,
Caddo,U.S. Senate,Aaron Delozier,IND,80031,0,0,0,0,
Caddo,U.S. Senate,Ray Woods,IND,80031,0,0,3,3,
Caddo,U.S. Senate,Joan Farr,IND,80031,0,0,0,0,
Caddo,U.S. Senate,Connie Johnson,DEM,80031,2,6,68,76,
Caddo,U.S. Senate,James Lankford,REP,80031,4,11,65,80,
Caddo,U.S. Senate,Mark Beard,IND,80031,0,0,1,1,
Caddo,U.S. House,Frankie Robbins,DEM,80031,3,6,63,72,03
Caddo,U.S. House,Frank Lucas,REP,80031,3,11,70,84,03
Caddo,State Senate,Kevin Black,DEM,80031,2,8,90,100,26
Caddo,State Senate,Darcy Jech,REP,80031,3,9,44,56,26
Caddo,State House,David Perryman,DEM,80031,4,15,93,112,56
Caddo,State House,Chuck Utsler,REP,80031,2,2,41,45,56
Caddo,Governor,Joe Dorman,DEM,80041,8,22,205,235,
Caddo,Governor,Mary Fallin,REP,80041,7,24,157,188,
Caddo,Governor,Kimberly Willis,IND,80041,1,0,6,7,
Caddo,Governor,Richard Prawdzienski,IND,80041,1,2,6,9,
Caddo,Lieutenant Governor,Cathy Cummings,DEM,80041,7,13,154,174,
Caddo,Lieutenant Governor,Todd Lamb,REP,80041,10,35,222,267,
Caddo,Superintendent of Public Instruction,John Cox,DEM,80041,10,29,206,245,
Caddo,Superintendent of Public Instruction,Joy Hofmeister,REP,80041,7,19,166,192,
Caddo,Commissioner of Labor,Mike Workman,DEM,80041,9,22,209,240,
Caddo,Commissioner of Labor,Mark Costello,REP,80041,8,26,165,199,
Caddo,U.S. Senate,Matt Silverstein,DEM,80041,5,12,108,125,
Caddo,U.S. Senate,Jim Inhofe,REP,80041,10,36,246,292,
Caddo,U.S. Senate,Aaron Delozier,IND,80041,1,0,5,6,
Caddo,U.S. Senate,Ray Woods,IND,80041,1,0,12,13,
Caddo,U.S. Senate,Joan Farr,IND,80041,0,0,3,3,
Caddo,U.S. Senate,Connie Johnson,DEM,80041,7,12,127,146,
Caddo,U.S. Senate,James Lankford,REP,80041,9,35,232,276,
Caddo,U.S. Senate,Mark Beard,IND,80041,1,1,14,16,
Caddo,U.S. House,Frankie Robbins,DEM,80041,7,13,114,134,03
Caddo,U.S. House,Frank Lucas,REP,80041,9,35,258,302,03
Caddo,State Senate,Kevin Black,DEM,80041,9,24,222,255,26
Caddo,State Senate,Darcy Jech,REP,80041,8,24,151,183,26
Caddo,State House,David Perryman,DEM,80041,9,31,251,291,56
Caddo,State House,Chuck Utsler,REP,80041,8,17,125,150,56
Caddo,Governor,Joe Dorman,DEM,80051,6,25,295,326,
Caddo,Governor,Mary Fallin,REP,80051,5,20,229,254,
Caddo,Governor,Kimberly Willis,IND,80051,0,1,5,6,
Caddo,Governor,Richard Prawdzienski,IND,80051,0,0,3,3,
Caddo,Lieutenant Governor,Cathy Cummings,DEM,80051,3,21,214,238,
Caddo,Lieutenant Governor,Todd Lamb,REP,80051,8,25,317,350,
Caddo,Superintendent of Public Instruction,John Cox,DEM,80051,5,28,331,364,
Caddo,Superintendent of Public Instruction,Joy Hofmeister,REP,80051,6,18,200,224,
Caddo,Commissioner of Labor,Mike Workman,DEM,80051,3,26,290,319,
Caddo,Commissioner of Labor,Mark Costello,REP,80051,8,20,233,261,
Caddo,U.S. Senate,Matt Silverstein,DEM,80051,4,18,183,205,
Caddo,U.S. Senate,Jim Inhofe,REP,80051,7,26,334,367,
Caddo,U.S. Senate,Aaron Delozier,IND,80051,0,0,3,3,
Caddo,U.S. Senate,Ray Woods,IND,80051,0,1,5,6,
Caddo,U.S. Senate,Joan Farr,IND,80051,0,1,7,8,
Caddo,U.S. Senate,Connie Johnson,DEM,80051,2,21,180,203,
Caddo,U.S. Senate,James Lankford,REP,80051,9,25,334,368,
Caddo,U.S. Senate,Mark Beard,IND,80051,0,1,21,22,
Caddo,U.S. House,Frankie Robbins,DEM,80051,2,19,177,198,03
Caddo,U.S. House,Frank Lucas,REP,80051,9,28,354,391,03
Caddo,State Senate,Kevin Black,DEM,80051,3,26,285,314,26
Caddo,State Senate,Darcy Jech,REP,80051,8,21,246,275,26
Caddo,State House,David Perryman,DEM,80051,5,37,379,421,56
Caddo,State House,Chuck Utsler,REP,80051,6,10,154,170,56
Caddo,Governor,Joe Dorman,DEM,80102,8,14,254,276,
Caddo,Governor,Mary Fallin,REP,80102,4,12,235,251,
Caddo,Governor,Kimberly Willis,IND,80102,1,0,5,6,
Caddo,Governor,Richard Prawdzienski,IND,80102,0,0,0,0,
Caddo,Lieutenant Governor,Cathy Cummings,DEM,80102,7,9,163,179,
Caddo,Lieutenant Governor,Todd Lamb,REP,80102,4,17,328,349,
Caddo,Superintendent of Public Instruction,John Cox,DEM,80102,7,18,256,281,
Caddo,Superintendent of Public Instruction,Joy Hofmeister,REP,80102,6,8,234,248,
Caddo,Commissioner of Labor,Mike Workman,DEM,80102,9,11,221,241,
Caddo,Commissioner of Labor,Mark Costello,REP,80102,4,13,260,277,
Caddo,U.S. Senate,Matt Silverstein,DEM,80102,7,5,140,152,
Caddo,U.S. Senate,Jim Inhofe,REP,80102,6,21,332,359,
Caddo,U.S. Senate,Aaron Delozier,IND,80102,0,0,11,11,
Caddo,U.S. Senate,Ray Woods,IND,80102,0,0,5,5,
Caddo,U.S. Senate,Joan Farr,IND,80102,0,0,3,3,
Caddo,U.S. Senate,Connie Johnson,DEM,80102,8,5,126,139,
Caddo,U.S. Senate,James Lankford,REP,80102,4,21,353,378,
Caddo,U.S. Senate,Mark Beard,IND,80102,1,0,8,9,
Caddo,U.S. House,Frankie Robbins,DEM,80102,7,5,126,138,03
Caddo,U.S. House,Frank Lucas,REP,80102,6,21,365,392,03
Caddo,State Senate,Kevin Black,DEM,80102,8,9,256,273,26
Caddo,State Senate,Darcy Jech,REP,80102,5,17,230,252,26
Caddo,Governor,Joe Dorman,DEM,80509,0,1,133,134,
Caddo,Governor,Mary Fallin,REP,80509,2,3,91,96,
Caddo,Governor,Kimberly Willis,IND,80509,0,0,3,3,
Caddo,Governor,Richard Prawdzienski,IND,80509,0,0,1,1,
Caddo,Lieutenant Governor,Cathy Cummings,DEM,80509,0,0,78,78,
Caddo,Lieutenant Governor,Todd Lamb,REP,80509,2,4,151,157,
Caddo,Superintendent of Public Instruction,John Cox,DEM,80509,0,2,127,129,
Caddo,Superintendent of Public Instruction,Joy Hofmeister,REP,80509,2,2,101,105,
Caddo,Commissioner of Labor,Mike Workman,DEM,80509,1,0,108,109,
Caddo,Commissioner of Labor,Mark Costello,REP,80509,1,4,119,124,
Caddo,U.S. Senate,Matt Silverstein,DEM,80509,0,1,58,59,
Caddo,U.S. Senate,Jim Inhofe,REP,80509,2,3,157,162,
Caddo,U.S. Senate,Aaron Delozier,IND,80509,0,0,1,1,
Caddo,U.S. Senate,Ray Woods,IND,80509,0,0,9,9,
Caddo,U.S. Senate,Joan Farr,IND,80509,0,0,3,3,
Caddo,U.S. Senate,Connie Johnson,DEM,80509,0,0,60,60,
Caddo,U.S. Senate,James Lankford,REP,80509,2,4,159,165,
Caddo,U.S. Senate,Mark Beard,IND,80509,0,0,9,9,
Caddo,U.S. House,Frankie Robbins,DEM,80509,0,1,67,68,03
Caddo,U.S. House,Frank Lucas,REP,80509,2,3,163,168,03
Caddo,State Senate,Kevin Black,DEM,80509,0,0,115,115,26
Caddo,State Senate,Darcy Jech,REP,80509,2,4,114,120,26
Caddo,State House,Toni Hasenbeck,DEM,80509,1,0,127,128,65
Caddo,State House,Scooter Park,REP,80509,1,4,102,107,65
Caddo,Governor,Joe Dorman,DEM,80510,5,7,243,255,
Caddo,Governor,Mary Fallin,REP,80510,6,2,171,179,
Caddo,Governor,Kimberly Willis,IND,80510,0,0,3,3,
Caddo,Governor,Richard Prawdzienski,IND,80510,0,0,1,1,
Caddo,Lieutenant Governor,Cathy Cummings,DEM,80510,2,0,124,126,
Caddo,Lieutenant Governor,Todd Lamb,REP,80510,9,9,293,311,
Caddo,Superintendent of Public Instruction,John Cox,DEM,80510,3,3,231,237,
Caddo,Superintendent of Public Instruction,Joy Hofmeister,REP,80510,8,6,183,197,
Caddo,Commissioner of Labor,Mike Workman,DEM,80510,2,5,159,166,
Caddo,Commissioner of Labor,Mark Costello,REP,80510,9,4,244,257,
Caddo,U.S. Senate,Matt Silverstein,DEM,80510,3,1,96,100,
Caddo,U.S. Senate,Jim Inhofe,REP,80510,8,7,305,320,
Caddo,U.S. Senate,Aaron Delozier,IND,80510,0,0,3,3,
Caddo,U.S. Senate,Ray Woods,IND,80510,0,0,5,5,
Caddo,U.S. Senate,Joan Farr,IND,80510,0,1,3,4,
Caddo,U.S. Senate,Connie Johnson,DEM,80510,2,0,92,94,
Caddo,U.S. Senate,James Lankford,REP,80510,8,9,317,334,
Caddo,U.S. Senate,Mark Beard,IND,80510,0,0,6,6,
Caddo,U.S. House,Frankie Robbins,DEM,80510,2,2,100,104,03
Caddo,U.S. House,Frank Lucas,REP,80510,8,7,313,328,03
Caddo,State Senate,Kevin Black,DEM,80510,3,2,178,183,26
Caddo,State Senate,Darcy Jech,REP,80510,8,7,227,242,26
Caddo,State House,Toni Hasenbeck,DEM,80510,3,6,215,224,65
Caddo,State House,Scooter Park,REP,80510,8,2,199,209,65
Caddo,Governor,Joe Dorman,DEM,80511,11,7,404,422,
Caddo,Governor,Mary Fallin,REP,80511,4,2,161,167,
Caddo,Governor,Kimberly Willis,IND,80511,0,0,6,6,
Caddo,Governor,Richard Prawdzienski,IND,80511,0,0,2,2,
Caddo,Lieutenant Governor,Cathy Cummings,DEM,80511,6,4,202,212,
Caddo,Lieutenant Governor,Todd Lamb,REP,80511,8,5,365,378,
Caddo,Superintendent of Public Instruction,John Cox,DEM,80511,10,6,342,358,
Caddo,Superintendent of Public Instruction,Joy Hofmeister,REP,80511,5,3,225,233,
Caddo,Commissioner of Labor,Mike Workman,DEM,80511,7,6,265,278,
Caddo,Commissioner of Labor,Mark Costello,REP,80511,8,3,278,289,
Caddo,U.S. Senate,Matt Silverstein,DEM,80511,5,3,150,158,
Caddo,U.S. Senate,Jim Inhofe,REP,80511,8,6,404,418,
Caddo,U.S. Senate,Aaron Delozier,IND,80511,0,0,3,3,
Caddo,U.S. Senate,Ray Woods,IND,80511,0,0,4,4,
Caddo,U.S. Senate,Joan Farr,IND,80511,1,0,8,9,
Caddo,U.S. Senate,Connie Johnson,DEM,80511,6,5,157,168,
Caddo,U.S. Senate,James Lankford,REP,80511,9,4,393,406,
Caddo,U.S. Senate,Mark Beard,IND,80511,0,0,18,18,
Caddo,U.S. House,Frankie Robbins,DEM,80511,7,3,160,170,03
Caddo,U.S. House,Frank Lucas,REP,80511,7,6,406,419,03
Caddo,State Senate,Kevin Black,DEM,80511,10,6,309,325,26
Caddo,State Senate,Darcy Jech,REP,80511,4,3,256,263,26
Caddo,State House,Toni Hasenbeck,DEM,80511,11,7,301,319,65
Caddo,State House,Scooter Park,REP,80511,3,2,263,268,65
Caddo,Governor,Joe Dorman,DEM,80712,4,7,218,229,
Caddo,Governor,Mary Fallin,REP,80712,1,5,104,110,
Caddo,Governor,Kimberly Willis,IND,80712,0,0,4,4,
Caddo,Governor,Richard Prawdzienski,IND,80712,0,0,1,1,
Caddo,Lieutenant Governor,Cathy Cummings,DEM,80712,3,4,104,111,
Caddo,Lieutenant Governor,Todd Lamb,REP,80712,2,8,222,232,
Caddo,Superintendent of Public Instruction,John Cox,DEM,80712,4,7,223,234,
Caddo,Superintendent of Public Instruction,Joy Hofmeister,REP,80712,1,5,102,108,
Caddo,Commissioner of Labor,Mike Workman,DEM,80712,4,8,168,180,
Caddo,Commissioner of Labor,Mark Costello,REP,80712,1,4,148,153,
Caddo,U.S. Senate,Matt Silverstein,DEM,80712,2,5,85,92,
Caddo,U.S. Senate,Jim Inhofe,REP,80712,3,7,232,242,
Caddo,U.S. Senate,Aaron Delozier,IND,80712,0,0,1,1,
Caddo,U.S. Senate,Ray Woods,IND,80712,0,0,3,3,
Caddo,U.S. Senate,Joan Farr,IND,80712,0,0,3,3,
Caddo,U.S. Senate,Connie Johnson,DEM,80712,2,2,78,82,
Caddo,U.S. Senate,James Lankford,REP,80712,3,10,240,253,
Caddo,U.S. Senate,Mark Beard,IND,80712,0,0,7,7,
Caddo,U.S. House,Frankie Robbins,DEM,80712,1,0,76,77,03
Caddo,U.S. House,Frank Lucas,REP,80712,4,12,250,266,03
Caddo,State Senate,Kevin Black,DEM,80712,4,8,179,191,26
Caddo,State Senate,Darcy Jech,REP,80712,1,4,144,149,26
Caddo,State House,David Perryman,DEM,80712,4,10,258,272,56
Caddo,State House,Chuck Utsler,REP,80712,1,2,69,72,56
Caddo,Governor,Joe Dorman,DEM,80715,2,1,32,35,
Caddo,Governor,Mary Fallin,REP,80715,0,1,27,28,
Caddo,Governor,Kimberly Willis,IND,80715,0,0,0,0,
Caddo,Governor,Richard Prawdzienski,IND,80715,0,0,1,1,
Caddo,Lieutenant Governor,Cathy Cummings,DEM,80715,0,0,22,22,
Caddo,Lieutenant Governor,Todd Lamb,REP,80715,2,2,37,41,
Caddo,Superintendent of Public Instruction,John Cox,DEM,80715,0,1,36,37,
Caddo,Superintendent of Public Instruction,Joy Hofmeister,REP,80715,2,1,24,27,
Caddo,Commissioner of Labor,Mike Workman,DEM,80715,0,2,32,34,
Caddo,Commissioner of Labor,Mark Costello,REP,80715,2,0,25,27,
Caddo,U.S. Senate,Matt Silverstein,DEM,80715,0,0,24,24,
Caddo,U.S. Senate,Jim Inhofe,REP,80715,2,2,34,38,
Caddo,U.S. Senate,Aaron Delozier,IND,80715,0,0,0,0,
Caddo,U.S. Senate,Ray Woods,IND,80715,0,0,1,1,
Caddo,U.S. Senate,Joan Farr,IND,80715,0,0,1,1,
Caddo,U.S. Senate,Connie Johnson,DEM,80715,0,2,21,23,
Caddo,U.S. Senate,James Lankford,REP,80715,2,0,37,39,
Caddo,U.S. Senate,Mark Beard,IND,80715,0,0,1,1,
Caddo,U.S. House,Frankie Robbins,DEM,80715,0,0,21,21,03
Caddo,U.S. House,Frank Lucas,REP,80715,2,2,39,43,03
Caddo,State Senate,Kevin Black,DEM,80715,0,2,31,33,26
Caddo,State Senate,Darcy Jech,REP,80715,2,0,27,29,26
Caddo,State House,David Perryman,DEM,80715,2,2,46,50,56
Caddo,State House,Chuck Utsler,REP,80715,0,0,13,13,56
Caddo,Governor,Joe Dorman,DEM,80810,1,3,44,48,
Caddo,Governor,Mary Fallin,REP,80810,2,1,68,71,
Caddo,Governor,Kimberly Willis,IND,80810,0,0,2,2,
Caddo,Governor,Richard Prawdzienski,IND,80810,0,0,2,2,
Caddo,Lieutenant Governor,Cathy Cummings,DEM,80810,0,1,24,25,
Caddo,Lieutenant Governor,Todd Lamb,REP,80810,3,3,89,95,
Caddo,Superintendent of Public Instruction,John Cox,DEM,80810,2,3,66,71,
Caddo,Superintendent of Public Instruction,Joy Hofmeister,REP,80810,1,1,50,52,
Caddo,Commissioner of Labor,Mike Workman,DEM,80810,0,2,44,46,
Caddo,Commissioner of Labor,Mark Costello,REP,80810,1,2,66,69,
Caddo,U.S. Senate,Matt Silverstein,DEM,80810,0,1,20,21,
Caddo,U.S. Senate,Jim Inhofe,REP,80810,3,3,91,97,
Caddo,U.S. Senate,Aaron Delozier,IND,80810,0,0,0,0,
Caddo,U.S. Senate,Ray Woods,IND,80810,0,0,4,4,
Caddo,U.S. Senate,Joan Farr,IND,80810,0,0,0,0,
Caddo,U.S. Senate,Connie Johnson,DEM,80810,0,1,23,24,
Caddo,U.S. Senate,James Lankford,REP,80810,3,3,89,95,
Caddo,U.S. Senate,Mark Beard,IND,80810,0,0,1,1,
Caddo,U.S. House,Frankie Robbins,DEM,80810,0,0,20,20,03
Caddo,U.S. House,Frank Lucas,REP,80810,3,4,95,102,03
Caddo,State Senate,Kevin Black,DEM,80810,1,1,44,46,26
Caddo,State Senate,Darcy Jech,REP,80810,2,3,70,75,26
Caddo,State House,David Perryman,DEM,80810,1,3,76,80,56
Caddo,State House,Chuck Utsler,REP,80810,2,1,40,43,56
Caddo,Governor,Joe Dorman,DEM,80811,2,13,110,125,
Caddo,Governor,Mary Fallin,REP,80811,6,13,89,108,
Caddo,Governor,Kimberly Willis,IND,80811,0,0,5,5,
Caddo,Governor,Richard Prawdzienski,IND,80811,0,1,0,1,
Caddo,Lieutenant Governor,Cathy Cummings,DEM,80811,2,12,72,86,
Caddo,Lieutenant Governor,Todd Lamb,REP,80811,5,15,130,150,
Caddo,Superintendent of Public Instruction,John Cox,DEM,80811,3,18,119,140,
Caddo,Superintendent of Public Instruction,Joy Hofmeister,REP,80811,5,9,82,96,
Caddo,Commissioner of Labor,Mike Workman,DEM,80811,4,17,113,134,
Caddo,Commissioner of Labor,Mark Costello,REP,80811,4,10,84,98,
Caddo,U.S. Senate,Matt Silverstein,DEM,80811,1,10,52,63,
Caddo,U.S. Senate,Jim Inhofe,REP,80811,7,16,144,167,
Caddo,U.S. Senate,Aaron Delozier,IND,80811,0,0,0,0,
Caddo,U.S. Senate,Ray Woods,IND,80811,0,0,3,3,
Caddo,U.S. Senate,Joan Farr,IND,80811,0,1,1,2,
Caddo,U.S. Senate,Connie Johnson,DEM,80811,1,11,57,69,
Caddo,U.S. Senate,James Lankford,REP,80811,7,16,142,165,
Caddo,U.S. Senate,Mark Beard,IND,80811,0,0,3,3,
Caddo,U.S. House,Frankie Robbins,DEM,80811,2,10,48,60,03
Caddo,U.S. House,Frank Lucas,REP,80811,6,17,153,176,03
Caddo,State Senate,Kevin Black,DEM,80811,2,17,98,117,26
Caddo,State Senate,Darcy Jech,REP,80811,6,10,102,118,26
Caddo,State House,David Perryman,DEM,80811,1,22,128,151,56
Caddo,State House,Chuck Utsler,REP,80811,7,5,73,85,56
Caddo,Governor,Joe Dorman,DEM,80812,3,3,60,66,
Caddo,Governor,Mary Fallin,REP,80812,2,5,67,74,
Caddo,Governor,Kimberly Willis,IND,80812,0,0,3,3,
Caddo,Governor,Richard Prawdzienski,IND,80812,0,0,1,1,
Caddo,Lieutenant Governor,Cathy Cummings,DEM,80812,2,3,43,48,
Caddo,Lieutenant Governor,Todd Lamb,REP,80812,3,5,86,94,
Caddo,Superintendent of Public Instruction,John Cox,DEM,80812,3,6,66,75,
Caddo,Superintendent of Public Instruction,Joy Hofmeister,REP,80812,2,2,65,69,
Caddo,Commissioner of Labor,Mike Workman,DEM,80812,2,5,56,63,
Caddo,Commissioner of Labor,Mark Costello,REP,80812,3,3,69,75,
Caddo,U.S. Senate,Matt Silverstein,DEM,80812,2,2,41,45,
Caddo,U.S. Senate,Jim Inhofe,REP,80812,3,6,85,94,
Caddo,U.S. Senate,Aaron Delozier,IND,80812,0,0,0,0,
Caddo,U.S. Senate,Ray Woods,IND,80812,0,0,3,3,
Caddo,U.S. Senate,Joan Farr,IND,80812,0,0,1,1,
Caddo,U.S. Senate,Connie Johnson,DEM,80812,2,2,36,40,
Caddo,U.S. Senate,James Lankford,REP,80812,3,6,91,100,
Caddo,U.S. Senate,Mark Beard,IND,80812,0,0,4,4,
Caddo,U.S. House,Frankie Robbins,DEM,80812,1,2,37,40,03
Caddo,U.S. House,Frank Lucas,REP,80812,4,6,94,104,03
Caddo,State Senate,Kevin Black,DEM,80812,2,5,58,65,26
Caddo,State Senate,Darcy Jech,REP,80812,3,3,73,79,26
Caddo,State House,David Perryman,DEM,80812,4,6,79,89,56
Caddo,State House,Chuck Utsler,REP,80812,1,2,51,54,56
Caddo,Governor,Joe Dorman,DEM,81009,0,2,52,54,
Caddo,Governor,Mary Fallin,REP,81009,2,5,110,117,
Caddo,Governor,Kimberly Willis,IND,81009,0,0,2,2,
Caddo,Governor,Richard Prawdzienski,IND,81009,0,0,0,0,
Caddo,Lieutenant Governor,Cathy Cummings,DEM,81009,0,2,37,39,
Caddo,Lieutenant Governor,Todd Lamb,REP,81009,2,5,125,132,
Caddo,Superintendent of Public Instruction,John Cox,DEM,81009,0,2,69,71,
Caddo,Superintendent of Public Instruction,Joy Hofmeister,REP,81009,2,5,95,102,
Caddo,Commissioner of Labor,Mike Workman,DEM,81009,0,2,47,49,
Caddo,Commissioner of Labor,Mark Costello,REP,81009,2,5,114,121,
Caddo,U.S. Senate,Matt Silverstein,DEM,81009,0,0,33,33,
Caddo,U.S. Senate,Jim Inhofe,REP,81009,2,7,123,132,
Caddo,U.S. Senate,Aaron Delozier,IND,81009,0,0,0,0,
Caddo,U.S. Senate,Ray Woods,IND,81009,0,0,1,1,
Caddo,U.S. Senate,Joan Farr,IND,81009,0,0,3,3,
Caddo,U.S. Senate,Connie Johnson,DEM,81009,0,1,30,31,
Caddo,U.S. Senate,James Lankford,REP,81009,2,6,126,134,
Caddo,U.S. Senate,Mark Beard,IND,81009,0,0,7,7,
Caddo,U.S. House,Frankie Robbins,DEM,81009,0,1,32,33,03
Caddo,U.S. House,Frank Lucas,REP,81009,2,6,131,139,03
Caddo,State Senate,Kevin Black,DEM,81009,0,1,46,47,26
Caddo,State Senate,Darcy Jech,REP,81009,2,6,116,124,26
Caddo,State House,David Perryman,DEM,81009,0,2,59,61,56
Caddo,State House,Chuck Utsler,REP,81009,2,5,104,111,56
Caddo,Governor,Joe Dorman,DEM,81010,0,4,105,109,
Caddo,Governor,Mary Fallin,REP,81010,3,2,119,124,
Caddo,Governor,Kimberly Willis,IND,81010,0,0,1,1,
Caddo,Governor,Richard Prawdzienski,IND,81010,0,0,2,2,
Caddo,Lieutenant Governor,Cathy Cummings,DEM,81010,1,1,66,68,
Caddo,Lieutenant Governor,Todd Lamb,REP,81010,2,5,157,164,
Caddo,Superintendent of Public Instruction,John Cox,DEM,81010,1,5,136,142,
Caddo,Superintendent of Public Instruction,Joy Hofmeister,REP,81010,2,1,87,90,
Caddo,Commissioner of Labor,Mike Workman,DEM,81010,1,3,101,105,
Caddo,Commissioner of Labor,Mark Costello,REP,81010,2,3,115,120,
Caddo,U.S. Senate,Matt Silverstein,DEM,81010,1,1,57,59,
Caddo,U.S. Senate,Jim Inhofe,REP,81010,2,4,163,169,
Caddo,U.S. Senate,Aaron Delozier,IND,81010,0,0,1,1,
Caddo,U.S. Senate,Ray Woods,IND,81010,0,0,3,3,
Caddo,U.S. Senate,Joan Farr,IND,81010,0,0,1,1,
Caddo,U.S. Senate,Connie Johnson,DEM,81010,1,1,48,50,
Caddo,U.S. Senate,James Lankford,REP,81010,1,5,170,176,
Caddo,U.S. Senate,Mark Beard,IND,81010,1,0,5,6,
Caddo,U.S. House,Frankie Robbins,DEM,81010,2,1,55,58,03
Caddo,U.S. House,Frank Lucas,REP,81010,1,5,170,176,03
Caddo,State Senate,Kevin Black,DEM,81010,1,4,103,108,26
Caddo,State Senate,Darcy Jech,REP,81010,2,2,120,124,26
Caddo,State House,David Perryman,DEM,81010,1,4,150,155,56
Caddo,State House,Chuck Utsler,REP,81010,2,2,75,79,56
Caddo,Governor,Joe Dorman,DEM,81011,2,0,81,83,
Caddo,Governor,Mary Fallin,REP,81011,1,1,106,108,
Caddo,Governor,Kimberly Willis,IND,81011,0,0,7,7,
Caddo,Governor,Richard Prawdzienski,IND,81011,0,0,0,0,
Caddo,Lieutenant Governor,Cathy Cummings,DEM,81011,2,0,46,48,
Caddo,Lieutenant Governor,Todd Lamb,REP,81011,1,1,147,149,
Caddo,Superintendent of Public Instruction,John Cox,DEM,81011,2,1,97,100,
Caddo,Superintendent of Public Instruction,Joy Hofmeister,REP,81011,1,0,98,99,
Caddo,Commissioner of Labor,Mike Workman,DEM,81011,2,0,82,84,
Caddo,Commissioner of Labor,Mark Costello,REP,81011,1,1,111,113,
Caddo,U.S. Senate,Matt Silverstein,DEM,81011,0,0,44,44,
Caddo,U.S. Senate,Jim Inhofe,REP,81011,3,1,149,153,
Caddo,U.S. Senate,Aaron Delozier,IND,81011,0,0,1,1,
Caddo,U.S. Senate,Ray Woods,IND,81011,0,0,0,0,
Caddo,U.S. Senate,Joan Farr,IND,81011,0,0,0,0,
Caddo,U.S. Senate,Connie Johnson,DEM,81011,0,0,41,41,
Caddo,U.S. Senate,James Lankford,REP,81011,3,1,154,158,
Caddo,U.S. Senate,Mark Beard,IND,81011,0,0,1,1,
Caddo,U.S. House,Frankie Robbins,DEM,81011,0,0,39,39,03
Caddo,U.S. House,Frank Lucas,REP,81011,3,1,157,161,03
Caddo,State Senate,Kevin Black,DEM,81011,2,0,77,79,26
Caddo,State Senate,Darcy Jech,REP,81011,1,1,115,117,26
Caddo,Governor,Joe Dorman,DEM,81013,5,0,72,77,
Caddo,Governor,Mary Fallin,REP,81013,10,0,99,109,
Caddo,Governor,Kimberly Willis,IND,81013,1,0,2,3,
Caddo,Governor,Richard Prawdzienski,IND,81013,0,0,1,1,
Caddo,Lieutenant Governor,Cathy Cummings,DEM,81013,0,0,37,37,
Caddo,Lieutenant Governor,Todd Lamb,REP,81013,15,0,134,149,
Caddo,Superintendent of Public Instruction,John Cox,DEM,81013,9,0,80,89,
Caddo,Superintendent of Public Instruction,Joy Hofmeister,REP,81013,6,0,91,97,
Caddo,Commissioner of Labor,Mike Workman,DEM,81013,3,0,62,65,
Caddo,Commissioner of Labor,Mark Costello,REP,81013,12,0,104,116,
Caddo,U.S. Senate,Matt Silverstein,DEM,81013,3,0,34,37,
Caddo,U.S. Senate,Jim Inhofe,REP,81013,13,0,136,149,
Caddo,U.S. Senate,Aaron Delozier,IND,81013,0,0,1,1,
Caddo,U.S. Senate,Ray Woods,IND,81013,0,0,2,2,
Caddo,U.S. Senate,Joan Farr,IND,81013,0,0,1,1,
Caddo,U.S. Senate,Connie Johnson,DEM,81013,1,0,31,32,
Caddo,U.S. Senate,James Lankford,REP,81013,15,0,141,156,
Caddo,U.S. Senate,Mark Beard,IND,81013,0,0,1,1,
Caddo,U.S. House,Frankie Robbins,DEM,81013,1,0,30,31,03
Caddo,U.S. House,Frank Lucas,REP,81013,15,0,144,159,03
Caddo,State Senate,Kevin Black,DEM,81013,3,0,59,62,26
Caddo,State Senate,Darcy Jech,REP,81013,12,0,113,125,26
Caddo,Governor,Joe Dorman,DEM,81111,1,3,176,180,
Caddo,Governor,Mary Fallin,REP,81111,9,4,327,340,
Caddo,Governor,Kimberly Willis,IND,81111,0,0,7,7,
Caddo,Governor,Richard Prawdzienski,IND,81111,0,0,4,4,
Caddo,Lieutenant Governor,Cathy Cummings,DEM,81111,0,1,92,93,
Caddo,Lieutenant Governor,Todd Lamb,REP,81111,10,6,422,438,
Caddo,Superintendent of Public Instruction,John Cox,DEM,81111,3,3,224,230,
Caddo,Superintendent of Public Instruction,Joy Hofmeister,REP,81111,7,3,289,299,
Caddo,Commissioner of Labor,Mike Workman,DEM,81111,0,1,151,152,
Caddo,Commissioner of Labor,Mark Costello,REP,81111,10,5,348,363,
Caddo,U.S. Senate,Matt Silverstein,DEM,81111,0,1,78,79,
Caddo,U.S. Senate,Jim Inhofe,REP,81111,10,6,425,441,
Caddo,U.S. Senate,Aaron Delozier,IND,81111,0,0,1,1,
Caddo,U.S. Senate,Ray Woods,IND,81111,0,0,8,8,
Caddo,U.S. Senate,Joan Farr,IND,81111,0,0,1,1,
Caddo,U.S. Senate,Connie Johnson,DEM,81111,0,2,71,73,
Caddo,U.S. Senate,James Lankford,REP,81111,10,5,433,448,
Caddo,U.S. Senate,Mark Beard,IND,81111,0,0,8,8,
Caddo,U.S. House,Frankie Robbins,DEM,81111,0,0,76,76,03
Caddo,U.S. House,Frank Lucas,REP,81111,10,7,436,453,03
Caddo,State Senate,Kevin Black,DEM,81111,1,0,135,136,26
Caddo,State Senate,Darcy Jech,REP,81111,9,7,369,385,26
Caddo,Governor,Joe Dorman,DEM,81213,0,1,51,52,
Caddo,Governor,Mary Fallin,REP,81213,2,0,114,116,
Caddo,Governor,Kimberly Willis,IND,81213,0,0,4,4,
Caddo,Governor,Richard Prawdzienski,IND,81213,0,0,0,0,
Caddo,Lieutenant Governor,Cathy Cummings,DEM,81213,1,1,37,39,
Caddo,Lieutenant Governor,Todd Lamb,REP,81213,1,0,132,133,
Caddo,Superintendent of Public Instruction,John Cox,DEM,81213,1,1,67,69,
Caddo,Superintendent of Public Instruction,Joy Hofmeister,REP,81213,1,0,103,104,
Caddo,Commissioner of Labor,Mike Workman,DEM,81213,1,1,48,50,
Caddo,Commissioner of Labor,Mark Costello,REP,81213,1,0,117,118,
Caddo,U.S. Senate,Matt Silverstein,DEM,81213,0,1,27,28,
Caddo,U.S. Senate,Jim Inhofe,REP,81213,2,0,139,141,
Caddo,U.S. Senate,Aaron Delozier,IND,81213,0,0,3,3,
Caddo,U.S. Senate,Ray Woods,IND,81213,0,0,1,1,
Caddo,U.S. Senate,Joan Farr,IND,81213,0,0,0,0,
Caddo,U.S. Senate,Connie Johnson,DEM,81213,0,0,29,29,
Caddo,U.S. Senate,James Lankford,REP,81213,2,0,137,139,
Caddo,U.S. Senate,Mark Beard,IND,81213,0,1,4,5,
Caddo,U.S. House,Frankie Robbins,DEM,81213,0,1,28,29,03
Caddo,U.S. House,Frank Lucas,REP,81213,2,0,141,143,03
Caddo,State Senate,Kevin Black,DEM,81213,0,1,41,42,26
Caddo,State Senate,Darcy Jech,REP,81213,2,0,128,130,26
Canadian,Governor,Joe Dorman,DEM,90100,4,9,134,147,
Canadian,Governor,Mary Fallin,REP,90100,1,45,262,308,
Canadian,Governor,Kimberly Willis,IND,90100,0,0,8,8,
Canadian,Governor,Richard Prawdzienski,IND,90100,0,0,9,9,
Canadian,Lieutenant Governor,Cathy Cummings,DEM,90100,3,8,104,115,
Canadian,Lieutenant Governor,Todd Lamb,REP,90100,2,45,306,353,
Canadian,Superintendent of Public Instruction,John Cox,DEM,90100,4,25,174,203,
Canadian,Superintendent of Public Instruction,Joy Hofmeister,REP,90100,1,27,231,259,
Canadian,Commissioner of Labor,Mike Workman,DEM,90100,1,12,143,156,
Canadian,Commissioner of Labor,Mark Costello,REP,90100,4,38,260,302,
Canadian,U.S. Senate,Matt Silverstein,DEM,90100,2,5,94,101,
Canadian,U.S. Senate,Jim Inhofe,REP,90100,3,46,287,336,
Canadian,U.S. Senate,Aaron Delozier,IND,90100,0,1,4,5,
Canadian,U.S. Senate,Ray Woods,IND,90100,0,1,10,11,
Canadian,U.S. Senate,Joan Farr,IND,90100,0,0,12,12,
Canadian,U.S. Senate,Connie Johnson,DEM,90100,1,9,90,100,
Canadian,U.S. Senate,James Lankford,REP,90100,4,44,300,348,
Canadian,U.S. Senate,Mark Beard,IND,90100,0,1,20,21,
Canadian,U.S. House,Frankie Robbins,DEM,90100,2,6,105,113,03
Canadian,U.S. House,Frank Lucas,REP,90100,3,48,304,355,03
Canadian,Governor,Joe Dorman,DEM,90102,0,4,37,41,
Canadian,Governor,Mary Fallin,REP,90102,4,8,87,99,
Canadian,Governor,Kimberly Willis,IND,90102,0,0,0,0,
Canadian,Governor,Richard Prawdzienski,IND,90102,0,0,0,0,
Canadian,Lieutenant Governor,Cathy Cummings,DEM,90102,1,3,26,30,
Canadian,Lieutenant Governor,Todd Lamb,REP,90102,3,9,98,110,
Canadian,Superintendent of Public Instruction,John Cox,DEM,90102,3,4,58,65,
Canadian,Superintendent of Public Instruction,Joy Hofmeister,REP,90102,1,7,65,73,
Canadian,Commissioner of Labor,Mike Workman,DEM,90102,1,4,28,33,
Canadian,Commissioner of Labor,Mark Costello,REP,90102,3,7,92,102,
Canadian,U.S. Senate,Matt Silverstein,DEM,90102,0,3,23,26,
Canadian,U.S. Senate,Jim Inhofe,REP,90102,4,8,96,108,
Canadian,U.S. Senate,Aaron Delozier,IND,90102,0,0,2,2,
Canadian,U.S. Senate,Ray Woods,IND,90102,0,0,1,1,
Canadian,U.S. Senate,Joan Farr,IND,90102,0,1,2,3,
Canadian,U.S. Senate,Connie Johnson,DEM,90102,0,4,25,29,
Canadian,U.S. Senate,James Lankford,REP,90102,4,8,97,109,
Canadian,U.S. Senate,Mark Beard,IND,90102,0,0,2,2,
Canadian,U.S. House,Frankie Robbins,DEM,90102,0,3,27,30,03
Canadian,U.S. House,Frank Lucas,REP,90102,4,9,97,110,03
Canadian,Governor,Joe Dorman,DEM,90106,7,18,181,206,
Canadian,Governor,Mary Fallin,REP,90106,4,31,235,270,
Canadian,Governor,Kimberly Willis,IND,90106,0,1,7,8,
Canadian,Governor,Richard Prawdzienski,IND,90106,0,0,1,1,
Canadian,Lieutenant Governor,Cathy Cummings,DEM,90106,6,9,127,142,
Canadian,Lieutenant Governor,Todd Lamb,REP,90106,5,42,292,339,
Canadian,Superintendent of Public Instruction,John Cox,DEM,90106,7,22,196,225,
Canadian,Superintendent of Public Instruction,Joy Hofmeister,REP,90106,4,29,224,257,
Canadian,Commissioner of Labor,Mike Workman,DEM,90106,7,15,150,172,
Canadian,Commissioner of Labor,Mark Costello,REP,90106,3,35,242,280,
Canadian,U.S. Senate,Matt Silverstein,DEM,90106,7,11,108,126,
Canadian,U.S. Senate,Jim Inhofe,REP,90106,4,36,297,337,
Canadian,U.S. Senate,Aaron Delozier,IND,90106,0,0,3,3,
Canadian,U.S. Senate,Ray Woods,IND,90106,0,0,9,9,
Canadian,U.S. Senate,Joan Farr,IND,90106,0,3,4,7,
Canadian,U.S. Senate,Connie Johnson,DEM,90106,7,11,111,129,
Canadian,U.S. Senate,James Lankford,REP,90106,4,37,295,336,
Canadian,U.S. Senate,Mark Beard,IND,90106,0,2,14,16,
Canadian,U.S. House,Frankie Robbins,DEM,90106,5,11,107,123,03
Canadian,U.S. House,Frank Lucas,REP,90106,6,39,307,352,03
Canadian,Governor,Joe Dorman,DEM,90107,0,1,70,71,
Canadian,Governor,Mary Fallin,REP,90107,1,9,137,147,
Canadian,Governor,Kimberly Willis,IND,90107,0,0,1,1,
Canadian,Governor,Richard Prawdzienski,IND,90107,0,0,1,1,
Canadian,Lieutenant Governor,Cathy Cummings,DEM,90107,0,0,53,53,
Canadian,Lieutenant Governor,Todd Lamb,REP,90107,1,10,156,167,
Canadian,Superintendent of Public Instruction,John Cox,DEM,90107,0,1,108,109,
Canadian,Superintendent of Public Instruction,Joy Hofmeister,REP,90107,1,9,102,112,
Canadian,Commissioner of Labor,Mike Workman,DEM,90107,0,3,69,72,
Canadian,Commissioner of Labor,Mark Costello,REP,90107,1,6,135,142,
Canadian,U.S. Senate,Matt Silverstein,DEM,90107,0,0,44,44,
Canadian,U.S. Senate,Jim Inhofe,REP,90107,1,10,159,170,
Canadian,U.S. Senate,Aaron Delozier,IND,90107,0,0,3,3,
Canadian,U.S. Senate,Ray Woods,IND,90107,0,0,1,1,
Canadian,U.S. Senate,Joan Farr,IND,90107,0,0,3,3,
Canadian,U.S. Senate,Connie Johnson,DEM,90107,0,1,43,44,
Canadian,U.S. Senate,James Lankford,REP,90107,1,9,158,168,
Canadian,U.S. Senate,Mark Beard,IND,90107,0,0,9,9,
Canadian,U.S. House,Frankie Robbins,DEM,90107,0,0,50,50,03
Canadian,U.S. House,Frank Lucas,REP,90107,1,10,160,171,03
Canadian,Governor,Joe Dorman,DEM,90109,2,2,29,33,
Canadian,Governor,Mary Fallin,REP,90109,1,9,43,53,
Canadian,Governor,Kimberly Willis,IND,90109,0,0,3,3,
Canadian,Governor,Richard Prawdzienski,IND,90109,0,0,0,0,
Canadian,Lieutenant Governor,Cathy Cummings,DEM,90109,2,0,18,20,
Canadian,Lieutenant Governor,Todd Lamb,REP,90109,1,11,57,69,
Canadian,Superintendent of Public Instruction,John Cox,DEM,90109,2,3,34,39,
Canadian,Superintendent of Public Instruction,Joy Hofmeister,REP,90109,1,8,38,47,
Canadian,Commissioner of Labor,Mike Workman,DEM,90109,2,3,25,30,
Canadian,Commissioner of Labor,Mark Costello,REP,90109,1,8,49,58,
Canadian,U.S. Senate,Matt Silverstein,DEM,90109,2,1,15,18,
Canadian,U.S. Senate,Jim Inhofe,REP,90109,1,10,58,69,
Canadian,U.S. Senate,Aaron Delozier,IND,90109,0,0,0,0,
Canadian,U.S. Senate,Ray Woods,IND,90109,0,0,1,1,
Canadian,U.S. Senate,Joan Farr,IND,90109,0,0,1,1,
Canadian,U.S. Senate,Connie Johnson,DEM,90109,2,0,14,16,
Canadian,U.S. Senate,James Lankford,REP,90109,1,11,59,71,
Canadian,U.S. Senate,Mark Beard,IND,90109,0,0,1,1,
Canadian,U.S. House,Frankie Robbins,DEM,90109,2,0,17,19,03
Canadian,U.S. House,Frank Lucas,REP,90109,1,11,58,70,03
Canadian,Governor,Joe Dorman,DEM,90114,6,8,134,148,
Canadian,Governor,Mary Fallin,REP,90114,14,32,221,267,
Canadian,Governor,Kimberly Willis,IND,90114,0,1,3,4,
Canadian,Governor,Richard Prawdzienski,IND,90114,0,1,4,5,
Canadian,Lieutenant Governor,Cathy Cummings,DEM,90114,6,3,100,109,
Canadian,Lieutenant Governor,Todd Lamb,REP,90114,14,37,262,313,
Canadian,Superintendent of Public Instruction,John Cox,DEM,90114,10,8,159,177,
Canadian,Superintendent of Public Instruction,Joy Hofmeister,REP,90114,10,32,202,244,
Canadian,Commissioner of Labor,Mike Workman,DEM,90114,4,10,109,123,
Canadian,Commissioner of Labor,Mark Costello,REP,90114,14,29,244,287,
Canadian,U.S. Senate,Matt Silverstein,DEM,90114,4,3,84,91,
Canadian,U.S. Senate,Jim Inhofe,REP,90114,16,39,266,321,
Canadian,U.S. Senate,Aaron Delozier,IND,90114,0,0,2,2,
Canadian,U.S. Senate,Ray Woods,IND,90114,0,0,4,4,
Canadian,U.S. Senate,Joan Farr,IND,90114,0,0,5,5,
Canadian,U.S. Senate,Connie Johnson,DEM,90114,4,3,89,96,
Canadian,U.S. Senate,James Lankford,REP,90114,14,38,262,314,
Canadian,U.S. Senate,Mark Beard,IND,90114,0,0,10,10,
Canadian,U.S. House,Frankie Robbins,DEM,90114,5,4,89,98,03
Canadian,U.S. House,Frank Lucas,REP,90114,13,38,271,322,03
Canadian,Governor,Joe Dorman,DEM,90116,5,25,210,240,
Canadian,Governor,Mary Fallin,REP,90116,3,26,253,282,
Canadian,Governor,Kimberly Willis,IND,90116,0,0,9,9,
Canadian,Governor,Richard Prawdzienski,IND,90116,0,3,6,9,
Canadian,Lieutenant Governor,Cathy Cummings,DEM,90116,5,18,167,190,
Canadian,Lieutenant Governor,Todd Lamb,REP,90116,3,34,309,346,
Canadian,Superintendent of Public Instruction,John Cox,DEM,90116,5,28,234,267,
Canadian,Superintendent of Public Instruction,Joy Hofmeister,REP,90116,3,26,241,270,
Canadian,Commissioner of Labor,Mike Workman,DEM,90116,5,23,205,233,
Canadian,Commissioner of Labor,Mark Costello,REP,90116,3,27,263,293,
Canadian,U.S. Senate,Matt Silverstein,DEM,90116,5,18,149,172,
Canadian,U.S. Senate,Jim Inhofe,REP,90116,3,33,307,343,
Canadian,U.S. Senate,Aaron Delozier,IND,90116,0,0,6,6,
Canadian,U.S. Senate,Ray Woods,IND,90116,0,1,8,9,
Canadian,U.S. Senate,Joan Farr,IND,90116,0,1,5,6,
Canadian,U.S. Senate,Connie Johnson,DEM,90116,5,18,154,177,
Canadian,U.S. Senate,James Lankford,REP,90116,3,32,305,340,
Canadian,U.S. Senate,Mark Beard,IND,90116,0,3,19,22,
Canadian,U.S. House,Frankie Robbins,DEM,90116,5,17,147,169,03
Canadian,U.S. House,Frank Lucas,REP,90116,3,37,332,372,03
Canadian,Governor,Joe Dorman,DEM,90124,7,21,212,240,
Canadian,Governor,Mary Fallin,REP,90124,7,34,390,431,
Canadian,Governor,Kimberly Willis,IND,90124,0,0,11,11,
Canadian,Governor,Richard Prawdzienski,IND,90124,0,0,8,8,
Canadian,Lieutenant Governor,Cathy Cummings,DEM,90124,4,18,165,187,
Canadian,Lieutenant Governor,Todd Lamb,REP,90124,10,38,456,504,
Canadian,Superintendent of Public Instruction,John Cox,DEM,90124,6,29,271,306,
Canadian,Superintendent of Public Instruction,Joy Hofmeister,REP,90124,8,27,346,381,
Canadian,Commissioner of Labor,Mike Workman,DEM,90124,4,22,206,232,
Canadian,Commissioner of Labor,Mark Costello,REP,90124,10,29,401,440,
Canadian,U.S. Senate,Matt Silverstein,DEM,90124,3,18,149,170,
Canadian,U.S. Senate,Jim Inhofe,REP,90124,11,37,447,495,
Canadian,U.S. Senate,Aaron Delozier,IND,90124,0,0,5,5,
Canadian,U.S. Senate,Ray Woods,IND,90124,0,0,12,12,
Canadian,U.S. Senate,Joan Farr,IND,90124,0,1,5,6,
Canadian,U.S. Senate,Connie Johnson,DEM,90124,3,15,151,169,
Canadian,U.S. Senate,James Lankford,REP,90124,10,39,453,502,
Canadian,U.S. Senate,Mark Beard,IND,90124,0,1,18,19,
Canadian,U.S. House,Frankie Robbins,DEM,90124,3,14,152,169,03
Canadian,U.S. House,Frank Lucas,REP,90124,10,38,467,515,03
Canadian,Governor,Joe Dorman,DEM,90200,20,10,556,586,
Canadian,Governor,Mary Fallin,REP,90200,41,30,1127,1198,
Canadian,Governor,Kimberly Willis,IND,90200,0,0,29,29,
Canadian,Governor,Richard Prawdzienski,IND,90200,0,0,18,18,
Canadian,Lieutenant Governor,Cathy Cummings,DEM,90200,14,7,387,408,
Canadian,Lieutenant Governor,Todd Lamb,REP,90200,47,33,1331,1411,
Canadian,Superintendent of Public Instruction,John Cox,DEM,90200,18,6,577,601,
Canadian,Superintendent of Public Instruction,Joy Hofmeister,REP,90200,42,31,1140,1213,
Canadian,Commissioner of Labor,Mike Workman,DEM,90200,14,8,418,440,
Canadian,Commissioner of Labor,Mark Costello,REP,90200,45,31,1265,1341,
Canadian,U.S. Senate,Matt Silverstein,DEM,90200,14,7,324,345,
Canadian,U.S. Senate,Jim Inhofe,REP,90200,46,32,1338,1416,
Canadian,U.S. Senate,Aaron Delozier,IND,90200,0,0,15,15,
Canadian,U.S. Senate,Ray Woods,IND,90200,0,0,15,15,
Canadian,U.S. Senate,Joan Farr,IND,90200,1,1,21,23,
Canadian,U.S. Senate,Connie Johnson,DEM,90200,11,7,336,354,
Canadian,U.S. Senate,James Lankford,REP,90200,49,33,1342,1424,
Canadian,U.S. Senate,Mark Beard,IND,90200,1,0,47,48,
Canadian,U.S. House,Frankie Robbins,DEM,90200,15,5,337,357,03
Canadian,U.S. House,Frank Lucas,REP,90200,45,35,1370,1450,03
Canadian,Governor,Joe Dorman,DEM,90201,11,8,142,161,
Canadian,Governor,Mary Fallin,REP,90201,12,18,448,478,
Canadian,Governor,Kimberly Willis,IND,90201,0,0,12,12,
Canadian,Governor,Richard Prawdzienski,IND,90201,0,0,8,8,
Canadian,Lieutenant Governor,Cathy Cummings,DEM,90201,7,9,97,113,
Canadian,Lieutenant Governor,Todd Lamb,REP,90201,16,17,513,546,
Canadian,Superintendent of Public Instruction,John Cox,DEM,90201,8,11,179,198,
Canadian,Superintendent of Public Instruction,Joy Hofmeister,REP,90201,15,15,429,459,
Canadian,Commissioner of Labor,Mike Workman,DEM,90201,9,8,115,132,
Canadian,Commissioner of Labor,Mark Costello,REP,90201,14,18,486,518,
Canadian,U.S. Senate,Matt Silverstein,DEM,90201,7,4,66,77,
Canadian,U.S. Senate,Jim Inhofe,REP,90201,15,21,521,557,
Canadian,U.S. Senate,Aaron Delozier,IND,90201,1,0,8,9,
Canadian,U.S. Senate,Ray Woods,IND,90201,0,0,7,7,
Canadian,U.S. Senate,Joan Farr,IND,90201,0,0,6,6,
Canadian,U.S. Senate,Connie Johnson,DEM,90201,6,6,71,83,
Canadian,U.S. Senate,James Lankford,REP,90201,16,20,523,559,
Canadian,U.S. Senate,Mark Beard,IND,90201,1,0,18,19,
Canadian,U.S. House,Frankie Robbins,DEM,90201,6,3,74,83,03
Canadian,U.S. House,Frank Lucas,REP,90201,17,23,537,577,03
Canadian,Governor,Joe Dorman,DEM,90202,1,1,46,48,
Canadian,Governor,Mary Fallin,REP,90202,12,2,207,221,
Canadian,Governor,Kimberly Willis,IND,90202,0,0,5,5,
Canadian,Governor,Richard Prawdzienski,IND,90202,0,0,3,3,
Canadian,Lieutenant Governor,Cathy Cummings,DEM,90202,1,2,26,29,
Canadian,Lieutenant Governor,Todd Lamb,REP,90202,12,1,235,248,
Canadian,Superintendent of Public Instruction,John Cox,DEM,90202,1,2,58,61,
Canadian,Superintendent of Public Instruction,Joy Hofmeister,REP,90202,12,1,204,217,
Canadian,Commissioner of Labor,Mike Workman,DEM,90202,1,1,32,34,
Canadian,Commissioner of Labor,Mark Costello,REP,90202,12,2,225,239,
Canadian,U.S. Senate,Matt Silverstein,DEM,90202,1,0,27,28,
Canadian,U.S. Senate,Jim Inhofe,REP,90202,12,2,228,242,
Canadian,U.S. Senate,Aaron Delozier,IND,90202,0,0,1,1,
Canadian,U.S. Senate,Ray Woods,IND,90202,0,0,4,4,
Canadian,U.S. Senate,Joan Farr,IND,90202,0,1,1,2,
Canadian,U.S. Senate,Connie Johnson,DEM,90202,1,1,27,29,
Canadian,U.S. Senate,James Lankford,REP,90202,12,2,232,246,
Canadian,U.S. Senate,Mark Beard,IND,90202,0,0,3,3,
Canadian,U.S. House,Frankie Robbins,DEM,90202,1,1,29,31,03
Canadian,U.S. House,Frank Lucas,REP,90202,12,2,231,245,03
Canadian,Governor,Joe Dorman,DEM,90204,3,4,213,220,
Canadian,Governor,Mary Fallin,REP,90204,7,6,393,406,
Canadian,Governor,Kimberly Willis,IND,90204,0,0,12,12,
Canadian,Governor,Richard Prawdzienski,IND,90204,0,0,6,6,
Canadian,Lieutenant Governor,Cathy Cummings,DEM,90204,2,3,150,155,
Canadian,Lieutenant Governor,Todd Lamb,REP,90204,8,7,473,488,
Canadian,Superintendent of Public Instruction,John Cox,DEM,90204,0,5,207,212,
Canadian,Superintendent of Public Instruction,Joy Hofmeister,REP,90204,10,5,412,427,
Canadian,Commissioner of Labor,Mike Workman,DEM,90204,1,3,150,154,
Canadian,Commissioner of Labor,Mark Costello,REP,90204,9,7,463,479,
Canadian,U.S. Senate,Matt Silverstein,DEM,90204,2,3,116,121,
Canadian,U.S. Senate,Jim Inhofe,REP,90204,8,7,492,507,
Canadian,U.S. Senate,Aaron Delozier,IND,90204,0,0,4,4,
Canadian,U.S. Senate,Ray Woods,IND,90204,0,0,1,1,
Canadian,U.S. Senate,Joan Farr,IND,90204,0,0,11,11,
Canadian,U.S. Senate,Connie Johnson,DEM,90204,3,1,116,120,
Canadian,U.S. Senate,James Lankford,REP,90204,7,9,487,503,
Canadian,U.S. Senate,Mark Beard,IND,90204,0,0,23,23,
Canadian,U.S. House,Frankie Robbins,DEM,90204,3,3,128,134,03
Canadian,U.S. House,Frank Lucas,REP,90204,7,7,494,508,03
Canadian,Governor,Joe Dorman,DEM,90206,9,6,256,271,
Canadian,Governor,Mary Fallin,REP,90206,14,16,536,566,
Canadian,Governor,Kimberly Willis,IND,90206,0,0,14,14,
Canadian,Governor,Richard Prawdzienski,IND,90206,1,0,4,5,
Canadian,Lieutenant Governor,Cathy Cummings,DEM,90206,9,4,171,184,
Canadian,Lieutenant Governor,Todd Lamb,REP,90206,15,18,634,667,
Canadian,Superintendent of Public Instruction,John Cox,DEM,90206,11,10,272,293,
Canadian,Superintendent of Public Instruction,Joy Hofmeister,REP,90206,13,12,534,559,
Canadian,Commissioner of Labor,Mike Workman,DEM,90206,10,4,196,210,
Canadian,Commissioner of Labor,Mark Costello,REP,90206,13,18,599,630,
Canadian,U.S. Senate,Matt Silverstein,DEM,90206,7,4,152,163,
Canadian,U.S. Senate,Jim Inhofe,REP,90206,15,17,635,667,
Canadian,U.S. Senate,Aaron Delozier,IND,90206,1,0,7,8,
Canadian,U.S. Senate,Ray Woods,IND,90206,0,0,5,5,
Canadian,U.S. Senate,Joan Farr,IND,90206,1,1,5,7,
Canadian,U.S. Senate,Connie Johnson,DEM,90206,7,5,159,171,
Canadian,U.S. Senate,James Lankford,REP,90206,17,17,635,669,
Canadian,U.S. Senate,Mark Beard,IND,90206,0,0,17,17,
Canadian,U.S. House,Frankie Robbins,DEM,90206,8,4,158,170,03
Canadian,U.S. House,Frank Lucas,REP,90206,16,18,648,682,03
Canadian,Governor,Joe Dorman,DEM,90208,10,5,251,266,
Canadian,Governor,Mary Fallin,REP,90208,22,5,440,467,
Canadian,Governor,Kimberly Willis,IND,90208,0,1,16,17,
Canadian,Governor,Richard Prawdzienski,IND,90208,0,0,13,13,
Canadian,Lieutenant Governor,Cathy Cummings,DEM,90208,9,3,185,197,
Canadian,Lieutenant Governor,Todd Lamb,REP,90208,23,8,533,564,
Canadian,Superintendent of Public Instruction,John Cox,DEM,90208,15,5,260,280,
Canadian,Superintendent of Public Instruction,Joy Hofmeister,REP,90208,16,6,449,471,
Canadian,Commissioner of Labor,Mike Workman,DEM,90208,12,3,219,234,
Canadian,Commissioner of Labor,Mark Costello,REP,90208,18,7,484,509,
Canadian,U.S. Senate,Matt Silverstein,DEM,90208,8,4,173,185,
Canadian,U.S. Senate,Jim Inhofe,REP,90208,24,6,509,539,
Canadian,U.S. Senate,Aaron Delozier,IND,90208,0,1,8,9,
Canadian,U.S. Senate,Ray Woods,IND,90208,0,0,14,14,
Canadian,U.S. Senate,Joan Farr,IND,90208,0,0,9,9,
Canadian,U.S. Senate,Connie Johnson,DEM,90208,10,3,175,188,
Canadian,U.S. Senate,James Lankford,REP,90208,22,6,522,550,
Canadian,U.S. Senate,Mark Beard,IND,90208,0,2,21,23,
Canadian,U.S. House,Frankie Robbins,DEM,90208,8,4,185,197,03
Canadian,U.S. House,Frank Lucas,REP,90208,23,7,532,562,03
Canadian,State House,Sarah Baker,DEM,90208,11,3,246,260,43
Canadian,State House,John Paul Jordan,REP,90208,19,8,463,490,43
Canadian,Governor,Joe Dorman,DEM,90209,0,0,15,15,
Canadian,Governor,Mary Fallin,REP,90209,0,0,13,13,
Canadian,Governor,Kimberly Willis,IND,90209,0,0,1,1,
Canadian,Governor,Richard Prawdzienski,IND,90209,0,0,1,1,
Canadian,Lieutenant Governor,Cathy Cummings,DEM,90209,0,0,11,11,
Canadian,Lieutenant Governor,Todd Lamb,REP,90209,0,0,18,18,
Canadian,Superintendent of Public Instruction,John Cox,DEM,90209,0,0,10,10,
Canadian,Superintendent of Public Instruction,Joy Hofmeister,REP,90209,0,0,19,19,
Canadian,Commissioner of Labor,Mike Workman,DEM,90209,0,0,12,12,
Canadian,Commissioner of Labor,Mark Costello,REP,90209,0,0,17,17,
Canadian,U.S. Senate,Matt Silverstein,DEM,90209,0,0,7,7,
Canadian,U.S. Senate,Jim Inhofe,REP,90209,0,0,20,20,
Canadian,U.S. Senate,Aaron Delozier,IND,90209,0,0,0,0,
Canadian,U.S. Senate,Ray Woods,IND,90209,0,0,1,1,
Canadian,U.S. Senate,Joan Farr,IND,90209,0,0,2,2,
Canadian,U.S. Senate,Connie Johnson,DEM,90209,0,0,10,10,
Canadian,U.S. Senate,James Lankford,REP,90209,0,0,17,17,
Canadian,U.S. Senate,Mark Beard,IND,90209,0,0,3,3,
Canadian,U.S. House,Frankie Robbins,DEM,90209,0,0,12,12,03
Canadian,U.S. House,Frank Lucas,REP,90209,0,0,17,17,03
Canadian,Governor,Joe Dorman,DEM,90210,2,2,91,95,
Canadian,Governor,Mary Fallin,REP,90210,11,8,233,252,
Canadian,Governor,Kimberly Willis,IND,90210,0,0,4,4,
Canadian,Governor,Richard Prawdzienski,IND,90210,0,0,0,0,
Canadian,Lieutenant Governor,Cathy Cummings,DEM,90210,1,2,61,64,
Canadian,Lieutenant Governor,Todd Lamb,REP,90210,12,8,265,285,
Canadian,Superintendent of Public Instruction,John Cox,DEM,90210,2,4,98,104,
Canadian,Superintendent of Public Instruction,Joy Hofmeister,REP,90210,11,6,230,247,
Canadian,Commissioner of Labor,Mike Workman,DEM,90210,2,2,69,73,
Canadian,Commissioner of Labor,Mark Costello,REP,90210,11,6,251,268,
Canadian,U.S. Senate,Matt Silverstein,DEM,90210,0,2,50,52,
Canadian,U.S. Senate,Jim Inhofe,REP,90210,12,8,271,291,
Canadian,U.S. Senate,Aaron Delozier,IND,90210,0,0,2,2,
Canadian,U.S. Senate,Ray Woods,IND,90210,0,0,3,3,
Canadian,U.S. Senate,Joan Farr,IND,90210,1,0,2,3,
Canadian,U.S. Senate,Connie Johnson,DEM,90210,3,2,49,54,
Canadian,U.S. Senate,James Lankford,REP,90210,10,8,275,293,
Canadian,U.S. Senate,Mark Beard,IND,90210,0,0,5,5,
Canadian,U.S. House,Frankie Robbins,DEM,90210,0,1,51,52,03
Canadian,U.S. House,Frank Lucas,REP,90210,13,9,276,298,03
Canadian,State House,Sarah Baker,DEM,90210,4,2,73,79,43
Canadian,State House,John Paul Jordan,REP,90210,9,8,249,266,43
Canadian,Governor,Joe Dorman,DEM,90211,6,0,80,86,
Canadian,Governor,Mary Fallin,REP,90211,10,4,225,239,
Canadian,Governor,Kimberly Willis,IND,90211,0,0,1,1,
Canadian,Governor,Richard Prawdzienski,IND,90211,0,0,3,3,
Canadian,Lieutenant Governor,Cathy Cummings,DEM,90211,2,0,61,63,
Canadian,Lieutenant Governor,Todd Lamb,REP,90211,14,4,248,266,
Canadian,Superintendent of Public Instruction,John Cox,DEM,90211,4,0,95,99,
Canadian,Superintendent of Public Instruction,Joy Hofmeister,REP,90211,12,4,212,228,
Canadian,Commissioner of Labor,Mike Workman,DEM,90211,3,1,69,73,
Canadian,Commissioner of Labor,Mark Costello,REP,90211,10,3,237,250,
Canadian,U.S. Senate,Matt Silverstein,DEM,90211,3,0,57,60,
Canadian,U.S. Senate,Jim Inhofe,REP,90211,13,4,245,262,
Canadian,U.S. Senate,Aaron Delozier,IND,90211,0,0,1,1,
Canadian,U.S. Senate,Ray Woods,IND,90211,0,0,3,3,
Canadian,U.S. Senate,Joan Farr,IND,90211,0,0,3,3,
Canadian,U.S. Senate,Connie Johnson,DEM,90211,2,0,61,63,
Canadian,U.S. Senate,James Lankford,REP,90211,14,4,244,262,
Canadian,U.S. Senate,Mark Beard,IND,90211,0,0,4,4,
Canadian,U.S. House,Frankie Robbins,DEM,90211,3,0,56,59,03
Canadian,U.S. House,Frank Lucas,REP,90211,13,4,253,270,03
Canadian,Governor,Joe Dorman,DEM,90214,12,5,237,254,
Canadian,Governor,Mary Fallin,REP,90214,21,15,476,512,
Canadian,Governor,Kimberly Willis,IND,90214,0,1,15,16,
Canadian,Governor,Richard Prawdzienski,IND,90214,0,1,11,12,
Canadian,Lieutenant Governor,Cathy Cummings,DEM,90214,8,3,169,180,
Canadian,Lieutenant Governor,Todd Lamb,REP,90214,24,19,571,614,
Canadian,Superintendent of Public Instruction,John Cox,DEM,90214,16,7,253,276,
Canadian,Superintendent of Public Instruction,Joy Hofmeister,REP,90214,17,15,486,518,
Canadian,Commissioner of Labor,Mike Workman,DEM,90214,11,5,192,208,
Canadian,Commissioner of Labor,Mark Costello,REP,90214,20,17,536,573,
Canadian,U.S. Senate,Matt Silverstein,DEM,90214,10,4,141,155,
Canadian,U.S. Senate,Jim Inhofe,REP,90214,23,18,561,602,
Canadian,U.S. Senate,Aaron Delozier,IND,90214,0,0,11,11,
Canadian,U.S. Senate,Ray Woods,IND,90214,0,0,6,6,
Canadian,U.S. Senate,Joan Farr,IND,90214,0,0,14,14,
Canadian,U.S. Senate,Connie Johnson,DEM,90214,12,4,142,158,
Canadian,U.S. Senate,James Lankford,REP,90214,21,18,570,609,
Canadian,U.S. Senate,Mark Beard,IND,90214,0,0,28,28,
Canadian,U.S. House,Frankie Robbins,DEM,90214,9,3,159,171,03
Canadian,U.S. House,Frank Lucas,REP,90214,24,19,575,618,03
Canadian,State House,Sarah Baker,DEM,90214,15,5,214,234,43
Canadian,State House,John Paul Jordan,REP,90214,18,17,516,551,43
Canadian,Governor,Joe Dorman,DEM,90215,16,16,305,337,
Canadian,Governor,Mary Fallin,REP,90215,31,28,517,576,
Canadian,Governor,Kimberly Willis,IND,90215,1,2,23,26,
Canadian,Governor,Richard Prawdzienski,IND,90215,0,0,11,11,
Canadian,Lieutenant Governor,Cathy Cummings,DEM,90215,15,13,220,248,
Canadian,Lieutenant Governor,Todd Lamb,REP,90215,33,33,634,700,
Canadian,Superintendent of Public Instruction,John Cox,DEM,90215,22,16,313,351,
Canadian,Superintendent of Public Instruction,Joy Hofmeister,REP,90215,26,30,533,589,
Canadian,Commissioner of Labor,Mike Workman,DEM,90215,17,19,236,272,
Canadian,Commissioner of Labor,Mark Costello,REP,90215,30,27,608,665,
Canadian,U.S. Senate,Matt Silverstein,DEM,90215,11,13,185,209,
Canadian,U.S. Senate,Jim Inhofe,REP,90215,35,29,632,696,
Canadian,U.S. Senate,Aaron Delozier,IND,90215,0,0,5,5,
Canadian,U.S. Senate,Ray Woods,IND,90215,0,0,11,11,
Canadian,U.S. Senate,Joan Farr,IND,90215,2,4,15,21,
Canadian,U.S. Senate,Connie Johnson,DEM,90215,13,12,193,218,
Canadian,U.S. Senate,James Lankford,REP,90215,34,33,636,703,
Canadian,U.S. Senate,Mark Beard,IND,90215,1,1,22,24,
Canadian,U.S. House,Frankie Robbins,DEM,90215,12,12,197,221,03
Canadian,U.S. House,Frank Lucas,REP,90215,36,34,653,723,03
Canadian,State House,Sarah Baker,DEM,90215,15,16,259,290,43
Canadian,State House,John Paul Jordan,REP,90215,33,30,589,652,43
Canadian,Governor,Joe Dorman,DEM,90216,13,8,305,326,
Canadian,Governor,Mary Fallin,REP,90216,38,23,722,783,
Canadian,Governor,Kimberly Willis,IND,90216,3,0,17,20,
Canadian,Governor,Richard Prawdzienski,IND,90216,0,0,12,12,
Canadian,Lieutenant Governor,Cathy Cummings,DEM,90216,12,8,202,222,
Canadian,Lieutenant Governor,Todd Lamb,REP,90216,42,23,858,923,
Canadian,Superintendent of Public Instruction,John Cox,DEM,90216,13,9,334,356,
Canadian,Superintendent of Public Instruction,Joy Hofmeister,REP,90216,42,21,721,784,
Canadian,Commissioner of Labor,Mike Workman,DEM,90216,11,9,259,279,
Canadian,Commissioner of Labor,Mark Costello,REP,90216,43,22,766,831,
Canadian,U.S. Senate,Matt Silverstein,DEM,90216,9,7,176,192,
Canadian,U.S. Senate,Jim Inhofe,REP,90216,43,23,845,911,
Canadian,U.S. Senate,Aaron Delozier,IND,90216,0,0,7,7,
Canadian,U.S. Senate,Ray Woods,IND,90216,1,0,13,14,
Canadian,U.S. Senate,Joan Farr,IND,90216,1,1,11,13,
Canadian,U.S. Senate,Connie Johnson,DEM,90216,10,7,175,192,
Canadian,U.S. Senate,James Lankford,REP,90216,44,24,862,930,
Canadian,U.S. Senate,Mark Beard,IND,90216,1,0,22,23,
Canadian,U.S. House,Frankie Robbins,DEM,90216,9,6,173,188,03
Canadian,U.S. House,Frank Lucas,REP,90216,46,25,878,949,03
Canadian,State House,Sarah Baker,DEM,90216,10,12,296,318,43
Canadian,State House,John Paul Jordan,REP,90216,45,19,744,808,43
Canadian,Governor,Joe Dorman,DEM,90217,9,2,234,245,
Canadian,Governor,Mary Fallin,REP,90217,39,15,541,595,
Canadian,Governor,Kimberly Willis,IND,90217,0,1,13,14,
Canadian,Governor,Richard Prawdzienski,IND,90217,0,0,15,15,
Canadian,Lieutenant Governor,Cathy Cummings,DEM,90217,8,3,175,186,
Canadian,Lieutenant Governor,Todd Lamb,REP,90217,40,15,624,679,
Canadian,Superintendent of Public Instruction,John Cox,DEM,90217,11,2,241,254,
Canadian,Superintendent of Public Instruction,Joy Hofmeister,REP,90217,36,16,556,608,
Canadian,Commissioner of Labor,Mike Workman,DEM,90217,11,2,177,190,
Canadian,Commissioner of Labor,Mark Costello,REP,90217,36,16,601,653,
Canadian,U.S. Senate,Matt Silverstein,DEM,90217,9,2,147,158,
Canadian,U.S. Senate,Jim Inhofe,REP,90217,38,16,621,675,
Canadian,U.S. Senate,Aaron Delozier,IND,90217,0,0,8,8,
Canadian,U.S. Senate,Ray Woods,IND,90217,0,0,12,12,
Canadian,U.S. Senate,Joan Farr,IND,90217,1,0,8,9,
Canadian,U.S. Senate,Connie Johnson,DEM,90217,7,2,148,157,
Canadian,U.S. Senate,James Lankford,REP,90217,40,16,627,683,
Canadian,U.S. Senate,Mark Beard,IND,90217,1,0,23,24,
Canadian,U.S. House,Frankie Robbins,DEM,90217,7,2,146,155,03
Canadian,U.S. House,Frank Lucas,REP,90217,40,16,644,700,03
Canadian,State House,Sarah Baker,DEM,90217,9,2,197,208,43
Canadian,State House,John Paul Jordan,REP,90217,37,16,588,641,43
Canadian,Governor,Joe Dorman,DEM,90218,7,1,201,209,
Canadian,Governor,Mary Fallin,REP,90218,21,7,389,417,
Canadian,Governor,Kimberly Willis,IND,90218,1,0,16,17,
Canadian,Governor,Richard Prawdzienski,IND,90218,0,0,11,11,
Canadian,Lieutenant Governor,Cathy Cummings,DEM,90218,7,1,132,140,
Canadian,Lieutenant Governor,Todd Lamb,REP,90218,21,7,484,512,
Canadian,Superintendent of Public Instruction,John Cox,DEM,90218,8,2,219,229,
Canadian,Superintendent of Public Instruction,Joy Hofmeister,REP,90218,21,6,398,425,
Canadian,Commissioner of Labor,Mike Workman,DEM,90218,8,1,163,172,
Canadian,Commissioner of Labor,Mark Costello,REP,90218,20,7,449,476,
Canadian,U.S. Senate,Matt Silverstein,DEM,90218,4,1,112,117,
Canadian,U.S. Senate,Jim Inhofe,REP,90218,24,7,471,502,
Canadian,U.S. Senate,Aaron Delozier,IND,90218,0,0,8,8,
Canadian,U.S. Senate,Ray Woods,IND,90218,0,0,12,12,
Canadian,U.S. Senate,Joan Farr,IND,90218,1,0,11,12,
Canadian,U.S. Senate,Connie Johnson,DEM,90218,6,1,117,124,
Canadian,U.S. Senate,James Lankford,REP,90218,21,7,474,502,
Canadian,U.S. Senate,Mark Beard,IND,90218,1,0,27,28,
Canadian,U.S. House,Frankie Robbins,DEM,90218,5,1,131,137,03
Canadian,U.S. House,Frank Lucas,REP,90218,24,7,480,511,03
Canadian,State House,Sarah Baker,DEM,90218,7,1,172,180,43
Canadian,State House,John Paul Jordan,REP,90218,21,7,443,471,43
Canadian,Governor,Joe Dorman,DEM,90220,9,8,331,348,
Canadian,Governor,Mary Fallin,REP,90220,27,12,647,686,
Canadian,Governor,Kimberly Willis,IND,90220,0,0,23,23,
Canadian,Governor,Richard Prawdzienski,IND,90220,0,0,5,5,
Canadian,Lieutenant Governor,Cathy Cummings,DEM,90220,3,8,225,236,
Canadian,Lieutenant Governor,Todd Lamb,REP,90220,31,12,780,823,
Canadian,Superintendent of Public Instruction,John Cox,DEM,90220,16,10,320,346,
Canadian,Superintendent of Public Instruction,Joy Hofmeister,REP,90220,19,9,681,709,
Canadian,Commissioner of Labor,Mike Workman,DEM,90220,8,7,257,272,
Canadian,Commissioner of Labor,Mark Costello,REP,90220,25,12,737,774,
Canadian,U.S. Senate,Matt Silverstein,DEM,90220,7,6,203,216,
Canadian,U.S. Senate,Jim Inhofe,REP,90220,28,13,773,814,
Canadian,U.S. Senate,Aaron Delozier,IND,90220,0,0,5,5,
Canadian,U.S. Senate,Ray Woods,IND,90220,0,0,12,12,
Canadian,U.S. Senate,Joan Farr,IND,90220,1,1,7,9,
Canadian,U.S. Senate,Connie Johnson,DEM,90220,4,7,203,214,
Canadian,U.S. Senate,James Lankford,REP,90220,30,12,777,819,
Canadian,U.S. Senate,Mark Beard,IND,90220,0,0,26,26,
Canadian,U.S. House,Frankie Robbins,DEM,90220,3,7,194,204,03
Canadian,U.S. House,Frank Lucas,REP,90220,31,12,804,847,03
Canadian,State House,Sarah Baker,DEM,90220,6,6,271,283,43
Canadian,State House,John Paul Jordan,REP,90220,25,14,726,765,43
Canadian,Governor,Joe Dorman,DEM,90221,7,3,218,228,
Canadian,Governor,Mary Fallin,REP,90221,10,13,338,361,
Canadian,Governor,Kimberly Willis,IND,90221,1,0,16,17,
Canadian,Governor,Richard Prawdzienski,IND,90221,0,0,12,12,
Canadian,Lieutenant Governor,Cathy Cummings,DEM,90221,6,1,171,178,
Canadian,Lieutenant Governor,Todd Lamb,REP,90221,12,15,411,438,
Canadian,Superintendent of Public Instruction,John Cox,DEM,90221,7,4,215,226,
Canadian,Superintendent of Public Instruction,Joy Hofmeister,REP,90221,11,12,361,384,
Canadian,Commissioner of Labor,Mike Workman,DEM,90221,6,2,174,182,
Canadian,Commissioner of Labor,Mark Costello,REP,90221,12,14,396,422,
Canadian,U.S. Senate,Matt Silverstein,DEM,90221,6,0,147,153,
Canadian,U.S. Senate,Jim Inhofe,REP,90221,12,15,411,438,
Canadian,U.S. Senate,Aaron Delozier,IND,90221,0,1,6,7,
Canadian,U.S. Senate,Ray Woods,IND,90221,0,0,9,9,
Canadian,U.S. Senate,Joan Farr,IND,90221,0,0,6,6,
Canadian,U.S. Senate,Connie Johnson,DEM,90221,6,0,144,150,
Canadian,U.S. Senate,James Lankford,REP,90221,12,15,421,448,
Canadian,U.S. Senate,Mark Beard,IND,90221,0,1,18,19,
Canadian,U.S. House,Frankie Robbins,DEM,90221,5,0,153,158,03
Canadian,U.S. House,Frank Lucas,REP,90221,13,16,428,457,03
Canadian,State House,Sarah Baker,DEM,90221,6,2,203,211,43
Canadian,State House,John Paul Jordan,REP,90221,12,14,372,398,43
Canadian,Governor,Joe Dorman,DEM,90223,18,9,302,329,
Canadian,Governor,Mary Fallin,REP,90223,18,29,521,568,
Canadian,Governor,Kimberly Willis,IND,90223,0,2,19,21,
Canadian,Governor,Richard Prawdzienski,IND,90223,0,0,10,10,
Canadian,Lieutenant Governor,Cathy Cummings,DEM,90223,12,10,223,245,
Canadian,Lieutenant Governor,Todd Lamb,REP,90223,23,30,625,678,
Canadian,Superintendent of Public Instruction,John Cox,DEM,90223,16,11,292,319,
Canadian,Superintendent of Public Instruction,Joy Hofmeister,REP,90223,19,29,558,606,
Canadian,Commissioner of Labor,Mike Workman,DEM,90223,13,9,246,268,
Canadian,Commissioner of Labor,Mark Costello,REP,90223,19,31,597,647,
Canadian,U.S. Senate,Matt Silverstein,DEM,90223,14,8,188,210,
Canadian,U.S. Senate,Jim Inhofe,REP,90223,22,31,631,684,
Canadian,U.S. Senate,Aaron Delozier,IND,90223,0,0,15,15,
Canadian,U.S. Senate,Ray Woods,IND,90223,0,0,7,7,
Canadian,U.S. Senate,Joan Farr,IND,90223,0,1,9,10,
Canadian,U.S. Senate,Connie Johnson,DEM,90223,13,9,189,211,
Canadian,U.S. Senate,James Lankford,REP,90223,22,31,643,696,
Canadian,U.S. Senate,Mark Beard,IND,90223,1,0,19,20,
Canadian,U.S. House,Frankie Robbins,DEM,90223,11,9,200,220,03
Canadian,U.S. House,Frank Lucas,REP,90223,24,31,647,702,03
Canadian,State House,Sarah Baker,DEM,90223,13,9,250,272,43
Canadian,State House,John Paul Jordan,REP,90223,22,31,595,648,43
Canadian,Governor,Joe Dorman,DEM,90224,4,2,120,126,
Canadian,Governor,Mary Fallin,REP,90224,6,5,213,224,
Canadian,Governor,Kimberly Willis,IND,90224,0,0,11,11,
Canadian,Governor,Richard Prawdzienski,IND,90224,0,0,5,5,
Canadian,Lieutenant Governor,Cathy Cummings,DEM,90224,4,2,76,82,
Canadian,Lieutenant Governor,Todd Lamb,REP,90224,6,5,272,283,
Canadian,Superintendent of Public Instruction,John Cox,DEM,90224,3,2,127,132,
Canadian,Superintendent of Public Instruction,Joy Hofmeister,REP,90224,7,5,220,232,
Canadian,Commissioner of Labor,Mike Workman,DEM,90224,3,1,85,89,
Canadian,Commissioner of Labor,Mark Costello,REP,90224,6,6,255,267,
Canadian,U.S. Senate,Matt Silverstein,DEM,90224,3,2,66,71,
Canadian,U.S. Senate,Jim Inhofe,REP,90224,6,5,269,280,
Canadian,U.S. Senate,Aaron Delozier,IND,90224,0,0,4,4,
Canadian,U.S. Senate,Ray Woods,IND,90224,0,0,4,4,
Canadian,U.S. Senate,Joan Farr,IND,90224,0,0,6,6,
Canadian,U.S. Senate,Connie Johnson,DEM,90224,4,2,66,72,
Canadian,U.S. Senate,James Lankford,REP,90224,6,4,274,284,
Canadian,U.S. Senate,Mark Beard,IND,90224,0,1,9,10,
Canadian,U.S. House,Frankie Robbins,DEM,90224,4,2,73,79,03
Canadian,U.S. House,Frank Lucas,REP,90224,6,5,273,284,03
Canadian,State Senate,Michael Brooks-Jimenez,DEM,90224,3,1,99,103,44
Canadian,State Senate,Ralph Shortey,REP,90224,6,4,214,224,44
Canadian,State Senate,Constance Fawcett,IND,90224,0,1,31,32,44
Canadian,State House,Sarah Baker,DEM,90224,3,2,98,103,43
Canadian,State House,John Paul Jordan,REP,90224,6,4,246,256,43
Canadian,Governor,Joe Dorman,DEM,90225,6,8,241,255,
Canadian,Governor,Mary Fallin,REP,90225,19,11,354,384,
Canadian,Governor,Kimberly Willis,IND,90225,0,0,17,17,
Canadian,Governor,Richard Prawdzienski,IND,90225,0,0,6,6,
Canadian,Lieutenant Governor,Cathy Cummings,DEM,90225,7,6,162,175,
Canadian,Lieutenant Governor,Todd Lamb,REP,90225,18,13,452,483,
Canadian,Superintendent of Public Instruction,John Cox,DEM,90225,11,9,235,255,
Canadian,Superintendent of Public Instruction,Joy Hofmeister,REP,90225,14,10,376,400,
Canadian,Commissioner of Labor,Mike Workman,DEM,90225,7,7,174,188,
Canadian,Commissioner of Labor,Mark Costello,REP,90225,18,12,431,461,
Canadian,U.S. Senate,Matt Silverstein,DEM,90225,7,6,142,155,
Canadian,U.S. Senate,Jim Inhofe,REP,90225,18,13,453,484,
Canadian,U.S. Senate,Aaron Delozier,IND,90225,0,0,5,5,
Canadian,U.S. Senate,Ray Woods,IND,90225,0,0,9,9,
Canadian,U.S. Senate,Joan Farr,IND,90225,0,0,3,3,
Canadian,U.S. Senate,Connie Johnson,DEM,90225,8,7,150,165,
Canadian,U.S. Senate,James Lankford,REP,90225,17,10,447,474,
Canadian,U.S. Senate,Mark Beard,IND,90225,0,2,21,23,
Canadian,U.S. House,Frankie Robbins,DEM,90225,7,7,151,165,03
Canadian,U.S. House,Frank Lucas,REP,90225,18,11,463,492,03
Canadian,State Senate,Michael Brooks-Jimenez,DEM,90225,10,7,193,210,44
Canadian,State Senate,Ralph Shortey,REP,90225,15,11,379,405,44
Canadian,State Senate,Constance Fawcett,IND,90225,0,1,38,39,44
Canadian,Governor,Joe Dorman,DEM,90226,2,0,43,45,
Canadian,Governor,Mary Fallin,REP,90226,7,10,135,152,
Canadian,Governor,Kimberly Willis,IND,90226,0,0,2,2,
Canadian,Governor,Richard Prawdzienski,IND,90226,0,0,1,1,
Canadian,Lieutenant Governor,Cathy Cummings,DEM,90226,5,0,28,33,
Canadian,Lieutenant Governor,Todd Lamb,REP,90226,4,10,152,166,
Canadian,Superintendent of Public Instruction,John Cox,DEM,90226,1,3,48,52,
Canadian,Superintendent of Public Instruction,Joy Hofmeister,REP,90226,8,7,132,147,
Canadian,Commissioner of Labor,Mike Workman,DEM,90226,1,2,35,38,
Canadian,Commissioner of Labor,Mark Costello,REP,90226,7,8,140,155,
Canadian,U.S. Senate,Matt Silverstein,DEM,90226,5,0,25,30,
Canadian,U.S. Senate,Jim Inhofe,REP,90226,4,10,151,165,
Canadian,U.S. Senate,Aaron Delozier,IND,90226,0,0,1,1,
Canadian,U.S. Senate,Ray Woods,IND,90226,0,0,1,1,
Canadian,U.S. Senate,Joan Farr,IND,90226,0,0,2,2,
Canadian,U.S. Senate,Connie Johnson,DEM,90226,1,0,30,31,
Canadian,U.S. Senate,James Lankford,REP,90226,7,10,149,166,
Canadian,U.S. Senate,Mark Beard,IND,90226,1,0,3,4,
Canadian,U.S. House,Frankie Robbins,DEM,90226,4,0,29,33,03
Canadian,U.S. House,Frank Lucas,REP,90226,4,10,153,167,03
Canadian,Governor,Joe Dorman,DEM,90227,18,11,294,323,
Canadian,Governor,Mary Fallin,REP,90227,57,20,650,727,
Canadian,Governor,Kimberly Willis,IND,90227,0,0,25,25,
Canadian,Governor,Richard Prawdzienski,IND,90227,0,0,8,8,
Canadian,Lieutenant Governor,Cathy Cummings,DEM,90227,11,7,229,247,
Canadian,Lieutenant Governor,Todd Lamb,REP,90227,63,24,750,837,
Canadian,Superintendent of Public Instruction,John Cox,DEM,90227,27,12,338,377,
Canadian,Superintendent of Public Instruction,Joy Hofmeister,REP,90227,46,19,637,702,
Canadian,Commissioner of Labor,Mike Workman,DEM,90227,15,7,245,267,
Canadian,Commissioner of Labor,Mark Costello,REP,90227,56,23,714,793,
Canadian,U.S. Senate,Matt Silverstein,DEM,90227,16,8,191,215,
Canadian,U.S. Senate,Jim Inhofe,REP,90227,58,23,743,824,
Canadian,U.S. Senate,Aaron Delozier,IND,90227,0,0,8,8,
Canadian,U.S. Senate,Ray Woods,IND,90227,0,0,15,15,
Canadian,U.S. Senate,Joan Farr,IND,90227,0,0,18,18,
Canadian,U.S. Senate,Connie Johnson,DEM,90227,12,6,190,208,
Canadian,U.S. Senate,James Lankford,REP,90227,61,24,763,848,
Canadian,U.S. Senate,Mark Beard,IND,90227,2,0,24,26,
Canadian,U.S. House,Frankie Robbins,DEM,90227,13,7,200,220,03
Canadian,U.S. House,Frank Lucas,REP,90227,60,23,770,853,03
Canadian,State Senate,Michael Brooks-Jimenez,DEM,90227,27,12,288,327,44
Canadian,State Senate,Ralph Shortey,REP,90227,44,17,603,664,44
Canadian,State Senate,Constance Fawcett,IND,90227,4,1,75,80,44
Canadian,Governor,Joe Dorman,DEM,90228,1,3,77,81,
Canadian,Governor,Mary Fallin,REP,90228,6,3,99,108,
Canadian,Governor,Kimberly Willis,IND,90228,0,0,5,5,
Canadian,Governor,Richard Prawdzienski,IND,90228,0,0,5,5,
Canadian,Lieutenant Governor,Cathy Cummings,DEM,90228,1,2,58,61,
Canadian,Lieutenant Governor,Todd Lamb,REP,90228,6,4,129,139,
Canadian,Superintendent of Public Instruction,John Cox,DEM,90228,1,3,76,80,
Canadian,Superintendent of Public Instruction,Joy Hofmeister,REP,90228,5,3,110,118,
Canadian,Commissioner of Labor,Mike Workman,DEM,90228,1,2,60,63,
Canadian,Commissioner of Labor,Mark Costello,REP,90228,6,4,125,135,
Canadian,U.S. Senate,Matt Silverstein,DEM,90228,1,2,52,55,
Canadian,U.S. Senate,Jim Inhofe,REP,90228,6,4,120,130,
Canadian,U.S. Senate,Aaron Delozier,IND,90228,0,0,3,3,
Canadian,U.S. Senate,Ray Woods,IND,90228,0,0,4,4,
Canadian,U.S. Senate,Joan Farr,IND,90228,0,0,5,5,
Canadian,U.S. Senate,Connie Johnson,DEM,90228,1,2,52,55,
Canadian,U.S. Senate,James Lankford,REP,90228,6,4,120,130,
Canadian,U.S. Senate,Mark Beard,IND,90228,0,0,14,14,
Canadian,U.S. House,Frankie Robbins,DEM,90228,1,2,56,59,03
Canadian,U.S. House,Frank Lucas,REP,90228,6,4,130,140,03
Canadian,State Senate,Michael Brooks-Jimenez,DEM,90228,3,4,59,66,44
Canadian,State Senate,Ralph Shortey,REP,90228,4,2,108,114,44
Canadian,State Senate,Constance Fawcett,IND,90228,0,0,17,17,44
Canadian,State House,Sarah Baker,DEM,90228,1,2,62,65,43
Canadian,State House,John Paul Jordan,REP,90228,6,4,121,131,43
Canadian,Governor,Joe Dorman,DEM,90300,6,9,184,199,
Canadian,Governor,Mary Fallin,REP,90300,21,13,485,519,
Canadian,Governor,Kimberly Willis,IND,90300,0,0,17,17,
Canadian,Governor,Richard Prawdzienski,IND,90300,0,0,9,9,
Canadian,Lieutenant Governor,Cathy Cummings,DEM,90300,6,8,122,136,
Canadian,Lieutenant Governor,Todd Lamb,REP,90300,21,14,568,603,
Canadian,Superintendent of Public Instruction,John Cox,DEM,90300,7,9,227,243,
Canadian,Superintendent of Public Instruction,Joy Hofmeister,REP,90300,20,13,463,496,
Canadian,Commissioner of Labor,Mike Workman,DEM,90300,5,8,144,157,
Canadian,Commissioner of Labor,Mark Costello,REP,90300,22,14,527,563,
Canadian,U.S. Senate,Matt Silverstein,DEM,90300,6,9,105,120,
Canadian,U.S. Senate,Jim Inhofe,REP,90300,19,13,561,593,
Canadian,U.S. Senate,Aaron Delozier,IND,90300,0,0,10,10,
Canadian,U.S. Senate,Ray Woods,IND,90300,0,0,10,10,
Canadian,U.S. Senate,Joan Farr,IND,90300,2,0,5,7,
Canadian,U.S. Senate,Connie Johnson,DEM,90300,4,8,113,125,
Canadian,U.S. Senate,James Lankford,REP,90300,23,14,566,603,
Canadian,U.S. Senate,Mark Beard,IND,90300,0,0,14,14,
Canadian,U.S. House,Bert Smith,DEM,90300,5,9,94,108,04
Canadian,U.S. House,Tom Cole,REP,90300,21,13,575,609,04
Canadian,U.S. House,Dennis Johnson,IND,90300,1,0,23,24,04
Canadian,Governor,Joe Dorman,DEM,90301,17,8,263,288,
Canadian,Governor,Mary Fallin,REP,90301,28,15,650,693,
Canadian,Governor,Kimberly Willis,IND,90301,0,0,19,19,
Canadian,Governor,Richard Prawdzienski,IND,90301,1,1,9,11,
Canadian,Lieutenant Governor,Cathy Cummings,DEM,90301,12,6,188,206,
Canadian,Lieutenant Governor,Todd Lamb,REP,90301,33,18,749,800,
Canadian,Superintendent of Public Instruction,John Cox,DEM,90301,17,8,291,316,
Canadian,Superintendent of Public Instruction,Joy Hofmeister,REP,90301,28,16,644,688,
Canadian,Commissioner of Labor,Mike Workman,DEM,90301,13,6,214,233,
Canadian,Commissioner of Labor,Mark Costello,REP,90301,30,18,700,748,
Canadian,U.S. Senate,Matt Silverstein,DEM,90301,10,6,163,179,
Canadian,U.S. Senate,Jim Inhofe,REP,90301,33,18,733,784,
Canadian,U.S. Senate,Aaron Delozier,IND,90301,0,0,8,8,
Canadian,U.S. Senate,Ray Woods,IND,90301,0,0,14,14,
Canadian,U.S. Senate,Joan Farr,IND,90301,3,0,17,20,
Canadian,U.S. Senate,Connie Johnson,DEM,90301,10,6,161,177,
Canadian,U.S. Senate,James Lankford,REP,90301,35,17,757,809,
Canadian,U.S. Senate,Mark Beard,IND,90301,1,1,23,25,
Canadian,U.S. House,Bert Smith,DEM,90301,11,6,137,154,04
Canadian,U.S. House,Tom Cole,REP,90301,34,17,750,801,04
Canadian,U.S. House,Dennis Johnson,IND,90301,1,1,51,53,04
Canadian,Governor,Joe Dorman,DEM,90302,8,3,256,267,
Canadian,Governor,Mary Fallin,REP,90302,20,10,490,520,
Canadian,Governor,Kimberly Willis,IND,90302,1,1,16,18,
Canadian,Governor,Richard Prawdzienski,IND,90302,0,0,9,9,
Canadian,Lieutenant Governor,Cathy Cummings,DEM,90302,9,2,180,191,
Canadian,Lieutenant Governor,Todd Lamb,REP,90302,20,12,595,627,
Canadian,Superintendent of Public Instruction,John Cox,DEM,90302,8,2,247,257,
Canadian,Superintendent of Public Instruction,Joy Hofmeister,REP,90302,21,12,520,553,
Canadian,Commissioner of Labor,Mike Workman,DEM,90302,9,2,202,213,
Canadian,Commissioner of Labor,Mark Costello,REP,90302,20,12,559,591,
Canadian,U.S. Senate,Matt Silverstein,DEM,90302,5,2,146,153,
Canadian,U.S. Senate,Jim Inhofe,REP,90302,22,12,589,623,
Canadian,U.S. Senate,Aaron Delozier,IND,90302,0,0,9,9,
Canadian,U.S. Senate,Ray Woods,IND,90302,1,0,13,14,
Canadian,U.S. Senate,Joan Farr,IND,90302,1,0,10,11,
Canadian,U.S. Senate,Connie Johnson,DEM,90302,5,2,157,164,
Canadian,U.S. Senate,James Lankford,REP,90302,24,12,592,628,
Canadian,U.S. Senate,Mark Beard,IND,90302,0,0,25,25,
Canadian,U.S. House,Bert Smith,DEM,90302,6,2,133,141,04
Canadian,U.S. House,Tom Cole,REP,90302,21,12,597,630,04
Canadian,U.S. House,Dennis Johnson,IND,90302,2,0,40,42,04
Canadian,Governor,Joe Dorman,DEM,90303,10,9,274,293,
Canadian,Governor,Mary Fallin,REP,90303,37,26,660,723,
Canadian,Governor,Kimberly Willis,IND,90303,1,1,11,13,
Canadian,Governor,Richard Prawdzienski,IND,90303,0,0,10,10,
Canadian,Lieutenant Governor,Cathy Cummings,DEM,90303,9,10,193,212,
Canadian,Lieutenant Governor,Todd Lamb,REP,90303,39,26,760,825,
Canadian,Superintendent of Public Instruction,John Cox,DEM,90303,12,12,281,305,
Canadian,Superintendent of Public Instruction,Joy Hofmeister,REP,90303,35,24,669,728,
Canadian,Commissioner of Labor,Mike Workman,DEM,90303,11,7,207,225,
Canadian,Commissioner of Labor,Mark Costello,REP,90303,36,29,729,794,
Canadian,U.S. Senate,Matt Silverstein,DEM,90303,10,7,174,191,
Canadian,U.S. Senate,Jim Inhofe,REP,90303,35,27,756,818,
Canadian,U.S. Senate,Aaron Delozier,IND,90303,1,0,6,7,
Canadian,U.S. Senate,Ray Woods,IND,90303,1,1,10,12,
Canadian,U.S. Senate,Joan Farr,IND,90303,1,1,6,8,
Canadian,U.S. Senate,Connie Johnson,DEM,90303,10,6,170,186,
Canadian,U.S. Senate,James Lankford,REP,90303,36,30,766,832,
Canadian,U.S. Senate,Mark Beard,IND,90303,2,0,20,22,
Canadian,U.S. House,Frankie Robbins,DEM,90303,8,7,169,184,03
Canadian,U.S. House,Frank Lucas,REP,90303,40,29,782,851,03
Canadian,Governor,Joe Dorman,DEM,90304,10,5,223,238,
Canadian,Governor,Mary Fallin,REP,90304,11,8,505,524,
Canadian,Governor,Kimberly Willis,IND,90304,1,0,20,21,
Canadian,Governor,Richard Prawdzienski,IND,90304,1,0,10,11,
Canadian,Lieutenant Governor,Cathy Cummings,DEM,90304,9,3,156,168,
Canadian,Lieutenant Governor,Todd Lamb,REP,90304,14,10,604,628,
Canadian,Superintendent of Public Instruction,John Cox,DEM,90304,6,7,238,251,
Canadian,Superintendent of Public Instruction,Joy Hofmeister,REP,90304,17,6,517,540,
Canadian,Commissioner of Labor,Mike Workman,DEM,90304,8,6,168,182,
Canadian,Commissioner of Labor,Mark Costello,REP,90304,15,7,577,599,
Canadian,U.S. Senate,Matt Silverstein,DEM,90304,8,5,131,144,
Canadian,U.S. Senate,Jim Inhofe,REP,90304,14,7,604,625,
Canadian,U.S. Senate,Aaron Delozier,IND,90304,0,0,7,7,
Canadian,U.S. Senate,Ray Woods,IND,90304,0,1,10,11,
Canadian,U.S. Senate,Joan Farr,IND,90304,1,0,8,9,
Canadian,U.S. Senate,Connie Johnson,DEM,90304,8,6,127,141,
Canadian,U.S. Senate,James Lankford,REP,90304,15,7,602,624,
Canadian,U.S. Senate,Mark Beard,IND,90304,0,0,31,31,
Canadian,U.S. House,Bert Smith,DEM,90304,8,4,122,134,04
Canadian,U.S. House,Tom Cole,REP,90304,14,7,604,625,04
Canadian,U.S. House,Dennis Johnson,IND,90304,1,2,34,37,04
Canadian,Governor,Joe Dorman,DEM,90306,12,11,265,288,
Canadian,Governor,Mary Fallin,REP,90306,52,17,794,863,
Canadian,Governor,Kimberly Willis,IND,90306,1,0,30,31,
Canadian,Governor,Richard Prawdzienski,IND,90306,0,0,9,9,
Canadian,Lieutenant Governor,Cathy Cummings,DEM,90306,7,8,205,220,
Canadian,Lieutenant Governor,Todd Lamb,REP,90306,58,20,895,973,
Canadian,Superintendent of Public Instruction,John Cox,DEM,90306,14,13,314,341,
Canadian,Superintendent of Public Instruction,Joy Hofmeister,REP,90306,51,15,783,849,
Canadian,Commissioner of Labor,Mike Workman,DEM,90306,9,7,227,243,
Canadian,Commissioner of Labor,Mark Costello,REP,90306,56,20,855,931,
Canadian,U.S. Senate,Matt Silverstein,DEM,90306,4,7,177,188,
Canadian,U.S. Senate,Jim Inhofe,REP,90306,60,20,886,966,
Canadian,U.S. Senate,Aaron Delozier,IND,90306,0,0,9,9,
Canadian,U.S. Senate,Ray Woods,IND,90306,0,1,18,19,
Canadian,U.S. Senate,Joan Farr,IND,90306,1,0,9,10,
Canadian,U.S. Senate,Connie Johnson,DEM,90306,3,5,168,176,
Canadian,U.S. Senate,James Lankford,REP,90306,61,23,900,984,
Canadian,U.S. Senate,Mark Beard,IND,90306,1,0,34,35,
Canadian,U.S. House,Bert Smith,DEM,90306,5,7,155,167,04
Canadian,U.S. House,Tom Cole,REP,90306,59,20,890,969,04
Canadian,U.S. House,Dennis Johnson,IND,90306,1,1,51,53,04
Canadian,Governor,Joe Dorman,DEM,90308,4,2,64,70,
Canadian,Governor,Mary Fallin,REP,90308,8,6,213,227,
Canadian,Governor,Kimberly Willis,IND,90308,0,0,5,5,
Canadian,Governor,Richard Prawdzienski,IND,90308,0,0,1,1,
Canadian,Lieutenant Governor,Cathy Cummings,DEM,90308,1,2,41,44,
Canadian,Lieutenant Governor,Todd Lamb,REP,90308,11,6,238,255,
Canadian,Superintendent of Public Instruction,John Cox,DEM,90308,2,3,70,75,
Canadian,Superintendent of Public Instruction,Joy Hofmeister,REP,90308,10,5,213,228,
Canadian,Commissioner of Labor,Mike Workman,DEM,90308,0,1,45,46,
Canadian,Commissioner of Labor,Mark Costello,REP,90308,11,7,230,248,
Canadian,U.S. Senate,Matt Silverstein,DEM,90308,2,1,32,35,
Canadian,U.S. Senate,Jim Inhofe,REP,90308,10,7,244,261,
Canadian,U.S. Senate,Aaron Delozier,IND,90308,0,0,1,1,
Canadian,U.S. Senate,Ray Woods,IND,90308,0,0,3,3,
Canadian,U.S. Senate,Joan Farr,IND,90308,0,0,3,3,
Canadian,U.S. Senate,Connie Johnson,DEM,90308,1,2,31,34,
Canadian,U.S. Senate,James Lankford,REP,90308,11,6,248,265,
Canadian,U.S. Senate,Mark Beard,IND,90308,0,0,4,4,
Canadian,U.S. House,Frankie Robbins,DEM,90308,0,0,33,33,03
Canadian,U.S. House,Frank Lucas,REP,90308,12,8,249,269,03
Canadian,Governor,Joe Dorman,DEM,90309,0,0,8,8,
Canadian,Governor,Mary Fallin,REP,90309,1,2,51,54,
Canadian,Governor,Kimberly Willis,IND,90309,0,0,0,0,
Canadian,Governor,Richard Prawdzienski,IND,90309,0,0,1,1,
Canadian,Lieutenant Governor,Cathy Cummings,DEM,90309,0,0,5,5,
Canadian,Lieutenant Governor,Todd Lamb,REP,90309,1,2,55,58,
Canadian,Superintendent of Public Instruction,John Cox,DEM,90309,0,0,10,10,
Canadian,Superintendent of Public Instruction,Joy Hofmeister,REP,90309,1,2,50,53,
Canadian,Commissioner of Labor,Mike Workman,DEM,90309,0,0,7,7,
Canadian,Commissioner of Labor,Mark Costello,REP,90309,1,2,51,54,
Canadian,U.S. Senate,Matt Silverstein,DEM,90309,0,0,7,7,
Canadian,U.S. Senate,Jim Inhofe,REP,90309,1,2,52,55,
Canadian,U.S. Senate,Aaron Delozier,IND,90309,0,0,1,1,
Canadian,U.S. Senate,Ray Woods,IND,90309,0,0,0,0,
Canadian,U.S. Senate,Joan Farr,IND,90309,0,0,0,0,
Canadian,U.S. Senate,Connie Johnson,DEM,90309,0,0,5,5,
Canadian,U.S. Senate,James Lankford,REP,90309,1,2,53,56,
Canadian,U.S. Senate,Mark Beard,IND,90309,0,0,2,2,
Canadian,U.S. House,Bert Smith,DEM,90309,0,0,6,6,04
Canadian,U.S. House,Tom Cole,REP,90309,1,2,52,55,04
Canadian,U.S. House,Dennis Johnson,IND,90309,0,0,2,2,04
Canadian,Governor,Joe Dorman,DEM,90398,0,0,0,0,
Canadian,Governor,Mary Fallin,REP,90398,0,0,0,0,
Canadian,Governor,Kimberly Willis,IND,90398,0,0,0,0,
Canadian,Governor,Richard Prawdzienski,IND,90398,0,0,0,0,
Canadian,Lieutenant Governor,Cathy Cummings,DEM,90398,0,0,0,0,
Canadian,Lieutenant Governor,Todd Lamb,REP,90398,0,0,0,0,
Canadian,Superintendent of Public Instruction,John Cox,DEM,90398,0,0,0,0,
Canadian,Superintendent of Public Instruction,Joy Hofmeister,REP,90398,0,0,0,0,
Canadian,Commissioner of Labor,Mike Workman,DEM,90398,0,0,0,0,
Canadian,Commissioner of Labor,Mark Costello,REP,90398,0,0,0,0,
Canadian,U.S. Senate,Matt Silverstein,DEM,90398,0,0,0,0,
Canadian,U.S. Senate,Jim Inhofe,REP,90398,0,0,0,0,
Canadian,U.S. Senate,Aaron Delozier,IND,90398,0,0,0,0,
Canadian,U.S. Senate,Ray Woods,IND,90398,0,0,0,0,
Canadian,U.S. Senate,Joan Farr,IND,90398,0,0,0,0,
Canadian,U.S. Senate,Connie Johnson,DEM,90398,0,0,0,0,
Canadian,U.S. Senate,James Lankford,REP,90398,0,0,0,0,
Canadian,U.S. Senate,Mark Beard,IND,90398,0,0,0,0,
Canadian,U.S. House,Bert Smith,DEM,90398,0,0,0,0,04
Canadian,U.S. House,Tom Cole,REP,90398,0,0,0,0,04
Canadian,U.S. House,Dennis Johnson,IND,90398,0,0,0,0,04
Canadian,Governor,Joe Dorman,DEM,90399,0,0,0,0,
Canadian,Governor,Mary Fallin,REP,90399,0,0,0,0,
Canadian,Governor,Kimberly Willis,IND,90399,0,0,0,0,
Canadian,Governor,Richard Prawdzienski,IND,90399,0,0,0,0,
Canadian,Lieutenant Governor,Cathy Cummings,DEM,90399,0,0,0,0,
Canadian,Lieutenant Governor,Todd Lamb,REP,90399,0,0,0,0,
Canadian,Superintendent of Public Instruction,John Cox,DEM,90399,0,0,0,0,
Canadian,Superintendent of Public Instruction,Joy Hofmeister,REP,90399,0,0,0,0,
Canadian,Commissioner of Labor,Mike Workman,DEM,90399,0,0,0,0,
Canadian,Commissioner of Labor,Mark Costello,REP,90399,0,0,0,0,
Canadian,U.S. Senate,Matt Silverstein,DEM,90399,0,0,0,0,
Canadian,U.S. Senate,Jim Inhofe,REP,90399,0,0,0,0,
Canadian,U.S. Senate,Aaron Delozier,IND,90399,0,0,0,0,
Canadian,U.S. Senate,Ray Woods,IND,90399,0,0,0,0,
Canadian,U.S. Senate,Joan Farr,IND,90399,0,0,0,0,
Canadian,U.S. Senate,Connie Johnson,DEM,90399,0,0,0,0,
Canadian,U.S. Senate,James Lankford,REP,90399,0,0,0,0,
Canadian,U.S. Senate,Mark Beard,IND,90399,0,0,0,0,
Canadian,U.S. House,Bert Smith,DEM,90399,0,0,0,0,04
Canadian,U.S. House,Tom Cole,REP,90399,0,0,0,0,04
Canadian,U.S. House,Dennis Johnson,IND,90399,0,0,0,0,04
Canadian,Governor,Joe Dorman,DEM,90400,1,2,132,135,
Canadian,Governor,Mary Fallin,REP,90400,10,7,272,289,
Canadian,Governor,Kimberly Willis,IND,90400,0,0,12,12,
Canadian,Governor,Richard Prawdzienski,IND,90400,0,0,5,5,
Canadian,Lieutenant Governor,Cathy Cummings,DEM,90400,0,2,85,87,
Canadian,Lieutenant Governor,Todd Lamb,REP,90400,11,7,336,354,
Canadian,Superintendent of Public Instruction,John Cox,DEM,90400,4,2,162,168,
Canadian,Superintendent of Public Instruction,Joy Hofmeister,REP,90400,7,7,255,269,
Canadian,Commissioner of Labor,Mike Workman,DEM,90400,0,2,103,105,
Canadian,Commissioner of Labor,Mark Costello,REP,90400,11,7,306,324,
Canadian,U.S. Senate,Matt Silverstein,DEM,90400,0,2,62,64,
Canadian,U.S. Senate,Jim Inhofe,REP,90400,11,7,344,362,
Canadian,U.S. Senate,Aaron Delozier,IND,90400,0,0,2,2,
Canadian,U.S. Senate,Ray Woods,IND,90400,0,0,5,5,
Canadian,U.S. Senate,Joan Farr,IND,90400,0,0,7,7,
Canadian,U.S. Senate,Connie Johnson,DEM,90400,0,1,65,66,
Canadian,U.S. Senate,James Lankford,REP,90400,11,8,346,365,
Canadian,U.S. Senate,Mark Beard,IND,90400,0,0,10,10,
Canadian,U.S. House,Frankie Robbins,DEM,90400,0,2,62,64,03
Canadian,U.S. House,Frank Lucas,REP,90400,11,7,359,377,03
Canadian,Governor,Joe Dorman,DEM,90403,4,0,40,44,
Canadian,Governor,Mary Fallin,REP,90403,0,6,105,111,
Canadian,Governor,Kimberly Willis,IND,90403,1,0,3,4,
Canadian,Governor,Richard Prawdzienski,IND,90403,0,0,4,4,
Canadian,Lieutenant Governor,Cathy Cummings,DEM,90403,2,0,29,31,
Canadian,Lieutenant Governor,Todd Lamb,REP,90403,3,6,123,132,
Canadian,Superintendent of Public Instruction,John Cox,DEM,90403,2,0,52,54,
Canadian,Superintendent of Public Instruction,Joy Hofmeister,REP,90403,3,6,98,107,
Canadian,Commissioner of Labor,Mike Workman,DEM,90403,2,0,32,34,
Canadian,Commissioner of Labor,Mark Costello,REP,90403,3,6,115,124,
Canadian,U.S. Senate,Matt Silverstein,DEM,90403,2,0,21,23,
Canadian,U.S. Senate,Jim Inhofe,REP,90403,3,6,127,136,
Canadian,U.S. Senate,Aaron Delozier,IND,90403,0,0,0,0,
Canadian,U.S. Senate,Ray Woods,IND,90403,0,0,2,2,
Canadian,U.S. Senate,Joan Farr,IND,90403,0,0,2,2,
Canadian,U.S. Senate,Connie Johnson,DEM,90403,2,0,20,22,
Canadian,U.S. Senate,James Lankford,REP,90403,3,6,129,138,
Canadian,U.S. Senate,Mark Beard,IND,90403,0,0,2,2,
Canadian,U.S. House,Frankie Robbins,DEM,90403,0,0,20,20,03
Canadian,U.S. House,Frank Lucas,REP,90403,5,6,131,142,03
Canadian,Governor,Joe Dorman,DEM,90404,0,5,28,33,
Canadian,Governor,Mary Fallin,REP,90404,6,5,84,95,
Canadian,Governor,Kimberly Willis,IND,90404,0,0,3,3,
Canadian,Governor,Richard Prawdzienski,IND,90404,0,0,1,1,
Canadian,Lieutenant Governor,Cathy Cummings,DEM,90404,0,5,19,24,
Canadian,Lieutenant Governor,Todd Lamb,REP,90404,6,5,96,107,
Canadian,Superintendent of Public Instruction,John Cox,DEM,90404,0,5,54,59,
Canadian,Superintendent of Public Instruction,Joy Hofmeister,REP,90404,6,5,58,69,
Canadian,Commissioner of Labor,Mike Workman,DEM,90404,0,4,28,32,
Canadian,Commissioner of Labor,Mark Costello,REP,90404,6,6,84,96,
Canadian,U.S. Senate,Matt Silverstein,DEM,90404,0,4,15,19,
Canadian,U.S. Senate,Jim Inhofe,REP,90404,5,6,97,108,
Canadian,U.S. Senate,Aaron Delozier,IND,90404,0,0,2,2,
Canadian,U.S. Senate,Ray Woods,IND,90404,0,0,1,1,
Canadian,U.S. Senate,Joan Farr,IND,90404,1,0,0,1,
Canadian,U.S. Senate,Connie Johnson,DEM,90404,0,3,16,19,
Canadian,U.S. Senate,James Lankford,REP,90404,6,6,93,105,
Canadian,U.S. Senate,Mark Beard,IND,90404,0,1,7,8,
Canadian,U.S. House,Frankie Robbins,DEM,90404,0,3,16,19,03
Canadian,U.S. House,Frank Lucas,REP,90404,6,7,98,111,03
Canadian,Governor,Joe Dorman,DEM,90406,0,0,41,41,
Canadian,Governor,Mary Fallin,REP,90406,0,2,82,84,
Canadian,Governor,Kimberly Willis,IND,90406,0,0,2,2,
Canadian,Governor,Richard Prawdzienski,IND,90406,0,0,1,1,
Canadian,Lieutenant Governor,Cathy Cummings,DEM,90406,0,0,27,27,
Canadian,Lieutenant Governor,Todd Lamb,REP,90406,0,2,99,101,
Canadian,Superintendent of Public Instruction,John Cox,DEM,90406,0,0,50,50,
Canadian,Superintendent of Public Instruction,Joy Hofmeister,REP,90406,0,2,76,78,
Canadian,Commissioner of Labor,Mike Workman,DEM,90406,0,1,34,35,
Canadian,Commissioner of Labor,Mark Costello,REP,90406,0,1,91,92,
Canadian,U.S. Senate,Matt Silverstein,DEM,90406,0,0,22,22,
Canadian,U.S. Senate,Jim Inhofe,REP,90406,0,2,98,100,
Canadian,U.S. Senate,Aaron Delozier,IND,90406,0,0,0,0,
Canadian,U.S. Senate,Ray Woods,IND,90406,0,0,3,3,
Canadian,U.S. Senate,Joan Farr,IND,90406,0,0,1,1,
Canadian,U.S. Senate,Connie Johnson,DEM,90406,0,0,20,20,
Canadian,U.S. Senate,James Lankford,REP,90406,0,2,101,103,
Canadian,U.S. Senate,Mark Beard,IND,90406,0,0,5,5,
Canadian,U.S. House,Frankie Robbins,DEM,90406,0,0,25,25,03
Canadian,U.S. House,Frank Lucas,REP,90406,0,2,101,103,03
Canadian,Governor,Joe Dorman,DEM,90408,0,2,75,77,
Canadian,Governor,Mary Fallin,REP,90408,2,1,117,120,
Canadian,Governor,Kimberly Willis,IND,90408,0,2,1,3,
Canadian,Governor,Richard Prawdzienski,IND,90408,0,0,4,4,
Canadian,Lieutenant Governor,Cathy Cummings,DEM,90408,0,0,49,49,
Canadian,Lieutenant Governor,Todd Lamb,REP,90408,2,5,147,154,
Canadian,Superintendent of Public Instruction,John Cox,DEM,90408,0,2,100,102,
Canadian,Superintendent of Public Instruction,Joy Hofmeister,REP,90408,2,3,93,98,
Canadian,Commissioner of Labor,Mike Workman,DEM,90408,0,0,66,66,
Canadian,Commissioner of Labor,Mark Costello,REP,90408,2,5,126,133,
Canadian,U.S. Senate,Matt Silverstein,DEM,90408,0,0,42,42,
Canadian,U.S. Senate,Jim Inhofe,REP,90408,2,4,149,155,
Canadian,U.S. Senate,Aaron Delozier,IND,90408,0,1,1,2,
Canadian,U.S. Senate,Ray Woods,IND,90408,0,0,2,2,
Canadian,U.S. Senate,Joan Farr,IND,90408,0,0,2,2,
Canadian,U.S. Senate,Connie Johnson,DEM,90408,0,1,41,42,
Canadian,U.S. Senate,James Lankford,REP,90408,2,2,150,154,
Canadian,U.S. Senate,Mark Beard,IND,90408,0,2,5,7,
Canadian,U.S. House,Frankie Robbins,DEM,90408,0,1,39,40,03
Canadian,U.S. House,Frank Lucas,REP,90408,2,4,158,164,03
Canadian,Governor,Joe Dorman,DEM,90409,0,0,5,5,
Canadian,Governor,Mary Fallin,REP,90409,1,2,20,23,
Canadian,Governor,Kimberly Willis,IND,90409,0,0,0,0,
Canadian,Governor,Richard Prawdzienski,IND,90409,0,0,0,0,
Canadian,Lieutenant Governor,Cathy Cummings,DEM,90409,0,0,2,2,
Canadian,Lieutenant Governor,Todd Lamb,REP,90409,1,2,22,25,
Canadian,Superintendent of Public Instruction,John Cox,DEM,90409,0,0,9,9,
Canadian,Superintendent of Public Instruction,Joy Hofmeister,REP,90409,1,2,16,19,
Canadian,Commissioner of Labor,Mike Workman,DEM,90409,0,0,5,5,
Canadian,Commissioner of Labor,Mark Costello,REP,90409,1,2,19,22,
Canadian,U.S. Senate,Matt Silverstein,DEM,90409,0,0,2,2,
Canadian,U.S. Senate,Jim Inhofe,REP,90409,1,2,23,26,
Canadian,U.S. Senate,Aaron Delozier,IND,90409,0,0,0,0,
Canadian,U.S. Senate,Ray Woods,IND,90409,0,0,0,0,
Canadian,U.S. Senate,Joan Farr,IND,90409,0,0,0,0,
Canadian,U.S. Senate,Connie Johnson,DEM,90409,0,0,1,1,
Canadian,U.S. Senate,James Lankford,REP,90409,1,2,23,26,
Canadian,U.S. Senate,Mark Beard,IND,90409,0,0,0,0,
Canadian,U.S. House,Frankie Robbins,DEM,90409,0,0,2,2,03
Canadian,U.S. House,Frank Lucas,REP,90409,1,2,22,25,03
Canadian,Governor,Joe Dorman,DEM,90502,1,0,34,35,
Canadian,Governor,Mary Fallin,REP,90502,3,6,114,123,
Canadian,Governor,Kimberly Willis,IND,90502,0,0,1,1,
Canadian,Governor,Richard Prawdzienski,IND,90502,0,0,2,2,
Canadian,Lieutenant Governor,Cathy Cummings,DEM,90502,0,0,19,19,
Canadian,Lieutenant Governor,Todd Lamb,REP,90502,4,6,132,142,
Canadian,Superintendent of Public Instruction,John Cox,DEM,90502,1,4,52,57,
Canadian,Superintendent of Public Instruction,Joy Hofmeister,REP,90502,3,2,96,101,
Canadian,Commissioner of Labor,Mike Workman,DEM,90502,1,1,36,38,
Canadian,Commissioner of Labor,Mark Costello,REP,90502,3,4,113,120,
Canadian,U.S. Senate,Matt Silverstein,DEM,90502,1,1,9,11,
Canadian,U.S. Senate,Jim Inhofe,REP,90502,3,5,131,139,
Canadian,U.S. Senate,Aaron Delozier,IND,90502,0,0,2,2,
Canadian,U.S. Senate,Ray Woods,IND,90502,0,0,4,4,
Canadian,U.S. Senate,Joan Farr,IND,90502,0,0,4,4,
Canadian,U.S. Senate,Connie Johnson,DEM,90502,1,0,14,15,
Canadian,U.S. Senate,James Lankford,REP,90502,3,6,132,141,
Canadian,U.S. Senate,Mark Beard,IND,90502,0,0,5,5,
Canadian,U.S. House,Frankie Robbins,DEM,90502,0,0,12,12,03
Canadian,U.S. House,Frank Lucas,REP,90502,4,6,138,148,03
Canadian,Governor,Joe Dorman,DEM,90503,1,0,38,39,
Canadian,Governor,Mary Fallin,REP,90503,8,2,132,142,
Canadian,Governor,Kimberly Willis,IND,90503,0,0,4,4,
Canadian,Governor,Richard Prawdzienski,IND,90503,0,0,1,1,
Canadian,Lieutenant Governor,Cathy Cummings,DEM,90503,1,0,26,27,
Canadian,Lieutenant Governor,Todd Lamb,REP,90503,8,2,148,158,
Canadian,Superintendent of Public Instruction,John Cox,DEM,90503,0,0,36,36,
Canadian,Superintendent of Public Instruction,Joy Hofmeister,REP,90503,9,2,136,147,
Canadian,Commissioner of Labor,Mike Workman,DEM,90503,2,0,32,34,
Canadian,Commissioner of Labor,Mark Costello,REP,90503,7,2,138,147,
Canadian,U.S. Senate,Matt Silverstein,DEM,90503,0,0,17,17,
Canadian,U.S. Senate,Jim Inhofe,REP,90503,9,2,149,160,
Canadian,U.S. Senate,Aaron Delozier,IND,90503,0,0,0,0,
Canadian,U.S. Senate,Ray Woods,IND,90503,0,0,3,3,
Canadian,U.S. Senate,Joan Farr,IND,90503,0,0,3,3,
Canadian,U.S. Senate,Connie Johnson,DEM,90503,0,0,22,22,
Canadian,U.S. Senate,James Lankford,REP,90503,9,2,148,159,
Canadian,U.S. Senate,Mark Beard,IND,90503,0,0,3,3,
Canadian,U.S. House,Frankie Robbins,DEM,90503,0,0,19,19,03
Canadian,U.S. House,Frank Lucas,REP,90503,9,2,152,163,03
Canadian,Governor,Joe Dorman,DEM,90504,6,6,304,316,
Canadian,Governor,Mary Fallin,REP,90504,14,7,759,780,
Canadian,Governor,Kimberly Willis,IND,90504,0,0,17,17,
Canadian,Governor,Richard Prawdzienski,IND,90504,0,0,15,15,
Canadian,Lieutenant Governor,Cathy Cummings,DEM,90504,2,2,181,185,
Canadian,Lieutenant Governor,Todd Lamb,REP,90504,18,11,915,944,
Canadian,Superintendent of Public Instruction,John Cox,DEM,90504,3,5,342,350,
Canadian,Superintendent of Public Instruction,Joy Hofmeister,REP,90504,15,6,747,768,
Canadian,Commissioner of Labor,Mike Workman,DEM,90504,4,4,215,223,
Canadian,Commissioner of Labor,Mark Costello,REP,90504,14,9,855,878,
Canadian,U.S. Senate,Matt Silverstein,DEM,90504,3,4,157,164,
Canadian,U.S. Senate,Jim Inhofe,REP,90504,16,8,898,922,
Canadian,U.S. Senate,Aaron Delozier,IND,90504,0,0,15,15,
Canadian,U.S. Senate,Ray Woods,IND,90504,0,0,13,13,
Canadian,U.S. Senate,Joan Farr,IND,90504,1,1,9,11,
Canadian,U.S. Senate,Connie Johnson,DEM,90504,1,3,151,155,
Canadian,U.S. Senate,James Lankford,REP,90504,18,9,914,941,
Canadian,U.S. Senate,Mark Beard,IND,90504,1,1,28,30,
Canadian,U.S. House,Frankie Robbins,DEM,90504,3,2,164,169,03
Canadian,U.S. House,Frank Lucas,REP,90504,17,11,927,955,03
Canadian,Governor,Joe Dorman,DEM,90506,10,4,338,352,
Canadian,Governor,Mary Fallin,REP,90506,27,17,732,776,
Canadian,Governor,Kimberly Willis,IND,90506,0,0,15,15,
Canadian,Governor,Richard Prawdzienski,IND,90506,0,0,15,15,
Canadian,Lieutenant Governor,Cathy Cummings,DEM,90506,6,4,185,195,
Canadian,Lieutenant Governor,Todd Lamb,REP,90506,31,17,914,962,
Canadian,Superintendent of Public Instruction,John Cox,DEM,90506,10,10,346,366,
Canadian,Superintendent of Public Instruction,Joy Hofmeister,REP,90506,27,11,751,789,
Canadian,Commissioner of Labor,Mike Workman,DEM,90506,8,5,201,214,
Canadian,Commissioner of Labor,Mark Costello,REP,90506,27,16,861,904,
Canadian,U.S. Senate,Matt Silverstein,DEM,90506,6,4,161,171,
Canadian,U.S. Senate,Jim Inhofe,REP,90506,29,17,902,948,
Canadian,U.S. Senate,Aaron Delozier,IND,90506,1,0,10,11,
Canadian,U.S. Senate,Ray Woods,IND,90506,0,0,11,11,
Canadian,U.S. Senate,Joan Farr,IND,90506,1,0,8,9,
Canadian,U.S. Senate,Connie Johnson,DEM,90506,7,4,152,163,
Canadian,U.S. Senate,James Lankford,REP,90506,30,17,926,973,
Canadian,U.S. Senate,Mark Beard,IND,90506,0,0,27,27,
Canadian,U.S. House,Frankie Robbins,DEM,90506,6,4,174,184,03
Canadian,U.S. House,Frank Lucas,REP,90506,31,17,923,971,03
Carter,Governor,Joe Dorman,DEM,100001,3,12,160,175,
Carter,Governor,Mary Fallin,REP,100001,3,12,164,179,
Carter,Governor,Kimberly Willis,IND,100001,0,0,20,20,
Carter,Governor,Richard Prawdzienski,IND,100001,0,0,9,9,
Carter,Lieutenant Governor,Cathy Cummings,DEM,100001,4,12,137,153,
Carter,Lieutenant Governor,Todd Lamb,REP,100001,3,11,214,228,
Carter,Superintendent of Public Instruction,John Cox,DEM,100001,4,14,168,186,
Carter,Superintendent of Public Instruction,Joy Hofmeister,REP,100001,2,10,182,194,
Carter,Commissioner of Labor,Mike Workman,DEM,100001,3,13,137,153,
Carter,Commissioner of Labor,Mark Costello,REP,100001,3,9,210,222,
Carter,U.S. Senate,Matt Silverstein,DEM,100001,3,11,113,127,
Carter,U.S. Senate,Jim Inhofe,REP,100001,2,12,209,223,
Carter,U.S. Senate,Aaron Delozier,IND,100001,0,0,2,2,
Carter,U.S. Senate,Ray Woods,IND,100001,0,0,11,11,
Carter,U.S. Senate,Joan Farr,IND,100001,1,1,15,17,
Carter,U.S. Senate,Connie Johnson,DEM,100001,3,11,124,138,
Carter,U.S. Senate,James Lankford,REP,100001,2,11,207,220,
Carter,U.S. Senate,Mark Beard,IND,100001,1,0,23,24,
Carter,U.S. House,Bert Smith,DEM,100001,3,10,103,116,04
Carter,U.S. House,Tom Cole,REP,100001,2,13,225,240,04
Carter,U.S. House,Dennis Johnson,IND,100001,1,1,26,28,04
Carter,State Senate,Chequita Williams,DEM,100001,2,11,117,130,14
Carter,State Senate,Frank Simpson,REP,100001,4,13,237,254,14
Carter,Governor,Joe Dorman,DEM,100002,14,24,179,217,
Carter,Governor,Mary Fallin,REP,100002,14,35,270,319,
Carter,Governor,Kimberly Willis,IND,100002,1,3,10,14,
Carter,Governor,Richard Prawdzienski,IND,100002,0,0,5,5,
Carter,Lieutenant Governor,Cathy Cummings,DEM,100002,14,16,164,194,
Carter,Lieutenant Governor,Todd Lamb,REP,100002,15,47,295,357,
Carter,Superintendent of Public Instruction,John Cox,DEM,100002,14,23,205,242,
Carter,Superintendent of Public Instruction,Joy Hofmeister,REP,100002,15,40,252,307,
Carter,Commissioner of Labor,Mike Workman,DEM,100002,14,21,161,196,
Carter,Commissioner of Labor,Mark Costello,REP,100002,14,40,286,340,
Carter,U.S. Senate,Matt Silverstein,DEM,100002,10,17,124,151,
Carter,U.S. Senate,Jim Inhofe,REP,100002,19,45,326,390,
Carter,U.S. Senate,Aaron Delozier,IND,100002,0,1,5,6,
Carter,U.S. Senate,Ray Woods,IND,100002,0,0,4,4,
Carter,U.S. Senate,Joan Farr,IND,100002,1,0,4,5,
Carter,U.S. Senate,Connie Johnson,DEM,100002,13,21,136,170,
Carter,U.S. Senate,James Lankford,REP,100002,17,40,307,364,
Carter,U.S. Senate,Mark Beard,IND,100002,0,1,19,20,
Carter,U.S. House,Bert Smith,DEM,100002,9,12,124,145,04
Carter,U.S. House,Tom Cole,REP,100002,19,49,323,391,04
Carter,U.S. House,Dennis Johnson,IND,100002,2,1,16,19,04
Carter,State Senate,Chequita Williams,DEM,100002,8,10,116,134,14
Carter,State Senate,Frank Simpson,REP,100002,22,52,346,420,14
Carter,Governor,Joe Dorman,DEM,100007,4,23,208,235,
Carter,Governor,Mary Fallin,REP,100007,0,11,32,43,
Carter,Governor,Kimberly Willis,IND,100007,0,1,7,8,
Carter,Governor,Richard Prawdzienski,IND,100007,0,0,2,2,
Carter,Lieutenant Governor,Cathy Cummings,DEM,100007,3,25,208,236,
Carter,Lieutenant Governor,Todd Lamb,REP,100007,1,10,40,51,
Carter,Superintendent of Public Instruction,John Cox,DEM,100007,4,27,213,244,
Carter,Superintendent of Public Instruction,Joy Hofmeister,REP,100007,0,8,35,43,
Carter,Commissioner of Labor,Mike Workman,DEM,100007,4,26,215,245,
Carter,Commissioner of Labor,Mark Costello,REP,100007,0,9,34,43,
Carter,U.S. Senate,Matt Silverstein,DEM,100007,3,23,196,222,
Carter,U.S. Senate,Jim Inhofe,REP,100007,1,11,44,56,
Carter,U.S. Senate,Aaron Delozier,IND,100007,0,1,0,1,
Carter,U.S. Senate,Ray Woods,IND,100007,0,0,6,6,
Carter,U.S. Senate,Joan Farr,IND,100007,0,0,3,3,
Carter,U.S. Senate,Connie Johnson,DEM,100007,3,24,214,241,
Carter,U.S. Senate,James Lankford,REP,100007,1,9,28,38,
Carter,U.S. Senate,Mark Beard,IND,100007,0,2,7,9,
Carter,U.S. House,Bert Smith,DEM,100007,3,23,187,213,04
Carter,U.S. House,Tom Cole,REP,100007,1,10,46,57,04
Carter,U.S. House,Dennis Johnson,IND,100007,0,1,14,15,04
Carter,State Senate,Chequita Williams,DEM,100007,3,24,204,231,14
Carter,State Senate,Frank Simpson,REP,100007,1,11,43,55,14
Carter,Governor,Joe Dorman,DEM,100011,1,18,96,115,
Carter,Governor,Mary Fallin,REP,100011,4,15,114,133,
Carter,Governor,Kimberly Willis,IND,100011,0,0,9,9,
Carter,Governor,Richard Prawdzienski,IND,100011,0,0,4,4,
Carter,Lieutenant Governor,Cathy Cummings,DEM,100011,1,17,82,100,
Carter,Lieutenant Governor,Todd Lamb,REP,100011,4,16,138,158,
Carter,Superintendent of Public Instruction,John Cox,DEM,100011,3,17,100,120,
Carter,Superintendent of Public Instruction,Joy Hofmeister,REP,100011,2,16,120,138,
Carter,Commissioner of Labor,Mike Workman,DEM,100011,1,20,92,113,
Carter,Commissioner of Labor,Mark Costello,REP,100011,3,13,124,140,
Carter,U.S. Senate,Matt Silverstein,DEM,100011,1,11,56,68,
Carter,U.S. Senate,Jim Inhofe,REP,100011,4,21,151,176,
Carter,U.S. Senate,Aaron Delozier,IND,100011,0,1,2,3,
Carter,U.S. Senate,Ray Woods,IND,100011,0,0,6,6,
Carter,U.S. Senate,Joan Farr,IND,100011,0,0,7,7,
Carter,U.S. Senate,Connie Johnson,DEM,100011,1,16,70,87,
Carter,U.S. Senate,James Lankford,REP,100011,3,17,144,164,
Carter,U.S. Senate,Mark Beard,IND,100011,0,0,8,8,
Carter,U.S. House,Bert Smith,DEM,100011,1,13,60,74,04
Carter,U.S. House,Tom Cole,REP,100011,4,20,149,173,04
Carter,U.S. House,Dennis Johnson,IND,100011,0,0,12,12,04
Carter,State Senate,Chequita Williams,DEM,100011,1,10,55,66,14
Carter,State Senate,Frank Simpson,REP,100011,4,23,169,196,14
Carter,Governor,Joe Dorman,DEM,100014,4,8,131,143,
Carter,Governor,Mary Fallin,REP,100014,9,11,126,146,
Carter,Governor,Kimberly Willis,IND,100014,1,1,10,12,
Carter,Governor,Richard Prawdzienski,IND,100014,0,0,8,8,
Carter,Lieutenant Governor,Cathy Cummings,DEM,100014,6,5,112,123,
Carter,Lieutenant Governor,Todd Lamb,REP,100014,8,15,158,181,
Carter,Superintendent of Public Instruction,John Cox,DEM,100014,9,12,140,161,
Carter,Superintendent of Public Instruction,Joy Hofmeister,REP,100014,4,8,127,139,
Carter,Commissioner of Labor,Mike Workman,DEM,100014,7,5,122,134,
Carter,Commissioner of Labor,Mark Costello,REP,100014,6,15,145,166,
Carter,U.S. Senate,Matt Silverstein,DEM,100014,4,4,85,93,
Carter,U.S. Senate,Jim Inhofe,REP,100014,8,16,172,196,
Carter,U.S. Senate,Aaron Delozier,IND,100014,1,0,3,4,
Carter,U.S. Senate,Ray Woods,IND,100014,0,0,4,4,
Carter,U.S. Senate,Joan Farr,IND,100014,0,0,8,8,
Carter,U.S. Senate,Connie Johnson,DEM,100014,4,6,105,115,
Carter,U.S. Senate,James Lankford,REP,100014,9,14,142,165,
Carter,U.S. Senate,Mark Beard,IND,100014,1,0,21,22,
Carter,U.S. House,Bert Smith,DEM,100014,3,4,79,86,04
Carter,U.S. House,Tom Cole,REP,100014,10,16,177,203,04
Carter,U.S. House,Dennis Johnson,IND,100014,0,0,17,17,04
Carter,State Senate,Chequita Williams,DEM,100014,4,2,94,100,14
Carter,State Senate,Frank Simpson,REP,100014,9,18,179,206,14
Carter,Governor,Joe Dorman,DEM,100015,16,26,191,233,
Carter,Governor,Mary Fallin,REP,100015,12,60,233,305,
Carter,Governor,Kimberly Willis,IND,100015,1,6,16,23,
Carter,Governor,Richard Prawdzienski,IND,100015,0,1,9,10,
Carter,Lieutenant Governor,Cathy Cummings,DEM,100015,17,23,177,217,
Carter,Lieutenant Governor,Todd Lamb,REP,100015,10,70,271,351,
Carter,Superintendent of Public Instruction,John Cox,DEM,100015,20,45,215,280,
Carter,Superintendent of Public Instruction,Joy Hofmeister,REP,100015,7,48,231,286,
Carter,Commissioner of Labor,Mike Workman,DEM,100015,18,30,172,220,
Carter,Commissioner of Labor,Mark Costello,REP,100015,9,63,269,341,
Carter,U.S. Senate,Matt Silverstein,DEM,100015,14,17,135,166,
Carter,U.S. Senate,Jim Inhofe,REP,100015,13,69,289,371,
Carter,U.S. Senate,Aaron Delozier,IND,100015,0,1,5,6,
Carter,U.S. Senate,Ray Woods,IND,100015,1,1,6,8,
Carter,U.S. Senate,Joan Farr,IND,100015,0,4,12,16,
Carter,U.S. Senate,Connie Johnson,DEM,100015,16,27,149,192,
Carter,U.S. Senate,James Lankford,REP,100015,10,64,272,346,
Carter,U.S. Senate,Mark Beard,IND,100015,0,2,26,28,
Carter,U.S. House,Bert Smith,DEM,100015,12,20,119,151,04
Carter,U.S. House,Tom Cole,REP,100015,15,69,303,387,04
Carter,U.S. House,Dennis Johnson,IND,100015,0,4,25,29,04
Carter,State Senate,Chequita Williams,DEM,100015,14,16,124,154,14
Carter,State Senate,Frank Simpson,REP,100015,13,76,322,411,14
Carter,Governor,Joe Dorman,DEM,100017,8,12,130,150,
Carter,Governor,Mary Fallin,REP,100017,14,19,229,262,
Carter,Governor,Kimberly Willis,IND,100017,0,0,12,12,
Carter,Governor,Richard Prawdzienski,IND,100017,0,1,4,5,
Carter,Lieutenant Governor,Cathy Cummings,DEM,100017,6,8,105,119,
Carter,Lieutenant Governor,Todd Lamb,REP,100017,15,24,266,305,
Carter,Superintendent of Public Instruction,John Cox,DEM,100017,8,17,143,168,
Carter,Superintendent of Public Instruction,Joy Hofmeister,REP,100017,14,14,224,252,
Carter,Commissioner of Labor,Mike Workman,DEM,100017,9,9,113,131,
Carter,Commissioner of Labor,Mark Costello,REP,100017,13,21,251,285,
Carter,U.S. Senate,Matt Silverstein,DEM,100017,7,8,71,86,
Carter,U.S. Senate,Jim Inhofe,REP,100017,15,23,288,326,
Carter,U.S. Senate,Aaron Delozier,IND,100017,0,0,2,2,
Carter,U.S. Senate,Ray Woods,IND,100017,0,0,5,5,
Carter,U.S. Senate,Joan Farr,IND,100017,0,0,4,4,
Carter,U.S. Senate,Connie Johnson,DEM,100017,7,11,97,115,
Carter,U.S. Senate,James Lankford,REP,100017,15,20,261,296,
Carter,U.S. Senate,Mark Beard,IND,100017,0,0,14,14,
Carter,U.S. House,Bert Smith,DEM,100017,6,8,70,84,04
Carter,U.S. House,Tom Cole,REP,100017,16,24,290,330,04
Carter,U.S. House,Dennis Johnson,IND,100017,0,0,13,13,04
Carter,State Senate,Chequita Williams,DEM,100017,6,5,75,86,14
Carter,State Senate,Frank Simpson,REP,100017,16,28,292,336,14
Carter,Governor,Joe Dorman,DEM,100019,5,63,388,456,
Carter,Governor,Mary Fallin,REP,100019,27,109,730,866,
Carter,Governor,Kimberly Willis,IND,100019,1,4,22,27,
Carter,Governor,Richard Prawdzienski,IND,100019,1,2,5,8,
Carter,Lieutenant Governor,Cathy Cummings,DEM,100019,7,45,260,312,
Carter,Lieutenant Governor,Todd Lamb,REP,100019,27,128,882,1037,
Carter,Superintendent of Public Instruction,John Cox,DEM,100019,6,66,399,471,
Carter,Superintendent of Public Instruction,Joy Hofmeister,REP,100019,27,109,720,856,
Carter,Commissioner of Labor,Mike Workman,DEM,100019,6,49,288,343,
Carter,Commissioner of Labor,Mark Costello,REP,100019,28,122,811,961,
Carter,U.S. Senate,Matt Silverstein,DEM,100019,7,40,207,254,
Carter,U.S. Senate,Jim Inhofe,REP,100019,26,136,902,1064,
Carter,U.S. Senate,Aaron Delozier,IND,100019,1,0,7,8,
Carter,U.S. Senate,Ray Woods,IND,100019,0,1,11,12,
Carter,U.S. Senate,Joan Farr,IND,100019,0,1,10,11,
Carter,U.S. Senate,Connie Johnson,DEM,100019,5,41,211,257,
Carter,U.S. Senate,James Lankford,REP,100019,28,132,898,1058,
Carter,U.S. Senate,Mark Beard,IND,100019,1,3,25,29,
Carter,U.S. House,Bert Smith,DEM,100019,6,31,189,226,04
Carter,U.S. House,Tom Cole,REP,100019,26,141,921,1088,04
Carter,U.S. House,Dennis Johnson,IND,100019,2,6,33,41,04
Carter,State Senate,Chequita Williams,DEM,100019,4,26,181,211,14
Carter,State Senate,Frank Simpson,REP,100019,30,149,959,1138,14
Carter,Governor,Joe Dorman,DEM,100020,0,16,190,206,
Carter,Governor,Mary Fallin,REP,100020,6,21,234,261,
Carter,Governor,Kimberly Willis,IND,100020,0,2,19,21,
Carter,Governor,Richard Prawdzienski,IND,100020,0,1,8,9,
Carter,Lieutenant Governor,Cathy Cummings,DEM,100020,0,15,154,169,
Carter,Lieutenant Governor,Todd Lamb,REP,100020,6,26,292,324,
Carter,Superintendent of Public Instruction,John Cox,DEM,100020,1,21,211,233,
Carter,Superintendent of Public Instruction,Joy Hofmeister,REP,100020,5,20,233,258,
Carter,Commissioner of Labor,Mike Workman,DEM,100020,0,22,160,182,
Carter,Commissioner of Labor,Mark Costello,REP,100020,6,18,276,300,
Carter,U.S. Senate,Matt Silverstein,DEM,100020,1,12,121,134,
Carter,U.S. Senate,Jim Inhofe,REP,100020,5,27,308,340,
Carter,U.S. Senate,Aaron Delozier,IND,100020,0,0,7,7,
Carter,U.S. Senate,Ray Woods,IND,100020,0,0,10,10,
Carter,U.S. Senate,Joan Farr,IND,100020,0,1,6,7,
Carter,U.S. Senate,Connie Johnson,DEM,100020,0,14,137,151,
Carter,U.S. Senate,James Lankford,REP,100020,6,25,286,317,
Carter,U.S. Senate,Mark Beard,IND,100020,0,1,25,26,
Carter,U.S. House,Bert Smith,DEM,100020,0,11,109,120,04
Carter,U.S. House,Tom Cole,REP,100020,5,30,318,353,04
Carter,U.S. House,Dennis Johnson,IND,100020,1,0,23,24,04
Carter,State Senate,Chequita Williams,DEM,100020,0,7,104,111,14
Carter,State Senate,Frank Simpson,REP,100020,6,34,343,383,14
Carter,Governor,Joe Dorman,DEM,100024,6,16,204,226,
Carter,Governor,Mary Fallin,REP,100024,9,44,443,496,
Carter,Governor,Kimberly Willis,IND,100024,0,0,20,20,
Carter,Governor,Richard Prawdzienski,IND,100024,0,0,8,8,
Carter,Lieutenant Governor,Cathy Cummings,DEM,100024,7,8,150,165,
Carter,Lieutenant Governor,Todd Lamb,REP,100024,8,51,511,570,
Carter,Superintendent of Public Instruction,John Cox,DEM,100024,9,16,229,254,
Carter,Superintendent of Public Instruction,Joy Hofmeister,REP,100024,5,42,423,470,
Carter,Commissioner of Labor,Mike Workman,DEM,100024,7,10,176,193,
Carter,Commissioner of Labor,Mark Costello,REP,100024,7,49,476,532,
Carter,U.S. Senate,Matt Silverstein,DEM,100024,3,9,117,129,
Carter,U.S. Senate,Jim Inhofe,REP,100024,11,48,541,600,
Carter,U.S. Senate,Aaron Delozier,IND,100024,0,1,4,5,
Carter,U.S. Senate,Ray Woods,IND,100024,0,0,5,5,
Carter,U.S. Senate,Joan Farr,IND,100024,0,0,8,8,
Carter,U.S. Senate,Connie Johnson,DEM,100024,4,8,134,146,
Carter,U.S. Senate,James Lankford,REP,100024,10,49,515,574,
Carter,U.S. Senate,Mark Beard,IND,100024,1,1,18,20,
Carter,U.S. House,Bert Smith,DEM,100024,3,9,118,130,04
Carter,U.S. House,Tom Cole,REP,100024,11,49,539,599,04
Carter,U.S. House,Dennis Johnson,IND,100024,1,2,17,20,04
Carter,State Senate,Chequita Williams,DEM,100024,4,6,112,122,14
Carter,State Senate,Frank Simpson,REP,100024,11,54,558,623,14
Carter,Governor,Joe Dorman,DEM,100025,1,5,61,67,
Carter,Governor,Mary Fallin,REP,100025,2,16,111,129,
Carter,Governor,Kimberly Willis,IND,100025,0,1,5,6,
Carter,Governor,Richard Prawdzienski,IND,100025,0,0,3,3,
Carter,Lieutenant Governor,Cathy Cummings,DEM,100025,1,4,38,43,
Carter,Lieutenant Governor,Todd Lamb,REP,100025,2,18,141,161,
Carter,Superintendent of Public Instruction,John Cox,DEM,100025,1,8,74,83,
Carter,Superintendent of Public Instruction,Joy Hofmeister,REP,100025,2,14,102,118,
Carter,Commissioner of Labor,Mike Workman,DEM,100025,1,4,44,49,
Carter,Commissioner of Labor,Mark Costello,REP,100025,2,18,130,150,
Carter,U.S. Senate,Matt Silverstein,DEM,100025,1,2,30,33,
Carter,U.S. Senate,Jim Inhofe,REP,100025,2,20,145,167,
Carter,U.S. Senate,Aaron Delozier,IND,100025,0,0,1,1,
Carter,U.S. Senate,Ray Woods,IND,100025,0,0,2,2,
Carter,U.S. Senate,Joan Farr,IND,100025,0,0,1,1,
Carter,U.S. Senate,Connie Johnson,DEM,100025,1,3,34,38,
Carter,U.S. Senate,James Lankford,REP,100025,2,18,135,155,
Carter,U.S. Senate,Mark Beard,IND,100025,0,1,8,9,
Carter,U.S. House,Bert Smith,DEM,100025,1,1,17,19,04
Carter,U.S. House,Tom Cole,REP,100025,2,21,156,179,04
Carter,U.S. House,Dennis Johnson,IND,100025,0,0,6,6,04
Carter,State Senate,Chequita Williams,DEM,100025,1,2,25,28,14
Carter,State Senate,Frank Simpson,REP,100025,2,20,155,177,14
Carter,State House,Jessica Pfau,DEM,100025,1,10,47,58,49
Carter,State House,Tommy Hardin,REP,100025,2,12,132,146,49
Carter,Governor,Joe Dorman,DEM,100026,3,5,60,68,
Carter,Governor,Mary Fallin,REP,100026,5,4,82,91,
Carter,Governor,Kimberly Willis,IND,100026,0,0,7,7,
Carter,Governor,Richard Prawdzienski,IND,100026,0,0,2,2,
Carter,Lieutenant Governor,Cathy Cummings,DEM,100026,3,3,52,58,
Carter,Lieutenant Governor,Todd Lamb,REP,100026,5,6,98,109,
Carter,Superintendent of Public Instruction,John Cox,DEM,100026,1,7,70,78,
Carter,Superintendent of Public Instruction,Joy Hofmeister,REP,100026,7,2,80,89,
Carter,Commissioner of Labor,Mike Workman,DEM,100026,3,3,57,63,
Carter,Commissioner of Labor,Mark Costello,REP,100026,5,6,91,102,
Carter,U.S. Senate,Matt Silverstein,DEM,100026,3,2,35,40,
Carter,U.S. Senate,Jim Inhofe,REP,100026,5,7,107,119,
Carter,U.S. Senate,Aaron Delozier,IND,100026,0,0,1,1,
Carter,U.S. Senate,Ray Woods,IND,100026,0,0,4,4,
Carter,U.S. Senate,Joan Farr,IND,100026,0,0,3,3,
Carter,U.S. Senate,Connie Johnson,DEM,100026,3,3,45,51,
Carter,U.S. Senate,James Lankford,REP,100026,5,6,93,104,
Carter,U.S. Senate,Mark Beard,IND,100026,0,0,11,11,
Carter,U.S. House,Bert Smith,DEM,100026,3,2,37,42,04
Carter,U.S. House,Tom Cole,REP,100026,5,7,103,115,04
Carter,U.S. House,Dennis Johnson,IND,100026,0,0,11,11,04
Carter,State Senate,Chequita Williams,DEM,100026,3,2,42,47,14
Carter,State Senate,Frank Simpson,REP,100026,5,7,107,119,14
Carter,Governor,Joe Dorman,DEM,100030,0,3,63,66,
Carter,Governor,Mary Fallin,REP,100030,1,1,110,112,
Carter,Governor,Kimberly Willis,IND,100030,0,0,6,6,
Carter,Governor,Richard Prawdzienski,IND,100030,0,0,3,3,
Carter,Lieutenant Governor,Cathy Cummings,DEM,100030,1,1,50,52,
Carter,Lieutenant Governor,Todd Lamb,REP,100030,0,3,129,132,
Carter,Superintendent of Public Instruction,John Cox,DEM,100030,0,1,77,78,
Carter,Superintendent of Public Instruction,Joy Hofmeister,REP,100030,1,3,105,109,
Carter,Commissioner of Labor,Mike Workman,DEM,100030,1,2,46,49,
Carter,Commissioner of Labor,Mark Costello,REP,100030,0,2,128,130,
Carter,U.S. Senate,Matt Silverstein,DEM,100030,0,3,31,34,
Carter,U.S. Senate,Jim Inhofe,REP,100030,1,1,141,143,
Carter,U.S. Senate,Aaron Delozier,IND,100030,0,0,0,0,
Carter,U.S. Senate,Ray Woods,IND,100030,0,0,3,3,
Carter,U.S. Senate,Joan Farr,IND,100030,0,0,6,6,
Carter,U.S. Senate,Connie Johnson,DEM,100030,1,2,37,40,
Carter,U.S. Senate,James Lankford,REP,100030,0,1,132,133,
Carter,U.S. Senate,Mark Beard,IND,100030,0,1,10,11,
Carter,U.S. House,Bert Smith,DEM,100030,0,1,29,30,04
Carter,U.S. House,Tom Cole,REP,100030,1,2,144,147,04
Carter,U.S. House,Dennis Johnson,IND,100030,0,1,8,9,04
Carter,State Senate,Chequita Williams,DEM,100030,0,2,33,35,14
Carter,State Senate,Frank Simpson,REP,100030,1,2,145,148,14
Carter,State House,Jessica Pfau,DEM,100030,0,1,43,44,49
Carter,State House,Tommy Hardin,REP,100030,1,3,137,141,49
Carter,Governor,Joe Dorman,DEM,100031,6,21,328,355,
Carter,Governor,Mary Fallin,REP,100031,5,34,450,489,
Carter,Governor,Kimberly Willis,IND,100031,1,2,34,37,
Carter,Governor,Richard Prawdzienski,IND,100031,0,3,14,17,
Carter,Lieutenant Governor,Cathy Cummings,DEM,100031,6,19,223,248,
Carter,Lieutenant Governor,Todd Lamb,REP,100031,6,42,597,645,
Carter,Superintendent of Public Instruction,John Cox,DEM,100031,4,29,354,387,
Carter,Superintendent of Public Instruction,Joy Hofmeister,REP,100031,8,32,468,508,
Carter,Commissioner of Labor,Mike Workman,DEM,100031,7,21,262,290,
Carter,Commissioner of Labor,Mark Costello,REP,100031,5,38,547,590,
Carter,U.S. Senate,Matt Silverstein,DEM,100031,3,12,158,173,
Carter,U.S. Senate,Jim Inhofe,REP,100031,9,45,633,687,
Carter,U.S. Senate,Aaron Delozier,IND,100031,0,0,6,6,
Carter,U.S. Senate,Ray Woods,IND,100031,0,2,15,17,
Carter,U.S. Senate,Joan Farr,IND,100031,0,1,15,16,
Carter,U.S. Senate,Connie Johnson,DEM,100031,4,16,187,207,
Carter,U.S. Senate,James Lankford,REP,100031,8,38,592,638,
Carter,U.S. Senate,Mark Beard,IND,100031,0,6,43,49,
Carter,U.S. House,Bert Smith,DEM,100031,3,14,138,155,04
Carter,U.S. House,Tom Cole,REP,100031,8,41,653,702,04
Carter,U.S. House,Dennis Johnson,IND,100031,0,5,35,40,04
Carter,State Senate,Chequita Williams,DEM,100031,3,13,142,158,14
Carter,State Senate,Frank Simpson,REP,100031,9,48,684,741,14
Carter,State House,Jessica Pfau,DEM,100031,4,22,264,290,49
Carter,State House,Tommy Hardin,REP,100031,8,39,564,611,49
Carter,Governor,Joe Dorman,DEM,100032,0,3,79,82,
Carter,Governor,Mary Fallin,REP,100032,1,5,77,83,
Carter,Governor,Kimberly Willis,IND,100032,0,0,3,3,
Carter,Governor,Richard Prawdzienski,IND,100032,0,1,0,1,
Carter,Lieutenant Governor,Cathy Cummings,DEM,100032,0,0,65,65,
Carter,Lieutenant Governor,Todd Lamb,REP,100032,1,8,94,103,
Carter,Superintendent of Public Instruction,John Cox,DEM,100032,0,4,83,87,
Carter,Superintendent of Public Instruction,Joy Hofmeister,REP,100032,1,4,77,82,
Carter,Commissioner of Labor,Mike Workman,DEM,100032,0,1,74,75,
Carter,Commissioner of Labor,Mark Costello,REP,100032,1,7,84,92,
Carter,U.S. Senate,Matt Silverstein,DEM,100032,0,1,58,59,
Carter,U.S. Senate,Jim Inhofe,REP,100032,1,8,94,103,
Carter,U.S. Senate,Aaron Delozier,IND,100032,0,0,1,1,
Carter,U.S. Senate,Ray Woods,IND,100032,0,0,2,2,
Carter,U.S. Senate,Joan Farr,IND,100032,0,0,2,2,
Carter,U.S. Senate,Connie Johnson,DEM,100032,0,1,60,61,
Carter,U.S. Senate,James Lankford,REP,100032,1,7,93,101,
Carter,U.S. Senate,Mark Beard,IND,100032,0,0,7,7,
Carter,U.S. House,Bert Smith,DEM,100032,0,0,55,55,04
Carter,U.S. House,Tom Cole,REP,100032,1,9,100,110,04
Carter,U.S. House,Dennis Johnson,IND,100032,0,0,4,4,04
Carter,State Senate,Chequita Williams,DEM,100032,0,1,56,57,14
Carter,State Senate,Frank Simpson,REP,100032,1,8,104,113,14
Carter,Governor,Joe Dorman,DEM,100033,5,7,109,121,
Carter,Governor,Mary Fallin,REP,100033,3,8,166,177,
Carter,Governor,Kimberly Willis,IND,100033,0,0,10,10,
Carter,Governor,Richard Prawdzienski,IND,100033,0,0,5,5,
Carter,Lieutenant Governor,Cathy Cummings,DEM,100033,5,3,88,96,
Carter,Lieutenant Governor,Todd Lamb,REP,100033,3,12,200,215,
Carter,Superintendent of Public Instruction,John Cox,DEM,100033,4,3,130,137,
Carter,Superintendent of Public Instruction,Joy Hofmeister,REP,100033,4,12,157,173,
Carter,Commissioner of Labor,Mike Workman,DEM,100033,5,3,93,101,
Carter,Commissioner of Labor,Mark Costello,REP,100033,3,12,187,202,
Carter,U.S. Senate,Matt Silverstein,DEM,100033,3,2,63,68,
Carter,U.S. Senate,Jim Inhofe,REP,100033,5,13,214,232,
Carter,U.S. Senate,Aaron Delozier,IND,100033,0,0,1,1,
Carter,U.S. Senate,Ray Woods,IND,100033,0,0,5,5,
Carter,U.S. Senate,Joan Farr,IND,100033,0,0,5,5,
Carter,U.S. Senate,Connie Johnson,DEM,100033,4,2,77,83,
Carter,U.S. Senate,James Lankford,REP,100033,4,14,193,211,
Carter,U.S. Senate,Mark Beard,IND,100033,0,0,19,19,
Carter,U.S. House,Bert Smith,DEM,100033,4,2,64,70,04
Carter,U.S. House,Tom Cole,REP,100033,4,14,210,228,04
Carter,U.S. House,Dennis Johnson,IND,100033,0,0,14,14,04
Carter,State Senate,Chequita Williams,DEM,100033,1,2,61,64,14
Carter,State Senate,Frank Simpson,REP,100033,7,14,227,248,14
Carter,Governor,Joe Dorman,DEM,100034,2,8,172,182,
Carter,Governor,Mary Fallin,REP,100034,0,16,215,231,
Carter,Governor,Kimberly Willis,IND,100034,0,1,18,19,
Carter,Governor,Richard Prawdzienski,IND,100034,0,0,5,5,
Carter,Lieutenant Governor,Cathy Cummings,DEM,100034,2,8,133,143,
Carter,Lieutenant Governor,Todd Lamb,REP,100034,0,17,273,290,
Carter,Superintendent of Public Instruction,John Cox,DEM,100034,2,11,188,201,
Carter,Superintendent of Public Instruction,Joy Hofmeister,REP,100034,0,14,219,233,
Carter,Commissioner of Labor,Mike Workman,DEM,100034,2,8,150,160,
Carter,Commissioner of Labor,Mark Costello,REP,100034,0,18,255,273,
Carter,U.S. Senate,Matt Silverstein,DEM,100034,2,6,90,98,
Carter,U.S. Senate,Jim Inhofe,REP,100034,0,18,303,321,
Carter,U.S. Senate,Aaron Delozier,IND,100034,0,0,5,5,
Carter,U.S. Senate,Ray Woods,IND,100034,0,2,6,8,
Carter,U.S. Senate,Joan Farr,IND,100034,0,0,5,5,
Carter,U.S. Senate,Connie Johnson,DEM,100034,2,7,109,118,
Carter,U.S. Senate,James Lankford,REP,100034,0,19,278,297,
Carter,U.S. Senate,Mark Beard,IND,100034,0,0,21,21,
Carter,U.S. House,Bert Smith,DEM,100034,1,6,76,83,04
Carter,U.S. House,Tom Cole,REP,100034,0,17,314,331,04
Carter,U.S. House,Dennis Johnson,IND,100034,1,2,21,24,04
Carter,State Senate,Chequita Williams,DEM,100034,2,4,84,90,14
Carter,State Senate,Frank Simpson,REP,100034,0,22,324,346,14
Carter,State House,Jessica Pfau,DEM,100034,2,10,149,161,49
Carter,State House,Tommy Hardin,REP,100034,0,16,262,278,49
Carter,Governor,Joe Dorman,DEM,100039,3,6,73,82,
Carter,Governor,Mary Fallin,REP,100039,1,3,100,104,
Carter,Governor,Kimberly Willis,IND,100039,0,1,3,4,
Carter,Governor,Richard Prawdzienski,IND,100039,0,0,3,3,
Carter,Lieutenant Governor,Cathy Cummings,DEM,100039,3,4,45,52,
Carter,Lieutenant Governor,Todd Lamb,REP,100039,1,6,130,137,
Carter,Superintendent of Public Instruction,John Cox,DEM,100039,3,6,68,77,
Carter,Superintendent of Public Instruction,Joy Hofmeister,REP,100039,1,4,106,111,
Carter,Commissioner of Labor,Mike Workman,DEM,100039,3,6,57,66,
Carter,Commissioner of Labor,Mark Costello,REP,100039,1,4,114,119,
Carter,U.S. Senate,Matt Silverstein,DEM,100039,2,2,23,27,
Carter,U.S. Senate,Jim Inhofe,REP,100039,2,7,151,160,
Carter,U.S. Senate,Aaron Delozier,IND,100039,0,0,0,0,
Carter,U.S. Senate,Ray Woods,IND,100039,0,0,1,1,
Carter,U.S. Senate,Joan Farr,IND,100039,0,1,3,4,
Carter,U.S. Senate,Connie Johnson,DEM,100039,3,4,44,51,
Carter,U.S. Senate,James Lankford,REP,100039,1,5,125,131,
Carter,U.S. Senate,Mark Beard,IND,100039,0,1,7,8,
Carter,U.S. House,Bert Smith,DEM,100039,3,2,24,29,04
Carter,U.S. House,Tom Cole,REP,100039,1,8,149,158,04
Carter,U.S. House,Dennis Johnson,IND,100039,0,0,5,5,04
Carter,State Senate,Chequita Williams,DEM,100039,1,2,32,35,14
Carter,State Senate,Frank Simpson,REP,100039,3,8,144,155,14
Carter,Governor,Joe Dorman,DEM,100041,2,7,186,195,
Carter,Governor,Mary Fallin,REP,100041,5,12,305,322,
Carter,Governor,Kimberly Willis,IND,100041,0,0,21,21,
Carter,Governor,Richard Prawdzienski,IND,100041,0,0,6,6,
Carter,Lieutenant Governor,Cathy Cummings,DEM,100041,3,3,125,131,
Carter,Lieutenant Governor,Todd Lamb,REP,100041,4,16,388,408,
Carter,Superintendent of Public Instruction,John Cox,DEM,100041,4,9,228,241,
Carter,Superintendent of Public Instruction,Joy Hofmeister,REP,100041,3,10,285,298,
Carter,Commissioner of Labor,Mike Workman,DEM,100041,5,8,150,163,
Carter,Commissioner of Labor,Mark Costello,REP,100041,2,11,357,370,
Carter,U.S. Senate,Matt Silverstein,DEM,100041,2,0,75,77,
Carter,U.S. Senate,Jim Inhofe,REP,100041,5,18,423,446,
Carter,U.S. Senate,Aaron Delozier,IND,100041,0,0,1,1,
Carter,U.S. Senate,Ray Woods,IND,100041,0,1,7,8,
Carter,U.S. Senate,Joan Farr,IND,100041,0,0,9,9,
Carter,U.S. Senate,Connie Johnson,DEM,100041,5,0,95,100,
Carter,U.S. Senate,James Lankford,REP,100041,2,18,395,415,
Carter,U.S. Senate,Mark Beard,IND,100041,0,0,21,21,
Carter,U.S. House,Bert Smith,DEM,100041,2,1,72,75,04
Carter,U.S. House,Tom Cole,REP,100041,5,18,428,451,04
Carter,U.S. House,Dennis Johnson,IND,100041,0,0,17,17,04
Carter,State Senate,Chequita Williams,DEM,100041,2,0,87,89,14
Carter,State Senate,Frank Simpson,REP,100041,5,19,425,449,14
Carter,Governor,Joe Dorman,DEM,100051,0,0,77,77,
Carter,Governor,Mary Fallin,REP,100051,0,5,69,74,
Carter,Governor,Kimberly Willis,IND,100051,0,0,3,3,
Carter,Governor,Richard Prawdzienski,IND,100051,0,0,1,1,
Carter,Lieutenant Governor,Cathy Cummings,DEM,100051,0,0,57,57,
Carter,Lieutenant Governor,Todd Lamb,REP,100051,0,5,93,98,
Carter,Superintendent of Public Instruction,John Cox,DEM,100051,0,0,82,82,
Carter,Superintendent of Public Instruction,Joy Hofmeister,REP,100051,0,5,68,73,
Carter,Commissioner of Labor,Mike Workman,DEM,100051,0,0,63,63,
Carter,Commissioner of Labor,Mark Costello,REP,100051,0,5,82,87,
Carter,U.S. Senate,Matt Silverstein,DEM,100051,0,0,45,45,
Carter,U.S. Senate,Jim Inhofe,REP,100051,0,5,99,104,
Carter,U.S. Senate,Aaron Delozier,IND,100051,0,0,1,1,
Carter,U.S. Senate,Ray Woods,IND,100051,0,0,3,3,
Carter,U.S. Senate,Joan Farr,IND,100051,0,0,1,1,
Carter,U.S. Senate,Connie Johnson,DEM,100051,0,0,54,54,
Carter,U.S. Senate,James Lankford,REP,100051,0,5,90,95,
Carter,U.S. Senate,Mark Beard,IND,100051,0,0,4,4,
Carter,U.S. House,Bert Smith,DEM,100051,0,0,50,50,04
Carter,U.S. House,Tom Cole,REP,100051,0,5,96,101,04
Carter,U.S. House,Dennis Johnson,IND,100051,0,0,5,5,04
Carter,State Senate,Chequita Williams,DEM,100051,0,0,50,50,14
Carter,State Senate,Frank Simpson,REP,100051,0,4,99,103,14
Carter,Governor,Joe Dorman,DEM,100052,2,1,83,86,
Carter,Governor,Mary Fallin,REP,100052,4,2,153,159,
Carter,Governor,Kimberly Willis,IND,100052,0,0,6,6,
Carter,Governor,Richard Prawdzienski,IND,100052,0,0,3,3,
Carter,Lieutenant Governor,Cathy Cummings,DEM,100052,2,1,48,51,
Carter,Lieutenant Governor,Todd Lamb,REP,100052,4,2,196,202,
Carter,Superintendent of Public Instruction,John Cox,DEM,100052,4,2,100,106,
Carter,Superintendent of Public Instruction,Joy Hofmeister,REP,100052,2,1,145,148,
Carter,Commissioner of Labor,Mike Workman,DEM,100052,4,1,59,64,
Carter,Commissioner of Labor,Mark Costello,REP,100052,2,2,183,187,
Carter,U.S. Senate,Matt Silverstein,DEM,100052,2,1,31,34,
Carter,U.S. Senate,Jim Inhofe,REP,100052,4,2,211,217,
Carter,U.S. Senate,Aaron Delozier,IND,100052,0,0,1,1,
Carter,U.S. Senate,Ray Woods,IND,100052,0,0,2,2,
Carter,U.S. Senate,Joan Farr,IND,100052,0,0,1,1,
Carter,U.S. Senate,Connie Johnson,DEM,100052,2,1,40,43,
Carter,U.S. Senate,James Lankford,REP,100052,4,2,195,201,
Carter,U.S. Senate,Mark Beard,IND,100052,0,0,9,9,
Carter,U.S. House,Bert Smith,DEM,100052,2,1,30,33,04
Carter,U.S. House,Tom Cole,REP,100052,4,2,205,211,04
Carter,U.S. House,Dennis Johnson,IND,100052,0,0,12,12,04
Carter,State Senate,Chequita Williams,DEM,100052,2,1,39,42,14
Carter,State Senate,Frank Simpson,REP,100052,4,2,206,212,14
Carter,Governor,Joe Dorman,DEM,100061,0,2,98,100,
Carter,Governor,Mary Fallin,REP,100061,2,8,153,163,
Carter,Governor,Kimberly Willis,IND,100061,0,1,9,10,
Carter,Governor,Richard Prawdzienski,IND,100061,0,0,4,4,
Carter,Lieutenant Governor,Cathy Cummings,DEM,100061,0,1,69,70,
Carter,Lieutenant Governor,Todd Lamb,REP,100061,2,9,194,205,
Carter,Superintendent of Public Instruction,John Cox,DEM,100061,0,3,101,104,
Carter,Superintendent of Public Instruction,Joy Hofmeister,REP,100061,1,7,162,170,
Carter,Commissioner of Labor,Mike Workman,DEM,100061,0,1,76,77,
Carter,Commissioner of Labor,Mark Costello,REP,100061,1,9,185,195,
Carter,U.S. Senate,Matt Silverstein,DEM,100061,0,1,47,48,
Carter,U.S. Senate,Jim Inhofe,REP,100061,2,9,208,219,
Carter,U.S. Senate,Aaron Delozier,IND,100061,0,0,2,2,
Carter,U.S. Senate,Ray Woods,IND,100061,0,0,4,4,
Carter,U.S. Senate,Joan Farr,IND,100061,0,0,3,3,
Carter,U.S. Senate,Connie Johnson,DEM,100061,0,1,50,51,
Carter,U.S. Senate,James Lankford,REP,100061,2,10,197,209,
Carter,U.S. Senate,Mark Beard,IND,100061,0,0,14,14,
Carter,U.S. House,Bert Smith,DEM,100061,0,1,44,45,04
Carter,U.S. House,Tom Cole,REP,100061,2,10,209,221,04
Carter,U.S. House,Dennis Johnson,IND,100061,0,0,10,10,04
Carter,State Senate,Chequita Williams,DEM,100061,0,1,48,49,14
Carter,State Senate,Frank Simpson,REP,100061,2,10,214,226,14
Carter,State House,Jessica Pfau,DEM,100061,1,3,84,88,49
Carter,State House,Tommy Hardin,REP,100061,1,8,178,187,49
Carter,Governor,Joe Dorman,DEM,100062,1,23,173,197,
Carter,Governor,Mary Fallin,REP,100062,1,19,241,261,
Carter,Governor,Kimberly Willis,IND,100062,1,1,12,14,
Carter,Governor,Richard Prawdzienski,IND,100062,0,2,8,10,
Carter,Lieutenant Governor,Cathy Cummings,DEM,100062,2,18,128,148,
Carter,Lieutenant Governor,Todd Lamb,REP,100062,1,27,301,329,
Carter,Superintendent of Public Instruction,John Cox,DEM,100062,2,29,167,198,
Carter,Superintendent of Public Instruction,Joy Hofmeister,REP,100062,1,17,260,278,
Carter,Commissioner of Labor,Mike Workman,DEM,100062,2,22,144,168,
Carter,Commissioner of Labor,Mark Costello,REP,100062,1,22,276,299,
Carter,U.S. Senate,Matt Silverstein,DEM,100062,1,17,103,121,
Carter,U.S. Senate,Jim Inhofe,REP,100062,2,27,317,346,
Carter,U.S. Senate,Aaron Delozier,IND,100062,0,0,3,3,
Carter,U.S. Senate,Ray Woods,IND,100062,0,2,3,5,
Carter,U.S. Senate,Joan Farr,IND,100062,0,0,9,9,
Carter,U.S. Senate,Connie Johnson,DEM,100062,2,15,111,128,
Carter,U.S. Senate,James Lankford,REP,100062,1,28,298,327,
Carter,U.S. Senate,Mark Beard,IND,100062,0,2,20,22,
Carter,U.S. House,Bert Smith,DEM,100062,1,11,88,100,04
Carter,U.S. House,Tom Cole,REP,100062,2,34,322,358,04
Carter,U.S. House,Dennis Johnson,IND,100062,0,1,20,21,04
Carter,State Senate,Chequita Williams,DEM,100062,2,8,94,104,14
Carter,State Senate,Frank Simpson,REP,100062,1,38,336,375,14
Carter,State House,Jessica Pfau,DEM,100062,2,16,158,176,49
Carter,State House,Tommy Hardin,REP,100062,1,29,275,305,49
Carter,Governor,Joe Dorman,DEM,100063,0,16,191,207,
Carter,Governor,Mary Fallin,REP,100063,3,27,317,347,
Carter,Governor,Kimberly Willis,IND,100063,0,0,15,15,
Carter,Governor,Richard Prawdzienski,IND,100063,0,0,10,10,
Carter,Lieutenant Governor,Cathy Cummings,DEM,100063,0,14,152,166,
Carter,Lieutenant Governor,Todd Lamb,REP,100063,3,30,381,414,
Carter,Superintendent of Public Instruction,John Cox,DEM,100063,0,24,217,241,
Carter,Superintendent of Public Instruction,Joy Hofmeister,REP,100063,3,20,315,338,
Carter,Commissioner of Labor,Mike Workman,DEM,100063,0,18,155,173,
Carter,Commissioner of Labor,Mark Costello,REP,100063,3,26,366,395,
Carter,U.S. Senate,Matt Silverstein,DEM,100063,0,12,107,119,
Carter,U.S. Senate,Jim Inhofe,REP,100063,3,31,406,440,
Carter,U.S. Senate,Aaron Delozier,IND,100063,0,1,4,5,
Carter,U.S. Senate,Ray Woods,IND,100063,0,1,5,6,
Carter,U.S. Senate,Joan Farr,IND,100063,0,0,11,11,
Carter,U.S. Senate,Connie Johnson,DEM,100063,0,17,133,150,
Carter,U.S. Senate,James Lankford,REP,100063,3,27,360,390,
Carter,U.S. Senate,Mark Beard,IND,100063,0,0,33,33,
Carter,U.S. House,Bert Smith,DEM,100063,0,12,96,108,04
Carter,U.S. House,Tom Cole,REP,100063,3,31,406,440,04
Carter,U.S. House,Dennis Johnson,IND,100063,0,1,30,31,04
Carter,State Senate,Chequita Williams,DEM,100063,0,12,103,115,14
Carter,State Senate,Frank Simpson,REP,100063,3,33,428,464,14
Carter,State House,Jessica Pfau,DEM,100063,0,19,211,230,49
Carter,State House,Tommy Hardin,REP,100063,3,26,321,350,49
Carter,Governor,Joe Dorman,DEM,100071,3,3,194,200,
Carter,Governor,Mary Fallin,REP,100071,7,9,222,238,
Carter,Governor,Kimberly Willis,IND,100071,0,1,15,16,
Carter,Governor,Richard Prawdzienski,IND,100071,0,0,10,10,
Carter,Lieutenant Governor,Cathy Cummings,DEM,100071,3,2,144,149,
Carter,Lieutenant Governor,Todd Lamb,REP,100071,7,10,294,311,
Carter,Superintendent of Public Instruction,John Cox,DEM,100071,5,2,220,227,
Carter,Superintendent of Public Instruction,Joy Hofmeister,REP,100071,5,10,223,238,
Carter,Commissioner of Labor,Mike Workman,DEM,100071,4,2,160,166,
Carter,Commissioner of Labor,Mark Costello,REP,100071,6,10,278,294,
Carter,U.S. Senate,Matt Silverstein,DEM,100071,3,1,82,86,
Carter,U.S. Senate,Jim Inhofe,REP,100071,7,10,337,354,
Carter,U.S. Senate,Aaron Delozier,IND,100071,0,1,3,4,
Carter,U.S. Senate,Ray Woods,IND,100071,0,0,12,12,
Carter,U.S. Senate,Joan Farr,IND,100071,0,0,4,4,
Carter,U.S. Senate,Connie Johnson,DEM,100071,1,2,109,112,
Carter,U.S. Senate,James Lankford,REP,100071,9,9,292,310,
Carter,U.S. Senate,Mark Beard,IND,100071,0,1,31,32,
Carter,U.S. House,Bert Smith,DEM,100071,1,2,78,81,04
Carter,U.S. House,Tom Cole,REP,100071,9,9,340,358,04
Carter,U.S. House,Dennis Johnson,IND,100071,0,1,19,20,04
Carter,State Senate,Chequita Williams,DEM,100071,4,1,92,97,14
Carter,State Senate,Frank Simpson,REP,100071,6,12,346,364,14
Cherokee,Governor,Joe Dorman,DEM,110001,4,26,275,305,
Cherokee,Governor,Mary Fallin,REP,110001,11,19,152,182,
Cherokee,Governor,Kimberly Willis,IND,110001,0,1,17,18,
Cherokee,Governor,Richard Prawdzienski,IND,110001,1,0,7,8,
Cherokee,Lieutenant Governor,Cathy Cummings,DEM,110001,7,18,238,263,
Cherokee,Lieutenant Governor,Todd Lamb,REP,110001,9,28,210,247,
Cherokee,Superintendent of Public Instruction,John Cox,DEM,110001,9,32,330,371,
Cherokee,Superintendent of Public Instruction,Joy Hofmeister,REP,110001,7,13,119,139,
Cherokee,Commissioner of Labor,Mike Workman,DEM,110001,5,23,258,286,
Cherokee,Commissioner of Labor,Mark Costello,REP,110001,10,22,181,213,
Cherokee,U.S. Senate,Matt Silverstein,DEM,110001,5,18,219,242,
Cherokee,U.S. Senate,Jim Inhofe,REP,110001,7,25,209,241,
Cherokee,U.S. Senate,Aaron Delozier,IND,110001,1,0,4,5,
Cherokee,U.S. Senate,Ray Woods,IND,110001,0,2,6,8,
Cherokee,U.S. Senate,Joan Farr,IND,110001,2,1,14,17,
Cherokee,U.S. Senate,Connie Johnson,DEM,110001,6,17,210,233,
Cherokee,U.S. Senate,James Lankford,REP,110001,8,27,215,250,
Cherokee,U.S. Senate,Mark Beard,IND,110001,2,1,22,25,
Cherokee,U.S. House,Earl Everett,DEM,110001,6,15,155,176,02
Cherokee,U.S. House,Markwayne Mullin,REP,110001,8,27,236,271,02
Cherokee,U.S. House,Jon Douthitt,IND,110001,2,4,58,64,02
Cherokee,Governor,Joe Dorman,DEM,110002,11,80,465,556,
Cherokee,Governor,Mary Fallin,REP,110002,9,59,387,455,
Cherokee,Governor,Kimberly Willis,IND,110002,0,0,18,18,
Cherokee,Governor,Richard Prawdzienski,IND,110002,0,1,15,16,
Cherokee,Lieutenant Governor,Cathy Cummings,DEM,110002,9,65,346,420,
Cherokee,Lieutenant Governor,Todd Lamb,REP,110002,10,74,536,620,
Cherokee,Superintendent of Public Instruction,John Cox,DEM,110002,14,102,529,645,
Cherokee,Superintendent of Public Instruction,Joy Hofmeister,REP,110002,6,38,355,399,
Cherokee,Commissioner of Labor,Mike Workman,DEM,110002,8,74,418,500,
Cherokee,Commissioner of Labor,Mark Costello,REP,110002,10,63,452,525,
Cherokee,U.S. Senate,Matt Silverstein,DEM,110002,10,61,336,407,
Cherokee,U.S. Senate,Jim Inhofe,REP,110002,10,69,516,595,
Cherokee,U.S. Senate,Aaron Delozier,IND,110002,0,4,6,10,
Cherokee,U.S. Senate,Ray Woods,IND,110002,0,2,15,17,
Cherokee,U.S. Senate,Joan Farr,IND,110002,0,2,10,12,
Cherokee,U.S. Senate,Connie Johnson,DEM,110002,8,63,322,393,
Cherokee,U.S. Senate,James Lankford,REP,110002,12,75,525,612,
Cherokee,U.S. Senate,Mark Beard,IND,110002,0,1,37,38,
Cherokee,U.S. House,Earl Everett,DEM,110002,8,58,240,306,02
Cherokee,U.S. House,Markwayne Mullin,REP,110002,12,77,565,654,02
Cherokee,U.S. House,Jon Douthitt,IND,110002,0,4,75,79,02
Cherokee,Governor,Joe Dorman,DEM,110003,10,123,283,416,
Cherokee,Governor,Mary Fallin,REP,110003,4,41,350,395,
Cherokee,Governor,Kimberly Willis,IND,110003,0,6,17,23,
Cherokee,Governor,Richard Prawdzienski,IND,110003,0,2,8,10,
Cherokee,Lieutenant Governor,Cathy Cummings,DEM,110003,8,100,218,326,
Cherokee,Lieutenant Governor,Todd Lamb,REP,110003,6,72,438,516,
Cherokee,Superintendent of Public Instruction,John Cox,DEM,110003,11,132,341,484,
Cherokee,Superintendent of Public Instruction,Joy Hofmeister,REP,110003,2,40,313,355,
Cherokee,Commissioner of Labor,Mike Workman,DEM,110003,10,111,269,390,
Cherokee,Commissioner of Labor,Mark Costello,REP,110003,4,59,371,434,
Cherokee,U.S. Senate,Matt Silverstein,DEM,110003,7,92,209,308,
Cherokee,U.S. Senate,Jim Inhofe,REP,110003,6,72,430,508,
Cherokee,U.S. Senate,Aaron Delozier,IND,110003,0,1,4,5,
Cherokee,U.S. Senate,Ray Woods,IND,110003,0,3,7,10,
Cherokee,U.S. Senate,Joan Farr,IND,110003,0,2,6,8,
Cherokee,U.S. Senate,Connie Johnson,DEM,110003,8,92,209,309,
Cherokee,U.S. Senate,James Lankford,REP,110003,5,72,426,503,
Cherokee,U.S. Senate,Mark Beard,IND,110003,0,8,19,27,
Cherokee,U.S. House,Earl Everett,DEM,110003,7,87,141,235,02
Cherokee,U.S. House,Markwayne Mullin,REP,110003,6,80,465,551,02
Cherokee,U.S. House,Jon Douthitt,IND,110003,1,5,47,53,02
Cherokee,Governor,Joe Dorman,DEM,110004,10,67,340,417,
Cherokee,Governor,Mary Fallin,REP,110004,4,31,267,302,
Cherokee,Governor,Kimberly Willis,IND,110004,0,3,11,14,
Cherokee,Governor,Richard Prawdzienski,IND,110004,0,0,8,8,
Cherokee,Lieutenant Governor,Cathy Cummings,DEM,110004,7,61,273,341,
Cherokee,Lieutenant Governor,Todd Lamb,REP,110004,5,40,351,396,
Cherokee,Superintendent of Public Instruction,John Cox,DEM,110004,12,72,397,481,
Cherokee,Superintendent of Public Instruction,Joy Hofmeister,REP,110004,1,29,228,258,
Cherokee,Commissioner of Labor,Mike Workman,DEM,110004,7,60,341,408,
Cherokee,Commissioner of Labor,Mark Costello,REP,110004,4,40,273,317,
Cherokee,U.S. Senate,Matt Silverstein,DEM,110004,5,59,268,332,
Cherokee,U.S. Senate,Jim Inhofe,REP,110004,7,38,340,385,
Cherokee,U.S. Senate,Aaron Delozier,IND,110004,0,1,6,7,
Cherokee,U.S. Senate,Ray Woods,IND,110004,1,0,8,9,
Cherokee,U.S. Senate,Joan Farr,IND,110004,0,3,3,6,
Cherokee,U.S. Senate,Connie Johnson,DEM,110004,7,56,256,319,
Cherokee,U.S. Senate,James Lankford,REP,110004,6,44,339,389,
Cherokee,U.S. Senate,Mark Beard,IND,110004,1,1,27,29,
Cherokee,U.S. House,Earl Everett,DEM,110004,4,48,207,259,02
Cherokee,U.S. House,Markwayne Mullin,REP,110004,7,43,365,415,02
Cherokee,U.S. House,Jon Douthitt,IND,110004,2,8,50,60,02
Cherokee,Governor,Joe Dorman,DEM,110005,0,8,88,96,
Cherokee,Governor,Mary Fallin,REP,110005,2,7,52,61,
Cherokee,Governor,Kimberly Willis,IND,110005,0,0,4,4,
Cherokee,Governor,Richard Prawdzienski,IND,110005,0,0,2,2,
Cherokee,Lieutenant Governor,Cathy Cummings,DEM,110005,0,5,74,79,
Cherokee,Lieutenant Governor,Todd Lamb,REP,110005,2,10,72,84,
Cherokee,Superintendent of Public Instruction,John Cox,DEM,110005,0,10,101,111,
Cherokee,Superintendent of Public Instruction,Joy Hofmeister,REP,110005,2,5,46,53,
Cherokee,Commissioner of Labor,Mike Workman,DEM,110005,0,8,83,91,
Cherokee,Commissioner of Labor,Mark Costello,REP,110005,2,7,58,67,
Cherokee,U.S. Senate,Matt Silverstein,DEM,110005,0,6,67,73,
Cherokee,U.S. Senate,Jim Inhofe,REP,110005,2,9,77,88,
Cherokee,U.S. Senate,Aaron Delozier,IND,110005,0,0,0,0,
Cherokee,U.S. Senate,Ray Woods,IND,110005,0,0,3,3,
Cherokee,U.S. Senate,Joan Farr,IND,110005,0,0,1,1,
Cherokee,U.S. Senate,Connie Johnson,DEM,110005,0,6,65,71,
Cherokee,U.S. Senate,James Lankford,REP,110005,2,9,80,91,
Cherokee,U.S. Senate,Mark Beard,IND,110005,0,0,4,4,
Cherokee,U.S. House,Earl Everett,DEM,110005,0,5,62,67,02
Cherokee,U.S. House,Markwayne Mullin,REP,110005,2,10,78,90,02
Cherokee,U.S. House,Jon Douthitt,IND,110005,0,0,9,9,02
Cherokee,Governor,Joe Dorman,DEM,110006,6,13,126,145,
Cherokee,Governor,Mary Fallin,REP,110006,4,16,100,120,
Cherokee,Governor,Kimberly Willis,IND,110006,0,0,6,6,
Cherokee,Governor,Richard Prawdzienski,IND,110006,0,0,3,3,
Cherokee,Lieutenant Governor,Cathy Cummings,DEM,110006,5,10,89,104,
Cherokee,Lieutenant Governor,Todd Lamb,REP,110006,5,19,141,165,
Cherokee,Superintendent of Public Instruction,John Cox,DEM,110006,6,18,149,173,
Cherokee,Superintendent of Public Instruction,Joy Hofmeister,REP,110006,4,11,83,98,
Cherokee,Commissioner of Labor,Mike Workman,DEM,110006,6,14,108,128,
Cherokee,Commissioner of Labor,Mark Costello,REP,110006,3,14,115,132,
Cherokee,U.S. Senate,Matt Silverstein,DEM,110006,8,12,86,106,
Cherokee,U.S. Senate,Jim Inhofe,REP,110006,2,17,140,159,
Cherokee,U.S. Senate,Aaron Delozier,IND,110006,0,0,2,2,
Cherokee,U.S. Senate,Ray Woods,IND,110006,0,0,2,2,
Cherokee,U.S. Senate,Joan Farr,IND,110006,0,0,3,3,
Cherokee,U.S. Senate,Connie Johnson,DEM,110006,5,10,84,99,
Cherokee,U.S. Senate,James Lankford,REP,110006,4,18,140,162,
Cherokee,U.S. Senate,Mark Beard,IND,110006,1,1,7,9,
Cherokee,U.S. House,Earl Everett,DEM,110006,5,6,66,77,02
Cherokee,U.S. House,Markwayne Mullin,REP,110006,5,21,153,179,02
Cherokee,U.S. House,Jon Douthitt,IND,110006,0,2,12,14,02
Cherokee,Governor,Joe Dorman,DEM,110007,0,3,30,33,
Cherokee,Governor,Mary Fallin,REP,110007,2,0,13,15,
Cherokee,Governor,Kimberly Willis,IND,110007,0,0,2,2,
Cherokee,Governor,Richard Prawdzienski,IND,110007,0,0,0,0,
Cherokee,Lieutenant Governor,Cathy Cummings,DEM,110007,0,2,14,16,
Cherokee,Lieutenant Governor,Todd Lamb,REP,110007,2,1,30,33,
Cherokee,Superintendent of Public Instruction,John Cox,DEM,110007,0,2,34,36,
Cherokee,Superintendent of Public Instruction,Joy Hofmeister,REP,110007,2,1,11,14,
Cherokee,Commissioner of Labor,Mike Workman,DEM,110007,0,2,26,28,
Cherokee,Commissioner of Labor,Mark Costello,REP,110007,2,1,18,21,
Cherokee,U.S. Senate,Matt Silverstein,DEM,110007,0,0,16,16,
Cherokee,U.S. Senate,Jim Inhofe,REP,110007,2,0,26,28,
Cherokee,U.S. Senate,Aaron Delozier,IND,110007,0,0,2,2,
Cherokee,U.S. Senate,Ray Woods,IND,110007,0,2,0,2,
Cherokee,U.S. Senate,Joan Farr,IND,110007,0,1,0,1,
Cherokee,U.S. Senate,Connie Johnson,DEM,110007,0,1,16,17,
Cherokee,U.S. Senate,James Lankford,REP,110007,2,1,24,27,
Cherokee,U.S. Senate,Mark Beard,IND,110007,0,1,4,5,
Cherokee,U.S. House,Earl Everett,DEM,110007,0,3,12,15,02
Cherokee,U.S. House,Markwayne Mullin,REP,110007,2,0,32,34,02
Cherokee,U.S. House,Jon Douthitt,IND,110007,0,0,1,1,02
Cherokee,Governor,Joe Dorman,DEM,110008,1,14,102,117,
Cherokee,Governor,Mary Fallin,REP,110008,0,10,60,70,
Cherokee,Governor,Kimberly Willis,IND,110008,0,1,5,6,
Cherokee,Governor,Richard Prawdzienski,IND,110008,0,0,2,2,
Cherokee,Lieutenant Governor,Cathy Cummings,DEM,110008,1,11,77,89,
Cherokee,Lieutenant Governor,Todd Lamb,REP,110008,0,14,93,107,
Cherokee,Superintendent of Public Instruction,John Cox,DEM,110008,1,17,127,145,
Cherokee,Superintendent of Public Instruction,Joy Hofmeister,REP,110008,0,7,43,50,
Cherokee,Commissioner of Labor,Mike Workman,DEM,110008,1,15,100,116,
Cherokee,Commissioner of Labor,Mark Costello,REP,110008,0,10,66,76,
Cherokee,U.S. Senate,Matt Silverstein,DEM,110008,1,10,79,90,
Cherokee,U.S. Senate,Jim Inhofe,REP,110008,0,13,82,95,
Cherokee,U.S. Senate,Aaron Delozier,IND,110008,0,0,2,2,
Cherokee,U.S. Senate,Ray Woods,IND,110008,0,0,2,2,
Cherokee,U.S. Senate,Joan Farr,IND,110008,0,1,5,6,
Cherokee,U.S. Senate,Connie Johnson,DEM,110008,1,13,76,90,
Cherokee,U.S. Senate,James Lankford,REP,110008,0,10,85,95,
Cherokee,U.S. Senate,Mark Beard,IND,110008,0,1,9,10,
Cherokee,U.S. House,Earl Everett,DEM,110008,1,9,59,69,02
Cherokee,U.S. House,Markwayne Mullin,REP,110008,0,14,92,106,02
Cherokee,U.S. House,Jon Douthitt,IND,110008,0,1,19,20,02
Cherokee,State House,Will Fourkiller,DEM,110008,1,16,122,139,86
Cherokee,State House,Tonya Teaney,REP,110008,0,9,48,57,86
Cherokee,Governor,Joe Dorman,DEM,110009,6,4,152,162,
Cherokee,Governor,Mary Fallin,REP,110009,8,13,309,330,
Cherokee,Governor,Kimberly Willis,IND,110009,0,0,7,7,
Cherokee,Governor,Richard Prawdzienski,IND,110009,0,0,8,8,
Cherokee,Lieutenant Governor,Cathy Cummings,DEM,110009,5,3,137,145,
Cherokee,Lieutenant Governor,Todd Lamb,REP,110009,9,14,339,362,
Cherokee,Superintendent of Public Instruction,John Cox,DEM,110009,4,5,199,208,
Cherokee,Superintendent of Public Instruction,Joy Hofmeister,REP,110009,10,12,274,296,
Cherokee,Commissioner of Labor,Mike Workman,DEM,110009,5,4,162,171,
Cherokee,Commissioner of Labor,Mark Costello,REP,110009,9,13,303,325,
Cherokee,U.S. Senate,Matt Silverstein,DEM,110009,4,4,123,131,
Cherokee,U.S. Senate,Jim Inhofe,REP,110009,10,13,342,365,
Cherokee,U.S. Senate,Aaron Delozier,IND,110009,0,0,2,2,
Cherokee,U.S. Senate,Ray Woods,IND,110009,0,0,3,3,
Cherokee,U.S. Senate,Joan Farr,IND,110009,0,0,6,6,
Cherokee,U.S. Senate,Connie Johnson,DEM,110009,4,4,126,134,
Cherokee,U.S. Senate,James Lankford,REP,110009,10,13,329,352,
Cherokee,U.S. Senate,Mark Beard,IND,110009,0,0,18,18,
Cherokee,U.S. House,Earl Everett,DEM,110009,3,4,88,95,02
Cherokee,U.S. House,Markwayne Mullin,REP,110009,11,13,355,379,02
Cherokee,U.S. House,Jon Douthitt,IND,110009,0,0,30,30,02
Cherokee,Governor,Joe Dorman,DEM,110010,8,24,343,375,
Cherokee,Governor,Mary Fallin,REP,110010,7,25,318,350,
Cherokee,Governor,Kimberly Willis,IND,110010,0,1,14,15,
Cherokee,Governor,Richard Prawdzienski,IND,110010,0,1,6,7,
Cherokee,Lieutenant Governor,Cathy Cummings,DEM,110010,6,21,266,293,
Cherokee,Lieutenant Governor,Todd Lamb,REP,110010,9,30,410,449,
Cherokee,Superintendent of Public Instruction,John Cox,DEM,110010,7,27,417,451,
Cherokee,Superintendent of Public Instruction,Joy Hofmeister,REP,110010,8,24,258,290,
Cherokee,Commissioner of Labor,Mike Workman,DEM,110010,7,25,334,366,
Cherokee,Commissioner of Labor,Mark Costello,REP,110010,8,23,329,360,
Cherokee,U.S. Senate,Matt Silverstein,DEM,110010,8,19,244,271,
Cherokee,U.S. Senate,Jim Inhofe,REP,110010,8,32,409,449,
Cherokee,U.S. Senate,Aaron Delozier,IND,110010,0,1,5,6,
Cherokee,U.S. Senate,Ray Woods,IND,110010,0,0,9,9,
Cherokee,U.S. Senate,Joan Farr,IND,110010,0,0,10,10,
Cherokee,U.S. Senate,Connie Johnson,DEM,110010,7,16,245,268,
Cherokee,U.S. Senate,James Lankford,REP,110010,7,32,413,452,
Cherokee,U.S. Senate,Mark Beard,IND,110010,1,3,19,23,
Cherokee,U.S. House,Earl Everett,DEM,110010,5,15,189,209,02
Cherokee,U.S. House,Markwayne Mullin,REP,110010,7,35,456,498,02
Cherokee,U.S. House,Jon Douthitt,IND,110010,3,2,37,42,02
Cherokee,Governor,Joe Dorman,DEM,110011,5,10,86,101,
Cherokee,Governor,Mary Fallin,REP,110011,2,7,84,93,
Cherokee,Governor,Kimberly Willis,IND,110011,0,0,6,6,
Cherokee,Governor,Richard Prawdzienski,IND,110011,0,0,2,2,
Cherokee,Lieutenant Governor,Cathy Cummings,DEM,110011,4,6,68,78,
Cherokee,Lieutenant Governor,Todd Lamb,REP,110011,1,11,111,123,
Cherokee,Superintendent of Public Instruction,John Cox,DEM,110011,7,12,130,149,
Cherokee,Superintendent of Public Instruction,Joy Hofmeister,REP,110011,0,5,51,56,
Cherokee,Commissioner of Labor,Mike Workman,DEM,110011,5,8,98,111,
Cherokee,Commissioner of Labor,Mark Costello,REP,110011,0,9,79,88,
Cherokee,U.S. Senate,Matt Silverstein,DEM,110011,2,7,73,82,
Cherokee,U.S. Senate,Jim Inhofe,REP,110011,2,10,103,115,
Cherokee,U.S. Senate,Aaron Delozier,IND,110011,0,0,1,1,
Cherokee,U.S. Senate,Ray Woods,IND,110011,0,0,0,0,
Cherokee,U.S. Senate,Joan Farr,IND,110011,0,0,1,1,
Cherokee,U.S. Senate,Connie Johnson,DEM,110011,3,4,70,77,
Cherokee,U.S. Senate,James Lankford,REP,110011,2,11,103,116,
Cherokee,U.S. Senate,Mark Beard,IND,110011,0,1,5,6,
Cherokee,U.S. House,Earl Everett,DEM,110011,3,5,50,58,02
Cherokee,U.S. House,Markwayne Mullin,REP,110011,2,12,121,135,02
Cherokee,U.S. House,Jon Douthitt,IND,110011,0,0,10,10,02
Cherokee,State Senate,Charles Arnall,DEM,110011,3,7,100,110,18
Cherokee,State Senate,Kim David,REP,110011,2,9,80,91,18
Cherokee,Governor,Joe Dorman,DEM,110012,0,33,229,262,
Cherokee,Governor,Mary Fallin,REP,110012,1,28,176,205,
Cherokee,Governor,Kimberly Willis,IND,110012,0,1,8,9,
Cherokee,Governor,Richard Prawdzienski,IND,110012,0,6,10,16,
Cherokee,Lieutenant Governor,Cathy Cummings,DEM,110012,0,23,170,193,
Cherokee,Lieutenant Governor,Todd Lamb,REP,110012,1,40,246,287,
Cherokee,Superintendent of Public Instruction,John Cox,DEM,110012,1,50,305,356,
Cherokee,Superintendent of Public Instruction,Joy Hofmeister,REP,110012,0,15,114,129,
Cherokee,Commissioner of Labor,Mike Workman,DEM,110012,1,32,214,247,
Cherokee,Commissioner of Labor,Mark Costello,REP,110012,0,31,194,225,
Cherokee,U.S. Senate,Matt Silverstein,DEM,110012,0,23,163,186,
Cherokee,U.S. Senate,Jim Inhofe,REP,110012,1,36,239,276,
Cherokee,U.S. Senate,Aaron Delozier,IND,110012,0,1,2,3,
Cherokee,U.S. Senate,Ray Woods,IND,110012,0,8,7,15,
Cherokee,U.S. Senate,Joan Farr,IND,110012,0,2,8,10,
Cherokee,U.S. Senate,Connie Johnson,DEM,110012,0,17,164,181,
Cherokee,U.S. Senate,James Lankford,REP,110012,1,45,245,291,
Cherokee,U.S. Senate,Mark Beard,IND,110012,0,7,12,19,
Cherokee,U.S. House,Earl Everett,DEM,110012,0,24,123,147,02
Cherokee,U.S. House,Markwayne Mullin,REP,110012,1,43,277,321,02
Cherokee,U.S. House,Jon Douthitt,IND,110012,0,2,20,22,02
Cherokee,State House,Will Fourkiller,DEM,110012,1,46,272,319,86
Cherokee,State House,Tonya Teaney,REP,110012,0,23,149,172,86
Cherokee,Governor,Joe Dorman,DEM,110013,5,14,147,166,
Cherokee,Governor,Mary Fallin,REP,110013,6,8,107,121,
Cherokee,Governor,Kimberly Willis,IND,110013,1,3,8,12,
Cherokee,Governor,Richard Prawdzienski,IND,110013,0,0,3,3,
Cherokee,Lieutenant Governor,Cathy Cummings,DEM,110013,9,12,117,138,
Cherokee,Lieutenant Governor,Todd Lamb,REP,110013,3,13,146,162,
Cherokee,Superintendent of Public Instruction,John Cox,DEM,110013,10,18,183,211,
Cherokee,Superintendent of Public Instruction,Joy Hofmeister,REP,110013,2,8,82,92,
Cherokee,Commissioner of Labor,Mike Workman,DEM,110013,8,13,147,168,
Cherokee,Commissioner of Labor,Mark Costello,REP,110013,3,12,113,128,
Cherokee,U.S. Senate,Matt Silverstein,DEM,110013,7,11,110,128,
Cherokee,U.S. Senate,Jim Inhofe,REP,110013,5,15,145,165,
Cherokee,U.S. Senate,Aaron Delozier,IND,110013,0,0,3,3,
Cherokee,U.S. Senate,Ray Woods,IND,110013,0,0,3,3,
Cherokee,U.S. Senate,Joan Farr,IND,110013,0,0,2,2,
Cherokee,U.S. Senate,Connie Johnson,DEM,110013,9,12,112,133,
Cherokee,U.S. Senate,James Lankford,REP,110013,3,14,141,158,
Cherokee,U.S. Senate,Mark Beard,IND,110013,0,0,10,10,
Cherokee,U.S. House,Earl Everett,DEM,110013,7,12,84,103,02
Cherokee,U.S. House,Markwayne Mullin,REP,110013,5,13,163,181,02
Cherokee,U.S. House,Jon Douthitt,IND,110013,0,0,16,16,02
Cherokee,Governor,Joe Dorman,DEM,110014,3,8,202,213,
Cherokee,Governor,Mary Fallin,REP,110014,7,5,177,189,
Cherokee,Governor,Kimberly Willis,IND,110014,0,0,15,15,
Cherokee,Governor,Richard Prawdzienski,IND,110014,0,0,2,2,
Cherokee,Lieutenant Governor,Cathy Cummings,DEM,110014,2,8,167,177,
Cherokee,Lieutenant Governor,Todd Lamb,REP,110014,8,5,229,242,
Cherokee,Superintendent of Public Instruction,John Cox,DEM,110014,6,8,246,260,
Cherokee,Superintendent of Public Instruction,Joy Hofmeister,REP,110014,4,5,151,160,
Cherokee,Commissioner of Labor,Mike Workman,DEM,110014,2,8,208,218,
Cherokee,Commissioner of Labor,Mark Costello,REP,110014,8,5,184,197,
Cherokee,U.S. Senate,Matt Silverstein,DEM,110014,1,7,160,168,
Cherokee,U.S. Senate,Jim Inhofe,REP,110014,9,6,224,239,
Cherokee,U.S. Senate,Aaron Delozier,IND,110014,0,0,3,3,
Cherokee,U.S. Senate,Ray Woods,IND,110014,0,0,6,6,
Cherokee,U.S. Senate,Joan Farr,IND,110014,0,0,5,5,
Cherokee,U.S. Senate,Connie Johnson,DEM,110014,1,8,164,173,
Cherokee,U.S. Senate,James Lankford,REP,110014,9,5,218,232,
Cherokee,U.S. Senate,Mark Beard,IND,110014,0,0,14,14,
Cherokee,U.S. House,Earl Everett,DEM,110014,2,7,132,141,02
Cherokee,U.S. House,Markwayne Mullin,REP,110014,8,6,244,258,02
Cherokee,U.S. House,Jon Douthitt,IND,110014,0,0,22,22,02
Cherokee,State Senate,Charles Arnall,DEM,110014,4,8,196,208,18
Cherokee,State Senate,Kim David,REP,110014,6,5,198,209,18
Cherokee,State House,Jack Reavis,DEM,110014,1,8,193,202,14
Cherokee,State House,George Faught,REP,110014,9,5,200,214,14
Cherokee,Governor,Joe Dorman,DEM,110015,5,6,187,198,
Cherokee,Governor,Mary Fallin,REP,110015,8,12,276,296,
Cherokee,Governor,Kimberly Willis,IND,110015,0,0,14,14,
Cherokee,Governor,Richard Prawdzienski,IND,110015,0,0,2,2,
Cherokee,Lieutenant Governor,Cathy Cummings,DEM,110015,5,4,153,162,
Cherokee,Lieutenant Governor,Todd Lamb,REP,110015,8,14,324,346,
Cherokee,Superintendent of Public Instruction,John Cox,DEM,110015,5,7,255,267,
Cherokee,Superintendent of Public Instruction,Joy Hofmeister,REP,110015,8,11,226,245,
Cherokee,Commissioner of Labor,Mike Workman,DEM,110015,5,5,201,211,
Cherokee,Commissioner of Labor,Mark Costello,REP,110015,8,13,269,290,
Cherokee,U.S. Senate,Matt Silverstein,DEM,110015,5,4,135,144,
Cherokee,U.S. Senate,Jim Inhofe,REP,110015,8,14,330,352,
Cherokee,U.S. Senate,Aaron Delozier,IND,110015,0,0,3,3,
Cherokee,U.S. Senate,Ray Woods,IND,110015,0,0,3,3,
Cherokee,U.S. Senate,Joan Farr,IND,110015,0,0,7,7,
Cherokee,U.S. Senate,Connie Johnson,DEM,110015,5,4,135,144,
Cherokee,U.S. Senate,James Lankford,REP,110015,8,14,328,350,
Cherokee,U.S. Senate,Mark Beard,IND,110015,0,0,17,17,
Cherokee,U.S. House,Earl Everett,DEM,110015,3,2,94,99,02
Cherokee,U.S. House,Markwayne Mullin,REP,110015,7,14,348,369,02
Cherokee,U.S. House,Jon Douthitt,IND,110015,2,2,38,42,02
Cherokee,State Senate,Charles Arnall,DEM,110015,4,4,162,170,18
Cherokee,State Senate,Kim David,REP,110015,8,14,314,336,18
Cherokee,State House,Jack Reavis,DEM,110015,5,5,182,192,14
Cherokee,State House,George Faught,REP,110015,8,13,295,316,14
Cherokee,Governor,Joe Dorman,DEM,110016,0,2,119,121,
Cherokee,Governor,Mary Fallin,REP,110016,3,2,93,98,
Cherokee,Governor,Kimberly Willis,IND,110016,0,0,5,5,
Cherokee,Governor,Richard Prawdzienski,IND,110016,0,0,5,5,
Cherokee,Lieutenant Governor,Cathy Cummings,DEM,110016,0,2,107,109,
Cherokee,Lieutenant Governor,Todd Lamb,REP,110016,3,2,113,118,
Cherokee,Superintendent of Public Instruction,John Cox,DEM,110016,1,2,178,181,
Cherokee,Superintendent of Public Instruction,Joy Hofmeister,REP,110016,2,2,42,46,
Cherokee,Commissioner of Labor,Mike Workman,DEM,110016,0,1,137,138,
Cherokee,Commissioner of Labor,Mark Costello,REP,110016,3,3,79,85,
Cherokee,U.S. Senate,Matt Silverstein,DEM,110016,1,1,86,88,
Cherokee,U.S. Senate,Jim Inhofe,REP,110016,2,3,121,126,
Cherokee,U.S. Senate,Aaron Delozier,IND,110016,0,0,3,3,
Cherokee,U.S. Senate,Ray Woods,IND,110016,0,0,7,7,
Cherokee,U.S. Senate,Joan Farr,IND,110016,0,0,1,1,
Cherokee,U.S. Senate,Connie Johnson,DEM,110016,0,1,99,100,
Cherokee,U.S. Senate,James Lankford,REP,110016,3,3,107,113,
Cherokee,U.S. Senate,Mark Beard,IND,110016,0,0,12,12,
Cherokee,U.S. House,Earl Everett,DEM,110016,0,1,73,74,02
Cherokee,U.S. House,Markwayne Mullin,REP,110016,3,3,128,134,02
Cherokee,U.S. House,Jon Douthitt,IND,110016,0,0,16,16,02
Cherokee,State House,Will Fourkiller,DEM,110016,0,2,153,155,86
Cherokee,State House,Tonya Teaney,REP,110016,3,2,65,70,86
Cherokee,Governor,Joe Dorman,DEM,110017,0,7,73,80,
Cherokee,Governor,Mary Fallin,REP,110017,2,4,65,71,
Cherokee,Governor,Kimberly Willis,IND,110017,0,0,6,6,
Cherokee,Governor,Richard Prawdzienski,IND,110017,0,0,0,0,
Cherokee,Lieutenant Governor,Cathy Cummings,DEM,110017,0,4,67,71,
Cherokee,Lieutenant Governor,Todd Lamb,REP,110017,2,7,75,84,
Cherokee,Superintendent of Public Instruction,John Cox,DEM,110017,0,10,84,94,
Cherokee,Superintendent of Public Instruction,Joy Hofmeister,REP,110017,2,2,59,63,
Cherokee,Commissioner of Labor,Mike Workman,DEM,110017,0,6,75,81,
Cherokee,Commissioner of Labor,Mark Costello,REP,110017,2,5,66,73,
Cherokee,U.S. Senate,Matt Silverstein,DEM,110017,0,4,60,64,
Cherokee,U.S. Senate,Jim Inhofe,REP,110017,2,6,83,91,
Cherokee,U.S. Senate,Aaron Delozier,IND,110017,0,0,0,0,
Cherokee,U.S. Senate,Ray Woods,IND,110017,0,0,1,1,
Cherokee,U.S. Senate,Joan Farr,IND,110017,0,0,1,1,
Cherokee,U.S. Senate,Connie Johnson,DEM,110017,0,5,62,67,
Cherokee,U.S. Senate,James Lankford,REP,110017,2,7,75,84,
Cherokee,U.S. Senate,Mark Beard,IND,110017,0,0,7,7,
Cherokee,U.S. House,Earl Everett,DEM,110017,0,2,40,42,02
Cherokee,U.S. House,Markwayne Mullin,REP,110017,2,9,93,104,02
Cherokee,U.S. House,Jon Douthitt,IND,110017,0,0,9,9,02
Cherokee,Governor,Joe Dorman,DEM,110018,0,0,53,53,
Cherokee,Governor,Mary Fallin,REP,110018,4,8,54,66,
Cherokee,Governor,Kimberly Willis,IND,110018,0,0,3,3,
Cherokee,Governor,Richard Prawdzienski,IND,110018,0,0,1,1,
Cherokee,Lieutenant Governor,Cathy Cummings,DEM,110018,0,0,39,39,
Cherokee,Lieutenant Governor,Todd Lamb,REP,110018,4,8,72,84,
Cherokee,Superintendent of Public Instruction,John Cox,DEM,110018,2,0,64,66,
Cherokee,Superintendent of Public Instruction,Joy Hofmeister,REP,110018,1,8,45,54,
Cherokee,Commissioner of Labor,Mike Workman,DEM,110018,0,0,50,50,
Cherokee,Commissioner of Labor,Mark Costello,REP,110018,4,8,58,70,
Cherokee,U.S. Senate,Matt Silverstein,DEM,110018,0,0,35,35,
Cherokee,U.S. Senate,Jim Inhofe,REP,110018,4,8,70,82,
Cherokee,U.S. Senate,Aaron Delozier,IND,110018,0,0,0,0,
Cherokee,U.S. Senate,Ray Woods,IND,110018,0,0,3,3,
Cherokee,U.S. Senate,Joan Farr,IND,110018,0,0,3,3,
Cherokee,U.S. Senate,Connie Johnson,DEM,110018,0,0,31,31,
Cherokee,U.S. Senate,James Lankford,REP,110018,4,8,68,80,
Cherokee,U.S. Senate,Mark Beard,IND,110018,0,0,11,11,
Cherokee,U.S. House,Earl Everett,DEM,110018,0,0,22,22,02
Cherokee,U.S. House,Markwayne Mullin,REP,110018,4,8,77,89,02
Cherokee,U.S. House,Jon Douthitt,IND,110018,0,0,12,12,02
Cherokee,State House,Will Fourkiller,DEM,110018,4,0,65,69,86
Cherokee,State House,Tonya Teaney,REP,110018,0,8,45,53,86
Cherokee,Governor,Joe Dorman,DEM,110019,3,24,151,178,
Cherokee,Governor,Mary Fallin,REP,110019,5,14,122,141,
Cherokee,Governor,Kimberly Willis,IND,110019,0,1,10,11,
Cherokee,Governor,Richard Prawdzienski,IND,110019,0,0,3,3,
Cherokee,Lieutenant Governor,Cathy Cummings,DEM,110019,2,18,129,149,
Cherokee,Lieutenant Governor,Todd Lamb,REP,110019,6,21,153,180,
Cherokee,Superintendent of Public Instruction,John Cox,DEM,110019,3,26,193,222,
Cherokee,Superintendent of Public Instruction,Joy Hofmeister,REP,110019,5,13,92,110,
Cherokee,Commissioner of Labor,Mike Workman,DEM,110019,2,20,153,175,
Cherokee,Commissioner of Labor,Mark Costello,REP,110019,6,18,128,152,
Cherokee,U.S. Senate,Matt Silverstein,DEM,110019,2,19,117,138,
Cherokee,U.S. Senate,Jim Inhofe,REP,110019,6,19,160,185,
Cherokee,U.S. Senate,Aaron Delozier,IND,110019,0,0,3,3,
Cherokee,U.S. Senate,Ray Woods,IND,110019,0,0,4,4,
Cherokee,U.S. Senate,Joan Farr,IND,110019,0,1,1,2,
Cherokee,U.S. Senate,Connie Johnson,DEM,110019,2,18,103,123,
Cherokee,U.S. Senate,James Lankford,REP,110019,6,20,164,190,
Cherokee,U.S. Senate,Mark Beard,IND,110019,0,1,16,17,
Cherokee,U.S. House,Earl Everett,DEM,110019,2,17,78,97,02
Cherokee,U.S. House,Markwayne Mullin,REP,110019,6,22,176,204,02
Cherokee,U.S. House,Jon Douthitt,IND,110019,0,0,27,27,02
Cherokee,State Senate,Charles Arnall,DEM,110019,3,21,145,169,18
Cherokee,State Senate,Kim David,REP,110019,4,18,139,161,18
Cherokee,Governor,Joe Dorman,DEM,110020,3,43,194,240,
Cherokee,Governor,Mary Fallin,REP,110020,6,21,134,161,
Cherokee,Governor,Kimberly Willis,IND,110020,0,0,10,10,
Cherokee,Governor,Richard Prawdzienski,IND,110020,0,0,5,5,
Cherokee,Lieutenant Governor,Cathy Cummings,DEM,110020,2,39,144,185,
Cherokee,Lieutenant Governor,Todd Lamb,REP,110020,7,25,198,230,
Cherokee,Superintendent of Public Instruction,John Cox,DEM,110020,5,47,217,269,
Cherokee,Superintendent of Public Instruction,Joy Hofmeister,REP,110020,4,17,125,146,
Cherokee,Commissioner of Labor,Mike Workman,DEM,110020,2,40,171,213,
Cherokee,Commissioner of Labor,Mark Costello,REP,110020,7,23,162,192,
Cherokee,U.S. Senate,Matt Silverstein,DEM,110020,2,33,149,184,
Cherokee,U.S. Senate,Jim Inhofe,REP,110020,7,28,186,221,
Cherokee,U.S. Senate,Aaron Delozier,IND,110020,0,1,2,3,
Cherokee,U.S. Senate,Ray Woods,IND,110020,0,1,1,2,
Cherokee,U.S. Senate,Joan Farr,IND,110020,0,0,4,4,
Cherokee,U.S. Senate,Connie Johnson,DEM,110020,2,33,137,172,
Cherokee,U.S. Senate,James Lankford,REP,110020,7,29,192,228,
Cherokee,U.S. Senate,Mark Beard,IND,110020,0,2,12,14,
Cherokee,U.S. House,Earl Everett,DEM,110020,2,31,96,129,02
Cherokee,U.S. House,Markwayne Mullin,REP,110020,7,31,208,246,02
Cherokee,U.S. House,Jon Douthitt,IND,110020,0,2,38,40,02
Cherokee,Governor,Joe Dorman,DEM,110021,0,3,90,93,
Cherokee,Governor,Mary Fallin,REP,110021,2,3,82,87,
Cherokee,Governor,Kimberly Willis,IND,110021,0,0,5,5,
Cherokee,Governor,Richard Prawdzienski,IND,110021,0,0,2,2,
Cherokee,Lieutenant Governor,Cathy Cummings,DEM,110021,1,2,69,72,
Cherokee,Lieutenant Governor,Todd Lamb,REP,110021,2,4,109,115,
Cherokee,Superintendent of Public Instruction,John Cox,DEM,110021,1,4,111,116,
Cherokee,Superintendent of Public Instruction,Joy Hofmeister,REP,110021,2,2,67,71,
Cherokee,Commissioner of Labor,Mike Workman,DEM,110021,1,3,92,96,
Cherokee,Commissioner of Labor,Mark Costello,REP,110021,2,3,83,88,
Cherokee,U.S. Senate,Matt Silverstein,DEM,110021,0,3,55,58,
Cherokee,U.S. Senate,Jim Inhofe,REP,110021,3,3,109,115,
Cherokee,U.S. Senate,Aaron Delozier,IND,110021,0,0,1,1,
Cherokee,U.S. Senate,Ray Woods,IND,110021,0,0,10,10,
Cherokee,U.S. Senate,Joan Farr,IND,110021,0,0,3,3,
Cherokee,U.S. Senate,Connie Johnson,DEM,110021,1,2,63,66,
Cherokee,U.S. Senate,James Lankford,REP,110021,2,4,102,108,
Cherokee,U.S. Senate,Mark Beard,IND,110021,0,0,11,11,
Cherokee,U.S. House,Earl Everett,DEM,110021,1,2,42,45,02
Cherokee,U.S. House,Markwayne Mullin,REP,110021,2,4,124,130,02
Cherokee,U.S. House,Jon Douthitt,IND,110021,0,0,15,15,02
Cherokee,Governor,Joe Dorman,DEM,110022,0,5,54,59,
Cherokee,Governor,Mary Fallin,REP,110022,1,1,66,68,
Cherokee,Governor,Kimberly Willis,IND,110022,0,0,2,2,
Cherokee,Governor,Richard Prawdzienski,IND,110022,0,0,3,3,
Cherokee,Lieutenant Governor,Cathy Cummings,DEM,110022,0,1,40,41,
Cherokee,Lieutenant Governor,Todd Lamb,REP,110022,1,5,86,92,
Cherokee,Superintendent of Public Instruction,John Cox,DEM,110022,1,5,83,89,
Cherokee,Superintendent of Public Instruction,Joy Hofmeister,REP,110022,0,1,41,42,
Cherokee,Commissioner of Labor,Mike Workman,DEM,110022,0,2,61,63,
Cherokee,Commissioner of Labor,Mark Costello,REP,110022,1,4,64,69,
Cherokee,U.S. Senate,Matt Silverstein,DEM,110022,0,3,41,44,
Cherokee,U.S. Senate,Jim Inhofe,REP,110022,1,3,79,83,
Cherokee,U.S. Senate,Aaron Delozier,IND,110022,0,0,2,2,
Cherokee,U.S. Senate,Ray Woods,IND,110022,0,0,2,2,
Cherokee,U.S. Senate,Joan Farr,IND,110022,0,0,1,1,
Cherokee,U.S. Senate,Connie Johnson,DEM,110022,0,2,43,45,
Cherokee,U.S. Senate,James Lankford,REP,110022,1,3,77,81,
Cherokee,U.S. Senate,Mark Beard,IND,110022,0,1,3,4,
Cherokee,U.S. House,Earl Everett,DEM,110022,0,2,35,37,02
Cherokee,U.S. House,Markwayne Mullin,REP,110022,1,4,86,91,02
Cherokee,U.S. House,Jon Douthitt,IND,110022,0,0,6,6,02
Cherokee,Governor,Joe Dorman,DEM,110023,2,23,56,81,
Cherokee,Governor,Mary Fallin,REP,110023,4,9,61,74,
Cherokee,Governor,Kimberly Willis,IND,110023,0,0,4,4,
Cherokee,Governor,Richard Prawdzienski,IND,110023,0,0,0,0,
Cherokee,Lieutenant Governor,Cathy Cummings,DEM,110023,2,15,42,59,
Cherokee,Lieutenant Governor,Todd Lamb,REP,110023,4,15,79,98,
Cherokee,Superintendent of Public Instruction,John Cox,DEM,110023,2,29,87,118,
Cherokee,Superintendent of Public Instruction,Joy Hofmeister,REP,110023,4,3,34,41,
Cherokee,Commissioner of Labor,Mike Workman,DEM,110023,2,23,62,87,
Cherokee,Commissioner of Labor,Mark Costello,REP,110023,4,8,59,71,
Cherokee,U.S. Senate,Matt Silverstein,DEM,110023,1,20,42,63,
Cherokee,U.S. Senate,Jim Inhofe,REP,110023,5,12,76,93,
Cherokee,U.S. Senate,Aaron Delozier,IND,110023,0,0,1,1,
Cherokee,U.S. Senate,Ray Woods,IND,110023,0,0,1,1,
Cherokee,U.S. Senate,Joan Farr,IND,110023,0,0,1,1,
Cherokee,U.S. Senate,Connie Johnson,DEM,110023,2,17,39,58,
Cherokee,U.S. Senate,James Lankford,REP,110023,4,14,74,92,
Cherokee,U.S. Senate,Mark Beard,IND,110023,0,1,7,8,
Cherokee,U.S. House,Earl Everett,DEM,110023,0,16,37,53,02
Cherokee,U.S. House,Markwayne Mullin,REP,110023,6,15,74,95,02
Cherokee,U.S. House,Jon Douthitt,IND,110023,0,0,9,9,02
Cherokee,Governor,Joe Dorman,DEM,110025,2,49,137,188,
Cherokee,Governor,Mary Fallin,REP,110025,4,21,118,143,
Cherokee,Governor,Kimberly Willis,IND,110025,0,0,9,9,
Cherokee,Governor,Richard Prawdzienski,IND,110025,0,0,5,5,
Cherokee,Lieutenant Governor,Cathy Cummings,DEM,110025,0,41,114,155,
Cherokee,Lieutenant Governor,Todd Lamb,REP,110025,6,28,149,183,
Cherokee,Superintendent of Public Instruction,John Cox,DEM,110025,4,53,193,250,
Cherokee,Superintendent of Public Instruction,Joy Hofmeister,REP,110025,2,16,75,93,
Cherokee,Commissioner of Labor,Mike Workman,DEM,110025,2,47,161,210,
Cherokee,Commissioner of Labor,Mark Costello,REP,110025,3,21,100,124,
Cherokee,U.S. Senate,Matt Silverstein,DEM,110025,2,38,93,133,
Cherokee,U.S. Senate,Jim Inhofe,REP,110025,4,30,167,201,
Cherokee,U.S. Senate,Aaron Delozier,IND,110025,0,0,3,3,
Cherokee,U.S. Senate,Ray Woods,IND,110025,0,0,5,5,
Cherokee,U.S. Senate,Joan Farr,IND,110025,0,0,1,1,
Cherokee,U.S. Senate,Connie Johnson,DEM,110025,2,31,105,138,
Cherokee,U.S. Senate,James Lankford,REP,110025,4,35,142,181,
Cherokee,U.S. Senate,Mark Beard,IND,110025,0,2,16,18,
Cherokee,U.S. House,Earl Everett,DEM,110025,0,29,78,107,02
Cherokee,U.S. House,Markwayne Mullin,REP,110025,6,38,173,217,02
Cherokee,U.S. House,Jon Douthitt,IND,110025,0,2,15,17,02
Cherokee,State Senate,Charles Arnall,DEM,110025,1,49,168,218,18
Cherokee,State Senate,Kim David,REP,110025,5,21,99,125,18
Choctaw,Governor,Joe Dorman,DEM,120101,2,6,119,127,
Choctaw,Governor,Mary Fallin,REP,120101,2,10,231,243,
Choctaw,Governor,Kimberly Willis,IND,120101,0,0,3,3,
Choctaw,Governor,Richard Prawdzienski,IND,120101,0,1,4,5,
Choctaw,Lieutenant Governor,Cathy Cummings,DEM,120101,2,5,100,107,
Choctaw,Lieutenant Governor,Todd Lamb,REP,120101,2,12,251,265,
Choctaw,Superintendent of Public Instruction,John Cox,DEM,120101,2,10,154,166,
Choctaw,Superintendent of Public Instruction,Joy Hofmeister,REP,120101,2,7,200,209,
Choctaw,Commissioner of Labor,Mike Workman,DEM,120101,2,5,127,134,
Choctaw,Commissioner of Labor,Mark Costello,REP,120101,2,12,218,232,
Choctaw,U.S. Senate,Matt Silverstein,DEM,120101,2,5,78,85,
Choctaw,U.S. Senate,Jim Inhofe,REP,120101,4,12,271,287,
Choctaw,U.S. Senate,Aaron Delozier,IND,120101,0,0,1,1,
Choctaw,U.S. Senate,Ray Woods,IND,120101,0,0,3,3,
Choctaw,U.S. Senate,Joan Farr,IND,120101,0,0,2,2,
Choctaw,U.S. Senate,Connie Johnson,DEM,120101,2,4,76,82,
Choctaw,U.S. Senate,James Lankford,REP,120101,4,12,260,276,
Choctaw,U.S. Senate,Mark Beard,IND,120101,0,1,14,15,
Choctaw,U.S. House,Earl Everett,DEM,120101,2,2,80,84,02
Choctaw,U.S. House,Markwayne Mullin,REP,120101,4,14,265,283,02
Choctaw,U.S. House,Jon Douthitt,IND,120101,0,1,8,9,02
Choctaw,State Senate,Curtis Mcdaniel,DEM,120101,2,9,124,135,5
Choctaw,State Senate,Joseph Silk,REP,120101,2,8,228,238,5
Choctaw,Governor,Joe Dorman,DEM,120104,1,9,121,131,
Choctaw,Governor,Mary Fallin,REP,120104,2,9,171,182,
Choctaw,Governor,Kimberly Willis,IND,120104,0,1,6,7,
Choctaw,Governor,Richard Prawdzienski,IND,120104,0,2,5,7,
Choctaw,Lieutenant Governor,Cathy Cummings,DEM,120104,0,7,87,94,
Choctaw,Lieutenant Governor,Todd Lamb,REP,120104,3,14,211,228,
Choctaw,Superintendent of Public Instruction,John Cox,DEM,120104,1,13,153,167,
Choctaw,Superintendent of Public Instruction,Joy Hofmeister,REP,120104,2,9,142,153,
Choctaw,Commissioner of Labor,Mike Workman,DEM,120104,0,9,119,128,
Choctaw,Commissioner of Labor,Mark Costello,REP,120104,3,11,174,188,
Choctaw,U.S. Senate,Matt Silverstein,DEM,120104,1,7,76,84,
Choctaw,U.S. Senate,Jim Inhofe,REP,120104,2,12,217,231,
Choctaw,U.S. Senate,Aaron Delozier,IND,120104,0,0,2,2,
Choctaw,U.S. Senate,Ray Woods,IND,120104,0,1,4,5,
Choctaw,U.S. Senate,Joan Farr,IND,120104,0,1,3,4,
Choctaw,U.S. Senate,Connie Johnson,DEM,120104,1,5,76,82,
Choctaw,U.S. Senate,James Lankford,REP,120104,2,16,208,226,
Choctaw,U.S. Senate,Mark Beard,IND,120104,0,1,13,14,
Choctaw,U.S. House,Earl Everett,DEM,120104,1,5,65,71,02
Choctaw,U.S. House,Markwayne Mullin,REP,120104,1,13,222,236,02
Choctaw,U.S. House,Jon Douthitt,IND,120104,1,2,11,14,02
Choctaw,State Senate,Curtis Mcdaniel,DEM,120104,1,10,121,132,5
Choctaw,State Senate,Joseph Silk,REP,120104,2,12,180,194,5
Choctaw,Governor,Joe Dorman,DEM,120105,0,6,52,58,
Choctaw,Governor,Mary Fallin,REP,120105,0,2,17,19,
Choctaw,Governor,Kimberly Willis,IND,120105,0,0,0,0,
Choctaw,Governor,Richard Prawdzienski,IND,120105,0,0,3,3,
Choctaw,Lieutenant Governor,Cathy Cummings,DEM,120105,0,8,50,58,
Choctaw,Lieutenant Governor,Todd Lamb,REP,120105,0,0,20,20,
Choctaw,Superintendent of Public Instruction,John Cox,DEM,120105,0,8,52,60,
Choctaw,Superintendent of Public Instruction,Joy Hofmeister,REP,120105,0,0,18,18,
Choctaw,Commissioner of Labor,Mike Workman,DEM,120105,0,6,51,57,
Choctaw,Commissioner of Labor,Mark Costello,REP,120105,0,2,20,22,
Choctaw,U.S. Senate,Matt Silverstein,DEM,120105,0,6,44,50,
Choctaw,U.S. Senate,Jim Inhofe,REP,120105,0,1,24,25,
Choctaw,U.S. Senate,Aaron Delozier,IND,120105,0,0,1,1,
Choctaw,U.S. Senate,Ray Woods,IND,120105,0,0,1,1,
Choctaw,U.S. Senate,Joan Farr,IND,120105,0,1,2,3,
Choctaw,U.S. Senate,Connie Johnson,DEM,120105,0,7,46,53,
Choctaw,U.S. Senate,James Lankford,REP,120105,0,0,22,22,
Choctaw,U.S. Senate,Mark Beard,IND,120105,0,1,3,4,
Choctaw,U.S. House,Earl Everett,DEM,120105,0,7,44,51,02
Choctaw,U.S. House,Markwayne Mullin,REP,120105,0,1,24,25,02
Choctaw,U.S. House,Jon Douthitt,IND,120105,0,0,3,3,02
Choctaw,State Senate,Curtis Mcdaniel,DEM,120105,0,5,51,56,5
Choctaw,State Senate,Joseph Silk,REP,120105,0,3,21,24,5
Choctaw,Governor,Joe Dorman,DEM,120106,1,5,59,65,
Choctaw,Governor,Mary Fallin,REP,120106,0,11,72,83,
Choctaw,Governor,Kimberly Willis,IND,120106,0,0,6,6,
Choctaw,Governor,Richard Prawdzienski,IND,120106,0,0,0,0,
Choctaw,Lieutenant Governor,Cathy Cummings,DEM,120106,1,7,50,58,
Choctaw,Lieutenant Governor,Todd Lamb,REP,120106,0,9,85,94,
Choctaw,Superintendent of Public Instruction,John Cox,DEM,120106,1,7,67,75,
Choctaw,Superintendent of Public Instruction,Joy Hofmeister,REP,120106,0,8,68,76,
Choctaw,Commissioner of Labor,Mike Workman,DEM,120106,1,7,43,51,
Choctaw,Commissioner of Labor,Mark Costello,REP,120106,0,8,92,100,
Choctaw,U.S. Senate,Matt Silverstein,DEM,120106,1,4,28,33,
Choctaw,U.S. Senate,Jim Inhofe,REP,120106,0,12,99,111,
Choctaw,U.S. Senate,Aaron Delozier,IND,120106,0,0,2,2,
Choctaw,U.S. Senate,Ray Woods,IND,120106,0,0,1,1,
Choctaw,U.S. Senate,Joan Farr,IND,120106,0,0,5,5,
Choctaw,U.S. Senate,Connie Johnson,DEM,120106,1,6,33,40,
Choctaw,U.S. Senate,James Lankford,REP,120106,0,9,96,105,
Choctaw,U.S. Senate,Mark Beard,IND,120106,0,0,8,8,
Choctaw,U.S. House,Earl Everett,DEM,120106,1,5,28,34,02
Choctaw,U.S. House,Markwayne Mullin,REP,120106,0,11,103,114,02
Choctaw,U.S. House,Jon Douthitt,IND,120106,0,0,6,6,02
Choctaw,State Senate,Curtis Mcdaniel,DEM,120106,1,8,48,57,5
Choctaw,State Senate,Joseph Silk,REP,120106,0,8,90,98,5
Choctaw,Governor,Joe Dorman,DEM,120207,3,0,23,26,
Choctaw,Governor,Mary Fallin,REP,120207,0,2,34,36,
Choctaw,Governor,Kimberly Willis,IND,120207,0,0,2,2,
Choctaw,Governor,Richard Prawdzienski,IND,120207,0,0,1,1,
Choctaw,Lieutenant Governor,Cathy Cummings,DEM,120207,3,0,24,27,
Choctaw,Lieutenant Governor,Todd Lamb,REP,120207,0,2,36,38,
Choctaw,Superintendent of Public Instruction,John Cox,DEM,120207,3,2,28,33,
Choctaw,Superintendent of Public Instruction,Joy Hofmeister,REP,120207,0,0,31,31,
Choctaw,Commissioner of Labor,Mike Workman,DEM,120207,3,2,26,31,
Choctaw,Commissioner of Labor,Mark Costello,REP,120207,0,0,33,33,
Choctaw,U.S. Senate,Matt Silverstein,DEM,120207,3,0,22,25,
Choctaw,U.S. Senate,Jim Inhofe,REP,120207,0,2,34,36,
Choctaw,U.S. Senate,Aaron Delozier,IND,120207,0,0,1,1,
Choctaw,U.S. Senate,Ray Woods,IND,120207,0,0,2,2,
Choctaw,U.S. Senate,Joan Farr,IND,120207,0,0,1,1,
Choctaw,U.S. Senate,Connie Johnson,DEM,120207,3,0,23,26,
Choctaw,U.S. Senate,James Lankford,REP,120207,0,2,35,37,
Choctaw,U.S. Senate,Mark Beard,IND,120207,0,0,2,2,
Choctaw,U.S. House,Earl Everett,DEM,120207,3,0,22,25,02
Choctaw,U.S. House,Markwayne Mullin,REP,120207,0,2,35,37,02
Choctaw,U.S. House,Jon Douthitt,IND,120207,0,0,3,3,02
Choctaw,State Senate,Curtis Mcdaniel,DEM,120207,3,2,28,33,5
Choctaw,State Senate,Joseph Silk,REP,120207,0,0,31,31,5
Choctaw,Governor,Joe Dorman,DEM,120208,0,21,90,111,
Choctaw,Governor,Mary Fallin,REP,120208,4,32,101,137,
Choctaw,Governor,Kimberly Willis,IND,120208,0,1,1,2,
Choctaw,Governor,Richard Prawdzienski,IND,120208,0,0,4,4,
Choctaw,Lieutenant Governor,Cathy Cummings,DEM,120208,0,14,68,82,
Choctaw,Lieutenant Governor,Todd Lamb,REP,120208,4,39,128,171,
Choctaw,Superintendent of Public Instruction,John Cox,DEM,120208,2,23,103,128,
Choctaw,Superintendent of Public Instruction,Joy Hofmeister,REP,120208,2,31,90,123,
Choctaw,Commissioner of Labor,Mike Workman,DEM,120208,0,19,77,96,
Choctaw,Commissioner of Labor,Mark Costello,REP,120208,4,35,117,156,
Choctaw,U.S. Senate,Matt Silverstein,DEM,120208,0,13,52,65,
Choctaw,U.S. Senate,Jim Inhofe,REP,120208,4,40,137,181,
Choctaw,U.S. Senate,Aaron Delozier,IND,120208,0,1,0,1,
Choctaw,U.S. Senate,Ray Woods,IND,120208,0,0,3,3,
Choctaw,U.S. Senate,Joan Farr,IND,120208,0,0,3,3,
Choctaw,U.S. Senate,Connie Johnson,DEM,120208,0,11,57,68,
Choctaw,U.S. Senate,James Lankford,REP,120208,4,41,131,176,
Choctaw,U.S. Senate,Mark Beard,IND,120208,0,2,5,7,
Choctaw,U.S. House,Earl Everett,DEM,120208,0,10,49,59,02
Choctaw,U.S. House,Markwayne Mullin,REP,120208,4,42,140,186,02
Choctaw,U.S. House,Jon Douthitt,IND,120208,0,2,5,7,02
Choctaw,State Senate,Curtis Mcdaniel,DEM,120208,0,24,85,109,5
Choctaw,State Senate,Joseph Silk,REP,120208,4,30,109,143,5
Choctaw,Governor,Joe Dorman,DEM,120209,0,0,38,38,
Choctaw,Governor,Mary Fallin,REP,120209,0,2,27,29,
Choctaw,Governor,Kimberly Willis,IND,120209,0,0,0,0,
Choctaw,Governor,Richard Prawdzienski,IND,120209,0,0,0,0,
Choctaw,Lieutenant Governor,Cathy Cummings,DEM,120209,0,0,34,34,
Choctaw,Lieutenant Governor,Todd Lamb,REP,120209,0,2,32,34,
Choctaw,Superintendent of Public Instruction,John Cox,DEM,120209,0,0,43,43,
Choctaw,Superintendent of Public Instruction,Joy Hofmeister,REP,120209,0,2,24,26,
Choctaw,Commissioner of Labor,Mike Workman,DEM,120209,0,0,39,39,
Choctaw,Commissioner of Labor,Mark Costello,REP,120209,0,2,28,30,
Choctaw,U.S. Senate,Matt Silverstein,DEM,120209,0,0,27,27,
Choctaw,U.S. Senate,Jim Inhofe,REP,120209,0,2,38,40,
Choctaw,U.S. Senate,Aaron Delozier,IND,120209,0,0,0,0,
Choctaw,U.S. Senate,Ray Woods,IND,120209,0,0,1,1,
Choctaw,U.S. Senate,Joan Farr,IND,120209,0,0,1,1,
Choctaw,U.S. Senate,Connie Johnson,DEM,120209,0,0,31,31,
Choctaw,U.S. Senate,James Lankford,REP,120209,0,2,35,37,
Choctaw,U.S. Senate,Mark Beard,IND,120209,0,0,0,0,
Choctaw,U.S. House,Earl Everett,DEM,120209,0,0,29,29,02
Choctaw,U.S. House,Markwayne Mullin,REP,120209,0,2,37,39,02
Choctaw,U.S. House,Jon Douthitt,IND,120209,0,0,1,1,02
Choctaw,State Senate,Curtis Mcdaniel,DEM,120209,0,0,38,38,5
Choctaw,State Senate,Joseph Silk,REP,120209,0,2,28,30,5
Choctaw,Governor,Joe Dorman,DEM,120210,0,14,75,89,
Choctaw,Governor,Mary Fallin,REP,120210,2,28,141,171,
Choctaw,Governor,Kimberly Willis,IND,120210,0,0,3,3,
Choctaw,Governor,Richard Prawdzienski,IND,120210,0,0,2,2,
Choctaw,Lieutenant Governor,Cathy Cummings,DEM,120210,1,4,55,60,
Choctaw,Lieutenant Governor,Todd Lamb,REP,120210,1,38,168,207,
Choctaw,Superintendent of Public Instruction,John Cox,DEM,120210,1,14,106,121,
Choctaw,Superintendent of Public Instruction,Joy Hofmeister,REP,120210,1,28,112,141,
Choctaw,Commissioner of Labor,Mike Workman,DEM,120210,1,6,79,86,
Choctaw,Commissioner of Labor,Mark Costello,REP,120210,1,36,138,175,
Choctaw,U.S. Senate,Matt Silverstein,DEM,120210,0,3,38,41,
Choctaw,U.S. Senate,Jim Inhofe,REP,120210,2,40,181,223,
Choctaw,U.S. Senate,Aaron Delozier,IND,120210,0,0,0,0,
Choctaw,U.S. Senate,Ray Woods,IND,120210,0,0,2,2,
Choctaw,U.S. Senate,Joan Farr,IND,120210,0,0,0,0,
Choctaw,U.S. Senate,Connie Johnson,DEM,120210,0,4,49,53,
Choctaw,U.S. Senate,James Lankford,REP,120210,2,38,166,206,
Choctaw,U.S. Senate,Mark Beard,IND,120210,0,0,7,7,
Choctaw,U.S. House,Earl Everett,DEM,120210,0,4,39,43,02
Choctaw,U.S. House,Markwayne Mullin,REP,120210,2,38,178,218,02
Choctaw,U.S. House,Jon Douthitt,IND,120210,0,0,4,4,02
Choctaw,State Senate,Curtis Mcdaniel,DEM,120210,1,12,79,92,5
Choctaw,State Senate,Joseph Silk,REP,120210,1,30,143,174,5
Choctaw,Governor,Joe Dorman,DEM,120211,0,2,36,38,
Choctaw,Governor,Mary Fallin,REP,120211,0,3,17,20,
Choctaw,Governor,Kimberly Willis,IND,120211,0,0,0,0,
Choctaw,Governor,Richard Prawdzienski,IND,120211,0,0,1,1,
Choctaw,Lieutenant Governor,Cathy Cummings,DEM,120211,0,2,33,35,
Choctaw,Lieutenant Governor,Todd Lamb,REP,120211,0,3,21,24,
Choctaw,Superintendent of Public Instruction,John Cox,DEM,120211,0,4,36,40,
Choctaw,Superintendent of Public Instruction,Joy Hofmeister,REP,120211,0,1,18,19,
Choctaw,Commissioner of Labor,Mike Workman,DEM,120211,0,2,33,35,
Choctaw,Commissioner of Labor,Mark Costello,REP,120211,0,3,21,24,
Choctaw,U.S. Senate,Matt Silverstein,DEM,120211,0,2,28,30,
Choctaw,U.S. Senate,Jim Inhofe,REP,120211,0,3,25,28,
Choctaw,U.S. Senate,Aaron Delozier,IND,120211,0,0,0,0,
Choctaw,U.S. Senate,Ray Woods,IND,120211,0,0,1,1,
Choctaw,U.S. Senate,Joan Farr,IND,120211,0,0,0,0,
Choctaw,U.S. Senate,Connie Johnson,DEM,120211,0,2,28,30,
Choctaw,U.S. Senate,James Lankford,REP,120211,0,3,23,26,
Choctaw,U.S. Senate,Mark Beard,IND,120211,0,0,2,2,
Choctaw,U.S. House,Earl Everett,DEM,120211,0,2,27,29,02
Choctaw,U.S. House,Markwayne Mullin,REP,120211,0,3,26,29,02
Choctaw,U.S. House,Jon Douthitt,IND,120211,0,0,1,1,02
Choctaw,State Senate,Curtis Mcdaniel,DEM,120211,0,2,30,32,5
Choctaw,State Senate,Joseph Silk,REP,120211,0,3,23,26,5
Choctaw,Governor,Joe Dorman,DEM,120214,0,11,88,99,
Choctaw,Governor,Mary Fallin,REP,120214,0,10,53,63,
Choctaw,Governor,Kimberly Willis,IND,120214,0,1,5,6,
Choctaw,Governor,Richard Prawdzienski,IND,120214,0,0,2,2,
Choctaw,Lieutenant Governor,Cathy Cummings,DEM,120214,0,11,81,92,
Choctaw,Lieutenant Governor,Todd Lamb,REP,120214,0,11,67,78,
Choctaw,Superintendent of Public Instruction,John Cox,DEM,120214,0,9,96,105,
Choctaw,Superintendent of Public Instruction,Joy Hofmeister,REP,120214,0,13,52,65,
Choctaw,Commissioner of Labor,Mike Workman,DEM,120214,0,12,86,98,
Choctaw,Commissioner of Labor,Mark Costello,REP,120214,0,9,60,69,
Choctaw,U.S. Senate,Matt Silverstein,DEM,120214,0,8,66,74,
Choctaw,U.S. Senate,Jim Inhofe,REP,120214,0,13,75,88,
Choctaw,U.S. Senate,Aaron Delozier,IND,120214,0,0,3,3,
Choctaw,U.S. Senate,Ray Woods,IND,120214,0,0,1,1,
Choctaw,U.S. Senate,Joan Farr,IND,120214,0,1,3,4,
Choctaw,U.S. Senate,Connie Johnson,DEM,120214,0,8,65,73,
Choctaw,U.S. Senate,James Lankford,REP,120214,0,13,77,90,
Choctaw,U.S. Senate,Mark Beard,IND,120214,0,1,6,7,
Choctaw,U.S. House,Earl Everett,DEM,120214,0,8,65,73,02
Choctaw,U.S. House,Markwayne Mullin,REP,120214,0,12,75,87,02
Choctaw,U.S. House,Jon Douthitt,IND,120214,0,1,9,10,02
Choctaw,State Senate,Curtis Mcdaniel,DEM,120214,0,12,81,93,5
Choctaw,State Senate,Joseph Silk,REP,120214,0,9,67,76,5
Choctaw,Governor,Joe Dorman,DEM,120215,0,7,42,49,
Choctaw,Governor,Mary Fallin,REP,120215,1,17,68,86,
Choctaw,Governor,Kimberly Willis,IND,120215,0,0,1,1,
Choctaw,Governor,Richard Prawdzienski,IND,120215,0,0,2,2,
Choctaw,Lieutenant Governor,Cathy Cummings,DEM,120215,0,8,38,46,
Choctaw,Lieutenant Governor,Todd Lamb,REP,120215,1,16,75,92,
Choctaw,Superintendent of Public Instruction,John Cox,DEM,120215,0,8,52,60,
Choctaw,Superintendent of Public Instruction,Joy Hofmeister,REP,120215,1,16,60,77,
Choctaw,Commissioner of Labor,Mike Workman,DEM,120215,0,6,42,48,
Choctaw,Commissioner of Labor,Mark Costello,REP,120215,1,18,67,86,
Choctaw,U.S. Senate,Matt Silverstein,DEM,120215,0,5,35,40,
Choctaw,U.S. Senate,Jim Inhofe,REP,120215,1,19,75,95,
Choctaw,U.S. Senate,Aaron Delozier,IND,120215,0,0,0,0,
Choctaw,U.S. Senate,Ray Woods,IND,120215,0,0,1,1,
Choctaw,U.S. Senate,Joan Farr,IND,120215,0,0,2,2,
Choctaw,U.S. Senate,Connie Johnson,DEM,120215,0,5,39,44,
Choctaw,U.S. Senate,James Lankford,REP,120215,1,19,69,89,
Choctaw,U.S. Senate,Mark Beard,IND,120215,0,0,4,4,
Choctaw,U.S. House,Earl Everett,DEM,120215,0,5,34,39,02
Choctaw,U.S. House,Markwayne Mullin,REP,120215,1,19,76,96,02
Choctaw,U.S. House,Jon Douthitt,IND,120215,0,0,4,4,02
Choctaw,State Senate,Curtis Mcdaniel,DEM,120215,0,9,46,55,5
Choctaw,State Senate,Joseph Silk,REP,120215,1,15,67,83,5
Choctaw,Governor,Joe Dorman,DEM,120316,2,25,93,120,
Choctaw,Governor,Mary Fallin,REP,120316,7,43,143,193,
Choctaw,Governor,Kimberly Willis,IND,120316,0,1,10,11,
Choctaw,Governor,Richard Prawdzienski,IND,120316,0,0,4,4,
Choctaw,Lieutenant Governor,Cathy Cummings,DEM,120316,1,20,83,104,
Choctaw,Lieutenant Governor,Todd Lamb,REP,120316,8,49,162,219,
Choctaw,Superintendent of Public Instruction,John Cox,DEM,120316,3,33,117,153,
Choctaw,Superintendent of Public Instruction,Joy Hofmeister,REP,120316,6,34,127,167,
Choctaw,Commissioner of Labor,Mike Workman,DEM,120316,2,25,92,119,
Choctaw,Commissioner of Labor,Mark Costello,REP,120316,7,40,147,194,
Choctaw,U.S. Senate,Matt Silverstein,DEM,120316,1,19,61,81,
Choctaw,U.S. Senate,Jim Inhofe,REP,120316,8,49,174,231,
Choctaw,U.S. Senate,Aaron Delozier,IND,120316,0,0,5,5,
Choctaw,U.S. Senate,Ray Woods,IND,120316,0,0,3,3,
Choctaw,U.S. Senate,Joan Farr,IND,120316,0,1,4,5,
Choctaw,U.S. Senate,Connie Johnson,DEM,120316,1,22,68,91,
Choctaw,U.S. Senate,James Lankford,REP,120316,7,42,167,216,
Choctaw,U.S. Senate,Mark Beard,IND,120316,1,3,11,15,
Choctaw,U.S. House,Earl Everett,DEM,120316,1,18,62,81,02
Choctaw,U.S. House,Markwayne Mullin,REP,120316,8,48,176,232,02
Choctaw,U.S. House,Jon Douthitt,IND,120316,0,3,10,13,02
Choctaw,State Senate,Curtis Mcdaniel,DEM,120316,1,31,86,118,5
Choctaw,State Senate,Joseph Silk,REP,120316,8,38,163,209,5
Choctaw,Governor,Joe Dorman,DEM,120318,0,17,78,95,
Choctaw,Governor,Mary Fallin,REP,120318,1,11,104,116,
Choctaw,Governor,Kimberly Willis,IND,120318,0,1,2,3,
Choctaw,Governor,Richard Prawdzienski,IND,120318,0,0,0,0,
Choctaw,Lieutenant Governor,Cathy Cummings,DEM,120318,0,14,50,64,
Choctaw,Lieutenant Governor,Todd Lamb,REP,120318,1,15,130,146,
Choctaw,Superintendent of Public Instruction,John Cox,DEM,120318,0,18,95,113,
Choctaw,Superintendent of Public Instruction,Joy Hofmeister,REP,120318,1,9,86,96,
Choctaw,Commissioner of Labor,Mike Workman,DEM,120318,0,14,61,75,
Choctaw,Commissioner of Labor,Mark Costello,REP,120318,1,13,120,134,
Choctaw,U.S. Senate,Matt Silverstein,DEM,120318,0,11,37,48,
Choctaw,U.S. Senate,Jim Inhofe,REP,120318,0,17,140,157,
Choctaw,U.S. Senate,Aaron Delozier,IND,120318,0,0,4,4,
Choctaw,U.S. Senate,Ray Woods,IND,120318,0,0,1,1,
Choctaw,U.S. Senate,Joan Farr,IND,120318,1,1,2,4,
Choctaw,U.S. Senate,Connie Johnson,DEM,120318,0,11,35,46,
Choctaw,U.S. Senate,James Lankford,REP,120318,1,18,136,155,
Choctaw,U.S. Senate,Mark Beard,IND,120318,0,0,10,10,
Choctaw,U.S. House,Earl Everett,DEM,120318,0,10,35,45,02
Choctaw,U.S. House,Markwayne Mullin,REP,120318,1,18,142,161,02
Choctaw,U.S. House,Jon Douthitt,IND,120318,0,1,4,5,02
Choctaw,State Senate,Curtis Mcdaniel,DEM,120318,1,17,65,83,5
Choctaw,State Senate,Joseph Silk,REP,120318,0,12,121,133,5
Choctaw,Governor,Joe Dorman,DEM,120319,2,6,69,77,
Choctaw,Governor,Mary Fallin,REP,120319,4,8,86,98,
Choctaw,Governor,Kimberly Willis,IND,120319,0,1,5,6,
Choctaw,Governor,Richard Prawdzienski,IND,120319,0,0,0,0,
Choctaw,Lieutenant Governor,Cathy Cummings,DEM,120319,1,4,56,61,
Choctaw,Lieutenant Governor,Todd Lamb,REP,120319,5,11,105,121,
Choctaw,Superintendent of Public Instruction,John Cox,DEM,120319,2,7,92,101,
Choctaw,Superintendent of Public Instruction,Joy Hofmeister,REP,120319,4,8,69,81,
Choctaw,Commissioner of Labor,Mike Workman,DEM,120319,1,6,61,68,
Choctaw,Commissioner of Labor,Mark Costello,REP,120319,5,9,96,110,
Choctaw,U.S. Senate,Matt Silverstein,DEM,120319,1,5,42,48,
Choctaw,U.S. Senate,Jim Inhofe,REP,120319,5,10,113,128,
Choctaw,U.S. Senate,Aaron Delozier,IND,120319,0,0,0,0,
Choctaw,U.S. Senate,Ray Woods,IND,120319,0,0,3,3,
Choctaw,U.S. Senate,Joan Farr,IND,120319,0,0,2,2,
Choctaw,U.S. Senate,Connie Johnson,DEM,120319,1,5,43,49,
Choctaw,U.S. Senate,James Lankford,REP,120319,5,10,110,125,
Choctaw,U.S. Senate,Mark Beard,IND,120319,0,0,9,9,
Choctaw,U.S. House,Earl Everett,DEM,120319,1,1,42,44,02
Choctaw,U.S. House,Markwayne Mullin,REP,120319,5,14,115,134,02
Choctaw,U.S. House,Jon Douthitt,IND,120319,0,0,6,6,02
Choctaw,State Senate,Curtis Mcdaniel,DEM,120319,2,5,64,71,5
Choctaw,State Senate,Joseph Silk,REP,120319,4,10,97,111,5
Choctaw,Governor,Joe Dorman,DEM,120320,0,2,38,40,
Choctaw,Governor,Mary Fallin,REP,120320,0,0,46,46,
Choctaw,Governor,Kimberly Willis,IND,120320,0,0,1,1,
Choctaw,Governor,Richard Prawdzienski,IND,120320,0,0,1,1,
Choctaw,Lieutenant Governor,Cathy Cummings,DEM,120320,0,2,30,32,
Choctaw,Lieutenant Governor,Todd Lamb,REP,120320,0,0,55,55,
Choctaw,Superintendent of Public Instruction,John Cox,DEM,120320,0,2,50,52,
Choctaw,Superintendent of Public Instruction,Joy Hofmeister,REP,120320,0,0,36,36,
Choctaw,Commissioner of Labor,Mike Workman,DEM,120320,0,1,31,32,
Choctaw,Commissioner of Labor,Mark Costello,REP,120320,0,1,52,53,
Choctaw,U.S. Senate,Matt Silverstein,DEM,120320,0,2,21,23,
Choctaw,U.S. Senate,Jim Inhofe,REP,120320,0,0,62,62,
Choctaw,U.S. Senate,Aaron Delozier,IND,120320,0,0,0,0,
Choctaw,U.S. Senate,Ray Woods,IND,120320,0,0,1,1,
Choctaw,U.S. Senate,Joan Farr,IND,120320,0,0,3,3,
Choctaw,U.S. Senate,Connie Johnson,DEM,120320,0,1,27,28,
Choctaw,U.S. Senate,James Lankford,REP,120320,0,1,55,56,
Choctaw,U.S. Senate,Mark Beard,IND,120320,0,0,5,5,
Choctaw,U.S. House,Earl Everett,DEM,120320,0,1,22,23,02
Choctaw,U.S. House,Markwayne Mullin,REP,120320,0,1,63,64,02
Choctaw,U.S. House,Jon Douthitt,IND,120320,0,0,1,1,02
Choctaw,State Senate,Curtis Mcdaniel,DEM,120320,0,1,31,32,5
Choctaw,State Senate,Joseph Silk,REP,120320,0,1,56,57,5
Choctaw,Governor,Joe Dorman,DEM,120321,1,2,73,76,
Choctaw,Governor,Mary Fallin,REP,120321,7,11,140,158,
Choctaw,Governor,Kimberly Willis,IND,120321,0,2,6,8,
Choctaw,Governor,Richard Prawdzienski,IND,120321,0,0,3,3,
Choctaw,Lieutenant Governor,Cathy Cummings,DEM,120321,1,1,67,69,
Choctaw,Lieutenant Governor,Todd Lamb,REP,120321,7,13,152,172,
Choctaw,Superintendent of Public Instruction,John Cox,DEM,120321,2,7,108,117,
Choctaw,Superintendent of Public Instruction,Joy Hofmeister,REP,120321,6,8,112,126,
Choctaw,Commissioner of Labor,Mike Workman,DEM,120321,1,1,76,78,
Choctaw,Commissioner of Labor,Mark Costello,REP,120321,7,13,141,161,
Choctaw,U.S. Senate,Matt Silverstein,DEM,120321,1,1,49,51,
Choctaw,U.S. Senate,Jim Inhofe,REP,120321,7,14,163,184,
Choctaw,U.S. Senate,Aaron Delozier,IND,120321,0,0,1,1,
Choctaw,U.S. Senate,Ray Woods,IND,120321,0,0,3,3,
Choctaw,U.S. Senate,Joan Farr,IND,120321,0,0,3,3,
Choctaw,U.S. Senate,Connie Johnson,DEM,120321,1,1,57,59,
Choctaw,U.S. Senate,James Lankford,REP,120321,7,13,157,177,
Choctaw,U.S. Senate,Mark Beard,IND,120321,0,0,5,5,
Choctaw,U.S. House,Earl Everett,DEM,120321,1,1,51,53,02
Choctaw,U.S. House,Markwayne Mullin,REP,120321,7,13,162,182,02
Choctaw,U.S. House,Jon Douthitt,IND,120321,0,0,4,4,02
Choctaw,State Senate,Curtis Mcdaniel,DEM,120321,1,4,73,78,5
Choctaw,State Senate,Joseph Silk,REP,120321,7,11,147,165,5
Choctaw,Governor,Joe Dorman,DEM,120322,0,1,42,43,
Choctaw,Governor,Mary Fallin,REP,120322,0,6,57,63,
Choctaw,Governor,Kimberly Willis,IND,120322,0,1,6,7,
Choctaw,Governor,Richard Prawdzienski,IND,120322,0,0,3,3,
Choctaw,Lieutenant Governor,Cathy Cummings,DEM,120322,0,1,33,34,
Choctaw,Lieutenant Governor,Todd Lamb,REP,120322,0,7,73,80,
Choctaw,Superintendent of Public Instruction,John Cox,DEM,120322,0,3,56,59,
Choctaw,Superintendent of Public Instruction,Joy Hofmeister,REP,120322,0,5,51,56,
Choctaw,Commissioner of Labor,Mike Workman,DEM,120322,0,1,39,40,
Choctaw,Commissioner of Labor,Mark Costello,REP,120322,0,5,66,71,
Choctaw,U.S. Senate,Matt Silverstein,DEM,120322,0,0,16,16,
Choctaw,U.S. Senate,Jim Inhofe,REP,120322,0,8,83,91,
Choctaw,U.S. Senate,Aaron Delozier,IND,120322,0,0,1,1,
Choctaw,U.S. Senate,Ray Woods,IND,120322,0,0,3,3,
Choctaw,U.S. Senate,Joan Farr,IND,120322,0,0,4,4,
Choctaw,U.S. Senate,Connie Johnson,DEM,120322,0,1,24,25,
Choctaw,U.S. Senate,James Lankford,REP,120322,0,7,76,83,
Choctaw,U.S. Senate,Mark Beard,IND,120322,0,0,6,6,
Choctaw,U.S. House,Earl Everett,DEM,120322,0,0,22,22,02
Choctaw,U.S. House,Markwayne Mullin,REP,120322,0,8,83,91,02
Choctaw,U.S. House,Jon Douthitt,IND,120322,0,0,3,3,02
Choctaw,State Senate,Curtis Mcdaniel,DEM,120322,0,4,41,45,5
Choctaw,State Senate,Joseph Silk,REP,120322,0,4,67,71,5
Cimarron,Governor,Joe Dorman,DEM,130002,1,1,14,16,
Cimarron,Governor,Mary Fallin,REP,130002,12,12,75,99,
Cimarron,Governor,Kimberly Willis,IND,130002,0,0,2,2,
Cimarron,Governor,Richard Prawdzienski,IND,130002,1,1,0,2,
Cimarron,Lieutenant Governor,Cathy Cummings,DEM,130002,3,0,9,12,
Cimarron,Lieutenant Governor,Todd Lamb,REP,130002,11,14,80,105,
Cimarron,Superintendent of Public Instruction,John Cox,DEM,130002,3,2,41,46,
Cimarron,Superintendent of Public Instruction,Joy Hofmeister,REP,130002,11,12,50,73,
Cimarron,Commissioner of Labor,Mike Workman,DEM,130002,2,2,14,18,
Cimarron,Commissioner of Labor,Mark Costello,REP,130002,12,12,75,99,
Cimarron,U.S. Senate,Matt Silverstein,DEM,130002,1,0,8,9,
Cimarron,U.S. Senate,Jim Inhofe,REP,130002,13,14,79,106,
Cimarron,U.S. Senate,Aaron Delozier,IND,130002,0,0,1,1,
Cimarron,U.S. Senate,Ray Woods,IND,130002,0,0,2,2,
Cimarron,U.S. Senate,Joan Farr,IND,130002,0,0,0,0,
Cimarron,U.S. Senate,Connie Johnson,DEM,130002,2,1,10,13,
Cimarron,U.S. Senate,James Lankford,REP,130002,11,13,79,103,
Cimarron,U.S. Senate,Mark Beard,IND,130002,1,0,1,2,
Cimarron,U.S. House,Frankie Robbins,DEM,130002,1,0,8,9,03
Cimarron,U.S. House,Frank Lucas,REP,130002,13,14,83,110,03
Cimarron,Governor,Joe Dorman,DEM,130003,0,2,23,25,
Cimarron,Governor,Mary Fallin,REP,130003,5,17,67,89,
Cimarron,Governor,Kimberly Willis,IND,130003,0,0,7,7,
Cimarron,Governor,Richard Prawdzienski,IND,130003,0,0,7,7,
Cimarron,Lieutenant Governor,Cathy Cummings,DEM,130003,0,1,8,9,
Cimarron,Lieutenant Governor,Todd Lamb,REP,130003,5,17,94,116,
Cimarron,Superintendent of Public Instruction,John Cox,DEM,130003,1,6,42,49,
Cimarron,Superintendent of Public Instruction,Joy Hofmeister,REP,130003,4,12,61,77,
Cimarron,Commissioner of Labor,Mike Workman,DEM,130003,0,4,18,22,
Cimarron,Commissioner of Labor,Mark Costello,REP,130003,5,14,86,105,
Cimarron,U.S. Senate,Matt Silverstein,DEM,130003,0,1,2,3,
Cimarron,U.S. Senate,Jim Inhofe,REP,130003,5,17,94,116,
Cimarron,U.S. Senate,Aaron Delozier,IND,130003,0,0,2,2,
Cimarron,U.S. Senate,Ray Woods,IND,130003,0,0,6,6,
Cimarron,U.S. Senate,Joan Farr,IND,130003,0,0,1,1,
Cimarron,U.S. Senate,Connie Johnson,DEM,130003,0,2,7,9,
Cimarron,U.S. Senate,James Lankford,REP,130003,5,16,88,109,
Cimarron,U.S. Senate,Mark Beard,IND,130003,0,0,6,6,
Cimarron,U.S. House,Frankie Robbins,DEM,130003,0,2,6,8,03
Cimarron,U.S. House,Frank Lucas,REP,130003,5,16,93,114,03
Cimarron,Governor,Joe Dorman,DEM,130004,0,7,21,28,
Cimarron,Governor,Mary Fallin,REP,130004,0,17,82,99,
Cimarron,Governor,Kimberly Willis,IND,130004,0,1,5,6,
Cimarron,Governor,Richard Prawdzienski,IND,130004,1,1,5,7,
Cimarron,Lieutenant Governor,Cathy Cummings,DEM,130004,0,3,9,12,
Cimarron,Lieutenant Governor,Todd Lamb,REP,130004,1,23,104,128,
Cimarron,Superintendent of Public Instruction,John Cox,DEM,130004,0,7,47,54,
Cimarron,Superintendent of Public Instruction,Joy Hofmeister,REP,130004,1,19,66,86,
Cimarron,Commissioner of Labor,Mike Workman,DEM,130004,0,4,16,20,
Cimarron,Commissioner of Labor,Mark Costello,REP,130004,1,22,94,117,
Cimarron,U.S. Senate,Matt Silverstein,DEM,130004,0,4,3,7,
Cimarron,U.S. Senate,Jim Inhofe,REP,130004,1,21,106,128,
Cimarron,U.S. Senate,Aaron Delozier,IND,130004,0,1,0,1,
Cimarron,U.S. Senate,Ray Woods,IND,130004,0,0,5,5,
Cimarron,U.S. Senate,Joan Farr,IND,130004,0,0,1,1,
Cimarron,U.S. Senate,Connie Johnson,DEM,130004,0,3,8,11,
Cimarron,U.S. Senate,James Lankford,REP,130004,0,21,100,121,
Cimarron,U.S. Senate,Mark Beard,IND,130004,1,2,4,7,
Cimarron,U.S. House,Frankie Robbins,DEM,130004,0,2,5,7,03
Cimarron,U.S. House,Frank Lucas,REP,130004,1,24,110,135,03
Cimarron,Governor,Joe Dorman,DEM,130005,0,4,25,29,
Cimarron,Governor,Mary Fallin,REP,130005,2,13,65,80,
Cimarron,Governor,Kimberly Willis,IND,130005,0,0,5,5,
Cimarron,Governor,Richard Prawdzienski,IND,130005,0,0,4,4,
Cimarron,Lieutenant Governor,Cathy Cummings,DEM,130005,0,2,11,13,
Cimarron,Lieutenant Governor,Todd Lamb,REP,130005,2,15,86,103,
Cimarron,Superintendent of Public Instruction,John Cox,DEM,130005,0,7,43,50,
Cimarron,Superintendent of Public Instruction,Joy Hofmeister,REP,130005,2,11,53,66,
Cimarron,Commissioner of Labor,Mike Workman,DEM,130005,0,4,17,21,
Cimarron,Commissioner of Labor,Mark Costello,REP,130005,2,13,78,93,
Cimarron,U.S. Senate,Matt Silverstein,DEM,130005,0,1,10,11,
Cimarron,U.S. Senate,Jim Inhofe,REP,130005,2,17,86,105,
Cimarron,U.S. Senate,Aaron Delozier,IND,130005,0,0,1,1,
Cimarron,U.S. Senate,Ray Woods,IND,130005,0,0,2,2,
Cimarron,U.S. Senate,Joan Farr,IND,130005,0,0,0,0,
Cimarron,U.S. Senate,Connie Johnson,DEM,130005,0,1,13,14,
Cimarron,U.S. Senate,James Lankford,REP,130005,2,15,79,96,
Cimarron,U.S. Senate,Mark Beard,IND,130005,0,1,5,6,
Cimarron,U.S. House,Frankie Robbins,DEM,130005,0,1,10,11,03
Cimarron,U.S. House,Frank Lucas,REP,130005,2,16,91,109,03
Cimarron,Governor,Joe Dorman,DEM,130006,2,5,26,33,
Cimarron,Governor,Mary Fallin,REP,130006,15,31,118,164,
Cimarron,Governor,Kimberly Willis,IND,130006,1,0,8,9,
Cimarron,Governor,Richard Prawdzienski,IND,130006,0,0,3,3,
Cimarron,Lieutenant Governor,Cathy Cummings,DEM,130006,0,3,12,15,
Cimarron,Lieutenant Governor,Todd Lamb,REP,130006,18,34,143,195,
Cimarron,Superintendent of Public Instruction,John Cox,DEM,130006,7,8,31,46,
Cimarron,Superintendent of Public Instruction,Joy Hofmeister,REP,130006,10,28,123,161,
Cimarron,Commissioner of Labor,Mike Workman,DEM,130006,1,7,21,29,
Cimarron,Commissioner of Labor,Mark Costello,REP,130006,16,27,131,174,
Cimarron,U.S. Senate,Matt Silverstein,DEM,130006,0,1,8,9,
Cimarron,U.S. Senate,Jim Inhofe,REP,130006,16,35,142,193,
Cimarron,U.S. Senate,Aaron Delozier,IND,130006,0,0,1,1,
Cimarron,U.S. Senate,Ray Woods,IND,130006,0,1,5,6,
Cimarron,U.S. Senate,Joan Farr,IND,130006,0,0,0,0,
Cimarron,U.S. Senate,Connie Johnson,DEM,130006,0,3,10,13,
Cimarron,U.S. Senate,James Lankford,REP,130006,16,33,138,187,
Cimarron,U.S. Senate,Mark Beard,IND,130006,2,1,7,10,
Cimarron,U.S. House,Frankie Robbins,DEM,130006,1,1,11,13,03
Cimarron,U.S. House,Frank Lucas,REP,130006,17,36,142,195,03
Cimarron,Governor,Joe Dorman,DEM,130007,1,2,3,6,
Cimarron,Governor,Mary Fallin,REP,130007,2,7,36,45,
Cimarron,Governor,Kimberly Willis,IND,130007,0,0,0,0,
Cimarron,Governor,Richard Prawdzienski,IND,130007,0,0,0,0,
Cimarron,Lieutenant Governor,Cathy Cummings,DEM,130007,1,2,3,6,
Cimarron,Lieutenant Governor,Todd Lamb,REP,130007,2,7,36,45,
Cimarron,Superintendent of Public Instruction,John Cox,DEM,130007,2,2,15,19,
Cimarron,Superintendent of Public Instruction,Joy Hofmeister,REP,130007,1,6,24,31,
Cimarron,Commissioner of Labor,Mike Workman,DEM,130007,1,2,2,5,
Cimarron,Commissioner of Labor,Mark Costello,REP,130007,2,6,36,44,
Cimarron,U.S. Senate,Matt Silverstein,DEM,130007,1,2,1,4,
Cimarron,U.S. Senate,Jim Inhofe,REP,130007,2,7,38,47,
Cimarron,U.S. Senate,Aaron Delozier,IND,130007,0,0,0,0,
Cimarron,U.S. Senate,Ray Woods,IND,130007,0,0,0,0,
Cimarron,U.S. Senate,Joan Farr,IND,130007,0,0,0,0,
Cimarron,U.S. Senate,Connie Johnson,DEM,130007,1,2,1,4,
Cimarron,U.S. Senate,James Lankford,REP,130007,2,5,37,44,
Cimarron,U.S. Senate,Mark Beard,IND,130007,0,1,0,1,
Cimarron,U.S. House,Frankie Robbins,DEM,130007,1,2,1,4,03
Cimarron,U.S. House,Frank Lucas,REP,130007,2,7,37,46,03
Cleveland,Governor,Joe Dorman,DEM,140002,7,13,210,230,
Cleveland,Governor,Mary Fallin,REP,140002,2,4,73,79,
Cleveland,Governor,Kimberly Willis,IND,140002,0,0,8,8,
Cleveland,Governor,Richard Prawdzienski,IND,140002,0,2,6,8,
Cleveland,Lieutenant Governor,Cathy Cummings,DEM,140002,7,10,189,206,
Cleveland,Lieutenant Governor,Todd Lamb,REP,140002,2,9,108,119,
Cleveland,Superintendent of Public Instruction,John Cox,DEM,140002,7,10,203,220,
Cleveland,Superintendent of Public Instruction,Joy Hofmeister,REP,140002,1,9,90,100,
Cleveland,Commissioner of Labor,Mike Workman,DEM,140002,7,11,193,211,
Cleveland,Commissioner of Labor,Mark Costello,REP,140002,2,8,97,107,
Cleveland,U.S. Senate,Matt Silverstein,DEM,140002,7,9,174,190,
Cleveland,U.S. Senate,Jim Inhofe,REP,140002,2,8,102,112,
Cleveland,U.S. Senate,Aaron Delozier,IND,140002,0,2,9,11,
Cleveland,U.S. Senate,Ray Woods,IND,140002,0,0,3,3,
Cleveland,U.S. Senate,Joan Farr,IND,140002,0,0,8,8,
Cleveland,U.S. Senate,Connie Johnson,DEM,140002,7,10,181,198,
Cleveland,U.S. Senate,James Lankford,REP,140002,2,7,103,112,
Cleveland,U.S. Senate,Mark Beard,IND,140002,0,2,12,14,
Cleveland,U.S. House,Bert Smith,DEM,140002,7,8,161,176,04
Cleveland,U.S. House,Tom Cole,REP,140002,1,10,112,123,04
Cleveland,U.S. House,Dennis Johnson,IND,140002,1,1,23,25,04
Cleveland,Governor,Joe Dorman,DEM,140003,6,29,274,309,
Cleveland,Governor,Mary Fallin,REP,140003,4,10,172,186,
Cleveland,Governor,Kimberly Willis,IND,140003,0,1,14,15,
Cleveland,Governor,Richard Prawdzienski,IND,140003,0,0,3,3,
Cleveland,Lieutenant Governor,Cathy Cummings,DEM,140003,6,24,224,254,
Cleveland,Lieutenant Governor,Todd Lamb,REP,140003,4,16,236,256,
Cleveland,Superintendent of Public Instruction,John Cox,DEM,140003,7,27,272,306,
Cleveland,Superintendent of Public Instruction,Joy Hofmeister,REP,140003,2,11,188,201,
Cleveland,Commissioner of Labor,Mike Workman,DEM,140003,6,25,225,256,
Cleveland,Commissioner of Labor,Mark Costello,REP,140003,4,13,221,238,
Cleveland,U.S. Senate,Matt Silverstein,DEM,140003,6,26,195,227,
Cleveland,U.S. Senate,Jim Inhofe,REP,140003,4,14,242,260,
Cleveland,U.S. Senate,Aaron Delozier,IND,140003,0,0,9,9,
Cleveland,U.S. Senate,Ray Woods,IND,140003,0,0,3,3,
Cleveland,U.S. Senate,Joan Farr,IND,140003,0,0,11,11,
Cleveland,U.S. Senate,Connie Johnson,DEM,140003,6,21,209,236,
Cleveland,U.S. Senate,James Lankford,REP,140003,4,18,236,258,
Cleveland,U.S. Senate,Mark Beard,IND,140003,0,1,19,20,
Cleveland,U.S. House,Bert Smith,DEM,140003,6,17,168,191,04
Cleveland,U.S. House,Tom Cole,REP,140003,4,20,265,289,04
Cleveland,U.S. House,Dennis Johnson,IND,140003,0,3,25,28,04
Cleveland,State House,Claudia Griffith,DEM,140003,6,26,251,283,45
Cleveland,State House,Aaron Stiles,REP,140003,4,14,208,226,45
Cleveland,Governor,Joe Dorman,DEM,140004,20,24,370,414,
Cleveland,Governor,Mary Fallin,REP,140004,50,33,796,879,
Cleveland,Governor,Kimberly Willis,IND,140004,0,0,18,18,
Cleveland,Governor,Richard Prawdzienski,IND,140004,0,0,6,6,
Cleveland,Lieutenant Governor,Cathy Cummings,DEM,140004,15,16,247,278,
Cleveland,Lieutenant Governor,Todd Lamb,REP,140004,55,40,939,1034,
Cleveland,Superintendent of Public Instruction,John Cox,DEM,140004,23,24,409,456,
Cleveland,Superintendent of Public Instruction,Joy Hofmeister,REP,140004,42,33,772,847,
Cleveland,Commissioner of Labor,Mike Workman,DEM,140004,17,18,266,301,
Cleveland,Commissioner of Labor,Mark Costello,REP,140004,50,36,887,973,
Cleveland,U.S. Senate,Matt Silverstein,DEM,140004,16,17,218,251,
Cleveland,U.S. Senate,Jim Inhofe,REP,140004,53,40,938,1031,
Cleveland,U.S. Senate,Aaron Delozier,IND,140004,0,0,8,8,
Cleveland,U.S. Senate,Ray Woods,IND,140004,0,0,10,10,
Cleveland,U.S. Senate,Joan Farr,IND,140004,1,0,14,15,
Cleveland,U.S. Senate,Connie Johnson,DEM,140004,15,14,210,239,
Cleveland,U.S. Senate,James Lankford,REP,140004,53,41,959,1053,
Cleveland,U.S. Senate,Mark Beard,IND,140004,1,2,21,24,
Cleveland,U.S. House,Bert Smith,DEM,140004,11,10,184,205,04
Cleveland,U.S. House,Tom Cole,REP,140004,56,46,963,1065,04
Cleveland,U.S. House,Dennis Johnson,IND,140004,3,1,40,44,04
Cleveland,State House,Trey Puckett,DEM,140004,15,18,230,263,91
Cleveland,State House,Chris Kannady,REP,140004,53,39,947,1039,91
Cleveland,Governor,Joe Dorman,DEM,140005,15,23,423,461,
Cleveland,Governor,Mary Fallin,REP,140005,62,36,706,804,
Cleveland,Governor,Kimberly Willis,IND,140005,0,1,18,19,
Cleveland,Governor,Richard Prawdzienski,IND,140005,0,0,8,8,
Cleveland,Lieutenant Governor,Cathy Cummings,DEM,140005,14,19,302,335,
Cleveland,Lieutenant Governor,Todd Lamb,REP,140005,62,41,850,953,
Cleveland,Superintendent of Public Instruction,John Cox,DEM,140005,23,23,436,482,
Cleveland,Superintendent of Public Instruction,Joy Hofmeister,REP,140005,51,36,709,796,
Cleveland,Commissioner of Labor,Mike Workman,DEM,140005,18,22,340,380,
Cleveland,Commissioner of Labor,Mark Costello,REP,140005,55,36,786,877,
Cleveland,U.S. Senate,Matt Silverstein,DEM,140005,11,17,263,291,
Cleveland,U.S. Senate,Jim Inhofe,REP,140005,65,42,849,956,
Cleveland,U.S. Senate,Aaron Delozier,IND,140005,0,1,8,9,
Cleveland,U.S. Senate,Ray Woods,IND,140005,0,0,12,12,
Cleveland,U.S. Senate,Joan Farr,IND,140005,1,0,15,16,
Cleveland,U.S. Senate,Connie Johnson,DEM,140005,11,18,266,295,
Cleveland,U.S. Senate,James Lankford,REP,140005,65,41,852,958,
Cleveland,U.S. Senate,Mark Beard,IND,140005,1,1,34,36,
Cleveland,U.S. House,Bert Smith,DEM,140005,10,14,243,267,04
Cleveland,U.S. House,Tom Cole,REP,140005,67,43,867,977,04
Cleveland,U.S. House,Dennis Johnson,IND,140005,0,3,42,45,04
Cleveland,Governor,Joe Dorman,DEM,140006,12,34,455,501,
Cleveland,Governor,Mary Fallin,REP,140006,3,4,104,111,
Cleveland,Governor,Kimberly Willis,IND,140006,0,0,5,5,
Cleveland,Governor,Richard Prawdzienski,IND,140006,0,0,3,3,
Cleveland,Lieutenant Governor,Cathy Cummings,DEM,140006,11,32,417,460,
Cleveland,Lieutenant Governor,Todd Lamb,REP,140006,3,6,142,151,
Cleveland,Superintendent of Public Instruction,John Cox,DEM,140006,10,32,419,461,
Cleveland,Superintendent of Public Instruction,Joy Hofmeister,REP,140006,5,6,141,152,
Cleveland,Commissioner of Labor,Mike Workman,DEM,140006,12,33,408,453,
Cleveland,Commissioner of Labor,Mark Costello,REP,140006,3,4,142,149,
Cleveland,U.S. Senate,Matt Silverstein,DEM,140006,12,34,401,447,
Cleveland,U.S. Senate,Jim Inhofe,REP,140006,3,4,133,140,
Cleveland,U.S. Senate,Aaron Delozier,IND,140006,0,0,8,8,
Cleveland,U.S. Senate,Ray Woods,IND,140006,0,0,8,8,
Cleveland,U.S. Senate,Joan Farr,IND,140006,0,0,8,8,
Cleveland,U.S. Senate,Connie Johnson,DEM,140006,12,33,395,440,
Cleveland,U.S. Senate,James Lankford,REP,140006,3,5,155,163,
Cleveland,U.S. Senate,Mark Beard,IND,140006,0,0,16,16,
Cleveland,U.S. House,Bert Smith,DEM,140006,9,27,347,383,04
Cleveland,U.S. House,Tom Cole,REP,140006,6,10,176,192,04
Cleveland,U.S. House,Dennis Johnson,IND,140006,0,1,38,39,04
Cleveland,Governor,Joe Dorman,DEM,140007,7,5,192,204,
Cleveland,Governor,Mary Fallin,REP,140007,17,14,423,454,
Cleveland,Governor,Kimberly Willis,IND,140007,0,0,12,12,
Cleveland,Governor,Richard Prawdzienski,IND,140007,1,0,3,4,
Cleveland,Lieutenant Governor,Cathy Cummings,DEM,140007,5,3,126,134,
Cleveland,Lieutenant Governor,Todd Lamb,REP,140007,20,16,504,540,
Cleveland,Superintendent of Public Instruction,John Cox,DEM,140007,2,5,189,196,
Cleveland,Superintendent of Public Instruction,Joy Hofmeister,REP,140007,22,13,436,471,
Cleveland,Commissioner of Labor,Mike Workman,DEM,140007,4,2,128,134,
Cleveland,Commissioner of Labor,Mark Costello,REP,140007,21,16,478,515,
Cleveland,U.S. Senate,Matt Silverstein,DEM,140007,4,2,102,108,
Cleveland,U.S. Senate,Jim Inhofe,REP,140007,19,17,511,547,
Cleveland,U.S. Senate,Aaron Delozier,IND,140007,0,0,3,3,
Cleveland,U.S. Senate,Ray Woods,IND,140007,1,0,5,6,
Cleveland,U.S. Senate,Joan Farr,IND,140007,1,0,10,11,
Cleveland,U.S. Senate,Connie Johnson,DEM,140007,4,2,113,119,
Cleveland,U.S. Senate,James Lankford,REP,140007,19,16,509,544,
Cleveland,U.S. Senate,Mark Beard,IND,140007,2,0,10,12,
Cleveland,U.S. House,Bert Smith,DEM,140007,2,2,91,95,04
Cleveland,U.S. House,Tom Cole,REP,140007,21,16,511,548,04
Cleveland,U.S. House,Dennis Johnson,IND,140007,2,0,24,26,04
Cleveland,Governor,Joe Dorman,DEM,140008,9,24,450,483,
Cleveland,Governor,Mary Fallin,REP,140008,4,7,67,78,
Cleveland,Governor,Kimberly Willis,IND,140008,0,3,11,14,
Cleveland,Governor,Richard Prawdzienski,IND,140008,0,0,6,6,
Cleveland,Lieutenant Governor,Cathy Cummings,DEM,140008,9,25,410,444,
Cleveland,Lieutenant Governor,Todd Lamb,REP,140008,4,9,121,134,
Cleveland,Superintendent of Public Instruction,John Cox,DEM,140008,9,20,418,447,
Cleveland,Superintendent of Public Instruction,Joy Hofmeister,REP,140008,3,14,112,129,
Cleveland,Commissioner of Labor,Mike Workman,DEM,140008,9,21,403,433,
Cleveland,Commissioner of Labor,Mark Costello,REP,140008,3,12,104,119,
Cleveland,U.S. Senate,Matt Silverstein,DEM,140008,8,18,388,414,
Cleveland,U.S. Senate,Jim Inhofe,REP,140008,3,12,113,128,
Cleveland,U.S. Senate,Aaron Delozier,IND,140008,0,1,8,9,
Cleveland,U.S. Senate,Ray Woods,IND,140008,0,0,6,6,
Cleveland,U.S. Senate,Joan Farr,IND,140008,1,3,17,21,
Cleveland,U.S. Senate,Connie Johnson,DEM,140008,9,25,403,437,
Cleveland,U.S. Senate,James Lankford,REP,140008,4,9,107,120,
Cleveland,U.S. Senate,Mark Beard,IND,140008,0,0,22,22,
Cleveland,U.S. House,Bert Smith,DEM,140008,9,18,346,373,04
Cleveland,U.S. House,Tom Cole,REP,140008,4,15,146,165,04
Cleveland,U.S. House,Dennis Johnson,IND,140008,0,1,38,39,04
Cleveland,Governor,Joe Dorman,DEM,140009,12,18,322,352,
Cleveland,Governor,Mary Fallin,REP,140009,23,30,545,598,
Cleveland,Governor,Kimberly Willis,IND,140009,0,0,26,26,
Cleveland,Governor,Richard Prawdzienski,IND,140009,0,0,11,11,
Cleveland,Lieutenant Governor,Cathy Cummings,DEM,140009,8,10,226,244,
Cleveland,Lieutenant Governor,Todd Lamb,REP,140009,27,38,669,734,
Cleveland,Superintendent of Public Instruction,John Cox,DEM,140009,10,13,332,355,
Cleveland,Superintendent of Public Instruction,Joy Hofmeister,REP,140009,25,35,562,622,
Cleveland,Commissioner of Labor,Mike Workman,DEM,140009,9,10,227,246,
Cleveland,Commissioner of Labor,Mark Costello,REP,140009,25,37,643,705,
Cleveland,U.S. Senate,Matt Silverstein,DEM,140009,7,10,191,208,
Cleveland,U.S. Senate,Jim Inhofe,REP,140009,28,37,660,725,
Cleveland,U.S. Senate,Aaron Delozier,IND,140009,0,0,11,11,
Cleveland,U.S. Senate,Ray Woods,IND,140009,0,1,17,18,
Cleveland,U.S. Senate,Joan Farr,IND,140009,0,0,11,11,
Cleveland,U.S. Senate,Connie Johnson,DEM,140009,7,12,193,212,
Cleveland,U.S. Senate,James Lankford,REP,140009,28,36,680,744,
Cleveland,U.S. Senate,Mark Beard,IND,140009,0,0,24,24,
Cleveland,U.S. House,Bert Smith,DEM,140009,7,11,165,183,04
Cleveland,U.S. House,Tom Cole,REP,140009,28,33,686,747,04
Cleveland,U.S. House,Dennis Johnson,IND,140009,0,2,42,44,04
Cleveland,State House,Trey Puckett,DEM,140009,7,10,204,221,91
Cleveland,State House,Chris Kannady,REP,140009,28,37,681,746,91
Cleveland,Governor,Joe Dorman,DEM,140010,7,7,189,203,
Cleveland,Governor,Mary Fallin,REP,140010,33,8,319,360,
Cleveland,Governor,Kimberly Willis,IND,140010,0,0,6,6,
Cleveland,Governor,Richard Prawdzienski,IND,140010,0,0,7,7,
Cleveland,Lieutenant Governor,Cathy Cummings,DEM,140010,6,5,141,152,
Cleveland,Lieutenant Governor,Todd Lamb,REP,140010,34,10,377,421,
Cleveland,Superintendent of Public Instruction,John Cox,DEM,140010,9,4,196,209,
Cleveland,Superintendent of Public Instruction,Joy Hofmeister,REP,140010,31,11,320,362,
Cleveland,Commissioner of Labor,Mike Workman,DEM,140010,5,5,148,158,
Cleveland,Commissioner of Labor,Mark Costello,REP,140010,34,10,354,398,
Cleveland,U.S. Senate,Matt Silverstein,DEM,140010,5,5,131,141,
Cleveland,U.S. Senate,Jim Inhofe,REP,140010,35,10,368,413,
Cleveland,U.S. Senate,Aaron Delozier,IND,140010,0,0,4,4,
Cleveland,U.S. Senate,Ray Woods,IND,140010,0,0,6,6,
Cleveland,U.S. Senate,Joan Farr,IND,140010,0,0,6,6,
Cleveland,U.S. Senate,Connie Johnson,DEM,140010,5,4,122,131,
Cleveland,U.S. Senate,James Lankford,REP,140010,35,10,382,427,
Cleveland,U.S. Senate,Mark Beard,IND,140010,0,0,12,12,
Cleveland,U.S. House,Bert Smith,DEM,140010,5,4,116,125,04
Cleveland,U.S. House,Tom Cole,REP,140010,35,10,380,425,04
Cleveland,U.S. House,Dennis Johnson,IND,140010,0,1,21,22,04
Cleveland,Governor,Joe Dorman,DEM,140011,10,31,437,478,
Cleveland,Governor,Mary Fallin,REP,140011,7,8,143,158,
Cleveland,Governor,Kimberly Willis,IND,140011,0,1,14,15,
Cleveland,Governor,Richard Prawdzienski,IND,140011,0,0,4,4,
Cleveland,Lieutenant Governor,Cathy Cummings,DEM,140011,8,28,393,429,
Cleveland,Lieutenant Governor,Todd Lamb,REP,140011,8,12,201,221,
Cleveland,Superintendent of Public Instruction,John Cox,DEM,140011,11,32,415,458,
Cleveland,Superintendent of Public Instruction,Joy Hofmeister,REP,140011,5,8,179,192,
Cleveland,Commissioner of Labor,Mike Workman,DEM,140011,8,27,396,431,
Cleveland,Commissioner of Labor,Mark Costello,REP,140011,7,12,188,207,
Cleveland,U.S. Senate,Matt Silverstein,DEM,140011,8,26,375,409,
Cleveland,U.S. Senate,Jim Inhofe,REP,140011,8,13,182,203,
Cleveland,U.S. Senate,Aaron Delozier,IND,140011,0,1,7,8,
Cleveland,U.S. Senate,Ray Woods,IND,140011,0,0,10,10,
Cleveland,U.S. Senate,Joan Farr,IND,140011,0,0,16,16,
Cleveland,U.S. Senate,Connie Johnson,DEM,140011,9,27,391,427,
Cleveland,U.S. Senate,James Lankford,REP,140011,8,11,189,208,
Cleveland,U.S. Senate,Mark Beard,IND,140011,0,2,15,17,
Cleveland,U.S. House,Bert Smith,DEM,140011,7,24,331,362,04
Cleveland,U.S. House,Tom Cole,REP,140011,9,15,225,249,04
Cleveland,U.S. House,Dennis Johnson,IND,140011,0,1,34,35,04
Cleveland,Governor,Joe Dorman,DEM,140012,16,60,374,450,
Cleveland,Governor,Mary Fallin,REP,140012,21,45,388,454,
Cleveland,Governor,Kimberly Willis,IND,140012,0,0,16,16,
Cleveland,Governor,Richard Prawdzienski,IND,140012,0,0,9,9,
Cleveland,Lieutenant Governor,Cathy Cummings,DEM,140012,13,53,311,377,
Cleveland,Lieutenant Governor,Todd Lamb,REP,140012,24,52,471,547,
Cleveland,Superintendent of Public Instruction,John Cox,DEM,140012,20,62,348,430,
Cleveland,Superintendent of Public Instruction,Joy Hofmeister,REP,140012,17,42,427,486,
Cleveland,Commissioner of Labor,Mike Workman,DEM,140012,13,59,317,389,
Cleveland,Commissioner of Labor,Mark Costello,REP,140012,23,45,444,512,
Cleveland,U.S. Senate,Matt Silverstein,DEM,140012,12,49,283,344,
Cleveland,U.S. Senate,Jim Inhofe,REP,140012,24,56,469,549,
Cleveland,U.S. Senate,Aaron Delozier,IND,140012,0,0,8,8,
Cleveland,U.S. Senate,Ray Woods,IND,140012,0,0,7,7,
Cleveland,U.S. Senate,Joan Farr,IND,140012,0,0,18,18,
Cleveland,U.S. Senate,Connie Johnson,DEM,140012,13,51,292,356,
Cleveland,U.S. Senate,James Lankford,REP,140012,24,54,470,548,
Cleveland,U.S. Senate,Mark Beard,IND,140012,0,0,20,20,
Cleveland,U.S. House,Bert Smith,DEM,140012,9,42,243,294,04
Cleveland,U.S. House,Tom Cole,REP,140012,26,58,499,583,04
Cleveland,U.S. House,Dennis Johnson,IND,140012,2,5,34,41,04
Cleveland,State House,Claudia Griffith,DEM,140012,14,65,366,445,45
Cleveland,State House,Aaron Stiles,REP,140012,23,40,410,473,45
Cleveland,Governor,Joe Dorman,DEM,140013,6,5,171,182,
Cleveland,Governor,Mary Fallin,REP,140013,0,0,32,32,
Cleveland,Governor,Kimberly Willis,IND,140013,1,0,2,3,
Cleveland,Governor,Richard Prawdzienski,IND,140013,0,0,3,3,
Cleveland,Lieutenant Governor,Cathy Cummings,DEM,140013,7,5,137,149,
Cleveland,Lieutenant Governor,Todd Lamb,REP,140013,0,0,66,66,
Cleveland,Superintendent of Public Instruction,John Cox,DEM,140013,6,4,140,150,
Cleveland,Superintendent of Public Instruction,Joy Hofmeister,REP,140013,0,1,62,63,
Cleveland,Commissioner of Labor,Mike Workman,DEM,140013,7,4,126,137,
Cleveland,Commissioner of Labor,Mark Costello,REP,140013,0,0,67,67,
Cleveland,U.S. Senate,Matt Silverstein,DEM,140013,6,5,125,136,
Cleveland,U.S. Senate,Jim Inhofe,REP,140013,0,0,68,68,
Cleveland,U.S. Senate,Aaron Delozier,IND,140013,1,0,1,2,
Cleveland,U.S. Senate,Ray Woods,IND,140013,0,0,3,3,
Cleveland,U.S. Senate,Joan Farr,IND,140013,0,0,6,6,
Cleveland,U.S. Senate,Connie Johnson,DEM,140013,6,4,125,135,
Cleveland,U.S. Senate,James Lankford,REP,140013,1,1,66,68,
Cleveland,U.S. Senate,Mark Beard,IND,140013,0,0,12,12,
Cleveland,U.S. House,Bert Smith,DEM,140013,5,3,104,112,04
Cleveland,U.S. House,Tom Cole,REP,140013,2,1,83,86,04
Cleveland,U.S. House,Dennis Johnson,IND,140013,0,0,15,15,04
Cleveland,Governor,Joe Dorman,DEM,140014,9,23,276,308,
Cleveland,Governor,Mary Fallin,REP,140014,5,6,85,96,
Cleveland,Governor,Kimberly Willis,IND,140014,0,0,10,10,
Cleveland,Governor,Richard Prawdzienski,IND,140014,0,1,6,7,
Cleveland,Lieutenant Governor,Cathy Cummings,DEM,140014,8,24,246,278,
Cleveland,Lieutenant Governor,Todd Lamb,REP,140014,6,5,124,135,
Cleveland,Superintendent of Public Instruction,John Cox,DEM,140014,8,24,243,275,
Cleveland,Superintendent of Public Instruction,Joy Hofmeister,REP,140014,5,6,128,139,
Cleveland,Commissioner of Labor,Mike Workman,DEM,140014,7,24,239,270,
Cleveland,Commissioner of Labor,Mark Costello,REP,140014,6,5,127,138,
Cleveland,U.S. Senate,Matt Silverstein,DEM,140014,8,23,235,266,
Cleveland,U.S. Senate,Jim Inhofe,REP,140014,6,4,119,129,
Cleveland,U.S. Senate,Aaron Delozier,IND,140014,0,0,3,3,
Cleveland,U.S. Senate,Ray Woods,IND,140014,0,2,8,10,
Cleveland,U.S. Senate,Joan Farr,IND,140014,0,1,8,9,
Cleveland,U.S. Senate,Connie Johnson,DEM,140014,8,24,235,267,
Cleveland,U.S. Senate,James Lankford,REP,140014,6,4,123,133,
Cleveland,U.S. Senate,Mark Beard,IND,140014,0,2,16,18,
Cleveland,U.S. House,Bert Smith,DEM,140014,6,23,207,236,04
Cleveland,U.S. House,Tom Cole,REP,140014,6,6,134,146,04
Cleveland,U.S. House,Dennis Johnson,IND,140014,2,1,29,32,04
Cleveland,Governor,Joe Dorman,DEM,140015,10,32,433,475,
Cleveland,Governor,Mary Fallin,REP,140015,5,15,183,203,
Cleveland,Governor,Kimberly Willis,IND,140015,1,0,10,11,
Cleveland,Governor,Richard Prawdzienski,IND,140015,0,0,12,12,
Cleveland,Lieutenant Governor,Cathy Cummings,DEM,140015,11,31,374,416,
Cleveland,Lieutenant Governor,Todd Lamb,REP,140015,5,15,250,270,
Cleveland,Superintendent of Public Instruction,John Cox,DEM,140015,9,34,413,456,
Cleveland,Superintendent of Public Instruction,Joy Hofmeister,REP,140015,7,14,216,237,
Cleveland,Commissioner of Labor,Mike Workman,DEM,140015,11,34,397,442,
Cleveland,Commissioner of Labor,Mark Costello,REP,140015,5,13,218,236,
Cleveland,U.S. Senate,Matt Silverstein,DEM,140015,11,31,366,408,
Cleveland,U.S. Senate,Jim Inhofe,REP,140015,5,15,232,252,
Cleveland,U.S. Senate,Aaron Delozier,IND,140015,0,0,9,9,
Cleveland,U.S. Senate,Ray Woods,IND,140015,0,0,6,6,
Cleveland,U.S. Senate,Joan Farr,IND,140015,0,1,15,16,
Cleveland,U.S. Senate,Connie Johnson,DEM,140015,10,32,378,420,
Cleveland,U.S. Senate,James Lankford,REP,140015,5,14,236,255,
Cleveland,U.S. Senate,Mark Beard,IND,140015,1,1,16,18,
Cleveland,U.S. House,Bert Smith,DEM,140015,9,29,331,369,04
Cleveland,U.S. House,Tom Cole,REP,140015,6,17,270,293,04
Cleveland,U.S. House,Dennis Johnson,IND,140015,0,2,28,30,04
Cleveland,Governor,Joe Dorman,DEM,140016,19,7,259,285,
Cleveland,Governor,Mary Fallin,REP,140016,24,14,372,410,
Cleveland,Governor,Kimberly Willis,IND,140016,1,0,19,20,
Cleveland,Governor,Richard Prawdzienski,IND,140016,0,0,10,10,
Cleveland,Lieutenant Governor,Cathy Cummings,DEM,140016,13,6,194,213,
Cleveland,Lieutenant Governor,Todd Lamb,REP,140016,31,15,464,510,
Cleveland,Superintendent of Public Instruction,John Cox,DEM,140016,25,6,275,306,
Cleveland,Superintendent of Public Instruction,Joy Hofmeister,REP,140016,19,15,381,415,
Cleveland,Commissioner of Labor,Mike Workman,DEM,140016,21,6,228,255,
Cleveland,Commissioner of Labor,Mark Costello,REP,140016,21,15,423,459,
Cleveland,U.S. Senate,Matt Silverstein,DEM,140016,12,6,171,189,
Cleveland,U.S. Senate,Jim Inhofe,REP,140016,32,15,463,510,
Cleveland,U.S. Senate,Aaron Delozier,IND,140016,0,0,6,6,
Cleveland,U.S. Senate,Ray Woods,IND,140016,0,0,11,11,
Cleveland,U.S. Senate,Joan Farr,IND,140016,0,0,8,8,
Cleveland,U.S. Senate,Connie Johnson,DEM,140016,13,6,174,193,
Cleveland,U.S. Senate,James Lankford,REP,140016,29,15,459,503,
Cleveland,U.S. Senate,Mark Beard,IND,140016,2,0,27,29,
Cleveland,U.S. House,Bert Smith,DEM,140016,10,6,152,168,04
Cleveland,U.S. House,Tom Cole,REP,140016,34,15,483,532,04
Cleveland,U.S. House,Dennis Johnson,IND,140016,0,0,25,25,04
Cleveland,Governor,Joe Dorman,DEM,140017,3,1,60,64,
Cleveland,Governor,Mary Fallin,REP,140017,6,1,167,174,
Cleveland,Governor,Kimberly Willis,IND,140017,0,0,6,6,
Cleveland,Governor,Richard Prawdzienski,IND,140017,0,0,8,8,
Cleveland,Lieutenant Governor,Cathy Cummings,DEM,140017,3,0,60,63,
Cleveland,Lieutenant Governor,Todd Lamb,REP,140017,6,2,177,185,
Cleveland,Superintendent of Public Instruction,John Cox,DEM,140017,3,1,69,73,
Cleveland,Superintendent of Public Instruction,Joy Hofmeister,REP,140017,6,1,168,175,
Cleveland,Commissioner of Labor,Mike Workman,DEM,140017,3,1,61,65,
Cleveland,Commissioner of Labor,Mark Costello,REP,140017,6,1,172,179,
Cleveland,U.S. Senate,Matt Silverstein,DEM,140017,3,1,48,52,
Cleveland,U.S. Senate,Jim Inhofe,REP,140017,6,1,181,188,
Cleveland,U.S. Senate,Aaron Delozier,IND,140017,0,0,9,9,
Cleveland,U.S. Senate,Ray Woods,IND,140017,0,0,0,0,
Cleveland,U.S. Senate,Joan Farr,IND,140017,0,0,2,2,
Cleveland,U.S. Senate,Connie Johnson,DEM,140017,3,1,48,52,
Cleveland,U.S. Senate,James Lankford,REP,140017,6,1,186,193,
Cleveland,U.S. Senate,Mark Beard,IND,140017,0,0,7,7,
Cleveland,U.S. House,Bert Smith,DEM,140017,3,0,46,49,04
Cleveland,U.S. House,Tom Cole,REP,140017,6,2,183,191,04
Cleveland,U.S. House,Dennis Johnson,IND,140017,0,0,10,10,04
Cleveland,Governor,Joe Dorman,DEM,140018,8,28,364,400,
Cleveland,Governor,Mary Fallin,REP,140018,2,7,156,165,
Cleveland,Governor,Kimberly Willis,IND,140018,0,0,22,22,
Cleveland,Governor,Richard Prawdzienski,IND,140018,0,0,9,9,
Cleveland,Lieutenant Governor,Cathy Cummings,DEM,140018,6,24,324,354,
Cleveland,Lieutenant Governor,Todd Lamb,REP,140018,4,11,223,238,
Cleveland,Superintendent of Public Instruction,John Cox,DEM,140018,6,25,346,377,
Cleveland,Superintendent of Public Instruction,Joy Hofmeister,REP,140018,4,10,195,209,
Cleveland,Commissioner of Labor,Mike Workman,DEM,140018,5,28,339,372,
Cleveland,Commissioner of Labor,Mark Costello,REP,140018,4,7,198,209,
Cleveland,U.S. Senate,Matt Silverstein,DEM,140018,8,24,309,341,
Cleveland,U.S. Senate,Jim Inhofe,REP,140018,2,10,215,227,
Cleveland,U.S. Senate,Aaron Delozier,IND,140018,0,1,5,6,
Cleveland,U.S. Senate,Ray Woods,IND,140018,0,0,8,8,
Cleveland,U.S. Senate,Joan Farr,IND,140018,0,0,11,11,
Cleveland,U.S. Senate,Connie Johnson,DEM,140018,6,27,309,342,
Cleveland,U.S. Senate,James Lankford,REP,140018,4,8,214,226,
Cleveland,U.S. Senate,Mark Beard,IND,140018,0,0,22,22,
Cleveland,U.S. House,Bert Smith,DEM,140018,3,21,271,295,04
Cleveland,U.S. House,Tom Cole,REP,140018,7,10,238,255,04
Cleveland,U.S. House,Dennis Johnson,IND,140018,0,4,36,40,04
Cleveland,Governor,Joe Dorman,DEM,140019,20,56,602,678,
Cleveland,Governor,Mary Fallin,REP,140019,10,30,410,450,
Cleveland,Governor,Kimberly Willis,IND,140019,0,2,25,27,
Cleveland,Governor,Richard Prawdzienski,IND,140019,0,1,9,10,
Cleveland,Lieutenant Governor,Cathy Cummings,DEM,140019,18,50,522,590,
Cleveland,Lieutenant Governor,Todd Lamb,REP,140019,12,39,521,572,
Cleveland,Superintendent of Public Instruction,John Cox,DEM,140019,23,52,584,659,
Cleveland,Superintendent of Public Instruction,Joy Hofmeister,REP,140019,7,36,455,498,
Cleveland,Commissioner of Labor,Mike Workman,DEM,140019,17,47,527,591,
Cleveland,Commissioner of Labor,Mark Costello,REP,140019,11,39,490,540,
Cleveland,U.S. Senate,Matt Silverstein,DEM,140019,17,44,481,542,
Cleveland,U.S. Senate,Jim Inhofe,REP,140019,13,43,517,573,
Cleveland,U.S. Senate,Aaron Delozier,IND,140019,0,0,11,11,
Cleveland,U.S. Senate,Ray Woods,IND,140019,0,0,10,10,
Cleveland,U.S. Senate,Joan Farr,IND,140019,0,1,23,24,
Cleveland,U.S. Senate,Connie Johnson,DEM,140019,17,45,492,554,
Cleveland,U.S. Senate,James Lankford,REP,140019,13,43,522,578,
Cleveland,U.S. Senate,Mark Beard,IND,140019,0,0,33,33,
Cleveland,U.S. House,Bert Smith,DEM,140019,16,38,434,488,04
Cleveland,U.S. House,Tom Cole,REP,140019,14,50,557,621,04
Cleveland,U.S. House,Dennis Johnson,IND,140019,0,0,57,57,04
Cleveland,Governor,Joe Dorman,DEM,140020,30,32,331,393,
Cleveland,Governor,Mary Fallin,REP,140020,51,58,702,811,
Cleveland,Governor,Kimberly Willis,IND,140020,1,1,19,21,
Cleveland,Governor,Richard Prawdzienski,IND,140020,0,0,9,9,
Cleveland,Lieutenant Governor,Cathy Cummings,DEM,140020,30,25,224,279,
Cleveland,Lieutenant Governor,Todd Lamb,REP,140020,52,66,834,952,
Cleveland,Superintendent of Public Instruction,John Cox,DEM,140020,30,33,317,380,
Cleveland,Superintendent of Public Instruction,Joy Hofmeister,REP,140020,47,58,738,843,
Cleveland,Commissioner of Labor,Mike Workman,DEM,140020,30,21,239,290,
Cleveland,Commissioner of Labor,Mark Costello,REP,140020,46,70,799,915,
Cleveland,U.S. Senate,Matt Silverstein,DEM,140020,30,23,206,259,
Cleveland,U.S. Senate,Jim Inhofe,REP,140020,49,65,825,939,
Cleveland,U.S. Senate,Aaron Delozier,IND,140020,0,0,11,11,
Cleveland,U.S. Senate,Ray Woods,IND,140020,1,1,9,11,
Cleveland,U.S. Senate,Joan Farr,IND,140020,2,2,7,11,
Cleveland,U.S. Senate,Connie Johnson,DEM,140020,29,22,200,251,
Cleveland,U.S. Senate,James Lankford,REP,140020,52,68,840,960,
Cleveland,U.S. Senate,Mark Beard,IND,140020,1,1,21,23,
Cleveland,U.S. House,Bert Smith,DEM,140020,26,17,166,209,04
Cleveland,U.S. House,Tom Cole,REP,140020,53,71,869,993,04
Cleveland,U.S. House,Dennis Johnson,IND,140020,3,2,26,31,04
Cleveland,State House,Trey Puckett,DEM,140020,29,18,203,250,91
Cleveland,State House,Chris Kannady,REP,140020,51,72,845,968,91
Cleveland,Governor,Joe Dorman,DEM,140021,5,1,180,186,
Cleveland,Governor,Mary Fallin,REP,140021,12,5,259,276,
Cleveland,Governor,Kimberly Willis,IND,140021,1,0,16,17,
Cleveland,Governor,Richard Prawdzienski,IND,140021,1,0,7,8,
Cleveland,Lieutenant Governor,Cathy Cummings,DEM,140021,5,1,143,149,
Cleveland,Lieutenant Governor,Todd Lamb,REP,140021,14,5,321,340,
Cleveland,Superintendent of Public Instruction,John Cox,DEM,140021,10,1,179,190,
Cleveland,Superintendent of Public Instruction,Joy Hofmeister,REP,140021,8,5,279,292,
Cleveland,Commissioner of Labor,Mike Workman,DEM,140021,9,2,165,176,
Cleveland,Commissioner of Labor,Mark Costello,REP,140021,8,4,286,298,
Cleveland,U.S. Senate,Matt Silverstein,DEM,140021,4,1,117,122,
Cleveland,U.S. Senate,Jim Inhofe,REP,140021,14,5,321,340,
Cleveland,U.S. Senate,Aaron Delozier,IND,140021,0,0,5,5,
Cleveland,U.S. Senate,Ray Woods,IND,140021,0,0,9,9,
Cleveland,U.S. Senate,Joan Farr,IND,140021,1,0,9,10,
Cleveland,U.S. Senate,Connie Johnson,DEM,140021,4,1,131,136,
Cleveland,U.S. Senate,James Lankford,REP,140021,14,5,312,331,
Cleveland,U.S. Senate,Mark Beard,IND,140021,1,0,19,20,
Cleveland,U.S. House,Bert Smith,DEM,140021,3,1,104,108,04
Cleveland,U.S. House,Tom Cole,REP,140021,15,5,329,349,04
Cleveland,U.S. House,Dennis Johnson,IND,140021,1,0,31,32,04
Cleveland,Governor,Joe Dorman,DEM,140022,22,23,402,447,
Cleveland,Governor,Mary Fallin,REP,140022,43,23,625,691,
Cleveland,Governor,Kimberly Willis,IND,140022,1,3,24,28,
Cleveland,Governor,Richard Prawdzienski,IND,140022,1,0,19,20,
Cleveland,Lieutenant Governor,Cathy Cummings,DEM,140022,18,20,283,321,
Cleveland,Lieutenant Governor,Todd Lamb,REP,140022,49,29,778,856,
Cleveland,Superintendent of Public Instruction,John Cox,DEM,140022,25,25,406,456,
Cleveland,Superintendent of Public Instruction,Joy Hofmeister,REP,140022,40,23,649,712,
Cleveland,Commissioner of Labor,Mike Workman,DEM,140022,21,21,323,365,
Cleveland,Commissioner of Labor,Mark Costello,REP,140022,45,26,703,774,
Cleveland,U.S. Senate,Matt Silverstein,DEM,140022,16,17,257,290,
Cleveland,U.S. Senate,Jim Inhofe,REP,140022,46,30,768,844,
Cleveland,U.S. Senate,Aaron Delozier,IND,140022,0,0,11,11,
Cleveland,U.S. Senate,Ray Woods,IND,140022,3,0,16,19,
Cleveland,U.S. Senate,Joan Farr,IND,140022,2,2,14,18,
Cleveland,U.S. Senate,Connie Johnson,DEM,140022,16,17,251,284,
Cleveland,U.S. Senate,James Lankford,REP,140022,47,28,773,848,
Cleveland,U.S. Senate,Mark Beard,IND,140022,4,3,40,47,
Cleveland,U.S. House,Bert Smith,DEM,140022,16,15,225,256,04
Cleveland,U.S. House,Tom Cole,REP,140022,47,32,788,867,04
Cleveland,U.S. House,Dennis Johnson,IND,140022,4,2,48,54,04
Cleveland,Governor,Joe Dorman,DEM,140024,25,39,518,582,
Cleveland,Governor,Mary Fallin,REP,140024,37,42,682,761,
Cleveland,Governor,Kimberly Willis,IND,140024,1,1,34,36,
Cleveland,Governor,Richard Prawdzienski,IND,140024,0,0,14,14,
Cleveland,Lieutenant Governor,Cathy Cummings,DEM,140024,24,39,358,421,
Cleveland,Lieutenant Governor,Todd Lamb,REP,140024,37,43,875,955,
Cleveland,Superintendent of Public Instruction,John Cox,DEM,140024,29,39,526,594,
Cleveland,Superintendent of Public Instruction,Joy Hofmeister,REP,140024,33,43,719,795,
Cleveland,Commissioner of Labor,Mike Workman,DEM,140024,26,40,386,452,
Cleveland,Commissioner of Labor,Mark Costello,REP,140024,34,42,827,903,
Cleveland,U.S. Senate,Matt Silverstein,DEM,140024,22,35,324,381,
Cleveland,U.S. Senate,Jim Inhofe,REP,140024,38,43,869,950,
Cleveland,U.S. Senate,Aaron Delozier,IND,140024,1,1,9,11,
Cleveland,U.S. Senate,Ray Woods,IND,140024,1,0,13,14,
Cleveland,U.S. Senate,Joan Farr,IND,140024,1,1,21,23,
Cleveland,U.S. Senate,Connie Johnson,DEM,140024,25,34,326,385,
Cleveland,U.S. Senate,James Lankford,REP,140024,36,48,884,968,
Cleveland,U.S. Senate,Mark Beard,IND,140024,1,0,36,37,
Cleveland,U.S. House,Bert Smith,DEM,140024,17,27,298,342,04
Cleveland,U.S. House,Tom Cole,REP,140024,45,52,893,990,04
Cleveland,U.S. House,Dennis Johnson,IND,140024,1,3,52,56,04
Cleveland,Governor,Joe Dorman,DEM,140025,3,5,190,198,
Cleveland,Governor,Mary Fallin,REP,140025,7,14,261,282,
Cleveland,Governor,Kimberly Willis,IND,140025,0,1,11,12,
Cleveland,Governor,Richard Prawdzienski,IND,140025,0,1,8,9,
Cleveland,Lieutenant Governor,Cathy Cummings,DEM,140025,3,7,157,167,
Cleveland,Lieutenant Governor,Todd Lamb,REP,140025,7,14,313,334,
Cleveland,Superintendent of Public Instruction,John Cox,DEM,140025,3,7,199,209,
Cleveland,Superintendent of Public Instruction,Joy Hofmeister,REP,140025,6,13,270,289,
Cleveland,Commissioner of Labor,Mike Workman,DEM,140025,2,6,181,189,
Cleveland,Commissioner of Labor,Mark Costello,REP,140025,7,14,283,304,
Cleveland,U.S. Senate,Matt Silverstein,DEM,140025,3,3,138,144,
Cleveland,U.S. Senate,Jim Inhofe,REP,140025,7,15,315,337,
Cleveland,U.S. Senate,Aaron Delozier,IND,140025,0,0,3,3,
Cleveland,U.S. Senate,Ray Woods,IND,140025,0,0,6,6,
Cleveland,U.S. Senate,Joan Farr,IND,140025,0,2,6,8,
Cleveland,U.S. Senate,Connie Johnson,DEM,140025,3,4,141,148,
Cleveland,U.S. Senate,James Lankford,REP,140025,7,16,311,334,
Cleveland,U.S. Senate,Mark Beard,IND,140025,0,1,17,18,
Cleveland,U.S. House,Bert Smith,DEM,140025,4,3,128,135,04
Cleveland,U.S. House,Tom Cole,REP,140025,6,16,311,333,04
Cleveland,U.S. House,Dennis Johnson,IND,140025,0,2,30,32,04
Cleveland,State House,Claudia Griffith,DEM,140025,3,5,181,189,45
Cleveland,State House,Aaron Stiles,REP,140025,7,16,286,309,45
Cleveland,Governor,Joe Dorman,DEM,140026,11,58,464,533,
Cleveland,Governor,Mary Fallin,REP,140026,12,32,355,399,
Cleveland,Governor,Kimberly Willis,IND,140026,0,2,11,13,
Cleveland,Governor,Richard Prawdzienski,IND,140026,0,2,7,9,
Cleveland,Lieutenant Governor,Cathy Cummings,DEM,140026,7,61,400,468,
Cleveland,Lieutenant Governor,Todd Lamb,REP,140026,16,33,437,486,
Cleveland,Superintendent of Public Instruction,John Cox,DEM,140026,9,54,441,504,
Cleveland,Superintendent of Public Instruction,Joy Hofmeister,REP,140026,13,40,391,444,
Cleveland,Commissioner of Labor,Mike Workman,DEM,140026,7,60,404,471,
Cleveland,Commissioner of Labor,Mark Costello,REP,140026,15,33,417,465,
Cleveland,U.S. Senate,Matt Silverstein,DEM,140026,8,55,360,423,
Cleveland,U.S. Senate,Jim Inhofe,REP,140026,15,34,442,491,
Cleveland,U.S. Senate,Aaron Delozier,IND,140026,0,0,11,11,
Cleveland,U.S. Senate,Ray Woods,IND,140026,0,3,8,11,
Cleveland,U.S. Senate,Joan Farr,IND,140026,0,3,16,19,
Cleveland,U.S. Senate,Connie Johnson,DEM,140026,6,52,374,432,
Cleveland,U.S. Senate,James Lankford,REP,140026,16,37,441,494,
Cleveland,U.S. Senate,Mark Beard,IND,140026,0,6,22,28,
Cleveland,U.S. House,Bert Smith,DEM,140026,5,48,330,383,04
Cleveland,U.S. House,Tom Cole,REP,140026,17,40,462,519,04
Cleveland,U.S. House,Dennis Johnson,IND,140026,1,6,41,48,04
Cleveland,State House,Claudia Griffith,DEM,140026,5,56,415,476,45
Cleveland,State House,Aaron Stiles,REP,140026,16,37,415,468,45
Cleveland,Governor,Joe Dorman,DEM,140027,35,53,558,646,
Cleveland,Governor,Mary Fallin,REP,140027,39,73,700,812,
Cleveland,Governor,Kimberly Willis,IND,140027,0,1,19,20,
Cleveland,Governor,Richard Prawdzienski,IND,140027,1,3,11,15,
Cleveland,Lieutenant Governor,Cathy Cummings,DEM,140027,31,45,435,511,
Cleveland,Lieutenant Governor,Todd Lamb,REP,140027,44,85,847,976,
Cleveland,Superintendent of Public Instruction,John Cox,DEM,140027,36,49,538,623,
Cleveland,Superintendent of Public Instruction,Joy Hofmeister,REP,140027,36,78,730,844,
Cleveland,Commissioner of Labor,Mike Workman,DEM,140027,29,49,433,511,
Cleveland,Commissioner of Labor,Mark Costello,REP,140027,40,75,816,931,
Cleveland,U.S. Senate,Matt Silverstein,DEM,140027,28,44,412,484,
Cleveland,U.S. Senate,Jim Inhofe,REP,140027,46,83,835,964,
Cleveland,U.S. Senate,Aaron Delozier,IND,140027,0,0,13,13,
Cleveland,U.S. Senate,Ray Woods,IND,140027,0,0,10,10,
Cleveland,U.S. Senate,Joan Farr,IND,140027,1,3,11,15,
Cleveland,U.S. Senate,Connie Johnson,DEM,140027,28,43,413,484,
Cleveland,U.S. Senate,James Lankford,REP,140027,44,83,836,963,
Cleveland,U.S. Senate,Mark Beard,IND,140027,2,3,29,34,
Cleveland,U.S. House,Bert Smith,DEM,140027,22,28,326,376,04
Cleveland,U.S. House,Tom Cole,REP,140027,48,99,900,1047,04
Cleveland,U.S. House,Dennis Johnson,IND,140027,3,2,46,51,04
Cleveland,State House,Scott Martin,REP,140027,49,94,848,991,46
Cleveland,State House,Scott Brockman,IND,140027,22,35,347,404,46
Cleveland,Governor,Joe Dorman,DEM,140028,14,57,477,548,
Cleveland,Governor,Mary Fallin,REP,140028,9,25,255,289,
Cleveland,Governor,Kimberly Willis,IND,140028,0,1,22,23,
Cleveland,Governor,Richard Prawdzienski,IND,140028,0,0,10,10,
Cleveland,Lieutenant Governor,Cathy Cummings,DEM,140028,14,50,435,499,
Cleveland,Lieutenant Governor,Todd Lamb,REP,140028,9,33,329,371,
Cleveland,Superintendent of Public Instruction,John Cox,DEM,140028,13,49,463,525,
Cleveland,Superintendent of Public Instruction,Joy Hofmeister,REP,140028,10,32,293,335,
Cleveland,Commissioner of Labor,Mike Workman,DEM,140028,11,55,442,508,
Cleveland,Commissioner of Labor,Mark Costello,REP,140028,11,26,306,343,
Cleveland,U.S. Senate,Matt Silverstein,DEM,140028,13,47,393,453,
Cleveland,U.S. Senate,Jim Inhofe,REP,140028,10,29,330,369,
Cleveland,U.S. Senate,Aaron Delozier,IND,140028,0,0,13,13,
Cleveland,U.S. Senate,Ray Woods,IND,140028,0,2,10,12,
Cleveland,U.S. Senate,Joan Farr,IND,140028,0,3,17,20,
Cleveland,U.S. Senate,Connie Johnson,DEM,140028,12,50,412,474,
Cleveland,U.S. Senate,James Lankford,REP,140028,11,29,322,362,
Cleveland,U.S. Senate,Mark Beard,IND,140028,0,3,26,29,
Cleveland,U.S. House,Bert Smith,DEM,140028,11,43,350,404,04
Cleveland,U.S. House,Tom Cole,REP,140028,12,33,370,415,04
Cleveland,U.S. House,Dennis Johnson,IND,140028,0,7,37,44,04
Cleveland,State House,Claudia Griffith,DEM,140028,13,54,445,512,45
Cleveland,State House,Aaron Stiles,REP,140028,10,28,312,350,45
Cleveland,Governor,Joe Dorman,DEM,140029,7,14,317,338,
Cleveland,Governor,Mary Fallin,REP,140029,14,17,474,505,
Cleveland,Governor,Kimberly Willis,IND,140029,0,0,21,21,
Cleveland,Governor,Richard Prawdzienski,IND,140029,0,1,11,12,
Cleveland,Lieutenant Governor,Cathy Cummings,DEM,140029,7,9,227,243,
Cleveland,Lieutenant Governor,Todd Lamb,REP,140029,14,22,586,622,
Cleveland,Superintendent of Public Instruction,John Cox,DEM,140029,7,12,330,349,
Cleveland,Superintendent of Public Instruction,Joy Hofmeister,REP,140029,14,19,488,521,
Cleveland,Commissioner of Labor,Mike Workman,DEM,140029,6,10,284,300,
Cleveland,Commissioner of Labor,Mark Costello,REP,140029,15,20,518,553,
Cleveland,U.S. Senate,Matt Silverstein,DEM,140029,6,8,178,192,
Cleveland,U.S. Senate,Jim Inhofe,REP,140029,15,23,609,647,
Cleveland,U.S. Senate,Aaron Delozier,IND,140029,0,0,9,9,
Cleveland,U.S. Senate,Ray Woods,IND,140029,0,0,13,13,
Cleveland,U.S. Senate,Joan Farr,IND,140029,0,0,9,9,
Cleveland,U.S. Senate,Connie Johnson,DEM,140029,4,9,179,192,
Cleveland,U.S. Senate,James Lankford,REP,140029,17,23,615,655,
Cleveland,U.S. Senate,Mark Beard,IND,140029,0,0,21,21,
Cleveland,U.S. House,Bert Smith,DEM,140029,4,7,158,169,04
Cleveland,U.S. House,Tom Cole,REP,140029,17,24,610,651,04
Cleveland,U.S. House,Dennis Johnson,IND,140029,0,1,44,45,04
Cleveland,State House,Joni Johnson,DEM,140029,5,9,249,263,20
Cleveland,State House,Bobby Cleveland,REP,140029,16,22,561,599,20
Cleveland,Governor,Joe Dorman,DEM,140030,7,28,253,288,
Cleveland,Governor,Mary Fallin,REP,140030,12,23,253,288,
Cleveland,Governor,Kimberly Willis,IND,140030,0,0,13,13,
Cleveland,Governor,Richard Prawdzienski,IND,140030,0,0,8,8,
Cleveland,Lieutenant Governor,Cathy Cummings,DEM,140030,7,28,214,249,
Cleveland,Lieutenant Governor,Todd Lamb,REP,140030,12,22,308,342,
Cleveland,Superintendent of Public Instruction,John Cox,DEM,140030,10,30,242,282,
Cleveland,Superintendent of Public Instruction,Joy Hofmeister,REP,140030,9,20,280,309,
Cleveland,Commissioner of Labor,Mike Workman,DEM,140030,7,24,220,251,
Cleveland,Commissioner of Labor,Mark Costello,REP,140030,12,26,292,330,
Cleveland,U.S. Senate,Matt Silverstein,DEM,140030,7,25,191,223,
Cleveland,U.S. Senate,Jim Inhofe,REP,140030,12,22,314,348,
Cleveland,U.S. Senate,Aaron Delozier,IND,140030,0,0,4,4,
Cleveland,U.S. Senate,Ray Woods,IND,140030,0,1,5,6,
Cleveland,U.S. Senate,Joan Farr,IND,140030,0,1,10,11,
Cleveland,U.S. Senate,Connie Johnson,DEM,140030,6,24,198,228,
Cleveland,U.S. Senate,James Lankford,REP,140030,12,24,308,344,
Cleveland,U.S. Senate,Mark Beard,IND,140030,1,2,16,19,
Cleveland,U.S. House,Bert Smith,DEM,140030,7,21,170,198,04
Cleveland,U.S. House,Tom Cole,REP,140030,12,27,331,370,04
Cleveland,U.S. House,Dennis Johnson,IND,140030,0,3,22,25,04
Cleveland,State House,Claudia Griffith,DEM,140030,11,30,236,277,45
Cleveland,State House,Aaron Stiles,REP,140030,7,21,284,312,45
Cleveland,Governor,Joe Dorman,DEM,140032,12,38,484,534,
Cleveland,Governor,Mary Fallin,REP,140032,12,14,188,214,
Cleveland,Governor,Kimberly Willis,IND,140032,0,4,10,14,
Cleveland,Governor,Richard Prawdzienski,IND,140032,0,2,13,15,
Cleveland,Lieutenant Governor,Cathy Cummings,DEM,140032,11,39,424,474,
Cleveland,Lieutenant Governor,Todd Lamb,REP,140032,13,18,269,300,
Cleveland,Superintendent of Public Instruction,John Cox,DEM,140032,11,40,445,496,
Cleveland,Superintendent of Public Instruction,Joy Hofmeister,REP,140032,13,16,248,277,
Cleveland,Commissioner of Labor,Mike Workman,DEM,140032,13,39,427,479,
Cleveland,Commissioner of Labor,Mark Costello,REP,140032,11,15,255,281,
Cleveland,U.S. Senate,Matt Silverstein,DEM,140032,9,37,356,402,
Cleveland,U.S. Senate,Jim Inhofe,REP,140032,15,17,280,312,
Cleveland,U.S. Senate,Aaron Delozier,IND,140032,0,1,9,10,
Cleveland,U.S. Senate,Ray Woods,IND,140032,0,0,16,16,
Cleveland,U.S. Senate,Joan Farr,IND,140032,0,2,30,32,
Cleveland,U.S. Senate,Connie Johnson,DEM,140032,10,37,389,436,
Cleveland,U.S. Senate,James Lankford,REP,140032,14,16,278,308,
Cleveland,U.S. Senate,Mark Beard,IND,140032,0,4,25,29,
Cleveland,U.S. House,Bert Smith,DEM,140032,9,34,345,388,04
Cleveland,U.S. House,Tom Cole,REP,140032,15,20,299,334,04
Cleveland,U.S. House,Dennis Johnson,IND,140032,0,3,44,47,04
Cleveland,State House,Claudia Griffith,DEM,140032,14,42,421,477,45
Cleveland,State House,Aaron Stiles,REP,140032,10,14,268,292,45
Cleveland,Governor,Joe Dorman,DEM,140034,11,6,390,407,
Cleveland,Governor,Mary Fallin,REP,140034,11,7,560,578,
Cleveland,Governor,Kimberly Willis,IND,140034,0,1,26,27,
Cleveland,Governor,Richard Prawdzienski,IND,140034,0,0,17,17,
Cleveland,Lieutenant Governor,Cathy Cummings,DEM,140034,9,4,273,286,
Cleveland,Lieutenant Governor,Todd Lamb,REP,140034,12,9,717,738,
Cleveland,Superintendent of Public Instruction,John Cox,DEM,140034,13,6,441,460,
Cleveland,Superintendent of Public Instruction,Joy Hofmeister,REP,140034,9,8,547,564,
Cleveland,Commissioner of Labor,Mike Workman,DEM,140034,11,4,370,385,
Cleveland,Commissioner of Labor,Mark Costello,REP,140034,11,8,603,622,
Cleveland,U.S. Senate,Matt Silverstein,DEM,140034,11,2,232,245,
Cleveland,U.S. Senate,Jim Inhofe,REP,140034,10,11,717,738,
Cleveland,U.S. Senate,Aaron Delozier,IND,140034,0,0,10,10,
Cleveland,U.S. Senate,Ray Woods,IND,140034,0,0,15,15,
Cleveland,U.S. Senate,Joan Farr,IND,140034,1,1,17,19,
Cleveland,U.S. Senate,Connie Johnson,DEM,140034,9,4,228,241,
Cleveland,U.S. Senate,James Lankford,REP,140034,11,9,730,750,
Cleveland,U.S. Senate,Mark Beard,IND,140034,1,0,36,37,
Cleveland,U.S. House,Bert Smith,DEM,140034,7,2,204,213,04
Cleveland,U.S. House,Tom Cole,REP,140034,15,11,743,769,04
Cleveland,U.S. House,Dennis Johnson,IND,140034,0,1,48,49,04
Cleveland,State House,Joni Johnson,DEM,140034,11,5,305,321,20
Cleveland,State House,Bobby Cleveland,REP,140034,11,9,690,710,20
Cleveland,Governor,Joe Dorman,DEM,140035,14,24,313,351,
Cleveland,Governor,Mary Fallin,REP,140035,17,19,294,330,
Cleveland,Governor,Kimberly Willis,IND,140035,0,0,14,14,
Cleveland,Governor,Richard Prawdzienski,IND,140035,0,0,5,5,
Cleveland,Lieutenant Governor,Cathy Cummings,DEM,140035,12,16,251,279,
Cleveland,Lieutenant Governor,Todd Lamb,REP,140035,18,27,374,419,
Cleveland,Superintendent of Public Instruction,John Cox,DEM,140035,15,17,306,338,
Cleveland,Superintendent of Public Instruction,Joy Hofmeister,REP,140035,16,26,315,357,
Cleveland,Commissioner of Labor,Mike Workman,DEM,140035,13,19,254,286,
Cleveland,Commissioner of Labor,Mark Costello,REP,140035,18,24,354,396,
Cleveland,U.S. Senate,Matt Silverstein,DEM,140035,14,20,234,268,
Cleveland,U.S. Senate,Jim Inhofe,REP,140035,17,23,365,405,
Cleveland,U.S. Senate,Aaron Delozier,IND,140035,0,0,3,3,
Cleveland,U.S. Senate,Ray Woods,IND,140035,0,0,4,4,
Cleveland,U.S. Senate,Joan Farr,IND,140035,0,0,14,14,
Cleveland,U.S. Senate,Connie Johnson,DEM,140035,13,17,227,257,
Cleveland,U.S. Senate,James Lankford,REP,140035,18,26,380,424,
Cleveland,U.S. Senate,Mark Beard,IND,140035,0,0,17,17,
Cleveland,U.S. House,Bert Smith,DEM,140035,8,13,195,216,04
Cleveland,U.S. House,Tom Cole,REP,140035,23,29,396,448,04
Cleveland,U.S. House,Dennis Johnson,IND,140035,0,1,32,33,04
Cleveland,State House,Scott Martin,REP,140035,21,27,376,424,46
Cleveland,State House,Scott Brockman,IND,140035,4,12,202,218,46
Cleveland,Governor,Joe Dorman,DEM,140036,3,6,153,162,
Cleveland,Governor,Mary Fallin,REP,140036,13,30,359,402,
Cleveland,Governor,Kimberly Willis,IND,140036,0,1,13,14,
Cleveland,Governor,Richard Prawdzienski,IND,140036,0,0,4,4,
Cleveland,Lieutenant Governor,Cathy Cummings,DEM,140036,3,5,130,138,
Cleveland,Lieutenant Governor,Todd Lamb,REP,140036,13,32,399,444,
Cleveland,Superintendent of Public Instruction,John Cox,DEM,140036,5,6,179,190,
Cleveland,Superintendent of Public Instruction,Joy Hofmeister,REP,140036,12,31,347,390,
Cleveland,Commissioner of Labor,Mike Workman,DEM,140036,4,5,154,163,
Cleveland,Commissioner of Labor,Mark Costello,REP,140036,13,30,369,412,
Cleveland,U.S. Senate,Matt Silverstein,DEM,140036,3,4,109,116,
Cleveland,U.S. Senate,Jim Inhofe,REP,140036,12,32,399,443,
Cleveland,U.S. Senate,Aaron Delozier,IND,140036,0,0,7,7,
Cleveland,U.S. Senate,Ray Woods,IND,140036,0,1,5,6,
Cleveland,U.S. Senate,Joan Farr,IND,140036,2,0,9,11,
Cleveland,U.S. Senate,Connie Johnson,DEM,140036,3,3,111,117,
Cleveland,U.S. Senate,James Lankford,REP,140036,14,31,394,439,
Cleveland,U.S. Senate,Mark Beard,IND,140036,0,3,24,27,
Cleveland,U.S. House,Bert Smith,DEM,140036,4,3,104,111,04
Cleveland,U.S. House,Tom Cole,REP,140036,13,33,389,435,04
Cleveland,U.S. House,Dennis Johnson,IND,140036,0,1,34,35,04
Cleveland,Governor,Joe Dorman,DEM,140037,3,5,200,208,
Cleveland,Governor,Mary Fallin,REP,140037,11,7,271,289,
Cleveland,Governor,Kimberly Willis,IND,140037,0,0,16,16,
Cleveland,Governor,Richard Prawdzienski,IND,140037,0,0,6,6,
Cleveland,Lieutenant Governor,Cathy Cummings,DEM,140037,2,2,154,158,
Cleveland,Lieutenant Governor,Todd Lamb,REP,140037,12,10,337,359,
Cleveland,Superintendent of Public Instruction,John Cox,DEM,140037,6,3,188,197,
Cleveland,Superintendent of Public Instruction,Joy Hofmeister,REP,140037,8,9,304,321,
Cleveland,Commissioner of Labor,Mike Workman,DEM,140037,3,3,173,179,
Cleveland,Commissioner of Labor,Mark Costello,REP,140037,11,9,315,335,
Cleveland,U.S. Senate,Matt Silverstein,DEM,140037,2,2,137,141,
Cleveland,U.S. Senate,Jim Inhofe,REP,140037,12,10,334,356,
Cleveland,U.S. Senate,Aaron Delozier,IND,140037,0,0,6,6,
Cleveland,U.S. Senate,Ray Woods,IND,140037,0,0,8,8,
Cleveland,U.S. Senate,Joan Farr,IND,140037,0,0,6,6,
Cleveland,U.S. Senate,Connie Johnson,DEM,140037,2,2,138,142,
Cleveland,U.S. Senate,James Lankford,REP,140037,9,10,340,359,
Cleveland,U.S. Senate,Mark Beard,IND,140037,3,0,16,19,
Cleveland,U.S. House,Bert Smith,DEM,140037,2,3,126,131,04
Cleveland,U.S. House,Tom Cole,REP,140037,11,9,349,369,04
Cleveland,U.S. House,Dennis Johnson,IND,140037,1,0,18,19,04
Cleveland,Governor,Joe Dorman,DEM,140038,4,7,214,225,
Cleveland,Governor,Mary Fallin,REP,140038,10,8,283,301,
Cleveland,Governor,Kimberly Willis,IND,140038,0,1,17,18,
Cleveland,Governor,Richard Prawdzienski,IND,140038,0,0,6,6,
Cleveland,Lieutenant Governor,Cathy Cummings,DEM,140038,3,7,170,180,
Cleveland,Lieutenant Governor,Todd Lamb,REP,140038,11,9,350,370,
Cleveland,Superintendent of Public Instruction,John Cox,DEM,140038,6,7,215,228,
Cleveland,Superintendent of Public Instruction,Joy Hofmeister,REP,140038,8,9,303,320,
Cleveland,Commissioner of Labor,Mike Workman,DEM,140038,4,8,208,220,
Cleveland,Commissioner of Labor,Mark Costello,REP,140038,10,8,308,326,
Cleveland,U.S. Senate,Matt Silverstein,DEM,140038,4,6,155,165,
Cleveland,U.S. Senate,Jim Inhofe,REP,140038,9,9,340,358,
Cleveland,U.S. Senate,Aaron Delozier,IND,140038,0,0,5,5,
Cleveland,U.S. Senate,Ray Woods,IND,140038,0,1,10,11,
Cleveland,U.S. Senate,Joan Farr,IND,140038,0,0,10,10,
Cleveland,U.S. Senate,Connie Johnson,DEM,140038,3,7,160,170,
Cleveland,U.S. Senate,James Lankford,REP,140038,11,9,336,356,
Cleveland,U.S. Senate,Mark Beard,IND,140038,0,0,25,25,
Cleveland,U.S. House,Bert Smith,DEM,140038,2,7,142,151,04
Cleveland,U.S. House,Tom Cole,REP,140038,11,9,340,360,04
Cleveland,U.S. House,Dennis Johnson,IND,140038,1,0,36,37,04
Cleveland,State House,Joni Johnson,DEM,140038,4,8,180,192,20
Cleveland,State House,Bobby Cleveland,REP,140038,10,8,335,353,20
Cleveland,Governor,Joe Dorman,DEM,140039,11,30,382,423,
Cleveland,Governor,Mary Fallin,REP,140039,13,27,268,308,
Cleveland,Governor,Kimberly Willis,IND,140039,2,2,12,16,
Cleveland,Governor,Richard Prawdzienski,IND,140039,1,1,7,9,
Cleveland,Lieutenant Governor,Cathy Cummings,DEM,140039,10,24,306,340,
Cleveland,Lieutenant Governor,Todd Lamb,REP,140039,19,36,356,411,
Cleveland,Superintendent of Public Instruction,John Cox,DEM,140039,13,32,353,398,
Cleveland,Superintendent of Public Instruction,Joy Hofmeister,REP,140039,16,28,306,350,
Cleveland,Commissioner of Labor,Mike Workman,DEM,140039,13,29,322,364,
Cleveland,Commissioner of Labor,Mark Costello,REP,140039,15,31,329,375,
Cleveland,U.S. Senate,Matt Silverstein,DEM,140039,5,24,292,321,
Cleveland,U.S. Senate,Jim Inhofe,REP,140039,22,35,350,407,
Cleveland,U.S. Senate,Aaron Delozier,IND,140039,2,0,10,12,
Cleveland,U.S. Senate,Ray Woods,IND,140039,0,0,7,7,
Cleveland,U.S. Senate,Joan Farr,IND,140039,0,1,8,9,
Cleveland,U.S. Senate,Connie Johnson,DEM,140039,9,25,275,309,
Cleveland,U.S. Senate,James Lankford,REP,140039,18,35,360,413,
Cleveland,U.S. Senate,Mark Beard,IND,140039,2,0,33,35,
Cleveland,U.S. House,Bert Smith,DEM,140039,3,22,238,263,04
Cleveland,U.S. House,Tom Cole,REP,140039,23,36,393,452,04
Cleveland,U.S. House,Dennis Johnson,IND,140039,3,1,36,40,04
Cleveland,State House,Scott Martin,REP,140039,17,31,377,425,46
Cleveland,State House,Scott Brockman,IND,140039,10,21,225,256,46
Cleveland,Governor,Joe Dorman,DEM,140040,8,11,262,281,
Cleveland,Governor,Mary Fallin,REP,140040,23,16,436,475,
Cleveland,Governor,Kimberly Willis,IND,140040,0,0,21,21,
Cleveland,Governor,Richard Prawdzienski,IND,140040,0,0,7,7,
Cleveland,Lieutenant Governor,Cathy Cummings,DEM,140040,6,8,212,226,
Cleveland,Lieutenant Governor,Todd Lamb,REP,140040,24,19,510,553,
Cleveland,Superintendent of Public Instruction,John Cox,DEM,140040,11,9,259,279,
Cleveland,Superintendent of Public Instruction,Joy Hofmeister,REP,140040,20,17,458,495,
Cleveland,Commissioner of Labor,Mike Workman,DEM,140040,8,8,226,242,
Cleveland,Commissioner of Labor,Mark Costello,REP,140040,22,17,481,520,
Cleveland,U.S. Senate,Matt Silverstein,DEM,140040,9,8,189,206,
Cleveland,U.S. Senate,Jim Inhofe,REP,140040,22,18,502,542,
Cleveland,U.S. Senate,Aaron Delozier,IND,140040,0,0,4,4,
Cleveland,U.S. Senate,Ray Woods,IND,140040,0,0,18,18,
Cleveland,U.S. Senate,Joan Farr,IND,140040,0,1,9,10,
Cleveland,U.S. Senate,Connie Johnson,DEM,140040,7,8,189,204,
Cleveland,U.S. Senate,James Lankford,REP,140040,24,19,512,555,
Cleveland,U.S. Senate,Mark Beard,IND,140040,0,0,25,25,
Cleveland,U.S. House,Bert Smith,DEM,140040,6,5,174,185,04
Cleveland,U.S. House,Tom Cole,REP,140040,25,21,512,558,04
Cleveland,U.S. House,Dennis Johnson,IND,140040,0,1,33,34,04
Cleveland,State House,Trey Puckett,DEM,140040,8,7,183,198,91
Cleveland,State House,Chris Kannady,REP,140040,22,18,532,572,91
Cleveland,Governor,Joe Dorman,DEM,140041,1,3,93,97,
Cleveland,Governor,Mary Fallin,REP,140041,5,13,170,188,
Cleveland,Governor,Kimberly Willis,IND,140041,0,1,9,10,
Cleveland,Governor,Richard Prawdzienski,IND,140041,0,0,5,5,
Cleveland,Lieutenant Governor,Cathy Cummings,DEM,140041,1,2,72,75,
Cleveland,Lieutenant Governor,Todd Lamb,REP,140041,4,15,203,222,
Cleveland,Superintendent of Public Instruction,John Cox,DEM,140041,2,2,104,108,
Cleveland,Superintendent of Public Instruction,Joy Hofmeister,REP,140041,4,15,163,182,
Cleveland,Commissioner of Labor,Mike Workman,DEM,140041,2,2,77,81,
Cleveland,Commissioner of Labor,Mark Costello,REP,140041,3,15,186,204,
Cleveland,U.S. Senate,Matt Silverstein,DEM,140041,1,2,65,68,
Cleveland,U.S. Senate,Jim Inhofe,REP,140041,4,15,204,223,
Cleveland,U.S. Senate,Aaron Delozier,IND,140041,0,0,0,0,
Cleveland,U.S. Senate,Ray Woods,IND,140041,0,0,2,2,
Cleveland,U.S. Senate,Joan Farr,IND,140041,0,0,3,3,
Cleveland,U.S. Senate,Connie Johnson,DEM,140041,1,2,68,71,
Cleveland,U.S. Senate,James Lankford,REP,140041,5,15,205,225,
Cleveland,U.S. Senate,Mark Beard,IND,140041,0,0,3,3,
Cleveland,U.S. House,Bert Smith,DEM,140041,1,2,62,65,04
Cleveland,U.S. House,Tom Cole,REP,140041,4,14,200,218,04
Cleveland,U.S. House,Dennis Johnson,IND,140041,0,1,8,9,04
Cleveland,State House,Trey Puckett,DEM,140041,1,2,72,75,91
Cleveland,State House,Chris Kannady,REP,140041,4,14,196,214,91
Cleveland,Governor,Joe Dorman,DEM,140042,12,19,371,402,
Cleveland,Governor,Mary Fallin,REP,140042,13,16,154,183,
Cleveland,Governor,Kimberly Willis,IND,140042,0,0,10,10,
Cleveland,Governor,Richard Prawdzienski,IND,140042,0,0,3,3,
Cleveland,Lieutenant Governor,Cathy Cummings,DEM,140042,12,12,335,359,
Cleveland,Lieutenant Governor,Todd Lamb,REP,140042,13,21,201,235,
Cleveland,Superintendent of Public Instruction,John Cox,DEM,140042,13,12,335,360,
Cleveland,Superintendent of Public Instruction,Joy Hofmeister,REP,140042,11,21,199,231,
Cleveland,Commissioner of Labor,Mike Workman,DEM,140042,12,13,328,353,
Cleveland,Commissioner of Labor,Mark Costello,REP,140042,13,18,191,222,
Cleveland,U.S. Senate,Matt Silverstein,DEM,140042,12,13,314,339,
Cleveland,U.S. Senate,Jim Inhofe,REP,140042,13,19,193,225,
Cleveland,U.S. Senate,Aaron Delozier,IND,140042,0,0,6,6,
Cleveland,U.S. Senate,Ray Woods,IND,140042,0,1,9,10,
Cleveland,U.S. Senate,Joan Farr,IND,140042,0,0,10,10,
Cleveland,U.S. Senate,Connie Johnson,DEM,140042,12,16,323,351,
Cleveland,U.S. Senate,James Lankford,REP,140042,13,17,201,231,
Cleveland,U.S. Senate,Mark Beard,IND,140042,0,1,12,13,
Cleveland,U.S. House,Bert Smith,DEM,140042,8,9,257,274,04
Cleveland,U.S. House,Tom Cole,REP,140042,15,23,264,302,04
Cleveland,U.S. House,Dennis Johnson,IND,140042,2,2,13,17,04
Cleveland,Governor,Joe Dorman,DEM,140043,7,24,398,429,
Cleveland,Governor,Mary Fallin,REP,140043,16,20,459,495,
Cleveland,Governor,Kimberly Willis,IND,140043,0,2,11,13,
Cleveland,Governor,Richard Prawdzienski,IND,140043,0,0,5,5,
Cleveland,Lieutenant Governor,Cathy Cummings,DEM,140043,7,23,263,293,
Cleveland,Lieutenant Governor,Todd Lamb,REP,140043,16,23,605,644,
Cleveland,Superintendent of Public Instruction,John Cox,DEM,140043,7,23,367,397,
Cleveland,Superintendent of Public Instruction,Joy Hofmeister,REP,140043,15,23,505,543,
Cleveland,Commissioner of Labor,Mike Workman,DEM,140043,5,24,266,295,
Cleveland,Commissioner of Labor,Mark Costello,REP,140043,18,22,583,623,
Cleveland,U.S. Senate,Matt Silverstein,DEM,140043,6,23,231,260,
Cleveland,U.S. Senate,Jim Inhofe,REP,140043,15,22,613,650,
Cleveland,U.S. Senate,Aaron Delozier,IND,140043,0,0,10,10,
Cleveland,U.S. Senate,Ray Woods,IND,140043,1,1,6,8,
Cleveland,U.S. Senate,Joan Farr,IND,140043,0,0,9,9,
Cleveland,U.S. Senate,Connie Johnson,DEM,140043,5,19,226,250,
Cleveland,U.S. Senate,James Lankford,REP,140043,17,25,614,656,
Cleveland,U.S. Senate,Mark Beard,IND,140043,1,2,28,31,
Cleveland,U.S. House,Bert Smith,DEM,140043,5,17,211,233,04
Cleveland,U.S. House,Tom Cole,REP,140043,17,25,627,669,04
Cleveland,U.S. House,Dennis Johnson,IND,140043,1,3,29,33,04
Cleveland,Governor,Joe Dorman,DEM,140044,11,15,365,391,
Cleveland,Governor,Mary Fallin,REP,140044,20,19,507,546,
Cleveland,Governor,Kimberly Willis,IND,140044,0,0,22,22,
Cleveland,Governor,Richard Prawdzienski,IND,140044,0,0,13,13,
Cleveland,Lieutenant Governor,Cathy Cummings,DEM,140044,11,12,280,303,
Cleveland,Lieutenant Governor,Todd Lamb,REP,140044,20,22,621,663,
Cleveland,Superintendent of Public Instruction,John Cox,DEM,140044,11,16,359,386,
Cleveland,Superintendent of Public Instruction,Joy Hofmeister,REP,140044,20,18,541,579,
Cleveland,Commissioner of Labor,Mike Workman,DEM,140044,13,15,299,327,
Cleveland,Commissioner of Labor,Mark Costello,REP,140044,17,19,588,624,
Cleveland,U.S. Senate,Matt Silverstein,DEM,140044,10,12,245,267,
Cleveland,U.S. Senate,Jim Inhofe,REP,140044,21,21,606,648,
Cleveland,U.S. Senate,Aaron Delozier,IND,140044,0,0,15,15,
Cleveland,U.S. Senate,Ray Woods,IND,140044,0,0,12,12,
Cleveland,U.S. Senate,Joan Farr,IND,140044,0,1,18,19,
Cleveland,U.S. Senate,Connie Johnson,DEM,140044,11,12,251,274,
Cleveland,U.S. Senate,James Lankford,REP,140044,20,22,621,663,
Cleveland,U.S. Senate,Mark Beard,IND,140044,0,0,32,32,
Cleveland,U.S. House,Bert Smith,DEM,140044,9,10,217,236,04
Cleveland,U.S. House,Tom Cole,REP,140044,22,21,643,686,04
Cleveland,U.S. House,Dennis Johnson,IND,140044,0,3,41,44,04
Cleveland,Governor,Joe Dorman,DEM,140045,0,14,136,150,
Cleveland,Governor,Mary Fallin,REP,140045,2,8,190,200,
Cleveland,Governor,Kimberly Willis,IND,140045,0,1,14,15,
Cleveland,Governor,Richard Prawdzienski,IND,140045,0,0,7,7,
Cleveland,Lieutenant Governor,Cathy Cummings,DEM,140045,1,12,125,138,
Cleveland,Lieutenant Governor,Todd Lamb,REP,140045,1,11,223,235,
Cleveland,Superintendent of Public Instruction,John Cox,DEM,140045,0,14,152,166,
Cleveland,Superintendent of Public Instruction,Joy Hofmeister,REP,140045,2,9,194,205,
Cleveland,Commissioner of Labor,Mike Workman,DEM,140045,1,11,120,132,
Cleveland,Commissioner of Labor,Mark Costello,REP,140045,1,10,218,229,
Cleveland,U.S. Senate,Matt Silverstein,DEM,140045,0,11,106,117,
Cleveland,U.S. Senate,Jim Inhofe,REP,140045,2,11,226,239,
Cleveland,U.S. Senate,Aaron Delozier,IND,140045,0,0,2,2,
Cleveland,U.S. Senate,Ray Woods,IND,140045,0,0,10,10,
Cleveland,U.S. Senate,Joan Farr,IND,140045,0,0,3,3,
Cleveland,U.S. Senate,Connie Johnson,DEM,140045,0,11,105,116,
Cleveland,U.S. Senate,James Lankford,REP,140045,2,12,223,237,
Cleveland,U.S. Senate,Mark Beard,IND,140045,0,0,18,18,
Cleveland,U.S. House,Bert Smith,DEM,140045,0,11,96,107,04
Cleveland,U.S. House,Tom Cole,REP,140045,2,11,229,242,04
Cleveland,U.S. House,Dennis Johnson,IND,140045,0,1,21,22,04
Cleveland,State House,Joni Johnson,DEM,140045,0,11,119,130,20
Cleveland,State House,Bobby Cleveland,REP,140045,1,11,224,236,20
Cleveland,Governor,Joe Dorman,DEM,140047,8,9,267,284,
Cleveland,Governor,Mary Fallin,REP,140047,10,8,360,378,
Cleveland,Governor,Kimberly Willis,IND,140047,0,0,32,32,
Cleveland,Governor,Richard Prawdzienski,IND,140047,2,0,16,18,
Cleveland,Lieutenant Governor,Cathy Cummings,DEM,140047,11,6,218,235,
Cleveland,Lieutenant Governor,Todd Lamb,REP,140047,9,11,451,471,
Cleveland,Superintendent of Public Instruction,John Cox,DEM,140047,11,7,302,320,
Cleveland,Superintendent of Public Instruction,Joy Hofmeister,REP,140047,8,10,370,388,
Cleveland,Commissioner of Labor,Mike Workman,DEM,140047,7,7,240,254,
Cleveland,Commissioner of Labor,Mark Costello,REP,140047,12,8,415,435,
Cleveland,U.S. Senate,Matt Silverstein,DEM,140047,8,6,176,190,
Cleveland,U.S. Senate,Jim Inhofe,REP,140047,10,10,448,468,
Cleveland,U.S. Senate,Aaron Delozier,IND,140047,1,0,9,10,
Cleveland,U.S. Senate,Ray Woods,IND,140047,1,0,11,12,
Cleveland,U.S. Senate,Joan Farr,IND,140047,0,0,22,22,
Cleveland,U.S. Senate,Connie Johnson,DEM,140047,7,4,202,213,
Cleveland,U.S. Senate,James Lankford,REP,140047,11,12,440,463,
Cleveland,U.S. Senate,Mark Beard,IND,140047,2,0,32,34,
Cleveland,U.S. House,Bert Smith,DEM,140047,6,6,157,169,04
Cleveland,U.S. House,Tom Cole,REP,140047,12,10,468,490,04
Cleveland,U.S. House,Dennis Johnson,IND,140047,2,0,45,47,04
Cleveland,Governor,Joe Dorman,DEM,140048,2,2,169,173,
Cleveland,Governor,Mary Fallin,REP,140048,3,10,228,241,
Cleveland,Governor,Kimberly Willis,IND,140048,1,0,11,12,
Cleveland,Governor,Richard Prawdzienski,IND,140048,0,0,8,8,
Cleveland,Lieutenant Governor,Cathy Cummings,DEM,140048,2,3,127,132,
Cleveland,Lieutenant Governor,Todd Lamb,REP,140048,4,9,288,301,
Cleveland,Superintendent of Public Instruction,John Cox,DEM,140048,3,4,173,180,
Cleveland,Superintendent of Public Instruction,Joy Hofmeister,REP,140048,3,8,239,250,
Cleveland,Commissioner of Labor,Mike Workman,DEM,140048,2,4,138,144,
Cleveland,Commissioner of Labor,Mark Costello,REP,140048,4,7,266,277,
Cleveland,U.S. Senate,Matt Silverstein,DEM,140048,3,1,107,111,
Cleveland,U.S. Senate,Jim Inhofe,REP,140048,3,10,292,305,
Cleveland,U.S. Senate,Aaron Delozier,IND,140048,0,0,3,3,
Cleveland,U.S. Senate,Ray Woods,IND,140048,0,0,5,5,
Cleveland,U.S. Senate,Joan Farr,IND,140048,0,1,9,10,
Cleveland,U.S. Senate,Connie Johnson,DEM,140048,2,2,113,117,
Cleveland,U.S. Senate,James Lankford,REP,140048,3,10,291,304,
Cleveland,U.S. Senate,Mark Beard,IND,140048,1,0,13,14,
Cleveland,U.S. House,Bert Smith,DEM,140048,1,2,94,97,04
Cleveland,U.S. House,Tom Cole,REP,140048,4,10,299,313,04
Cleveland,U.S. House,Dennis Johnson,IND,140048,1,0,21,22,04
Cleveland,Governor,Joe Dorman,DEM,140049,5,2,176,183,
Cleveland,Governor,Mary Fallin,REP,140049,9,4,200,213,
Cleveland,Governor,Kimberly Willis,IND,140049,0,0,12,12,
Cleveland,Governor,Richard Prawdzienski,IND,140049,0,0,6,6,
Cleveland,Lieutenant Governor,Cathy Cummings,DEM,140049,3,1,130,134,
Cleveland,Lieutenant Governor,Todd Lamb,REP,140049,11,5,261,277,
Cleveland,Superintendent of Public Instruction,John Cox,DEM,140049,4,1,177,182,
Cleveland,Superintendent of Public Instruction,Joy Hofmeister,REP,140049,10,5,216,231,
Cleveland,Commissioner of Labor,Mike Workman,DEM,140049,4,1,153,158,
Cleveland,Commissioner of Labor,Mark Costello,REP,140049,10,5,230,245,
Cleveland,U.S. Senate,Matt Silverstein,DEM,140049,3,1,115,119,
Cleveland,U.S. Senate,Jim Inhofe,REP,140049,11,5,253,269,
Cleveland,U.S. Senate,Aaron Delozier,IND,140049,0,0,5,5,
Cleveland,U.S. Senate,Ray Woods,IND,140049,0,0,8,8,
Cleveland,U.S. Senate,Joan Farr,IND,140049,0,0,10,10,
Cleveland,U.S. Senate,Connie Johnson,DEM,140049,2,1,119,122,
Cleveland,U.S. Senate,James Lankford,REP,140049,12,5,251,268,
Cleveland,U.S. Senate,Mark Beard,IND,140049,0,0,24,24,
Cleveland,U.S. House,Bert Smith,DEM,140049,3,1,100,104,04
Cleveland,U.S. House,Tom Cole,REP,140049,10,5,268,283,04
Cleveland,U.S. House,Dennis Johnson,IND,140049,1,0,22,23,04
Cleveland,Governor,Joe Dorman,DEM,140050,14,12,375,401,
Cleveland,Governor,Mary Fallin,REP,140050,27,19,554,600,
Cleveland,Governor,Kimberly Willis,IND,140050,1,0,21,22,
Cleveland,Governor,Richard Prawdzienski,IND,140050,0,0,8,8,
Cleveland,Lieutenant Governor,Cathy Cummings,DEM,140050,13,9,303,325,
Cleveland,Lieutenant Governor,Todd Lamb,REP,140050,29,22,651,702,
Cleveland,Superintendent of Public Instruction,John Cox,DEM,140050,19,8,401,428,
Cleveland,Superintendent of Public Instruction,Joy Hofmeister,REP,140050,23,23,547,593,
Cleveland,Commissioner of Labor,Mike Workman,DEM,140050,16,10,334,360,
Cleveland,Commissioner of Labor,Mark Costello,REP,140050,26,21,602,649,
Cleveland,U.S. Senate,Matt Silverstein,DEM,140050,13,7,271,291,
Cleveland,U.S. Senate,Jim Inhofe,REP,140050,27,24,644,695,
Cleveland,U.S. Senate,Aaron Delozier,IND,140050,1,0,12,13,
Cleveland,U.S. Senate,Ray Woods,IND,140050,0,0,12,12,
Cleveland,U.S. Senate,Joan Farr,IND,140050,2,0,16,18,
Cleveland,U.S. Senate,Connie Johnson,DEM,140050,10,7,261,278,
Cleveland,U.S. Senate,James Lankford,REP,140050,32,24,648,704,
Cleveland,U.S. Senate,Mark Beard,IND,140050,1,0,45,46,
Cleveland,U.S. House,Bert Smith,DEM,140050,11,7,247,265,04
Cleveland,U.S. House,Tom Cole,REP,140050,32,22,658,712,04
Cleveland,U.S. House,Dennis Johnson,IND,140050,0,2,48,50,04
Cleveland,State House,Trey Puckett,DEM,140050,11,9,277,297,91
Cleveland,State House,Chris Kannady,REP,140050,31,22,665,718,91
Cleveland,Governor,Joe Dorman,DEM,140051,7,17,254,278,
Cleveland,Governor,Mary Fallin,REP,140051,13,10,155,178,
Cleveland,Governor,Kimberly Willis,IND,140051,0,0,9,9,
Cleveland,Governor,Richard Prawdzienski,IND,140051,0,0,3,3,
Cleveland,Lieutenant Governor,Cathy Cummings,DEM,140051,6,16,214,236,
Cleveland,Lieutenant Governor,Todd Lamb,REP,140051,14,11,199,224,
Cleveland,Superintendent of Public Instruction,John Cox,DEM,140051,5,19,244,268,
Cleveland,Superintendent of Public Instruction,Joy Hofmeister,REP,140051,14,7,169,190,
Cleveland,Commissioner of Labor,Mike Workman,DEM,140051,6,15,222,243,
Cleveland,Commissioner of Labor,Mark Costello,REP,140051,13,11,178,202,
Cleveland,U.S. Senate,Matt Silverstein,DEM,140051,5,16,196,217,
Cleveland,U.S. Senate,Jim Inhofe,REP,140051,15,11,206,232,
Cleveland,U.S. Senate,Aaron Delozier,IND,140051,0,0,3,3,
Cleveland,U.S. Senate,Ray Woods,IND,140051,0,0,3,3,
Cleveland,U.S. Senate,Joan Farr,IND,140051,0,0,7,7,
Cleveland,U.S. Senate,Connie Johnson,DEM,140051,4,16,208,228,
Cleveland,U.S. Senate,James Lankford,REP,140051,15,10,199,224,
Cleveland,U.S. Senate,Mark Beard,IND,140051,1,1,9,11,
Cleveland,U.S. House,Bert Smith,DEM,140051,4,13,177,194,04
Cleveland,U.S. House,Tom Cole,REP,140051,15,13,218,246,04
Cleveland,U.S. House,Dennis Johnson,IND,140051,1,0,17,18,04
Cleveland,Governor,Joe Dorman,DEM,140053,32,61,630,723,
Cleveland,Governor,Mary Fallin,REP,140053,25,51,655,731,
Cleveland,Governor,Kimberly Willis,IND,140053,2,2,25,29,
Cleveland,Governor,Richard Prawdzienski,IND,140053,0,1,15,16,
Cleveland,Lieutenant Governor,Cathy Cummings,DEM,140053,30,51,517,598,
Cleveland,Lieutenant Governor,Todd Lamb,REP,140053,31,66,808,905,
Cleveland,Superintendent of Public Instruction,John Cox,DEM,140053,35,60,593,688,
Cleveland,Superintendent of Public Instruction,Joy Hofmeister,REP,140053,25,57,719,801,
Cleveland,Commissioner of Labor,Mike Workman,DEM,140053,28,50,529,607,
Cleveland,Commissioner of Labor,Mark Costello,REP,140053,32,64,762,858,
Cleveland,U.S. Senate,Matt Silverstein,DEM,140053,27,54,474,555,
Cleveland,U.S. Senate,Jim Inhofe,REP,140053,28,61,798,887,
Cleveland,U.S. Senate,Aaron Delozier,IND,140053,1,0,10,11,
Cleveland,U.S. Senate,Ray Woods,IND,140053,2,1,20,23,
Cleveland,U.S. Senate,Joan Farr,IND,140053,1,1,14,16,
Cleveland,U.S. Senate,Connie Johnson,DEM,140053,27,47,480,554,
Cleveland,U.S. Senate,James Lankford,REP,140053,33,69,799,901,
Cleveland,U.S. Senate,Mark Beard,IND,140053,1,1,43,45,
Cleveland,U.S. House,Bert Smith,DEM,140053,21,39,409,469,04
Cleveland,U.S. House,Tom Cole,REP,140053,39,73,862,974,04
Cleveland,U.S. House,Dennis Johnson,IND,140053,1,4,53,58,04
Cleveland,State House,Scott Martin,REP,140053,33,65,837,935,46
Cleveland,State House,Scott Brockman,IND,140053,15,39,380,434,46
Cleveland,Governor,Joe Dorman,DEM,140054,3,11,148,162,
Cleveland,Governor,Mary Fallin,REP,140054,6,2,233,241,
Cleveland,Governor,Kimberly Willis,IND,140054,0,1,14,15,
Cleveland,Governor,Richard Prawdzienski,IND,140054,0,1,10,11,
Cleveland,Lieutenant Governor,Cathy Cummings,DEM,140054,2,11,113,126,
Cleveland,Lieutenant Governor,Todd Lamb,REP,140054,8,4,289,301,
Cleveland,Superintendent of Public Instruction,John Cox,DEM,140054,4,12,145,161,
Cleveland,Superintendent of Public Instruction,Joy Hofmeister,REP,140054,5,3,257,265,
Cleveland,Commissioner of Labor,Mike Workman,DEM,140054,2,10,128,140,
Cleveland,Commissioner of Labor,Mark Costello,REP,140054,6,4,269,279,
Cleveland,U.S. Senate,Matt Silverstein,DEM,140054,0,10,106,116,
Cleveland,U.S. Senate,Jim Inhofe,REP,140054,9,5,275,289,
Cleveland,U.S. Senate,Aaron Delozier,IND,140054,1,0,3,4,
Cleveland,U.S. Senate,Ray Woods,IND,140054,0,0,9,9,
Cleveland,U.S. Senate,Joan Farr,IND,140054,0,0,10,10,
Cleveland,U.S. Senate,Connie Johnson,DEM,140054,2,10,108,120,
Cleveland,U.S. Senate,James Lankford,REP,140054,8,3,276,287,
Cleveland,U.S. Senate,Mark Beard,IND,140054,0,2,18,20,
Cleveland,U.S. House,Bert Smith,DEM,140054,1,10,92,103,04
Cleveland,U.S. House,Tom Cole,REP,140054,9,3,286,298,04
Cleveland,U.S. House,Dennis Johnson,IND,140054,0,2,24,26,04
Cleveland,Governor,Joe Dorman,DEM,140055,33,115,791,939,
Cleveland,Governor,Mary Fallin,REP,140055,37,62,713,812,
Cleveland,Governor,Kimberly Willis,IND,140055,1,1,37,39,
Cleveland,Governor,Richard Prawdzienski,IND,140055,1,2,13,16,
Cleveland,Lieutenant Governor,Cathy Cummings,DEM,140055,26,98,629,753,
Cleveland,Lieutenant Governor,Todd Lamb,REP,140055,46,82,918,1046,
Cleveland,Superintendent of Public Instruction,John Cox,DEM,140055,36,108,761,905,
Cleveland,Superintendent of Public Instruction,Joy Hofmeister,REP,140055,35,73,775,883,
Cleveland,Commissioner of Labor,Mike Workman,DEM,140055,29,101,637,767,
Cleveland,Commissioner of Labor,Mark Costello,REP,140055,41,78,872,991,
Cleveland,U.S. Senate,Matt Silverstein,DEM,140055,29,97,580,706,
Cleveland,U.S. Senate,Jim Inhofe,REP,140055,41,82,903,1026,
Cleveland,U.S. Senate,Aaron Delozier,IND,140055,0,0,19,19,
Cleveland,U.S. Senate,Ray Woods,IND,140055,2,0,17,19,
Cleveland,U.S. Senate,Joan Farr,IND,140055,0,2,25,27,
Cleveland,U.S. Senate,Connie Johnson,DEM,140055,29,100,603,732,
Cleveland,U.S. Senate,James Lankford,REP,140055,42,82,892,1016,
Cleveland,U.S. Senate,Mark Beard,IND,140055,1,0,50,51,
Cleveland,U.S. House,Bert Smith,DEM,140055,23,87,515,625,04
Cleveland,U.S. House,Tom Cole,REP,140055,47,90,960,1097,04
Cleveland,U.S. House,Dennis Johnson,IND,140055,2,4,68,74,04
Cleveland,State House,Claudia Griffith,DEM,140055,36,112,713,861,45
Cleveland,State House,Aaron Stiles,REP,140055,36,68,826,930,45
Cleveland,Governor,Joe Dorman,DEM,140056,24,35,544,603,
Cleveland,Governor,Mary Fallin,REP,140056,13,34,316,363,
Cleveland,Governor,Kimberly Willis,IND,140056,0,0,17,17,
Cleveland,Governor,Richard Prawdzienski,IND,140056,0,0,9,9,
Cleveland,Lieutenant Governor,Cathy Cummings,DEM,140056,23,30,454,507,
Cleveland,Lieutenant Governor,Todd Lamb,REP,140056,14,38,426,478,
Cleveland,Superintendent of Public Instruction,John Cox,DEM,140056,24,33,520,577,
Cleveland,Superintendent of Public Instruction,Joy Hofmeister,REP,140056,12,36,353,401,
Cleveland,Commissioner of Labor,Mike Workman,DEM,140056,24,33,460,517,
Cleveland,Commissioner of Labor,Mark Costello,REP,140056,12,36,391,439,
Cleveland,U.S. Senate,Matt Silverstein,DEM,140056,23,29,426,478,
Cleveland,U.S. Senate,Jim Inhofe,REP,140056,13,38,414,465,
Cleveland,U.S. Senate,Aaron Delozier,IND,140056,0,0,12,12,
Cleveland,U.S. Senate,Ray Woods,IND,140056,0,0,9,9,
Cleveland,U.S. Senate,Joan Farr,IND,140056,1,2,14,17,
Cleveland,U.S. Senate,Connie Johnson,DEM,140056,21,28,444,493,
Cleveland,U.S. Senate,James Lankford,REP,140056,16,38,404,458,
Cleveland,U.S. Senate,Mark Beard,IND,140056,0,2,27,29,
Cleveland,U.S. House,Bert Smith,DEM,140056,20,24,376,420,04
Cleveland,U.S. House,Tom Cole,REP,140056,16,41,462,519,04
Cleveland,U.S. House,Dennis Johnson,IND,140056,1,3,38,42,04
Cleveland,Governor,Joe Dorman,DEM,140057,5,14,438,457,
Cleveland,Governor,Mary Fallin,REP,140057,14,4,488,506,
Cleveland,Governor,Kimberly Willis,IND,140057,1,0,28,29,
Cleveland,Governor,Richard Prawdzienski,IND,140057,0,0,16,16,
Cleveland,Lieutenant Governor,Cathy Cummings,DEM,140057,4,9,307,320,
Cleveland,Lieutenant Governor,Todd Lamb,REP,140057,16,9,663,688,
Cleveland,Superintendent of Public Instruction,John Cox,DEM,140057,9,8,416,433,
Cleveland,Superintendent of Public Instruction,Joy Hofmeister,REP,140057,11,9,552,572,
Cleveland,Commissioner of Labor,Mike Workman,DEM,140057,6,10,383,399,
Cleveland,Commissioner of Labor,Mark Costello,REP,140057,14,7,562,583,
Cleveland,U.S. Senate,Matt Silverstein,DEM,140057,4,5,258,267,
Cleveland,U.S. Senate,Jim Inhofe,REP,140057,15,13,664,692,
Cleveland,U.S. Senate,Aaron Delozier,IND,140057,0,0,12,12,
Cleveland,U.S. Senate,Ray Woods,IND,140057,0,0,16,16,
Cleveland,U.S. Senate,Joan Farr,IND,140057,1,0,19,20,
Cleveland,U.S. Senate,Connie Johnson,DEM,140057,4,4,261,269,
Cleveland,U.S. Senate,James Lankford,REP,140057,15,13,666,694,
Cleveland,U.S. Senate,Mark Beard,IND,140057,1,1,47,49,
Cleveland,U.S. House,Bert Smith,DEM,140057,3,5,226,234,04
Cleveland,U.S. House,Tom Cole,REP,140057,16,13,683,712,04
Cleveland,U.S. House,Dennis Johnson,IND,140057,1,0,62,63,04
Cleveland,State House,Scott Martin,REP,140057,14,12,617,643,46
Cleveland,State House,Scott Brockman,IND,140057,6,5,301,312,46
Cleveland,Governor,Joe Dorman,DEM,140058,19,13,259,291,
Cleveland,Governor,Mary Fallin,REP,140058,18,7,471,496,
Cleveland,Governor,Kimberly Willis,IND,140058,1,0,20,21,
Cleveland,Governor,Richard Prawdzienski,IND,140058,0,0,11,11,
Cleveland,Lieutenant Governor,Cathy Cummings,DEM,140058,21,5,199,225,
Cleveland,Lieutenant Governor,Todd Lamb,REP,140058,16,15,564,595,
Cleveland,Superintendent of Public Instruction,John Cox,DEM,140058,28,12,301,341,
Cleveland,Superintendent of Public Instruction,Joy Hofmeister,REP,140058,10,8,460,478,
Cleveland,Commissioner of Labor,Mike Workman,DEM,140058,25,7,220,252,
Cleveland,Commissioner of Labor,Mark Costello,REP,140058,12,12,520,544,
Cleveland,U.S. Senate,Matt Silverstein,DEM,140058,19,4,163,186,
Cleveland,U.S. Senate,Jim Inhofe,REP,140058,18,12,554,584,
Cleveland,U.S. Senate,Aaron Delozier,IND,140058,0,0,15,15,
Cleveland,U.S. Senate,Ray Woods,IND,140058,0,2,9,11,
Cleveland,U.S. Senate,Joan Farr,IND,140058,0,2,17,19,
Cleveland,U.S. Senate,Connie Johnson,DEM,140058,19,4,162,185,
Cleveland,U.S. Senate,James Lankford,REP,140058,18,13,564,595,
Cleveland,U.S. Senate,Mark Beard,IND,140058,1,3,35,39,
Cleveland,U.S. House,Bert Smith,DEM,140058,20,7,133,160,04
Cleveland,U.S. House,Tom Cole,REP,140058,16,8,584,608,04
Cleveland,U.S. House,Dennis Johnson,IND,140058,2,5,45,52,04
Cleveland,Governor,Joe Dorman,DEM,140059,7,12,143,162,
Cleveland,Governor,Mary Fallin,REP,140059,10,11,125,146,
Cleveland,Governor,Kimberly Willis,IND,140059,0,1,5,6,
Cleveland,Governor,Richard Prawdzienski,IND,140059,0,0,4,4,
Cleveland,Lieutenant Governor,Cathy Cummings,DEM,140059,8,9,117,134,
Cleveland,Lieutenant Governor,Todd Lamb,REP,140059,9,15,157,181,
Cleveland,Superintendent of Public Instruction,John Cox,DEM,140059,9,14,143,166,
Cleveland,Superintendent of Public Instruction,Joy Hofmeister,REP,140059,8,10,131,149,
Cleveland,Commissioner of Labor,Mike Workman,DEM,140059,10,9,128,147,
Cleveland,Commissioner of Labor,Mark Costello,REP,140059,7,15,141,163,
Cleveland,U.S. Senate,Matt Silverstein,DEM,140059,7,7,112,126,
Cleveland,U.S. Senate,Jim Inhofe,REP,140059,7,17,152,176,
Cleveland,U.S. Senate,Aaron Delozier,IND,140059,1,0,5,6,
Cleveland,U.S. Senate,Ray Woods,IND,140059,2,0,2,4,
Cleveland,U.S. Senate,Joan Farr,IND,140059,0,0,1,1,
Cleveland,U.S. Senate,Connie Johnson,DEM,140059,6,9,111,126,
Cleveland,U.S. Senate,James Lankford,REP,140059,8,14,154,176,
Cleveland,U.S. Senate,Mark Beard,IND,140059,3,0,10,13,
Cleveland,U.S. House,Bert Smith,DEM,140059,6,6,93,105,04
Cleveland,U.S. House,Tom Cole,REP,140059,9,16,168,193,04
Cleveland,U.S. House,Dennis Johnson,IND,140059,1,1,14,16,04
Cleveland,State House,Scott Martin,REP,140059,6,15,149,170,46
Cleveland,State House,Scott Brockman,IND,140059,8,7,110,125,46
Cleveland,Governor,Joe Dorman,DEM,140060,13,10,399,422,
Cleveland,Governor,Mary Fallin,REP,140060,44,33,766,843,
Cleveland,Governor,Kimberly Willis,IND,140060,1,0,24,25,
Cleveland,Governor,Richard Prawdzienski,IND,140060,0,0,19,19,
Cleveland,Lieutenant Governor,Cathy Cummings,DEM,140060,13,8,283,304,
Cleveland,Lieutenant Governor,Todd Lamb,REP,140060,45,35,923,1003,
Cleveland,Superintendent of Public Instruction,John Cox,DEM,140060,17,10,429,456,
Cleveland,Superintendent of Public Instruction,Joy Hofmeister,REP,140060,39,33,765,837,
Cleveland,Commissioner of Labor,Mike Workman,DEM,140060,13,8,342,363,
Cleveland,Commissioner of Labor,Mark Costello,REP,140060,45,35,838,918,
Cleveland,U.S. Senate,Matt Silverstein,DEM,140060,11,9,271,291,
Cleveland,U.S. Senate,Jim Inhofe,REP,140060,47,33,903,983,
Cleveland,U.S. Senate,Aaron Delozier,IND,140060,0,0,9,9,
Cleveland,U.S. Senate,Ray Woods,IND,140060,0,0,13,13,
Cleveland,U.S. Senate,Joan Farr,IND,140060,0,0,9,9,
Cleveland,U.S. Senate,Connie Johnson,DEM,140060,12,5,277,294,
Cleveland,U.S. Senate,James Lankford,REP,140060,46,38,886,970,
Cleveland,U.S. Senate,Mark Beard,IND,140060,0,0,41,41,
Cleveland,U.S. House,Bert Smith,DEM,140060,10,6,222,238,04
Cleveland,U.S. House,Tom Cole,REP,140060,43,37,936,1016,04
Cleveland,U.S. House,Dennis Johnson,IND,140060,5,0,46,51,04
Cleveland,Governor,Joe Dorman,DEM,140061,22,9,282,313,
Cleveland,Governor,Mary Fallin,REP,140061,57,25,645,727,
Cleveland,Governor,Kimberly Willis,IND,140061,0,2,20,22,
Cleveland,Governor,Richard Prawdzienski,IND,140061,0,0,8,8,
Cleveland,Lieutenant Governor,Cathy Cummings,DEM,140061,17,9,204,230,
Cleveland,Lieutenant Governor,Todd Lamb,REP,140061,63,27,747,837,
Cleveland,Superintendent of Public Instruction,John Cox,DEM,140061,20,12,310,342,
Cleveland,Superintendent of Public Instruction,Joy Hofmeister,REP,140061,56,23,636,715,
Cleveland,Commissioner of Labor,Mike Workman,DEM,140061,17,10,217,244,
Cleveland,Commissioner of Labor,Mark Costello,REP,140061,59,24,709,792,
Cleveland,U.S. Senate,Matt Silverstein,DEM,140061,14,9,179,202,
Cleveland,U.S. Senate,Jim Inhofe,REP,140061,62,26,755,843,
Cleveland,U.S. Senate,Aaron Delozier,IND,140061,1,0,7,8,
Cleveland,U.S. Senate,Ray Woods,IND,140061,0,1,7,8,
Cleveland,U.S. Senate,Joan Farr,IND,140061,2,0,4,6,
Cleveland,U.S. Senate,Connie Johnson,DEM,140061,16,9,184,209,
Cleveland,U.S. Senate,James Lankford,REP,140061,65,27,749,841,
Cleveland,U.S. Senate,Mark Beard,IND,140061,0,0,22,22,
Cleveland,U.S. House,Bert Smith,DEM,140061,10,8,162,180,04
Cleveland,U.S. House,Tom Cole,REP,140061,66,27,751,844,04
Cleveland,U.S. House,Dennis Johnson,IND,140061,5,1,41,47,04
Cleveland,State House,Trey Puckett,DEM,140061,14,9,188,211,91
Cleveland,State House,Chris Kannady,REP,140061,64,26,750,840,91
Cleveland,Governor,Joe Dorman,DEM,140063,5,10,109,124,
Cleveland,Governor,Mary Fallin,REP,140063,10,14,194,218,
Cleveland,Governor,Kimberly Willis,IND,140063,0,0,5,5,
Cleveland,Governor,Richard Prawdzienski,IND,140063,0,0,1,1,
Cleveland,Lieutenant Governor,Cathy Cummings,DEM,140063,4,9,84,97,
Cleveland,Lieutenant Governor,Todd Lamb,REP,140063,11,15,224,250,
Cleveland,Superintendent of Public Instruction,John Cox,DEM,140063,3,9,122,134,
Cleveland,Superintendent of Public Instruction,Joy Hofmeister,REP,140063,12,14,186,212,
Cleveland,Commissioner of Labor,Mike Workman,DEM,140063,3,8,94,105,
Cleveland,Commissioner of Labor,Mark Costello,REP,140063,11,15,212,238,
Cleveland,U.S. Senate,Matt Silverstein,DEM,140063,2,4,77,83,
Cleveland,U.S. Senate,Jim Inhofe,REP,140063,13,17,221,251,
Cleveland,U.S. Senate,Aaron Delozier,IND,140063,0,1,3,4,
Cleveland,U.S. Senate,Ray Woods,IND,140063,0,0,5,5,
Cleveland,U.S. Senate,Joan Farr,IND,140063,0,1,0,1,
Cleveland,U.S. Senate,Connie Johnson,DEM,140063,1,5,78,84,
Cleveland,U.S. Senate,James Lankford,REP,140063,13,16,221,250,
Cleveland,U.S. Senate,Mark Beard,IND,140063,1,3,9,13,
Cleveland,U.S. House,Bert Smith,DEM,140063,1,5,70,76,04
Cleveland,U.S. House,Tom Cole,REP,140063,14,17,223,254,04
Cleveland,U.S. House,Dennis Johnson,IND,140063,0,1,15,16,04
Cleveland,Governor,Joe Dorman,DEM,140064,11,11,179,201,
Cleveland,Governor,Mary Fallin,REP,140064,39,4,439,482,
Cleveland,Governor,Kimberly Willis,IND,140064,0,0,12,12,
Cleveland,Governor,Richard Prawdzienski,IND,140064,0,0,10,10,
Cleveland,Lieutenant Governor,Cathy Cummings,DEM,140064,13,7,153,173,
Cleveland,Lieutenant Governor,Todd Lamb,REP,140064,37,8,484,529,
Cleveland,Superintendent of Public Instruction,John Cox,DEM,140064,18,9,206,233,
Cleveland,Superintendent of Public Instruction,Joy Hofmeister,REP,140064,32,6,431,469,
Cleveland,Commissioner of Labor,Mike Workman,DEM,140064,14,9,179,202,
Cleveland,Commissioner of Labor,Mark Costello,REP,140064,35,6,455,496,
Cleveland,U.S. Senate,Matt Silverstein,DEM,140064,11,9,125,145,
Cleveland,U.S. Senate,Jim Inhofe,REP,140064,38,6,485,529,
Cleveland,U.S. Senate,Aaron Delozier,IND,140064,0,0,5,5,
Cleveland,U.S. Senate,Ray Woods,IND,140064,0,0,12,12,
Cleveland,U.S. Senate,Joan Farr,IND,140064,0,0,9,9,
Cleveland,U.S. Senate,Connie Johnson,DEM,140064,11,6,134,151,
Cleveland,U.S. Senate,James Lankford,REP,140064,39,8,484,531,
Cleveland,U.S. Senate,Mark Beard,IND,140064,0,1,21,22,
Cleveland,U.S. House,Bert Smith,DEM,140064,13,6,121,140,04
Cleveland,U.S. House,Tom Cole,REP,140064,35,7,491,533,04
Cleveland,U.S. House,Dennis Johnson,IND,140064,2,2,25,29,04
Cleveland,Governor,Joe Dorman,DEM,140065,4,5,149,158,
Cleveland,Governor,Mary Fallin,REP,140065,5,0,217,222,
Cleveland,Governor,Kimberly Willis,IND,140065,1,0,8,9,
Cleveland,Governor,Richard Prawdzienski,IND,140065,0,0,5,5,
Cleveland,Lieutenant Governor,Cathy Cummings,DEM,140065,5,4,128,137,
Cleveland,Lieutenant Governor,Todd Lamb,REP,140065,5,1,248,254,
Cleveland,Superintendent of Public Instruction,John Cox,DEM,140065,4,4,165,173,
Cleveland,Superintendent of Public Instruction,Joy Hofmeister,REP,140065,6,1,213,220,
Cleveland,Commissioner of Labor,Mike Workman,DEM,140065,4,3,146,153,
Cleveland,Commissioner of Labor,Mark Costello,REP,140065,6,2,225,233,
Cleveland,U.S. Senate,Matt Silverstein,DEM,140065,3,4,110,117,
Cleveland,U.S. Senate,Jim Inhofe,REP,140065,6,1,248,255,
Cleveland,U.S. Senate,Aaron Delozier,IND,140065,0,0,3,3,
Cleveland,U.S. Senate,Ray Woods,IND,140065,0,0,6,6,
Cleveland,U.S. Senate,Joan Farr,IND,140065,1,0,7,8,
Cleveland,U.S. Senate,Connie Johnson,DEM,140065,5,3,118,126,
Cleveland,U.S. Senate,James Lankford,REP,140065,5,2,244,251,
Cleveland,U.S. Senate,Mark Beard,IND,140065,0,0,16,16,
Cleveland,U.S. House,Bert Smith,DEM,140065,2,3,104,109,04
Cleveland,U.S. House,Tom Cole,REP,140065,8,2,243,253,04
Cleveland,U.S. House,Dennis Johnson,IND,140065,0,0,32,32,04
Cleveland,Governor,Joe Dorman,DEM,140067,7,18,274,299,
Cleveland,Governor,Mary Fallin,REP,140067,3,17,226,246,
Cleveland,Governor,Kimberly Willis,IND,140067,0,0,7,7,
Cleveland,Governor,Richard Prawdzienski,IND,140067,0,0,4,4,
Cleveland,Lieutenant Governor,Cathy Cummings,DEM,140067,7,18,216,241,
Cleveland,Lieutenant Governor,Todd Lamb,REP,140067,3,17,294,314,
Cleveland,Superintendent of Public Instruction,John Cox,DEM,140067,7,18,262,287,
Cleveland,Superintendent of Public Instruction,Joy Hofmeister,REP,140067,3,16,245,264,
Cleveland,Commissioner of Labor,Mike Workman,DEM,140067,6,16,218,240,
Cleveland,Commissioner of Labor,Mark Costello,REP,140067,4,18,284,306,
Cleveland,U.S. Senate,Matt Silverstein,DEM,140067,7,17,196,220,
Cleveland,U.S. Senate,Jim Inhofe,REP,140067,3,18,294,315,
Cleveland,U.S. Senate,Aaron Delozier,IND,140067,0,0,8,8,
Cleveland,U.S. Senate,Ray Woods,IND,140067,0,0,7,7,
Cleveland,U.S. Senate,Joan Farr,IND,140067,0,0,8,8,
Cleveland,U.S. Senate,Connie Johnson,DEM,140067,6,16,191,213,
Cleveland,U.S. Senate,James Lankford,REP,140067,4,18,305,327,
Cleveland,U.S. Senate,Mark Beard,IND,140067,0,0,17,17,
Cleveland,U.S. House,Bert Smith,DEM,140067,6,13,161,180,04
Cleveland,U.S. House,Tom Cole,REP,140067,4,22,321,347,04
Cleveland,U.S. House,Dennis Johnson,IND,140067,0,0,27,27,04
Cleveland,State House,Scott Martin,REP,140067,5,18,301,324,46
Cleveland,State House,Scott Brockman,IND,140067,4,13,171,188,46
Cleveland,Governor,Joe Dorman,DEM,140068,6,20,279,305,
Cleveland,Governor,Mary Fallin,REP,140068,3,3,203,209,
Cleveland,Governor,Kimberly Willis,IND,140068,0,2,13,15,
Cleveland,Governor,Richard Prawdzienski,IND,140068,1,0,8,9,
Cleveland,Lieutenant Governor,Cathy Cummings,DEM,140068,6,17,223,246,
Cleveland,Lieutenant Governor,Todd Lamb,REP,140068,4,8,281,293,
Cleveland,Superintendent of Public Instruction,John Cox,DEM,140068,6,20,264,290,
Cleveland,Superintendent of Public Instruction,Joy Hofmeister,REP,140068,4,5,232,241,
Cleveland,Commissioner of Labor,Mike Workman,DEM,140068,6,18,227,251,
Cleveland,Commissioner of Labor,Mark Costello,REP,140068,4,7,258,269,
Cleveland,U.S. Senate,Matt Silverstein,DEM,140068,4,18,215,237,
Cleveland,U.S. Senate,Jim Inhofe,REP,140068,5,7,270,282,
Cleveland,U.S. Senate,Aaron Delozier,IND,140068,0,0,3,3,
Cleveland,U.S. Senate,Ray Woods,IND,140068,0,0,8,8,
Cleveland,U.S. Senate,Joan Farr,IND,140068,1,0,8,9,
Cleveland,U.S. Senate,Connie Johnson,DEM,140068,6,18,211,235,
Cleveland,U.S. Senate,James Lankford,REP,140068,4,7,274,285,
Cleveland,U.S. Senate,Mark Beard,IND,140068,0,0,20,20,
Cleveland,U.S. House,Bert Smith,DEM,140068,5,13,184,202,04
Cleveland,U.S. House,Tom Cole,REP,140068,3,11,298,312,04
Cleveland,U.S. House,Dennis Johnson,IND,140068,2,1,23,26,04
Cleveland,State House,Scott Martin,REP,140068,3,10,262,275,46
Cleveland,State House,Scott Brockman,IND,140068,3,13,200,216,46
Cleveland,Governor,Joe Dorman,DEM,140069,9,4,393,406,
Cleveland,Governor,Mary Fallin,REP,140069,30,17,633,680,
Cleveland,Governor,Kimberly Willis,IND,140069,0,0,28,28,
Cleveland,Governor,Richard Prawdzienski,IND,140069,0,0,13,13,
Cleveland,Lieutenant Governor,Cathy Cummings,DEM,140069,8,4,311,323,
Cleveland,Lieutenant Governor,Todd Lamb,REP,140069,31,17,747,795,
Cleveland,Superintendent of Public Instruction,John Cox,DEM,140069,13,3,405,421,
Cleveland,Superintendent of Public Instruction,Joy Hofmeister,REP,140069,26,18,649,693,
Cleveland,Commissioner of Labor,Mike Workman,DEM,140069,10,6,334,350,
Cleveland,Commissioner of Labor,Mark Costello,REP,140069,29,15,696,740,
Cleveland,U.S. Senate,Matt Silverstein,DEM,140069,8,4,259,271,
Cleveland,U.S. Senate,Jim Inhofe,REP,140069,31,17,759,807,
Cleveland,U.S. Senate,Aaron Delozier,IND,140069,0,0,7,7,
Cleveland,U.S. Senate,Ray Woods,IND,140069,0,0,14,14,
Cleveland,U.S. Senate,Joan Farr,IND,140069,0,0,14,14,
Cleveland,U.S. Senate,Connie Johnson,DEM,140069,7,3,273,283,
Cleveland,U.S. Senate,James Lankford,REP,140069,32,18,757,807,
Cleveland,U.S. Senate,Mark Beard,IND,140069,0,0,30,30,
Cleveland,U.S. House,Bert Smith,DEM,140069,8,3,232,243,04
Cleveland,U.S. House,Tom Cole,REP,140069,30,17,774,821,04
Cleveland,U.S. House,Dennis Johnson,IND,140069,1,1,56,58,04
Cleveland,State House,Trey Puckett,DEM,140069,9,3,284,296,91
Cleveland,State House,Chris Kannady,REP,140069,29,18,759,806,91
Cleveland,Governor,Joe Dorman,DEM,140070,2,9,316,327,
Cleveland,Governor,Mary Fallin,REP,140070,19,17,435,471,
Cleveland,Governor,Kimberly Willis,IND,140070,1,2,25,28,
Cleveland,Governor,Richard Prawdzienski,IND,140070,0,0,13,13,
Cleveland,Lieutenant Governor,Cathy Cummings,DEM,140070,3,8,225,236,
Cleveland,Lieutenant Governor,Todd Lamb,REP,140070,19,20,554,593,
Cleveland,Superintendent of Public Instruction,John Cox,DEM,140070,9,9,305,323,
Cleveland,Superintendent of Public Instruction,Joy Hofmeister,REP,140070,13,19,476,508,
Cleveland,Commissioner of Labor,Mike Workman,DEM,140070,4,11,246,261,
Cleveland,Commissioner of Labor,Mark Costello,REP,140070,18,17,521,556,
Cleveland,U.S. Senate,Matt Silverstein,DEM,140070,4,8,201,213,
Cleveland,U.S. Senate,Jim Inhofe,REP,140070,17,19,544,580,
Cleveland,U.S. Senate,Aaron Delozier,IND,140070,0,0,14,14,
Cleveland,U.S. Senate,Ray Woods,IND,140070,0,1,8,9,
Cleveland,U.S. Senate,Joan Farr,IND,140070,1,0,12,13,
Cleveland,U.S. Senate,Connie Johnson,DEM,140070,3,9,194,206,
Cleveland,U.S. Senate,James Lankford,REP,140070,18,17,555,590,
Cleveland,U.S. Senate,Mark Beard,IND,140070,1,2,32,35,
Cleveland,U.S. House,Bert Smith,DEM,140070,2,7,170,179,04
Cleveland,U.S. House,Tom Cole,REP,140070,18,17,570,605,04
Cleveland,U.S. House,Dennis Johnson,IND,140070,2,4,42,48,04
Cleveland,Governor,Joe Dorman,DEM,140071,10,14,227,251,
Cleveland,Governor,Mary Fallin,REP,140071,11,14,198,223,
Cleveland,Governor,Kimberly Willis,IND,140071,0,0,6,6,
Cleveland,Governor,Richard Prawdzienski,IND,140071,1,0,4,5,
Cleveland,Lieutenant Governor,Cathy Cummings,DEM,140071,9,15,187,211,
Cleveland,Lieutenant Governor,Todd Lamb,REP,140071,13,13,247,273,
Cleveland,Superintendent of Public Instruction,John Cox,DEM,140071,10,16,219,245,
Cleveland,Superintendent of Public Instruction,Joy Hofmeister,REP,140071,12,12,215,239,
Cleveland,Commissioner of Labor,Mike Workman,DEM,140071,9,13,198,220,
Cleveland,Commissioner of Labor,Mark Costello,REP,140071,13,15,223,251,
Cleveland,U.S. Senate,Matt Silverstein,DEM,140071,7,14,174,195,
Cleveland,U.S. Senate,Jim Inhofe,REP,140071,14,14,244,272,
Cleveland,U.S. Senate,Aaron Delozier,IND,140071,0,0,4,4,
Cleveland,U.S. Senate,Ray Woods,IND,140071,0,0,2,2,
Cleveland,U.S. Senate,Joan Farr,IND,140071,0,0,10,10,
Cleveland,U.S. Senate,Connie Johnson,DEM,140071,9,13,175,197,
Cleveland,U.S. Senate,James Lankford,REP,140071,12,15,251,278,
Cleveland,U.S. Senate,Mark Beard,IND,140071,1,0,11,12,
Cleveland,U.S. House,Bert Smith,DEM,140071,7,10,153,170,04
Cleveland,U.S. House,Tom Cole,REP,140071,15,18,265,298,04
Cleveland,U.S. House,Dennis Johnson,IND,140071,0,0,17,17,04
Cleveland,State House,Scott Martin,REP,140071,16,16,250,282,46
Cleveland,State House,Scott Brockman,IND,140071,5,10,141,156,46
Cleveland,Governor,Joe Dorman,DEM,140072,11,17,308,336,
Cleveland,Governor,Mary Fallin,REP,140072,23,12,552,587,
Cleveland,Governor,Kimberly Willis,IND,140072,1,1,22,24,
Cleveland,Governor,Richard Prawdzienski,IND,140072,0,0,17,17,
Cleveland,Lieutenant Governor,Cathy Cummings,DEM,140072,6,16,236,258,
Cleveland,Lieutenant Governor,Todd Lamb,REP,140072,29,15,665,709,
Cleveland,Superintendent of Public Instruction,John Cox,DEM,140072,11,17,313,341,
Cleveland,Superintendent of Public Instruction,Joy Hofmeister,REP,140072,24,13,579,616,
Cleveland,Commissioner of Labor,Mike Workman,DEM,140072,9,17,247,273,
Cleveland,Commissioner of Labor,Mark Costello,REP,140072,25,14,639,678,
Cleveland,U.S. Senate,Matt Silverstein,DEM,140072,6,15,192,213,
Cleveland,U.S. Senate,Jim Inhofe,REP,140072,24,16,667,707,
Cleveland,U.S. Senate,Aaron Delozier,IND,140072,2,0,7,9,
Cleveland,U.S. Senate,Ray Woods,IND,140072,2,0,16,18,
Cleveland,U.S. Senate,Joan Farr,IND,140072,1,0,14,15,
Cleveland,U.S. Senate,Connie Johnson,DEM,140072,7,17,204,228,
Cleveland,U.S. Senate,James Lankford,REP,140072,26,14,666,706,
Cleveland,U.S. Senate,Mark Beard,IND,140072,1,0,30,31,
Cleveland,U.S. House,Bert Smith,DEM,140072,6,15,183,204,04
Cleveland,U.S. House,Tom Cole,REP,140072,27,15,678,720,04
Cleveland,U.S. House,Dennis Johnson,IND,140072,2,0,37,39,04
Cleveland,Governor,Joe Dorman,DEM,140073,33,38,690,761,
Cleveland,Governor,Mary Fallin,REP,140073,26,43,783,852,
Cleveland,Governor,Kimberly Willis,IND,140073,0,1,18,19,
Cleveland,Governor,Richard Prawdzienski,IND,140073,0,1,9,10,
Cleveland,Lieutenant Governor,Cathy Cummings,DEM,140073,30,30,526,586,
Cleveland,Lieutenant Governor,Todd Lamb,REP,140073,29,53,966,1048,
Cleveland,Superintendent of Public Instruction,John Cox,DEM,140073,35,31,633,699,
Cleveland,Superintendent of Public Instruction,Joy Hofmeister,REP,140073,23,50,850,923,
Cleveland,Commissioner of Labor,Mike Workman,DEM,140073,26,30,512,568,
Cleveland,Commissioner of Labor,Mark Costello,REP,140073,28,52,928,1008,
Cleveland,U.S. Senate,Matt Silverstein,DEM,140073,31,30,506,567,
Cleveland,U.S. Senate,Jim Inhofe,REP,140073,28,54,954,1036,
Cleveland,U.S. Senate,Aaron Delozier,IND,140073,0,0,6,6,
Cleveland,U.S. Senate,Ray Woods,IND,140073,0,0,12,12,
Cleveland,U.S. Senate,Joan Farr,IND,140073,0,0,15,15,
Cleveland,U.S. Senate,Connie Johnson,DEM,140073,30,29,487,546,
Cleveland,U.S. Senate,James Lankford,REP,140073,28,55,963,1046,
Cleveland,U.S. Senate,Mark Beard,IND,140073,0,0,43,43,
Cleveland,U.S. House,Bert Smith,DEM,140073,24,23,418,465,04
Cleveland,U.S. House,Tom Cole,REP,140073,33,57,1012,1102,04
Cleveland,U.S. House,Dennis Johnson,IND,140073,0,4,59,63,04
Cleveland,State House,Scott Martin,REP,140073,32,51,881,964,46
Cleveland,State House,Scott Brockman,IND,140073,21,25,523,569,46
Cleveland,Governor,Joe Dorman,DEM,140074,12,17,276,305,
Cleveland,Governor,Mary Fallin,REP,140074,11,16,294,321,
Cleveland,Governor,Kimberly Willis,IND,140074,0,2,8,10,
Cleveland,Governor,Richard Prawdzienski,IND,140074,1,0,8,9,
Cleveland,Lieutenant Governor,Cathy Cummings,DEM,140074,11,14,214,239,
Cleveland,Lieutenant Governor,Todd Lamb,REP,140074,13,21,365,399,
Cleveland,Superintendent of Public Instruction,John Cox,DEM,140074,12,23,252,287,
Cleveland,Superintendent of Public Instruction,Joy Hofmeister,REP,140074,10,12,326,348,
Cleveland,Commissioner of Labor,Mike Workman,DEM,140074,8,16,212,236,
Cleveland,Commissioner of Labor,Mark Costello,REP,140074,16,19,357,392,
Cleveland,U.S. Senate,Matt Silverstein,DEM,140074,11,15,199,225,
Cleveland,U.S. Senate,Jim Inhofe,REP,140074,14,18,366,398,
Cleveland,U.S. Senate,Aaron Delozier,IND,140074,0,1,4,5,
Cleveland,U.S. Senate,Ray Woods,IND,140074,0,0,4,4,
Cleveland,U.S. Senate,Joan Farr,IND,140074,0,0,10,10,
Cleveland,U.S. Senate,Connie Johnson,DEM,140074,10,14,199,223,
Cleveland,U.S. Senate,James Lankford,REP,140074,15,19,363,397,
Cleveland,U.S. Senate,Mark Beard,IND,140074,0,2,22,24,
Cleveland,U.S. House,Bert Smith,DEM,140074,8,13,159,180,04
Cleveland,U.S. House,Tom Cole,REP,140074,14,21,397,432,04
Cleveland,U.S. House,Dennis Johnson,IND,140074,2,1,26,29,04
Cleveland,State House,Scott Martin,REP,140074,16,22,373,411,46
Cleveland,State House,Scott Brockman,IND,140074,6,9,178,193,46
Cleveland,Governor,Joe Dorman,DEM,140076,8,15,289,312,
Cleveland,Governor,Mary Fallin,REP,140076,6,21,230,257,
Cleveland,Governor,Kimberly Willis,IND,140076,1,0,20,21,
Cleveland,Governor,Richard Prawdzienski,IND,140076,0,1,9,10,
Cleveland,Lieutenant Governor,Cathy Cummings,DEM,140076,7,14,235,256,
Cleveland,Lieutenant Governor,Todd Lamb,REP,140076,7,23,310,340,
Cleveland,Superintendent of Public Instruction,John Cox,DEM,140076,10,14,278,302,
Cleveland,Superintendent of Public Instruction,Joy Hofmeister,REP,140076,5,23,265,293,
Cleveland,Commissioner of Labor,Mike Workman,DEM,140076,8,10,250,268,
Cleveland,Commissioner of Labor,Mark Costello,REP,140076,7,27,288,322,
Cleveland,U.S. Senate,Matt Silverstein,DEM,140076,6,11,215,232,
Cleveland,U.S. Senate,Jim Inhofe,REP,140076,8,24,303,335,
Cleveland,U.S. Senate,Aaron Delozier,IND,140076,0,1,6,7,
Cleveland,U.S. Senate,Ray Woods,IND,140076,1,0,2,3,
Cleveland,U.S. Senate,Joan Farr,IND,140076,0,0,18,18,
Cleveland,U.S. Senate,Connie Johnson,DEM,140076,8,13,226,247,
Cleveland,U.S. Senate,James Lankford,REP,140076,6,23,301,330,
Cleveland,U.S. Senate,Mark Beard,IND,140076,1,1,20,22,
Cleveland,U.S. House,Bert Smith,DEM,140076,7,9,183,199,04
Cleveland,U.S. House,Tom Cole,REP,140076,7,26,329,362,04
Cleveland,U.S. House,Dennis Johnson,IND,140076,1,2,33,36,04
Cleveland,State House,Scott Martin,REP,140076,7,28,295,330,46
Cleveland,State House,Scott Brockman,IND,140076,7,8,215,230,46
Cleveland,Governor,Joe Dorman,DEM,140077,2,1,98,101,
Cleveland,Governor,Mary Fallin,REP,140077,2,4,57,63,
Cleveland,Governor,Kimberly Willis,IND,140077,0,1,7,8,
Cleveland,Governor,Richard Prawdzienski,IND,140077,0,0,4,4,
Cleveland,Lieutenant Governor,Cathy Cummings,DEM,140077,2,1,89,92,
Cleveland,Lieutenant Governor,Todd Lamb,REP,140077,2,5,75,82,
Cleveland,Superintendent of Public Instruction,John Cox,DEM,140077,2,1,90,93,
Cleveland,Superintendent of Public Instruction,Joy Hofmeister,REP,140077,2,5,73,80,
Cleveland,Commissioner of Labor,Mike Workman,DEM,140077,2,1,87,90,
Cleveland,Commissioner of Labor,Mark Costello,REP,140077,2,5,74,81,
Cleveland,U.S. Senate,Matt Silverstein,DEM,140077,2,1,77,80,
Cleveland,U.S. Senate,Jim Inhofe,REP,140077,2,5,80,87,
Cleveland,U.S. Senate,Aaron Delozier,IND,140077,0,0,4,4,
Cleveland,U.S. Senate,Ray Woods,IND,140077,0,0,1,1,
Cleveland,U.S. Senate,Joan Farr,IND,140077,0,0,2,2,
Cleveland,U.S. Senate,Connie Johnson,DEM,140077,2,1,89,92,
Cleveland,U.S. Senate,James Lankford,REP,140077,1,5,70,76,
Cleveland,U.S. Senate,Mark Beard,IND,140077,1,0,7,8,
Cleveland,U.S. House,Bert Smith,DEM,140077,2,1,73,76,04
Cleveland,U.S. House,Tom Cole,REP,140077,2,4,85,91,04
Cleveland,U.S. House,Dennis Johnson,IND,140077,0,1,7,8,04
Cleveland,State House,Scott Martin,REP,140077,2,5,71,78,46
Cleveland,State House,Scott Brockman,IND,140077,2,0,82,84,46
Cleveland,Governor,Joe Dorman,DEM,140078,7,4,182,193,
Cleveland,Governor,Mary Fallin,REP,140078,34,12,572,618,
Cleveland,Governor,Kimberly Willis,IND,140078,1,0,18,19,
Cleveland,Governor,Richard Prawdzienski,IND,140078,0,1,8,9,
Cleveland,Lieutenant Governor,Cathy Cummings,DEM,140078,4,4,129,137,
Cleveland,Lieutenant Governor,Todd Lamb,REP,140078,38,13,655,706,
Cleveland,Superintendent of Public Instruction,John Cox,DEM,140078,15,5,208,228,
Cleveland,Superintendent of Public Instruction,Joy Hofmeister,REP,140078,26,12,571,609,
Cleveland,Commissioner of Labor,Mike Workman,DEM,140078,6,6,145,157,
Cleveland,Commissioner of Labor,Mark Costello,REP,140078,33,11,616,660,
Cleveland,U.S. Senate,Matt Silverstein,DEM,140078,4,4,101,109,
Cleveland,U.S. Senate,Jim Inhofe,REP,140078,38,12,644,694,
Cleveland,U.S. Senate,Aaron Delozier,IND,140078,0,0,8,8,
Cleveland,U.S. Senate,Ray Woods,IND,140078,0,0,14,14,
Cleveland,U.S. Senate,Joan Farr,IND,140078,0,1,15,16,
Cleveland,U.S. Senate,Connie Johnson,DEM,140078,2,4,112,118,
Cleveland,U.S. Senate,James Lankford,REP,140078,38,13,644,695,
Cleveland,U.S. Senate,Mark Beard,IND,140078,2,0,27,29,
Cleveland,U.S. House,Bert Smith,DEM,140078,4,4,91,99,04
Cleveland,U.S. House,Tom Cole,REP,140078,37,12,644,693,04
Cleveland,U.S. House,Dennis Johnson,IND,140078,1,1,49,51,04
Cleveland,Governor,Joe Dorman,DEM,140080,2,1,55,58,
Cleveland,Governor,Mary Fallin,REP,140080,7,8,142,157,
Cleveland,Governor,Kimberly Willis,IND,140080,0,0,3,3,
Cleveland,Governor,Richard Prawdzienski,IND,140080,0,0,1,1,
Cleveland,Lieutenant Governor,Cathy Cummings,DEM,140080,1,1,32,34,
Cleveland,Lieutenant Governor,Todd Lamb,REP,140080,8,8,168,184,
Cleveland,Superintendent of Public Instruction,John Cox,DEM,140080,5,1,55,61,
Cleveland,Superintendent of Public Instruction,Joy Hofmeister,REP,140080,4,8,143,155,
Cleveland,Commissioner of Labor,Mike Workman,DEM,140080,3,1,40,44,
Cleveland,Commissioner of Labor,Mark Costello,REP,140080,6,8,152,166,
Cleveland,U.S. Senate,Matt Silverstein,DEM,140080,2,1,27,30,
Cleveland,U.S. Senate,Jim Inhofe,REP,140080,6,8,163,177,
Cleveland,U.S. Senate,Aaron Delozier,IND,140080,0,0,0,0,
Cleveland,U.S. Senate,Ray Woods,IND,140080,1,0,6,7,
Cleveland,U.S. Senate,Joan Farr,IND,140080,0,0,4,4,
Cleveland,U.S. Senate,Connie Johnson,DEM,140080,1,1,29,31,
Cleveland,U.S. Senate,James Lankford,REP,140080,8,8,163,179,
Cleveland,U.S. Senate,Mark Beard,IND,140080,0,0,6,6,
Cleveland,U.S. House,Bert Smith,DEM,140080,1,1,30,32,04
Cleveland,U.S. House,Tom Cole,REP,140080,7,8,163,178,04
Cleveland,U.S. House,Dennis Johnson,IND,140080,1,0,7,8,04
Cleveland,Governor,Joe Dorman,DEM,140081,38,63,493,594,
Cleveland,Governor,Mary Fallin,REP,140081,44,46,309,399,
Cleveland,Governor,Kimberly Willis,IND,140081,0,1,20,21,
Cleveland,Governor,Richard Prawdzienski,IND,140081,0,0,9,9,
Cleveland,Lieutenant Governor,Cathy Cummings,DEM,140081,41,60,431,532,
Cleveland,Lieutenant Governor,Todd Lamb,REP,140081,40,49,393,482,
Cleveland,Superintendent of Public Instruction,John Cox,DEM,140081,39,60,484,583,
Cleveland,Superintendent of Public Instruction,Joy Hofmeister,REP,140081,41,48,343,432,
Cleveland,Commissioner of Labor,Mike Workman,DEM,140081,37,61,421,519,
Cleveland,Commissioner of Labor,Mark Costello,REP,140081,42,48,389,479,
Cleveland,U.S. Senate,Matt Silverstein,DEM,140081,35,56,401,492,
Cleveland,U.S. Senate,Jim Inhofe,REP,140081,42,49,399,490,
Cleveland,U.S. Senate,Aaron Delozier,IND,140081,0,1,10,11,
Cleveland,U.S. Senate,Ray Woods,IND,140081,0,1,7,8,
Cleveland,U.S. Senate,Joan Farr,IND,140081,3,2,12,17,
Cleveland,U.S. Senate,Connie Johnson,DEM,140081,39,57,418,514,
Cleveland,U.S. Senate,James Lankford,REP,140081,40,51,389,480,
Cleveland,U.S. Senate,Mark Beard,IND,140081,3,1,26,30,
Cleveland,U.S. House,Bert Smith,DEM,140081,34,49,362,445,04
Cleveland,U.S. House,Tom Cole,REP,140081,44,55,425,524,04
Cleveland,U.S. House,Dennis Johnson,IND,140081,3,5,38,46,04
Cleveland,State House,Claudia Griffith,DEM,140081,42,67,428,537,45
Cleveland,State House,Aaron Stiles,REP,140081,39,43,399,481,45
Cleveland,Governor,Joe Dorman,DEM,140082,15,58,521,594,
Cleveland,Governor,Mary Fallin,REP,140082,17,31,408,456,
Cleveland,Governor,Kimberly Willis,IND,140082,0,0,16,16,
Cleveland,Governor,Richard Prawdzienski,IND,140082,0,3,8,11,
Cleveland,Lieutenant Governor,Cathy Cummings,DEM,140082,16,48,423,487,
Cleveland,Lieutenant Governor,Todd Lamb,REP,140082,16,43,524,583,
Cleveland,Superintendent of Public Instruction,John Cox,DEM,140082,15,57,499,571,
Cleveland,Superintendent of Public Instruction,Joy Hofmeister,REP,140082,15,34,445,494,
Cleveland,Commissioner of Labor,Mike Workman,DEM,140082,15,49,418,482,
Cleveland,Commissioner of Labor,Mark Costello,REP,140082,17,39,499,555,
Cleveland,U.S. Senate,Matt Silverstein,DEM,140082,14,50,384,448,
Cleveland,U.S. Senate,Jim Inhofe,REP,140082,17,40,522,579,
Cleveland,U.S. Senate,Aaron Delozier,IND,140082,0,1,12,13,
Cleveland,U.S. Senate,Ray Woods,IND,140082,0,0,15,15,
Cleveland,U.S. Senate,Joan Farr,IND,140082,0,1,13,14,
Cleveland,U.S. Senate,Connie Johnson,DEM,140082,15,50,394,459,
Cleveland,U.S. Senate,James Lankford,REP,140082,17,39,525,581,
Cleveland,U.S. Senate,Mark Beard,IND,140082,0,3,32,35,
Cleveland,U.S. House,Bert Smith,DEM,140082,13,42,334,389,04
Cleveland,U.S. House,Tom Cole,REP,140082,17,45,562,624,04
Cleveland,U.S. House,Dennis Johnson,IND,140082,1,4,51,56,04
Cleveland,State House,Claudia Griffith,DEM,140082,17,65,448,530,45
Cleveland,State House,Aaron Stiles,REP,140082,15,26,494,535,45
Cleveland,Governor,Joe Dorman,DEM,140083,5,4,108,117,
Cleveland,Governor,Mary Fallin,REP,140083,1,11,147,159,
Cleveland,Governor,Kimberly Willis,IND,140083,0,0,2,2,
Cleveland,Governor,Richard Prawdzienski,IND,140083,0,0,3,3,
Cleveland,Lieutenant Governor,Cathy Cummings,DEM,140083,5,5,88,98,
Cleveland,Lieutenant Governor,Todd Lamb,REP,140083,1,10,170,181,
Cleveland,Superintendent of Public Instruction,John Cox,DEM,140083,5,5,119,129,
Cleveland,Superintendent of Public Instruction,Joy Hofmeister,REP,140083,1,10,142,153,
Cleveland,Commissioner of Labor,Mike Workman,DEM,140083,3,4,95,102,
Cleveland,Commissioner of Labor,Mark Costello,REP,140083,2,11,154,167,
Cleveland,U.S. Senate,Matt Silverstein,DEM,140083,4,4,79,87,
Cleveland,U.S. Senate,Jim Inhofe,REP,140083,1,11,172,184,
Cleveland,U.S. Senate,Aaron Delozier,IND,140083,0,0,1,1,
Cleveland,U.S. Senate,Ray Woods,IND,140083,1,0,2,3,
Cleveland,U.S. Senate,Joan Farr,IND,140083,0,0,4,4,
Cleveland,U.S. Senate,Connie Johnson,DEM,140083,4,4,81,89,
Cleveland,U.S. Senate,James Lankford,REP,140083,2,11,172,185,
Cleveland,U.S. Senate,Mark Beard,IND,140083,0,0,6,6,
Cleveland,U.S. House,Bert Smith,DEM,140083,4,3,67,74,04
Cleveland,U.S. House,Tom Cole,REP,140083,1,9,178,188,04
Cleveland,U.S. House,Dennis Johnson,IND,140083,1,2,14,17,04
Cleveland,State House,Joni Johnson,DEM,140083,5,6,83,94,20
Cleveland,State House,Bobby Cleveland,REP,140083,1,9,174,184,20
Cleveland,Governor,Joe Dorman,DEM,140086,9,20,335,364,
Cleveland,Governor,Mary Fallin,REP,140086,26,28,550,604,
Cleveland,Governor,Kimberly Willis,IND,140086,1,0,20,21,
Cleveland,Governor,Richard Prawdzienski,IND,140086,0,0,7,7,
Cleveland,Lieutenant Governor,Cathy Cummings,DEM,140086,14,11,241,266,
Cleveland,Lieutenant Governor,Todd Lamb,REP,140086,23,37,671,731,
Cleveland,Superintendent of Public Instruction,John Cox,DEM,140086,12,17,364,393,
Cleveland,Superintendent of Public Instruction,Joy Hofmeister,REP,140086,24,30,547,601,
Cleveland,Commissioner of Labor,Mike Workman,DEM,140086,9,13,261,283,
Cleveland,Commissioner of Labor,Mark Costello,REP,140086,25,33,630,688,
Cleveland,U.S. Senate,Matt Silverstein,DEM,140086,11,9,195,215,
Cleveland,U.S. Senate,Jim Inhofe,REP,140086,25,36,691,752,
Cleveland,U.S. Senate,Aaron Delozier,IND,140086,0,2,7,9,
Cleveland,U.S. Senate,Ray Woods,IND,140086,0,0,7,7,
Cleveland,U.S. Senate,Joan Farr,IND,140086,1,1,10,12,
Cleveland,U.S. Senate,Connie Johnson,DEM,140086,9,8,205,222,
Cleveland,U.S. Senate,James Lankford,REP,140086,28,39,692,759,
Cleveland,U.S. Senate,Mark Beard,IND,140086,0,1,22,23,
Cleveland,U.S. House,Bert Smith,DEM,140086,6,5,180,191,04
Cleveland,U.S. House,Tom Cole,REP,140086,30,40,703,773,04
Cleveland,U.S. House,Dennis Johnson,IND,140086,1,3,32,36,04
Cleveland,State House,Trey Puckett,DEM,140086,11,4,213,228,91
Cleveland,State House,Chris Kannady,REP,140086,25,44,690,759,91
Cleveland,Governor,Joe Dorman,DEM,140087,5,1,106,112,
Cleveland,Governor,Mary Fallin,REP,140087,16,2,235,253,
Cleveland,Governor,Kimberly Willis,IND,140087,0,0,3,3,
Cleveland,Governor,Richard Prawdzienski,IND,140087,0,0,7,7,
Cleveland,Lieutenant Governor,Cathy Cummings,DEM,140087,5,0,78,83,
Cleveland,Lieutenant Governor,Todd Lamb,REP,140087,16,3,272,291,
Cleveland,Superintendent of Public Instruction,John Cox,DEM,140087,5,1,107,113,
Cleveland,Superintendent of Public Instruction,Joy Hofmeister,REP,140087,16,1,242,259,
Cleveland,Commissioner of Labor,Mike Workman,DEM,140087,6,0,77,83,
Cleveland,Commissioner of Labor,Mark Costello,REP,140087,15,2,265,282,
Cleveland,U.S. Senate,Matt Silverstein,DEM,140087,4,0,69,73,
Cleveland,U.S. Senate,Jim Inhofe,REP,140087,16,3,269,288,
Cleveland,U.S. Senate,Aaron Delozier,IND,140087,0,0,4,4,
Cleveland,U.S. Senate,Ray Woods,IND,140087,0,0,2,2,
Cleveland,U.S. Senate,Joan Farr,IND,140087,0,0,6,6,
Cleveland,U.S. Senate,Connie Johnson,DEM,140087,3,0,68,71,
Cleveland,U.S. Senate,James Lankford,REP,140087,17,3,273,293,
Cleveland,U.S. Senate,Mark Beard,IND,140087,1,0,9,10,
Cleveland,U.S. House,Bert Smith,DEM,140087,3,0,59,62,04
Cleveland,U.S. House,Tom Cole,REP,140087,16,3,273,292,04
Cleveland,U.S. House,Dennis Johnson,IND,140087,1,0,17,18,04
Cleveland,Governor,Joe Dorman,DEM,140088,9,15,345,369,
Cleveland,Governor,Mary Fallin,REP,140088,27,24,628,679,
Cleveland,Governor,Kimberly Willis,IND,140088,2,2,22,26,
Cleveland,Governor,Richard Prawdzienski,IND,140088,1,0,4,5,
Cleveland,Lieutenant Governor,Cathy Cummings,DEM,140088,9,11,234,254,
Cleveland,Lieutenant Governor,Todd Lamb,REP,140088,30,30,772,832,
Cleveland,Superintendent of Public Instruction,John Cox,DEM,140088,12,18,360,390,
Cleveland,Superintendent of Public Instruction,Joy Hofmeister,REP,140088,26,23,641,690,
Cleveland,Commissioner of Labor,Mike Workman,DEM,140088,7,12,259,278,
Cleveland,Commissioner of Labor,Mark Costello,REP,140088,32,29,719,780,
Cleveland,U.S. Senate,Matt Silverstein,DEM,140088,7,10,213,230,
Cleveland,U.S. Senate,Jim Inhofe,REP,140088,30,29,759,818,
Cleveland,U.S. Senate,Aaron Delozier,IND,140088,0,1,6,7,
Cleveland,U.S. Senate,Ray Woods,IND,140088,0,1,13,14,
Cleveland,U.S. Senate,Joan Farr,IND,140088,2,0,12,14,
Cleveland,U.S. Senate,Connie Johnson,DEM,140088,5,11,192,208,
Cleveland,U.S. Senate,James Lankford,REP,140088,31,29,794,854,
Cleveland,U.S. Senate,Mark Beard,IND,140088,3,1,21,25,
Cleveland,U.S. House,Bert Smith,DEM,140088,6,8,182,196,04
Cleveland,U.S. House,Tom Cole,REP,140088,30,32,788,850,04
Cleveland,U.S. House,Dennis Johnson,IND,140088,3,1,31,35,04
Cleveland,State House,Trey Puckett,DEM,140088,8,9,216,233,91
Cleveland,State House,Chris Kannady,REP,140088,31,32,779,842,91
Cleveland,Governor,Joe Dorman,DEM,140089,13,21,369,403,
Cleveland,Governor,Mary Fallin,REP,140089,39,39,538,616,
Cleveland,Governor,Kimberly Willis,IND,140089,2,0,20,22,
Cleveland,Governor,Richard Prawdzienski,IND,140089,1,1,16,18,
Cleveland,Lieutenant Governor,Cathy Cummings,DEM,140089,12,18,272,302,
Cleveland,Lieutenant Governor,Todd Lamb,REP,140089,43,42,669,754,
Cleveland,Superintendent of Public Instruction,John Cox,DEM,140089,17,25,360,402,
Cleveland,Superintendent of Public Instruction,Joy Hofmeister,REP,140089,37,36,578,651,
Cleveland,Commissioner of Labor,Mike Workman,DEM,140089,14,22,277,313,
Cleveland,Commissioner of Labor,Mark Costello,REP,140089,38,36,651,725,
Cleveland,U.S. Senate,Matt Silverstein,DEM,140089,8,16,249,273,
Cleveland,U.S. Senate,Jim Inhofe,REP,140089,43,42,653,738,
Cleveland,U.S. Senate,Aaron Delozier,IND,140089,1,1,9,11,
Cleveland,U.S. Senate,Ray Woods,IND,140089,0,1,17,18,
Cleveland,U.S. Senate,Joan Farr,IND,140089,3,0,15,18,
Cleveland,U.S. Senate,Connie Johnson,DEM,140089,8,16,247,271,
Cleveland,U.S. Senate,James Lankford,REP,140089,42,43,672,757,
Cleveland,U.S. Senate,Mark Beard,IND,140089,5,2,26,33,
Cleveland,U.S. House,Bert Smith,DEM,140089,7,12,202,221,04
Cleveland,U.S. House,Tom Cole,REP,140089,45,45,699,789,04
Cleveland,U.S. House,Dennis Johnson,IND,140089,3,2,43,48,04
Cleveland,Governor,Joe Dorman,DEM,140090,0,0,0,0,
Cleveland,Governor,Mary Fallin,REP,140090,0,0,0,0,
Cleveland,Governor,Kimberly Willis,IND,140090,0,0,0,0,
Cleveland,Governor,Richard Prawdzienski,IND,140090,0,0,0,0,
Cleveland,Lieutenant Governor,Cathy Cummings,DEM,140090,0,0,0,0,
Cleveland,Lieutenant Governor,Todd Lamb,REP,140090,0,0,0,0,
Cleveland,Superintendent of Public Instruction,John Cox,DEM,140090,0,0,0,0,
Cleveland,Superintendent of Public Instruction,Joy Hofmeister,REP,140090,0,0,0,0,
Cleveland,Commissioner of Labor,Mike Workman,DEM,140090,0,0,0,0,
Cleveland,Commissioner of Labor,Mark Costello,REP,140090,0,0,0,0,
Cleveland,U.S. Senate,Matt Silverstein,DEM,140090,0,0,0,0,
Cleveland,U.S. Senate,Jim Inhofe,REP,140090,0,0,0,0,
Cleveland,U.S. Senate,Aaron Delozier,IND,140090,0,0,0,0,
Cleveland,U.S. Senate,Ray Woods,IND,140090,0,0,0,0,
Cleveland,U.S. Senate,Joan Farr,IND,140090,0,0,0,0,
Cleveland,U.S. Senate,Connie Johnson,DEM,140090,0,0,0,0,
Cleveland,U.S. Senate,James Lankford,REP,140090,0,0,0,0,
Cleveland,U.S. Senate,Mark Beard,IND,140090,0,0,0,0,
Cleveland,U.S. House,Bert Smith,DEM,140090,0,0,0,0,04
Cleveland,U.S. House,Tom Cole,REP,140090,0,0,0,0,04
Cleveland,U.S. House,Dennis Johnson,IND,140090,0,0,0,0,04
Cleveland,Governor,Joe Dorman,DEM,140091,3,1,20,24,
Cleveland,Governor,Mary Fallin,REP,140091,0,7,56,63,
Cleveland,Governor,Kimberly Willis,IND,140091,0,0,1,1,
Cleveland,Governor,Richard Prawdzienski,IND,140091,0,0,0,0,
Cleveland,Lieutenant Governor,Cathy Cummings,DEM,140091,3,0,15,18,
Cleveland,Lieutenant Governor,Todd Lamb,REP,140091,0,8,62,70,
Cleveland,Superintendent of Public Instruction,John Cox,DEM,140091,3,0,28,31,
Cleveland,Superintendent of Public Instruction,Joy Hofmeister,REP,140091,0,8,48,56,
Cleveland,Commissioner of Labor,Mike Workman,DEM,140091,3,0,16,19,
Cleveland,Commissioner of Labor,Mark Costello,REP,140091,0,8,58,66,
Cleveland,U.S. Senate,Matt Silverstein,DEM,140091,2,0,14,16,
Cleveland,U.S. Senate,Jim Inhofe,REP,140091,1,8,62,71,
Cleveland,U.S. Senate,Aaron Delozier,IND,140091,0,0,0,0,
Cleveland,U.S. Senate,Ray Woods,IND,140091,0,0,0,0,
Cleveland,U.S. Senate,Joan Farr,IND,140091,0,0,0,0,
Cleveland,U.S. Senate,Connie Johnson,DEM,140091,3,0,16,19,
Cleveland,U.S. Senate,James Lankford,REP,140091,0,8,60,68,
Cleveland,U.S. Senate,Mark Beard,IND,140091,0,0,1,1,
Cleveland,U.S. House,Bert Smith,DEM,140091,2,1,14,17,04
Cleveland,U.S. House,Tom Cole,REP,140091,1,7,61,69,04
Cleveland,U.S. House,Dennis Johnson,IND,140091,0,0,2,2,04
Cleveland,State House,Scott Martin,REP,140091,0,8,65,73,46
Cleveland,State House,Scott Brockman,IND,140091,3,0,8,11,46
Cleveland,Governor,Joe Dorman,DEM,140092,0,0,1,1,
Cleveland,Governor,Mary Fallin,REP,140092,0,0,1,1,
Cleveland,Governor,Kimberly Willis,IND,140092,0,0,0,0,
Cleveland,Governor,Richard Prawdzienski,IND,140092,0,0,0,0,
Cleveland,Lieutenant Governor,Cathy Cummings,DEM,140092,0,0,1,1,
Cleveland,Lieutenant Governor,Todd Lamb,REP,140092,0,0,1,1,
Cleveland,Superintendent of Public Instruction,John Cox,DEM,140092,0,0,1,1,
Cleveland,Superintendent of Public Instruction,Joy Hofmeister,REP,140092,0,0,1,1,
Cleveland,Commissioner of Labor,Mike Workman,DEM,140092,0,0,1,1,
Cleveland,Commissioner of Labor,Mark Costello,REP,140092,0,0,1,1,
Cleveland,U.S. Senate,Matt Silverstein,DEM,140092,0,0,1,1,
Cleveland,U.S. Senate,Jim Inhofe,REP,140092,0,0,1,1,
Cleveland,U.S. Senate,Aaron Delozier,IND,140092,0,0,0,0,
Cleveland,U.S. Senate,Ray Woods,IND,140092,0,0,0,0,
Cleveland,U.S. Senate,Joan Farr,IND,140092,0,0,0,0,
Cleveland,U.S. Senate,Connie Johnson,DEM,140092,0,0,1,1,
Cleveland,U.S. Senate,James Lankford,REP,140092,0,0,1,1,
Cleveland,U.S. Senate,Mark Beard,IND,140092,0,0,0,0,
Cleveland,U.S. House,Bert Smith,DEM,140092,0,0,1,1,04
Cleveland,U.S. House,Tom Cole,REP,140092,0,0,1,1,04
Cleveland,U.S. House,Dennis Johnson,IND,140092,0,0,0,0,04
Cleveland,State House,Scott Martin,REP,140092,0,0,1,1,46
Cleveland,State House,Scott Brockman,IND,140092,0,0,1,1,46
Cleveland,Governor,Joe Dorman,DEM,140093,12,26,207,245,
Cleveland,Governor,Mary Fallin,REP,140093,5,9,100,114,
Cleveland,Governor,Kimberly Willis,IND,140093,0,0,3,3,
Cleveland,Governor,Richard Prawdzienski,IND,140093,0,1,9,10,
Cleveland,Lieutenant Governor,Cathy Cummings,DEM,140093,12,26,189,227,
Cleveland,Lieutenant Governor,Todd Lamb,REP,140093,6,10,129,145,
Cleveland,Superintendent of Public Instruction,John Cox,DEM,140093,12,28,207,247,
Cleveland,Superintendent of Public Instruction,Joy Hofmeister,REP,140093,6,7,110,123,
Cleveland,Commissioner of Labor,Mike Workman,DEM,140093,10,23,193,226,
Cleveland,Commissioner of Labor,Mark Costello,REP,140093,7,12,121,140,
Cleveland,U.S. Senate,Matt Silverstein,DEM,140093,11,22,182,215,
Cleveland,U.S. Senate,Jim Inhofe,REP,140093,5,12,124,141,
Cleveland,U.S. Senate,Aaron Delozier,IND,140093,0,1,1,2,
Cleveland,U.S. Senate,Ray Woods,IND,140093,1,0,2,3,
Cleveland,U.S. Senate,Joan Farr,IND,140093,0,1,8,9,
Cleveland,U.S. Senate,Connie Johnson,DEM,140093,11,26,182,219,
Cleveland,U.S. Senate,James Lankford,REP,140093,7,10,127,144,
Cleveland,U.S. Senate,Mark Beard,IND,140093,0,0,8,8,
Cleveland,U.S. House,Bert Smith,DEM,140093,8,18,158,184,04
Cleveland,U.S. House,Tom Cole,REP,140093,10,17,142,169,04
Cleveland,U.S. House,Dennis Johnson,IND,140093,0,1,18,19,04
Cleveland,State House,Scott Martin,REP,140093,4,12,129,145,46
Cleveland,State House,Scott Brockman,IND,140093,10,20,148,178,46
Cleveland,Governor,Joe Dorman,DEM,140094,2,10,81,93,
Cleveland,Governor,Mary Fallin,REP,140094,9,17,81,107,
Cleveland,Governor,Kimberly Willis,IND,140094,1,0,2,3,
Cleveland,Governor,Richard Prawdzienski,IND,140094,0,0,2,2,
Cleveland,Lieutenant Governor,Cathy Cummings,DEM,140094,2,8,73,83,
Cleveland,Lieutenant Governor,Todd Lamb,REP,140094,10,19,93,122,
Cleveland,Superintendent of Public Instruction,John Cox,DEM,140094,3,9,79,91,
Cleveland,Superintendent of Public Instruction,Joy Hofmeister,REP,140094,7,17,86,110,
Cleveland,Commissioner of Labor,Mike Workman,DEM,140094,3,9,80,92,
Cleveland,Commissioner of Labor,Mark Costello,REP,140094,7,16,82,105,
Cleveland,U.S. Senate,Matt Silverstein,DEM,140094,2,9,70,81,
Cleveland,U.S. Senate,Jim Inhofe,REP,140094,8,18,93,119,
Cleveland,U.S. Senate,Aaron Delozier,IND,140094,0,0,0,0,
Cleveland,U.S. Senate,Ray Woods,IND,140094,0,0,1,1,
Cleveland,U.S. Senate,Joan Farr,IND,140094,1,0,1,2,
Cleveland,U.S. Senate,Connie Johnson,DEM,140094,3,9,67,79,
Cleveland,U.S. Senate,James Lankford,REP,140094,8,18,94,120,
Cleveland,U.S. Senate,Mark Beard,IND,140094,0,0,5,5,
Cleveland,U.S. House,Bert Smith,DEM,140094,2,6,61,69,04
Cleveland,U.S. House,Tom Cole,REP,140094,7,21,99,127,04
Cleveland,U.S. House,Dennis Johnson,IND,140094,2,0,5,7,04
Cleveland,State House,Claudia Griffith,DEM,140094,3,11,86,100,45
Cleveland,State House,Aaron Stiles,REP,140094,7,16,79,102,45
Cleveland,Governor,Joe Dorman,DEM,140095,4,0,103,107,
Cleveland,Governor,Mary Fallin,REP,140095,4,1,138,143,
Cleveland,Governor,Kimberly Willis,IND,140095,0,0,7,7,
Cleveland,Governor,Richard Prawdzienski,IND,140095,0,0,6,6,
Cleveland,Lieutenant Governor,Cathy Cummings,DEM,140095,1,0,77,78,
Cleveland,Lieutenant Governor,Todd Lamb,REP,140095,6,1,176,183,
Cleveland,Superintendent of Public Instruction,John Cox,DEM,140095,3,0,98,101,
Cleveland,Superintendent of Public Instruction,Joy Hofmeister,REP,140095,5,1,154,160,
Cleveland,Commissioner of Labor,Mike Workman,DEM,140095,3,0,91,94,
Cleveland,Commissioner of Labor,Mark Costello,REP,140095,5,1,150,156,
Cleveland,U.S. Senate,Matt Silverstein,DEM,140095,3,0,67,70,
Cleveland,U.S. Senate,Jim Inhofe,REP,140095,5,1,172,178,
Cleveland,U.S. Senate,Aaron Delozier,IND,140095,0,0,3,3,
Cleveland,U.S. Senate,Ray Woods,IND,140095,0,0,6,6,
Cleveland,U.S. Senate,Joan Farr,IND,140095,0,0,4,4,
Cleveland,U.S. Senate,Connie Johnson,DEM,140095,3,0,65,68,
Cleveland,U.S. Senate,James Lankford,REP,140095,5,1,177,183,
Cleveland,U.S. Senate,Mark Beard,IND,140095,0,0,12,12,
Cleveland,U.S. House,Bert Smith,DEM,140095,3,0,58,61,04
Cleveland,U.S. House,Tom Cole,REP,140095,5,1,181,187,04
Cleveland,U.S. House,Dennis Johnson,IND,140095,0,0,14,14,04
Cleveland,State House,Joni Johnson,DEM,140095,3,0,77,80,20
Cleveland,State House,Bobby Cleveland,REP,140095,5,1,176,182,20
Coal,Governor,Joe Dorman,DEM,150002,0,2,135,137,
Coal,Governor,Mary Fallin,REP,150002,0,6,93,99,
Coal,Governor,Kimberly Willis,IND,150002,0,0,3,3,
Coal,Governor,Richard Prawdzienski,IND,150002,0,0,2,2,
Coal,Lieutenant Governor,Cathy Cummings,DEM,150002,0,0,107,107,
Coal,Lieutenant Governor,Todd Lamb,REP,150002,0,7,127,134,
Coal,Superintendent of Public Instruction,John Cox,DEM,150002,0,0,152,152,
Coal,Superintendent of Public Instruction,Joy Hofmeister,REP,150002,0,8,82,90,
Coal,Commissioner of Labor,Mike Workman,DEM,150002,0,0,123,123,
Coal,Commissioner of Labor,Mark Costello,REP,150002,0,8,108,116,
Coal,U.S. Senate,Matt Silverstein,DEM,150002,0,1,76,77,
Coal,U.S. Senate,Jim Inhofe,REP,150002,0,6,144,150,
Coal,U.S. Senate,Aaron Delozier,IND,150002,0,1,2,3,
Coal,U.S. Senate,Ray Woods,IND,150002,0,0,8,8,
Coal,U.S. Senate,Joan Farr,IND,150002,0,0,4,4,
Coal,U.S. Senate,Connie Johnson,DEM,150002,0,0,75,75,
Coal,U.S. Senate,James Lankford,REP,150002,0,7,144,151,
Coal,U.S. Senate,Mark Beard,IND,150002,0,1,14,15,
Coal,U.S. House,Earl Everett,DEM,150002,0,0,84,84,02
Coal,U.S. House,Markwayne Mullin,REP,150002,0,7,144,151,02
Coal,U.S. House,Jon Douthitt,IND,150002,0,1,5,6,02
Coal,State Senate,Joe Hill,DEM,150002,0,0,131,131,6
Coal,State Senate,Josh Brecheen,REP,150002,0,7,101,108,6
Coal,State Senate,Vicki Gaylor,IND,150002,0,1,2,3,6
Coal,Governor,Joe Dorman,DEM,150003,3,11,60,74,
Coal,Governor,Mary Fallin,REP,150003,2,5,50,57,
Coal,Governor,Kimberly Willis,IND,150003,0,0,4,4,
Coal,Governor,Richard Prawdzienski,IND,150003,0,0,0,0,
Coal,Lieutenant Governor,Cathy Cummings,DEM,150003,1,8,45,54,
Coal,Lieutenant Governor,Todd Lamb,REP,150003,4,8,67,79,
Coal,Superintendent of Public Instruction,John Cox,DEM,150003,2,12,67,81,
Coal,Superintendent of Public Instruction,Joy Hofmeister,REP,150003,3,4,44,51,
Coal,Commissioner of Labor,Mike Workman,DEM,150003,1,6,62,69,
Coal,Commissioner of Labor,Mark Costello,REP,150003,4,10,45,59,
Coal,U.S. Senate,Matt Silverstein,DEM,150003,0,6,33,39,
Coal,U.S. Senate,Jim Inhofe,REP,150003,3,8,75,86,
Coal,U.S. Senate,Aaron Delozier,IND,150003,0,0,2,2,
Coal,U.S. Senate,Ray Woods,IND,150003,2,1,0,3,
Coal,U.S. Senate,Joan Farr,IND,150003,0,1,2,3,
Coal,U.S. Senate,Connie Johnson,DEM,150003,0,7,43,50,
Coal,U.S. Senate,James Lankford,REP,150003,5,9,60,74,
Coal,U.S. Senate,Mark Beard,IND,150003,0,0,6,6,
Coal,U.S. House,Earl Everett,DEM,150003,2,4,39,45,02
Coal,U.S. House,Markwayne Mullin,REP,150003,3,11,65,79,02
Coal,U.S. House,Jon Douthitt,IND,150003,0,1,5,6,02
Coal,State Senate,Joe Hill,DEM,150003,2,10,50,62,6
Coal,State Senate,Josh Brecheen,REP,150003,3,6,60,69,6
Coal,State Senate,Vicki Gaylor,IND,150003,0,0,3,3,6
Coal,Governor,Joe Dorman,DEM,150004,6,21,118,145,
Coal,Governor,Mary Fallin,REP,150004,2,27,89,118,
Coal,Governor,Kimberly Willis,IND,150004,0,0,2,2,
Coal,Governor,Richard Prawdzienski,IND,150004,0,0,4,4,
Coal,Lieutenant Governor,Cathy Cummings,DEM,150004,0,16,98,114,
Coal,Lieutenant Governor,Todd Lamb,REP,150004,7,32,110,149,
Coal,Superintendent of Public Instruction,John Cox,DEM,150004,3,28,137,168,
Coal,Superintendent of Public Instruction,Joy Hofmeister,REP,150004,4,19,71,94,
Coal,Commissioner of Labor,Mike Workman,DEM,150004,3,18,122,143,
Coal,Commissioner of Labor,Mark Costello,REP,150004,4,30,82,116,
Coal,U.S. Senate,Matt Silverstein,DEM,150004,0,15,65,80,
Coal,U.S. Senate,Jim Inhofe,REP,150004,8,33,136,177,
Coal,U.S. Senate,Aaron Delozier,IND,150004,0,0,2,2,
Coal,U.S. Senate,Ray Woods,IND,150004,0,0,3,3,
Coal,U.S. Senate,Joan Farr,IND,150004,0,0,0,0,
Coal,U.S. Senate,Connie Johnson,DEM,150004,0,18,86,104,
Coal,U.S. Senate,James Lankford,REP,150004,8,28,119,155,
Coal,U.S. Senate,Mark Beard,IND,150004,0,0,4,4,
Coal,U.S. House,Earl Everett,DEM,150004,0,15,67,82,02
Coal,U.S. House,Markwayne Mullin,REP,150004,8,33,134,175,02
Coal,U.S. House,Jon Douthitt,IND,150004,0,0,9,9,02
Coal,State Senate,Joe Hill,DEM,150004,7,24,117,148,6
Coal,State Senate,Josh Brecheen,REP,150004,1,25,97,123,6
Coal,State Senate,Vicki Gaylor,IND,150004,0,1,2,3,6
Coal,Governor,Joe Dorman,DEM,150005,4,34,134,172,
Coal,Governor,Mary Fallin,REP,150005,2,25,96,123,
Coal,Governor,Kimberly Willis,IND,150005,0,3,7,10,
Coal,Governor,Richard Prawdzienski,IND,150005,0,0,2,2,
Coal,Lieutenant Governor,Cathy Cummings,DEM,150005,4,29,115,148,
Coal,Lieutenant Governor,Todd Lamb,REP,150005,2,31,119,152,
Coal,Superintendent of Public Instruction,John Cox,DEM,150005,4,40,147,191,
Coal,Superintendent of Public Instruction,Joy Hofmeister,REP,150005,2,20,90,112,
Coal,Commissioner of Labor,Mike Workman,DEM,150005,4,36,125,165,
Coal,Commissioner of Labor,Mark Costello,REP,150005,2,24,108,134,
Coal,U.S. Senate,Matt Silverstein,DEM,150005,4,18,75,97,
Coal,U.S. Senate,Jim Inhofe,REP,150005,2,37,146,185,
Coal,U.S. Senate,Aaron Delozier,IND,150005,0,1,4,5,
Coal,U.S. Senate,Ray Woods,IND,150005,0,3,8,11,
Coal,U.S. Senate,Joan Farr,IND,150005,0,2,4,6,
Coal,U.S. Senate,Connie Johnson,DEM,150005,4,30,93,127,
Coal,U.S. Senate,James Lankford,REP,150005,2,28,122,152,
Coal,U.S. Senate,Mark Beard,IND,150005,0,3,17,20,
Coal,U.S. House,Earl Everett,DEM,150005,4,23,81,108,02
Coal,U.S. House,Markwayne Mullin,REP,150005,2,34,142,178,02
Coal,U.S. House,Jon Douthitt,IND,150005,0,3,8,11,02
Coal,State Senate,Joe Hill,DEM,150005,4,38,133,175,6
Coal,State Senate,Josh Brecheen,REP,150005,2,22,105,129,6
Coal,State Senate,Vicki Gaylor,IND,150005,0,2,4,6,6
Coal,Governor,Joe Dorman,DEM,150006,1,17,38,56,
Coal,Governor,Mary Fallin,REP,150006,2,9,39,50,
Coal,Governor,Kimberly Willis,IND,150006,1,0,0,1,
Coal,Governor,Richard Prawdzienski,IND,150006,0,0,3,3,
Coal,Lieutenant Governor,Cathy Cummings,DEM,150006,1,16,26,43,
Coal,Lieutenant Governor,Todd Lamb,REP,150006,3,10,49,62,
Coal,Superintendent of Public Instruction,John Cox,DEM,150006,2,21,39,62,
Coal,Superintendent of Public Instruction,Joy Hofmeister,REP,150006,2,5,36,43,
Coal,Commissioner of Labor,Mike Workman,DEM,150006,2,15,40,57,
Coal,Commissioner of Labor,Mark Costello,REP,150006,2,7,36,45,
Coal,U.S. Senate,Matt Silverstein,DEM,150006,2,10,15,27,
Coal,U.S. Senate,Jim Inhofe,REP,150006,2,15,55,72,
Coal,U.S. Senate,Aaron Delozier,IND,150006,0,0,1,1,
Coal,U.S. Senate,Ray Woods,IND,150006,0,0,6,6,
Coal,U.S. Senate,Joan Farr,IND,150006,0,0,2,2,
Coal,U.S. Senate,Connie Johnson,DEM,150006,2,11,27,40,
Coal,U.S. Senate,James Lankford,REP,150006,2,14,38,54,
Coal,U.S. Senate,Mark Beard,IND,150006,0,0,11,11,
Coal,U.S. House,Earl Everett,DEM,150006,1,9,22,32,02
Coal,U.S. House,Markwayne Mullin,REP,150006,2,15,50,67,02
Coal,U.S. House,Jon Douthitt,IND,150006,1,1,5,7,02
Coal,State Senate,Joe Hill,DEM,150006,2,20,43,65,6
Coal,State Senate,Josh Brecheen,REP,150006,2,7,35,44,6
Coal,State Senate,Vicki Gaylor,IND,150006,0,0,2,2,6
Coal,Governor,Joe Dorman,DEM,150007,2,20,72,94,
Coal,Governor,Mary Fallin,REP,150007,2,18,83,103,
Coal,Governor,Kimberly Willis,IND,150007,0,0,7,7,
Coal,Governor,Richard Prawdzienski,IND,150007,0,3,9,12,
Coal,Lieutenant Governor,Cathy Cummings,DEM,150007,2,15,63,80,
Coal,Lieutenant Governor,Todd Lamb,REP,150007,2,25,105,132,
Coal,Superintendent of Public Instruction,John Cox,DEM,150007,3,25,96,124,
Coal,Superintendent of Public Instruction,Joy Hofmeister,REP,150007,1,15,71,87,
Coal,Commissioner of Labor,Mike Workman,DEM,150007,3,19,73,95,
Coal,Commissioner of Labor,Mark Costello,REP,150007,1,22,95,118,
Coal,U.S. Senate,Matt Silverstein,DEM,150007,2,6,38,46,
Coal,U.S. Senate,Jim Inhofe,REP,150007,2,31,123,156,
Coal,U.S. Senate,Aaron Delozier,IND,150007,0,1,1,2,
Coal,U.S. Senate,Ray Woods,IND,150007,0,2,5,7,
Coal,U.S. Senate,Joan Farr,IND,150007,0,1,0,1,
Coal,U.S. Senate,Connie Johnson,DEM,150007,3,9,52,64,
Coal,U.S. Senate,James Lankford,REP,150007,1,27,104,132,
Coal,U.S. Senate,Mark Beard,IND,150007,0,3,9,12,
Coal,U.S. House,Earl Everett,DEM,150007,2,6,41,49,02
Coal,U.S. House,Markwayne Mullin,REP,150007,2,33,120,155,02
Coal,U.S. House,Jon Douthitt,IND,150007,0,0,4,4,02
Coal,State Senate,Joe Hill,DEM,150007,2,19,71,92,6
Coal,State Senate,Josh Brecheen,REP,150007,2,22,95,119,6
Coal,State Senate,Vicki Gaylor,IND,150007,0,0,2,2,6
Coal,Governor,Joe Dorman,DEM,150009,0,4,44,48,
Coal,Governor,Mary Fallin,REP,150009,0,2,36,38,
Coal,Governor,Kimberly Willis,IND,150009,0,0,0,0,
Coal,Governor,Richard Prawdzienski,IND,150009,0,0,1,1,
Coal,Lieutenant Governor,Cathy Cummings,DEM,150009,0,2,37,39,
Coal,Lieutenant Governor,Todd Lamb,REP,150009,0,4,40,44,
Coal,Superintendent of Public Instruction,John Cox,DEM,150009,0,5,56,61,
Coal,Superintendent of Public Instruction,Joy Hofmeister,REP,150009,0,1,18,19,
Coal,Commissioner of Labor,Mike Workman,DEM,150009,0,4,41,45,
Coal,Commissioner of Labor,Mark Costello,REP,150009,0,2,32,34,
Coal,U.S. Senate,Matt Silverstein,DEM,150009,0,2,23,25,
Coal,U.S. Senate,Jim Inhofe,REP,150009,0,4,52,56,
Coal,U.S. Senate,Aaron Delozier,IND,150009,0,0,1,1,
Coal,U.S. Senate,Ray Woods,IND,150009,0,0,1,1,
Coal,U.S. Senate,Joan Farr,IND,150009,0,0,0,0,
Coal,U.S. Senate,Connie Johnson,DEM,150009,0,2,33,35,
Coal,U.S. Senate,James Lankford,REP,150009,0,3,40,43,
Coal,U.S. Senate,Mark Beard,IND,150009,0,0,1,1,
Coal,U.S. House,Earl Everett,DEM,150009,0,2,25,27,02
Coal,U.S. House,Markwayne Mullin,REP,150009,0,4,46,50,02
Coal,U.S. House,Jon Douthitt,IND,150009,0,0,1,1,02
Coal,State Senate,Joe Hill,DEM,150009,0,4,42,46,6
Coal,State Senate,Josh Brecheen,REP,150009,0,2,38,40,6
Coal,State Senate,Vicki Gaylor,IND,150009,0,0,1,1,6
Coal,Governor,Joe Dorman,DEM,150010,0,5,40,45,
Coal,Governor,Mary Fallin,REP,150010,0,4,50,54,
Coal,Governor,Kimberly Willis,IND,150010,0,0,3,3,
Coal,Governor,Richard Prawdzienski,IND,150010,0,0,1,1,
Coal,Lieutenant Governor,Cathy Cummings,DEM,150010,0,2,31,33,
Coal,Lieutenant Governor,Todd Lamb,REP,150010,0,8,56,64,
Coal,Superintendent of Public Instruction,John Cox,DEM,150010,0,5,46,51,
Coal,Superintendent of Public Instruction,Joy Hofmeister,REP,150010,0,5,44,49,
Coal,Commissioner of Labor,Mike Workman,DEM,150010,0,3,43,46,
Coal,Commissioner of Labor,Mark Costello,REP,150010,0,6,42,48,
Coal,U.S. Senate,Matt Silverstein,DEM,150010,0,0,20,20,
Coal,U.S. Senate,Jim Inhofe,REP,150010,0,9,69,78,
Coal,U.S. Senate,Aaron Delozier,IND,150010,0,0,2,2,
Coal,U.S. Senate,Ray Woods,IND,150010,0,0,0,0,
Coal,U.S. Senate,Joan Farr,IND,150010,0,0,1,1,
Coal,U.S. Senate,Connie Johnson,DEM,150010,0,1,26,27,
Coal,U.S. Senate,James Lankford,REP,150010,0,7,58,65,
Coal,U.S. Senate,Mark Beard,IND,150010,0,2,6,8,
Coal,U.S. House,Earl Everett,DEM,150010,0,1,17,18,02
Coal,U.S. House,Markwayne Mullin,REP,150010,0,8,67,75,02
Coal,U.S. House,Jon Douthitt,IND,150010,0,1,6,7,02
Coal,State Senate,Joe Hill,DEM,150010,0,4,30,34,6
Coal,State Senate,Josh Brecheen,REP,150010,0,6,63,69,6
Coal,State Senate,Vicki Gaylor,IND,150010,0,0,2,2,6
Coal,Governor,Joe Dorman,DEM,150011,6,33,127,166,
Coal,Governor,Mary Fallin,REP,150011,0,11,96,107,
Coal,Governor,Kimberly Willis,IND,150011,0,0,6,6,
Coal,Governor,Richard Prawdzienski,IND,150011,0,0,4,4,
Coal,Lieutenant Governor,Cathy Cummings,DEM,150011,6,32,114,152,
Coal,Lieutenant Governor,Todd Lamb,REP,150011,1,8,107,116,
Coal,Superintendent of Public Instruction,John Cox,DEM,150011,7,34,147,188,
Coal,Superintendent of Public Instruction,Joy Hofmeister,REP,150011,0,6,79,85,
Coal,Commissioner of Labor,Mike Workman,DEM,150011,7,33,127,167,
Coal,Commissioner of Labor,Mark Costello,REP,150011,0,7,93,100,
Coal,U.S. Senate,Matt Silverstein,DEM,150011,5,24,75,104,
Coal,U.S. Senate,Jim Inhofe,REP,150011,2,13,143,158,
Coal,U.S. Senate,Aaron Delozier,IND,150011,0,1,4,5,
Coal,U.S. Senate,Ray Woods,IND,150011,0,0,3,3,
Coal,U.S. Senate,Joan Farr,IND,150011,0,2,2,4,
Coal,U.S. Senate,Connie Johnson,DEM,150011,6,27,91,124,
Coal,U.S. Senate,James Lankford,REP,150011,1,7,112,120,
Coal,U.S. Senate,Mark Beard,IND,150011,0,4,17,21,
Coal,U.S. House,Earl Everett,DEM,150011,5,28,81,114,02
Coal,U.S. House,Markwayne Mullin,REP,150011,2,9,138,149,02
Coal,U.S. House,Jon Douthitt,IND,150011,0,3,5,8,02
Coal,State Senate,Joe Hill,DEM,150011,6,34,127,167,6
Coal,State Senate,Josh Brecheen,REP,150011,1,10,102,113,6
Coal,State Senate,Vicki Gaylor,IND,150011,0,1,6,7,6
Comanche,Governor,Joe Dorman,DEM,160001,14,50,331,395,
Comanche,Governor,Mary Fallin,REP,160001,16,34,355,405,
Comanche,Governor,Kimberly Willis,IND,160001,1,0,8,9,
Comanche,Governor,Richard Prawdzienski,IND,160001,1,0,7,8,
Comanche,Lieutenant Governor,Cathy Cummings,DEM,160001,11,27,244,282,
Comanche,Lieutenant Governor,Todd Lamb,REP,160001,19,57,453,529,
Comanche,Superintendent of Public Instruction,John Cox,DEM,160001,14,45,313,372,
Comanche,Superintendent of Public Instruction,Joy Hofmeister,REP,160001,15,39,389,443,
Comanche,Commissioner of Labor,Mike Workman,DEM,160001,15,41,275,331,
Comanche,Commissioner of Labor,Mark Costello,REP,160001,13,42,411,466,
Comanche,U.S. Senate,Matt Silverstein,DEM,160001,11,28,223,262,
Comanche,U.S. Senate,Jim Inhofe,REP,160001,15,53,455,523,
Comanche,U.S. Senate,Aaron Delozier,IND,160001,0,1,4,5,
Comanche,U.S. Senate,Ray Woods,IND,160001,1,2,13,16,
Comanche,U.S. Senate,Joan Farr,IND,160001,3,0,5,8,
Comanche,U.S. Senate,Connie Johnson,DEM,160001,11,30,238,279,
Comanche,U.S. Senate,James Lankford,REP,160001,16,51,442,509,
Comanche,U.S. Senate,Mark Beard,IND,160001,3,2,19,24,
Comanche,U.S. House,Bert Smith,DEM,160001,9,22,199,230,04
Comanche,U.S. House,Tom Cole,REP,160001,17,57,463,537,04
Comanche,U.S. House,Dennis Johnson,IND,160001,3,5,37,45,04
Comanche,State House,John Dunaway,DEM,160001,14,39,271,324,62
Comanche,State House,John Michael Montgomery,REP,160001,15,45,427,487,62
Comanche,Governor,Joe Dorman,DEM,160002,10,44,272,326,
Comanche,Governor,Mary Fallin,REP,160002,6,42,241,289,
Comanche,Governor,Kimberly Willis,IND,160002,0,4,11,15,
Comanche,Governor,Richard Prawdzienski,IND,160002,0,1,4,5,
Comanche,Lieutenant Governor,Cathy Cummings,DEM,160002,8,39,228,275,
Comanche,Lieutenant Governor,Todd Lamb,REP,160002,8,52,300,360,
Comanche,Superintendent of Public Instruction,John Cox,DEM,160002,8,43,267,318,
Comanche,Superintendent of Public Instruction,Joy Hofmeister,REP,160002,8,48,260,316,
Comanche,Commissioner of Labor,Mike Workman,DEM,160002,8,39,256,303,
Comanche,Commissioner of Labor,Mark Costello,REP,160002,8,51,267,326,
Comanche,U.S. Senate,Matt Silverstein,DEM,160002,8,37,204,249,
Comanche,U.S. Senate,Jim Inhofe,REP,160002,8,49,304,361,
Comanche,U.S. Senate,Aaron Delozier,IND,160002,0,1,2,3,
Comanche,U.S. Senate,Ray Woods,IND,160002,0,1,5,6,
Comanche,U.S. Senate,Joan Farr,IND,160002,0,2,11,13,
Comanche,U.S. Senate,Connie Johnson,DEM,160002,8,38,230,276,
Comanche,U.S. Senate,James Lankford,REP,160002,8,50,284,342,
Comanche,U.S. Senate,Mark Beard,IND,160002,0,3,13,16,
Comanche,U.S. House,Bert Smith,DEM,160002,8,37,197,242,04
Comanche,U.S. House,Tom Cole,REP,160002,8,51,313,372,04
Comanche,U.S. House,Dennis Johnson,IND,160002,0,3,18,21,04
Comanche,State House,John Dunaway,DEM,160002,8,45,246,299,62
Comanche,State House,John Michael Montgomery,REP,160002,8,46,278,332,62
Comanche,Governor,Joe Dorman,DEM,160003,3,35,208,246,
Comanche,Governor,Mary Fallin,REP,160003,6,23,209,238,
Comanche,Governor,Kimberly Willis,IND,160003,0,0,13,13,
Comanche,Governor,Richard Prawdzienski,IND,160003,1,1,10,12,
Comanche,Lieutenant Governor,Cathy Cummings,DEM,160003,3,30,184,217,
Comanche,Lieutenant Governor,Todd Lamb,REP,160003,7,29,254,290,
Comanche,Superintendent of Public Instruction,John Cox,DEM,160003,4,32,203,239,
Comanche,Superintendent of Public Instruction,Joy Hofmeister,REP,160003,5,27,231,263,
Comanche,Commissioner of Labor,Mike Workman,DEM,160003,2,31,201,234,
Comanche,Commissioner of Labor,Mark Costello,REP,160003,7,28,225,260,
Comanche,U.S. Senate,Matt Silverstein,DEM,160003,3,29,149,181,
Comanche,U.S. Senate,Jim Inhofe,REP,160003,7,27,257,291,
Comanche,U.S. Senate,Aaron Delozier,IND,160003,0,1,6,7,
Comanche,U.S. Senate,Ray Woods,IND,160003,0,0,11,11,
Comanche,U.S. Senate,Joan Farr,IND,160003,0,2,14,16,
Comanche,U.S. Senate,Connie Johnson,DEM,160003,4,31,185,220,
Comanche,U.S. Senate,James Lankford,REP,160003,4,27,225,256,
Comanche,U.S. Senate,Mark Beard,IND,160003,2,0,26,28,
Comanche,U.S. House,Bert Smith,DEM,160003,2,28,149,179,04
Comanche,U.S. House,Tom Cole,REP,160003,7,28,264,299,04
Comanche,U.S. House,Dennis Johnson,IND,160003,1,3,26,30,04
Comanche,State House,John Dunaway,DEM,160003,5,32,192,229,62
Comanche,State House,John Michael Montgomery,REP,160003,4,27,239,270,62
Comanche,Governor,Joe Dorman,DEM,160007,14,34,245,293,
Comanche,Governor,Mary Fallin,REP,160007,7,16,262,285,
Comanche,Governor,Kimberly Willis,IND,160007,0,1,10,11,
Comanche,Governor,Richard Prawdzienski,IND,160007,1,1,9,11,
Comanche,Lieutenant Governor,Cathy Cummings,DEM,160007,12,29,199,240,
Comanche,Lieutenant Governor,Todd Lamb,REP,160007,11,23,325,359,
Comanche,Superintendent of Public Instruction,John Cox,DEM,160007,14,33,233,280,
Comanche,Superintendent of Public Instruction,Joy Hofmeister,REP,160007,9,19,291,319,
Comanche,Commissioner of Labor,Mike Workman,DEM,160007,12,35,229,276,
Comanche,Commissioner of Labor,Mark Costello,REP,160007,11,16,283,310,
Comanche,U.S. Senate,Matt Silverstein,DEM,160007,12,29,170,211,
Comanche,U.S. Senate,Jim Inhofe,REP,160007,11,20,333,364,
Comanche,U.S. Senate,Aaron Delozier,IND,160007,0,0,3,3,
Comanche,U.S. Senate,Ray Woods,IND,160007,0,1,8,9,
Comanche,U.S. Senate,Joan Farr,IND,160007,0,1,9,10,
Comanche,U.S. Senate,Connie Johnson,DEM,160007,12,31,193,236,
Comanche,U.S. Senate,James Lankford,REP,160007,11,19,311,341,
Comanche,U.S. Senate,Mark Beard,IND,160007,0,2,21,23,
Comanche,U.S. House,Bert Smith,DEM,160007,12,25,159,196,04
Comanche,U.S. House,Tom Cole,REP,160007,11,26,348,385,04
Comanche,U.S. House,Dennis Johnson,IND,160007,0,1,17,18,04
Comanche,State House,John Dunaway,DEM,160007,12,31,229,272,62
Comanche,State House,John Michael Montgomery,REP,160007,11,21,294,326,62
Comanche,Governor,Joe Dorman,DEM,160008,12,60,353,425,
Comanche,Governor,Mary Fallin,REP,160008,22,61,376,459,
Comanche,Governor,Kimberly Willis,IND,160008,0,2,16,18,
Comanche,Governor,Richard Prawdzienski,IND,160008,0,3,5,8,
Comanche,Lieutenant Governor,Cathy Cummings,DEM,160008,10,50,279,339,
Comanche,Lieutenant Governor,Todd Lamb,REP,160008,23,76,466,565,
Comanche,Superintendent of Public Instruction,John Cox,DEM,160008,12,56,333,401,
Comanche,Superintendent of Public Instruction,Joy Hofmeister,REP,160008,21,69,407,497,
Comanche,Commissioner of Labor,Mike Workman,DEM,160008,12,54,329,395,
Comanche,Commissioner of Labor,Mark Costello,REP,160008,21,71,399,491,
Comanche,U.S. Senate,Matt Silverstein,DEM,160008,8,43,259,310,
Comanche,U.S. Senate,Jim Inhofe,REP,160008,25,76,457,558,
Comanche,U.S. Senate,Aaron Delozier,IND,160008,0,0,6,6,
Comanche,U.S. Senate,Ray Woods,IND,160008,0,3,10,13,
Comanche,U.S. Senate,Joan Farr,IND,160008,1,4,17,22,
Comanche,U.S. Senate,Connie Johnson,DEM,160008,10,50,294,354,
Comanche,U.S. Senate,James Lankford,REP,160008,23,68,423,514,
Comanche,U.S. Senate,Mark Beard,IND,160008,0,5,27,32,
Comanche,U.S. House,Bert Smith,DEM,160008,8,38,237,283,04
Comanche,U.S. House,Tom Cole,REP,160008,25,82,492,599,04
Comanche,U.S. House,Dennis Johnson,IND,160008,0,6,22,28,04
Comanche,State House,John Dunaway,DEM,160008,12,60,324,396,62
Comanche,State House,John Michael Montgomery,REP,160008,21,66,413,500,62
Comanche,Governor,Joe Dorman,DEM,160009,2,50,341,393,
Comanche,Governor,Mary Fallin,REP,160009,8,47,294,349,
Comanche,Governor,Kimberly Willis,IND,160009,0,1,14,15,
Comanche,Governor,Richard Prawdzienski,IND,160009,0,0,8,8,
Comanche,Lieutenant Governor,Cathy Cummings,DEM,160009,2,39,299,340,
Comanche,Lieutenant Governor,Todd Lamb,REP,160009,8,59,358,425,
Comanche,Superintendent of Public Instruction,John Cox,DEM,160009,3,45,315,363,
Comanche,Superintendent of Public Instruction,Joy Hofmeister,REP,160009,7,52,341,400,
Comanche,Commissioner of Labor,Mike Workman,DEM,160009,2,46,318,366,
Comanche,Commissioner of Labor,Mark Costello,REP,160009,8,52,332,392,
Comanche,U.S. Senate,Matt Silverstein,DEM,160009,2,33,260,295,
Comanche,U.S. Senate,Jim Inhofe,REP,160009,8,61,366,435,
Comanche,U.S. Senate,Aaron Delozier,IND,160009,0,0,11,11,
Comanche,U.S. Senate,Ray Woods,IND,160009,0,1,8,9,
Comanche,U.S. Senate,Joan Farr,IND,160009,0,2,10,12,
Comanche,U.S. Senate,Connie Johnson,DEM,160009,2,43,290,335,
Comanche,U.S. Senate,James Lankford,REP,160009,8,52,339,399,
Comanche,U.S. Senate,Mark Beard,IND,160009,0,3,27,30,
Comanche,U.S. House,Bert Smith,DEM,160009,2,36,236,274,04
Comanche,U.S. House,Tom Cole,REP,160009,8,60,385,453,04
Comanche,U.S. House,Dennis Johnson,IND,160009,0,2,35,37,04
Comanche,State House,John Dunaway,DEM,160009,2,48,313,363,62
Comanche,State House,John Michael Montgomery,REP,160009,8,50,343,401,62
Comanche,Governor,Joe Dorman,DEM,160011,4,32,238,274,
Comanche,Governor,Mary Fallin,REP,160011,4,21,213,238,
Comanche,Governor,Kimberly Willis,IND,160011,0,0,12,12,
Comanche,Governor,Richard Prawdzienski,IND,160011,0,0,6,6,
Comanche,Lieutenant Governor,Cathy Cummings,DEM,160011,4,26,200,230,
Comanche,Lieutenant Governor,Todd Lamb,REP,160011,4,27,269,300,
Comanche,Superintendent of Public Instruction,John Cox,DEM,160011,3,30,234,267,
Comanche,Superintendent of Public Instruction,Joy Hofmeister,REP,160011,5,23,233,261,
Comanche,Commissioner of Labor,Mike Workman,DEM,160011,4,28,216,248,
Comanche,Commissioner of Labor,Mark Costello,REP,160011,4,24,248,276,
Comanche,U.S. Senate,Matt Silverstein,DEM,160011,4,26,195,225,
Comanche,U.S. Senate,Jim Inhofe,REP,160011,4,27,260,291,
Comanche,U.S. Senate,Aaron Delozier,IND,160011,0,0,1,1,
Comanche,U.S. Senate,Ray Woods,IND,160011,0,0,7,7,
Comanche,U.S. Senate,Joan Farr,IND,160011,0,0,4,4,
Comanche,U.S. Senate,Connie Johnson,DEM,160011,4,26,210,240,
Comanche,U.S. Senate,James Lankford,REP,160011,4,27,242,273,
Comanche,U.S. Senate,Mark Beard,IND,160011,0,0,15,15,
Comanche,U.S. House,Bert Smith,DEM,160011,2,25,170,197,04
Comanche,U.S. House,Tom Cole,REP,160011,6,28,280,314,04
Comanche,U.S. House,Dennis Johnson,IND,160011,0,0,17,17,04
Comanche,State House,John Dunaway,DEM,160011,4,28,228,260,62
Comanche,State House,John Michael Montgomery,REP,160011,4,25,236,265,62
Comanche,Governor,Joe Dorman,DEM,160013,15,24,267,306,
Comanche,Governor,Mary Fallin,REP,160013,9,21,284,314,
Comanche,Governor,Kimberly Willis,IND,160013,0,0,22,22,
Comanche,Governor,Richard Prawdzienski,IND,160013,0,0,7,7,
Comanche,Lieutenant Governor,Cathy Cummings,DEM,160013,14,15,247,276,
Comanche,Lieutenant Governor,Todd Lamb,REP,160013,11,30,327,368,
Comanche,Superintendent of Public Instruction,John Cox,DEM,160013,16,20,285,321,
Comanche,Superintendent of Public Instruction,Joy Hofmeister,REP,160013,9,24,288,321,
Comanche,Commissioner of Labor,Mike Workman,DEM,160013,14,22,285,321,
Comanche,Commissioner of Labor,Mark Costello,REP,160013,11,22,280,313,
Comanche,U.S. Senate,Matt Silverstein,DEM,160013,16,13,210,239,
Comanche,U.S. Senate,Jim Inhofe,REP,160013,9,30,330,369,
Comanche,U.S. Senate,Aaron Delozier,IND,160013,0,0,6,6,
Comanche,U.S. Senate,Ray Woods,IND,160013,1,1,16,18,
Comanche,U.S. Senate,Joan Farr,IND,160013,0,1,19,20,
Comanche,U.S. Senate,Connie Johnson,DEM,160013,16,15,256,287,
Comanche,U.S. Senate,James Lankford,REP,160013,10,26,279,315,
Comanche,U.S. Senate,Mark Beard,IND,160013,0,3,37,40,
Comanche,U.S. House,Bert Smith,DEM,160013,14,14,201,229,04
Comanche,U.S. House,Tom Cole,REP,160013,10,28,343,381,04
Comanche,U.S. House,Dennis Johnson,IND,160013,1,3,36,40,04
Comanche,Governor,Joe Dorman,DEM,160014,1,0,12,13,
Comanche,Governor,Mary Fallin,REP,160014,3,1,13,17,
Comanche,Governor,Kimberly Willis,IND,160014,0,0,1,1,
Comanche,Governor,Richard Prawdzienski,IND,160014,0,0,0,0,
Comanche,Lieutenant Governor,Cathy Cummings,DEM,160014,2,0,10,12,
Comanche,Lieutenant Governor,Todd Lamb,REP,160014,2,1,16,19,
Comanche,Superintendent of Public Instruction,John Cox,DEM,160014,1,0,12,13,
Comanche,Superintendent of Public Instruction,Joy Hofmeister,REP,160014,3,1,14,18,
Comanche,Commissioner of Labor,Mike Workman,DEM,160014,2,0,10,12,
Comanche,Commissioner of Labor,Mark Costello,REP,160014,2,1,16,19,
Comanche,U.S. Senate,Matt Silverstein,DEM,160014,0,0,10,10,
Comanche,U.S. Senate,Jim Inhofe,REP,160014,3,1,16,20,
Comanche,U.S. Senate,Aaron Delozier,IND,160014,0,0,0,0,
Comanche,U.S. Senate,Ray Woods,IND,160014,0,0,0,0,
Comanche,U.S. Senate,Joan Farr,IND,160014,1,0,0,1,
Comanche,U.S. Senate,Connie Johnson,DEM,160014,1,0,12,13,
Comanche,U.S. Senate,James Lankford,REP,160014,2,1,14,17,
Comanche,U.S. Senate,Mark Beard,IND,160014,1,0,0,1,
Comanche,U.S. House,Bert Smith,DEM,160014,1,0,9,10,04
Comanche,U.S. House,Tom Cole,REP,160014,2,1,17,20,04
Comanche,U.S. House,Dennis Johnson,IND,160014,1,0,0,1,04
Comanche,State House,Toni Hasenbeck,DEM,160014,2,0,14,16,65
Comanche,State House,Scooter Park,REP,160014,2,1,12,15,65
Comanche,Governor,Joe Dorman,DEM,160015,11,39,201,251,
Comanche,Governor,Mary Fallin,REP,160015,8,41,281,330,
Comanche,Governor,Kimberly Willis,IND,160015,0,0,14,14,
Comanche,Governor,Richard Prawdzienski,IND,160015,0,2,6,8,
Comanche,Lieutenant Governor,Cathy Cummings,DEM,160015,8,29,169,206,
Comanche,Lieutenant Governor,Todd Lamb,REP,160015,11,53,331,395,
Comanche,Superintendent of Public Instruction,John Cox,DEM,160015,9,33,214,256,
Comanche,Superintendent of Public Instruction,Joy Hofmeister,REP,160015,10,49,285,344,
Comanche,Commissioner of Labor,Mike Workman,DEM,160015,10,38,206,254,
Comanche,Commissioner of Labor,Mark Costello,REP,160015,9,43,285,337,
Comanche,U.S. Senate,Matt Silverstein,DEM,160015,7,22,144,173,
Comanche,U.S. Senate,Jim Inhofe,REP,160015,10,56,335,401,
Comanche,U.S. Senate,Aaron Delozier,IND,160015,0,2,7,9,
Comanche,U.S. Senate,Ray Woods,IND,160015,0,0,5,5,
Comanche,U.S. Senate,Joan Farr,IND,160015,2,2,6,10,
Comanche,U.S. Senate,Connie Johnson,DEM,160015,10,30,172,212,
Comanche,U.S. Senate,James Lankford,REP,160015,9,47,300,356,
Comanche,U.S. Senate,Mark Beard,IND,160015,0,3,26,29,
Comanche,U.S. House,Bert Smith,DEM,160015,7,22,136,165,04
Comanche,U.S. House,Tom Cole,REP,160015,11,59,345,415,04
Comanche,U.S. House,Dennis Johnson,IND,160015,1,1,21,23,04
Comanche,Governor,Joe Dorman,DEM,160017,6,38,264,308,
Comanche,Governor,Mary Fallin,REP,160017,11,40,312,363,
Comanche,Governor,Kimberly Willis,IND,160017,0,0,9,9,
Comanche,Governor,Richard Prawdzienski,IND,160017,0,2,9,11,
Comanche,Lieutenant Governor,Cathy Cummings,DEM,160017,5,28,189,222,
Comanche,Lieutenant Governor,Todd Lamb,REP,160017,12,52,404,468,
Comanche,Superintendent of Public Instruction,John Cox,DEM,160017,7,31,241,279,
Comanche,Superintendent of Public Instruction,Joy Hofmeister,REP,160017,10,47,351,408,
Comanche,Commissioner of Labor,Mike Workman,DEM,160017,7,28,223,258,
Comanche,Commissioner of Labor,Mark Costello,REP,160017,10,50,353,413,
Comanche,U.S. Senate,Matt Silverstein,DEM,160017,6,20,160,186,
Comanche,U.S. Senate,Jim Inhofe,REP,160017,11,55,407,473,
Comanche,U.S. Senate,Aaron Delozier,IND,160017,0,0,4,4,
Comanche,U.S. Senate,Ray Woods,IND,160017,0,0,9,9,
Comanche,U.S. Senate,Joan Farr,IND,160017,0,4,14,18,
Comanche,U.S. Senate,Connie Johnson,DEM,160017,5,24,197,226,
Comanche,U.S. Senate,James Lankford,REP,160017,11,53,370,434,
Comanche,U.S. Senate,Mark Beard,IND,160017,1,3,28,32,
Comanche,U.S. House,Bert Smith,DEM,160017,4,17,139,160,04
Comanche,U.S. House,Tom Cole,REP,160017,12,60,427,499,04
Comanche,U.S. House,Dennis Johnson,IND,160017,1,3,26,30,04
Comanche,Governor,Joe Dorman,DEM,160019,2,27,231,260,
Comanche,Governor,Mary Fallin,REP,160019,2,12,203,217,
Comanche,Governor,Kimberly Willis,IND,160019,0,0,16,16,
Comanche,Governor,Richard Prawdzienski,IND,160019,2,1,7,10,
Comanche,Lieutenant Governor,Cathy Cummings,DEM,160019,2,18,160,180,
Comanche,Lieutenant Governor,Todd Lamb,REP,160019,2,22,296,320,
Comanche,Superintendent of Public Instruction,John Cox,DEM,160019,2,21,206,229,
Comanche,Superintendent of Public Instruction,Joy Hofmeister,REP,160019,4,19,247,270,
Comanche,Commissioner of Labor,Mike Workman,DEM,160019,2,20,190,212,
Comanche,Commissioner of Labor,Mark Costello,REP,160019,4,18,259,281,
Comanche,U.S. Senate,Matt Silverstein,DEM,160019,2,13,142,157,
Comanche,U.S. Senate,Jim Inhofe,REP,160019,2,26,293,321,
Comanche,U.S. Senate,Aaron Delozier,IND,160019,0,0,3,3,
Comanche,U.S. Senate,Ray Woods,IND,160019,0,0,4,4,
Comanche,U.S. Senate,Joan Farr,IND,160019,2,1,9,12,
Comanche,U.S. Senate,Connie Johnson,DEM,160019,2,19,172,193,
Comanche,U.S. Senate,James Lankford,REP,160019,4,20,261,285,
Comanche,U.S. Senate,Mark Beard,IND,160019,0,0,18,18,
Comanche,U.S. House,Bert Smith,DEM,160019,2,16,123,141,04
Comanche,U.S. House,Tom Cole,REP,160019,2,22,316,340,04
Comanche,U.S. House,Dennis Johnson,IND,160019,0,1,15,16,04
Comanche,Governor,Joe Dorman,DEM,160020,7,24,183,214,
Comanche,Governor,Mary Fallin,REP,160020,2,17,180,199,
Comanche,Governor,Kimberly Willis,IND,160020,0,1,16,17,
Comanche,Governor,Richard Prawdzienski,IND,160020,0,1,4,5,
Comanche,Lieutenant Governor,Cathy Cummings,DEM,160020,4,17,157,178,
Comanche,Lieutenant Governor,Todd Lamb,REP,160020,5,26,224,255,
Comanche,Superintendent of Public Instruction,John Cox,DEM,160020,4,19,170,193,
Comanche,Superintendent of Public Instruction,Joy Hofmeister,REP,160020,4,22,211,237,
Comanche,Commissioner of Labor,Mike Workman,DEM,160020,6,18,172,196,
Comanche,Commissioner of Labor,Mark Costello,REP,160020,3,23,205,231,
Comanche,U.S. Senate,Matt Silverstein,DEM,160020,3,16,127,146,
Comanche,U.S. Senate,Jim Inhofe,REP,160020,6,27,236,269,
Comanche,U.S. Senate,Aaron Delozier,IND,160020,0,0,4,4,
Comanche,U.S. Senate,Ray Woods,IND,160020,0,0,5,5,
Comanche,U.S. Senate,Joan Farr,IND,160020,0,0,7,7,
Comanche,U.S. Senate,Connie Johnson,DEM,160020,4,19,142,165,
Comanche,U.S. Senate,James Lankford,REP,160020,6,22,212,240,
Comanche,U.S. Senate,Mark Beard,IND,160020,0,2,25,27,
Comanche,U.S. House,Bert Smith,DEM,160020,3,14,121,138,04
Comanche,U.S. House,Tom Cole,REP,160020,6,28,246,280,04
Comanche,U.S. House,Dennis Johnson,IND,160020,0,1,14,15,04
Comanche,Governor,Joe Dorman,DEM,160021,6,34,152,192,
Comanche,Governor,Mary Fallin,REP,160021,2,18,123,143,
Comanche,Governor,Kimberly Willis,IND,160021,0,1,16,17,
Comanche,Governor,Richard Prawdzienski,IND,160021,0,0,5,5,
Comanche,Lieutenant Governor,Cathy Cummings,DEM,160021,6,24,133,163,
Comanche,Lieutenant Governor,Todd Lamb,REP,160021,2,29,162,193,
Comanche,Superintendent of Public Instruction,John Cox,DEM,160021,7,29,142,178,
Comanche,Superintendent of Public Instruction,Joy Hofmeister,REP,160021,1,23,153,177,
Comanche,Commissioner of Labor,Mike Workman,DEM,160021,7,29,138,174,
Comanche,Commissioner of Labor,Mark Costello,REP,160021,1,22,152,175,
Comanche,U.S. Senate,Matt Silverstein,DEM,160021,7,24,102,133,
Comanche,U.S. Senate,Jim Inhofe,REP,160021,1,28,167,196,
Comanche,U.S. Senate,Aaron Delozier,IND,160021,0,0,8,8,
Comanche,U.S. Senate,Ray Woods,IND,160021,0,1,9,10,
Comanche,U.S. Senate,Joan Farr,IND,160021,0,0,11,11,
Comanche,U.S. Senate,Connie Johnson,DEM,160021,7,26,126,159,
Comanche,U.S. Senate,James Lankford,REP,160021,1,25,142,168,
Comanche,U.S. Senate,Mark Beard,IND,160021,0,1,26,27,
Comanche,U.S. House,Bert Smith,DEM,160021,5,23,97,125,04
Comanche,U.S. House,Tom Cole,REP,160021,3,27,173,203,04
Comanche,U.S. House,Dennis Johnson,IND,160021,0,3,25,28,04
Comanche,Governor,Joe Dorman,DEM,160025,5,22,174,201,
Comanche,Governor,Mary Fallin,REP,160025,1,4,21,26,
Comanche,Governor,Kimberly Willis,IND,160025,0,0,3,3,
Comanche,Governor,Richard Prawdzienski,IND,160025,0,0,1,1,
Comanche,Lieutenant Governor,Cathy Cummings,DEM,160025,5,22,170,197,
Comanche,Lieutenant Governor,Todd Lamb,REP,160025,1,4,27,32,
Comanche,Superintendent of Public Instruction,John Cox,DEM,160025,5,21,177,203,
Comanche,Superintendent of Public Instruction,Joy Hofmeister,REP,160025,1,5,20,26,
Comanche,Commissioner of Labor,Mike Workman,DEM,160025,5,21,172,198,
Comanche,Commissioner of Labor,Mark Costello,REP,160025,1,5,25,31,
Comanche,U.S. Senate,Matt Silverstein,DEM,160025,5,20,163,188,
Comanche,U.S. Senate,Jim Inhofe,REP,160025,1,4,30,35,
Comanche,U.S. Senate,Aaron Delozier,IND,160025,0,2,1,3,
Comanche,U.S. Senate,Ray Woods,IND,160025,0,0,3,3,
Comanche,U.S. Senate,Joan Farr,IND,160025,0,0,0,0,
Comanche,U.S. Senate,Connie Johnson,DEM,160025,5,22,176,203,
Comanche,U.S. Senate,James Lankford,REP,160025,1,3,19,23,
Comanche,U.S. Senate,Mark Beard,IND,160025,0,1,4,5,
Comanche,U.S. House,Bert Smith,DEM,160025,5,18,158,181,04
Comanche,U.S. House,Tom Cole,REP,160025,1,6,34,41,04
Comanche,U.S. House,Dennis Johnson,IND,160025,0,2,5,7,04
Comanche,State House,John Dunaway,DEM,160025,5,22,182,209,62
Comanche,State House,John Michael Montgomery,REP,160025,1,4,17,22,62
Comanche,Governor,Joe Dorman,DEM,160026,1,8,93,102,
Comanche,Governor,Mary Fallin,REP,160026,0,12,115,127,
Comanche,Governor,Kimberly Willis,IND,160026,0,0,12,12,
Comanche,Governor,Richard Prawdzienski,IND,160026,0,3,1,4,
Comanche,Lieutenant Governor,Cathy Cummings,DEM,160026,1,7,83,91,
Comanche,Lieutenant Governor,Todd Lamb,REP,160026,0,16,138,154,
Comanche,Superintendent of Public Instruction,John Cox,DEM,160026,1,6,93,100,
Comanche,Superintendent of Public Instruction,Joy Hofmeister,REP,160026,0,17,128,145,
Comanche,Commissioner of Labor,Mike Workman,DEM,160026,1,8,94,103,
Comanche,Commissioner of Labor,Mark Costello,REP,160026,0,15,121,136,
Comanche,U.S. Senate,Matt Silverstein,DEM,160026,0,7,62,69,
Comanche,U.S. Senate,Jim Inhofe,REP,160026,1,12,139,152,
Comanche,U.S. Senate,Aaron Delozier,IND,160026,0,1,5,6,
Comanche,U.S. Senate,Ray Woods,IND,160026,0,2,9,11,
Comanche,U.S. Senate,Joan Farr,IND,160026,0,1,5,6,
Comanche,U.S. Senate,Connie Johnson,DEM,160026,1,6,82,89,
Comanche,U.S. Senate,James Lankford,REP,160026,0,14,121,135,
Comanche,U.S. Senate,Mark Beard,IND,160026,0,3,17,20,
Comanche,U.S. House,Bert Smith,DEM,160026,0,7,59,66,04
Comanche,U.S. House,Tom Cole,REP,160026,1,11,145,157,04
Comanche,U.S. House,Dennis Johnson,IND,160026,0,5,17,22,04
Comanche,State House,Juan Rodriguez,DEM,160026,1,8,87,96,63
Comanche,State House,Jeff Coody,REP,160026,0,15,133,148,63
Comanche,Governor,Joe Dorman,DEM,160027,1,8,90,99,
Comanche,Governor,Mary Fallin,REP,160027,2,10,85,97,
Comanche,Governor,Kimberly Willis,IND,160027,0,0,6,6,
Comanche,Governor,Richard Prawdzienski,IND,160027,0,1,7,8,
Comanche,Lieutenant Governor,Cathy Cummings,DEM,160027,0,9,85,94,
Comanche,Lieutenant Governor,Todd Lamb,REP,160027,3,10,103,116,
Comanche,Superintendent of Public Instruction,John Cox,DEM,160027,1,11,85,97,
Comanche,Superintendent of Public Instruction,Joy Hofmeister,REP,160027,2,8,100,110,
Comanche,Commissioner of Labor,Mike Workman,DEM,160027,1,9,99,109,
Comanche,Commissioner of Labor,Mark Costello,REP,160027,2,10,86,98,
Comanche,U.S. Senate,Matt Silverstein,DEM,160027,0,7,73,80,
Comanche,U.S. Senate,Jim Inhofe,REP,160027,2,10,101,113,
Comanche,U.S. Senate,Aaron Delozier,IND,160027,0,0,1,1,
Comanche,U.S. Senate,Ray Woods,IND,160027,1,2,8,11,
Comanche,U.S. Senate,Joan Farr,IND,160027,0,0,4,4,
Comanche,U.S. Senate,Connie Johnson,DEM,160027,0,9,79,88,
Comanche,U.S. Senate,James Lankford,REP,160027,1,9,92,102,
Comanche,U.S. Senate,Mark Beard,IND,160027,2,1,13,16,
Comanche,U.S. House,Bert Smith,DEM,160027,0,8,64,72,04
Comanche,U.S. House,Tom Cole,REP,160027,2,10,109,121,04
Comanche,U.S. House,Dennis Johnson,IND,160027,1,1,14,16,04
Comanche,Governor,Joe Dorman,DEM,160029,0,15,144,159,
Comanche,Governor,Mary Fallin,REP,160029,0,3,31,34,
Comanche,Governor,Kimberly Willis,IND,160029,0,0,1,1,
Comanche,Governor,Richard Prawdzienski,IND,160029,0,0,1,1,
Comanche,Lieutenant Governor,Cathy Cummings,DEM,160029,0,14,139,153,
Comanche,Lieutenant Governor,Todd Lamb,REP,160029,0,4,37,41,
Comanche,Superintendent of Public Instruction,John Cox,DEM,160029,0,15,141,156,
Comanche,Superintendent of Public Instruction,Joy Hofmeister,REP,160029,0,3,35,38,
Comanche,Commissioner of Labor,Mike Workman,DEM,160029,0,14,139,153,
Comanche,Commissioner of Labor,Mark Costello,REP,160029,0,4,36,40,
Comanche,U.S. Senate,Matt Silverstein,DEM,160029,0,14,129,143,
Comanche,U.S. Senate,Jim Inhofe,REP,160029,0,4,41,45,
Comanche,U.S. Senate,Aaron Delozier,IND,160029,0,0,1,1,
Comanche,U.S. Senate,Ray Woods,IND,160029,0,0,4,4,
Comanche,U.S. Senate,Joan Farr,IND,160029,0,0,2,2,
Comanche,U.S. Senate,Connie Johnson,DEM,160029,0,14,137,151,
Comanche,U.S. Senate,James Lankford,REP,160029,0,4,37,41,
Comanche,U.S. Senate,Mark Beard,IND,160029,0,0,3,3,
Comanche,U.S. House,Bert Smith,DEM,160029,0,12,126,138,04
Comanche,U.S. House,Tom Cole,REP,160029,0,6,44,50,04
Comanche,U.S. House,Dennis Johnson,IND,160029,0,0,7,7,04
Comanche,State House,Juan Rodriguez,DEM,160029,0,15,134,149,63
Comanche,State House,Jeff Coody,REP,160029,0,3,40,43,63
Comanche,Governor,Joe Dorman,DEM,160030,1,11,86,98,
Comanche,Governor,Mary Fallin,REP,160030,1,2,65,68,
Comanche,Governor,Kimberly Willis,IND,160030,0,0,4,4,
Comanche,Governor,Richard Prawdzienski,IND,160030,0,0,0,0,
Comanche,Lieutenant Governor,Cathy Cummings,DEM,160030,0,7,73,80,
Comanche,Lieutenant Governor,Todd Lamb,REP,160030,2,5,82,89,
Comanche,Superintendent of Public Instruction,John Cox,DEM,160030,0,7,86,93,
Comanche,Superintendent of Public Instruction,Joy Hofmeister,REP,160030,2,5,69,76,
Comanche,Commissioner of Labor,Mike Workman,DEM,160030,0,7,83,90,
Comanche,Commissioner of Labor,Mark Costello,REP,160030,2,5,71,78,
Comanche,U.S. Senate,Matt Silverstein,DEM,160030,0,6,71,77,
Comanche,U.S. Senate,Jim Inhofe,REP,160030,2,4,82,88,
Comanche,U.S. Senate,Aaron Delozier,IND,160030,0,0,0,0,
Comanche,U.S. Senate,Ray Woods,IND,160030,0,0,0,0,
Comanche,U.S. Senate,Joan Farr,IND,160030,0,0,3,3,
Comanche,U.S. Senate,Connie Johnson,DEM,160030,0,8,77,85,
Comanche,U.S. Senate,James Lankford,REP,160030,2,3,74,79,
Comanche,U.S. Senate,Mark Beard,IND,160030,0,0,5,5,
Comanche,U.S. House,Bert Smith,DEM,160030,0,6,64,70,04
Comanche,U.S. House,Tom Cole,REP,160030,2,6,89,97,04
Comanche,U.S. House,Dennis Johnson,IND,160030,0,0,3,3,04
Comanche,State House,Toni Hasenbeck,DEM,160030,0,10,97,107,65
Comanche,State House,Scooter Park,REP,160030,2,2,59,63,65
Comanche,Governor,Joe Dorman,DEM,160031,19,153,463,635,
Comanche,Governor,Mary Fallin,REP,160031,15,158,603,776,
Comanche,Governor,Kimberly Willis,IND,160031,1,4,17,22,
Comanche,Governor,Richard Prawdzienski,IND,160031,0,1,9,10,
Comanche,Lieutenant Governor,Cathy Cummings,DEM,160031,17,101,324,442,
Comanche,Lieutenant Governor,Todd Lamb,REP,160031,18,214,760,992,
Comanche,Superintendent of Public Instruction,John Cox,DEM,160031,18,137,420,575,
Comanche,Superintendent of Public Instruction,Joy Hofmeister,REP,160031,17,180,663,860,
Comanche,Commissioner of Labor,Mike Workman,DEM,160031,17,117,350,484,
Comanche,Commissioner of Labor,Mark Costello,REP,160031,17,196,708,921,
Comanche,U.S. Senate,Matt Silverstein,DEM,160031,16,98,289,403,
Comanche,U.S. Senate,Jim Inhofe,REP,160031,18,213,766,997,
Comanche,U.S. Senate,Aaron Delozier,IND,160031,0,3,9,12,
Comanche,U.S. Senate,Ray Woods,IND,160031,0,1,9,10,
Comanche,U.S. Senate,Joan Farr,IND,160031,0,2,12,14,
Comanche,U.S. Senate,Connie Johnson,DEM,160031,17,108,313,438,
Comanche,U.S. Senate,James Lankford,REP,160031,17,202,743,962,
Comanche,U.S. Senate,Mark Beard,IND,160031,1,6,28,35,
Comanche,U.S. House,Bert Smith,DEM,160031,15,88,249,352,04
Comanche,U.S. House,Tom Cole,REP,160031,18,219,799,1036,04
Comanche,U.S. House,Dennis Johnson,IND,160031,1,9,42,52,04
Comanche,Governor,Joe Dorman,DEM,160032,0,1,53,54,
Comanche,Governor,Mary Fallin,REP,160032,0,0,1,1,
Comanche,Governor,Kimberly Willis,IND,160032,1,0,0,1,
Comanche,Governor,Richard Prawdzienski,IND,160032,0,0,0,0,
Comanche,Lieutenant Governor,Cathy Cummings,DEM,160032,1,1,48,50,
Comanche,Lieutenant Governor,Todd Lamb,REP,160032,0,0,6,6,
Comanche,Superintendent of Public Instruction,John Cox,DEM,160032,1,1,52,54,
Comanche,Superintendent of Public Instruction,Joy Hofmeister,REP,160032,0,0,2,2,
Comanche,Commissioner of Labor,Mike Workman,DEM,160032,1,1,50,52,
Comanche,Commissioner of Labor,Mark Costello,REP,160032,0,0,3,3,
Comanche,U.S. Senate,Matt Silverstein,DEM,160032,1,1,51,53,
Comanche,U.S. Senate,Jim Inhofe,REP,160032,0,0,3,3,
Comanche,U.S. Senate,Aaron Delozier,IND,160032,0,0,0,0,
Comanche,U.S. Senate,Ray Woods,IND,160032,0,0,0,0,
Comanche,U.S. Senate,Joan Farr,IND,160032,0,0,0,0,
Comanche,U.S. Senate,Connie Johnson,DEM,160032,1,1,52,54,
Comanche,U.S. Senate,James Lankford,REP,160032,0,0,2,2,
Comanche,U.S. Senate,Mark Beard,IND,160032,0,0,0,0,
Comanche,U.S. House,Bert Smith,DEM,160032,1,1,49,51,04
Comanche,U.S. House,Tom Cole,REP,160032,0,0,5,5,04
Comanche,U.S. House,Dennis Johnson,IND,160032,0,0,0,0,04
Comanche,Governor,Joe Dorman,DEM,160033,6,18,97,121,
Comanche,Governor,Mary Fallin,REP,160033,5,18,107,130,
Comanche,Governor,Kimberly Willis,IND,160033,1,0,6,7,
Comanche,Governor,Richard Prawdzienski,IND,160033,1,0,4,5,
Comanche,Lieutenant Governor,Cathy Cummings,DEM,160033,6,17,76,99,
Comanche,Lieutenant Governor,Todd Lamb,REP,160033,7,19,135,161,
Comanche,Superintendent of Public Instruction,John Cox,DEM,160033,6,20,92,118,
Comanche,Superintendent of Public Instruction,Joy Hofmeister,REP,160033,6,16,120,142,
Comanche,Commissioner of Labor,Mike Workman,DEM,160033,6,17,90,113,
Comanche,Commissioner of Labor,Mark Costello,REP,160033,5,19,118,142,
Comanche,U.S. Senate,Matt Silverstein,DEM,160033,5,13,65,83,
Comanche,U.S. Senate,Jim Inhofe,REP,160033,7,20,136,163,
Comanche,U.S. Senate,Aaron Delozier,IND,160033,1,0,4,5,
Comanche,U.S. Senate,Ray Woods,IND,160033,0,2,6,8,
Comanche,U.S. Senate,Joan Farr,IND,160033,0,1,3,4,
Comanche,U.S. Senate,Connie Johnson,DEM,160033,5,16,71,92,
Comanche,U.S. Senate,James Lankford,REP,160033,6,18,131,155,
Comanche,U.S. Senate,Mark Beard,IND,160033,1,2,11,14,
Comanche,U.S. House,Bert Smith,DEM,160033,4,13,60,77,04
Comanche,U.S. House,Tom Cole,REP,160033,7,21,144,172,04
Comanche,U.S. House,Dennis Johnson,IND,160033,2,2,10,14,04
Comanche,Governor,Joe Dorman,DEM,160034,7,62,327,396,
Comanche,Governor,Mary Fallin,REP,160034,12,59,330,401,
Comanche,Governor,Kimberly Willis,IND,160034,2,2,15,19,
Comanche,Governor,Richard Prawdzienski,IND,160034,0,1,5,6,
Comanche,Lieutenant Governor,Cathy Cummings,DEM,160034,7,49,260,316,
Comanche,Lieutenant Governor,Todd Lamb,REP,160034,13,75,414,502,
Comanche,Superintendent of Public Instruction,John Cox,DEM,160034,8,62,328,398,
Comanche,Superintendent of Public Instruction,Joy Hofmeister,REP,160034,12,61,344,417,
Comanche,Commissioner of Labor,Mike Workman,DEM,160034,7,59,296,362,
Comanche,Commissioner of Labor,Mark Costello,REP,160034,13,64,367,444,
Comanche,U.S. Senate,Matt Silverstein,DEM,160034,6,51,225,282,
Comanche,U.S. Senate,Jim Inhofe,REP,160034,14,69,420,503,
Comanche,U.S. Senate,Aaron Delozier,IND,160034,0,0,3,3,
Comanche,U.S. Senate,Ray Woods,IND,160034,0,4,12,16,
Comanche,U.S. Senate,Joan Farr,IND,160034,1,0,14,15,
Comanche,U.S. Senate,Connie Johnson,DEM,160034,7,58,259,324,
Comanche,U.S. Senate,James Lankford,REP,160034,13,62,394,469,
Comanche,U.S. Senate,Mark Beard,IND,160034,1,5,19,25,
Comanche,U.S. House,Bert Smith,DEM,160034,7,47,212,266,04
Comanche,U.S. House,Tom Cole,REP,160034,12,71,434,517,04
Comanche,U.S. House,Dennis Johnson,IND,160034,2,6,26,34,04
Comanche,State House,Juan Rodriguez,DEM,160034,7,57,289,353,63
Comanche,State House,Jeff Coody,REP,160034,13,68,386,467,63
Comanche,Governor,Joe Dorman,DEM,160035,0,3,77,80,
Comanche,Governor,Mary Fallin,REP,160035,3,12,121,136,
Comanche,Governor,Kimberly Willis,IND,160035,0,0,3,3,
Comanche,Governor,Richard Prawdzienski,IND,160035,0,0,7,7,
Comanche,Lieutenant Governor,Cathy Cummings,DEM,160035,0,3,51,54,
Comanche,Lieutenant Governor,Todd Lamb,REP,160035,3,12,158,173,
Comanche,Superintendent of Public Instruction,John Cox,DEM,160035,2,6,72,80,
Comanche,Superintendent of Public Instruction,Joy Hofmeister,REP,160035,1,8,135,144,
Comanche,Commissioner of Labor,Mike Workman,DEM,160035,2,5,67,74,
Comanche,Commissioner of Labor,Mark Costello,REP,160035,1,10,136,147,
Comanche,U.S. Senate,Matt Silverstein,DEM,160035,0,3,49,52,
Comanche,U.S. Senate,Jim Inhofe,REP,160035,1,11,148,160,
Comanche,U.S. Senate,Aaron Delozier,IND,160035,0,0,2,2,
Comanche,U.S. Senate,Ray Woods,IND,160035,1,1,7,9,
Comanche,U.S. Senate,Joan Farr,IND,160035,1,0,3,4,
Comanche,U.S. Senate,Connie Johnson,DEM,160035,0,2,54,56,
Comanche,U.S. Senate,James Lankford,REP,160035,3,12,142,157,
Comanche,U.S. Senate,Mark Beard,IND,160035,0,1,12,13,
Comanche,U.S. House,Bert Smith,DEM,160035,0,4,43,47,04
Comanche,U.S. House,Tom Cole,REP,160035,3,11,151,165,04
Comanche,U.S. House,Dennis Johnson,IND,160035,0,0,16,16,04
Comanche,State House,Juan Rodriguez,DEM,160035,0,4,74,78,63
Comanche,State House,Jeff Coody,REP,160035,3,11,136,150,63
Comanche,Governor,Joe Dorman,DEM,160036,1,6,82,89,
Comanche,Governor,Mary Fallin,REP,160036,7,5,127,139,
Comanche,Governor,Kimberly Willis,IND,160036,0,1,1,2,
Comanche,Governor,Richard Prawdzienski,IND,160036,0,0,2,2,
Comanche,Lieutenant Governor,Cathy Cummings,DEM,160036,1,8,69,78,
Comanche,Lieutenant Governor,Todd Lamb,REP,160036,7,4,143,154,
Comanche,Superintendent of Public Instruction,John Cox,DEM,160036,1,9,89,99,
Comanche,Superintendent of Public Instruction,Joy Hofmeister,REP,160036,7,3,121,131,
Comanche,Commissioner of Labor,Mike Workman,DEM,160036,1,9,69,79,
Comanche,Commissioner of Labor,Mark Costello,REP,160036,6,3,142,151,
Comanche,U.S. Senate,Matt Silverstein,DEM,160036,1,6,59,66,
Comanche,U.S. Senate,Jim Inhofe,REP,160036,7,5,141,153,
Comanche,U.S. Senate,Aaron Delozier,IND,160036,0,0,4,4,
Comanche,U.S. Senate,Ray Woods,IND,160036,0,0,3,3,
Comanche,U.S. Senate,Joan Farr,IND,160036,0,1,3,4,
Comanche,U.S. Senate,Connie Johnson,DEM,160036,1,7,65,73,
Comanche,U.S. Senate,James Lankford,REP,160036,7,4,139,150,
Comanche,U.S. Senate,Mark Beard,IND,160036,0,1,5,6,
Comanche,U.S. House,Bert Smith,DEM,160036,1,6,57,64,04
Comanche,U.S. House,Tom Cole,REP,160036,8,5,138,151,04
Comanche,U.S. House,Dennis Johnson,IND,160036,0,1,15,16,04
Comanche,State House,Juan Rodriguez,DEM,160036,2,6,86,94,63
Comanche,State House,Jeff Coody,REP,160036,6,6,128,140,63
Comanche,Governor,Joe Dorman,DEM,160037,0,3,69,72,
Comanche,Governor,Mary Fallin,REP,160037,2,1,99,102,
Comanche,Governor,Kimberly Willis,IND,160037,0,0,6,6,
Comanche,Governor,Richard Prawdzienski,IND,160037,0,0,3,3,
Comanche,Lieutenant Governor,Cathy Cummings,DEM,160037,0,2,27,29,
Comanche,Lieutenant Governor,Todd Lamb,REP,160037,2,2,150,154,
Comanche,Superintendent of Public Instruction,John Cox,DEM,160037,0,1,50,51,
Comanche,Superintendent of Public Instruction,Joy Hofmeister,REP,160037,2,3,126,131,
Comanche,Commissioner of Labor,Mike Workman,DEM,160037,0,1,50,51,
Comanche,Commissioner of Labor,Mark Costello,REP,160037,2,3,122,127,
Comanche,U.S. Senate,Matt Silverstein,DEM,160037,0,1,26,27,
Comanche,U.S. Senate,Jim Inhofe,REP,160037,2,3,144,149,
Comanche,U.S. Senate,Aaron Delozier,IND,160037,0,0,2,2,
Comanche,U.S. Senate,Ray Woods,IND,160037,0,0,3,3,
Comanche,U.S. Senate,Joan Farr,IND,160037,0,0,2,2,
Comanche,U.S. Senate,Connie Johnson,DEM,160037,0,1,28,29,
Comanche,U.S. Senate,James Lankford,REP,160037,2,3,142,147,
Comanche,U.S. Senate,Mark Beard,IND,160037,0,0,5,5,
Comanche,U.S. House,Bert Smith,DEM,160037,0,1,24,25,04
Comanche,U.S. House,Tom Cole,REP,160037,2,3,145,150,04
Comanche,U.S. House,Dennis Johnson,IND,160037,0,0,8,8,04
Comanche,State House,Juan Rodriguez,DEM,160037,0,3,53,56,63
Comanche,State House,Jeff Coody,REP,160037,2,1,124,127,63
Comanche,Governor,Joe Dorman,DEM,160038,10,49,486,545,
Comanche,Governor,Mary Fallin,REP,160038,14,56,577,647,
Comanche,Governor,Kimberly Willis,IND,160038,0,0,20,20,
Comanche,Governor,Richard Prawdzienski,IND,160038,0,0,5,5,
Comanche,Lieutenant Governor,Cathy Cummings,DEM,160038,6,29,261,296,
Comanche,Lieutenant Governor,Todd Lamb,REP,160038,18,74,820,912,
Comanche,Superintendent of Public Instruction,John Cox,DEM,160038,8,45,398,451,
Comanche,Superintendent of Public Instruction,Joy Hofmeister,REP,160038,16,58,681,755,
Comanche,Commissioner of Labor,Mike Workman,DEM,160038,8,34,319,361,
Comanche,Commissioner of Labor,Mark Costello,REP,160038,15,68,740,823,
Comanche,U.S. Senate,Matt Silverstein,DEM,160038,5,24,193,222,
Comanche,U.S. Senate,Jim Inhofe,REP,160038,18,75,837,930,
Comanche,U.S. Senate,Aaron Delozier,IND,160038,0,0,7,7,
Comanche,U.S. Senate,Ray Woods,IND,160038,0,4,21,25,
Comanche,U.S. Senate,Joan Farr,IND,160038,1,1,20,22,
Comanche,U.S. Senate,Connie Johnson,DEM,160038,6,28,237,271,
Comanche,U.S. Senate,James Lankford,REP,160038,18,75,785,878,
Comanche,U.S. Senate,Mark Beard,IND,160038,0,3,48,51,
Comanche,U.S. House,Bert Smith,DEM,160038,5,25,177,207,04
Comanche,U.S. House,Tom Cole,REP,160038,19,75,852,946,04
Comanche,U.S. House,Dennis Johnson,IND,160038,0,5,48,53,04
Comanche,State House,Toni Hasenbeck,DEM,160038,12,53,554,619,65
Comanche,State House,Scooter Park,REP,160038,12,50,529,591,65
Comanche,Governor,Joe Dorman,DEM,160039,4,9,287,300,
Comanche,Governor,Mary Fallin,REP,160039,2,13,262,277,
Comanche,Governor,Kimberly Willis,IND,160039,0,0,7,7,
Comanche,Governor,Richard Prawdzienski,IND,160039,0,0,2,2,
Comanche,Lieutenant Governor,Cathy Cummings,DEM,160039,2,7,145,154,
Comanche,Lieutenant Governor,Todd Lamb,REP,160039,4,15,409,428,
Comanche,Superintendent of Public Instruction,John Cox,DEM,160039,3,7,230,240,
Comanche,Superintendent of Public Instruction,Joy Hofmeister,REP,160039,3,15,320,338,
Comanche,Commissioner of Labor,Mike Workman,DEM,160039,2,7,196,205,
Comanche,Commissioner of Labor,Mark Costello,REP,160039,4,15,342,361,
Comanche,U.S. Senate,Matt Silverstein,DEM,160039,2,3,112,117,
Comanche,U.S. Senate,Jim Inhofe,REP,160039,4,18,419,441,
Comanche,U.S. Senate,Aaron Delozier,IND,160039,0,0,3,3,
Comanche,U.S. Senate,Ray Woods,IND,160039,0,1,12,13,
Comanche,U.S. Senate,Joan Farr,IND,160039,0,0,10,10,
Comanche,U.S. Senate,Connie Johnson,DEM,160039,2,6,130,138,
Comanche,U.S. Senate,James Lankford,REP,160039,4,14,395,413,
Comanche,U.S. Senate,Mark Beard,IND,160039,0,2,24,26,
Comanche,U.S. House,Bert Smith,DEM,160039,1,2,102,105,04
Comanche,U.S. House,Tom Cole,REP,160039,5,18,430,453,04
Comanche,U.S. House,Dennis Johnson,IND,160039,0,2,23,25,04
Comanche,State House,Toni Hasenbeck,DEM,160039,3,8,281,292,65
Comanche,State House,Scooter Park,REP,160039,3,14,275,292,65
Comanche,Governor,Joe Dorman,DEM,160040,8,14,361,383,
Comanche,Governor,Mary Fallin,REP,160040,3,5,236,244,
Comanche,Governor,Kimberly Willis,IND,160040,0,0,4,4,
Comanche,Governor,Richard Prawdzienski,IND,160040,0,0,4,4,
Comanche,Lieutenant Governor,Cathy Cummings,DEM,160040,6,7,161,174,
Comanche,Lieutenant Governor,Todd Lamb,REP,160040,5,12,438,455,
Comanche,Superintendent of Public Instruction,John Cox,DEM,160040,8,8,289,305,
Comanche,Superintendent of Public Instruction,Joy Hofmeister,REP,160040,3,11,313,327,
Comanche,Commissioner of Labor,Mike Workman,DEM,160040,5,8,214,227,
Comanche,Commissioner of Labor,Mark Costello,REP,160040,6,11,374,391,
Comanche,U.S. Senate,Matt Silverstein,DEM,160040,6,7,122,135,
Comanche,U.S. Senate,Jim Inhofe,REP,160040,5,12,450,467,
Comanche,U.S. Senate,Aaron Delozier,IND,160040,0,0,7,7,
Comanche,U.S. Senate,Ray Woods,IND,160040,0,0,4,4,
Comanche,U.S. Senate,Joan Farr,IND,160040,0,0,12,12,
Comanche,U.S. Senate,Connie Johnson,DEM,160040,4,8,149,161,
Comanche,U.S. Senate,James Lankford,REP,160040,6,10,408,424,
Comanche,U.S. Senate,Mark Beard,IND,160040,1,1,31,33,
Comanche,U.S. House,Bert Smith,DEM,160040,5,6,121,132,04
Comanche,U.S. House,Tom Cole,REP,160040,6,13,446,465,04
Comanche,U.S. House,Dennis Johnson,IND,160040,0,0,30,30,04
Comanche,State House,Toni Hasenbeck,DEM,160040,7,11,316,334,65
Comanche,State House,Scooter Park,REP,160040,4,8,284,296,65
Comanche,Governor,Joe Dorman,DEM,160041,2,6,159,167,
Comanche,Governor,Mary Fallin,REP,160041,1,10,184,195,
Comanche,Governor,Kimberly Willis,IND,160041,0,0,11,11,
Comanche,Governor,Richard Prawdzienski,IND,160041,1,0,7,8,
Comanche,Lieutenant Governor,Cathy Cummings,DEM,160041,2,3,83,88,
Comanche,Lieutenant Governor,Todd Lamb,REP,160041,2,13,273,288,
Comanche,Superintendent of Public Instruction,John Cox,DEM,160041,2,5,159,166,
Comanche,Superintendent of Public Instruction,Joy Hofmeister,REP,160041,2,11,199,212,
Comanche,Commissioner of Labor,Mike Workman,DEM,160041,2,3,122,127,
Comanche,Commissioner of Labor,Mark Costello,REP,160041,2,13,227,242,
Comanche,U.S. Senate,Matt Silverstein,DEM,160041,2,3,77,82,
Comanche,U.S. Senate,Jim Inhofe,REP,160041,2,13,267,282,
Comanche,U.S. Senate,Aaron Delozier,IND,160041,0,0,1,1,
Comanche,U.S. Senate,Ray Woods,IND,160041,0,0,4,4,
Comanche,U.S. Senate,Joan Farr,IND,160041,0,0,8,8,
Comanche,U.S. Senate,Connie Johnson,DEM,160041,2,3,95,100,
Comanche,U.S. Senate,James Lankford,REP,160041,2,13,247,262,
Comanche,U.S. Senate,Mark Beard,IND,160041,0,0,13,13,
Comanche,U.S. House,Bert Smith,DEM,160041,2,3,68,73,04
Comanche,U.S. House,Tom Cole,REP,160041,1,13,272,286,04
Comanche,U.S. House,Dennis Johnson,IND,160041,1,0,18,19,04
Comanche,State House,Juan Rodriguez,DEM,160041,2,6,160,168,63
Comanche,State House,Jeff Coody,REP,160041,2,10,199,211,63
Comanche,Governor,Joe Dorman,DEM,160042,15,94,437,546,
Comanche,Governor,Mary Fallin,REP,160042,29,84,603,716,
Comanche,Governor,Kimberly Willis,IND,160042,2,0,23,25,
Comanche,Governor,Richard Prawdzienski,IND,160042,0,1,9,10,
Comanche,Lieutenant Governor,Cathy Cummings,DEM,160042,13,61,287,361,
Comanche,Lieutenant Governor,Todd Lamb,REP,160042,33,117,783,933,
Comanche,Superintendent of Public Instruction,John Cox,DEM,160042,16,83,420,519,
Comanche,Superintendent of Public Instruction,Joy Hofmeister,REP,160042,30,95,647,772,
Comanche,Commissioner of Labor,Mike Workman,DEM,160042,19,76,366,461,
Comanche,Commissioner of Labor,Mark Costello,REP,160042,27,98,683,808,
Comanche,U.S. Senate,Matt Silverstein,DEM,160042,11,61,261,333,
Comanche,U.S. Senate,Jim Inhofe,REP,160042,32,113,776,921,
Comanche,U.S. Senate,Aaron Delozier,IND,160042,1,0,8,9,
Comanche,U.S. Senate,Ray Woods,IND,160042,2,3,13,18,
Comanche,U.S. Senate,Joan Farr,IND,160042,0,3,10,13,
Comanche,U.S. Senate,Connie Johnson,DEM,160042,13,69,329,411,
Comanche,U.S. Senate,James Lankford,REP,160042,31,104,717,852,
Comanche,U.S. Senate,Mark Beard,IND,160042,2,5,17,24,
Comanche,U.S. House,Bert Smith,DEM,160042,9,60,241,310,04
Comanche,U.S. House,Tom Cole,REP,160042,35,116,803,954,04
Comanche,U.S. House,Dennis Johnson,IND,160042,2,4,27,33,04
Comanche,State House,Juan Rodriguez,DEM,160042,15,80,435,530,63
Comanche,State House,Jeff Coody,REP,160042,31,100,633,764,63
Comanche,Governor,Joe Dorman,DEM,160043,2,13,61,76,
Comanche,Governor,Mary Fallin,REP,160043,4,14,136,154,
Comanche,Governor,Kimberly Willis,IND,160043,1,0,4,5,
Comanche,Governor,Richard Prawdzienski,IND,160043,0,0,3,3,
Comanche,Lieutenant Governor,Cathy Cummings,DEM,160043,0,7,34,41,
Comanche,Lieutenant Governor,Todd Lamb,REP,160043,7,19,169,195,
Comanche,Superintendent of Public Instruction,John Cox,DEM,160043,3,9,65,77,
Comanche,Superintendent of Public Instruction,Joy Hofmeister,REP,160043,4,17,135,156,
Comanche,Commissioner of Labor,Mike Workman,DEM,160043,2,10,51,63,
Comanche,Commissioner of Labor,Mark Costello,REP,160043,5,16,147,168,
Comanche,U.S. Senate,Matt Silverstein,DEM,160043,0,9,26,35,
Comanche,U.S. Senate,Jim Inhofe,REP,160043,7,17,163,187,
Comanche,U.S. Senate,Aaron Delozier,IND,160043,0,0,1,1,
Comanche,U.S. Senate,Ray Woods,IND,160043,0,0,8,8,
Comanche,U.S. Senate,Joan Farr,IND,160043,0,0,4,4,
Comanche,U.S. Senate,Connie Johnson,DEM,160043,0,7,44,51,
Comanche,U.S. Senate,James Lankford,REP,160043,7,18,150,175,
Comanche,U.S. Senate,Mark Beard,IND,160043,0,1,7,8,
Comanche,U.S. House,Bert Smith,DEM,160043,0,6,25,31,04
Comanche,U.S. House,Tom Cole,REP,160043,7,18,166,191,04
Comanche,U.S. House,Dennis Johnson,IND,160043,0,1,12,13,04
Comanche,State House,Juan Rodriguez,DEM,160043,1,13,68,82,63
Comanche,State House,Jeff Coody,REP,160043,6,13,136,155,63
Comanche,Governor,Joe Dorman,DEM,160045,2,26,140,168,
Comanche,Governor,Mary Fallin,REP,160045,5,28,268,301,
Comanche,Governor,Kimberly Willis,IND,160045,1,1,5,7,
Comanche,Governor,Richard Prawdzienski,IND,160045,0,0,3,3,
Comanche,Lieutenant Governor,Cathy Cummings,DEM,160045,1,16,82,99,
Comanche,Lieutenant Governor,Todd Lamb,REP,160045,7,38,331,376,
Comanche,Superintendent of Public Instruction,John Cox,DEM,160045,1,30,127,158,
Comanche,Superintendent of Public Instruction,Joy Hofmeister,REP,160045,7,24,287,318,
Comanche,Commissioner of Labor,Mike Workman,DEM,160045,3,23,110,136,
Comanche,Commissioner of Labor,Mark Costello,REP,160045,5,31,299,335,
Comanche,U.S. Senate,Matt Silverstein,DEM,160045,1,16,80,97,
Comanche,U.S. Senate,Jim Inhofe,REP,160045,6,39,322,367,
Comanche,U.S. Senate,Aaron Delozier,IND,160045,0,0,3,3,
Comanche,U.S. Senate,Ray Woods,IND,160045,1,0,2,3,
Comanche,U.S. Senate,Joan Farr,IND,160045,0,0,4,4,
Comanche,U.S. Senate,Connie Johnson,DEM,160045,1,22,93,116,
Comanche,U.S. Senate,James Lankford,REP,160045,7,31,311,349,
Comanche,U.S. Senate,Mark Beard,IND,160045,0,2,7,9,
Comanche,U.S. House,Bert Smith,DEM,160045,1,15,70,86,04
Comanche,U.S. House,Tom Cole,REP,160045,7,38,336,381,04
Comanche,U.S. House,Dennis Johnson,IND,160045,0,1,9,10,04
Comanche,State House,Juan Rodriguez,DEM,160045,2,29,134,165,63
Comanche,State House,Jeff Coody,REP,160045,6,26,278,310,63
Comanche,Governor,Joe Dorman,DEM,160046,0,6,86,92,
Comanche,Governor,Mary Fallin,REP,160046,1,5,112,118,
Comanche,Governor,Kimberly Willis,IND,160046,0,0,7,7,
Comanche,Governor,Richard Prawdzienski,IND,160046,0,0,0,0,
Comanche,Lieutenant Governor,Cathy Cummings,DEM,160046,0,2,49,51,
Comanche,Lieutenant Governor,Todd Lamb,REP,160046,1,8,157,166,
Comanche,Superintendent of Public Instruction,John Cox,DEM,160046,0,4,83,87,
Comanche,Superintendent of Public Instruction,Joy Hofmeister,REP,160046,1,7,120,128,
Comanche,Commissioner of Labor,Mike Workman,DEM,160046,0,3,64,67,
Comanche,Commissioner of Labor,Mark Costello,REP,160046,1,8,130,139,
Comanche,U.S. Senate,Matt Silverstein,DEM,160046,0,3,40,43,
Comanche,U.S. Senate,Jim Inhofe,REP,160046,1,6,161,168,
Comanche,U.S. Senate,Aaron Delozier,IND,160046,0,1,1,2,
Comanche,U.S. Senate,Ray Woods,IND,160046,0,0,1,1,
Comanche,U.S. Senate,Joan Farr,IND,160046,0,1,2,3,
Comanche,U.S. Senate,Connie Johnson,DEM,160046,0,3,48,51,
Comanche,U.S. Senate,James Lankford,REP,160046,1,8,140,149,
Comanche,U.S. Senate,Mark Beard,IND,160046,0,0,11,11,
Comanche,U.S. House,Bert Smith,DEM,160046,0,2,36,38,04
Comanche,U.S. House,Tom Cole,REP,160046,1,8,158,167,04
Comanche,U.S. House,Dennis Johnson,IND,160046,0,1,9,10,04
Comanche,State House,Juan Rodriguez,DEM,160046,0,7,86,93,63
Comanche,State House,Jeff Coody,REP,160046,1,4,120,125,63
Comanche,Governor,Joe Dorman,DEM,160048,1,11,172,184,
Comanche,Governor,Mary Fallin,REP,160048,1,11,206,218,
Comanche,Governor,Kimberly Willis,IND,160048,0,0,13,13,
Comanche,Governor,Richard Prawdzienski,IND,160048,0,0,7,7,
Comanche,Lieutenant Governor,Cathy Cummings,DEM,160048,0,10,112,122,
Comanche,Lieutenant Governor,Todd Lamb,REP,160048,2,12,285,299,
Comanche,Superintendent of Public Instruction,John Cox,DEM,160048,2,13,162,177,
Comanche,Superintendent of Public Instruction,Joy Hofmeister,REP,160048,0,9,234,243,
Comanche,Commissioner of Labor,Mike Workman,DEM,160048,0,10,149,159,
Comanche,Commissioner of Labor,Mark Costello,REP,160048,2,11,245,258,
Comanche,U.S. Senate,Matt Silverstein,DEM,160048,0,6,85,91,
Comanche,U.S. Senate,Jim Inhofe,REP,160048,2,12,289,303,
Comanche,U.S. Senate,Aaron Delozier,IND,160048,0,0,6,6,
Comanche,U.S. Senate,Ray Woods,IND,160048,0,1,11,12,
Comanche,U.S. Senate,Joan Farr,IND,160048,0,2,6,8,
Comanche,U.S. Senate,Connie Johnson,DEM,160048,0,10,123,133,
Comanche,U.S. Senate,James Lankford,REP,160048,2,10,254,266,
Comanche,U.S. Senate,Mark Beard,IND,160048,0,2,18,20,
Comanche,U.S. House,Bert Smith,DEM,160048,0,5,83,88,04
Comanche,U.S. House,Tom Cole,REP,160048,2,14,300,316,04
Comanche,U.S. House,Dennis Johnson,IND,160048,0,3,13,16,04
Comanche,State House,Juan Rodriguez,DEM,160048,1,10,193,204,63
Comanche,State House,Jeff Coody,REP,160048,1,12,206,219,63
Comanche,Governor,Joe Dorman,DEM,160049,0,22,172,194,
Comanche,Governor,Mary Fallin,REP,160049,8,21,231,260,
Comanche,Governor,Kimberly Willis,IND,160049,0,0,4,4,
Comanche,Governor,Richard Prawdzienski,IND,160049,0,0,3,3,
Comanche,Lieutenant Governor,Cathy Cummings,DEM,160049,0,15,88,103,
Comanche,Lieutenant Governor,Todd Lamb,REP,160049,8,27,321,356,
Comanche,Superintendent of Public Instruction,John Cox,DEM,160049,0,20,169,189,
Comanche,Superintendent of Public Instruction,Joy Hofmeister,REP,160049,8,23,240,271,
Comanche,Commissioner of Labor,Mike Workman,DEM,160049,0,18,127,145,
Comanche,Commissioner of Labor,Mark Costello,REP,160049,8,24,278,310,
Comanche,U.S. Senate,Matt Silverstein,DEM,160049,0,11,81,92,
Comanche,U.S. Senate,Jim Inhofe,REP,160049,8,29,323,360,
Comanche,U.S. Senate,Aaron Delozier,IND,160049,0,0,0,0,
Comanche,U.S. Senate,Ray Woods,IND,160049,0,1,3,4,
Comanche,U.S. Senate,Joan Farr,IND,160049,0,1,5,6,
Comanche,U.S. Senate,Connie Johnson,DEM,160049,0,13,108,121,
Comanche,U.S. Senate,James Lankford,REP,160049,8,28,291,327,
Comanche,U.S. Senate,Mark Beard,IND,160049,0,1,12,13,
Comanche,U.S. House,Bert Smith,DEM,160049,0,10,75,85,04
Comanche,U.S. House,Tom Cole,REP,160049,8,30,323,361,04
Comanche,U.S. House,Dennis Johnson,IND,160049,0,3,13,16,04
Comanche,State House,Toni Hasenbeck,DEM,160049,0,20,196,216,65
Comanche,State House,Scooter Park,REP,160049,8,23,214,245,65
Comanche,Governor,Joe Dorman,DEM,160050,8,68,336,412,
Comanche,Governor,Mary Fallin,REP,160050,24,93,571,688,
Comanche,Governor,Kimberly Willis,IND,160050,0,2,16,18,
Comanche,Governor,Richard Prawdzienski,IND,160050,0,1,8,9,
Comanche,Lieutenant Governor,Cathy Cummings,DEM,160050,5,41,234,280,
Comanche,Lieutenant Governor,Todd Lamb,REP,160050,27,123,684,834,
Comanche,Superintendent of Public Instruction,John Cox,DEM,160050,11,63,289,363,
Comanche,Superintendent of Public Instruction,Joy Hofmeister,REP,160050,20,102,634,756,
Comanche,Commissioner of Labor,Mike Workman,DEM,160050,7,57,280,344,
Comanche,Commissioner of Labor,Mark Costello,REP,160050,20,105,613,738,
Comanche,U.S. Senate,Matt Silverstein,DEM,160050,4,43,197,244,
Comanche,U.S. Senate,Jim Inhofe,REP,160050,28,116,706,850,
Comanche,U.S. Senate,Aaron Delozier,IND,160050,0,2,7,9,
Comanche,U.S. Senate,Ray Woods,IND,160050,0,1,6,7,
Comanche,U.S. Senate,Joan Farr,IND,160050,0,3,9,12,
Comanche,U.S. Senate,Connie Johnson,DEM,160050,7,43,224,274,
Comanche,U.S. Senate,James Lankford,REP,160050,25,115,672,812,
Comanche,U.S. Senate,Mark Beard,IND,160050,0,5,29,34,
Comanche,U.S. House,Bert Smith,DEM,160050,4,35,180,219,04
Comanche,U.S. House,Tom Cole,REP,160050,28,123,721,872,04
Comanche,U.S. House,Dennis Johnson,IND,160050,0,6,23,29,04
Comanche,State House,John Dunaway,DEM,160050,7,50,262,319,62
Comanche,State House,John Michael Montgomery,REP,160050,23,113,657,793,62
Comanche,Governor,Joe Dorman,DEM,160051,0,16,214,230,
Comanche,Governor,Mary Fallin,REP,160051,11,24,355,390,
Comanche,Governor,Kimberly Willis,IND,160051,0,0,4,4,
Comanche,Governor,Richard Prawdzienski,IND,160051,0,0,5,5,
Comanche,Lieutenant Governor,Cathy Cummings,DEM,160051,0,13,151,164,
Comanche,Lieutenant Governor,Todd Lamb,REP,160051,11,27,425,463,
Comanche,Superintendent of Public Instruction,John Cox,DEM,160051,3,14,206,223,
Comanche,Superintendent of Public Instruction,Joy Hofmeister,REP,160051,8,24,369,401,
Comanche,Commissioner of Labor,Mike Workman,DEM,160051,0,11,180,191,
Comanche,Commissioner of Labor,Mark Costello,REP,160051,11,28,385,424,
Comanche,U.S. Senate,Matt Silverstein,DEM,160051,0,10,124,134,
Comanche,U.S. Senate,Jim Inhofe,REP,160051,11,29,423,463,
Comanche,U.S. Senate,Aaron Delozier,IND,160051,0,0,8,8,
Comanche,U.S. Senate,Ray Woods,IND,160051,0,0,9,9,
Comanche,U.S. Senate,Joan Farr,IND,160051,0,0,8,8,
Comanche,U.S. Senate,Connie Johnson,DEM,160051,1,12,149,162,
Comanche,U.S. Senate,James Lankford,REP,160051,10,27,403,440,
Comanche,U.S. Senate,Mark Beard,IND,160051,0,0,17,17,
Comanche,U.S. House,Bert Smith,DEM,160051,0,9,114,123,04
Comanche,U.S. House,Tom Cole,REP,160051,11,28,440,479,04
Comanche,U.S. House,Dennis Johnson,IND,160051,0,2,22,24,04
Comanche,State House,Juan Rodriguez,DEM,160051,0,14,181,195,63
Comanche,State House,Jeff Coody,REP,160051,11,26,395,432,63
Comanche,Governor,Joe Dorman,DEM,160053,0,0,0,0,
Comanche,Governor,Mary Fallin,REP,160053,0,0,0,0,
Comanche,Governor,Kimberly Willis,IND,160053,0,0,0,0,
Comanche,Governor,Richard Prawdzienski,IND,160053,0,0,0,0,
Comanche,Lieutenant Governor,Cathy Cummings,DEM,160053,0,0,0,0,
Comanche,Lieutenant Governor,Todd Lamb,REP,160053,0,0,0,0,
Comanche,Superintendent of Public Instruction,John Cox,DEM,160053,0,0,0,0,
Comanche,Superintendent of Public Instruction,Joy Hofmeister,REP,160053,0,0,0,0,
Comanche,Commissioner of Labor,Mike Workman,DEM,160053,0,0,0,0,
Comanche,Commissioner of Labor,Mark Costello,REP,160053,0,0,0,0,
Comanche,U.S. Senate,Matt Silverstein,DEM,160053,0,0,0,0,
Comanche,U.S. Senate,Jim Inhofe,REP,160053,0,0,0,0,
Comanche,U.S. Senate,Aaron Delozier,IND,160053,0,0,0,0,
Comanche,U.S. Senate,Ray Woods,IND,160053,0,0,0,0,
Comanche,U.S. Senate,Joan Farr,IND,160053,0,0,0,0,
Comanche,U.S. Senate,Connie Johnson,DEM,160053,0,0,0,0,
Comanche,U.S. Senate,James Lankford,REP,160053,0,0,0,0,
Comanche,U.S. Senate,Mark Beard,IND,160053,0,0,0,0,
Comanche,U.S. House,Bert Smith,DEM,160053,0,0,0,0,04
Comanche,U.S. House,Tom Cole,REP,160053,0,0,0,0,04
Comanche,U.S. House,Dennis Johnson,IND,160053,0,0,0,0,04
Comanche,State House,Toni Hasenbeck,DEM,160053,0,0,0,0,65
Comanche,State House,Scooter Park,REP,160053,0,0,0,0,65
Cotton,Governor,Joe Dorman,DEM,170001,0,2,26,28,
Cotton,Governor,Mary Fallin,REP,170001,3,0,27,30,
Cotton,Governor,Kimberly Willis,IND,170001,0,0,0,0,
Cotton,Governor,Richard Prawdzienski,IND,170001,0,0,0,0,
Cotton,Lieutenant Governor,Cathy Cummings,DEM,170001,0,0,16,16,
Cotton,Lieutenant Governor,Todd Lamb,REP,170001,3,2,37,42,
Cotton,Superintendent of Public Instruction,John Cox,DEM,170001,1,1,27,29,
Cotton,Superintendent of Public Instruction,Joy Hofmeister,REP,170001,2,0,26,28,
Cotton,Commissioner of Labor,Mike Workman,DEM,170001,0,0,27,27,
Cotton,Commissioner of Labor,Mark Costello,REP,170001,2,1,24,27,
Cotton,U.S. Senate,Matt Silverstein,DEM,170001,0,0,15,15,
Cotton,U.S. Senate,Jim Inhofe,REP,170001,3,2,34,39,
Cotton,U.S. Senate,Aaron Delozier,IND,170001,0,0,0,0,
Cotton,U.S. Senate,Ray Woods,IND,170001,0,0,1,1,
Cotton,U.S. Senate,Joan Farr,IND,170001,0,0,2,2,
Cotton,U.S. Senate,Connie Johnson,DEM,170001,0,0,17,17,
Cotton,U.S. Senate,James Lankford,REP,170001,3,1,32,36,
Cotton,U.S. Senate,Mark Beard,IND,170001,0,1,3,4,
Cotton,U.S. House,Bert Smith,DEM,170001,0,0,12,12,04
Cotton,U.S. House,Tom Cole,REP,170001,3,2,37,42,04
Cotton,U.S. House,Dennis Johnson,IND,170001,0,0,3,3,04
Cotton,State House,Toni Hasenbeck,DEM,170001,0,0,18,18,65
Cotton,State House,Scooter Park,REP,170001,3,2,34,39,65
Cotton,Governor,Joe Dorman,DEM,170003,4,23,90,117,
Cotton,Governor,Mary Fallin,REP,170003,10,22,121,153,
Cotton,Governor,Kimberly Willis,IND,170003,0,0,5,5,
Cotton,Governor,Richard Prawdzienski,IND,170003,0,1,3,4,
Cotton,Lieutenant Governor,Cathy Cummings,DEM,170003,1,12,51,64,
Cotton,Lieutenant Governor,Todd Lamb,REP,170003,13,34,166,213,
Cotton,Superintendent of Public Instruction,John Cox,DEM,170003,3,15,79,97,
Cotton,Superintendent of Public Instruction,Joy Hofmeister,REP,170003,11,30,137,178,
Cotton,Commissioner of Labor,Mike Workman,DEM,170003,3,16,64,83,
Cotton,Commissioner of Labor,Mark Costello,REP,170003,11,30,148,189,
Cotton,U.S. Senate,Matt Silverstein,DEM,170003,1,11,45,57,
Cotton,U.S. Senate,Jim Inhofe,REP,170003,13,34,167,214,
Cotton,U.S. Senate,Aaron Delozier,IND,170003,0,0,1,1,
Cotton,U.S. Senate,Ray Woods,IND,170003,0,1,1,2,
Cotton,U.S. Senate,Joan Farr,IND,170003,0,0,3,3,
Cotton,U.S. Senate,Connie Johnson,DEM,170003,1,12,42,55,
Cotton,U.S. Senate,James Lankford,REP,170003,13,30,166,209,
Cotton,U.S. Senate,Mark Beard,IND,170003,0,3,9,12,
Cotton,U.S. House,Bert Smith,DEM,170003,0,8,39,47,04
Cotton,U.S. House,Tom Cole,REP,170003,14,36,174,224,04
Cotton,U.S. House,Dennis Johnson,IND,170003,0,2,5,7,04
Cotton,State House,Toni Hasenbeck,DEM,170003,3,17,82,102,65
Cotton,State House,Scooter Park,REP,170003,11,30,135,176,65
Cotton,Governor,Joe Dorman,DEM,170004,2,13,96,111,
Cotton,Governor,Mary Fallin,REP,170004,4,10,102,116,
Cotton,Governor,Kimberly Willis,IND,170004,0,0,6,6,
Cotton,Governor,Richard Prawdzienski,IND,170004,0,0,6,6,
Cotton,Lieutenant Governor,Cathy Cummings,DEM,170004,2,7,48,57,
Cotton,Lieutenant Governor,Todd Lamb,REP,170004,5,16,159,180,
Cotton,Superintendent of Public Instruction,John Cox,DEM,170004,2,11,80,93,
Cotton,Superintendent of Public Instruction,Joy Hofmeister,REP,170004,5,12,130,147,
Cotton,Commissioner of Labor,Mike Workman,DEM,170004,1,11,69,81,
Cotton,Commissioner of Labor,Mark Costello,REP,170004,6,12,134,152,
Cotton,U.S. Senate,Matt Silverstein,DEM,170004,2,8,45,55,
Cotton,U.S. Senate,Jim Inhofe,REP,170004,5,15,158,178,
Cotton,U.S. Senate,Aaron Delozier,IND,170004,0,0,1,1,
Cotton,U.S. Senate,Ray Woods,IND,170004,0,0,2,2,
Cotton,U.S. Senate,Joan Farr,IND,170004,0,0,4,4,
Cotton,U.S. Senate,Connie Johnson,DEM,170004,1,9,51,61,
Cotton,U.S. Senate,James Lankford,REP,170004,6,14,152,172,
Cotton,U.S. Senate,Mark Beard,IND,170004,0,0,6,6,
Cotton,U.S. House,Bert Smith,DEM,170004,1,8,35,44,04
Cotton,U.S. House,Tom Cole,REP,170004,6,14,165,185,04
Cotton,U.S. House,Dennis Johnson,IND,170004,0,0,10,10,04
Cotton,State House,Toni Hasenbeck,DEM,170004,4,6,75,85,65
Cotton,State House,Scooter Park,REP,170004,3,17,137,157,65
Cotton,Governor,Joe Dorman,DEM,170005,5,7,132,144,
Cotton,Governor,Mary Fallin,REP,170005,3,8,162,173,
Cotton,Governor,Kimberly Willis,IND,170005,1,1,2,4,
Cotton,Governor,Richard Prawdzienski,IND,170005,0,1,0,1,
Cotton,Lieutenant Governor,Cathy Cummings,DEM,170005,6,4,91,101,
Cotton,Lieutenant Governor,Todd Lamb,REP,170005,3,13,206,222,
Cotton,Superintendent of Public Instruction,John Cox,DEM,170005,7,7,116,130,
Cotton,Superintendent of Public Instruction,Joy Hofmeister,REP,170005,2,9,178,189,
Cotton,Commissioner of Labor,Mike Workman,DEM,170005,6,8,123,137,
Cotton,Commissioner of Labor,Mark Costello,REP,170005,3,8,168,179,
Cotton,U.S. Senate,Matt Silverstein,DEM,170005,5,5,80,90,
Cotton,U.S. Senate,Jim Inhofe,REP,170005,3,12,209,224,
Cotton,U.S. Senate,Aaron Delozier,IND,170005,0,0,1,1,
Cotton,U.S. Senate,Ray Woods,IND,170005,1,0,3,4,
Cotton,U.S. Senate,Joan Farr,IND,170005,0,0,4,4,
Cotton,U.S. Senate,Connie Johnson,DEM,170005,5,4,86,95,
Cotton,U.S. Senate,James Lankford,REP,170005,4,12,202,218,
Cotton,U.S. Senate,Mark Beard,IND,170005,0,1,7,8,
Cotton,U.S. House,Bert Smith,DEM,170005,5,3,71,79,04
Cotton,U.S. House,Tom Cole,REP,170005,4,12,211,227,04
Cotton,U.S. House,Dennis Johnson,IND,170005,0,2,14,16,04
Cotton,State House,Toni Hasenbeck,DEM,170005,7,5,115,127,65
Cotton,State House,Scooter Park,REP,170005,2,12,184,198,65
Cotton,Governor,Joe Dorman,DEM,170007,2,15,106,123,
Cotton,Governor,Mary Fallin,REP,170007,2,12,97,111,
Cotton,Governor,Kimberly Willis,IND,170007,0,0,1,1,
Cotton,Governor,Richard Prawdzienski,IND,170007,0,0,3,3,
Cotton,Lieutenant Governor,Cathy Cummings,DEM,170007,1,5,53,59,
Cotton,Lieutenant Governor,Todd Lamb,REP,170007,3,22,152,177,
Cotton,Superintendent of Public Instruction,John Cox,DEM,170007,2,12,85,99,
Cotton,Superintendent of Public Instruction,Joy Hofmeister,REP,170007,2,15,120,137,
Cotton,Commissioner of Labor,Mike Workman,DEM,170007,2,6,70,78,
Cotton,Commissioner of Labor,Mark Costello,REP,170007,2,21,132,155,
Cotton,U.S. Senate,Matt Silverstein,DEM,170007,1,4,49,54,
Cotton,U.S. Senate,Jim Inhofe,REP,170007,3,22,154,179,
Cotton,U.S. Senate,Aaron Delozier,IND,170007,0,0,0,0,
Cotton,U.S. Senate,Ray Woods,IND,170007,0,1,4,5,
Cotton,U.S. Senate,Joan Farr,IND,170007,0,0,2,2,
Cotton,U.S. Senate,Connie Johnson,DEM,170007,1,4,48,53,
Cotton,U.S. Senate,James Lankford,REP,170007,3,23,150,176,
Cotton,U.S. Senate,Mark Beard,IND,170007,0,0,8,8,
Cotton,U.S. House,Bert Smith,DEM,170007,1,5,40,46,04
Cotton,U.S. House,Tom Cole,REP,170007,3,22,161,186,04
Cotton,U.S. House,Dennis Johnson,IND,170007,0,0,7,7,04
Cotton,State House,Toni Hasenbeck,DEM,170007,2,9,89,100,65
Cotton,State House,Scooter Park,REP,170007,2,18,120,140,65
Cotton,Governor,Joe Dorman,DEM,170008,1,0,23,24,
Cotton,Governor,Mary Fallin,REP,170008,2,1,24,27,
Cotton,Governor,Kimberly Willis,IND,170008,0,0,0,0,
Cotton,Governor,Richard Prawdzienski,IND,170008,0,0,0,0,
Cotton,Lieutenant Governor,Cathy Cummings,DEM,170008,1,0,13,14,
Cotton,Lieutenant Governor,Todd Lamb,REP,170008,2,1,33,36,
Cotton,Superintendent of Public Instruction,John Cox,DEM,170008,1,1,16,18,
Cotton,Superintendent of Public Instruction,Joy Hofmeister,REP,170008,2,0,30,32,
Cotton,Commissioner of Labor,Mike Workman,DEM,170008,1,1,15,17,
Cotton,Commissioner of Labor,Mark Costello,REP,170008,2,0,31,33,
Cotton,U.S. Senate,Matt Silverstein,DEM,170008,1,0,11,12,
Cotton,U.S. Senate,Jim Inhofe,REP,170008,2,0,35,37,
Cotton,U.S. Senate,Aaron Delozier,IND,170008,0,1,0,1,
Cotton,U.S. Senate,Ray Woods,IND,170008,0,0,0,0,
Cotton,U.S. Senate,Joan Farr,IND,170008,0,0,1,1,
Cotton,U.S. Senate,Connie Johnson,DEM,170008,1,0,12,13,
Cotton,U.S. Senate,James Lankford,REP,170008,2,0,34,36,
Cotton,U.S. Senate,Mark Beard,IND,170008,0,1,1,2,
Cotton,U.S. House,Bert Smith,DEM,170008,1,0,11,12,04
Cotton,U.S. House,Tom Cole,REP,170008,2,0,34,36,04
Cotton,U.S. House,Dennis Johnson,IND,170008,0,1,2,3,04
Cotton,State House,Toni Hasenbeck,DEM,170008,0,0,12,12,65
Cotton,State House,Scooter Park,REP,170008,3,1,35,39,65
Cotton,Governor,Joe Dorman,DEM,170009,1,18,85,104,
Cotton,Governor,Mary Fallin,REP,170009,4,23,71,98,
Cotton,Governor,Kimberly Willis,IND,170009,0,0,6,6,
Cotton,Governor,Richard Prawdzienski,IND,170009,0,0,6,6,
Cotton,Lieutenant Governor,Cathy Cummings,DEM,170009,1,6,36,43,
Cotton,Lieutenant Governor,Todd Lamb,REP,170009,4,33,132,169,
Cotton,Superintendent of Public Instruction,John Cox,DEM,170009,1,9,78,88,
Cotton,Superintendent of Public Instruction,Joy Hofmeister,REP,170009,4,30,88,122,
Cotton,Commissioner of Labor,Mike Workman,DEM,170009,2,12,53,67,
Cotton,Commissioner of Labor,Mark Costello,REP,170009,3,25,113,141,
Cotton,U.S. Senate,Matt Silverstein,DEM,170009,1,8,29,38,
Cotton,U.S. Senate,Jim Inhofe,REP,170009,4,32,132,168,
Cotton,U.S. Senate,Aaron Delozier,IND,170009,0,0,1,1,
Cotton,U.S. Senate,Ray Woods,IND,170009,0,0,4,4,
Cotton,U.S. Senate,Joan Farr,IND,170009,0,0,2,2,
Cotton,U.S. Senate,Connie Johnson,DEM,170009,1,6,35,42,
Cotton,U.S. Senate,James Lankford,REP,170009,4,34,129,167,
Cotton,U.S. Senate,Mark Beard,IND,170009,0,0,4,4,
Cotton,U.S. House,Bert Smith,DEM,170009,0,3,21,24,04
Cotton,U.S. House,Tom Cole,REP,170009,5,38,140,183,04
Cotton,U.S. House,Dennis Johnson,IND,170009,0,0,7,7,04
Cotton,State House,Toni Hasenbeck,DEM,170009,1,8,64,73,65
Cotton,State House,Scooter Park,REP,170009,4,33,104,141,65
Cotton,Governor,Joe Dorman,DEM,170010,1,2,31,34,
Cotton,Governor,Mary Fallin,REP,170010,2,1,67,70,
Cotton,Governor,Kimberly Willis,IND,170010,0,0,2,2,
Cotton,Governor,Richard Prawdzienski,IND,170010,0,0,0,0,
Cotton,Lieutenant Governor,Cathy Cummings,DEM,170010,0,1,20,21,
Cotton,Lieutenant Governor,Todd Lamb,REP,170010,3,2,80,85,
Cotton,Superintendent of Public Instruction,John Cox,DEM,170010,1,1,30,32,
Cotton,Superintendent of Public Instruction,Joy Hofmeister,REP,170010,2,2,68,72,
Cotton,Commissioner of Labor,Mike Workman,DEM,170010,0,1,26,27,
Cotton,Commissioner of Labor,Mark Costello,REP,170010,3,2,72,77,
Cotton,U.S. Senate,Matt Silverstein,DEM,170010,0,1,16,17,
Cotton,U.S. Senate,Jim Inhofe,REP,170010,3,2,81,86,
Cotton,U.S. Senate,Aaron Delozier,IND,170010,0,0,0,0,
Cotton,U.S. Senate,Ray Woods,IND,170010,0,0,2,2,
Cotton,U.S. Senate,Joan Farr,IND,170010,0,0,0,0,
Cotton,U.S. Senate,Connie Johnson,DEM,170010,0,1,14,15,
Cotton,U.S. Senate,James Lankford,REP,170010,3,2,79,84,
Cotton,U.S. Senate,Mark Beard,IND,170010,0,0,6,6,
Cotton,U.S. House,Bert Smith,DEM,170010,0,1,12,13,04
Cotton,U.S. House,Tom Cole,REP,170010,3,2,86,91,04
Cotton,U.S. House,Dennis Johnson,IND,170010,0,0,2,2,04
Cotton,State House,Toni Hasenbeck,DEM,170010,0,0,12,12,65
Cotton,State House,Scooter Park,REP,170010,3,3,88,94,65
Cotton,Governor,Joe Dorman,DEM,170011,0,2,43,45,
Cotton,Governor,Mary Fallin,REP,170011,0,3,121,124,
Cotton,Governor,Kimberly Willis,IND,170011,0,0,5,5,
Cotton,Governor,Richard Prawdzienski,IND,170011,0,0,3,3,
Cotton,Lieutenant Governor,Cathy Cummings,DEM,170011,0,0,25,25,
Cotton,Lieutenant Governor,Todd Lamb,REP,170011,0,4,146,150,
Cotton,Superintendent of Public Instruction,John Cox,DEM,170011,0,1,47,48,
Cotton,Superintendent of Public Instruction,Joy Hofmeister,REP,170011,0,3,125,128,
Cotton,Commissioner of Labor,Mike Workman,DEM,170011,0,1,40,41,
Cotton,Commissioner of Labor,Mark Costello,REP,170011,0,3,129,132,
Cotton,U.S. Senate,Matt Silverstein,DEM,170011,0,0,26,26,
Cotton,U.S. Senate,Jim Inhofe,REP,170011,0,4,137,141,
Cotton,U.S. Senate,Aaron Delozier,IND,170011,0,0,0,0,
Cotton,U.S. Senate,Ray Woods,IND,170011,0,0,5,5,
Cotton,U.S. Senate,Joan Farr,IND,170011,0,0,2,2,
Cotton,U.S. Senate,Connie Johnson,DEM,170011,0,0,28,28,
Cotton,U.S. Senate,James Lankford,REP,170011,0,4,138,142,
Cotton,U.S. Senate,Mark Beard,IND,170011,0,0,5,5,
Cotton,U.S. House,Bert Smith,DEM,170011,0,0,29,29,04
Cotton,U.S. House,Tom Cole,REP,170011,0,5,133,138,04
Cotton,U.S. House,Dennis Johnson,IND,170011,0,0,7,7,04
Cotton,State House,Toni Hasenbeck,DEM,170011,0,2,34,36,65
Cotton,State House,Scooter Park,REP,170011,0,3,139,142,65
Craig,Governor,Joe Dorman,DEM,180140,1,2,149,152,
Craig,Governor,Mary Fallin,REP,180140,7,0,207,214,
Craig,Governor,Kimberly Willis,IND,180140,1,0,7,8,
Craig,Governor,Richard Prawdzienski,IND,180140,0,0,2,2,
Craig,Lieutenant Governor,Cathy Cummings,DEM,180140,0,0,115,115,
Craig,Lieutenant Governor,Todd Lamb,REP,180140,9,2,246,257,
Craig,Superintendent of Public Instruction,John Cox,DEM,180140,2,2,192,196,
Craig,Superintendent of Public Instruction,Joy Hofmeister,REP,180140,7,0,170,177,
Craig,Commissioner of Labor,Mike Workman,DEM,180140,2,2,155,159,
Craig,Commissioner of Labor,Mark Costello,REP,180140,7,0,198,205,
Craig,U.S. Senate,Matt Silverstein,DEM,180140,1,1,101,103,
Craig,U.S. Senate,Jim Inhofe,REP,180140,8,1,251,260,
Craig,U.S. Senate,Aaron Delozier,IND,180140,0,0,3,3,
Craig,U.S. Senate,Ray Woods,IND,180140,0,0,4,4,
Craig,U.S. Senate,Joan Farr,IND,180140,0,0,3,3,
Craig,U.S. Senate,Connie Johnson,DEM,180140,1,0,107,108,
Craig,U.S. Senate,James Lankford,REP,180140,8,1,242,251,
Craig,U.S. Senate,Mark Beard,IND,180140,0,1,11,12,
Craig,U.S. House,Earl Everett,DEM,180140,1,0,72,73,02
Craig,U.S. House,Markwayne Mullin,REP,180140,8,2,276,286,02
Craig,U.S. House,Jon Douthitt,IND,180140,0,0,17,17,02
Craig,State House,Chuck Hoskin,DEM,180140,6,2,230,238,6
Craig,State House,Marshall Scott Mcguire,REP,180140,3,0,136,139,6
Craig,Governor,Joe Dorman,DEM,180320,2,2,47,51,
Craig,Governor,Mary Fallin,REP,180320,9,6,57,72,
Craig,Governor,Kimberly Willis,IND,180320,1,0,3,4,
Craig,Governor,Richard Prawdzienski,IND,180320,0,0,1,1,
Craig,Lieutenant Governor,Cathy Cummings,DEM,180320,0,2,39,41,
Craig,Lieutenant Governor,Todd Lamb,REP,180320,12,6,68,86,
Craig,Superintendent of Public Instruction,John Cox,DEM,180320,5,2,69,76,
Craig,Superintendent of Public Instruction,Joy Hofmeister,REP,180320,6,6,37,49,
Craig,Commissioner of Labor,Mike Workman,DEM,180320,2,2,59,63,
Craig,Commissioner of Labor,Mark Costello,REP,180320,10,6,46,62,
Craig,U.S. Senate,Matt Silverstein,DEM,180320,0,2,42,44,
Craig,U.S. Senate,Jim Inhofe,REP,180320,12,6,57,75,
Craig,U.S. Senate,Aaron Delozier,IND,180320,0,0,0,0,
Craig,U.S. Senate,Ray Woods,IND,180320,0,0,3,3,
Craig,U.S. Senate,Joan Farr,IND,180320,0,0,2,2,
Craig,U.S. Senate,Connie Johnson,DEM,180320,0,1,32,33,
Craig,U.S. Senate,James Lankford,REP,180320,11,6,67,84,
Craig,U.S. Senate,Mark Beard,IND,180320,1,1,7,9,
Craig,U.S. House,Earl Everett,DEM,180320,0,0,25,25,02
Craig,U.S. House,Markwayne Mullin,REP,180320,12,8,73,93,02
Craig,U.S. House,Jon Douthitt,IND,180320,0,0,9,9,02
Craig,State House,Chuck Hoskin,DEM,180320,6,6,87,99,6
Craig,State House,Marshall Scott Mcguire,REP,180320,5,2,21,28,6
Craig,Governor,Joe Dorman,DEM,180410,0,4,88,92,
Craig,Governor,Mary Fallin,REP,180410,2,3,110,115,
Craig,Governor,Kimberly Willis,IND,180410,0,0,7,7,
Craig,Governor,Richard Prawdzienski,IND,180410,0,0,3,3,
Craig,Lieutenant Governor,Cathy Cummings,DEM,180410,0,4,73,77,
Craig,Lieutenant Governor,Todd Lamb,REP,180410,2,2,135,139,
Craig,Superintendent of Public Instruction,John Cox,DEM,180410,0,5,115,120,
Craig,Superintendent of Public Instruction,Joy Hofmeister,REP,180410,2,2,93,97,
Craig,Commissioner of Labor,Mike Workman,DEM,180410,0,4,114,118,
Craig,Commissioner of Labor,Mark Costello,REP,180410,2,2,87,91,
Craig,U.S. Senate,Matt Silverstein,DEM,180410,0,2,73,75,
Craig,U.S. Senate,Jim Inhofe,REP,180410,2,5,127,134,
Craig,U.S. Senate,Aaron Delozier,IND,180410,0,0,2,2,
Craig,U.S. Senate,Ray Woods,IND,180410,0,0,3,3,
Craig,U.S. Senate,Joan Farr,IND,180410,0,0,4,4,
Craig,U.S. Senate,Connie Johnson,DEM,180410,0,2,67,69,
Craig,U.S. Senate,James Lankford,REP,180410,2,5,127,134,
Craig,U.S. Senate,Mark Beard,IND,180410,0,0,11,11,
Craig,U.S. House,Earl Everett,DEM,180410,0,1,53,54,02
Craig,U.S. House,Markwayne Mullin,REP,180410,2,6,149,157,02
Craig,U.S. House,Jon Douthitt,IND,180410,0,0,6,6,02
Craig,State House,Chuck Hoskin,DEM,180410,1,6,150,157,6
Craig,State House,Marshall Scott Mcguire,REP,180410,1,1,60,62,6
Craig,Governor,Joe Dorman,DEM,180520,0,10,92,102,
Craig,Governor,Mary Fallin,REP,180520,3,5,136,144,
Craig,Governor,Kimberly Willis,IND,180520,0,1,4,5,
Craig,Governor,Richard Prawdzienski,IND,180520,0,0,0,0,
Craig,Lieutenant Governor,Cathy Cummings,DEM,180520,0,6,71,77,
Craig,Lieutenant Governor,Todd Lamb,REP,180520,3,10,153,166,
Craig,Superintendent of Public Instruction,John Cox,DEM,180520,3,16,135,154,
Craig,Superintendent of Public Instruction,Joy Hofmeister,REP,180520,0,0,94,94,
Craig,Commissioner of Labor,Mike Workman,DEM,180520,1,9,114,124,
Craig,Commissioner of Labor,Mark Costello,REP,180520,2,7,110,119,
Craig,U.S. Senate,Matt Silverstein,DEM,180520,0,4,66,70,
Craig,U.S. Senate,Jim Inhofe,REP,180520,3,9,156,168,
Craig,U.S. Senate,Aaron Delozier,IND,180520,0,0,3,3,
Craig,U.S. Senate,Ray Woods,IND,180520,0,1,1,2,
Craig,U.S. Senate,Joan Farr,IND,180520,0,2,3,5,
Craig,U.S. Senate,Connie Johnson,DEM,180520,1,6,68,75,
Craig,U.S. Senate,James Lankford,REP,180520,2,9,154,165,
Craig,U.S. Senate,Mark Beard,IND,180520,0,1,3,4,
Craig,U.S. House,Earl Everett,DEM,180520,0,2,40,42,02
Craig,U.S. House,Markwayne Mullin,REP,180520,3,12,178,193,02
Craig,U.S. House,Jon Douthitt,IND,180520,0,2,8,10,02
Craig,State House,Chuck Hoskin,DEM,180520,3,12,166,181,6
Craig,State House,Marshall Scott Mcguire,REP,180520,0,4,64,68,6
Craig,Governor,Joe Dorman,DEM,180611,1,11,136,148,
Craig,Governor,Mary Fallin,REP,180611,1,6,143,150,
Craig,Governor,Kimberly Willis,IND,180611,0,0,14,14,
Craig,Governor,Richard Prawdzienski,IND,180611,0,0,6,6,
Craig,Lieutenant Governor,Cathy Cummings,DEM,180611,1,7,101,109,
Craig,Lieutenant Governor,Todd Lamb,REP,180611,1,10,197,208,
Craig,Superintendent of Public Instruction,John Cox,DEM,180611,1,12,170,183,
Craig,Superintendent of Public Instruction,Joy Hofmeister,REP,180611,1,5,129,135,
Craig,Commissioner of Labor,Mike Workman,DEM,180611,1,11,149,161,
Craig,Commissioner of Labor,Mark Costello,REP,180611,1,5,143,149,
Craig,U.S. Senate,Matt Silverstein,DEM,180611,1,9,88,98,
Craig,U.S. Senate,Jim Inhofe,REP,180611,1,8,202,211,
Craig,U.S. Senate,Aaron Delozier,IND,180611,0,0,6,6,
Craig,U.S. Senate,Ray Woods,IND,180611,0,0,1,1,
Craig,U.S. Senate,Joan Farr,IND,180611,0,0,4,4,
Craig,U.S. Senate,Connie Johnson,DEM,180611,1,7,103,111,
Craig,U.S. Senate,James Lankford,REP,180611,1,10,187,198,
Craig,U.S. Senate,Mark Beard,IND,180611,0,0,6,6,
Craig,U.S. House,Earl Everett,DEM,180611,1,6,70,77,02
Craig,U.S. House,Markwayne Mullin,REP,180611,1,11,217,229,02
Craig,U.S. House,Jon Douthitt,IND,180611,0,0,13,13,02
Craig,State House,Chuck Hoskin,DEM,180611,0,15,245,260,6
Craig,State House,Marshall Scott Mcguire,REP,180611,2,2,56,60,6
Craig,Governor,Joe Dorman,DEM,180612,3,4,94,101,
Craig,Governor,Mary Fallin,REP,180612,4,5,104,113,
Craig,Governor,Kimberly Willis,IND,180612,0,0,4,4,
Craig,Governor,Richard Prawdzienski,IND,180612,0,0,4,4,
Craig,Lieutenant Governor,Cathy Cummings,DEM,180612,2,4,67,73,
Craig,Lieutenant Governor,Todd Lamb,REP,180612,5,5,136,146,
Craig,Superintendent of Public Instruction,John Cox,DEM,180612,5,6,117,128,
Craig,Superintendent of Public Instruction,Joy Hofmeister,REP,180612,2,3,88,93,
Craig,Commissioner of Labor,Mike Workman,DEM,180612,2,5,116,123,
Craig,Commissioner of Labor,Mark Costello,REP,180612,4,4,79,87,
Craig,U.S. Senate,Matt Silverstein,DEM,180612,1,4,64,69,
Craig,U.S. Senate,Jim Inhofe,REP,180612,5,5,131,141,
Craig,U.S. Senate,Aaron Delozier,IND,180612,0,0,2,2,
Craig,U.S. Senate,Ray Woods,IND,180612,0,0,3,3,
Craig,U.S. Senate,Joan Farr,IND,180612,0,0,5,5,
Craig,U.S. Senate,Connie Johnson,DEM,180612,1,5,73,79,
Craig,U.S. Senate,James Lankford,REP,180612,5,4,122,131,
Craig,U.S. Senate,Mark Beard,IND,180612,0,0,7,7,
Craig,U.S. House,Earl Everett,DEM,180612,2,3,47,52,02
Craig,U.S. House,Markwayne Mullin,REP,180612,4,4,142,150,02
Craig,U.S. House,Jon Douthitt,IND,180612,0,2,17,19,02
Craig,State House,Chuck Hoskin,DEM,180612,4,6,174,184,6
Craig,State House,Marshall Scott Mcguire,REP,180612,3,3,32,38,6
Craig,Governor,Joe Dorman,DEM,180621,7,26,244,277,
Craig,Governor,Mary Fallin,REP,180621,4,20,205,229,
Craig,Governor,Kimberly Willis,IND,180621,0,0,6,6,
Craig,Governor,Richard Prawdzienski,IND,180621,0,1,8,9,
Craig,Lieutenant Governor,Cathy Cummings,DEM,180621,6,17,177,200,
Craig,Lieutenant Governor,Todd Lamb,REP,180621,5,30,284,319,
Craig,Superintendent of Public Instruction,John Cox,DEM,180621,10,29,288,327,
Craig,Superintendent of Public Instruction,Joy Hofmeister,REP,180621,1,18,172,191,
Craig,Commissioner of Labor,Mike Workman,DEM,180621,8,22,239,269,
Craig,Commissioner of Labor,Mark Costello,REP,180621,3,24,217,244,
Craig,U.S. Senate,Matt Silverstein,DEM,180621,7,14,157,178,
Craig,U.S. Senate,Jim Inhofe,REP,180621,3,31,284,318,
Craig,U.S. Senate,Aaron Delozier,IND,180621,0,2,12,14,
Craig,U.S. Senate,Ray Woods,IND,180621,1,0,5,6,
Craig,U.S. Senate,Joan Farr,IND,180621,0,0,4,4,
Craig,U.S. Senate,Connie Johnson,DEM,180621,6,17,167,190,
Craig,U.S. Senate,James Lankford,REP,180621,5,29,283,317,
Craig,U.S. Senate,Mark Beard,IND,180621,0,1,12,13,
Craig,U.S. House,Earl Everett,DEM,180621,5,13,111,129,02
Craig,U.S. House,Markwayne Mullin,REP,180621,5,33,322,360,02
Craig,U.S. House,Jon Douthitt,IND,180621,1,1,31,33,02
Craig,State House,Chuck Hoskin,DEM,180621,9,43,382,434,6
Craig,State House,Marshall Scott Mcguire,REP,180621,2,4,83,89,6
Craig,Governor,Joe Dorman,DEM,180622,3,10,148,161,
Craig,Governor,Mary Fallin,REP,180622,8,9,119,136,
Craig,Governor,Kimberly Willis,IND,180622,0,0,6,6,
Craig,Governor,Richard Prawdzienski,IND,180622,0,0,4,4,
Craig,Lieutenant Governor,Cathy Cummings,DEM,180622,2,11,123,136,
Craig,Lieutenant Governor,Todd Lamb,REP,180622,8,8,152,168,
Craig,Superintendent of Public Instruction,John Cox,DEM,180622,3,10,180,193,
Craig,Superintendent of Public Instruction,Joy Hofmeister,REP,180622,7,9,95,111,
Craig,Commissioner of Labor,Mike Workman,DEM,180622,3,12,160,175,
Craig,Commissioner of Labor,Mark Costello,REP,180622,7,7,110,124,
Craig,U.S. Senate,Matt Silverstein,DEM,180622,1,11,106,118,
Craig,U.S. Senate,Jim Inhofe,REP,180622,8,8,156,172,
Craig,U.S. Senate,Aaron Delozier,IND,180622,1,0,7,8,
Craig,U.S. Senate,Ray Woods,IND,180622,0,0,2,2,
Craig,U.S. Senate,Joan Farr,IND,180622,0,0,3,3,
Craig,U.S. Senate,Connie Johnson,DEM,180622,2,9,118,129,
Craig,U.S. Senate,James Lankford,REP,180622,8,10,147,165,
Craig,U.S. Senate,Mark Beard,IND,180622,0,0,8,8,
Craig,U.S. House,Earl Everett,DEM,180622,2,8,93,103,02
Craig,U.S. House,Markwayne Mullin,REP,180622,7,11,167,185,02
Craig,U.S. House,Jon Douthitt,IND,180622,1,0,14,15,02
Craig,State House,Chuck Hoskin,DEM,180622,8,16,232,256,6
Craig,State House,Marshall Scott Mcguire,REP,180622,3,3,45,51,6
Craig,Governor,Joe Dorman,DEM,180710,2,5,78,85,
Craig,Governor,Mary Fallin,REP,180710,6,6,126,138,
Craig,Governor,Kimberly Willis,IND,180710,0,0,6,6,
Craig,Governor,Richard Prawdzienski,IND,180710,0,0,0,0,
Craig,Lieutenant Governor,Cathy Cummings,DEM,180710,0,2,67,69,
Craig,Lieutenant Governor,Todd Lamb,REP,180710,8,6,143,157,
Craig,Superintendent of Public Instruction,John Cox,DEM,180710,0,4,107,111,
Craig,Superintendent of Public Instruction,Joy Hofmeister,REP,180710,7,5,103,115,
Craig,Commissioner of Labor,Mike Workman,DEM,180710,0,5,92,97,
Craig,Commissioner of Labor,Mark Costello,REP,180710,7,3,116,126,
Craig,U.S. Senate,Matt Silverstein,DEM,180710,0,2,56,58,
Craig,U.S. Senate,Jim Inhofe,REP,180710,8,8,145,161,
Craig,U.S. Senate,Aaron Delozier,IND,180710,0,0,5,5,
Craig,U.S. Senate,Ray Woods,IND,180710,0,0,4,4,
Craig,U.S. Senate,Joan Farr,IND,180710,0,0,0,0,
Craig,U.S. Senate,Connie Johnson,DEM,180710,0,4,55,59,
Craig,U.S. Senate,James Lankford,REP,180710,8,5,147,160,
Craig,U.S. Senate,Mark Beard,IND,180710,0,0,9,9,
Craig,U.S. House,Earl Everett,DEM,180710,0,1,36,37,02
Craig,U.S. House,Markwayne Mullin,REP,180710,8,8,163,179,02
Craig,U.S. House,Jon Douthitt,IND,180710,0,0,11,11,02
Craig,State House,Chuck Hoskin,DEM,180710,3,7,150,160,6
Craig,State House,Marshall Scott Mcguire,REP,180710,5,4,60,69,6
Craig,Governor,Joe Dorman,DEM,180810,2,5,93,100,
Craig,Governor,Mary Fallin,REP,180810,2,13,239,254,
Craig,Governor,Kimberly Willis,IND,180810,0,0,8,8,
Craig,Governor,Richard Prawdzienski,IND,180810,0,0,1,1,
Craig,Lieutenant Governor,Cathy Cummings,DEM,180810,2,2,68,72,
Craig,Lieutenant Governor,Todd Lamb,REP,180810,1,16,270,287,
Craig,Superintendent of Public Instruction,John Cox,DEM,180810,3,10,167,180,
Craig,Superintendent of Public Instruction,Joy Hofmeister,REP,180810,1,8,174,183,
Craig,Commissioner of Labor,Mike Workman,DEM,180810,2,5,112,119,
Craig,Commissioner of Labor,Mark Costello,REP,180810,1,13,224,238,
Craig,U.S. Senate,Matt Silverstein,DEM,180810,3,3,68,74,
Craig,U.S. Senate,Jim Inhofe,REP,180810,1,14,258,273,
Craig,U.S. Senate,Aaron Delozier,IND,180810,0,0,9,9,
Craig,U.S. Senate,Ray Woods,IND,180810,0,0,2,2,
Craig,U.S. Senate,Joan Farr,IND,180810,0,0,6,6,
Craig,U.S. Senate,Connie Johnson,DEM,180810,2,2,68,72,
Craig,U.S. Senate,James Lankford,REP,180810,1,16,261,278,
Craig,U.S. Senate,Mark Beard,IND,180810,0,0,13,13,
Craig,U.S. House,Earl Everett,DEM,180810,2,0,48,50,02
Craig,U.S. House,Markwayne Mullin,REP,180810,2,18,276,296,02
Craig,U.S. House,Jon Douthitt,IND,180810,0,0,17,17,02
Craig,State House,Chuck Hoskin,DEM,180810,3,11,190,204,6
Craig,State House,Marshall Scott Mcguire,REP,180810,1,7,151,159,6
Craig,Governor,Joe Dorman,DEM,180820,1,6,107,114,
Craig,Governor,Mary Fallin,REP,180820,7,14,225,246,
Craig,Governor,Kimberly Willis,IND,180820,0,0,8,8,
Craig,Governor,Richard Prawdzienski,IND,180820,0,0,6,6,
Craig,Lieutenant Governor,Cathy Cummings,DEM,180820,0,5,93,98,
Craig,Lieutenant Governor,Todd Lamb,REP,180820,8,15,251,274,
Craig,Superintendent of Public Instruction,John Cox,DEM,180820,3,10,165,178,
Craig,Superintendent of Public Instruction,Joy Hofmeister,REP,180820,5,10,180,195,
Craig,Commissioner of Labor,Mike Workman,DEM,180820,2,8,134,144,
Craig,Commissioner of Labor,Mark Costello,REP,180820,6,11,195,212,
Craig,U.S. Senate,Matt Silverstein,DEM,180820,0,5,84,89,
Craig,U.S. Senate,Jim Inhofe,REP,180820,7,15,255,277,
Craig,U.S. Senate,Aaron Delozier,IND,180820,0,0,5,5,
Craig,U.S. Senate,Ray Woods,IND,180820,0,0,2,2,
Craig,U.S. Senate,Joan Farr,IND,180820,0,0,3,3,
Craig,U.S. Senate,Connie Johnson,DEM,180820,0,5,87,92,
Craig,U.S. Senate,James Lankford,REP,180820,8,13,253,274,
Craig,U.S. Senate,Mark Beard,IND,180820,0,1,5,6,
Craig,U.S. House,Earl Everett,DEM,180820,0,5,65,70,02
Craig,U.S. House,Markwayne Mullin,REP,180820,8,15,272,295,02
Craig,U.S. House,Jon Douthitt,IND,180820,0,0,11,11,02
Craig,State House,Chuck Hoskin,DEM,180820,4,16,219,239,6
Craig,State House,Marshall Scott Mcguire,REP,180820,4,4,125,133,6
Craig,Governor,Joe Dorman,DEM,180910,0,5,103,108,
Craig,Governor,Mary Fallin,REP,180910,1,11,135,147,
Craig,Governor,Kimberly Willis,IND,180910,0,0,1,1,
Craig,Governor,Richard Prawdzienski,IND,180910,0,0,2,2,
Craig,Lieutenant Governor,Cathy Cummings,DEM,180910,0,5,67,72,
Craig,Lieutenant Governor,Todd Lamb,REP,180910,1,11,173,185,
Craig,Superintendent of Public Instruction,John Cox,DEM,180910,0,6,128,134,
Craig,Superintendent of Public Instruction,Joy Hofmeister,REP,180910,1,10,111,122,
Craig,Commissioner of Labor,Mike Workman,DEM,180910,0,4,114,118,
Craig,Commissioner of Labor,Mark Costello,REP,180910,1,12,121,134,
Craig,U.S. Senate,Matt Silverstein,DEM,180910,0,4,60,64,
Craig,U.S. Senate,Jim Inhofe,REP,180910,1,12,174,187,
Craig,U.S. Senate,Aaron Delozier,IND,180910,0,0,3,3,
Craig,U.S. Senate,Ray Woods,IND,180910,0,0,0,0,
Craig,U.S. Senate,Joan Farr,IND,180910,0,0,1,1,
Craig,U.S. Senate,Connie Johnson,DEM,180910,0,4,61,65,
Craig,U.S. Senate,James Lankford,REP,180910,1,12,171,184,
Craig,U.S. Senate,Mark Beard,IND,180910,0,0,5,5,
Craig,U.S. House,Earl Everett,DEM,180910,0,4,33,37,02
Craig,U.S. House,Markwayne Mullin,REP,180910,1,12,199,212,02
Craig,U.S. House,Jon Douthitt,IND,180910,0,0,8,8,02
Craig,State House,Chuck Hoskin,DEM,180910,0,10,179,189,6
Craig,State House,Marshall Scott Mcguire,REP,180910,1,6,63,70,6
Creek,Governor,Joe Dorman,DEM,190111,2,10,128,140,
Creek,Governor,Mary Fallin,REP,190111,9,24,223,256,
Creek,Governor,Kimberly Willis,IND,190111,1,0,7,8,
Creek,Governor,Richard Prawdzienski,IND,190111,1,0,4,5,
Creek,Lieutenant Governor,Cathy Cummings,DEM,190111,4,9,107,120,
Creek,Lieutenant Governor,Todd Lamb,REP,190111,9,25,254,288,
Creek,Superintendent of Public Instruction,John Cox,DEM,190111,2,16,142,160,
Creek,Superintendent of Public Instruction,Joy Hofmeister,REP,190111,11,18,219,248,
Creek,Commissioner of Labor,Mike Workman,DEM,190111,5,12,122,139,
Creek,Commissioner of Labor,Mark Costello,REP,190111,8,21,233,262,
Creek,U.S. Senate,Matt Silverstein,DEM,190111,4,9,87,100,
Creek,U.S. Senate,Jim Inhofe,REP,190111,9,25,258,292,
Creek,U.S. Senate,Aaron Delozier,IND,190111,0,0,2,2,
Creek,U.S. Senate,Ray Woods,IND,190111,0,0,5,5,
Creek,U.S. Senate,Joan Farr,IND,190111,0,0,8,8,
Creek,U.S. Senate,Connie Johnson,DEM,190111,3,9,87,99,
Creek,U.S. Senate,James Lankford,REP,190111,10,25,256,291,
Creek,U.S. Senate,Mark Beard,IND,190111,0,0,17,17,
Creek,U.S. House,Frankie Robbins,DEM,190111,4,10,91,105,03
Creek,U.S. House,Frank Lucas,REP,190111,9,24,268,301,03
Creek,Governor,Joe Dorman,DEM,190112,1,3,40,44,
Creek,Governor,Mary Fallin,REP,190112,2,1,79,82,
Creek,Governor,Kimberly Willis,IND,190112,0,0,1,1,
Creek,Governor,Richard Prawdzienski,IND,190112,0,0,3,3,
Creek,Lieutenant Governor,Cathy Cummings,DEM,190112,1,3,32,36,
Creek,Lieutenant Governor,Todd Lamb,REP,190112,2,1,91,94,
Creek,Superintendent of Public Instruction,John Cox,DEM,190112,1,3,39,43,
Creek,Superintendent of Public Instruction,Joy Hofmeister,REP,190112,2,1,83,86,
Creek,Commissioner of Labor,Mike Workman,DEM,190112,1,3,32,36,
Creek,Commissioner of Labor,Mark Costello,REP,190112,2,1,91,94,
Creek,U.S. Senate,Matt Silverstein,DEM,190112,1,3,31,35,
Creek,U.S. Senate,Jim Inhofe,REP,190112,2,1,87,90,
Creek,U.S. Senate,Aaron Delozier,IND,190112,0,0,3,3,
Creek,U.S. Senate,Ray Woods,IND,190112,0,0,2,2,
Creek,U.S. Senate,Joan Farr,IND,190112,0,0,0,0,
Creek,U.S. Senate,Connie Johnson,DEM,190112,1,3,31,35,
Creek,U.S. Senate,James Lankford,REP,190112,2,1,87,90,
Creek,U.S. Senate,Mark Beard,IND,190112,0,0,4,4,
Creek,U.S. House,Frankie Robbins,DEM,190112,1,3,33,37,03
Creek,U.S. House,Frank Lucas,REP,190112,2,1,88,91,03
Creek,Governor,Joe Dorman,DEM,190121,5,24,173,202,
Creek,Governor,Mary Fallin,REP,190121,12,25,395,432,
Creek,Governor,Kimberly Willis,IND,190121,0,0,12,12,
Creek,Governor,Richard Prawdzienski,IND,190121,2,1,6,9,
Creek,Lieutenant Governor,Cathy Cummings,DEM,190121,5,14,121,140,
Creek,Lieutenant Governor,Todd Lamb,REP,190121,14,36,464,514,
Creek,Superintendent of Public Instruction,John Cox,DEM,190121,6,20,190,216,
Creek,Superintendent of Public Instruction,Joy Hofmeister,REP,190121,13,30,396,439,
Creek,Commissioner of Labor,Mike Workman,DEM,190121,7,17,158,182,
Creek,Commissioner of Labor,Mark Costello,REP,190121,12,32,425,469,
Creek,U.S. Senate,Matt Silverstein,DEM,190121,5,14,127,146,
Creek,U.S. Senate,Jim Inhofe,REP,190121,12,33,437,482,
Creek,U.S. Senate,Aaron Delozier,IND,190121,2,2,7,11,
Creek,U.S. Senate,Ray Woods,IND,190121,0,1,5,6,
Creek,U.S. Senate,Joan Farr,IND,190121,0,0,7,7,
Creek,U.S. Senate,Connie Johnson,DEM,190121,5,11,118,134,
Creek,U.S. Senate,James Lankford,REP,190121,13,35,454,502,
Creek,U.S. Senate,Mark Beard,IND,190121,1,4,14,19,
Creek,U.S. House,Frankie Robbins,DEM,190121,5,16,126,147,03
Creek,U.S. House,Frank Lucas,REP,190121,13,34,459,506,03
Creek,State House,Robert Bobby Talley,DEM,190121,6,16,136,158,29
Creek,State House,James Leewright,REP,190121,13,34,449,496,29
Creek,Governor,Joe Dorman,DEM,190122,0,2,100,102,
Creek,Governor,Mary Fallin,REP,190122,1,2,18,21,
Creek,Governor,Kimberly Willis,IND,190122,0,0,6,6,
Creek,Governor,Richard Prawdzienski,IND,190122,0,0,1,1,
Creek,Lieutenant Governor,Cathy Cummings,DEM,190122,0,1,90,91,
Creek,Lieutenant Governor,Todd Lamb,REP,190122,1,3,35,39,
Creek,Superintendent of Public Instruction,John Cox,DEM,190122,0,2,96,98,
Creek,Superintendent of Public Instruction,Joy Hofmeister,REP,190122,1,2,28,31,
Creek,Commissioner of Labor,Mike Workman,DEM,190122,0,2,97,99,
Creek,Commissioner of Labor,Mark Costello,REP,190122,1,2,27,30,
Creek,U.S. Senate,Matt Silverstein,DEM,190122,0,1,96,97,
Creek,U.S. Senate,Jim Inhofe,REP,190122,1,2,26,29,
Creek,U.S. Senate,Aaron Delozier,IND,190122,0,1,1,2,
Creek,U.S. Senate,Ray Woods,IND,190122,0,0,1,1,
Creek,U.S. Senate,Joan Farr,IND,190122,0,0,1,1,
Creek,U.S. Senate,Connie Johnson,DEM,190122,0,1,95,96,
Creek,U.S. Senate,James Lankford,REP,190122,1,3,26,30,
Creek,U.S. Senate,Mark Beard,IND,190122,0,0,4,4,
Creek,U.S. House,Frankie Robbins,DEM,190122,0,2,92,94,03
Creek,U.S. House,Frank Lucas,REP,190122,1,2,32,35,03
Creek,Governor,Joe Dorman,DEM,190131,0,16,103,119,
Creek,Governor,Mary Fallin,REP,190131,6,17,144,167,
Creek,Governor,Kimberly Willis,IND,190131,0,0,5,5,
Creek,Governor,Richard Prawdzienski,IND,190131,1,1,1,3,
Creek,Lieutenant Governor,Cathy Cummings,DEM,190131,1,16,88,105,
Creek,Lieutenant Governor,Todd Lamb,REP,190131,5,18,165,188,
Creek,Superintendent of Public Instruction,John Cox,DEM,190131,1,22,109,132,
Creek,Superintendent of Public Instruction,Joy Hofmeister,REP,190131,6,12,144,162,
Creek,Commissioner of Labor,Mike Workman,DEM,190131,0,18,98,116,
Creek,Commissioner of Labor,Mark Costello,REP,190131,7,15,154,176,
Creek,U.S. Senate,Matt Silverstein,DEM,190131,0,12,71,83,
Creek,U.S. Senate,Jim Inhofe,REP,190131,6,19,176,201,
Creek,U.S. Senate,Aaron Delozier,IND,190131,0,1,2,3,
Creek,U.S. Senate,Ray Woods,IND,190131,1,0,0,1,
Creek,U.S. Senate,Joan Farr,IND,190131,0,1,3,4,
Creek,U.S. Senate,Connie Johnson,DEM,190131,0,14,82,96,
Creek,U.S. Senate,James Lankford,REP,190131,6,19,160,185,
Creek,U.S. Senate,Mark Beard,IND,190131,1,1,11,13,
Creek,U.S. House,Frankie Robbins,DEM,190131,0,13,79,92,03
Creek,U.S. House,Frank Lucas,REP,190131,6,21,174,201,03
Creek,Governor,Joe Dorman,DEM,190132,10,12,150,172,
Creek,Governor,Mary Fallin,REP,190132,7,22,263,292,
Creek,Governor,Kimberly Willis,IND,190132,1,1,5,7,
Creek,Governor,Richard Prawdzienski,IND,190132,0,1,6,7,
Creek,Lieutenant Governor,Cathy Cummings,DEM,190132,10,10,106,126,
Creek,Lieutenant Governor,Todd Lamb,REP,190132,8,26,317,351,
Creek,Superintendent of Public Instruction,John Cox,DEM,190132,11,10,164,185,
Creek,Superintendent of Public Instruction,Joy Hofmeister,REP,190132,6,26,258,290,
Creek,Commissioner of Labor,Mike Workman,DEM,190132,11,13,144,168,
Creek,Commissioner of Labor,Mark Costello,REP,190132,6,23,274,303,
Creek,U.S. Senate,Matt Silverstein,DEM,190132,10,10,108,128,
Creek,U.S. Senate,Jim Inhofe,REP,190132,6,25,296,327,
Creek,U.S. Senate,Aaron Delozier,IND,190132,0,1,7,8,
Creek,U.S. Senate,Ray Woods,IND,190132,1,0,6,7,
Creek,U.S. Senate,Joan Farr,IND,190132,0,0,6,6,
Creek,U.S. Senate,Connie Johnson,DEM,190132,9,8,106,123,
Creek,U.S. Senate,James Lankford,REP,190132,8,28,297,333,
Creek,U.S. Senate,Mark Beard,IND,190132,1,0,17,18,
Creek,U.S. House,Frankie Robbins,DEM,190132,11,8,119,138,03
Creek,U.S. House,Frank Lucas,REP,190132,7,28,304,339,03
Creek,Governor,Joe Dorman,DEM,190142,15,56,318,389,
Creek,Governor,Mary Fallin,REP,190142,6,82,565,653,
Creek,Governor,Kimberly Willis,IND,190142,1,1,31,33,
Creek,Governor,Richard Prawdzienski,IND,190142,0,0,14,14,
Creek,Lieutenant Governor,Cathy Cummings,DEM,190142,15,37,234,286,
Creek,Lieutenant Governor,Todd Lamb,REP,190142,6,103,692,801,
Creek,Superintendent of Public Instruction,John Cox,DEM,190142,16,58,332,406,
Creek,Superintendent of Public Instruction,Joy Hofmeister,REP,190142,5,81,593,679,
Creek,Commissioner of Labor,Mike Workman,DEM,190142,14,44,279,337,
Creek,Commissioner of Labor,Mark Costello,REP,190142,6,86,633,725,
Creek,U.S. Senate,Matt Silverstein,DEM,190142,12,41,236,289,
Creek,U.S. Senate,Jim Inhofe,REP,190142,9,93,658,760,
Creek,U.S. Senate,Aaron Delozier,IND,190142,0,2,12,14,
Creek,U.S. Senate,Ray Woods,IND,190142,1,0,7,8,
Creek,U.S. Senate,Joan Farr,IND,190142,0,1,11,12,
Creek,U.S. Senate,Connie Johnson,DEM,190142,13,38,217,268,
Creek,U.S. Senate,James Lankford,REP,190142,8,100,675,783,
Creek,U.S. Senate,Mark Beard,IND,190142,1,2,35,38,
Creek,U.S. House,Frankie Robbins,DEM,190142,12,36,236,284,03
Creek,U.S. House,Frank Lucas,REP,190142,9,103,686,798,03
Creek,Governor,Joe Dorman,DEM,190143,8,16,157,181,
Creek,Governor,Mary Fallin,REP,190143,8,32,225,265,
Creek,Governor,Kimberly Willis,IND,190143,0,0,8,8,
Creek,Governor,Richard Prawdzienski,IND,190143,1,0,4,5,
Creek,Lieutenant Governor,Cathy Cummings,DEM,190143,8,14,135,157,
Creek,Lieutenant Governor,Todd Lamb,REP,190143,9,35,258,302,
Creek,Superintendent of Public Instruction,John Cox,DEM,190143,6,20,177,203,
Creek,Superintendent of Public Instruction,Joy Hofmeister,REP,190143,10,29,216,255,
Creek,Commissioner of Labor,Mike Workman,DEM,190143,7,19,149,175,
Creek,Commissioner of Labor,Mark Costello,REP,190143,9,29,241,279,
Creek,U.S. Senate,Matt Silverstein,DEM,190143,7,13,122,142,
Creek,U.S. Senate,Jim Inhofe,REP,190143,8,35,259,302,
Creek,U.S. Senate,Aaron Delozier,IND,190143,0,1,5,6,
Creek,U.S. Senate,Ray Woods,IND,190143,2,0,5,7,
Creek,U.S. Senate,Joan Farr,IND,190143,0,0,3,3,
Creek,U.S. Senate,Connie Johnson,DEM,190143,7,14,130,151,
Creek,U.S. Senate,James Lankford,REP,190143,7,32,242,281,
Creek,U.S. Senate,Mark Beard,IND,190143,2,2,21,25,
Creek,U.S. House,Frankie Robbins,DEM,190143,7,14,135,156,03
Creek,U.S. House,Frank Lucas,REP,190143,10,35,259,304,03
Creek,Governor,Joe Dorman,DEM,190211,3,0,123,126,
Creek,Governor,Mary Fallin,REP,190211,6,1,91,98,
Creek,Governor,Kimberly Willis,IND,190211,0,0,6,6,
Creek,Governor,Richard Prawdzienski,IND,190211,0,0,1,1,
Creek,Lieutenant Governor,Cathy Cummings,DEM,190211,4,0,77,81,
Creek,Lieutenant Governor,Todd Lamb,REP,190211,5,1,146,152,
Creek,Superintendent of Public Instruction,John Cox,DEM,190211,5,0,125,130,
Creek,Superintendent of Public Instruction,Joy Hofmeister,REP,190211,3,1,98,102,
Creek,Commissioner of Labor,Mike Workman,DEM,190211,5,0,106,111,
Creek,Commissioner of Labor,Mark Costello,REP,190211,3,1,114,118,
Creek,U.S. Senate,Matt Silverstein,DEM,190211,4,0,78,82,
Creek,U.S. Senate,Jim Inhofe,REP,190211,5,1,137,143,
Creek,U.S. Senate,Aaron Delozier,IND,190211,0,0,3,3,
Creek,U.S. Senate,Ray Woods,IND,190211,0,0,2,2,
Creek,U.S. Senate,Joan Farr,IND,190211,0,0,2,2,
Creek,U.S. Senate,Connie Johnson,DEM,190211,4,0,76,80,
Creek,U.S. Senate,James Lankford,REP,190211,4,1,135,140,
Creek,U.S. Senate,Mark Beard,IND,190211,0,0,12,12,
Creek,U.S. House,Frankie Robbins,DEM,190211,5,0,79,84,03
Creek,U.S. House,Frank Lucas,REP,190211,4,1,143,148,03
Creek,State House,Robert Bobby Talley,DEM,190211,5,0,63,68,29
Creek,State House,James Leewright,REP,190211,3,1,159,163,29
Creek,Governor,Joe Dorman,DEM,190221,0,0,75,75,
Creek,Governor,Mary Fallin,REP,190221,1,0,72,73,
Creek,Governor,Kimberly Willis,IND,190221,0,0,5,5,
Creek,Governor,Richard Prawdzienski,IND,190221,0,0,3,3,
Creek,Lieutenant Governor,Cathy Cummings,DEM,190221,0,0,58,58,
Creek,Lieutenant Governor,Todd Lamb,REP,190221,1,0,94,95,
Creek,Superintendent of Public Instruction,John Cox,DEM,190221,0,0,82,82,
Creek,Superintendent of Public Instruction,Joy Hofmeister,REP,190221,1,0,69,70,
Creek,Commissioner of Labor,Mike Workman,DEM,190221,0,0,76,76,
Creek,Commissioner of Labor,Mark Costello,REP,190221,1,0,74,75,
Creek,U.S. Senate,Matt Silverstein,DEM,190221,0,0,61,61,
Creek,U.S. Senate,Jim Inhofe,REP,190221,1,0,84,85,
Creek,U.S. Senate,Aaron Delozier,IND,190221,0,0,1,1,
Creek,U.S. Senate,Ray Woods,IND,190221,0,0,5,5,
Creek,U.S. Senate,Joan Farr,IND,190221,0,0,1,1,
Creek,U.S. Senate,Connie Johnson,DEM,190221,0,0,57,57,
Creek,U.S. Senate,James Lankford,REP,190221,1,0,85,86,
Creek,U.S. Senate,Mark Beard,IND,190221,0,0,10,10,
Creek,U.S. House,Frankie Robbins,DEM,190221,0,0,53,53,03
Creek,U.S. House,Frank Lucas,REP,190221,1,0,99,100,03
Creek,State House,Robert Bobby Talley,DEM,190221,0,0,47,47,29
Creek,State House,James Leewright,REP,190221,1,0,103,104,29
Creek,Governor,Joe Dorman,DEM,190231,1,0,121,122,
Creek,Governor,Mary Fallin,REP,190231,0,3,130,133,
Creek,Governor,Kimberly Willis,IND,190231,1,0,4,5,
Creek,Governor,Richard Prawdzienski,IND,190231,1,0,0,1,
Creek,Lieutenant Governor,Cathy Cummings,DEM,190231,2,0,88,90,
Creek,Lieutenant Governor,Todd Lamb,REP,190231,1,3,164,168,
Creek,Superintendent of Public Instruction,John Cox,DEM,190231,2,0,136,138,
Creek,Superintendent of Public Instruction,Joy Hofmeister,REP,190231,1,3,119,123,
Creek,Commissioner of Labor,Mike Workman,DEM,190231,2,0,112,114,
Creek,Commissioner of Labor,Mark Costello,REP,190231,1,3,140,144,
Creek,U.S. Senate,Matt Silverstein,DEM,190231,0,0,85,85,
Creek,U.S. Senate,Jim Inhofe,REP,190231,1,2,163,166,
Creek,U.S. Senate,Aaron Delozier,IND,190231,0,1,4,5,
Creek,U.S. Senate,Ray Woods,IND,190231,1,0,2,3,
Creek,U.S. Senate,Joan Farr,IND,190231,1,0,1,2,
Creek,U.S. Senate,Connie Johnson,DEM,190231,0,0,82,82,
Creek,U.S. Senate,James Lankford,REP,190231,1,3,161,165,
Creek,U.S. Senate,Mark Beard,IND,190231,2,0,10,12,
Creek,U.S. House,Frankie Robbins,DEM,190231,2,1,92,95,03
Creek,U.S. House,Frank Lucas,REP,190231,1,2,161,164,03
Creek,State House,Robert Bobby Talley,DEM,190231,2,0,84,86,29
Creek,State House,James Leewright,REP,190231,1,3,171,175,29
Creek,Governor,Joe Dorman,DEM,190241,2,3,122,127,
Creek,Governor,Mary Fallin,REP,190241,1,2,128,131,
Creek,Governor,Kimberly Willis,IND,190241,0,0,6,6,
Creek,Governor,Richard Prawdzienski,IND,190241,0,0,6,6,
Creek,Lieutenant Governor,Cathy Cummings,DEM,190241,2,2,83,87,
Creek,Lieutenant Governor,Todd Lamb,REP,190241,1,3,178,182,
Creek,Superintendent of Public Instruction,John Cox,DEM,190241,2,3,135,140,
Creek,Superintendent of Public Instruction,Joy Hofmeister,REP,190241,1,2,127,130,
Creek,Commissioner of Labor,Mike Workman,DEM,190241,2,1,104,107,
Creek,Commissioner of Labor,Mark Costello,REP,190241,1,2,150,153,
Creek,U.S. Senate,Matt Silverstein,DEM,190241,2,3,89,94,
Creek,U.S. Senate,Jim Inhofe,REP,190241,1,2,161,164,
Creek,U.S. Senate,Aaron Delozier,IND,190241,0,0,1,1,
Creek,U.S. Senate,Ray Woods,IND,190241,0,0,4,4,
Creek,U.S. Senate,Joan Farr,IND,190241,0,0,2,2,
Creek,U.S. Senate,Connie Johnson,DEM,190241,2,2,80,84,
Creek,U.S. Senate,James Lankford,REP,190241,1,3,163,167,
Creek,U.S. Senate,Mark Beard,IND,190241,0,0,17,17,
Creek,U.S. House,Frankie Robbins,DEM,190241,2,2,80,84,03
Creek,U.S. House,Frank Lucas,REP,190241,1,3,179,183,03
Creek,State House,Robert Bobby Talley,DEM,190241,2,0,73,75,29
Creek,State House,James Leewright,REP,190241,1,4,185,190,29
Creek,Governor,Joe Dorman,DEM,190311,11,4,175,190,
Creek,Governor,Mary Fallin,REP,190311,7,2,264,273,
Creek,Governor,Kimberly Willis,IND,190311,0,0,18,18,
Creek,Governor,Richard Prawdzienski,IND,190311,0,0,5,5,
Creek,Lieutenant Governor,Cathy Cummings,DEM,190311,10,4,122,136,
Creek,Lieutenant Governor,Todd Lamb,REP,190311,7,2,338,347,
Creek,Superintendent of Public Instruction,John Cox,DEM,190311,10,4,195,209,
Creek,Superintendent of Public Instruction,Joy Hofmeister,REP,190311,7,2,264,273,
Creek,Commissioner of Labor,Mike Workman,DEM,190311,11,4,156,171,
Creek,Commissioner of Labor,Mark Costello,REP,190311,6,2,298,306,
Creek,U.S. Senate,Matt Silverstein,DEM,190311,10,4,107,121,
Creek,U.S. Senate,Jim Inhofe,REP,190311,6,2,340,348,
Creek,U.S. Senate,Aaron Delozier,IND,190311,1,0,2,3,
Creek,U.S. Senate,Ray Woods,IND,190311,0,0,2,2,
Creek,U.S. Senate,Joan Farr,IND,190311,0,0,8,8,
Creek,U.S. Senate,Connie Johnson,DEM,190311,9,5,103,117,
Creek,U.S. Senate,James Lankford,REP,190311,8,1,339,348,
Creek,U.S. Senate,Mark Beard,IND,190311,0,0,19,19,
Creek,U.S. House,Frankie Robbins,DEM,190311,10,4,107,121,03
Creek,U.S. House,Frank Lucas,REP,190311,7,2,352,361,03
Creek,State House,Wannetta Cloyd,DEM,190311,9,4,99,112,35
Creek,State House,Dennis Casey,REP,190311,7,2,356,365,35
Creek,Governor,Joe Dorman,DEM,190401,6,12,101,119,
Creek,Governor,Mary Fallin,REP,190401,6,17,247,270,
Creek,Governor,Kimberly Willis,IND,190401,0,0,12,12,
Creek,Governor,Richard Prawdzienski,IND,190401,0,0,7,7,
Creek,Lieutenant Governor,Cathy Cummings,DEM,190401,4,9,66,79,
Creek,Lieutenant Governor,Todd Lamb,REP,190401,8,20,301,329,
Creek,Superintendent of Public Instruction,John Cox,DEM,190401,6,10,118,134,
Creek,Superintendent of Public Instruction,Joy Hofmeister,REP,190401,6,19,247,272,
Creek,Commissioner of Labor,Mike Workman,DEM,190401,5,10,93,108,
Creek,Commissioner of Labor,Mark Costello,REP,190401,7,17,273,297,
Creek,U.S. Senate,Matt Silverstein,DEM,190401,4,9,59,72,
Creek,U.S. Senate,Jim Inhofe,REP,190401,7,20,293,320,
Creek,U.S. Senate,Aaron Delozier,IND,190401,0,0,4,4,
Creek,U.S. Senate,Ray Woods,IND,190401,0,0,6,6,
Creek,U.S. Senate,Joan Farr,IND,190401,1,0,4,5,
Creek,U.S. Senate,Connie Johnson,DEM,190401,3,9,59,71,
Creek,U.S. Senate,James Lankford,REP,190401,7,20,290,317,
Creek,U.S. Senate,Mark Beard,IND,190401,2,0,20,22,
Creek,U.S. House,Frankie Robbins,DEM,190401,4,9,64,77,03
Creek,U.S. House,Frank Lucas,REP,190401,8,20,301,329,03
Creek,State House,Robert Bobby Talley,DEM,190401,3,9,75,87,29
Creek,State House,James Leewright,REP,190401,9,20,289,318,29
Creek,Governor,Joe Dorman,DEM,190402,1,9,131,141,
Creek,Governor,Mary Fallin,REP,190402,8,30,282,320,
Creek,Governor,Kimberly Willis,IND,190402,0,1,11,12,
Creek,Governor,Richard Prawdzienski,IND,190402,0,0,3,3,
Creek,Lieutenant Governor,Cathy Cummings,DEM,190402,0,3,99,102,
Creek,Lieutenant Governor,Todd Lamb,REP,190402,9,37,327,373,
Creek,Superintendent of Public Instruction,John Cox,DEM,190402,1,8,148,157,
Creek,Superintendent of Public Instruction,Joy Hofmeister,REP,190402,8,32,277,317,
Creek,Commissioner of Labor,Mike Workman,DEM,190402,0,8,127,135,
Creek,Commissioner of Labor,Mark Costello,REP,190402,9,32,293,334,
Creek,U.S. Senate,Matt Silverstein,DEM,190402,0,7,95,102,
Creek,U.S. Senate,Jim Inhofe,REP,190402,9,31,321,361,
Creek,U.S. Senate,Aaron Delozier,IND,190402,0,1,4,5,
Creek,U.S. Senate,Ray Woods,IND,190402,0,0,6,6,
Creek,U.S. Senate,Joan Farr,IND,190402,0,1,3,4,
Creek,U.S. Senate,Connie Johnson,DEM,190402,0,4,86,90,
Creek,U.S. Senate,James Lankford,REP,190402,9,35,323,367,
Creek,U.S. Senate,Mark Beard,IND,190402,0,1,18,19,
Creek,U.S. House,Frankie Robbins,DEM,190402,0,3,97,100,03
Creek,U.S. House,Frank Lucas,REP,190402,9,36,329,374,03
Creek,State House,Robert Bobby Talley,DEM,190402,1,4,99,104,29
Creek,State House,James Leewright,REP,190402,7,35,326,368,29
Creek,Governor,Joe Dorman,DEM,190403,2,4,134,140,
Creek,Governor,Mary Fallin,REP,190403,1,20,298,319,
Creek,Governor,Kimberly Willis,IND,190403,0,0,16,16,
Creek,Governor,Richard Prawdzienski,IND,190403,0,0,3,3,
Creek,Lieutenant Governor,Cathy Cummings,DEM,190403,2,6,105,113,
Creek,Lieutenant Governor,Todd Lamb,REP,190403,1,18,344,363,
Creek,Superintendent of Public Instruction,John Cox,DEM,190403,2,5,149,156,
Creek,Superintendent of Public Instruction,Joy Hofmeister,REP,190403,1,19,295,315,
Creek,Commissioner of Labor,Mike Workman,DEM,190403,2,5,121,128,
Creek,Commissioner of Labor,Mark Costello,REP,190403,1,19,322,342,
Creek,U.S. Senate,Matt Silverstein,DEM,190403,2,6,94,102,
Creek,U.S. Senate,Jim Inhofe,REP,190403,1,17,330,348,
Creek,U.S. Senate,Aaron Delozier,IND,190403,0,0,6,6,
Creek,U.S. Senate,Ray Woods,IND,190403,0,0,9,9,
Creek,U.S. Senate,Joan Farr,IND,190403,0,1,7,8,
Creek,U.S. Senate,Connie Johnson,DEM,190403,2,5,98,105,
Creek,U.S. Senate,James Lankford,REP,190403,1,19,334,354,
Creek,U.S. Senate,Mark Beard,IND,190403,0,0,16,16,
Creek,U.S. House,Frankie Robbins,DEM,190403,2,7,106,115,03
Creek,U.S. House,Frank Lucas,REP,190403,1,17,340,358,03
Creek,State House,Robert Bobby Talley,DEM,190403,2,5,106,113,29
Creek,State House,James Leewright,REP,190403,1,19,342,362,29
Creek,Governor,Joe Dorman,DEM,190404,6,9,283,298,
Creek,Governor,Mary Fallin,REP,190404,12,13,560,585,
Creek,Governor,Kimberly Willis,IND,190404,0,0,15,15,
Creek,Governor,Richard Prawdzienski,IND,190404,0,0,11,11,
Creek,Lieutenant Governor,Cathy Cummings,DEM,190404,4,5,202,211,
Creek,Lieutenant Governor,Todd Lamb,REP,190404,14,17,667,698,
Creek,Superintendent of Public Instruction,John Cox,DEM,190404,7,9,333,349,
Creek,Superintendent of Public Instruction,Joy Hofmeister,REP,190404,11,13,532,556,
Creek,Commissioner of Labor,Mike Workman,DEM,190404,4,6,259,269,
Creek,Commissioner of Labor,Mark Costello,REP,190404,13,16,588,617,
Creek,U.S. Senate,Matt Silverstein,DEM,190404,2,4,208,214,
Creek,U.S. Senate,Jim Inhofe,REP,190404,15,16,642,673,
Creek,U.S. Senate,Aaron Delozier,IND,190404,0,0,4,4,
Creek,U.S. Senate,Ray Woods,IND,190404,1,1,5,7,
Creek,U.S. Senate,Joan Farr,IND,190404,0,1,9,10,
Creek,U.S. Senate,Connie Johnson,DEM,190404,3,5,189,197,
Creek,U.S. Senate,James Lankford,REP,190404,14,17,654,685,
Creek,U.S. Senate,Mark Beard,IND,190404,1,0,28,29,
Creek,U.S. House,Frankie Robbins,DEM,190404,2,6,199,207,03
Creek,U.S. House,Frank Lucas,REP,190404,16,16,666,698,03
Creek,State House,Robert Bobby Talley,DEM,190404,4,5,224,233,29
Creek,State House,James Leewright,REP,190404,14,17,636,667,29
Creek,Governor,Joe Dorman,DEM,190405,2,4,116,122,
Creek,Governor,Mary Fallin,REP,190405,9,26,322,357,
Creek,Governor,Kimberly Willis,IND,190405,0,0,8,8,
Creek,Governor,Richard Prawdzienski,IND,190405,0,1,15,16,
Creek,Lieutenant Governor,Cathy Cummings,DEM,190405,3,0,92,95,
Creek,Lieutenant Governor,Todd Lamb,REP,190405,8,31,367,406,
Creek,Superintendent of Public Instruction,John Cox,DEM,190405,2,3,155,160,
Creek,Superintendent of Public Instruction,Joy Hofmeister,REP,190405,9,28,303,340,
Creek,Commissioner of Labor,Mike Workman,DEM,190405,3,1,116,120,
Creek,Commissioner of Labor,Mark Costello,REP,190405,8,30,335,373,
Creek,U.S. Senate,Matt Silverstein,DEM,190405,4,0,77,81,
Creek,U.S. Senate,Jim Inhofe,REP,190405,6,30,368,404,
Creek,U.S. Senate,Aaron Delozier,IND,190405,0,0,1,1,
Creek,U.S. Senate,Ray Woods,IND,190405,0,1,10,11,
Creek,U.S. Senate,Joan Farr,IND,190405,1,0,6,7,
Creek,U.S. Senate,Connie Johnson,DEM,190405,3,0,74,77,
Creek,U.S. Senate,James Lankford,REP,190405,7,30,363,400,
Creek,U.S. Senate,Mark Beard,IND,190405,1,1,23,25,
Creek,U.S. House,Frankie Robbins,DEM,190405,2,1,80,83,03
Creek,U.S. House,Frank Lucas,REP,190405,9,30,378,417,03
Creek,State House,Wannetta Cloyd,DEM,190405,4,2,99,105,35
Creek,State House,Dennis Casey,REP,190405,7,29,357,393,35
Creek,Governor,Joe Dorman,DEM,190406,1,0,102,103,
Creek,Governor,Mary Fallin,REP,190406,4,3,226,233,
Creek,Governor,Kimberly Willis,IND,190406,0,0,8,8,
Creek,Governor,Richard Prawdzienski,IND,190406,0,0,8,8,
Creek,Lieutenant Governor,Cathy Cummings,DEM,190406,0,0,76,76,
Creek,Lieutenant Governor,Todd Lamb,REP,190406,5,3,268,276,
Creek,Superintendent of Public Instruction,John Cox,DEM,190406,2,0,117,119,
Creek,Superintendent of Public Instruction,Joy Hofmeister,REP,190406,3,3,225,231,
Creek,Commissioner of Labor,Mike Workman,DEM,190406,1,0,109,110,
Creek,Commissioner of Labor,Mark Costello,REP,190406,4,3,231,238,
Creek,U.S. Senate,Matt Silverstein,DEM,190406,1,0,64,65,
Creek,U.S. Senate,Jim Inhofe,REP,190406,4,3,269,276,
Creek,U.S. Senate,Aaron Delozier,IND,190406,0,0,2,2,
Creek,U.S. Senate,Ray Woods,IND,190406,0,0,3,3,
Creek,U.S. Senate,Joan Farr,IND,190406,0,0,3,3,
Creek,U.S. Senate,Connie Johnson,DEM,190406,0,0,72,72,
Creek,U.S. Senate,James Lankford,REP,190406,5,3,262,270,
Creek,U.S. Senate,Mark Beard,IND,190406,0,0,9,9,
Creek,U.S. House,Frankie Robbins,DEM,190406,1,0,80,81,03
Creek,U.S. House,Frank Lucas,REP,190406,4,3,263,270,03
Creek,State House,Wannetta Cloyd,DEM,190406,0,0,47,47,35
Creek,State House,Dennis Casey,REP,190406,5,3,295,303,35
Creek,Governor,Joe Dorman,DEM,190407,1,2,70,73,
Creek,Governor,Mary Fallin,REP,190407,2,4,91,97,
Creek,Governor,Kimberly Willis,IND,190407,0,0,9,9,
Creek,Governor,Richard Prawdzienski,IND,190407,0,1,0,1,
Creek,Lieutenant Governor,Cathy Cummings,DEM,190407,1,2,59,62,
Creek,Lieutenant Governor,Todd Lamb,REP,190407,2,5,111,118,
Creek,Superintendent of Public Instruction,John Cox,DEM,190407,3,3,93,99,
Creek,Superintendent of Public Instruction,Joy Hofmeister,REP,190407,0,4,76,80,
Creek,Commissioner of Labor,Mike Workman,DEM,190407,2,2,78,82,
Creek,Commissioner of Labor,Mark Costello,REP,190407,1,5,89,95,
Creek,U.S. Senate,Matt Silverstein,DEM,190407,2,2,55,59,
Creek,U.S. Senate,Jim Inhofe,REP,190407,1,5,110,116,
Creek,U.S. Senate,Aaron Delozier,IND,190407,0,0,1,1,
Creek,U.S. Senate,Ray Woods,IND,190407,0,0,3,3,
Creek,U.S. Senate,Joan Farr,IND,190407,0,0,1,1,
Creek,U.S. Senate,Connie Johnson,DEM,190407,1,2,48,51,
Creek,U.S. Senate,James Lankford,REP,190407,2,4,116,122,
Creek,U.S. Senate,Mark Beard,IND,190407,0,0,6,6,
Creek,U.S. House,Frankie Robbins,DEM,190407,1,3,58,62,03
Creek,U.S. House,Frank Lucas,REP,190407,2,3,112,117,03
Creek,State House,Wannetta Cloyd,DEM,190407,1,2,57,60,35
Creek,State House,Dennis Casey,REP,190407,2,5,112,119,35
Creek,Governor,Joe Dorman,DEM,190408,0,1,55,56,
Creek,Governor,Mary Fallin,REP,190408,7,0,128,135,
Creek,Governor,Kimberly Willis,IND,190408,0,0,1,1,
Creek,Governor,Richard Prawdzienski,IND,190408,0,0,5,5,
Creek,Lieutenant Governor,Cathy Cummings,DEM,190408,0,1,36,37,
Creek,Lieutenant Governor,Todd Lamb,REP,190408,7,0,153,160,
Creek,Superintendent of Public Instruction,John Cox,DEM,190408,3,1,73,77,
Creek,Superintendent of Public Instruction,Joy Hofmeister,REP,190408,4,0,117,121,
Creek,Commissioner of Labor,Mike Workman,DEM,190408,1,1,51,53,
Creek,Commissioner of Labor,Mark Costello,REP,190408,6,0,136,142,
Creek,U.S. Senate,Matt Silverstein,DEM,190408,0,0,33,33,
Creek,U.S. Senate,Jim Inhofe,REP,190408,7,1,150,158,
Creek,U.S. Senate,Aaron Delozier,IND,190408,0,0,3,3,
Creek,U.S. Senate,Ray Woods,IND,190408,0,0,3,3,
Creek,U.S. Senate,Joan Farr,IND,190408,0,0,0,0,
Creek,U.S. Senate,Connie Johnson,DEM,190408,0,0,37,37,
Creek,U.S. Senate,James Lankford,REP,190408,6,0,147,153,
Creek,U.S. Senate,Mark Beard,IND,190408,1,1,5,7,
Creek,U.S. House,Frankie Robbins,DEM,190408,0,0,38,38,03
Creek,U.S. House,Frank Lucas,REP,190408,7,1,150,158,03
Creek,State House,Robert Bobby Talley,DEM,190408,0,0,36,36,29
Creek,State House,James Leewright,REP,190408,7,1,153,161,29
Creek,Governor,Joe Dorman,DEM,190409,2,3,180,185,
Creek,Governor,Mary Fallin,REP,190409,1,8,289,298,
Creek,Governor,Kimberly Willis,IND,190409,0,0,9,9,
Creek,Governor,Richard Prawdzienski,IND,190409,0,0,6,6,
Creek,Lieutenant Governor,Cathy Cummings,DEM,190409,3,3,112,118,
Creek,Lieutenant Governor,Todd Lamb,REP,190409,0,8,368,376,
Creek,Superintendent of Public Instruction,John Cox,DEM,190409,3,5,213,221,
Creek,Superintendent of Public Instruction,Joy Hofmeister,REP,190409,0,6,264,270,
Creek,Commissioner of Labor,Mike Workman,DEM,190409,3,2,160,165,
Creek,Commissioner of Labor,Mark Costello,REP,190409,0,9,313,322,
Creek,U.S. Senate,Matt Silverstein,DEM,190409,2,5,107,114,
Creek,U.S. Senate,Jim Inhofe,REP,190409,1,5,361,367,
Creek,U.S. Senate,Aaron Delozier,IND,190409,0,1,4,5,
Creek,U.S. Senate,Ray Woods,IND,190409,0,0,4,4,
Creek,U.S. Senate,Joan Farr,IND,190409,0,0,6,6,
Creek,U.S. Senate,Connie Johnson,DEM,190409,1,3,110,114,
Creek,U.S. Senate,James Lankford,REP,190409,2,8,361,371,
Creek,U.S. Senate,Mark Beard,IND,190409,0,0,12,12,
Creek,U.S. House,Frankie Robbins,DEM,190409,2,3,110,115,03
Creek,U.S. House,Frank Lucas,REP,190409,1,8,374,383,03
Creek,State House,Robert Bobby Talley,DEM,190409,1,3,93,97,29
Creek,State House,James Leewright,REP,190409,2,8,386,396,29
Creek,Governor,Joe Dorman,DEM,190410,1,3,36,40,
Creek,Governor,Mary Fallin,REP,190410,0,2,75,77,
Creek,Governor,Kimberly Willis,IND,190410,0,0,2,2,
Creek,Governor,Richard Prawdzienski,IND,190410,0,0,4,4,
Creek,Lieutenant Governor,Cathy Cummings,DEM,190410,1,2,21,24,
Creek,Lieutenant Governor,Todd Lamb,REP,190410,0,3,96,99,
Creek,Superintendent of Public Instruction,John Cox,DEM,190410,1,3,48,52,
Creek,Superintendent of Public Instruction,Joy Hofmeister,REP,190410,0,2,68,70,
Creek,Commissioner of Labor,Mike Workman,DEM,190410,1,3,36,40,
Creek,Commissioner of Labor,Mark Costello,REP,190410,0,1,79,80,
Creek,U.S. Senate,Matt Silverstein,DEM,190410,1,3,21,25,
Creek,U.S. Senate,Jim Inhofe,REP,190410,0,2,92,94,
Creek,U.S. Senate,Aaron Delozier,IND,190410,0,0,1,1,
Creek,U.S. Senate,Ray Woods,IND,190410,0,0,1,1,
Creek,U.S. Senate,Joan Farr,IND,190410,0,0,2,2,
Creek,U.S. Senate,Connie Johnson,DEM,190410,1,2,18,21,
Creek,U.S. Senate,James Lankford,REP,190410,0,3,94,97,
Creek,U.S. Senate,Mark Beard,IND,190410,0,0,4,4,
Creek,U.S. House,Frankie Robbins,DEM,190410,1,3,19,23,03
Creek,U.S. House,Frank Lucas,REP,190410,0,2,96,98,03
Creek,State House,Robert Bobby Talley,DEM,190410,1,3,17,21,29
Creek,State House,James Leewright,REP,190410,0,2,100,102,29
Creek,Governor,Joe Dorman,DEM,190411,1,2,152,155,
Creek,Governor,Mary Fallin,REP,190411,3,3,182,188,
Creek,Governor,Kimberly Willis,IND,190411,1,0,15,16,
Creek,Governor,Richard Prawdzienski,IND,190411,1,0,4,5,
Creek,Lieutenant Governor,Cathy Cummings,DEM,190411,0,2,99,101,
Creek,Lieutenant Governor,Todd Lamb,REP,190411,5,3,251,259,
Creek,Superintendent of Public Instruction,John Cox,DEM,190411,1,3,161,165,
Creek,Superintendent of Public Instruction,Joy Hofmeister,REP,190411,5,2,186,193,
Creek,Commissioner of Labor,Mike Workman,DEM,190411,2,2,137,141,
Creek,Commissioner of Labor,Mark Costello,REP,190411,4,3,206,213,
Creek,U.S. Senate,Matt Silverstein,DEM,190411,1,2,92,95,
Creek,U.S. Senate,Jim Inhofe,REP,190411,4,2,243,249,
Creek,U.S. Senate,Aaron Delozier,IND,190411,1,0,3,4,
Creek,U.S. Senate,Ray Woods,IND,190411,0,0,9,9,
Creek,U.S. Senate,Joan Farr,IND,190411,0,0,3,3,
Creek,U.S. Senate,Connie Johnson,DEM,190411,1,2,97,100,
Creek,U.S. Senate,James Lankford,REP,190411,4,3,241,248,
Creek,U.S. Senate,Mark Beard,IND,190411,1,0,11,12,
Creek,U.S. House,Frankie Robbins,DEM,190411,2,2,104,108,03
Creek,U.S. House,Frank Lucas,REP,190411,4,3,241,248,03
Creek,State House,Robert Bobby Talley,DEM,190411,1,0,96,97,29
Creek,State House,James Leewright,REP,190411,5,6,255,266,29
Creek,Governor,Joe Dorman,DEM,190412,0,3,123,126,
Creek,Governor,Mary Fallin,REP,190412,2,1,165,168,
Creek,Governor,Kimberly Willis,IND,190412,0,0,4,4,
Creek,Governor,Richard Prawdzienski,IND,190412,0,0,0,0,
Creek,Lieutenant Governor,Cathy Cummings,DEM,190412,0,3,84,87,
Creek,Lieutenant Governor,Todd Lamb,REP,190412,3,1,209,213,
Creek,Superintendent of Public Instruction,John Cox,DEM,190412,0,4,126,130,
Creek,Superintendent of Public Instruction,Joy Hofmeister,REP,190412,3,0,165,168,
Creek,Commissioner of Labor,Mike Workman,DEM,190412,0,3,118,121,
Creek,Commissioner of Labor,Mark Costello,REP,190412,3,1,172,176,
Creek,U.S. Senate,Matt Silverstein,DEM,190412,0,3,82,85,
Creek,U.S. Senate,Jim Inhofe,REP,190412,3,1,204,208,
Creek,U.S. Senate,Aaron Delozier,IND,190412,0,0,1,1,
Creek,U.S. Senate,Ray Woods,IND,190412,0,0,3,3,
Creek,U.S. Senate,Joan Farr,IND,190412,0,0,2,2,
Creek,U.S. Senate,Connie Johnson,DEM,190412,0,3,83,86,
Creek,U.S. Senate,James Lankford,REP,190412,3,1,200,204,
Creek,U.S. Senate,Mark Beard,IND,190412,0,0,8,8,
Creek,U.S. House,Frankie Robbins,DEM,190412,0,3,91,94,03
Creek,U.S. House,Frank Lucas,REP,190412,3,1,200,204,03
Creek,State House,Robert Bobby Talley,DEM,190412,0,3,81,84,29
Creek,State House,James Leewright,REP,190412,3,1,209,213,29
Creek,Governor,Joe Dorman,DEM,190413,1,2,179,182,
Creek,Governor,Mary Fallin,REP,190413,4,6,313,323,
Creek,Governor,Kimberly Willis,IND,190413,0,0,7,7,
Creek,Governor,Richard Prawdzienski,IND,190413,0,0,8,8,
Creek,Lieutenant Governor,Cathy Cummings,DEM,190413,1,2,115,118,
Creek,Lieutenant Governor,Todd Lamb,REP,190413,4,6,390,400,
Creek,Superintendent of Public Instruction,John Cox,DEM,190413,0,4,225,229,
Creek,Superintendent of Public Instruction,Joy Hofmeister,REP,190413,5,4,280,289,
Creek,Commissioner of Labor,Mike Workman,DEM,190413,3,4,165,172,
Creek,Commissioner of Labor,Mark Costello,REP,190413,2,4,329,335,
Creek,U.S. Senate,Matt Silverstein,DEM,190413,0,2,114,116,
Creek,U.S. Senate,Jim Inhofe,REP,190413,5,6,375,386,
Creek,U.S. Senate,Aaron Delozier,IND,190413,0,0,4,4,
Creek,U.S. Senate,Ray Woods,IND,190413,0,0,9,9,
Creek,U.S. Senate,Joan Farr,IND,190413,0,0,4,4,
Creek,U.S. Senate,Connie Johnson,DEM,190413,0,2,107,109,
Creek,U.S. Senate,James Lankford,REP,190413,5,6,381,392,
Creek,U.S. Senate,Mark Beard,IND,190413,0,0,14,14,
Creek,U.S. House,Frankie Robbins,DEM,190413,1,2,112,115,03
Creek,U.S. House,Frank Lucas,REP,190413,4,6,391,401,03
Creek,State House,Robert Bobby Talley,DEM,190413,0,2,94,96,29
Creek,State House,James Leewright,REP,190413,5,6,409,420,29
Creek,Governor,Joe Dorman,DEM,190414,4,18,233,255,
Creek,Governor,Mary Fallin,REP,190414,8,49,554,611,
Creek,Governor,Kimberly Willis,IND,190414,0,0,20,20,
Creek,Governor,Richard Prawdzienski,IND,190414,0,1,9,10,
Creek,Lieutenant Governor,Cathy Cummings,DEM,190414,5,13,171,189,
Creek,Lieutenant Governor,Todd Lamb,REP,190414,7,55,643,705,
Creek,Superintendent of Public Instruction,John Cox,DEM,190414,3,22,281,306,
Creek,Superintendent of Public Instruction,Joy Hofmeister,REP,190414,9,46,532,587,
Creek,Commissioner of Labor,Mike Workman,DEM,190414,5,17,223,245,
Creek,Commissioner of Labor,Mark Costello,REP,190414,7,51,579,637,
Creek,U.S. Senate,Matt Silverstein,DEM,190414,4,9,170,183,
Creek,U.S. Senate,Jim Inhofe,REP,190414,8,55,629,692,
Creek,U.S. Senate,Aaron Delozier,IND,190414,0,1,2,3,
Creek,U.S. Senate,Ray Woods,IND,190414,0,0,8,8,
Creek,U.S. Senate,Joan Farr,IND,190414,0,1,8,9,
Creek,U.S. Senate,Connie Johnson,DEM,190414,5,9,161,175,
Creek,U.S. Senate,James Lankford,REP,190414,7,56,629,692,
Creek,U.S. Senate,Mark Beard,IND,190414,0,3,28,31,
Creek,U.S. House,Frankie Robbins,DEM,190414,3,10,170,183,03
Creek,U.S. House,Frank Lucas,REP,190414,9,58,641,708,03
Creek,State House,Robert Bobby Talley,DEM,190414,4,11,173,188,29
Creek,State House,James Leewright,REP,190414,8,57,636,701,29
Creek,Governor,Joe Dorman,DEM,190415,0,2,64,66,
Creek,Governor,Mary Fallin,REP,190415,2,8,128,138,
Creek,Governor,Kimberly Willis,IND,190415,0,0,5,5,
Creek,Governor,Richard Prawdzienski,IND,190415,0,0,1,1,
Creek,Lieutenant Governor,Cathy Cummings,DEM,190415,0,1,47,48,
Creek,Lieutenant Governor,Todd Lamb,REP,190415,2,9,149,160,
Creek,Superintendent of Public Instruction,John Cox,DEM,190415,0,3,82,85,
Creek,Superintendent of Public Instruction,Joy Hofmeister,REP,190415,2,7,116,125,
Creek,Commissioner of Labor,Mike Workman,DEM,190415,0,1,58,59,
Creek,Commissioner of Labor,Mark Costello,REP,190415,2,9,135,146,
Creek,U.S. Senate,Matt Silverstein,DEM,190415,0,0,44,44,
Creek,U.S. Senate,Jim Inhofe,REP,190415,2,10,148,160,
Creek,U.S. Senate,Aaron Delozier,IND,190415,0,0,0,0,
Creek,U.S. Senate,Ray Woods,IND,190415,0,0,2,2,
Creek,U.S. Senate,Joan Farr,IND,190415,0,0,2,2,
Creek,U.S. Senate,Connie Johnson,DEM,190415,0,2,43,45,
Creek,U.S. Senate,James Lankford,REP,190415,2,8,148,158,
Creek,U.S. Senate,Mark Beard,IND,190415,0,0,5,5,
Creek,State House,Robert Bobby Talley,DEM,190415,0,3,42,45,29
Creek,State House,James Leewright,REP,190415,2,7,152,161,29
Creek,Governor,Joe Dorman,DEM,190416,0,3,123,126,
Creek,Governor,Mary Fallin,REP,190416,4,12,283,299,
Creek,Governor,Kimberly Willis,IND,190416,0,0,10,10,
Creek,Governor,Richard Prawdzienski,IND,190416,0,0,5,5,
Creek,Lieutenant Governor,Cathy Cummings,DEM,190416,0,2,93,95,
Creek,Lieutenant Governor,Todd Lamb,REP,190416,4,14,324,342,
Creek,Superintendent of Public Instruction,John Cox,DEM,190416,1,5,141,147,
Creek,Superintendent of Public Instruction,Joy Hofmeister,REP,190416,2,10,278,290,
Creek,Commissioner of Labor,Mike Workman,DEM,190416,1,2,112,115,
Creek,Commissioner of Labor,Mark Costello,REP,190416,2,14,298,314,
Creek,U.S. Senate,Matt Silverstein,DEM,190416,0,3,83,86,
Creek,U.S. Senate,Jim Inhofe,REP,190416,4,13,316,333,
Creek,U.S. Senate,Aaron Delozier,IND,190416,0,0,6,6,
Creek,U.S. Senate,Ray Woods,IND,190416,0,0,4,4,
Creek,U.S. Senate,Joan Farr,IND,190416,0,0,10,10,
Creek,U.S. Senate,Connie Johnson,DEM,190416,0,3,78,81,
Creek,U.S. Senate,James Lankford,REP,190416,3,13,323,339,
Creek,U.S. Senate,Mark Beard,IND,190416,1,0,16,17,
Creek,Governor,Joe Dorman,DEM,190417,5,18,261,284,
Creek,Governor,Mary Fallin,REP,190417,10,31,533,574,
Creek,Governor,Kimberly Willis,IND,190417,0,0,16,16,
Creek,Governor,Richard Prawdzienski,IND,190417,0,0,2,2,
Creek,Lieutenant Governor,Cathy Cummings,DEM,190417,5,13,173,191,
Creek,Lieutenant Governor,Todd Lamb,REP,190417,10,36,637,683,
Creek,Superintendent of Public Instruction,John Cox,DEM,190417,6,22,307,335,
Creek,Superintendent of Public Instruction,Joy Hofmeister,REP,190417,8,27,502,537,
Creek,Commissioner of Labor,Mike Workman,DEM,190417,4,20,205,229,
Creek,Commissioner of Labor,Mark Costello,REP,190417,11,29,593,633,
Creek,U.S. Senate,Matt Silverstein,DEM,190417,3,11,164,178,
Creek,U.S. Senate,Jim Inhofe,REP,190417,12,37,626,675,
Creek,U.S. Senate,Aaron Delozier,IND,190417,0,1,5,6,
Creek,U.S. Senate,Ray Woods,IND,190417,0,0,5,5,
Creek,U.S. Senate,Joan Farr,IND,190417,0,0,9,9,
Creek,U.S. Senate,Connie Johnson,DEM,190417,3,12,149,164,
Creek,U.S. Senate,James Lankford,REP,190417,12,36,633,681,
Creek,U.S. Senate,Mark Beard,IND,190417,0,1,24,25,
Creek,Governor,Joe Dorman,DEM,190418,6,23,174,203,
Creek,Governor,Mary Fallin,REP,190418,6,42,469,517,
Creek,Governor,Kimberly Willis,IND,190418,0,0,7,7,
Creek,Governor,Richard Prawdzienski,IND,190418,1,0,4,5,
Creek,Lieutenant Governor,Cathy Cummings,DEM,190418,8,18,115,141,
Creek,Lieutenant Governor,Todd Lamb,REP,190418,5,47,537,589,
Creek,Superintendent of Public Instruction,John Cox,DEM,190418,7,22,199,228,
Creek,Superintendent of Public Instruction,Joy Hofmeister,REP,190418,6,42,454,502,
Creek,Commissioner of Labor,Mike Workman,DEM,190418,8,21,142,171,
Creek,Commissioner of Labor,Mark Costello,REP,190418,5,42,499,546,
Creek,U.S. Senate,Matt Silverstein,DEM,190418,6,20,118,144,
Creek,U.S. Senate,Jim Inhofe,REP,190418,7,44,526,577,
Creek,U.S. Senate,Aaron Delozier,IND,190418,0,0,3,3,
Creek,U.S. Senate,Ray Woods,IND,190418,0,0,4,4,
Creek,U.S. Senate,Joan Farr,IND,190418,0,1,3,4,
Creek,U.S. Senate,Connie Johnson,DEM,190418,8,20,112,140,
Creek,U.S. Senate,James Lankford,REP,190418,5,45,525,575,
Creek,U.S. Senate,Mark Beard,IND,190418,0,0,15,15,
Creek,U.S. House,Frankie Robbins,DEM,190418,7,21,118,146,03
Creek,U.S. House,Frank Lucas,REP,190418,6,44,531,581,03
Creek,Governor,Joe Dorman,DEM,190419,3,10,170,183,
Creek,Governor,Mary Fallin,REP,190419,16,14,374,404,
Creek,Governor,Kimberly Willis,IND,190419,0,0,8,8,
Creek,Governor,Richard Prawdzienski,IND,190419,0,0,3,3,
Creek,Lieutenant Governor,Cathy Cummings,DEM,190419,1,8,112,121,
Creek,Lieutenant Governor,Todd Lamb,REP,190419,18,17,438,473,
Creek,Superintendent of Public Instruction,John Cox,DEM,190419,1,13,165,179,
Creek,Superintendent of Public Instruction,Joy Hofmeister,REP,190419,18,12,387,417,
Creek,Commissioner of Labor,Mike Workman,DEM,190419,2,8,122,132,
Creek,Commissioner of Labor,Mark Costello,REP,190419,17,15,422,454,
Creek,U.S. Senate,Matt Silverstein,DEM,190419,1,6,119,126,
Creek,U.S. Senate,Jim Inhofe,REP,190419,18,16,426,460,
Creek,U.S. Senate,Aaron Delozier,IND,190419,0,0,1,1,
Creek,U.S. Senate,Ray Woods,IND,190419,0,0,4,4,
Creek,U.S. Senate,Joan Farr,IND,190419,0,2,3,5,
Creek,U.S. Senate,Connie Johnson,DEM,190419,1,9,102,112,
Creek,U.S. Senate,James Lankford,REP,190419,18,16,433,467,
Creek,U.S. Senate,Mark Beard,IND,190419,0,0,17,17,
Creek,U.S. House,Frankie Robbins,DEM,190419,1,8,114,123,03
Creek,U.S. House,Frank Lucas,REP,190419,18,17,437,472,03
Creek,Governor,Joe Dorman,DEM,190420,2,4,112,118,
Creek,Governor,Mary Fallin,REP,190420,0,3,251,254,
Creek,Governor,Kimberly Willis,IND,190420,0,0,3,3,
Creek,Governor,Richard Prawdzienski,IND,190420,0,0,1,1,
Creek,Lieutenant Governor,Cathy Cummings,DEM,190420,2,3,83,88,
Creek,Lieutenant Governor,Todd Lamb,REP,190420,0,4,281,285,
Creek,Superintendent of Public Instruction,John Cox,DEM,190420,2,2,109,113,
Creek,Superintendent of Public Instruction,Joy Hofmeister,REP,190420,0,5,258,263,
Creek,Commissioner of Labor,Mike Workman,DEM,190420,2,3,97,102,
Creek,Commissioner of Labor,Mark Costello,REP,190420,0,4,259,263,
Creek,U.S. Senate,Matt Silverstein,DEM,190420,2,2,77,81,
Creek,U.S. Senate,Jim Inhofe,REP,190420,0,5,284,289,
Creek,U.S. Senate,Aaron Delozier,IND,190420,0,0,3,3,
Creek,U.S. Senate,Ray Woods,IND,190420,0,0,2,2,
Creek,U.S. Senate,Joan Farr,IND,190420,0,0,2,2,
Creek,U.S. Senate,Connie Johnson,DEM,190420,2,3,76,81,
Creek,U.S. Senate,James Lankford,REP,190420,0,4,281,285,
Creek,U.S. Senate,Mark Beard,IND,190420,0,0,6,6,
Creek,U.S. House,Frankie Robbins,DEM,190420,1,2,76,79,03
Creek,U.S. House,Frank Lucas,REP,190420,0,5,289,294,03
Creek,Governor,Joe Dorman,DEM,190421,5,5,160,170,
Creek,Governor,Mary Fallin,REP,190421,17,7,365,389,
Creek,Governor,Kimberly Willis,IND,190421,0,1,10,11,
Creek,Governor,Richard Prawdzienski,IND,190421,0,0,12,12,
Creek,Lieutenant Governor,Cathy Cummings,DEM,190421,3,2,131,136,
Creek,Lieutenant Governor,Todd Lamb,REP,190421,18,11,415,444,
Creek,Superintendent of Public Instruction,John Cox,DEM,190421,5,7,168,180,
Creek,Superintendent of Public Instruction,Joy Hofmeister,REP,190421,16,6,375,397,
Creek,Commissioner of Labor,Mike Workman,DEM,190421,4,4,161,169,
Creek,Commissioner of Labor,Mark Costello,REP,190421,17,9,370,396,
Creek,U.S. Senate,Matt Silverstein,DEM,190421,6,4,124,134,
Creek,U.S. Senate,Jim Inhofe,REP,190421,14,9,401,424,
Creek,U.S. Senate,Aaron Delozier,IND,190421,0,0,7,7,
Creek,U.S. Senate,Ray Woods,IND,190421,0,0,9,9,
Creek,U.S. Senate,Joan Farr,IND,190421,0,0,7,7,
Creek,U.S. Senate,Connie Johnson,DEM,190421,2,3,118,123,
Creek,U.S. Senate,James Lankford,REP,190421,19,9,411,439,
Creek,U.S. Senate,Mark Beard,IND,190421,0,1,19,20,
Creek,U.S. House,Frankie Robbins,DEM,190421,3,3,133,139,03
Creek,U.S. House,Frank Lucas,REP,190421,16,10,403,429,03
Creek,Governor,Joe Dorman,DEM,190422,0,1,75,76,
Creek,Governor,Mary Fallin,REP,190422,17,14,155,186,
Creek,Governor,Kimberly Willis,IND,190422,0,0,6,6,
Creek,Governor,Richard Prawdzienski,IND,190422,0,0,5,5,
Creek,Lieutenant Governor,Cathy Cummings,DEM,190422,2,1,59,62,
Creek,Lieutenant Governor,Todd Lamb,REP,190422,14,14,180,208,
Creek,Superintendent of Public Instruction,John Cox,DEM,190422,2,1,89,92,
Creek,Superintendent of Public Instruction,Joy Hofmeister,REP,190422,15,14,149,178,
Creek,Commissioner of Labor,Mike Workman,DEM,190422,3,1,79,83,
Creek,Commissioner of Labor,Mark Costello,REP,190422,14,14,156,184,
Creek,U.S. Senate,Matt Silverstein,DEM,190422,0,1,49,50,
Creek,U.S. Senate,Jim Inhofe,REP,190422,14,14,180,208,
Creek,U.S. Senate,Aaron Delozier,IND,190422,0,0,2,2,
Creek,U.S. Senate,Ray Woods,IND,190422,1,0,4,5,
Creek,U.S. Senate,Joan Farr,IND,190422,1,0,3,4,
Creek,U.S. Senate,Connie Johnson,DEM,190422,1,1,54,56,
Creek,U.S. Senate,James Lankford,REP,190422,14,14,176,204,
Creek,U.S. Senate,Mark Beard,IND,190422,2,0,8,10,
Creek,U.S. House,Frankie Robbins,DEM,190422,1,1,56,58,03
Creek,U.S. House,Frank Lucas,REP,190422,16,14,183,213,03
Creek,State House,Robert Bobby Talley,DEM,190422,2,1,55,58,29
Creek,State House,James Leewright,REP,190422,15,14,184,213,29
Custer,Governor,Joe Dorman,DEM,200001,3,9,140,152,
Custer,Governor,Mary Fallin,REP,200001,6,16,185,207,
Custer,Governor,Kimberly Willis,IND,200001,0,0,12,12,
Custer,Governor,Richard Prawdzienski,IND,200001,0,1,4,5,
Custer,Lieutenant Governor,Cathy Cummings,DEM,200001,2,7,104,113,
Custer,Lieutenant Governor,Todd Lamb,REP,200001,7,19,234,260,
Custer,Superintendent of Public Instruction,John Cox,DEM,200001,4,11,149,164,
Custer,Superintendent of Public Instruction,Joy Hofmeister,REP,200001,5,15,188,208,
Custer,Commissioner of Labor,Mike Workman,DEM,200001,3,9,134,146,
Custer,Commissioner of Labor,Mark Costello,REP,200001,6,14,195,215,
Custer,U.S. Senate,Matt Silverstein,DEM,200001,2,5,79,86,
Custer,U.S. Senate,Jim Inhofe,REP,200001,7,21,243,271,
Custer,U.S. Senate,Aaron Delozier,IND,200001,0,0,2,2,
Custer,U.S. Senate,Ray Woods,IND,200001,0,0,3,3,
Custer,U.S. Senate,Joan Farr,IND,200001,0,0,11,11,
Custer,U.S. Senate,Connie Johnson,DEM,200001,2,4,99,105,
Custer,U.S. Senate,James Lankford,REP,200001,7,21,234,262,
Custer,U.S. Senate,Mark Beard,IND,200001,0,1,5,6,
Custer,U.S. House,Frankie Robbins,DEM,200001,2,5,93,100,03
Custer,U.S. House,Frank Lucas,REP,200001,7,21,246,274,03
Custer,Governor,Joe Dorman,DEM,200003,1,13,192,206,
Custer,Governor,Mary Fallin,REP,200003,12,45,327,384,
Custer,Governor,Kimberly Willis,IND,200003,0,0,11,11,
Custer,Governor,Richard Prawdzienski,IND,200003,1,0,7,8,
Custer,Lieutenant Governor,Cathy Cummings,DEM,200003,1,4,112,117,
Custer,Lieutenant Governor,Todd Lamb,REP,200003,13,54,423,490,
Custer,Superintendent of Public Instruction,John Cox,DEM,200003,2,15,200,217,
Custer,Superintendent of Public Instruction,Joy Hofmeister,REP,200003,12,43,329,384,
Custer,Commissioner of Labor,Mike Workman,DEM,200003,0,13,170,183,
Custer,Commissioner of Labor,Mark Costello,REP,200003,13,45,352,410,
Custer,U.S. Senate,Matt Silverstein,DEM,200003,0,3,88,91,
Custer,U.S. Senate,Jim Inhofe,REP,200003,14,54,428,496,
Custer,U.S. Senate,Aaron Delozier,IND,200003,0,0,4,4,
Custer,U.S. Senate,Ray Woods,IND,200003,0,0,5,5,
Custer,U.S. Senate,Joan Farr,IND,200003,0,0,10,10,
Custer,U.S. Senate,Connie Johnson,DEM,200003,1,2,101,104,
Custer,U.S. Senate,James Lankford,REP,200003,13,53,421,487,
Custer,U.S. Senate,Mark Beard,IND,200003,0,2,13,15,
Custer,U.S. House,Frankie Robbins,DEM,200003,0,1,89,90,03
Custer,U.S. House,Frank Lucas,REP,200003,14,58,444,516,03
Custer,Governor,Joe Dorman,DEM,200005,4,30,177,211,
Custer,Governor,Mary Fallin,REP,200005,13,43,335,391,
Custer,Governor,Kimberly Willis,IND,200005,1,2,13,16,
Custer,Governor,Richard Prawdzienski,IND,200005,1,0,3,4,
Custer,Lieutenant Governor,Cathy Cummings,DEM,200005,7,20,107,134,
Custer,Lieutenant Governor,Todd Lamb,REP,200005,12,54,420,486,
Custer,Superintendent of Public Instruction,John Cox,DEM,200005,8,38,205,251,
Custer,Superintendent of Public Instruction,Joy Hofmeister,REP,200005,11,37,323,371,
Custer,Commissioner of Labor,Mike Workman,DEM,200005,6,31,178,215,
Custer,Commissioner of Labor,Mark Costello,REP,200005,12,40,334,386,
Custer,U.S. Senate,Matt Silverstein,DEM,200005,4,19,76,99,
Custer,U.S. Senate,Jim Inhofe,REP,200005,14,55,432,501,
Custer,U.S. Senate,Aaron Delozier,IND,200005,0,0,4,4,
Custer,U.S. Senate,Ray Woods,IND,200005,0,0,6,6,
Custer,U.S. Senate,Joan Farr,IND,200005,1,1,10,12,
Custer,U.S. Senate,Connie Johnson,DEM,200005,5,23,91,119,
Custer,U.S. Senate,James Lankford,REP,200005,14,49,429,492,
Custer,U.S. Senate,Mark Beard,IND,200005,1,3,8,12,
Custer,U.S. House,Frankie Robbins,DEM,200005,6,18,73,97,03
Custer,U.S. House,Frank Lucas,REP,200005,14,57,455,526,03
Custer,Governor,Joe Dorman,DEM,200007,5,13,129,147,
Custer,Governor,Mary Fallin,REP,200007,7,20,172,199,
Custer,Governor,Kimberly Willis,IND,200007,0,0,5,5,
Custer,Governor,Richard Prawdzienski,IND,200007,0,0,3,3,
Custer,Lieutenant Governor,Cathy Cummings,DEM,200007,5,10,98,113,
Custer,Lieutenant Governor,Todd Lamb,REP,200007,7,23,211,241,
Custer,Superintendent of Public Instruction,John Cox,DEM,200007,6,11,139,156,
Custer,Superintendent of Public Instruction,Joy Hofmeister,REP,200007,6,21,168,195,
Custer,Commissioner of Labor,Mike Workman,DEM,200007,5,14,135,154,
Custer,Commissioner of Labor,Mark Costello,REP,200007,7,16,170,193,
Custer,U.S. Senate,Matt Silverstein,DEM,200007,3,10,89,102,
Custer,U.S. Senate,Jim Inhofe,REP,200007,9,23,213,245,
Custer,U.S. Senate,Aaron Delozier,IND,200007,0,0,0,0,
Custer,U.S. Senate,Ray Woods,IND,200007,0,0,3,3,
Custer,U.S. Senate,Joan Farr,IND,200007,0,0,3,3,
Custer,U.S. Senate,Connie Johnson,DEM,200007,4,10,102,116,
Custer,U.S. Senate,James Lankford,REP,200007,8,22,204,234,
Custer,U.S. Senate,Mark Beard,IND,200007,0,1,2,3,
Custer,U.S. House,Frankie Robbins,DEM,200007,3,10,89,102,03
Custer,U.S. House,Frank Lucas,REP,200007,8,22,219,249,03
Custer,Governor,Joe Dorman,DEM,200012,4,13,126,143,
Custer,Governor,Mary Fallin,REP,200012,9,34,221,264,
Custer,Governor,Kimberly Willis,IND,200012,0,0,8,8,
Custer,Governor,Richard Prawdzienski,IND,200012,0,0,5,5,
Custer,Lieutenant Governor,Cathy Cummings,DEM,200012,4,8,64,76,
Custer,Lieutenant Governor,Todd Lamb,REP,200012,9,39,294,342,
Custer,Superintendent of Public Instruction,John Cox,DEM,200012,5,15,129,149,
Custer,Superintendent of Public Instruction,Joy Hofmeister,REP,200012,8,32,227,267,
Custer,Commissioner of Labor,Mike Workman,DEM,200012,4,17,120,141,
Custer,Commissioner of Labor,Mark Costello,REP,200012,9,30,234,273,
Custer,U.S. Senate,Matt Silverstein,DEM,200012,3,8,50,61,
Custer,U.S. Senate,Jim Inhofe,REP,200012,10,39,298,347,
Custer,U.S. Senate,Aaron Delozier,IND,200012,0,0,0,0,
Custer,U.S. Senate,Ray Woods,IND,200012,0,0,5,5,
Custer,U.S. Senate,Joan Farr,IND,200012,0,0,4,4,
Custer,U.S. Senate,Connie Johnson,DEM,200012,2,5,46,53,
Custer,U.S. Senate,James Lankford,REP,200012,10,39,300,349,
Custer,U.S. Senate,Mark Beard,IND,200012,1,3,12,16,
Custer,U.S. House,Frankie Robbins,DEM,200012,1,4,39,44,03
Custer,U.S. House,Frank Lucas,REP,200012,12,42,320,374,03
Custer,State Senate,Kevin Black,DEM,200012,3,13,99,115,26
Custer,State Senate,Darcy Jech,REP,200012,10,33,259,302,26
Custer,Governor,Joe Dorman,DEM,200013,3,6,54,63,
Custer,Governor,Mary Fallin,REP,200013,0,12,116,128,
Custer,Governor,Kimberly Willis,IND,200013,0,0,4,4,
Custer,Governor,Richard Prawdzienski,IND,200013,0,0,3,3,
Custer,Lieutenant Governor,Cathy Cummings,DEM,200013,1,5,43,49,
Custer,Lieutenant Governor,Todd Lamb,REP,200013,2,13,133,148,
Custer,Superintendent of Public Instruction,John Cox,DEM,200013,2,7,68,77,
Custer,Superintendent of Public Instruction,Joy Hofmeister,REP,200013,1,11,107,119,
Custer,Commissioner of Labor,Mike Workman,DEM,200013,2,6,63,71,
Custer,Commissioner of Labor,Mark Costello,REP,200013,0,12,109,121,
Custer,U.S. Senate,Matt Silverstein,DEM,200013,1,5,34,40,
Custer,U.S. Senate,Jim Inhofe,REP,200013,1,13,133,147,
Custer,U.S. Senate,Aaron Delozier,IND,200013,0,0,3,3,
Custer,U.S. Senate,Ray Woods,IND,200013,0,0,1,1,
Custer,U.S. Senate,Joan Farr,IND,200013,1,0,3,4,
Custer,U.S. Senate,Connie Johnson,DEM,200013,1,5,33,39,
Custer,U.S. Senate,James Lankford,REP,200013,2,12,139,153,
Custer,U.S. Senate,Mark Beard,IND,200013,0,1,5,6,
Custer,U.S. House,Frankie Robbins,DEM,200013,0,4,29,33,03
Custer,U.S. House,Frank Lucas,REP,200013,3,14,147,164,03
Custer,State Senate,Kevin Black,DEM,200013,3,4,61,68,26
Custer,State Senate,Darcy Jech,REP,200013,0,13,113,126,26
Custer,Governor,Joe Dorman,DEM,200018,3,9,239,251,
Custer,Governor,Mary Fallin,REP,200018,17,29,473,519,
Custer,Governor,Kimberly Willis,IND,200018,0,0,10,10,
Custer,Governor,Richard Prawdzienski,IND,200018,0,0,3,3,
Custer,Lieutenant Governor,Cathy Cummings,DEM,200018,2,6,137,145,
Custer,Lieutenant Governor,Todd Lamb,REP,200018,18,30,582,630,
Custer,Superintendent of Public Instruction,John Cox,DEM,200018,2,14,235,251,
Custer,Superintendent of Public Instruction,Joy Hofmeister,REP,200018,18,23,482,523,
Custer,Commissioner of Labor,Mike Workman,DEM,200018,2,7,200,209,
Custer,Commissioner of Labor,Mark Costello,REP,200018,17,29,501,547,
Custer,U.S. Senate,Matt Silverstein,DEM,200018,2,8,127,137,
Custer,U.S. Senate,Jim Inhofe,REP,200018,18,29,576,623,
Custer,U.S. Senate,Aaron Delozier,IND,200018,0,0,3,3,
Custer,U.S. Senate,Ray Woods,IND,200018,0,0,10,10,
Custer,U.S. Senate,Joan Farr,IND,200018,0,1,4,5,
Custer,U.S. Senate,Connie Johnson,DEM,200018,1,4,118,123,
Custer,U.S. Senate,James Lankford,REP,200018,19,32,589,640,
Custer,U.S. Senate,Mark Beard,IND,200018,0,2,17,19,
Custer,U.S. House,Frankie Robbins,DEM,200018,1,7,116,124,03
Custer,U.S. House,Frank Lucas,REP,200018,19,31,605,655,03
Custer,Governor,Joe Dorman,DEM,200019,8,8,223,239,
Custer,Governor,Mary Fallin,REP,200019,30,14,427,471,
Custer,Governor,Kimberly Willis,IND,200019,1,0,10,11,
Custer,Governor,Richard Prawdzienski,IND,200019,1,0,3,4,
Custer,Lieutenant Governor,Cathy Cummings,DEM,200019,8,3,140,151,
Custer,Lieutenant Governor,Todd Lamb,REP,200019,32,19,524,575,
Custer,Superintendent of Public Instruction,John Cox,DEM,200019,17,9,226,252,
Custer,Superintendent of Public Instruction,Joy Hofmeister,REP,200019,25,12,436,473,
Custer,Commissioner of Labor,Mike Workman,DEM,200019,13,7,186,206,
Custer,Commissioner of Labor,Mark Costello,REP,200019,29,14,461,504,
Custer,U.S. Senate,Matt Silverstein,DEM,200019,9,2,130,141,
Custer,U.S. Senate,Jim Inhofe,REP,200019,32,20,512,564,
Custer,U.S. Senate,Aaron Delozier,IND,200019,0,0,8,8,
Custer,U.S. Senate,Ray Woods,IND,200019,0,0,3,3,
Custer,U.S. Senate,Joan Farr,IND,200019,1,0,10,11,
Custer,U.S. Senate,Connie Johnson,DEM,200019,10,4,126,140,
Custer,U.S. Senate,James Lankford,REP,200019,30,18,519,567,
Custer,U.S. Senate,Mark Beard,IND,200019,0,0,17,17,
Custer,U.S. House,Frankie Robbins,DEM,200019,7,0,118,125,03
Custer,U.S. House,Frank Lucas,REP,200019,34,22,543,599,03
Custer,Governor,Joe Dorman,DEM,200020,6,5,234,245,
Custer,Governor,Mary Fallin,REP,200020,10,18,476,504,
Custer,Governor,Kimberly Willis,IND,200020,0,0,14,14,
Custer,Governor,Richard Prawdzienski,IND,200020,1,0,6,7,
Custer,Lieutenant Governor,Cathy Cummings,DEM,200020,5,4,127,136,
Custer,Lieutenant Governor,Todd Lamb,REP,200020,11,19,601,631,
Custer,Superintendent of Public Instruction,John Cox,DEM,200020,8,5,261,274,
Custer,Superintendent of Public Instruction,Joy Hofmeister,REP,200020,8,17,467,492,
Custer,Commissioner of Labor,Mike Workman,DEM,200020,8,4,178,190,
Custer,Commissioner of Labor,Mark Costello,REP,200020,7,19,532,558,
Custer,U.S. Senate,Matt Silverstein,DEM,200020,3,4,124,131,
Custer,U.S. Senate,Jim Inhofe,REP,200020,13,19,592,624,
Custer,U.S. Senate,Aaron Delozier,IND,200020,0,0,3,3,
Custer,U.S. Senate,Ray Woods,IND,200020,0,0,6,6,
Custer,U.S. Senate,Joan Farr,IND,200020,1,0,5,6,
Custer,U.S. Senate,Connie Johnson,DEM,200020,4,3,116,123,
Custer,U.S. Senate,James Lankford,REP,200020,11,20,606,637,
Custer,U.S. Senate,Mark Beard,IND,200020,1,0,10,11,
Custer,U.S. House,Frankie Robbins,DEM,200020,4,4,108,116,03
Custer,U.S. House,Frank Lucas,REP,200020,13,19,622,654,03
Custer,Governor,Joe Dorman,DEM,200021,4,6,233,243,
Custer,Governor,Mary Fallin,REP,200021,10,4,312,326,
Custer,Governor,Kimberly Willis,IND,200021,0,0,15,15,
Custer,Governor,Richard Prawdzienski,IND,200021,0,0,11,11,
Custer,Lieutenant Governor,Cathy Cummings,DEM,200021,4,4,139,147,
Custer,Lieutenant Governor,Todd Lamb,REP,200021,10,6,428,444,
Custer,Superintendent of Public Instruction,John Cox,DEM,200021,10,4,233,247,
Custer,Superintendent of Public Instruction,Joy Hofmeister,REP,200021,5,6,337,348,
Custer,Commissioner of Labor,Mike Workman,DEM,200021,7,4,184,195,
Custer,Commissioner of Labor,Mark Costello,REP,200021,7,5,374,386,
Custer,U.S. Senate,Matt Silverstein,DEM,200021,5,4,124,133,
Custer,U.S. Senate,Jim Inhofe,REP,200021,10,6,414,430,
Custer,U.S. Senate,Aaron Delozier,IND,200021,0,0,10,10,
Custer,U.S. Senate,Ray Woods,IND,200021,0,0,15,15,
Custer,U.S. Senate,Joan Farr,IND,200021,0,0,8,8,
Custer,U.S. Senate,Connie Johnson,DEM,200021,5,4,130,139,
Custer,U.S. Senate,James Lankford,REP,200021,9,6,422,437,
Custer,U.S. Senate,Mark Beard,IND,200021,0,0,22,22,
Custer,U.S. House,Frankie Robbins,DEM,200021,4,3,130,137,03
Custer,U.S. House,Frank Lucas,REP,200021,11,7,437,455,03
Custer,Governor,Joe Dorman,DEM,200022,0,2,24,26,
Custer,Governor,Mary Fallin,REP,200022,5,12,137,154,
Custer,Governor,Kimberly Willis,IND,200022,0,0,2,2,
Custer,Governor,Richard Prawdzienski,IND,200022,0,0,0,0,
Custer,Lieutenant Governor,Cathy Cummings,DEM,200022,0,2,11,13,
Custer,Lieutenant Governor,Todd Lamb,REP,200022,5,12,153,170,
Custer,Superintendent of Public Instruction,John Cox,DEM,200022,2,6,43,51,
Custer,Superintendent of Public Instruction,Joy Hofmeister,REP,200022,3,8,121,132,
Custer,Commissioner of Labor,Mike Workman,DEM,200022,0,2,26,28,
Custer,Commissioner of Labor,Mark Costello,REP,200022,5,12,133,150,
Custer,U.S. Senate,Matt Silverstein,DEM,200022,0,0,13,13,
Custer,U.S. Senate,Jim Inhofe,REP,200022,5,13,144,162,
Custer,U.S. Senate,Aaron Delozier,IND,200022,0,0,1,1,
Custer,U.S. Senate,Ray Woods,IND,200022,0,0,1,1,
Custer,U.S. Senate,Joan Farr,IND,200022,0,0,2,2,
Custer,U.S. Senate,Connie Johnson,DEM,200022,0,0,12,12,
Custer,U.S. Senate,James Lankford,REP,200022,5,14,148,167,
Custer,U.S. Senate,Mark Beard,IND,200022,0,0,4,4,
Custer,U.S. House,Frankie Robbins,DEM,200022,0,0,17,17,03
Custer,U.S. House,Frank Lucas,REP,200022,5,14,147,166,03
Custer,State Senate,Kevin Black,DEM,200022,0,4,28,32,26
Custer,State Senate,Darcy Jech,REP,200022,5,10,132,147,26
Custer,Governor,Joe Dorman,DEM,200023,0,4,104,108,
Custer,Governor,Mary Fallin,REP,200023,11,11,396,418,
Custer,Governor,Kimberly Willis,IND,200023,0,0,13,13,
Custer,Governor,Richard Prawdzienski,IND,200023,0,0,2,2,
Custer,Lieutenant Governor,Cathy Cummings,DEM,200023,0,1,67,68,
Custer,Lieutenant Governor,Todd Lamb,REP,200023,11,14,448,473,
Custer,Superintendent of Public Instruction,John Cox,DEM,200023,0,2,158,160,
Custer,Superintendent of Public Instruction,Joy Hofmeister,REP,200023,11,13,351,375,
Custer,Commissioner of Labor,Mike Workman,DEM,200023,0,1,120,121,
Custer,Commissioner of Labor,Mark Costello,REP,200023,11,14,379,404,
Custer,U.S. Senate,Matt Silverstein,DEM,200023,0,1,54,55,
Custer,U.S. Senate,Jim Inhofe,REP,200023,11,14,445,470,
Custer,U.S. Senate,Aaron Delozier,IND,200023,0,0,6,6,
Custer,U.S. Senate,Ray Woods,IND,200023,0,0,4,4,
Custer,U.S. Senate,Joan Farr,IND,200023,0,0,7,7,
Custer,U.S. Senate,Connie Johnson,DEM,200023,0,1,58,59,
Custer,U.S. Senate,James Lankford,REP,200023,11,14,444,469,
Custer,U.S. Senate,Mark Beard,IND,200023,0,0,11,11,
Custer,U.S. House,Frankie Robbins,DEM,200023,0,3,48,51,03
Custer,U.S. House,Frank Lucas,REP,200023,11,12,468,491,03
Custer,State Senate,Kevin Black,DEM,200023,0,1,108,109,26
Custer,State Senate,Darcy Jech,REP,200023,11,13,401,425,26
Custer,Governor,Joe Dorman,DEM,200026,7,5,78,90,
Custer,Governor,Mary Fallin,REP,200026,12,13,220,245,
Custer,Governor,Kimberly Willis,IND,200026,0,1,5,6,
Custer,Governor,Richard Prawdzienski,IND,200026,0,0,2,2,
Custer,Lieutenant Governor,Cathy Cummings,DEM,200026,5,3,32,40,
Custer,Lieutenant Governor,Todd Lamb,REP,200026,13,16,276,305,
Custer,Superintendent of Public Instruction,John Cox,DEM,200026,7,6,125,138,
Custer,Superintendent of Public Instruction,Joy Hofmeister,REP,200026,12,13,179,204,
Custer,Commissioner of Labor,Mike Workman,DEM,200026,8,4,79,91,
Custer,Commissioner of Labor,Mark Costello,REP,200026,10,14,220,244,
Custer,U.S. Senate,Matt Silverstein,DEM,200026,4,3,24,31,
Custer,U.S. Senate,Jim Inhofe,REP,200026,14,15,276,305,
Custer,U.S. Senate,Aaron Delozier,IND,200026,0,0,2,2,
Custer,U.S. Senate,Ray Woods,IND,200026,0,0,1,1,
Custer,U.S. Senate,Joan Farr,IND,200026,0,1,3,4,
Custer,U.S. Senate,Connie Johnson,DEM,200026,4,2,33,39,
Custer,U.S. Senate,James Lankford,REP,200026,14,15,269,298,
Custer,U.S. Senate,Mark Beard,IND,200026,1,2,6,9,
Custer,U.S. House,Frankie Robbins,DEM,200026,5,4,18,27,03
Custer,U.S. House,Frank Lucas,REP,200026,14,15,291,320,03
Custer,State Senate,Kevin Black,DEM,200026,13,6,110,129,26
Custer,State Senate,Darcy Jech,REP,200026,6,12,193,211,26
Delaware,Governor,Joe Dorman,DEM,210001,8,0,153,161,
Delaware,Governor,Mary Fallin,REP,210001,12,2,379,393,
Delaware,Governor,Kimberly Willis,IND,210001,0,0,5,5,
Delaware,Governor,Richard Prawdzienski,IND,210001,0,0,2,2,
Delaware,Lieutenant Governor,Cathy Cummings,DEM,210001,7,0,119,126,
Delaware,Lieutenant Governor,Todd Lamb,REP,210001,13,2,418,433,
Delaware,Superintendent of Public Instruction,John Cox,DEM,210001,8,0,194,202,
Delaware,Superintendent of Public Instruction,Joy Hofmeister,REP,210001,12,2,344,358,
Delaware,Commissioner of Labor,Mike Workman,DEM,210001,7,0,143,150,
Delaware,Commissioner of Labor,Mark Costello,REP,210001,13,2,385,400,
Delaware,U.S. Senate,Matt Silverstein,DEM,210001,7,0,121,128,
Delaware,U.S. Senate,Jim Inhofe,REP,210001,13,2,399,414,
Delaware,U.S. Senate,Aaron Delozier,IND,210001,0,0,8,8,
Delaware,U.S. Senate,Ray Woods,IND,210001,0,0,5,5,
Delaware,U.S. Senate,Joan Farr,IND,210001,0,0,6,6,
Delaware,U.S. Senate,Connie Johnson,DEM,210001,7,0,99,106,
Delaware,U.S. Senate,James Lankford,REP,210001,12,2,417,431,
Delaware,U.S. Senate,Mark Beard,IND,210001,0,0,17,17,
Delaware,U.S. House,Earl Everett,DEM,210001,6,0,75,81,02
Delaware,U.S. House,Markwayne Mullin,REP,210001,12,2,413,427,02
Delaware,U.S. House,Jon Douthitt,IND,210001,2,0,46,48,02
Delaware,Governor,Joe Dorman,DEM,210002,2,2,96,100,
Delaware,Governor,Mary Fallin,REP,210002,4,2,154,160,
Delaware,Governor,Kimberly Willis,IND,210002,0,0,8,8,
Delaware,Governor,Richard Prawdzienski,IND,210002,0,0,6,6,
Delaware,Lieutenant Governor,Cathy Cummings,DEM,210002,2,1,74,77,
Delaware,Lieutenant Governor,Todd Lamb,REP,210002,4,3,188,195,
Delaware,Superintendent of Public Instruction,John Cox,DEM,210002,2,2,124,128,
Delaware,Superintendent of Public Instruction,Joy Hofmeister,REP,210002,4,2,138,144,
Delaware,Commissioner of Labor,Mike Workman,DEM,210002,2,2,109,113,
Delaware,Commissioner of Labor,Mark Costello,REP,210002,4,2,150,156,
Delaware,U.S. Senate,Matt Silverstein,DEM,210002,1,2,73,76,
Delaware,U.S. Senate,Jim Inhofe,REP,210002,5,2,172,179,
Delaware,U.S. Senate,Aaron Delozier,IND,210002,0,0,4,4,
Delaware,U.S. Senate,Ray Woods,IND,210002,0,0,8,8,
Delaware,U.S. Senate,Joan Farr,IND,210002,0,0,6,6,
Delaware,U.S. Senate,Connie Johnson,DEM,210002,2,2,65,69,
Delaware,U.S. Senate,James Lankford,REP,210002,4,2,183,189,
Delaware,U.S. Senate,Mark Beard,IND,210002,0,0,16,16,
Delaware,U.S. House,Earl Everett,DEM,210002,2,1,61,64,02
Delaware,U.S. House,Markwayne Mullin,REP,210002,4,3,184,191,02
Delaware,U.S. House,Jon Douthitt,IND,210002,0,0,18,18,02
Delaware,Governor,Joe Dorman,DEM,210003,5,3,151,159,
Delaware,Governor,Mary Fallin,REP,210003,17,8,313,338,
Delaware,Governor,Kimberly Willis,IND,210003,0,0,4,4,
Delaware,Governor,Richard Prawdzienski,IND,210003,0,0,6,6,
Delaware,Lieutenant Governor,Cathy Cummings,DEM,210003,6,1,115,122,
Delaware,Lieutenant Governor,Todd Lamb,REP,210003,16,10,360,386,
Delaware,Superintendent of Public Instruction,John Cox,DEM,210003,5,2,176,183,
Delaware,Superintendent of Public Instruction,Joy Hofmeister,REP,210003,17,9,298,324,
Delaware,Commissioner of Labor,Mike Workman,DEM,210003,5,3,152,160,
Delaware,Commissioner of Labor,Mark Costello,REP,210003,15,8,310,333,
Delaware,U.S. Senate,Matt Silverstein,DEM,210003,5,3,114,122,
Delaware,U.S. Senate,Jim Inhofe,REP,210003,14,8,338,360,
Delaware,U.S. Senate,Aaron Delozier,IND,210003,0,0,6,6,
Delaware,U.S. Senate,Ray Woods,IND,210003,2,0,4,6,
Delaware,U.S. Senate,Joan Farr,IND,210003,1,0,9,10,
Delaware,U.S. Senate,Connie Johnson,DEM,210003,4,2,115,121,
Delaware,U.S. Senate,James Lankford,REP,210003,18,9,345,372,
Delaware,U.S. Senate,Mark Beard,IND,210003,0,0,13,13,
Delaware,U.S. House,Earl Everett,DEM,210003,4,2,81,87,02
Delaware,U.S. House,Markwayne Mullin,REP,210003,18,9,350,377,02
Delaware,U.S. House,Jon Douthitt,IND,210003,0,0,39,39,02
Delaware,Governor,Joe Dorman,DEM,210004,3,0,97,100,
Delaware,Governor,Mary Fallin,REP,210004,3,3,181,187,
Delaware,Governor,Kimberly Willis,IND,210004,0,0,5,5,
Delaware,Governor,Richard Prawdzienski,IND,210004,0,0,3,3,
Delaware,Lieutenant Governor,Cathy Cummings,DEM,210004,2,0,88,90,
Delaware,Lieutenant Governor,Todd Lamb,REP,210004,4,3,196,203,
Delaware,Superintendent of Public Instruction,John Cox,DEM,210004,2,2,121,125,
Delaware,Superintendent of Public Instruction,Joy Hofmeister,REP,210004,4,1,163,168,
Delaware,Commissioner of Labor,Mike Workman,DEM,210004,1,0,115,116,
Delaware,Commissioner of Labor,Mark Costello,REP,210004,5,3,167,175,
Delaware,U.S. Senate,Matt Silverstein,DEM,210004,3,0,85,88,
Delaware,U.S. Senate,Jim Inhofe,REP,210004,3,3,188,194,
Delaware,U.S. Senate,Aaron Delozier,IND,210004,0,0,2,2,
Delaware,U.S. Senate,Ray Woods,IND,210004,0,0,1,1,
Delaware,U.S. Senate,Joan Farr,IND,210004,0,0,6,6,
Delaware,U.S. Senate,Connie Johnson,DEM,210004,2,0,91,93,
Delaware,U.S. Senate,James Lankford,REP,210004,4,3,185,192,
Delaware,U.S. Senate,Mark Beard,IND,210004,0,0,8,8,
Delaware,U.S. House,Earl Everett,DEM,210004,1,0,72,73,02
Delaware,U.S. House,Markwayne Mullin,REP,210004,4,3,199,206,02
Delaware,U.S. House,Jon Douthitt,IND,210004,1,0,12,13,02
Delaware,Governor,Joe Dorman,DEM,210005,9,7,156,172,
Delaware,Governor,Mary Fallin,REP,210005,10,12,352,374,
Delaware,Governor,Kimberly Willis,IND,210005,0,0,5,5,
Delaware,Governor,Richard Prawdzienski,IND,210005,1,0,11,12,
Delaware,Lieutenant Governor,Cathy Cummings,DEM,210005,7,6,114,127,
Delaware,Lieutenant Governor,Todd Lamb,REP,210005,13,13,408,434,
Delaware,Superintendent of Public Instruction,John Cox,DEM,210005,7,8,192,207,
Delaware,Superintendent of Public Instruction,Joy Hofmeister,REP,210005,13,11,329,353,
Delaware,Commissioner of Labor,Mike Workman,DEM,210005,9,8,145,162,
Delaware,Commissioner of Labor,Mark Costello,REP,210005,11,11,365,387,
Delaware,U.S. Senate,Matt Silverstein,DEM,210005,9,7,116,132,
Delaware,U.S. Senate,Jim Inhofe,REP,210005,10,10,398,418,
Delaware,U.S. Senate,Aaron Delozier,IND,210005,0,0,3,3,
Delaware,U.S. Senate,Ray Woods,IND,210005,1,1,5,7,
Delaware,U.S. Senate,Joan Farr,IND,210005,0,1,4,5,
Delaware,U.S. Senate,Connie Johnson,DEM,210005,8,6,110,124,
Delaware,U.S. Senate,James Lankford,REP,210005,11,13,395,419,
Delaware,U.S. Senate,Mark Beard,IND,210005,1,0,17,18,
Delaware,U.S. House,Earl Everett,DEM,210005,8,6,81,95,02
Delaware,U.S. House,Markwayne Mullin,REP,210005,12,12,413,437,02
Delaware,U.S. House,Jon Douthitt,IND,210005,0,1,30,31,02
Delaware,Governor,Joe Dorman,DEM,210006,5,5,107,117,
Delaware,Governor,Mary Fallin,REP,210006,13,7,235,255,
Delaware,Governor,Kimberly Willis,IND,210006,0,1,5,6,
Delaware,Governor,Richard Prawdzienski,IND,210006,0,0,6,6,
Delaware,Lieutenant Governor,Cathy Cummings,DEM,210006,5,4,88,97,
Delaware,Lieutenant Governor,Todd Lamb,REP,210006,13,9,264,286,
Delaware,Superintendent of Public Instruction,John Cox,DEM,210006,7,8,150,165,
Delaware,Superintendent of Public Instruction,Joy Hofmeister,REP,210006,10,5,203,218,
Delaware,Commissioner of Labor,Mike Workman,DEM,210006,5,5,115,125,
Delaware,Commissioner of Labor,Mark Costello,REP,210006,13,7,226,246,
Delaware,U.S. Senate,Matt Silverstein,DEM,210006,3,3,78,84,
Delaware,U.S. Senate,Jim Inhofe,REP,210006,14,10,263,287,
Delaware,U.S. Senate,Aaron Delozier,IND,210006,0,0,5,5,
Delaware,U.S. Senate,Ray Woods,IND,210006,0,0,3,3,
Delaware,U.S. Senate,Joan Farr,IND,210006,0,0,4,4,
Delaware,U.S. Senate,Connie Johnson,DEM,210006,4,3,80,87,
Delaware,U.S. Senate,James Lankford,REP,210006,14,8,260,282,
Delaware,U.S. Senate,Mark Beard,IND,210006,0,1,11,12,
Delaware,U.S. House,Earl Everett,DEM,210006,3,3,66,72,02
Delaware,U.S. House,Markwayne Mullin,REP,210006,15,10,268,293,02
Delaware,U.S. House,Jon Douthitt,IND,210006,0,0,18,18,02
Delaware,Governor,Joe Dorman,DEM,210007,10,9,271,290,
Delaware,Governor,Mary Fallin,REP,210007,31,31,626,688,
Delaware,Governor,Kimberly Willis,IND,210007,0,0,10,10,
Delaware,Governor,Richard Prawdzienski,IND,210007,0,0,7,7,
Delaware,Lieutenant Governor,Cathy Cummings,DEM,210007,11,7,221,239,
Delaware,Lieutenant Governor,Todd Lamb,REP,210007,29,33,691,753,
Delaware,Superintendent of Public Instruction,John Cox,DEM,210007,15,11,340,366,
Delaware,Superintendent of Public Instruction,Joy Hofmeister,REP,210007,25,29,571,625,
Delaware,Commissioner of Labor,Mike Workman,DEM,210007,13,8,262,283,
Delaware,Commissioner of Labor,Mark Costello,REP,210007,25,31,633,689,
Delaware,U.S. Senate,Matt Silverstein,DEM,210007,8,9,221,238,
Delaware,U.S. Senate,Jim Inhofe,REP,210007,33,31,671,735,
Delaware,U.S. Senate,Aaron Delozier,IND,210007,0,0,6,6,
Delaware,U.S. Senate,Ray Woods,IND,210007,0,0,8,8,
Delaware,U.S. Senate,Joan Farr,IND,210007,0,0,9,9,
Delaware,U.S. Senate,Connie Johnson,DEM,210007,9,8,198,215,
Delaware,U.S. Senate,James Lankford,REP,210007,30,32,685,747,
Delaware,U.S. Senate,Mark Beard,IND,210007,0,0,26,26,
Delaware,U.S. House,Earl Everett,DEM,210007,6,9,172,187,02
Delaware,U.S. House,Markwayne Mullin,REP,210007,31,31,689,751,02
Delaware,U.S. House,Jon Douthitt,IND,210007,2,0,45,47,02
Delaware,Governor,Joe Dorman,DEM,210008,1,6,50,57,
Delaware,Governor,Mary Fallin,REP,210008,6,2,116,124,
Delaware,Governor,Kimberly Willis,IND,210008,0,0,5,5,
Delaware,Governor,Richard Prawdzienski,IND,210008,0,1,2,3,
Delaware,Lieutenant Governor,Cathy Cummings,DEM,210008,1,3,33,37,
Delaware,Lieutenant Governor,Todd Lamb,REP,210008,5,6,140,151,
Delaware,Superintendent of Public Instruction,John Cox,DEM,210008,1,6,65,72,
Delaware,Superintendent of Public Instruction,Joy Hofmeister,REP,210008,6,2,107,115,
Delaware,Commissioner of Labor,Mike Workman,DEM,210008,1,5,55,61,
Delaware,Commissioner of Labor,Mark Costello,REP,210008,6,3,114,123,
Delaware,U.S. Senate,Matt Silverstein,DEM,210008,1,2,34,37,
Delaware,U.S. Senate,Jim Inhofe,REP,210008,6,6,133,145,
Delaware,U.S. Senate,Aaron Delozier,IND,210008,0,0,3,3,
Delaware,U.S. Senate,Ray Woods,IND,210008,0,1,1,2,
Delaware,U.S. Senate,Joan Farr,IND,210008,0,0,2,2,
Delaware,U.S. Senate,Connie Johnson,DEM,210008,0,2,34,36,
Delaware,U.S. Senate,James Lankford,REP,210008,6,5,127,138,
Delaware,U.S. Senate,Mark Beard,IND,210008,1,1,10,12,
Delaware,U.S. House,Earl Everett,DEM,210008,1,1,30,32,02
Delaware,U.S. House,Markwayne Mullin,REP,210008,6,4,129,139,02
Delaware,U.S. House,Jon Douthitt,IND,210008,0,2,13,15,02
Delaware,Governor,Joe Dorman,DEM,210009,10,8,245,263,
Delaware,Governor,Mary Fallin,REP,210009,35,18,624,677,
Delaware,Governor,Kimberly Willis,IND,210009,0,0,12,12,
Delaware,Governor,Richard Prawdzienski,IND,210009,0,0,10,10,
Delaware,Lieutenant Governor,Cathy Cummings,DEM,210009,12,5,173,190,
Delaware,Lieutenant Governor,Todd Lamb,REP,210009,33,21,710,764,
Delaware,Superintendent of Public Instruction,John Cox,DEM,210009,22,11,303,336,
Delaware,Superintendent of Public Instruction,Joy Hofmeister,REP,210009,24,15,586,625,
Delaware,Commissioner of Labor,Mike Workman,DEM,210009,14,6,236,256,
Delaware,Commissioner of Labor,Mark Costello,REP,210009,31,17,632,680,
Delaware,U.S. Senate,Matt Silverstein,DEM,210009,10,5,181,196,
Delaware,U.S. Senate,Jim Inhofe,REP,210009,34,20,676,730,
Delaware,U.S. Senate,Aaron Delozier,IND,210009,0,0,6,6,
Delaware,U.S. Senate,Ray Woods,IND,210009,1,0,10,11,
Delaware,U.S. Senate,Joan Farr,IND,210009,0,0,10,10,
Delaware,U.S. Senate,Connie Johnson,DEM,210009,10,7,180,197,
Delaware,U.S. Senate,James Lankford,REP,210009,36,16,683,735,
Delaware,U.S. Senate,Mark Beard,IND,210009,0,2,25,27,
Delaware,U.S. House,Earl Everett,DEM,210009,9,5,125,139,02
Delaware,U.S. House,Markwayne Mullin,REP,210009,37,19,714,770,02
Delaware,U.S. House,Jon Douthitt,IND,210009,0,1,43,44,02
Delaware,Governor,Joe Dorman,DEM,210010,0,2,5,7,
Delaware,Governor,Mary Fallin,REP,210010,2,6,10,18,
Delaware,Governor,Kimberly Willis,IND,210010,0,0,0,0,
Delaware,Governor,Richard Prawdzienski,IND,210010,0,0,0,0,
Delaware,Lieutenant Governor,Cathy Cummings,DEM,210010,0,1,5,6,
Delaware,Lieutenant Governor,Todd Lamb,REP,210010,2,7,10,19,
Delaware,Superintendent of Public Instruction,John Cox,DEM,210010,2,4,11,17,
Delaware,Superintendent of Public Instruction,Joy Hofmeister,REP,210010,0,4,4,8,
Delaware,Commissioner of Labor,Mike Workman,DEM,210010,2,2,4,8,
Delaware,Commissioner of Labor,Mark Costello,REP,210010,0,5,10,15,
Delaware,U.S. Senate,Matt Silverstein,DEM,210010,0,2,3,5,
Delaware,U.S. Senate,Jim Inhofe,REP,210010,2,5,11,18,
Delaware,U.S. Senate,Aaron Delozier,IND,210010,0,0,1,1,
Delaware,U.S. Senate,Ray Woods,IND,210010,0,0,0,0,
Delaware,U.S. Senate,Joan Farr,IND,210010,0,0,0,0,
Delaware,U.S. Senate,Connie Johnson,DEM,210010,2,2,3,7,
Delaware,U.S. Senate,James Lankford,REP,210010,0,6,11,17,
Delaware,U.S. Senate,Mark Beard,IND,210010,0,0,1,1,
Delaware,U.S. House,Earl Everett,DEM,210010,0,0,2,2,02
Delaware,U.S. House,Markwayne Mullin,REP,210010,2,7,11,20,02
Delaware,U.S. House,Jon Douthitt,IND,210010,0,0,2,2,02
Delaware,State House,Will Fourkiller,DEM,210010,2,4,6,12,86
Delaware,State House,Tonya Teaney,REP,210010,0,3,9,12,86
Delaware,Governor,Joe Dorman,DEM,210011,5,3,116,124,
Delaware,Governor,Mary Fallin,REP,210011,5,5,292,302,
Delaware,Governor,Kimberly Willis,IND,210011,0,1,7,8,
Delaware,Governor,Richard Prawdzienski,IND,210011,0,0,3,3,
Delaware,Lieutenant Governor,Cathy Cummings,DEM,210011,3,1,89,93,
Delaware,Lieutenant Governor,Todd Lamb,REP,210011,7,8,329,344,
Delaware,Superintendent of Public Instruction,John Cox,DEM,210011,4,4,147,155,
Delaware,Superintendent of Public Instruction,Joy Hofmeister,REP,210011,6,5,268,279,
Delaware,Commissioner of Labor,Mike Workman,DEM,210011,4,2,120,126,
Delaware,Commissioner of Labor,Mark Costello,REP,210011,6,6,289,301,
Delaware,U.S. Senate,Matt Silverstein,DEM,210011,3,1,86,90,
Delaware,U.S. Senate,Jim Inhofe,REP,210011,7,7,321,335,
Delaware,U.S. Senate,Aaron Delozier,IND,210011,0,0,1,1,
Delaware,U.S. Senate,Ray Woods,IND,210011,0,1,6,7,
Delaware,U.S. Senate,Joan Farr,IND,210011,0,0,5,5,
Delaware,U.S. Senate,Connie Johnson,DEM,210011,3,1,94,98,
Delaware,U.S. Senate,James Lankford,REP,210011,6,7,312,325,
Delaware,U.S. Senate,Mark Beard,IND,210011,1,1,10,12,
Delaware,U.S. House,Earl Everett,DEM,210011,4,1,72,77,02
Delaware,U.S. House,Markwayne Mullin,REP,210011,5,7,328,340,02
Delaware,U.S. House,Jon Douthitt,IND,210011,0,1,16,17,02
Delaware,Governor,Joe Dorman,DEM,210012,6,3,124,133,
Delaware,Governor,Mary Fallin,REP,210012,6,11,200,217,
Delaware,Governor,Kimberly Willis,IND,210012,0,0,6,6,
Delaware,Governor,Richard Prawdzienski,IND,210012,0,1,1,2,
Delaware,Lieutenant Governor,Cathy Cummings,DEM,210012,6,3,95,104,
Delaware,Lieutenant Governor,Todd Lamb,REP,210012,6,12,229,247,
Delaware,Superintendent of Public Instruction,John Cox,DEM,210012,8,9,167,184,
Delaware,Superintendent of Public Instruction,Joy Hofmeister,REP,210012,4,6,163,173,
Delaware,Commissioner of Labor,Mike Workman,DEM,210012,6,4,129,139,
Delaware,Commissioner of Labor,Mark Costello,REP,210012,4,11,196,211,
Delaware,U.S. Senate,Matt Silverstein,DEM,210012,6,3,84,93,
Delaware,U.S. Senate,Jim Inhofe,REP,210012,5,12,238,255,
Delaware,U.S. Senate,Aaron Delozier,IND,210012,0,0,3,3,
Delaware,U.S. Senate,Ray Woods,IND,210012,0,0,4,4,
Delaware,U.S. Senate,Joan Farr,IND,210012,1,0,1,2,
Delaware,U.S. Senate,Connie Johnson,DEM,210012,6,3,76,85,
Delaware,U.S. Senate,James Lankford,REP,210012,6,12,235,253,
Delaware,U.S. Senate,Mark Beard,IND,210012,0,0,16,16,
Delaware,U.S. House,Earl Everett,DEM,210012,6,3,66,75,02
Delaware,U.S. House,Markwayne Mullin,REP,210012,6,12,242,260,02
Delaware,U.S. House,Jon Douthitt,IND,210012,0,0,19,19,02
Delaware,Governor,Joe Dorman,DEM,210014,7,24,134,165,
Delaware,Governor,Mary Fallin,REP,210014,4,17,146,167,
Delaware,Governor,Kimberly Willis,IND,210014,0,0,4,4,
Delaware,Governor,Richard Prawdzienski,IND,210014,0,0,1,1,
Delaware,Lieutenant Governor,Cathy Cummings,DEM,210014,7,14,91,112,
Delaware,Lieutenant Governor,Todd Lamb,REP,210014,4,27,192,223,
Delaware,Superintendent of Public Instruction,John Cox,DEM,210014,7,29,202,238,
Delaware,Superintendent of Public Instruction,Joy Hofmeister,REP,210014,4,12,85,101,
Delaware,Commissioner of Labor,Mike Workman,DEM,210014,7,19,128,154,
Delaware,Commissioner of Labor,Mark Costello,REP,210014,4,20,146,170,
Delaware,U.S. Senate,Matt Silverstein,DEM,210014,6,11,79,96,
Delaware,U.S. Senate,Jim Inhofe,REP,210014,5,30,198,233,
Delaware,U.S. Senate,Aaron Delozier,IND,210014,0,0,3,3,
Delaware,U.S. Senate,Ray Woods,IND,210014,0,0,2,2,
Delaware,U.S. Senate,Joan Farr,IND,210014,0,0,4,4,
Delaware,U.S. Senate,Connie Johnson,DEM,210014,6,15,90,111,
Delaware,U.S. Senate,James Lankford,REP,210014,5,26,184,215,
Delaware,U.S. Senate,Mark Beard,IND,210014,0,0,8,8,
Delaware,U.S. House,Earl Everett,DEM,210014,6,6,59,71,02
Delaware,U.S. House,Markwayne Mullin,REP,210014,5,35,213,253,02
Delaware,U.S. House,Jon Douthitt,IND,210014,0,0,14,14,02
Delaware,Governor,Joe Dorman,DEM,210015,8,9,137,154,
Delaware,Governor,Mary Fallin,REP,210015,7,10,232,249,
Delaware,Governor,Kimberly Willis,IND,210015,0,0,6,6,
Delaware,Governor,Richard Prawdzienski,IND,210015,0,0,2,2,
Delaware,Lieutenant Governor,Cathy Cummings,DEM,210015,9,8,102,119,
Delaware,Lieutenant Governor,Todd Lamb,REP,210015,6,11,271,288,
Delaware,Superintendent of Public Instruction,John Cox,DEM,210015,8,10,179,197,
Delaware,Superintendent of Public Instruction,Joy Hofmeister,REP,210015,7,9,197,213,
Delaware,Commissioner of Labor,Mike Workman,DEM,210015,8,8,131,147,
Delaware,Commissioner of Labor,Mark Costello,REP,210015,7,11,238,256,
Delaware,U.S. Senate,Matt Silverstein,DEM,210015,8,7,101,116,
Delaware,U.S. Senate,Jim Inhofe,REP,210015,7,12,262,281,
Delaware,U.S. Senate,Aaron Delozier,IND,210015,0,0,4,4,
Delaware,U.S. Senate,Ray Woods,IND,210015,0,0,6,6,
Delaware,U.S. Senate,Joan Farr,IND,210015,0,0,3,3,
Delaware,U.S. Senate,Connie Johnson,DEM,210015,8,6,100,114,
Delaware,U.S. Senate,James Lankford,REP,210015,7,12,260,279,
Delaware,U.S. Senate,Mark Beard,IND,210015,0,1,13,14,
Delaware,U.S. House,Earl Everett,DEM,210015,8,5,65,78,02
Delaware,U.S. House,Markwayne Mullin,REP,210015,7,13,281,301,02
Delaware,U.S. House,Jon Douthitt,IND,210015,0,1,29,30,02
Delaware,Governor,Joe Dorman,DEM,210016,11,14,109,134,
Delaware,Governor,Mary Fallin,REP,210016,5,16,125,146,
Delaware,Governor,Kimberly Willis,IND,210016,0,1,8,9,
Delaware,Governor,Richard Prawdzienski,IND,210016,0,0,3,3,
Delaware,Lieutenant Governor,Cathy Cummings,DEM,210016,10,10,85,105,
Delaware,Lieutenant Governor,Todd Lamb,REP,210016,6,20,159,185,
Delaware,Superintendent of Public Instruction,John Cox,DEM,210016,12,24,164,200,
Delaware,Superintendent of Public Instruction,Joy Hofmeister,REP,210016,4,6,81,91,
Delaware,Commissioner of Labor,Mike Workman,DEM,210016,9,13,109,131,
Delaware,Commissioner of Labor,Mark Costello,REP,210016,7,17,130,154,
Delaware,U.S. Senate,Matt Silverstein,DEM,210016,8,7,71,86,
Delaware,U.S. Senate,Jim Inhofe,REP,210016,9,24,167,200,
Delaware,U.S. Senate,Aaron Delozier,IND,210016,0,0,1,1,
Delaware,U.S. Senate,Ray Woods,IND,210016,0,0,2,2,
Delaware,U.S. Senate,Joan Farr,IND,210016,0,0,4,4,
Delaware,U.S. Senate,Connie Johnson,DEM,210016,10,9,81,100,
Delaware,U.S. Senate,James Lankford,REP,210016,7,22,152,181,
Delaware,U.S. Senate,Mark Beard,IND,210016,0,0,11,11,
Delaware,U.S. House,Earl Everett,DEM,210016,9,6,57,72,02
Delaware,U.S. House,Markwayne Mullin,REP,210016,8,23,170,201,02
Delaware,U.S. House,Jon Douthitt,IND,210016,0,1,18,19,02
Delaware,Governor,Joe Dorman,DEM,210017,7,20,81,108,
Delaware,Governor,Mary Fallin,REP,210017,0,15,74,89,
Delaware,Governor,Kimberly Willis,IND,210017,0,0,4,4,
Delaware,Governor,Richard Prawdzienski,IND,210017,0,2,4,6,
Delaware,Lieutenant Governor,Cathy Cummings,DEM,210017,7,10,51,68,
Delaware,Lieutenant Governor,Todd Lamb,REP,210017,0,25,105,130,
Delaware,Superintendent of Public Instruction,John Cox,DEM,210017,7,29,117,153,
Delaware,Superintendent of Public Instruction,Joy Hofmeister,REP,210017,0,8,46,54,
Delaware,Commissioner of Labor,Mike Workman,DEM,210017,7,14,75,96,
Delaware,Commissioner of Labor,Mark Costello,REP,210017,0,19,76,95,
Delaware,U.S. Senate,Matt Silverstein,DEM,210017,6,14,43,63,
Delaware,U.S. Senate,Jim Inhofe,REP,210017,1,20,103,124,
Delaware,U.S. Senate,Aaron Delozier,IND,210017,0,1,3,4,
Delaware,U.S. Senate,Ray Woods,IND,210017,0,1,8,9,
Delaware,U.S. Senate,Joan Farr,IND,210017,0,0,0,0,
Delaware,U.S. Senate,Connie Johnson,DEM,210017,7,11,43,61,
Delaware,U.S. Senate,James Lankford,REP,210017,0,21,101,122,
Delaware,U.S. Senate,Mark Beard,IND,210017,0,2,11,13,
Delaware,U.S. House,Earl Everett,DEM,210017,6,12,31,49,02
Delaware,U.S. House,Markwayne Mullin,REP,210017,0,21,115,136,02
Delaware,U.S. House,Jon Douthitt,IND,210017,1,2,12,15,02
Delaware,Governor,Joe Dorman,DEM,210018,0,11,72,83,
Delaware,Governor,Mary Fallin,REP,210018,4,13,102,119,
Delaware,Governor,Kimberly Willis,IND,210018,0,2,4,6,
Delaware,Governor,Richard Prawdzienski,IND,210018,0,0,2,2,
Delaware,Lieutenant Governor,Cathy Cummings,DEM,210018,0,6,41,47,
Delaware,Lieutenant Governor,Todd Lamb,REP,210018,4,17,136,157,
Delaware,Superintendent of Public Instruction,John Cox,DEM,210018,2,21,104,127,
Delaware,Superintendent of Public Instruction,Joy Hofmeister,REP,210018,2,6,77,85,
Delaware,Commissioner of Labor,Mike Workman,DEM,210018,1,7,69,77,
Delaware,Commissioner of Labor,Mark Costello,REP,210018,3,16,106,125,
Delaware,U.S. Senate,Matt Silverstein,DEM,210018,0,9,43,52,
Delaware,U.S. Senate,Jim Inhofe,REP,210018,4,15,132,151,
Delaware,U.S. Senate,Aaron Delozier,IND,210018,0,0,3,3,
Delaware,U.S. Senate,Ray Woods,IND,210018,0,1,0,1,
Delaware,U.S. Senate,Joan Farr,IND,210018,0,1,2,3,
Delaware,U.S. Senate,Connie Johnson,DEM,210018,0,6,44,50,
Delaware,U.S. Senate,James Lankford,REP,210018,2,16,130,148,
Delaware,U.S. Senate,Mark Beard,IND,210018,2,1,6,9,
Delaware,U.S. House,Earl Everett,DEM,210018,0,8,35,43,02
Delaware,U.S. House,Markwayne Mullin,REP,210018,4,19,142,165,02
Delaware,U.S. House,Jon Douthitt,IND,210018,0,0,4,4,02
Delaware,Governor,Joe Dorman,DEM,210019,12,6,216,234,
Delaware,Governor,Mary Fallin,REP,210019,22,2,285,309,
Delaware,Governor,Kimberly Willis,IND,210019,0,0,8,8,
Delaware,Governor,Richard Prawdzienski,IND,210019,0,0,5,5,
Delaware,Lieutenant Governor,Cathy Cummings,DEM,210019,10,6,157,173,
Delaware,Lieutenant Governor,Todd Lamb,REP,210019,20,2,345,367,
Delaware,Superintendent of Public Instruction,John Cox,DEM,210019,27,6,341,374,
Delaware,Superintendent of Public Instruction,Joy Hofmeister,REP,210019,7,2,170,179,
Delaware,Commissioner of Labor,Mike Workman,DEM,210019,11,6,244,261,
Delaware,Commissioner of Labor,Mark Costello,REP,210019,15,2,240,257,
Delaware,U.S. Senate,Matt Silverstein,DEM,210019,8,6,143,157,
Delaware,U.S. Senate,Jim Inhofe,REP,210019,26,2,349,377,
Delaware,U.S. Senate,Aaron Delozier,IND,210019,0,0,2,2,
Delaware,U.S. Senate,Ray Woods,IND,210019,0,0,8,8,
Delaware,U.S. Senate,Joan Farr,IND,210019,0,0,8,8,
Delaware,U.S. Senate,Connie Johnson,DEM,210019,7,4,157,168,
Delaware,U.S. Senate,James Lankford,REP,210019,24,2,325,351,
Delaware,U.S. Senate,Mark Beard,IND,210019,0,2,20,22,
Delaware,U.S. House,Earl Everett,DEM,210019,8,4,117,129,02
Delaware,U.S. House,Markwayne Mullin,REP,210019,19,2,372,393,02
Delaware,U.S. House,Jon Douthitt,IND,210019,0,2,22,24,02
Delaware,State House,Will Fourkiller,DEM,210019,28,7,379,414,86
Delaware,State House,Tonya Teaney,REP,210019,6,1,136,143,86
Delaware,Governor,Joe Dorman,DEM,210020,0,1,75,76,
Delaware,Governor,Mary Fallin,REP,210020,0,0,58,58,
Delaware,Governor,Kimberly Willis,IND,210020,0,0,1,1,
Delaware,Governor,Richard Prawdzienski,IND,210020,0,0,2,2,
Delaware,Lieutenant Governor,Cathy Cummings,DEM,210020,0,1,47,48,
Delaware,Lieutenant Governor,Todd Lamb,REP,210020,0,0,89,89,
Delaware,Superintendent of Public Instruction,John Cox,DEM,210020,0,1,109,110,
Delaware,Superintendent of Public Instruction,Joy Hofmeister,REP,210020,0,0,27,27,
Delaware,Commissioner of Labor,Mike Workman,DEM,210020,0,1,75,76,
Delaware,Commissioner of Labor,Mark Costello,REP,210020,0,0,58,58,
Delaware,U.S. Senate,Matt Silverstein,DEM,210020,0,1,44,45,
Delaware,U.S. Senate,Jim Inhofe,REP,210020,0,0,91,91,
Delaware,U.S. Senate,Aaron Delozier,IND,210020,0,0,2,2,
Delaware,U.S. Senate,Ray Woods,IND,210020,0,0,1,1,
Delaware,U.S. Senate,Joan Farr,IND,210020,0,0,0,0,
Delaware,U.S. Senate,Connie Johnson,DEM,210020,0,1,46,47,
Delaware,U.S. Senate,James Lankford,REP,210020,0,0,83,83,
Delaware,U.S. Senate,Mark Beard,IND,210020,0,0,6,6,
Delaware,U.S. House,Earl Everett,DEM,210020,0,1,30,31,02
Delaware,U.S. House,Markwayne Mullin,REP,210020,0,0,101,101,02
Delaware,U.S. House,Jon Douthitt,IND,210020,0,0,7,7,02
Delaware,Governor,Joe Dorman,DEM,210021,1,1,42,44,
Delaware,Governor,Mary Fallin,REP,210021,2,0,62,64,
Delaware,Governor,Kimberly Willis,IND,210021,0,1,3,4,
Delaware,Governor,Richard Prawdzienski,IND,210021,0,0,2,2,
Delaware,Lieutenant Governor,Cathy Cummings,DEM,210021,1,1,32,34,
Delaware,Lieutenant Governor,Todd Lamb,REP,210021,2,1,72,75,
Delaware,Superintendent of Public Instruction,John Cox,DEM,210021,3,2,66,71,
Delaware,Superintendent of Public Instruction,Joy Hofmeister,REP,210021,0,0,43,43,
Delaware,Commissioner of Labor,Mike Workman,DEM,210021,3,1,48,52,
Delaware,Commissioner of Labor,Mark Costello,REP,210021,0,1,56,57,
Delaware,U.S. Senate,Matt Silverstein,DEM,210021,0,2,23,25,
Delaware,U.S. Senate,Jim Inhofe,REP,210021,3,0,81,84,
Delaware,U.S. Senate,Aaron Delozier,IND,210021,0,0,3,3,
Delaware,U.S. Senate,Ray Woods,IND,210021,0,0,2,2,
Delaware,U.S. Senate,Joan Farr,IND,210021,0,0,0,0,
Delaware,U.S. Senate,Connie Johnson,DEM,210021,2,1,31,34,
Delaware,U.S. Senate,James Lankford,REP,210021,1,1,71,73,
Delaware,U.S. Senate,Mark Beard,IND,210021,0,0,5,5,
Delaware,U.S. House,Earl Everett,DEM,210021,0,1,22,23,02
Delaware,U.S. House,Markwayne Mullin,REP,210021,3,1,80,84,02
Delaware,U.S. House,Jon Douthitt,IND,210021,0,0,6,6,02
Delaware,Governor,Joe Dorman,DEM,210022,13,0,321,334,
Delaware,Governor,Mary Fallin,REP,210022,18,11,381,410,
Delaware,Governor,Kimberly Willis,IND,210022,0,0,28,28,
Delaware,Governor,Richard Prawdzienski,IND,210022,0,0,9,9,
Delaware,Lieutenant Governor,Cathy Cummings,DEM,210022,12,0,242,254,
Delaware,Lieutenant Governor,Todd Lamb,REP,210022,18,9,488,515,
Delaware,Superintendent of Public Instruction,John Cox,DEM,210022,19,4,454,477,
Delaware,Superintendent of Public Instruction,Joy Hofmeister,REP,210022,11,7,284,302,
Delaware,Commissioner of Labor,Mike Workman,DEM,210022,9,1,349,359,
Delaware,Commissioner of Labor,Mark Costello,REP,210022,17,8,376,401,
Delaware,U.S. Senate,Matt Silverstein,DEM,210022,11,0,195,206,
Delaware,U.S. Senate,Jim Inhofe,REP,210022,20,11,513,544,
Delaware,U.S. Senate,Aaron Delozier,IND,210022,0,0,8,8,
Delaware,U.S. Senate,Ray Woods,IND,210022,0,0,12,12,
Delaware,U.S. Senate,Joan Farr,IND,210022,0,0,7,7,
Delaware,U.S. Senate,Connie Johnson,DEM,210022,10,0,225,235,
Delaware,U.S. Senate,James Lankford,REP,210022,18,9,471,498,
Delaware,U.S. Senate,Mark Beard,IND,210022,0,0,40,40,
Delaware,U.S. House,Earl Everett,DEM,210022,9,0,160,169,02
Delaware,U.S. House,Markwayne Mullin,REP,210022,21,11,534,566,02
Delaware,U.S. House,Jon Douthitt,IND,210022,0,0,48,48,02
Delaware,State House,Will Fourkiller,DEM,210022,22,3,498,523,86
Delaware,State House,Tonya Teaney,REP,210022,8,8,239,255,86
Delaware,Governor,Joe Dorman,DEM,210023,7,2,102,111,
Delaware,Governor,Mary Fallin,REP,210023,11,1,258,270,
Delaware,Governor,Kimberly Willis,IND,210023,0,0,8,8,
Delaware,Governor,Richard Prawdzienski,IND,210023,0,0,6,6,
Delaware,Lieutenant Governor,Cathy Cummings,DEM,210023,8,1,78,87,
Delaware,Lieutenant Governor,Todd Lamb,REP,210023,10,2,293,305,
Delaware,Superintendent of Public Instruction,John Cox,DEM,210023,10,2,184,196,
Delaware,Superintendent of Public Instruction,Joy Hofmeister,REP,210023,8,1,189,198,
Delaware,Commissioner of Labor,Mike Workman,DEM,210023,8,1,121,130,
Delaware,Commissioner of Labor,Mark Costello,REP,210023,10,2,241,253,
Delaware,U.S. Senate,Matt Silverstein,DEM,210023,6,1,62,69,
Delaware,U.S. Senate,Jim Inhofe,REP,210023,11,2,290,303,
Delaware,U.S. Senate,Aaron Delozier,IND,210023,0,0,4,4,
Delaware,U.S. Senate,Ray Woods,IND,210023,0,0,4,4,
Delaware,U.S. Senate,Joan Farr,IND,210023,0,0,11,11,
Delaware,U.S. Senate,Connie Johnson,DEM,210023,6,1,63,70,
Delaware,U.S. Senate,James Lankford,REP,210023,11,2,289,302,
Delaware,U.S. Senate,Mark Beard,IND,210023,1,0,19,20,
Delaware,U.S. House,Earl Everett,DEM,210023,5,1,49,55,02
Delaware,U.S. House,Markwayne Mullin,REP,210023,11,2,310,323,02
Delaware,U.S. House,Jon Douthitt,IND,210023,2,0,11,13,02
Delaware,State House,Will Fourkiller,DEM,210023,9,2,210,221,86
Delaware,State House,Tonya Teaney,REP,210023,9,1,160,170,86
Dewey,Governor,Joe Dorman,DEM,220001,1,6,69,76,
Dewey,Governor,Mary Fallin,REP,220001,0,14,103,117,
Dewey,Governor,Kimberly Willis,IND,220001,0,0,4,4,
Dewey,Governor,Richard Prawdzienski,IND,220001,0,0,1,1,
Dewey,Lieutenant Governor,Cathy Cummings,DEM,220001,1,2,26,29,
Dewey,Lieutenant Governor,Todd Lamb,REP,220001,0,18,150,168,
Dewey,Superintendent of Public Instruction,John Cox,DEM,220001,1,7,89,97,
Dewey,Superintendent of Public Instruction,Joy Hofmeister,REP,220001,0,13,86,99,
Dewey,Commissioner of Labor,Mike Workman,DEM,220001,1,5,51,57,
Dewey,Commissioner of Labor,Mark Costello,REP,220001,0,14,118,132,
Dewey,U.S. Senate,Matt Silverstein,DEM,220001,1,3,25,29,
Dewey,U.S. Senate,Jim Inhofe,REP,220001,0,17,147,164,
Dewey,U.S. Senate,Aaron Delozier,IND,220001,0,0,0,0,
Dewey,U.S. Senate,Ray Woods,IND,220001,0,0,2,2,
Dewey,U.S. Senate,Joan Farr,IND,220001,0,0,2,2,
Dewey,U.S. Senate,Connie Johnson,DEM,220001,1,3,31,35,
Dewey,U.S. Senate,James Lankford,REP,220001,0,17,139,156,
Dewey,U.S. Senate,Mark Beard,IND,220001,0,0,4,4,
Dewey,U.S. House,Frankie Robbins,DEM,220001,0,1,23,24,03
Dewey,U.S. House,Frank Lucas,REP,220001,1,19,152,172,03
Dewey,Governor,Joe Dorman,DEM,220002,0,0,7,7,
Dewey,Governor,Mary Fallin,REP,220002,12,1,60,73,
Dewey,Governor,Kimberly Willis,IND,220002,0,0,0,0,
Dewey,Governor,Richard Prawdzienski,IND,220002,0,0,1,1,
Dewey,Lieutenant Governor,Cathy Cummings,DEM,220002,0,0,8,8,
Dewey,Lieutenant Governor,Todd Lamb,REP,220002,12,1,60,73,
Dewey,Superintendent of Public Instruction,John Cox,DEM,220002,2,0,17,19,
Dewey,Superintendent of Public Instruction,Joy Hofmeister,REP,220002,10,1,49,60,
Dewey,Commissioner of Labor,Mike Workman,DEM,220002,1,0,13,14,
Dewey,Commissioner of Labor,Mark Costello,REP,220002,11,1,49,61,
Dewey,U.S. Senate,Matt Silverstein,DEM,220002,0,0,3,3,
Dewey,U.S. Senate,Jim Inhofe,REP,220002,12,1,60,73,
Dewey,U.S. Senate,Aaron Delozier,IND,220002,0,0,0,0,
Dewey,U.S. Senate,Ray Woods,IND,220002,0,0,2,2,
Dewey,U.S. Senate,Joan Farr,IND,220002,0,0,2,2,
Dewey,U.S. Senate,Connie Johnson,DEM,220002,2,0,3,5,
Dewey,U.S. Senate,James Lankford,REP,220002,10,1,58,69,
Dewey,U.S. Senate,Mark Beard,IND,220002,0,0,4,4,
Dewey,U.S. House,Frankie Robbins,DEM,220002,0,0,1,1,03
Dewey,U.S. House,Frank Lucas,REP,220002,12,1,64,77,03
Dewey,Governor,Joe Dorman,DEM,220003,3,0,88,91,
Dewey,Governor,Mary Fallin,REP,220003,3,0,141,144,
Dewey,Governor,Kimberly Willis,IND,220003,0,0,2,2,
Dewey,Governor,Richard Prawdzienski,IND,220003,0,0,4,4,
Dewey,Lieutenant Governor,Cathy Cummings,DEM,220003,0,0,40,40,
Dewey,Lieutenant Governor,Todd Lamb,REP,220003,6,0,195,201,
Dewey,Superintendent of Public Instruction,John Cox,DEM,220003,3,0,123,126,
Dewey,Superintendent of Public Instruction,Joy Hofmeister,REP,220003,3,0,109,112,
Dewey,Commissioner of Labor,Mike Workman,DEM,220003,0,0,68,68,
Dewey,Commissioner of Labor,Mark Costello,REP,220003,5,0,152,157,
Dewey,U.S. Senate,Matt Silverstein,DEM,220003,0,0,38,38,
Dewey,U.S. Senate,Jim Inhofe,REP,220003,5,0,189,194,
Dewey,U.S. Senate,Aaron Delozier,IND,220003,0,0,1,1,
Dewey,U.S. Senate,Ray Woods,IND,220003,0,0,3,3,
Dewey,U.S. Senate,Joan Farr,IND,220003,1,0,0,1,
Dewey,U.S. Senate,Connie Johnson,DEM,220003,0,0,33,33,
Dewey,U.S. Senate,James Lankford,REP,220003,6,0,193,199,
Dewey,U.S. Senate,Mark Beard,IND,220003,0,0,6,6,
Dewey,U.S. House,Frankie Robbins,DEM,220003,2,0,27,29,03
Dewey,U.S. House,Frank Lucas,REP,220003,4,0,206,210,03
Dewey,Governor,Joe Dorman,DEM,220004,0,0,34,34,
Dewey,Governor,Mary Fallin,REP,220004,4,0,54,58,
Dewey,Governor,Kimberly Willis,IND,220004,0,0,1,1,
Dewey,Governor,Richard Prawdzienski,IND,220004,0,0,1,1,
Dewey,Lieutenant Governor,Cathy Cummings,DEM,220004,0,0,21,21,
Dewey,Lieutenant Governor,Todd Lamb,REP,220004,4,0,70,74,
Dewey,Superintendent of Public Instruction,John Cox,DEM,220004,0,0,36,36,
Dewey,Superintendent of Public Instruction,Joy Hofmeister,REP,220004,4,0,55,59,
Dewey,Commissioner of Labor,Mike Workman,DEM,220004,0,0,22,22,
Dewey,Commissioner of Labor,Mark Costello,REP,220004,3,0,68,71,
Dewey,U.S. Senate,Matt Silverstein,DEM,220004,0,0,15,15,
Dewey,U.S. Senate,Jim Inhofe,REP,220004,4,0,74,78,
Dewey,U.S. Senate,Aaron Delozier,IND,220004,0,0,0,0,
Dewey,U.S. Senate,Ray Woods,IND,220004,0,0,2,2,
Dewey,U.S. Senate,Joan Farr,IND,220004,0,0,0,0,
Dewey,U.S. Senate,Connie Johnson,DEM,220004,0,0,14,14,
Dewey,U.S. Senate,James Lankford,REP,220004,4,0,77,81,
Dewey,U.S. Senate,Mark Beard,IND,220004,0,0,0,0,
Dewey,U.S. House,Frankie Robbins,DEM,220004,0,0,13,13,03
Dewey,U.S. House,Frank Lucas,REP,220004,4,0,78,82,03
Dewey,Governor,Joe Dorman,DEM,220005,1,8,88,97,
Dewey,Governor,Mary Fallin,REP,220005,5,14,229,248,
Dewey,Governor,Kimberly Willis,IND,220005,1,0,4,5,
Dewey,Governor,Richard Prawdzienski,IND,220005,1,0,5,6,
Dewey,Lieutenant Governor,Cathy Cummings,DEM,220005,1,0,30,31,
Dewey,Lieutenant Governor,Todd Lamb,REP,220005,7,22,293,322,
Dewey,Superintendent of Public Instruction,John Cox,DEM,220005,4,7,136,147,
Dewey,Superintendent of Public Instruction,Joy Hofmeister,REP,220005,4,15,188,207,
Dewey,Commissioner of Labor,Mike Workman,DEM,220005,3,2,88,93,
Dewey,Commissioner of Labor,Mark Costello,REP,220005,4,19,224,247,
Dewey,U.S. Senate,Matt Silverstein,DEM,220005,2,0,39,41,
Dewey,U.S. Senate,Jim Inhofe,REP,220005,6,22,277,305,
Dewey,U.S. Senate,Aaron Delozier,IND,220005,0,0,3,3,
Dewey,U.S. Senate,Ray Woods,IND,220005,0,0,5,5,
Dewey,U.S. Senate,Joan Farr,IND,220005,0,0,1,1,
Dewey,U.S. Senate,Connie Johnson,DEM,220005,0,0,39,39,
Dewey,U.S. Senate,James Lankford,REP,220005,6,22,273,301,
Dewey,U.S. Senate,Mark Beard,IND,220005,0,0,10,10,
Dewey,U.S. House,Frankie Robbins,DEM,220005,1,2,40,43,03
Dewey,U.S. House,Frank Lucas,REP,220005,7,20,284,311,03
Dewey,Governor,Joe Dorman,DEM,220007,0,2,19,21,
Dewey,Governor,Mary Fallin,REP,220007,3,1,39,43,
Dewey,Governor,Kimberly Willis,IND,220007,0,0,0,0,
Dewey,Governor,Richard Prawdzienski,IND,220007,0,0,0,0,
Dewey,Lieutenant Governor,Cathy Cummings,DEM,220007,0,0,4,4,
Dewey,Lieutenant Governor,Todd Lamb,REP,220007,3,3,54,60,
Dewey,Superintendent of Public Instruction,John Cox,DEM,220007,0,1,19,20,
Dewey,Superintendent of Public Instruction,Joy Hofmeister,REP,220007,3,2,39,44,
Dewey,Commissioner of Labor,Mike Workman,DEM,220007,1,0,15,16,
Dewey,Commissioner of Labor,Mark Costello,REP,220007,2,3,43,48,
Dewey,U.S. Senate,Matt Silverstein,DEM,220007,0,0,4,4,
Dewey,U.S. Senate,Jim Inhofe,REP,220007,3,3,52,58,
Dewey,U.S. Senate,Aaron Delozier,IND,220007,0,0,1,1,
Dewey,U.S. Senate,Ray Woods,IND,220007,0,0,0,0,
Dewey,U.S. Senate,Joan Farr,IND,220007,0,0,1,1,
Dewey,U.S. Senate,Connie Johnson,DEM,220007,0,0,4,4,
Dewey,U.S. Senate,James Lankford,REP,220007,3,3,54,60,
Dewey,U.S. Senate,Mark Beard,IND,220007,0,0,0,0,
Dewey,U.S. House,Frankie Robbins,DEM,220007,0,0,2,2,03
Dewey,U.S. House,Frank Lucas,REP,220007,3,3,56,62,03
Dewey,Governor,Joe Dorman,DEM,220008,4,5,74,83,
Dewey,Governor,Mary Fallin,REP,220008,15,8,194,217,
Dewey,Governor,Kimberly Willis,IND,220008,0,1,9,10,
Dewey,Governor,Richard Prawdzienski,IND,220008,0,0,7,7,
Dewey,Lieutenant Governor,Cathy Cummings,DEM,220008,3,2,41,46,
Dewey,Lieutenant Governor,Todd Lamb,REP,220008,17,12,240,269,
Dewey,Superintendent of Public Instruction,John Cox,DEM,220008,7,0,93,100,
Dewey,Superintendent of Public Instruction,Joy Hofmeister,REP,220008,13,14,189,216,
Dewey,Commissioner of Labor,Mike Workman,DEM,220008,3,4,67,74,
Dewey,Commissioner of Labor,Mark Costello,REP,220008,16,10,205,231,
Dewey,U.S. Senate,Matt Silverstein,DEM,220008,3,0,31,34,
Dewey,U.S. Senate,Jim Inhofe,REP,220008,15,14,239,268,
Dewey,U.S. Senate,Aaron Delozier,IND,220008,1,0,3,4,
Dewey,U.S. Senate,Ray Woods,IND,220008,0,0,8,8,
Dewey,U.S. Senate,Joan Farr,IND,220008,0,0,3,3,
Dewey,U.S. Senate,Connie Johnson,DEM,220008,2,1,35,38,
Dewey,U.S. Senate,James Lankford,REP,220008,14,13,240,267,
Dewey,U.S. Senate,Mark Beard,IND,220008,2,0,8,10,
Dewey,U.S. House,Frankie Robbins,DEM,220008,3,0,35,38,03
Dewey,U.S. House,Frank Lucas,REP,220008,16,14,247,277,03
Dewey,Governor,Joe Dorman,DEM,220009,6,3,27,36,
Dewey,Governor,Mary Fallin,REP,220009,1,1,70,72,
Dewey,Governor,Kimberly Willis,IND,220009,1,0,2,3,
Dewey,Governor,Richard Prawdzienski,IND,220009,0,0,1,1,
Dewey,Lieutenant Governor,Cathy Cummings,DEM,220009,4,0,17,21,
Dewey,Lieutenant Governor,Todd Lamb,REP,220009,4,4,81,89,
Dewey,Superintendent of Public Instruction,John Cox,DEM,220009,7,1,37,45,
Dewey,Superintendent of Public Instruction,Joy Hofmeister,REP,220009,1,3,62,66,
Dewey,Commissioner of Labor,Mike Workman,DEM,220009,7,3,23,33,
Dewey,Commissioner of Labor,Mark Costello,REP,220009,1,1,73,75,
Dewey,U.S. Senate,Matt Silverstein,DEM,220009,4,0,13,17,
Dewey,U.S. Senate,Jim Inhofe,REP,220009,4,4,85,93,
Dewey,U.S. Senate,Aaron Delozier,IND,220009,0,0,0,0,
Dewey,U.S. Senate,Ray Woods,IND,220009,0,0,2,2,
Dewey,U.S. Senate,Joan Farr,IND,220009,0,0,0,0,
Dewey,U.S. Senate,Connie Johnson,DEM,220009,3,0,10,13,
Dewey,U.S. Senate,James Lankford,REP,220009,4,4,84,92,
Dewey,U.S. Senate,Mark Beard,IND,220009,1,0,5,6,
Dewey,U.S. House,Frankie Robbins,DEM,220009,2,0,12,14,03
Dewey,U.S. House,Frank Lucas,REP,220009,6,4,88,98,03
Dewey,Governor,Joe Dorman,DEM,220010,0,0,9,9,
Dewey,Governor,Mary Fallin,REP,220010,1,0,23,24,
Dewey,Governor,Kimberly Willis,IND,220010,0,0,0,0,
Dewey,Governor,Richard Prawdzienski,IND,220010,0,0,0,0,
Dewey,Lieutenant Governor,Cathy Cummings,DEM,220010,0,0,6,6,
Dewey,Lieutenant Governor,Todd Lamb,REP,220010,1,0,25,26,
Dewey,Superintendent of Public Instruction,John Cox,DEM,220010,0,0,12,12,
Dewey,Superintendent of Public Instruction,Joy Hofmeister,REP,220010,1,0,20,21,
Dewey,Commissioner of Labor,Mike Workman,DEM,220010,0,0,11,11,
Dewey,Commissioner of Labor,Mark Costello,REP,220010,1,0,19,20,
Dewey,U.S. Senate,Matt Silverstein,DEM,220010,0,0,6,6,
Dewey,U.S. Senate,Jim Inhofe,REP,220010,1,0,22,23,
Dewey,U.S. Senate,Aaron Delozier,IND,220010,0,0,2,2,
Dewey,U.S. Senate,Ray Woods,IND,220010,0,0,1,1,
Dewey,U.S. Senate,Joan Farr,IND,220010,0,0,0,0,
Dewey,U.S. Senate,Connie Johnson,DEM,220010,0,0,3,3,
Dewey,U.S. Senate,James Lankford,REP,220010,1,0,27,28,
Dewey,U.S. Senate,Mark Beard,IND,220010,0,0,2,2,
Dewey,U.S. House,Frankie Robbins,DEM,220010,0,0,5,5,03
Dewey,U.S. House,Frank Lucas,REP,220010,1,0,27,28,03
Ellis,Governor,Joe Dorman,DEM,230001,3,13,80,96,
Ellis,Governor,Mary Fallin,REP,230001,12,26,150,188,
Ellis,Governor,Kimberly Willis,IND,230001,0,1,6,7,
Ellis,Governor,Richard Prawdzienski,IND,230001,0,2,4,6,
Ellis,Lieutenant Governor,Cathy Cummings,DEM,230001,2,7,40,49,
Ellis,Lieutenant Governor,Todd Lamb,REP,230001,14,36,199,249,
Ellis,Superintendent of Public Instruction,John Cox,DEM,230001,9,20,119,148,
Ellis,Superintendent of Public Instruction,Joy Hofmeister,REP,230001,7,22,120,149,
Ellis,Commissioner of Labor,Mike Workman,DEM,230001,4,13,81,98,
Ellis,Commissioner of Labor,Mark Costello,REP,230001,12,29,151,192,
Ellis,U.S. Senate,Matt Silverstein,DEM,230001,1,2,33,36,
Ellis,U.S. Senate,Jim Inhofe,REP,230001,15,36,199,250,
Ellis,U.S. Senate,Aaron Delozier,IND,230001,0,0,3,3,
Ellis,U.S. Senate,Ray Woods,IND,230001,0,2,4,6,
Ellis,U.S. Senate,Joan Farr,IND,230001,0,1,1,2,
Ellis,U.S. Senate,Connie Johnson,DEM,230001,1,2,33,36,
Ellis,U.S. Senate,James Lankford,REP,230001,15,39,201,255,
Ellis,U.S. Senate,Mark Beard,IND,230001,0,2,6,8,
Ellis,U.S. House,Frankie Robbins,DEM,230001,3,7,35,45,03
Ellis,U.S. House,Frank Lucas,REP,230001,13,36,205,254,03
Ellis,Governor,Joe Dorman,DEM,230003,2,4,81,87,
Ellis,Governor,Mary Fallin,REP,230003,11,12,275,298,
Ellis,Governor,Kimberly Willis,IND,230003,0,0,5,5,
Ellis,Governor,Richard Prawdzienski,IND,230003,0,0,6,6,
Ellis,Lieutenant Governor,Cathy Cummings,DEM,230003,3,0,32,35,
Ellis,Lieutenant Governor,Todd Lamb,REP,230003,9,16,336,361,
Ellis,Superintendent of Public Instruction,John Cox,DEM,230003,7,4,131,142,
Ellis,Superintendent of Public Instruction,Joy Hofmeister,REP,230003,6,12,235,253,
Ellis,Commissioner of Labor,Mike Workman,DEM,230003,5,2,63,70,
Ellis,Commissioner of Labor,Mark Costello,REP,230003,8,12,294,314,
Ellis,U.S. Senate,Matt Silverstein,DEM,230003,5,0,26,31,
Ellis,U.S. Senate,Jim Inhofe,REP,230003,8,16,327,351,
Ellis,U.S. Senate,Aaron Delozier,IND,230003,0,0,2,2,
Ellis,U.S. Senate,Ray Woods,IND,230003,0,0,8,8,
Ellis,U.S. Senate,Joan Farr,IND,230003,0,0,3,3,
Ellis,U.S. Senate,Connie Johnson,DEM,230003,3,0,26,29,
Ellis,U.S. Senate,James Lankford,REP,230003,10,16,336,362,
Ellis,U.S. Senate,Mark Beard,IND,230003,0,0,6,6,
Ellis,U.S. House,Frankie Robbins,DEM,230003,3,2,38,43,03
Ellis,U.S. House,Frank Lucas,REP,230003,10,14,328,352,03
Ellis,Governor,Joe Dorman,DEM,230004,0,0,16,16,
Ellis,Governor,Mary Fallin,REP,230004,0,1,44,45,
Ellis,Governor,Kimberly Willis,IND,230004,0,0,3,3,
Ellis,Governor,Richard Prawdzienski,IND,230004,0,1,1,2,
Ellis,Lieutenant Governor,Cathy Cummings,DEM,230004,0,0,3,3,
Ellis,Lieutenant Governor,Todd Lamb,REP,230004,0,2,61,63,
Ellis,Superintendent of Public Instruction,John Cox,DEM,230004,0,0,27,27,
Ellis,Superintendent of Public Instruction,Joy Hofmeister,REP,230004,0,2,37,39,
Ellis,Commissioner of Labor,Mike Workman,DEM,230004,0,0,7,7,
Ellis,Commissioner of Labor,Mark Costello,REP,230004,0,2,57,59,
Ellis,U.S. Senate,Matt Silverstein,DEM,230004,0,0,1,1,
Ellis,U.S. Senate,Jim Inhofe,REP,230004,0,2,60,62,
Ellis,U.S. Senate,Aaron Delozier,IND,230004,0,0,1,1,
Ellis,U.S. Senate,Ray Woods,IND,230004,0,0,2,2,
Ellis,U.S. Senate,Joan Farr,IND,230004,0,0,0,0,
Ellis,U.S. Senate,Connie Johnson,DEM,230004,0,0,3,3,
Ellis,U.S. Senate,James Lankford,REP,230004,0,2,58,60,
Ellis,U.S. Senate,Mark Beard,IND,230004,0,0,3,3,
Ellis,U.S. House,Frankie Robbins,DEM,230004,0,0,5,5,03
Ellis,U.S. House,Frank Lucas,REP,230004,0,2,59,61,03
Ellis,Governor,Joe Dorman,DEM,230006,4,0,3,7,
Ellis,Governor,Mary Fallin,REP,230006,0,4,25,29,
Ellis,Governor,Kimberly Willis,IND,230006,0,0,0,0,
Ellis,Governor,Richard Prawdzienski,IND,230006,0,0,0,0,
Ellis,Lieutenant Governor,Cathy Cummings,DEM,230006,2,0,1,3,
Ellis,Lieutenant Governor,Todd Lamb,REP,230006,2,4,27,33,
Ellis,Superintendent of Public Instruction,John Cox,DEM,230006,3,1,10,14,
Ellis,Superintendent of Public Instruction,Joy Hofmeister,REP,230006,1,3,18,22,
Ellis,Commissioner of Labor,Mike Workman,DEM,230006,3,0,2,5,
Ellis,Commissioner of Labor,Mark Costello,REP,230006,1,4,25,30,
Ellis,U.S. Senate,Matt Silverstein,DEM,230006,2,0,2,4,
Ellis,U.S. Senate,Jim Inhofe,REP,230006,2,4,26,32,
Ellis,U.S. Senate,Aaron Delozier,IND,230006,0,0,0,0,
Ellis,U.S. Senate,Ray Woods,IND,230006,0,0,0,0,
Ellis,U.S. Senate,Joan Farr,IND,230006,0,0,0,0,
Ellis,U.S. Senate,Connie Johnson,DEM,230006,2,0,2,4,
Ellis,U.S. Senate,James Lankford,REP,230006,2,4,26,32,
Ellis,U.S. Senate,Mark Beard,IND,230006,0,0,0,0,
Ellis,U.S. House,Frankie Robbins,DEM,230006,2,0,2,4,03
Ellis,U.S. House,Frank Lucas,REP,230006,2,4,26,32,03
Ellis,Governor,Joe Dorman,DEM,230007,5,4,33,42,
Ellis,Governor,Mary Fallin,REP,230007,1,7,156,164,
Ellis,Governor,Kimberly Willis,IND,230007,0,0,6,6,
Ellis,Governor,Richard Prawdzienski,IND,230007,0,0,2,2,
Ellis,Lieutenant Governor,Cathy Cummings,DEM,230007,3,0,22,25,
Ellis,Lieutenant Governor,Todd Lamb,REP,230007,3,11,175,189,
Ellis,Superintendent of Public Instruction,John Cox,DEM,230007,4,7,62,73,
Ellis,Superintendent of Public Instruction,Joy Hofmeister,REP,230007,2,4,134,140,
Ellis,Commissioner of Labor,Mike Workman,DEM,230007,4,0,44,48,
Ellis,Commissioner of Labor,Mark Costello,REP,230007,2,10,152,164,
Ellis,U.S. Senate,Matt Silverstein,DEM,230007,1,1,18,20,
Ellis,U.S. Senate,Jim Inhofe,REP,230007,5,9,170,184,
Ellis,U.S. Senate,Aaron Delozier,IND,230007,0,0,0,0,
Ellis,U.S. Senate,Ray Woods,IND,230007,0,0,2,2,
Ellis,U.S. Senate,Joan Farr,IND,230007,0,0,3,3,
Ellis,U.S. Senate,Connie Johnson,DEM,230007,3,1,24,28,
Ellis,U.S. Senate,James Lankford,REP,230007,3,9,167,179,
Ellis,U.S. Senate,Mark Beard,IND,230007,0,0,5,5,
Ellis,U.S. House,Frankie Robbins,DEM,230007,0,0,14,14,03
Ellis,U.S. House,Frank Lucas,REP,230007,6,11,184,201,03
Ellis,Governor,Joe Dorman,DEM,230008,1,1,40,42,
Ellis,Governor,Mary Fallin,REP,230008,1,1,120,122,
Ellis,Governor,Kimberly Willis,IND,230008,0,0,3,3,
Ellis,Governor,Richard Prawdzienski,IND,230008,0,1,2,3,
Ellis,Lieutenant Governor,Cathy Cummings,DEM,230008,0,2,15,17,
Ellis,Lieutenant Governor,Todd Lamb,REP,230008,2,1,148,151,
Ellis,Superintendent of Public Instruction,John Cox,DEM,230008,1,1,69,71,
Ellis,Superintendent of Public Instruction,Joy Hofmeister,REP,230008,1,2,95,98,
Ellis,Commissioner of Labor,Mike Workman,DEM,230008,0,1,34,35,
Ellis,Commissioner of Labor,Mark Costello,REP,230008,2,2,125,129,
Ellis,U.S. Senate,Matt Silverstein,DEM,230008,1,1,13,15,
Ellis,U.S. Senate,Jim Inhofe,REP,230008,1,2,147,150,
Ellis,U.S. Senate,Aaron Delozier,IND,230008,0,0,0,0,
Ellis,U.S. Senate,Ray Woods,IND,230008,0,0,2,2,
Ellis,U.S. Senate,Joan Farr,IND,230008,0,0,2,2,
Ellis,U.S. Senate,Connie Johnson,DEM,230008,0,1,18,19,
Ellis,U.S. Senate,James Lankford,REP,230008,2,2,144,148,
Ellis,U.S. Senate,Mark Beard,IND,230008,0,0,2,2,
Ellis,U.S. House,Frankie Robbins,DEM,230008,0,2,13,15,03
Ellis,U.S. House,Frank Lucas,REP,230008,2,1,150,153,03
Ellis,Governor,Joe Dorman,DEM,230009,0,0,26,26,
Ellis,Governor,Mary Fallin,REP,230009,0,4,38,42,
Ellis,Governor,Kimberly Willis,IND,230009,0,0,0,0,
Ellis,Governor,Richard Prawdzienski,IND,230009,0,0,0,0,
Ellis,Lieutenant Governor,Cathy Cummings,DEM,230009,0,0,7,7,
Ellis,Lieutenant Governor,Todd Lamb,REP,230009,0,4,56,60,
Ellis,Superintendent of Public Instruction,John Cox,DEM,230009,0,1,22,23,
Ellis,Superintendent of Public Instruction,Joy Hofmeister,REP,230009,0,3,42,45,
Ellis,Commissioner of Labor,Mike Workman,DEM,230009,0,0,20,20,
Ellis,Commissioner of Labor,Mark Costello,REP,230009,0,4,38,42,
Ellis,U.S. Senate,Matt Silverstein,DEM,230009,0,0,10,10,
Ellis,U.S. Senate,Jim Inhofe,REP,230009,0,4,52,56,
Ellis,U.S. Senate,Aaron Delozier,IND,230009,0,0,0,0,
Ellis,U.S. Senate,Ray Woods,IND,230009,0,0,1,1,
Ellis,U.S. Senate,Joan Farr,IND,230009,0,0,0,0,
Ellis,U.S. Senate,Connie Johnson,DEM,230009,0,0,10,10,
Ellis,U.S. Senate,James Lankford,REP,230009,0,4,50,54,
Ellis,U.S. Senate,Mark Beard,IND,230009,0,0,3,3,
Ellis,U.S. House,Frankie Robbins,DEM,230009,0,0,9,9,03
Ellis,U.S. House,Frank Lucas,REP,230009,0,4,54,58,03
Garfield,Governor,Joe Dorman,DEM,240101,7,6,111,124,
Garfield,Governor,Mary Fallin,REP,240101,19,2,95,116,
Garfield,Governor,Kimberly Willis,IND,240101,1,0,1,2,
Garfield,Governor,Richard Prawdzienski,IND,240101,1,0,3,4,
Garfield,Lieutenant Governor,Cathy Cummings,DEM,240101,5,4,78,87,
Garfield,Lieutenant Governor,Todd Lamb,REP,240101,24,4,131,159,
Garfield,Superintendent of Public Instruction,John Cox,DEM,240101,9,5,104,118,
Garfield,Superintendent of Public Instruction,Joy Hofmeister,REP,240101,19,3,104,126,
Garfield,Commissioner of Labor,Mike Workman,DEM,240101,10,5,89,104,
Garfield,Commissioner of Labor,Mark Costello,REP,240101,18,3,118,139,
Garfield,U.S. Senate,Matt Silverstein,DEM,240101,6,4,77,87,
Garfield,U.S. Senate,Jim Inhofe,REP,240101,22,4,124,150,
Garfield,U.S. Senate,Aaron Delozier,IND,240101,0,0,2,2,
Garfield,U.S. Senate,Ray Woods,IND,240101,1,0,2,3,
Garfield,U.S. Senate,Joan Farr,IND,240101,0,0,2,2,
Garfield,U.S. Senate,Connie Johnson,DEM,240101,5,4,86,95,
Garfield,U.S. Senate,James Lankford,REP,240101,20,4,118,142,
Garfield,U.S. Senate,Mark Beard,IND,240101,2,0,6,8,
Garfield,U.S. House,Frankie Robbins,DEM,240101,7,4,80,91,03
Garfield,U.S. House,Frank Lucas,REP,240101,22,4,128,154,03
Garfield,State House,Pierce Jones,DEM,240101,10,5,89,104,40
Garfield,State House,Chad Caldwell,REP,240101,18,3,120,141,40
Garfield,Governor,Joe Dorman,DEM,240102,3,8,121,132,
Garfield,Governor,Mary Fallin,REP,240102,3,4,118,125,
Garfield,Governor,Kimberly Willis,IND,240102,0,0,9,9,
Garfield,Governor,Richard Prawdzienski,IND,240102,0,0,9,9,
Garfield,Lieutenant Governor,Cathy Cummings,DEM,240102,2,7,78,87,
Garfield,Lieutenant Governor,Todd Lamb,REP,240102,4,5,179,188,
Garfield,Superintendent of Public Instruction,John Cox,DEM,240102,3,7,113,123,
Garfield,Superintendent of Public Instruction,Joy Hofmeister,REP,240102,3,5,143,151,
Garfield,Commissioner of Labor,Mike Workman,DEM,240102,2,6,112,120,
Garfield,Commissioner of Labor,Mark Costello,REP,240102,4,6,145,155,
Garfield,U.S. Senate,Matt Silverstein,DEM,240102,1,5,76,82,
Garfield,U.S. Senate,Jim Inhofe,REP,240102,5,7,170,182,
Garfield,U.S. Senate,Aaron Delozier,IND,240102,0,0,0,0,
Garfield,U.S. Senate,Ray Woods,IND,240102,0,0,5,5,
Garfield,U.S. Senate,Joan Farr,IND,240102,0,0,6,6,
Garfield,U.S. Senate,Connie Johnson,DEM,240102,2,6,81,89,
Garfield,U.S. Senate,James Lankford,REP,240102,4,6,161,171,
Garfield,U.S. Senate,Mark Beard,IND,240102,0,0,14,14,
Garfield,U.S. House,Frankie Robbins,DEM,240102,2,5,79,86,03
Garfield,U.S. House,Frank Lucas,REP,240102,4,7,178,189,03
Garfield,State House,Pierce Jones,DEM,240102,3,6,101,110,40
Garfield,State House,Chad Caldwell,REP,240102,3,6,155,164,40
Garfield,Governor,Joe Dorman,DEM,240103,7,8,165,180,
Garfield,Governor,Mary Fallin,REP,240103,7,13,178,198,
Garfield,Governor,Kimberly Willis,IND,240103,0,1,17,18,
Garfield,Governor,Richard Prawdzienski,IND,240103,0,1,5,6,
Garfield,Lieutenant Governor,Cathy Cummings,DEM,240103,6,4,108,118,
Garfield,Lieutenant Governor,Todd Lamb,REP,240103,8,19,256,283,
Garfield,Superintendent of Public Instruction,John Cox,DEM,240103,4,8,149,161,
Garfield,Superintendent of Public Instruction,Joy Hofmeister,REP,240103,10,14,213,237,
Garfield,Commissioner of Labor,Mike Workman,DEM,240103,5,8,127,140,
Garfield,Commissioner of Labor,Mark Costello,REP,240103,9,14,230,253,
Garfield,U.S. Senate,Matt Silverstein,DEM,240103,4,5,98,107,
Garfield,U.S. Senate,Jim Inhofe,REP,240103,8,17,251,276,
Garfield,U.S. Senate,Aaron Delozier,IND,240103,1,0,3,4,
Garfield,U.S. Senate,Ray Woods,IND,240103,0,0,7,7,
Garfield,U.S. Senate,Joan Farr,IND,240103,1,1,6,8,
Garfield,U.S. Senate,Connie Johnson,DEM,240103,5,6,107,118,
Garfield,U.S. Senate,James Lankford,REP,240103,9,14,244,267,
Garfield,U.S. Senate,Mark Beard,IND,240103,0,1,14,15,
Garfield,U.S. House,Frankie Robbins,DEM,240103,6,4,103,113,03
Garfield,U.S. House,Frank Lucas,REP,240103,8,19,260,287,03
Garfield,State House,Pierce Jones,DEM,240103,5,4,125,134,40
Garfield,State House,Chad Caldwell,REP,240103,9,18,233,260,40
Garfield,Governor,Joe Dorman,DEM,240104,9,15,181,205,
Garfield,Governor,Mary Fallin,REP,240104,7,16,159,182,
Garfield,Governor,Kimberly Willis,IND,240104,0,0,12,12,
Garfield,Governor,Richard Prawdzienski,IND,240104,0,0,8,8,
Garfield,Lieutenant Governor,Cathy Cummings,DEM,240104,6,11,105,122,
Garfield,Lieutenant Governor,Todd Lamb,REP,240104,10,20,254,284,
Garfield,Superintendent of Public Instruction,John Cox,DEM,240104,5,16,151,172,
Garfield,Superintendent of Public Instruction,Joy Hofmeister,REP,240104,10,15,207,232,
Garfield,Commissioner of Labor,Mike Workman,DEM,240104,8,15,142,165,
Garfield,Commissioner of Labor,Mark Costello,REP,240104,7,16,213,236,
Garfield,U.S. Senate,Matt Silverstein,DEM,240104,5,12,112,129,
Garfield,U.S. Senate,Jim Inhofe,REP,240104,10,19,227,256,
Garfield,U.S. Senate,Aaron Delozier,IND,240104,0,0,3,3,
Garfield,U.S. Senate,Ray Woods,IND,240104,0,0,9,9,
Garfield,U.S. Senate,Joan Farr,IND,240104,1,0,7,8,
Garfield,U.S. Senate,Connie Johnson,DEM,240104,6,10,116,132,
Garfield,U.S. Senate,James Lankford,REP,240104,8,21,231,260,
Garfield,U.S. Senate,Mark Beard,IND,240104,1,0,12,13,
Garfield,U.S. House,Frankie Robbins,DEM,240104,6,11,108,125,03
Garfield,U.S. House,Frank Lucas,REP,240104,10,20,250,280,03
Garfield,State House,Pierce Jones,DEM,240104,8,13,125,146,40
Garfield,State House,Chad Caldwell,REP,240104,7,17,231,255,40
Garfield,Governor,Joe Dorman,DEM,240105,3,6,129,138,
Garfield,Governor,Mary Fallin,REP,240105,3,12,143,158,
Garfield,Governor,Kimberly Willis,IND,240105,0,1,14,15,
Garfield,Governor,Richard Prawdzienski,IND,240105,0,0,7,7,
Garfield,Lieutenant Governor,Cathy Cummings,DEM,240105,2,4,63,69,
Garfield,Lieutenant Governor,Todd Lamb,REP,240105,4,15,228,247,
Garfield,Superintendent of Public Instruction,John Cox,DEM,240105,3,7,106,116,
Garfield,Superintendent of Public Instruction,Joy Hofmeister,REP,240105,3,12,184,199,
Garfield,Commissioner of Labor,Mike Workman,DEM,240105,3,3,99,105,
Garfield,Commissioner of Labor,Mark Costello,REP,240105,3,15,190,208,
Garfield,U.S. Senate,Matt Silverstein,DEM,240105,2,3,63,68,
Garfield,U.S. Senate,Jim Inhofe,REP,240105,4,15,216,235,
Garfield,U.S. Senate,Aaron Delozier,IND,240105,0,0,5,5,
Garfield,U.S. Senate,Ray Woods,IND,240105,0,0,5,5,
Garfield,U.S. Senate,Joan Farr,IND,240105,0,1,2,3,
Garfield,U.S. Senate,Connie Johnson,DEM,240105,2,4,69,75,
Garfield,U.S. Senate,James Lankford,REP,240105,4,14,211,229,
Garfield,U.S. Senate,Mark Beard,IND,240105,0,1,13,14,
Garfield,U.S. House,Frankie Robbins,DEM,240105,2,4,70,76,03
Garfield,U.S. House,Frank Lucas,REP,240105,4,15,221,240,03
Garfield,Governor,Joe Dorman,DEM,240106,0,6,105,111,
Garfield,Governor,Mary Fallin,REP,240106,1,3,170,174,
Garfield,Governor,Kimberly Willis,IND,240106,0,0,7,7,
Garfield,Governor,Richard Prawdzienski,IND,240106,0,0,1,1,
Garfield,Lieutenant Governor,Cathy Cummings,DEM,240106,0,3,33,36,
Garfield,Lieutenant Governor,Todd Lamb,REP,240106,1,6,249,256,
Garfield,Superintendent of Public Instruction,John Cox,DEM,240106,0,5,101,106,
Garfield,Superintendent of Public Instruction,Joy Hofmeister,REP,240106,1,4,183,188,
Garfield,Commissioner of Labor,Mike Workman,DEM,240106,0,5,72,77,
Garfield,Commissioner of Labor,Mark Costello,REP,240106,1,4,206,211,
Garfield,U.S. Senate,Matt Silverstein,DEM,240106,0,4,39,43,
Garfield,U.S. Senate,Jim Inhofe,REP,240106,1,5,232,238,
Garfield,U.S. Senate,Aaron Delozier,IND,240106,0,0,2,2,
Garfield,U.S. Senate,Ray Woods,IND,240106,0,0,6,6,
Garfield,U.S. Senate,Joan Farr,IND,240106,0,0,4,4,
Garfield,U.S. Senate,Connie Johnson,DEM,240106,0,2,30,32,
Garfield,U.S. Senate,James Lankford,REP,240106,1,7,246,254,
Garfield,U.S. Senate,Mark Beard,IND,240106,0,0,8,8,
Garfield,U.S. House,Frankie Robbins,DEM,240106,0,3,37,40,03
Garfield,U.S. House,Frank Lucas,REP,240106,1,6,247,254,03
Garfield,Governor,Joe Dorman,DEM,240107,0,1,20,21,
Garfield,Governor,Mary Fallin,REP,240107,1,5,36,42,
Garfield,Governor,Kimberly Willis,IND,240107,0,0,0,0,
Garfield,Governor,Richard Prawdzienski,IND,240107,0,0,1,1,
Garfield,Lieutenant Governor,Cathy Cummings,DEM,240107,0,1,10,11,
Garfield,Lieutenant Governor,Todd Lamb,REP,240107,1,5,47,53,
Garfield,Superintendent of Public Instruction,John Cox,DEM,240107,0,4,22,26,
Garfield,Superintendent of Public Instruction,Joy Hofmeister,REP,240107,1,2,35,38,
Garfield,Commissioner of Labor,Mike Workman,DEM,240107,0,1,11,12,
Garfield,Commissioner of Labor,Mark Costello,REP,240107,1,5,45,51,
Garfield,U.S. Senate,Matt Silverstein,DEM,240107,0,2,7,9,
Garfield,U.S. Senate,Jim Inhofe,REP,240107,1,4,46,51,
Garfield,U.S. Senate,Aaron Delozier,IND,240107,0,0,2,2,
Garfield,U.S. Senate,Ray Woods,IND,240107,0,0,1,1,
Garfield,U.S. Senate,Joan Farr,IND,240107,0,0,1,1,
Garfield,U.S. Senate,Connie Johnson,DEM,240107,0,1,9,10,
Garfield,U.S. Senate,James Lankford,REP,240107,1,5,47,53,
Garfield,U.S. Senate,Mark Beard,IND,240107,0,0,2,2,
Garfield,U.S. House,Frankie Robbins,DEM,240107,0,2,11,13,03
Garfield,U.S. House,Frank Lucas,REP,240107,1,4,47,52,03
Garfield,Governor,Joe Dorman,DEM,240108,0,2,23,25,
Garfield,Governor,Mary Fallin,REP,240108,0,1,28,29,
Garfield,Governor,Kimberly Willis,IND,240108,0,0,2,2,
Garfield,Governor,Richard Prawdzienski,IND,240108,0,0,0,0,
Garfield,Lieutenant Governor,Cathy Cummings,DEM,240108,0,1,5,6,
Garfield,Lieutenant Governor,Todd Lamb,REP,240108,0,2,48,50,
Garfield,Superintendent of Public Instruction,John Cox,DEM,240108,0,2,18,20,
Garfield,Superintendent of Public Instruction,Joy Hofmeister,REP,240108,0,1,35,36,
Garfield,Commissioner of Labor,Mike Workman,DEM,240108,0,1,10,11,
Garfield,Commissioner of Labor,Mark Costello,REP,240108,0,2,41,43,
Garfield,U.S. Senate,Matt Silverstein,DEM,240108,0,1,5,6,
Garfield,U.S. Senate,Jim Inhofe,REP,240108,0,2,45,47,
Garfield,U.S. Senate,Aaron Delozier,IND,240108,0,0,0,0,
Garfield,U.S. Senate,Ray Woods,IND,240108,0,0,2,2,
Garfield,U.S. Senate,Joan Farr,IND,240108,0,0,1,1,
Garfield,U.S. Senate,Connie Johnson,DEM,240108,0,1,6,7,
Garfield,U.S. Senate,James Lankford,REP,240108,0,2,45,47,
Garfield,U.S. Senate,Mark Beard,IND,240108,0,0,2,2,
Garfield,U.S. House,Frankie Robbins,DEM,240108,0,1,9,10,03
Garfield,U.S. House,Frank Lucas,REP,240108,0,2,44,46,03
Garfield,Governor,Joe Dorman,DEM,240109,1,2,54,57,
Garfield,Governor,Mary Fallin,REP,240109,2,4,99,105,
Garfield,Governor,Kimberly Willis,IND,240109,0,0,4,4,
Garfield,Governor,Richard Prawdzienski,IND,240109,0,0,4,4,
Garfield,Lieutenant Governor,Cathy Cummings,DEM,240109,0,2,17,19,
Garfield,Lieutenant Governor,Todd Lamb,REP,240109,3,4,144,151,
Garfield,Superintendent of Public Instruction,John Cox,DEM,240109,1,2,55,58,
Garfield,Superintendent of Public Instruction,Joy Hofmeister,REP,240109,2,4,106,112,
Garfield,Commissioner of Labor,Mike Workman,DEM,240109,0,2,32,34,
Garfield,Commissioner of Labor,Mark Costello,REP,240109,3,4,124,131,
Garfield,U.S. Senate,Matt Silverstein,DEM,240109,0,2,15,17,
Garfield,U.S. Senate,Jim Inhofe,REP,240109,3,4,138,145,
Garfield,U.S. Senate,Aaron Delozier,IND,240109,0,0,1,1,
Garfield,U.S. Senate,Ray Woods,IND,240109,0,0,3,3,
Garfield,U.S. Senate,Joan Farr,IND,240109,0,0,3,3,
Garfield,U.S. Senate,Connie Johnson,DEM,240109,0,2,18,20,
Garfield,U.S. Senate,James Lankford,REP,240109,3,4,138,145,
Garfield,U.S. Senate,Mark Beard,IND,240109,0,0,5,5,
Garfield,U.S. House,Frankie Robbins,DEM,240109,0,2,20,22,03
Garfield,U.S. House,Frank Lucas,REP,240109,3,4,140,147,03
Garfield,Governor,Joe Dorman,DEM,240110,3,22,160,185,
Garfield,Governor,Mary Fallin,REP,240110,5,18,168,191,
Garfield,Governor,Kimberly Willis,IND,240110,0,0,9,9,
Garfield,Governor,Richard Prawdzienski,IND,240110,0,0,4,4,
Garfield,Lieutenant Governor,Cathy Cummings,DEM,240110,2,12,67,81,
Garfield,Lieutenant Governor,Todd Lamb,REP,240110,6,28,273,307,
Garfield,Superintendent of Public Instruction,John Cox,DEM,240110,3,19,134,156,
Garfield,Superintendent of Public Instruction,Joy Hofmeister,REP,240110,5,21,207,233,
Garfield,Commissioner of Labor,Mike Workman,DEM,240110,2,13,100,115,
Garfield,Commissioner of Labor,Mark Costello,REP,240110,6,26,235,267,
Garfield,U.S. Senate,Matt Silverstein,DEM,240110,3,13,67,83,
Garfield,U.S. Senate,Jim Inhofe,REP,240110,5,27,265,297,
Garfield,U.S. Senate,Aaron Delozier,IND,240110,0,0,3,3,
Garfield,U.S. Senate,Ray Woods,IND,240110,0,0,2,2,
Garfield,U.S. Senate,Joan Farr,IND,240110,0,0,3,3,
Garfield,U.S. Senate,Connie Johnson,DEM,240110,2,13,60,75,
Garfield,U.S. Senate,James Lankford,REP,240110,6,25,271,302,
Garfield,U.S. Senate,Mark Beard,IND,240110,0,2,10,12,
Garfield,U.S. House,Frankie Robbins,DEM,240110,3,12,69,84,03
Garfield,U.S. House,Frank Lucas,REP,240110,5,28,271,304,03
Garfield,Governor,Joe Dorman,DEM,240201,9,42,304,355,
Garfield,Governor,Mary Fallin,REP,240201,16,23,397,436,
Garfield,Governor,Kimberly Willis,IND,240201,0,2,16,18,
Garfield,Governor,Richard Prawdzienski,IND,240201,2,0,12,14,
Garfield,Lieutenant Governor,Cathy Cummings,DEM,240201,6,27,142,175,
Garfield,Lieutenant Governor,Todd Lamb,REP,240201,21,41,591,653,
Garfield,Superintendent of Public Instruction,John Cox,DEM,240201,9,34,257,300,
Garfield,Superintendent of Public Instruction,Joy Hofmeister,REP,240201,18,32,471,521,
Garfield,Commissioner of Labor,Mike Workman,DEM,240201,6,28,198,232,
Garfield,Commissioner of Labor,Mark Costello,REP,240201,21,37,525,583,
Garfield,U.S. Senate,Matt Silverstein,DEM,240201,8,27,155,190,
Garfield,U.S. Senate,Jim Inhofe,REP,240201,19,38,536,593,
Garfield,U.S. Senate,Aaron Delozier,IND,240201,0,0,10,10,
Garfield,U.S. Senate,Ray Woods,IND,240201,0,0,16,16,
Garfield,U.S. Senate,Joan Farr,IND,240201,0,2,10,12,
Garfield,U.S. Senate,Connie Johnson,DEM,240201,8,27,161,196,
Garfield,U.S. Senate,James Lankford,REP,240201,19,40,549,608,
Garfield,U.S. Senate,Mark Beard,IND,240201,0,1,20,21,
Garfield,U.S. House,Frankie Robbins,DEM,240201,6,26,156,188,03
Garfield,U.S. House,Frank Lucas,REP,240201,21,42,574,637,03
Garfield,State House,Pierce Jones,DEM,240201,9,25,157,191,40
Garfield,State House,Chad Caldwell,REP,240201,18,42,570,630,40
Garfield,Governor,Joe Dorman,DEM,240202,12,18,273,303,
Garfield,Governor,Mary Fallin,REP,240202,27,32,384,443,
Garfield,Governor,Kimberly Willis,IND,240202,1,0,17,18,
Garfield,Governor,Richard Prawdzienski,IND,240202,2,0,11,13,
Garfield,Lieutenant Governor,Cathy Cummings,DEM,240202,11,8,136,155,
Garfield,Lieutenant Governor,Todd Lamb,REP,240202,31,42,549,622,
Garfield,Superintendent of Public Instruction,John Cox,DEM,240202,14,7,237,258,
Garfield,Superintendent of Public Instruction,Joy Hofmeister,REP,240202,28,42,441,511,
Garfield,Commissioner of Labor,Mike Workman,DEM,240202,13,5,173,191,
Garfield,Commissioner of Labor,Mark Costello,REP,240202,28,42,495,565,
Garfield,U.S. Senate,Matt Silverstein,DEM,240202,11,5,133,149,
Garfield,U.S. Senate,Jim Inhofe,REP,240202,30,41,523,594,
Garfield,U.S. Senate,Aaron Delozier,IND,240202,1,0,6,7,
Garfield,U.S. Senate,Ray Woods,IND,240202,0,0,12,12,
Garfield,U.S. Senate,Joan Farr,IND,240202,0,2,11,13,
Garfield,U.S. Senate,Connie Johnson,DEM,240202,11,7,136,154,
Garfield,U.S. Senate,James Lankford,REP,240202,31,41,527,599,
Garfield,U.S. Senate,Mark Beard,IND,240202,0,1,21,22,
Garfield,U.S. House,Frankie Robbins,DEM,240202,11,5,142,158,03
Garfield,U.S. House,Frank Lucas,REP,240202,31,45,543,619,03
Garfield,State House,Pierce Jones,DEM,240202,12,7,147,166,40
Garfield,State House,Chad Caldwell,REP,240202,30,42,537,609,40
Garfield,Governor,Joe Dorman,DEM,240203,4,6,106,116,
Garfield,Governor,Mary Fallin,REP,240203,7,10,144,161,
Garfield,Governor,Kimberly Willis,IND,240203,0,0,15,15,
Garfield,Governor,Richard Prawdzienski,IND,240203,0,0,10,10,
Garfield,Lieutenant Governor,Cathy Cummings,DEM,240203,4,4,63,71,
Garfield,Lieutenant Governor,Todd Lamb,REP,240203,7,12,215,234,
Garfield,Superintendent of Public Instruction,John Cox,DEM,240203,6,4,101,111,
Garfield,Superintendent of Public Instruction,Joy Hofmeister,REP,240203,5,12,174,191,
Garfield,Commissioner of Labor,Mike Workman,DEM,240203,4,6,101,111,
Garfield,Commissioner of Labor,Mark Costello,REP,240203,7,10,171,188,
Garfield,U.S. Senate,Matt Silverstein,DEM,240203,4,5,67,76,
Garfield,U.S. Senate,Jim Inhofe,REP,240203,7,11,184,202,
Garfield,U.S. Senate,Aaron Delozier,IND,240203,0,0,7,7,
Garfield,U.S. Senate,Ray Woods,IND,240203,0,0,11,11,
Garfield,U.S. Senate,Joan Farr,IND,240203,0,0,8,8,
Garfield,U.S. Senate,Connie Johnson,DEM,240203,4,4,76,84,
Garfield,U.S. Senate,James Lankford,REP,240203,7,11,194,212,
Garfield,U.S. Senate,Mark Beard,IND,240203,0,1,9,10,
Garfield,U.S. House,Frankie Robbins,DEM,240203,6,3,72,81,03
Garfield,U.S. House,Frank Lucas,REP,240203,5,13,206,224,03
Garfield,State House,Pierce Jones,DEM,240203,5,5,89,99,40
Garfield,State House,Chad Caldwell,REP,240203,6,11,188,205,40
Garfield,Governor,Joe Dorman,DEM,240204,6,25,316,347,
Garfield,Governor,Mary Fallin,REP,240204,17,44,455,516,
Garfield,Governor,Kimberly Willis,IND,240204,1,0,21,22,
Garfield,Governor,Richard Prawdzienski,IND,240204,0,1,7,8,
Garfield,Lieutenant Governor,Cathy Cummings,DEM,240204,4,13,153,170,
Garfield,Lieutenant Governor,Todd Lamb,REP,240204,20,58,648,726,
Garfield,Superintendent of Public Instruction,John Cox,DEM,240204,8,24,268,300,
Garfield,Superintendent of Public Instruction,Joy Hofmeister,REP,240204,14,45,533,592,
Garfield,Commissioner of Labor,Mike Workman,DEM,240204,7,15,203,225,
Garfield,Commissioner of Labor,Mark Costello,REP,240204,17,54,580,651,
Garfield,U.S. Senate,Matt Silverstein,DEM,240204,4,14,146,164,
Garfield,U.S. Senate,Jim Inhofe,REP,240204,18,55,629,702,
Garfield,U.S. Senate,Aaron Delozier,IND,240204,0,0,7,7,
Garfield,U.S. Senate,Ray Woods,IND,240204,0,2,16,18,
Garfield,U.S. Senate,Joan Farr,IND,240204,1,0,3,4,
Garfield,U.S. Senate,Connie Johnson,DEM,240204,4,13,163,180,
Garfield,U.S. Senate,James Lankford,REP,240204,18,57,613,688,
Garfield,U.S. Senate,Mark Beard,IND,240204,1,1,24,26,
Garfield,U.S. House,Frankie Robbins,DEM,240204,6,12,161,179,03
Garfield,U.S. House,Frank Lucas,REP,240204,18,58,637,713,03
Garfield,State House,Pierce Jones,DEM,240204,4,15,168,187,40
Garfield,State House,Chad Caldwell,REP,240204,20,56,628,704,40
Garfield,Governor,Joe Dorman,DEM,240206,6,6,161,173,
Garfield,Governor,Mary Fallin,REP,240206,2,10,195,207,
Garfield,Governor,Kimberly Willis,IND,240206,0,0,23,23,
Garfield,Governor,Richard Prawdzienski,IND,240206,0,0,7,7,
Garfield,Lieutenant Governor,Cathy Cummings,DEM,240206,4,2,83,89,
Garfield,Lieutenant Governor,Todd Lamb,REP,240206,4,14,304,322,
Garfield,Superintendent of Public Instruction,John Cox,DEM,240206,4,2,134,140,
Garfield,Superintendent of Public Instruction,Joy Hofmeister,REP,240206,4,14,251,269,
Garfield,Commissioner of Labor,Mike Workman,DEM,240206,4,4,109,117,
Garfield,Commissioner of Labor,Mark Costello,REP,240206,4,12,269,285,
Garfield,U.S. Senate,Matt Silverstein,DEM,240206,2,1,85,88,
Garfield,U.S. Senate,Jim Inhofe,REP,240206,5,13,282,300,
Garfield,U.S. Senate,Aaron Delozier,IND,240206,1,0,7,8,
Garfield,U.S. Senate,Ray Woods,IND,240206,0,2,6,8,
Garfield,U.S. Senate,Joan Farr,IND,240206,0,0,4,4,
Garfield,U.S. Senate,Connie Johnson,DEM,240206,2,2,82,86,
Garfield,U.S. Senate,James Lankford,REP,240206,6,13,284,303,
Garfield,U.S. Senate,Mark Beard,IND,240206,0,1,19,20,
Garfield,U.S. House,Frankie Robbins,DEM,240206,3,2,91,96,03
Garfield,U.S. House,Frank Lucas,REP,240206,5,14,294,313,03
Garfield,State House,Pierce Jones,DEM,240206,3,3,99,105,40
Garfield,State House,Chad Caldwell,REP,240206,5,13,285,303,40
Garfield,Governor,Joe Dorman,DEM,240207,3,4,122,129,
Garfield,Governor,Mary Fallin,REP,240207,4,5,219,228,
Garfield,Governor,Kimberly Willis,IND,240207,0,0,12,12,
Garfield,Governor,Richard Prawdzienski,IND,240207,0,0,11,11,
Garfield,Lieutenant Governor,Cathy Cummings,DEM,240207,1,3,60,64,
Garfield,Lieutenant Governor,Todd Lamb,REP,240207,6,6,302,314,
Garfield,Superintendent of Public Instruction,John Cox,DEM,240207,2,5,109,116,
Garfield,Superintendent of Public Instruction,Joy Hofmeister,REP,240207,5,4,256,265,
Garfield,Commissioner of Labor,Mike Workman,DEM,240207,2,5,87,94,
Garfield,Commissioner of Labor,Mark Costello,REP,240207,5,4,273,282,
Garfield,U.S. Senate,Matt Silverstein,DEM,240207,1,4,58,63,
Garfield,U.S. Senate,Jim Inhofe,REP,240207,5,5,291,301,
Garfield,U.S. Senate,Aaron Delozier,IND,240207,1,0,5,6,
Garfield,U.S. Senate,Ray Woods,IND,240207,0,0,6,6,
Garfield,U.S. Senate,Joan Farr,IND,240207,0,0,4,4,
Garfield,U.S. Senate,Connie Johnson,DEM,240207,1,3,57,61,
Garfield,U.S. Senate,James Lankford,REP,240207,5,6,299,310,
Garfield,U.S. Senate,Mark Beard,IND,240207,0,0,9,9,
Garfield,U.S. House,Frankie Robbins,DEM,240207,2,3,63,68,03
Garfield,U.S. House,Frank Lucas,REP,240207,4,6,302,312,03
Garfield,State House,Pierce Jones,DEM,240207,2,3,69,74,40
Garfield,State House,Chad Caldwell,REP,240207,5,6,294,305,40
Garfield,Governor,Joe Dorman,DEM,240208,0,0,20,20,
Garfield,Governor,Mary Fallin,REP,240208,1,5,57,63,
Garfield,Governor,Kimberly Willis,IND,240208,0,0,3,3,
Garfield,Governor,Richard Prawdzienski,IND,240208,0,0,2,2,
Garfield,Lieutenant Governor,Cathy Cummings,DEM,240208,0,0,11,11,
Garfield,Lieutenant Governor,Todd Lamb,REP,240208,1,5,72,78,
Garfield,Superintendent of Public Instruction,John Cox,DEM,240208,0,0,27,27,
Garfield,Superintendent of Public Instruction,Joy Hofmeister,REP,240208,1,5,56,62,
Garfield,Commissioner of Labor,Mike Workman,DEM,240208,0,0,12,12,
Garfield,Commissioner of Labor,Mark Costello,REP,240208,0,5,70,75,
Garfield,U.S. Senate,Matt Silverstein,DEM,240208,0,0,9,9,
Garfield,U.S. Senate,Jim Inhofe,REP,240208,1,5,67,73,
Garfield,U.S. Senate,Aaron Delozier,IND,240208,0,0,2,2,
Garfield,U.S. Senate,Ray Woods,IND,240208,0,0,3,3,
Garfield,U.S. Senate,Joan Farr,IND,240208,0,0,0,0,
Garfield,U.S. Senate,Connie Johnson,DEM,240208,0,0,10,10,
Garfield,U.S. Senate,James Lankford,REP,240208,0,5,71,76,
Garfield,U.S. Senate,Mark Beard,IND,240208,0,0,1,1,
Garfield,U.S. House,Frankie Robbins,DEM,240208,0,1,9,10,03
Garfield,U.S. House,Frank Lucas,REP,240208,1,4,73,78,03
Garfield,Governor,Joe Dorman,DEM,240210,0,2,108,110,
Garfield,Governor,Mary Fallin,REP,240210,1,4,110,115,
Garfield,Governor,Kimberly Willis,IND,240210,0,0,8,8,
Garfield,Governor,Richard Prawdzienski,IND,240210,0,0,7,7,
Garfield,Lieutenant Governor,Cathy Cummings,DEM,240210,1,0,46,47,
Garfield,Lieutenant Governor,Todd Lamb,REP,240210,0,6,187,193,
Garfield,Superintendent of Public Instruction,John Cox,DEM,240210,0,1,107,108,
Garfield,Superintendent of Public Instruction,Joy Hofmeister,REP,240210,1,5,127,133,
Garfield,Commissioner of Labor,Mike Workman,DEM,240210,0,1,69,70,
Garfield,Commissioner of Labor,Mark Costello,REP,240210,1,5,162,168,
Garfield,U.S. Senate,Matt Silverstein,DEM,240210,0,0,41,41,
Garfield,U.S. Senate,Jim Inhofe,REP,240210,1,5,182,188,
Garfield,U.S. Senate,Aaron Delozier,IND,240210,0,1,3,4,
Garfield,U.S. Senate,Ray Woods,IND,240210,0,0,7,7,
Garfield,U.S. Senate,Joan Farr,IND,240210,0,0,2,2,
Garfield,U.S. Senate,Connie Johnson,DEM,240210,0,0,42,42,
Garfield,U.S. Senate,James Lankford,REP,240210,1,4,184,189,
Garfield,U.S. Senate,Mark Beard,IND,240210,0,2,8,10,
Garfield,U.S. House,Frankie Robbins,DEM,240210,0,1,46,47,03
Garfield,U.S. House,Frank Lucas,REP,240210,1,5,185,191,03
Garfield,Governor,Joe Dorman,DEM,240211,6,1,121,128,
Garfield,Governor,Mary Fallin,REP,240211,0,13,231,244,
Garfield,Governor,Kimberly Willis,IND,240211,0,0,9,9,
Garfield,Governor,Richard Prawdzienski,IND,240211,0,1,0,1,
Garfield,Lieutenant Governor,Cathy Cummings,DEM,240211,1,2,41,44,
Garfield,Lieutenant Governor,Todd Lamb,REP,240211,5,13,320,338,
Garfield,Superintendent of Public Instruction,John Cox,DEM,240211,3,2,126,131,
Garfield,Superintendent of Public Instruction,Joy Hofmeister,REP,240211,3,13,234,250,
Garfield,Commissioner of Labor,Mike Workman,DEM,240211,2,2,66,70,
Garfield,Commissioner of Labor,Mark Costello,REP,240211,4,13,287,304,
Garfield,U.S. Senate,Matt Silverstein,DEM,240211,1,1,45,47,
Garfield,U.S. Senate,Jim Inhofe,REP,240211,5,13,307,325,
Garfield,U.S. Senate,Aaron Delozier,IND,240211,0,0,1,1,
Garfield,U.S. Senate,Ray Woods,IND,240211,0,1,4,5,
Garfield,U.S. Senate,Joan Farr,IND,240211,0,0,3,3,
Garfield,U.S. Senate,Connie Johnson,DEM,240211,0,1,52,53,
Garfield,U.S. Senate,James Lankford,REP,240211,6,13,304,323,
Garfield,U.S. Senate,Mark Beard,IND,240211,0,1,4,5,
Garfield,U.S. House,Frankie Robbins,DEM,240211,1,2,45,48,03
Garfield,U.S. House,Frank Lucas,REP,240211,5,13,314,332,03
Garfield,Governor,Joe Dorman,DEM,240212,1,4,65,70,
Garfield,Governor,Mary Fallin,REP,240212,5,6,158,169,
Garfield,Governor,Kimberly Willis,IND,240212,0,0,5,5,
Garfield,Governor,Richard Prawdzienski,IND,240212,0,0,5,5,
Garfield,Lieutenant Governor,Cathy Cummings,DEM,240212,0,3,28,31,
Garfield,Lieutenant Governor,Todd Lamb,REP,240212,6,7,206,219,
Garfield,Superintendent of Public Instruction,John Cox,DEM,240212,2,5,83,90,
Garfield,Superintendent of Public Instruction,Joy Hofmeister,REP,240212,4,5,151,160,
Garfield,Commissioner of Labor,Mike Workman,DEM,240212,1,3,47,51,
Garfield,Commissioner of Labor,Mark Costello,REP,240212,5,7,184,196,
Garfield,U.S. Senate,Matt Silverstein,DEM,240212,2,3,21,26,
Garfield,U.S. Senate,Jim Inhofe,REP,240212,4,7,200,211,
Garfield,U.S. Senate,Aaron Delozier,IND,240212,0,0,6,6,
Garfield,U.S. Senate,Ray Woods,IND,240212,0,0,4,4,
Garfield,U.S. Senate,Joan Farr,IND,240212,0,0,3,3,
Garfield,U.S. Senate,Connie Johnson,DEM,240212,2,3,25,30,
Garfield,U.S. Senate,James Lankford,REP,240212,4,7,200,211,
Garfield,U.S. Senate,Mark Beard,IND,240212,0,0,9,9,
Garfield,U.S. House,Frankie Robbins,DEM,240212,0,3,37,40,03
Garfield,U.S. House,Frank Lucas,REP,240212,6,7,196,209,03
Garfield,Governor,Joe Dorman,DEM,240301,6,17,133,156,
Garfield,Governor,Mary Fallin,REP,240301,5,17,216,238,
Garfield,Governor,Kimberly Willis,IND,240301,0,0,12,12,
Garfield,Governor,Richard Prawdzienski,IND,240301,0,0,5,5,
Garfield,Lieutenant Governor,Cathy Cummings,DEM,240301,1,10,60,71,
Garfield,Lieutenant Governor,Todd Lamb,REP,240301,11,24,307,342,
Garfield,Superintendent of Public Instruction,John Cox,DEM,240301,2,13,110,125,
Garfield,Superintendent of Public Instruction,Joy Hofmeister,REP,240301,10,21,255,286,
Garfield,Commissioner of Labor,Mike Workman,DEM,240301,1,11,74,86,
Garfield,Commissioner of Labor,Mark Costello,REP,240301,10,23,281,314,
Garfield,U.S. Senate,Matt Silverstein,DEM,240301,1,11,62,74,
Garfield,U.S. Senate,Jim Inhofe,REP,240301,11,23,294,328,
Garfield,U.S. Senate,Aaron Delozier,IND,240301,0,0,1,1,
Garfield,U.S. Senate,Ray Woods,IND,240301,0,0,4,4,
Garfield,U.S. Senate,Joan Farr,IND,240301,0,0,4,4,
Garfield,U.S. Senate,Connie Johnson,DEM,240301,1,10,64,75,
Garfield,U.S. Senate,James Lankford,REP,240301,11,22,289,322,
Garfield,U.S. Senate,Mark Beard,IND,240301,0,1,12,13,
Garfield,U.S. House,Frankie Robbins,DEM,240301,1,9,63,73,03
Garfield,U.S. House,Frank Lucas,REP,240301,11,25,301,337,03
Garfield,State House,Pierce Jones,DEM,240301,1,10,68,79,40
Garfield,State House,Chad Caldwell,REP,240301,11,23,296,330,40
Garfield,Governor,Joe Dorman,DEM,240302,2,27,387,416,
Garfield,Governor,Mary Fallin,REP,240302,17,70,502,589,
Garfield,Governor,Kimberly Willis,IND,240302,2,1,19,22,
Garfield,Governor,Richard Prawdzienski,IND,240302,0,1,15,16,
Garfield,Lieutenant Governor,Cathy Cummings,DEM,240302,3,14,156,173,
Garfield,Lieutenant Governor,Todd Lamb,REP,240302,18,86,771,875,
Garfield,Superintendent of Public Instruction,John Cox,DEM,240302,6,23,296,325,
Garfield,Superintendent of Public Instruction,Joy Hofmeister,REP,240302,14,77,627,718,
Garfield,Commissioner of Labor,Mike Workman,DEM,240302,3,14,240,257,
Garfield,Commissioner of Labor,Mark Costello,REP,240302,16,85,670,771,
Garfield,U.S. Senate,Matt Silverstein,DEM,240302,2,11,173,186,
Garfield,U.S. Senate,Jim Inhofe,REP,240302,19,88,726,833,
Garfield,U.S. Senate,Aaron Delozier,IND,240302,0,0,6,6,
Garfield,U.S. Senate,Ray Woods,IND,240302,0,0,13,13,
Garfield,U.S. Senate,Joan Farr,IND,240302,0,1,8,9,
Garfield,U.S. Senate,Connie Johnson,DEM,240302,3,13,176,192,
Garfield,U.S. Senate,James Lankford,REP,240302,18,84,733,835,
Garfield,U.S. Senate,Mark Beard,IND,240302,0,3,18,21,
Garfield,U.S. House,Frankie Robbins,DEM,240302,3,13,177,193,03
Garfield,U.S. House,Frank Lucas,REP,240302,18,86,747,851,03
Garfield,Governor,Joe Dorman,DEM,240304,7,25,300,332,
Garfield,Governor,Mary Fallin,REP,240304,22,64,485,571,
Garfield,Governor,Kimberly Willis,IND,240304,0,0,25,25,
Garfield,Governor,Richard Prawdzienski,IND,240304,1,0,11,12,
Garfield,Lieutenant Governor,Cathy Cummings,DEM,240304,4,10,115,129,
Garfield,Lieutenant Governor,Todd Lamb,REP,240304,26,79,710,815,
Garfield,Superintendent of Public Instruction,John Cox,DEM,240304,9,16,255,280,
Garfield,Superintendent of Public Instruction,Joy Hofmeister,REP,240304,21,73,567,661,
Garfield,Commissioner of Labor,Mike Workman,DEM,240304,3,11,162,176,
Garfield,Commissioner of Labor,Mark Costello,REP,240304,26,77,651,754,
Garfield,U.S. Senate,Matt Silverstein,DEM,240304,3,8,117,128,
Garfield,U.S. Senate,Jim Inhofe,REP,240304,26,78,680,784,
Garfield,U.S. Senate,Aaron Delozier,IND,240304,1,0,9,10,
Garfield,U.S. Senate,Ray Woods,IND,240304,0,2,15,17,
Garfield,U.S. Senate,Joan Farr,IND,240304,0,0,4,4,
Garfield,U.S. Senate,Connie Johnson,DEM,240304,4,9,116,129,
Garfield,U.S. Senate,James Lankford,REP,240304,26,80,688,794,
Garfield,U.S. Senate,Mark Beard,IND,240304,0,0,16,16,
Garfield,U.S. House,Frankie Robbins,DEM,240304,2,8,124,134,03
Garfield,U.S. House,Frank Lucas,REP,240304,28,79,697,804,03
Garfield,Governor,Joe Dorman,DEM,240305,8,41,245,294,
Garfield,Governor,Mary Fallin,REP,240305,29,78,455,562,
Garfield,Governor,Kimberly Willis,IND,240305,1,0,15,16,
Garfield,Governor,Richard Prawdzienski,IND,240305,0,1,12,13,
Garfield,Lieutenant Governor,Cathy Cummings,DEM,240305,4,17,82,103,
Garfield,Lieutenant Governor,Todd Lamb,REP,240305,32,104,650,786,
Garfield,Superintendent of Public Instruction,John Cox,DEM,240305,5,34,191,230,
Garfield,Superintendent of Public Instruction,Joy Hofmeister,REP,240305,32,87,540,659,
Garfield,Commissioner of Labor,Mike Workman,DEM,240305,3,23,129,155,
Garfield,Commissioner of Labor,Mark Costello,REP,240305,34,95,588,717,
Garfield,U.S. Senate,Matt Silverstein,DEM,240305,7,19,99,125,
Garfield,U.S. Senate,Jim Inhofe,REP,240305,31,96,605,732,
Garfield,U.S. Senate,Aaron Delozier,IND,240305,0,0,6,6,
Garfield,U.S. Senate,Ray Woods,IND,240305,0,0,9,9,
Garfield,U.S. Senate,Joan Farr,IND,240305,0,5,7,12,
Garfield,U.S. Senate,Connie Johnson,DEM,240305,3,16,96,115,
Garfield,U.S. Senate,James Lankford,REP,240305,35,103,622,760,
Garfield,U.S. Senate,Mark Beard,IND,240305,0,2,14,16,
Garfield,U.S. House,Frankie Robbins,DEM,240305,4,20,93,117,03
Garfield,U.S. House,Frank Lucas,REP,240305,34,101,638,773,03
Garfield,State House,Pierce Jones,DEM,240305,4,22,103,129,40
Garfield,State House,Chad Caldwell,REP,240305,34,97,630,761,40
Garfield,Governor,Joe Dorman,DEM,240306,9,12,142,163,
Garfield,Governor,Mary Fallin,REP,240306,7,20,231,258,
Garfield,Governor,Kimberly Willis,IND,240306,0,0,10,10,
Garfield,Governor,Richard Prawdzienski,IND,240306,0,0,10,10,
Garfield,Lieutenant Governor,Cathy Cummings,DEM,240306,6,6,70,82,
Garfield,Lieutenant Governor,Todd Lamb,REP,240306,10,28,327,365,
Garfield,Superintendent of Public Instruction,John Cox,DEM,240306,8,9,135,152,
Garfield,Superintendent of Public Instruction,Joy Hofmeister,REP,240306,8,25,260,293,
Garfield,Commissioner of Labor,Mike Workman,DEM,240306,6,10,97,113,
Garfield,Commissioner of Labor,Mark Costello,REP,240306,10,23,287,320,
Garfield,U.S. Senate,Matt Silverstein,DEM,240306,6,4,69,79,
Garfield,U.S. Senate,Jim Inhofe,REP,240306,9,28,310,347,
Garfield,U.S. Senate,Aaron Delozier,IND,240306,1,0,5,6,
Garfield,U.S. Senate,Ray Woods,IND,240306,0,1,5,6,
Garfield,U.S. Senate,Joan Farr,IND,240306,0,0,4,4,
Garfield,U.S. Senate,Connie Johnson,DEM,240306,5,7,81,93,
Garfield,U.S. Senate,James Lankford,REP,240306,10,27,309,346,
Garfield,U.S. Senate,Mark Beard,IND,240306,1,0,7,8,
Garfield,U.S. House,Frankie Robbins,DEM,240306,5,4,83,92,03
Garfield,U.S. House,Frank Lucas,REP,240306,10,30,313,353,03
Garfield,State House,Pierce Jones,DEM,240306,8,8,81,97,40
Garfield,State House,Chad Caldwell,REP,240306,8,26,315,349,40
Garfield,Governor,Joe Dorman,DEM,240307,3,4,48,55,
Garfield,Governor,Mary Fallin,REP,240307,14,5,114,133,
Garfield,Governor,Kimberly Willis,IND,240307,0,0,4,4,
Garfield,Governor,Richard Prawdzienski,IND,240307,0,0,3,3,
Garfield,Lieutenant Governor,Cathy Cummings,DEM,240307,3,2,24,29,
Garfield,Lieutenant Governor,Todd Lamb,REP,240307,14,7,143,164,
Garfield,Superintendent of Public Instruction,John Cox,DEM,240307,3,3,48,54,
Garfield,Superintendent of Public Instruction,Joy Hofmeister,REP,240307,13,6,117,136,
Garfield,Commissioner of Labor,Mike Workman,DEM,240307,5,3,26,34,
Garfield,Commissioner of Labor,Mark Costello,REP,240307,9,6,139,154,
Garfield,U.S. Senate,Matt Silverstein,DEM,240307,2,3,18,23,
Garfield,U.S. Senate,Jim Inhofe,REP,240307,15,6,139,160,
Garfield,U.S. Senate,Aaron Delozier,IND,240307,0,0,2,2,
Garfield,U.S. Senate,Ray Woods,IND,240307,0,0,5,5,
Garfield,U.S. Senate,Joan Farr,IND,240307,0,0,3,3,
Garfield,U.S. Senate,Connie Johnson,DEM,240307,2,3,22,27,
Garfield,U.S. Senate,James Lankford,REP,240307,15,6,144,165,
Garfield,U.S. Senate,Mark Beard,IND,240307,0,0,4,4,
Garfield,U.S. House,Frankie Robbins,DEM,240307,2,2,22,26,03
Garfield,U.S. House,Frank Lucas,REP,240307,15,7,147,169,03
Garfield,State House,Pierce Jones,DEM,240307,2,1,24,27,40
Garfield,State House,Chad Caldwell,REP,240307,13,8,142,163,40
Garfield,Governor,Joe Dorman,DEM,240308,2,19,86,107,
Garfield,Governor,Mary Fallin,REP,240308,11,23,205,239,
Garfield,Governor,Kimberly Willis,IND,240308,0,0,2,2,
Garfield,Governor,Richard Prawdzienski,IND,240308,0,1,4,5,
Garfield,Lieutenant Governor,Cathy Cummings,DEM,240308,1,13,22,36,
Garfield,Lieutenant Governor,Todd Lamb,REP,240308,12,30,277,319,
Garfield,Superintendent of Public Instruction,John Cox,DEM,240308,1,15,82,98,
Garfield,Superintendent of Public Instruction,Joy Hofmeister,REP,240308,12,28,213,253,
Garfield,Commissioner of Labor,Mike Workman,DEM,240308,1,14,34,49,
Garfield,Commissioner of Labor,Mark Costello,REP,240308,12,28,257,297,
Garfield,U.S. Senate,Matt Silverstein,DEM,240308,0,14,20,34,
Garfield,U.S. Senate,Jim Inhofe,REP,240308,13,29,267,309,
Garfield,U.S. Senate,Aaron Delozier,IND,240308,0,0,4,4,
Garfield,U.S. Senate,Ray Woods,IND,240308,0,0,3,3,
Garfield,U.S. Senate,Joan Farr,IND,240308,0,0,3,3,
Garfield,U.S. Senate,Connie Johnson,DEM,240308,1,14,22,37,
Garfield,U.S. Senate,James Lankford,REP,240308,12,29,269,310,
Garfield,U.S. Senate,Mark Beard,IND,240308,0,0,8,8,
Garfield,U.S. House,Frankie Robbins,DEM,240308,2,12,26,40,03
Garfield,U.S. House,Frank Lucas,REP,240308,11,31,272,314,03
Garfield,Governor,Joe Dorman,DEM,240309,2,1,96,99,
Garfield,Governor,Mary Fallin,REP,240309,8,9,182,199,
Garfield,Governor,Kimberly Willis,IND,240309,0,0,7,7,
Garfield,Governor,Richard Prawdzienski,IND,240309,0,0,5,5,
Garfield,Lieutenant Governor,Cathy Cummings,DEM,240309,0,0,39,39,
Garfield,Lieutenant Governor,Todd Lamb,REP,240309,10,10,252,272,
Garfield,Superintendent of Public Instruction,John Cox,DEM,240309,1,2,95,98,
Garfield,Superintendent of Public Instruction,Joy Hofmeister,REP,240309,9,8,192,209,
Garfield,Commissioner of Labor,Mike Workman,DEM,240309,2,0,58,60,
Garfield,Commissioner of Labor,Mark Costello,REP,240309,8,9,230,247,
Garfield,U.S. Senate,Matt Silverstein,DEM,240309,1,0,30,31,
Garfield,U.S. Senate,Jim Inhofe,REP,240309,9,10,243,262,
Garfield,U.S. Senate,Aaron Delozier,IND,240309,0,0,4,4,
Garfield,U.S. Senate,Ray Woods,IND,240309,0,0,9,9,
Garfield,U.S. Senate,Joan Farr,IND,240309,0,0,4,4,
Garfield,U.S. Senate,Connie Johnson,DEM,240309,1,0,37,38,
Garfield,U.S. Senate,James Lankford,REP,240309,9,10,242,261,
Garfield,U.S. Senate,Mark Beard,IND,240309,0,0,10,10,
Garfield,U.S. House,Frankie Robbins,DEM,240309,0,0,34,34,03
Garfield,U.S. House,Frank Lucas,REP,240309,10,10,257,277,03
Garfield,Governor,Joe Dorman,DEM,240310,5,15,105,125,
Garfield,Governor,Mary Fallin,REP,240310,15,17,199,231,
Garfield,Governor,Kimberly Willis,IND,240310,0,0,6,6,
Garfield,Governor,Richard Prawdzienski,IND,240310,0,0,3,3,
Garfield,Lieutenant Governor,Cathy Cummings,DEM,240310,1,4,51,56,
Garfield,Lieutenant Governor,Todd Lamb,REP,240310,19,28,266,313,
Garfield,Superintendent of Public Instruction,John Cox,DEM,240310,4,12,112,128,
Garfield,Superintendent of Public Instruction,Joy Hofmeister,REP,240310,16,20,204,240,
Garfield,Commissioner of Labor,Mike Workman,DEM,240310,4,6,79,89,
Garfield,Commissioner of Labor,Mark Costello,REP,240310,16,26,236,278,
Garfield,U.S. Senate,Matt Silverstein,DEM,240310,1,2,48,51,
Garfield,U.S. Senate,Jim Inhofe,REP,240310,19,27,260,306,
Garfield,U.S. Senate,Aaron Delozier,IND,240310,0,2,2,4,
Garfield,U.S. Senate,Ray Woods,IND,240310,0,1,4,5,
Garfield,U.S. Senate,Joan Farr,IND,240310,0,0,3,3,
Garfield,U.S. Senate,Connie Johnson,DEM,240310,3,3,45,51,
Garfield,U.S. Senate,James Lankford,REP,240310,17,27,262,306,
Garfield,U.S. Senate,Mark Beard,IND,240310,0,2,10,12,
Garfield,U.S. House,Frankie Robbins,DEM,240310,1,4,62,67,03
Garfield,U.S. House,Frank Lucas,REP,240310,19,28,255,302,03
Garfield,Governor,Joe Dorman,DEM,240311,3,30,197,230,
Garfield,Governor,Mary Fallin,REP,240311,7,25,293,325,
Garfield,Governor,Kimberly Willis,IND,240311,2,1,12,15,
Garfield,Governor,Richard Prawdzienski,IND,240311,0,0,6,6,
Garfield,Lieutenant Governor,Cathy Cummings,DEM,240311,3,14,81,98,
Garfield,Lieutenant Governor,Todd Lamb,REP,240311,10,42,425,477,
Garfield,Superintendent of Public Instruction,John Cox,DEM,240311,4,27,179,210,
Garfield,Superintendent of Public Instruction,Joy Hofmeister,REP,240311,9,27,326,362,
Garfield,Commissioner of Labor,Mike Workman,DEM,240311,3,17,105,125,
Garfield,Commissioner of Labor,Mark Costello,REP,240311,10,37,393,440,
Garfield,U.S. Senate,Matt Silverstein,DEM,240311,2,18,69,89,
Garfield,U.S. Senate,Jim Inhofe,REP,240311,10,37,416,463,
Garfield,U.S. Senate,Aaron Delozier,IND,240311,0,0,8,8,
Garfield,U.S. Senate,Ray Woods,IND,240311,0,0,8,8,
Garfield,U.S. Senate,Joan Farr,IND,240311,1,1,5,7,
Garfield,U.S. Senate,Connie Johnson,DEM,240311,2,17,80,99,
Garfield,U.S. Senate,James Lankford,REP,240311,10,37,412,459,
Garfield,U.S. Senate,Mark Beard,IND,240311,1,2,13,16,
Garfield,U.S. House,Frankie Robbins,DEM,240311,3,16,96,115,03
Garfield,U.S. House,Frank Lucas,REP,240311,10,40,410,460,03
Garvin,Governor,Joe Dorman,DEM,250001,3,0,72,75,
Garvin,Governor,Mary Fallin,REP,250001,5,0,153,158,
Garvin,Governor,Kimberly Willis,IND,250001,1,0,2,3,
Garvin,Governor,Richard Prawdzienski,IND,250001,0,0,0,0,
Garvin,Lieutenant Governor,Cathy Cummings,DEM,250001,3,0,54,57,
Garvin,Lieutenant Governor,Todd Lamb,REP,250001,6,0,171,177,
Garvin,Superintendent of Public Instruction,John Cox,DEM,250001,2,0,102,104,
Garvin,Superintendent of Public Instruction,Joy Hofmeister,REP,250001,7,0,125,132,
Garvin,Commissioner of Labor,Mike Workman,DEM,250001,4,0,75,79,
Garvin,Commissioner of Labor,Mark Costello,REP,250001,5,0,145,150,
Garvin,U.S. Senate,Matt Silverstein,DEM,250001,2,0,34,36,
Garvin,U.S. Senate,Jim Inhofe,REP,250001,6,0,182,188,
Garvin,U.S. Senate,Aaron Delozier,IND,250001,0,0,4,4,
Garvin,U.S. Senate,Ray Woods,IND,250001,0,0,3,3,
Garvin,U.S. Senate,Joan Farr,IND,250001,1,0,4,5,
Garvin,U.S. Senate,Connie Johnson,DEM,250001,2,0,46,48,
Garvin,U.S. Senate,James Lankford,REP,250001,7,0,174,181,
Garvin,U.S. Senate,Mark Beard,IND,250001,0,0,7,7,
Garvin,U.S. House,Bert Smith,DEM,250001,2,0,33,35,04
Garvin,U.S. House,Tom Cole,REP,250001,6,0,186,192,04
Garvin,U.S. House,Dennis Johnson,IND,250001,1,0,6,7,04
Garvin,Governor,Joe Dorman,DEM,250002,1,0,104,105,
Garvin,Governor,Mary Fallin,REP,250002,4,1,187,192,
Garvin,Governor,Kimberly Willis,IND,250002,0,0,5,5,
Garvin,Governor,Richard Prawdzienski,IND,250002,0,0,7,7,
Garvin,Lieutenant Governor,Cathy Cummings,DEM,250002,1,0,58,59,
Garvin,Lieutenant Governor,Todd Lamb,REP,250002,4,1,243,248,
Garvin,Superintendent of Public Instruction,John Cox,DEM,250002,3,1,123,127,
Garvin,Superintendent of Public Instruction,Joy Hofmeister,REP,250002,2,0,174,176,
Garvin,Commissioner of Labor,Mike Workman,DEM,250002,0,0,87,87,
Garvin,Commissioner of Labor,Mark Costello,REP,250002,4,1,203,208,
Garvin,U.S. Senate,Matt Silverstein,DEM,250002,2,0,44,46,
Garvin,U.S. Senate,Jim Inhofe,REP,250002,3,1,241,245,
Garvin,U.S. Senate,Aaron Delozier,IND,250002,0,0,4,4,
Garvin,U.S. Senate,Ray Woods,IND,250002,0,0,5,5,
Garvin,U.S. Senate,Joan Farr,IND,250002,0,0,7,7,
Garvin,U.S. Senate,Connie Johnson,DEM,250002,0,0,44,44,
Garvin,U.S. Senate,James Lankford,REP,250002,4,1,249,254,
Garvin,U.S. Senate,Mark Beard,IND,250002,1,0,9,10,
Garvin,U.S. House,Bert Smith,DEM,250002,0,0,39,39,04
Garvin,U.S. House,Tom Cole,REP,250002,4,1,243,248,04
Garvin,U.S. House,Dennis Johnson,IND,250002,1,0,20,21,04
Garvin,Governor,Joe Dorman,DEM,250003,2,0,115,117,
Garvin,Governor,Mary Fallin,REP,250003,5,8,213,226,
Garvin,Governor,Kimberly Willis,IND,250003,0,0,1,1,
Garvin,Governor,Richard Prawdzienski,IND,250003,0,0,1,1,
Garvin,Lieutenant Governor,Cathy Cummings,DEM,250003,1,0,65,66,
Garvin,Lieutenant Governor,Todd Lamb,REP,250003,6,8,264,278,
Garvin,Superintendent of Public Instruction,John Cox,DEM,250003,5,1,116,122,
Garvin,Superintendent of Public Instruction,Joy Hofmeister,REP,250003,2,7,210,219,
Garvin,Commissioner of Labor,Mike Workman,DEM,250003,2,0,101,103,
Garvin,Commissioner of Labor,Mark Costello,REP,250003,5,8,216,229,
Garvin,U.S. Senate,Matt Silverstein,DEM,250003,2,0,48,50,
Garvin,U.S. Senate,Jim Inhofe,REP,250003,5,8,275,288,
Garvin,U.S. Senate,Aaron Delozier,IND,250003,0,0,0,0,
Garvin,U.S. Senate,Ray Woods,IND,250003,0,0,4,4,
Garvin,U.S. Senate,Joan Farr,IND,250003,0,0,3,3,
Garvin,U.S. Senate,Connie Johnson,DEM,250003,2,0,53,55,
Garvin,U.S. Senate,James Lankford,REP,250003,4,8,266,278,
Garvin,U.S. Senate,Mark Beard,IND,250003,1,0,10,11,
Garvin,U.S. House,Bert Smith,DEM,250003,2,0,50,52,04
Garvin,U.S. House,Tom Cole,REP,250003,4,8,270,282,04
Garvin,U.S. House,Dennis Johnson,IND,250003,1,0,9,10,04
Garvin,Governor,Joe Dorman,DEM,250005,3,5,164,172,
Garvin,Governor,Mary Fallin,REP,250005,5,15,277,297,
Garvin,Governor,Kimberly Willis,IND,250005,0,0,5,5,
Garvin,Governor,Richard Prawdzienski,IND,250005,0,0,5,5,
Garvin,Lieutenant Governor,Cathy Cummings,DEM,250005,1,3,86,90,
Garvin,Lieutenant Governor,Todd Lamb,REP,250005,7,17,357,381,
Garvin,Superintendent of Public Instruction,John Cox,DEM,250005,5,8,190,203,
Garvin,Superintendent of Public Instruction,Joy Hofmeister,REP,250005,3,12,250,265,
Garvin,Commissioner of Labor,Mike Workman,DEM,250005,3,4,139,146,
Garvin,Commissioner of Labor,Mark Costello,REP,250005,4,16,292,312,
Garvin,U.S. Senate,Matt Silverstein,DEM,250005,1,3,65,69,
Garvin,U.S. Senate,Jim Inhofe,REP,250005,7,17,366,390,
Garvin,U.S. Senate,Aaron Delozier,IND,250005,0,0,4,4,
Garvin,U.S. Senate,Ray Woods,IND,250005,0,0,4,4,
Garvin,U.S. Senate,Joan Farr,IND,250005,0,0,4,4,
Garvin,U.S. Senate,Connie Johnson,DEM,250005,1,3,70,74,
Garvin,U.S. Senate,James Lankford,REP,250005,6,16,365,387,
Garvin,U.S. Senate,Mark Beard,IND,250005,1,1,12,14,
Garvin,U.S. House,Bert Smith,DEM,250005,1,3,58,62,04
Garvin,U.S. House,Tom Cole,REP,250005,7,17,375,399,04
Garvin,U.S. House,Dennis Johnson,IND,250005,0,0,11,11,04
Garvin,Governor,Joe Dorman,DEM,250006,1,4,110,115,
Garvin,Governor,Mary Fallin,REP,250006,3,7,63,73,
Garvin,Governor,Kimberly Willis,IND,250006,0,1,10,11,
Garvin,Governor,Richard Prawdzienski,IND,250006,0,0,1,1,
Garvin,Lieutenant Governor,Cathy Cummings,DEM,250006,1,2,79,82,
Garvin,Lieutenant Governor,Todd Lamb,REP,250006,3,10,104,117,
Garvin,Superintendent of Public Instruction,John Cox,DEM,250006,3,3,112,118,
Garvin,Superintendent of Public Instruction,Joy Hofmeister,REP,250006,1,8,71,80,
Garvin,Commissioner of Labor,Mike Workman,DEM,250006,1,3,102,106,
Garvin,Commissioner of Labor,Mark Costello,REP,250006,3,8,75,86,
Garvin,U.S. Senate,Matt Silverstein,DEM,250006,1,1,68,70,
Garvin,U.S. Senate,Jim Inhofe,REP,250006,3,11,108,122,
Garvin,U.S. Senate,Aaron Delozier,IND,250006,0,0,0,0,
Garvin,U.S. Senate,Ray Woods,IND,250006,0,0,3,3,
Garvin,U.S. Senate,Joan Farr,IND,250006,0,0,4,4,
Garvin,U.S. Senate,Connie Johnson,DEM,250006,1,1,71,73,
Garvin,U.S. Senate,James Lankford,REP,250006,3,10,105,118,
Garvin,U.S. Senate,Mark Beard,IND,250006,0,0,8,8,
Garvin,U.S. House,Bert Smith,DEM,250006,1,1,62,64,04
Garvin,U.S. House,Tom Cole,REP,250006,3,10,112,125,04
Garvin,U.S. House,Dennis Johnson,IND,250006,0,1,10,11,04
Garvin,Governor,Joe Dorman,DEM,250007,4,13,94,111,
Garvin,Governor,Mary Fallin,REP,250007,1,25,150,176,
Garvin,Governor,Kimberly Willis,IND,250007,0,0,10,10,
Garvin,Governor,Richard Prawdzienski,IND,250007,0,0,1,1,
Garvin,Lieutenant Governor,Cathy Cummings,DEM,250007,4,5,62,71,
Garvin,Lieutenant Governor,Todd Lamb,REP,250007,1,33,194,228,
Garvin,Superintendent of Public Instruction,John Cox,DEM,250007,5,11,108,124,
Garvin,Superintendent of Public Instruction,Joy Hofmeister,REP,250007,0,27,145,172,
Garvin,Commissioner of Labor,Mike Workman,DEM,250007,4,6,100,110,
Garvin,Commissioner of Labor,Mark Costello,REP,250007,1,31,148,180,
Garvin,U.S. Senate,Matt Silverstein,DEM,250007,4,5,52,61,
Garvin,U.S. Senate,Jim Inhofe,REP,250007,1,32,196,229,
Garvin,U.S. Senate,Aaron Delozier,IND,250007,0,0,2,2,
Garvin,U.S. Senate,Ray Woods,IND,250007,0,1,1,2,
Garvin,U.S. Senate,Joan Farr,IND,250007,0,0,5,5,
Garvin,U.S. Senate,Connie Johnson,DEM,250007,4,5,65,74,
Garvin,U.S. Senate,James Lankford,REP,250007,1,33,184,218,
Garvin,U.S. Senate,Mark Beard,IND,250007,0,0,5,5,
Garvin,U.S. House,Bert Smith,DEM,250007,4,6,51,61,04
Garvin,U.S. House,Tom Cole,REP,250007,1,31,201,233,04
Garvin,U.S. House,Dennis Johnson,IND,250007,0,1,4,5,04
Garvin,Governor,Joe Dorman,DEM,250008,1,13,126,140,
Garvin,Governor,Mary Fallin,REP,250008,1,35,165,201,
Garvin,Governor,Kimberly Willis,IND,250008,0,0,7,7,
Garvin,Governor,Richard Prawdzienski,IND,250008,0,0,2,2,
Garvin,Lieutenant Governor,Cathy Cummings,DEM,250008,0,9,87,96,
Garvin,Lieutenant Governor,Todd Lamb,REP,250008,2,38,212,252,
Garvin,Superintendent of Public Instruction,John Cox,DEM,250008,1,16,134,151,
Garvin,Superintendent of Public Instruction,Joy Hofmeister,REP,250008,1,32,162,195,
Garvin,Commissioner of Labor,Mike Workman,DEM,250008,0,12,114,126,
Garvin,Commissioner of Labor,Mark Costello,REP,250008,2,36,178,216,
Garvin,U.S. Senate,Matt Silverstein,DEM,250008,0,8,81,89,
Garvin,U.S. Senate,Jim Inhofe,REP,250008,2,38,207,247,
Garvin,U.S. Senate,Aaron Delozier,IND,250008,0,1,4,5,
Garvin,U.S. Senate,Ray Woods,IND,250008,0,0,3,3,
Garvin,U.S. Senate,Joan Farr,IND,250008,0,1,4,5,
Garvin,U.S. Senate,Connie Johnson,DEM,250008,1,7,76,84,
Garvin,U.S. Senate,James Lankford,REP,250008,1,40,211,252,
Garvin,U.S. Senate,Mark Beard,IND,250008,0,1,11,12,
Garvin,U.S. House,Bert Smith,DEM,250008,1,7,77,85,04
Garvin,U.S. House,Tom Cole,REP,250008,1,40,212,253,04
Garvin,U.S. House,Dennis Johnson,IND,250008,0,1,10,11,04
Garvin,Governor,Joe Dorman,DEM,250009,3,11,220,234,
Garvin,Governor,Mary Fallin,REP,250009,4,15,270,289,
Garvin,Governor,Kimberly Willis,IND,250009,0,1,9,10,
Garvin,Governor,Richard Prawdzienski,IND,250009,0,0,5,5,
Garvin,Lieutenant Governor,Cathy Cummings,DEM,250009,3,5,141,149,
Garvin,Lieutenant Governor,Todd Lamb,REP,250009,4,22,356,382,
Garvin,Superintendent of Public Instruction,John Cox,DEM,250009,4,10,253,267,
Garvin,Superintendent of Public Instruction,Joy Hofmeister,REP,250009,3,17,247,267,
Garvin,Commissioner of Labor,Mike Workman,DEM,250009,4,8,208,220,
Garvin,Commissioner of Labor,Mark Costello,REP,250009,3,19,288,310,
Garvin,U.S. Senate,Matt Silverstein,DEM,250009,4,6,121,131,
Garvin,U.S. Senate,Jim Inhofe,REP,250009,3,21,365,389,
Garvin,U.S. Senate,Aaron Delozier,IND,250009,0,0,5,5,
Garvin,U.S. Senate,Ray Woods,IND,250009,0,0,5,5,
Garvin,U.S. Senate,Joan Farr,IND,250009,0,0,7,7,
Garvin,U.S. Senate,Connie Johnson,DEM,250009,2,4,112,118,
Garvin,U.S. Senate,James Lankford,REP,250009,5,23,380,408,
Garvin,U.S. Senate,Mark Beard,IND,250009,0,0,13,13,
Garvin,U.S. House,Bert Smith,DEM,250009,4,5,107,116,04
Garvin,U.S. House,Tom Cole,REP,250009,2,22,378,402,04
Garvin,U.S. House,Dennis Johnson,IND,250009,1,0,19,20,04
Garvin,Governor,Joe Dorman,DEM,250013,0,3,76,79,
Garvin,Governor,Mary Fallin,REP,250013,2,5,107,114,
Garvin,Governor,Kimberly Willis,IND,250013,0,1,7,8,
Garvin,Governor,Richard Prawdzienski,IND,250013,0,0,1,1,
Garvin,Lieutenant Governor,Cathy Cummings,DEM,250013,0,1,55,56,
Garvin,Lieutenant Governor,Todd Lamb,REP,250013,2,8,133,143,
Garvin,Superintendent of Public Instruction,John Cox,DEM,250013,0,2,88,90,
Garvin,Superintendent of Public Instruction,Joy Hofmeister,REP,250013,2,7,102,111,
Garvin,Commissioner of Labor,Mike Workman,DEM,250013,0,2,76,78,
Garvin,Commissioner of Labor,Mark Costello,REP,250013,2,7,110,119,
Garvin,U.S. Senate,Matt Silverstein,DEM,250013,0,1,38,39,
Garvin,U.S. Senate,Jim Inhofe,REP,250013,2,8,147,157,
Garvin,U.S. Senate,Aaron Delozier,IND,250013,0,0,2,2,
Garvin,U.S. Senate,Ray Woods,IND,250013,0,0,1,1,
Garvin,U.S. Senate,Joan Farr,IND,250013,0,0,0,0,
Garvin,U.S. Senate,Connie Johnson,DEM,250013,0,2,47,49,
Garvin,U.S. Senate,James Lankford,REP,250013,2,7,140,149,
Garvin,U.S. Senate,Mark Beard,IND,250013,0,0,2,2,
Garvin,U.S. House,Bert Smith,DEM,250013,0,1,41,42,04
Garvin,U.S. House,Tom Cole,REP,250013,2,7,142,151,04
Garvin,U.S. House,Dennis Johnson,IND,250013,0,1,7,8,04
Garvin,Governor,Joe Dorman,DEM,250015,4,28,126,158,
Garvin,Governor,Mary Fallin,REP,250015,9,30,219,258,
Garvin,Governor,Kimberly Willis,IND,250015,1,1,11,13,
Garvin,Governor,Richard Prawdzienski,IND,250015,0,0,4,4,
Garvin,Lieutenant Governor,Cathy Cummings,DEM,250015,3,14,80,97,
Garvin,Lieutenant Governor,Todd Lamb,REP,250015,11,45,279,335,
Garvin,Superintendent of Public Instruction,John Cox,DEM,250015,10,29,163,202,
Garvin,Superintendent of Public Instruction,Joy Hofmeister,REP,250015,4,30,195,229,
Garvin,Commissioner of Labor,Mike Workman,DEM,250015,7,25,118,150,
Garvin,Commissioner of Labor,Mark Costello,REP,250015,7,33,229,269,
Garvin,U.S. Senate,Matt Silverstein,DEM,250015,4,15,66,85,
Garvin,U.S. Senate,Jim Inhofe,REP,250015,9,43,287,339,
Garvin,U.S. Senate,Aaron Delozier,IND,250015,0,1,0,1,
Garvin,U.S. Senate,Ray Woods,IND,250015,0,0,5,5,
Garvin,U.S. Senate,Joan Farr,IND,250015,0,0,2,2,
Garvin,U.S. Senate,Connie Johnson,DEM,250015,2,15,74,91,
Garvin,U.S. Senate,James Lankford,REP,250015,11,44,275,330,
Garvin,U.S. Senate,Mark Beard,IND,250015,1,0,11,12,
Garvin,U.S. House,Bert Smith,DEM,250015,3,14,59,76,04
Garvin,U.S. House,Tom Cole,REP,250015,10,43,287,340,04
Garvin,U.S. House,Dennis Johnson,IND,250015,1,2,13,16,04
Garvin,Governor,Joe Dorman,DEM,250016,0,19,128,147,
Garvin,Governor,Mary Fallin,REP,250016,10,21,185,216,
Garvin,Governor,Kimberly Willis,IND,250016,0,1,10,11,
Garvin,Governor,Richard Prawdzienski,IND,250016,0,0,4,4,
Garvin,Lieutenant Governor,Cathy Cummings,DEM,250016,0,9,105,114,
Garvin,Lieutenant Governor,Todd Lamb,REP,250016,9,32,223,264,
Garvin,Superintendent of Public Instruction,John Cox,DEM,250016,0,20,162,182,
Garvin,Superintendent of Public Instruction,Joy Hofmeister,REP,250016,9,21,161,191,
Garvin,Commissioner of Labor,Mike Workman,DEM,250016,0,12,127,139,
Garvin,Commissioner of Labor,Mark Costello,REP,250016,9,27,191,227,
Garvin,U.S. Senate,Matt Silverstein,DEM,250016,0,8,87,95,
Garvin,U.S. Senate,Jim Inhofe,REP,250016,10,31,231,272,
Garvin,U.S. Senate,Aaron Delozier,IND,250016,0,1,2,3,
Garvin,U.S. Senate,Ray Woods,IND,250016,0,0,2,2,
Garvin,U.S. Senate,Joan Farr,IND,250016,0,0,2,2,
Garvin,U.S. Senate,Connie Johnson,DEM,250016,0,11,92,103,
Garvin,U.S. Senate,James Lankford,REP,250016,10,30,221,261,
Garvin,U.S. Senate,Mark Beard,IND,250016,0,0,13,13,
Garvin,U.S. House,Bert Smith,DEM,250016,0,8,84,92,04
Garvin,U.S. House,Tom Cole,REP,250016,10,31,234,275,04
Garvin,U.S. House,Dennis Johnson,IND,250016,0,2,10,12,04
Garvin,Governor,Joe Dorman,DEM,250017,5,22,140,167,
Garvin,Governor,Mary Fallin,REP,250017,6,27,116,149,
Garvin,Governor,Kimberly Willis,IND,250017,0,1,6,7,
Garvin,Governor,Richard Prawdzienski,IND,250017,0,0,5,5,
Garvin,Lieutenant Governor,Cathy Cummings,DEM,250017,4,19,104,127,
Garvin,Lieutenant Governor,Todd Lamb,REP,250017,7,31,159,197,
Garvin,Superintendent of Public Instruction,John Cox,DEM,250017,6,23,151,180,
Garvin,Superintendent of Public Instruction,Joy Hofmeister,REP,250017,4,27,113,144,
Garvin,Commissioner of Labor,Mike Workman,DEM,250017,7,16,121,144,
Garvin,Commissioner of Labor,Mark Costello,REP,250017,3,33,136,172,
Garvin,U.S. Senate,Matt Silverstein,DEM,250017,7,16,94,117,
Garvin,U.S. Senate,Jim Inhofe,REP,250017,4,33,160,197,
Garvin,U.S. Senate,Aaron Delozier,IND,250017,0,1,1,2,
Garvin,U.S. Senate,Ray Woods,IND,250017,0,0,3,3,
Garvin,U.S. Senate,Joan Farr,IND,250017,0,0,4,4,
Garvin,U.S. Senate,Connie Johnson,DEM,250017,5,15,100,120,
Garvin,U.S. Senate,James Lankford,REP,250017,6,35,153,194,
Garvin,U.S. Senate,Mark Beard,IND,250017,0,0,11,11,
Garvin,U.S. House,Bert Smith,DEM,250017,7,13,87,107,04
Garvin,U.S. House,Tom Cole,REP,250017,4,37,165,206,04
Garvin,U.S. House,Dennis Johnson,IND,250017,0,0,13,13,04
Garvin,Governor,Joe Dorman,DEM,250018,8,28,217,253,
Garvin,Governor,Mary Fallin,REP,250018,16,62,326,404,
Garvin,Governor,Kimberly Willis,IND,250018,0,0,17,17,
Garvin,Governor,Richard Prawdzienski,IND,250018,0,0,6,6,
Garvin,Lieutenant Governor,Cathy Cummings,DEM,250018,7,25,168,200,
Garvin,Lieutenant Governor,Todd Lamb,REP,250018,17,64,394,475,
Garvin,Superintendent of Public Instruction,John Cox,DEM,250018,9,32,262,303,
Garvin,Superintendent of Public Instruction,Joy Hofmeister,REP,250018,15,57,304,376,
Garvin,Commissioner of Labor,Mike Workman,DEM,250018,11,24,226,261,
Garvin,Commissioner of Labor,Mark Costello,REP,250018,13,57,330,400,
Garvin,U.S. Senate,Matt Silverstein,DEM,250018,6,14,144,164,
Garvin,U.S. Senate,Jim Inhofe,REP,250018,18,73,401,492,
Garvin,U.S. Senate,Aaron Delozier,IND,250018,0,1,5,6,
Garvin,U.S. Senate,Ray Woods,IND,250018,0,1,5,6,
Garvin,U.S. Senate,Joan Farr,IND,250018,0,0,9,9,
Garvin,U.S. Senate,Connie Johnson,DEM,250018,6,17,156,179,
Garvin,U.S. Senate,James Lankford,REP,250018,18,72,385,475,
Garvin,U.S. Senate,Mark Beard,IND,250018,0,2,24,26,
Garvin,U.S. House,Bert Smith,DEM,250018,8,14,124,146,04
Garvin,U.S. House,Tom Cole,REP,250018,16,73,415,504,04
Garvin,U.S. House,Dennis Johnson,IND,250018,0,4,24,28,04
Garvin,State House,Joni Johnson,DEM,250018,9,19,187,215,20
Garvin,State House,Bobby Cleveland,REP,250018,15,69,370,454,20
Garvin,Governor,Joe Dorman,DEM,250020,5,6,259,270,
Garvin,Governor,Mary Fallin,REP,250020,4,12,250,266,
Garvin,Governor,Kimberly Willis,IND,250020,0,1,12,13,
Garvin,Governor,Richard Prawdzienski,IND,250020,2,0,2,4,
Garvin,Lieutenant Governor,Cathy Cummings,DEM,250020,4,7,189,200,
Garvin,Lieutenant Governor,Todd Lamb,REP,250020,7,12,332,351,
Garvin,Superintendent of Public Instruction,John Cox,DEM,250020,5,12,285,302,
Garvin,Superintendent of Public Instruction,Joy Hofmeister,REP,250020,6,7,236,249,
Garvin,Commissioner of Labor,Mike Workman,DEM,250020,4,8,243,255,
Garvin,Commissioner of Labor,Mark Costello,REP,250020,7,11,264,282,
Garvin,U.S. Senate,Matt Silverstein,DEM,250020,3,6,156,165,
Garvin,U.S. Senate,Jim Inhofe,REP,250020,8,12,345,365,
Garvin,U.S. Senate,Aaron Delozier,IND,250020,0,0,2,2,
Garvin,U.S. Senate,Ray Woods,IND,250020,0,0,10,10,
Garvin,U.S. Senate,Joan Farr,IND,250020,0,1,7,8,
Garvin,U.S. Senate,Connie Johnson,DEM,250020,3,4,163,170,
Garvin,U.S. Senate,James Lankford,REP,250020,8,13,344,365,
Garvin,U.S. Senate,Mark Beard,IND,250020,0,2,14,16,
Garvin,U.S. House,Bert Smith,DEM,250020,3,4,146,153,04
Garvin,U.S. House,Tom Cole,REP,250020,8,11,358,377,04
Garvin,U.S. House,Dennis Johnson,IND,250020,0,4,17,21,04
Garvin,Governor,Joe Dorman,DEM,250021,0,0,5,5,
Garvin,Governor,Mary Fallin,REP,250021,0,0,1,1,
Garvin,Governor,Kimberly Willis,IND,250021,0,0,1,1,
Garvin,Governor,Richard Prawdzienski,IND,250021,0,0,1,1,
Garvin,Lieutenant Governor,Cathy Cummings,DEM,250021,0,0,4,4,
Garvin,Lieutenant Governor,Todd Lamb,REP,250021,0,0,4,4,
Garvin,Superintendent of Public Instruction,John Cox,DEM,250021,0,0,6,6,
Garvin,Superintendent of Public Instruction,Joy Hofmeister,REP,250021,0,0,2,2,
Garvin,Commissioner of Labor,Mike Workman,DEM,250021,0,0,5,5,
Garvin,Commissioner of Labor,Mark Costello,REP,250021,0,0,3,3,
Garvin,U.S. Senate,Matt Silverstein,DEM,250021,0,0,3,3,
Garvin,U.S. Senate,Jim Inhofe,REP,250021,0,0,3,3,
Garvin,U.S. Senate,Aaron Delozier,IND,250021,0,0,0,0,
Garvin,U.S. Senate,Ray Woods,IND,250021,0,0,2,2,
Garvin,U.S. Senate,Joan Farr,IND,250021,0,0,0,0,
Garvin,U.S. Senate,Connie Johnson,DEM,250021,0,0,4,4,
Garvin,U.S. Senate,James Lankford,REP,250021,0,0,3,3,
Garvin,U.S. Senate,Mark Beard,IND,250021,0,0,1,1,
Garvin,U.S. House,Bert Smith,DEM,250021,0,0,2,2,04
Garvin,U.S. House,Tom Cole,REP,250021,0,0,5,5,04
Garvin,U.S. House,Dennis Johnson,IND,250021,0,0,1,1,04
Garvin,State House,Joni Johnson,DEM,250021,0,0,4,4,20
Garvin,State House,Bobby Cleveland,REP,250021,0,0,3,3,20
Garvin,Governor,Joe Dorman,DEM,250024,2,7,156,165,
Garvin,Governor,Mary Fallin,REP,250024,2,7,201,210,
Garvin,Governor,Kimberly Willis,IND,250024,0,0,8,8,
Garvin,Governor,Richard Prawdzienski,IND,250024,0,0,4,4,
Garvin,Lieutenant Governor,Cathy Cummings,DEM,250024,1,7,105,113,
Garvin,Lieutenant Governor,Todd Lamb,REP,250024,3,7,261,271,
Garvin,Superintendent of Public Instruction,John Cox,DEM,250024,3,6,161,170,
Garvin,Superintendent of Public Instruction,Joy Hofmeister,REP,250024,1,8,206,215,
Garvin,Commissioner of Labor,Mike Workman,DEM,250024,1,6,141,148,
Garvin,Commissioner of Labor,Mark Costello,REP,250024,3,8,218,229,
Garvin,U.S. Senate,Matt Silverstein,DEM,250024,1,5,80,86,
Garvin,U.S. Senate,Jim Inhofe,REP,250024,3,9,273,285,
Garvin,U.S. Senate,Aaron Delozier,IND,250024,0,0,4,4,
Garvin,U.S. Senate,Ray Woods,IND,250024,0,0,6,6,
Garvin,U.S. Senate,Joan Farr,IND,250024,0,0,6,6,
Garvin,U.S. Senate,Connie Johnson,DEM,250024,1,5,95,101,
Garvin,U.S. Senate,James Lankford,REP,250024,3,9,263,275,
Garvin,U.S. Senate,Mark Beard,IND,250024,0,0,8,8,
Garvin,U.S. House,Bert Smith,DEM,250024,1,4,70,75,04
Garvin,U.S. House,Tom Cole,REP,250024,3,10,281,294,04
Garvin,U.S. House,Dennis Johnson,IND,250024,0,0,14,14,04
Garvin,Governor,Joe Dorman,DEM,250025,6,8,101,115,
Garvin,Governor,Mary Fallin,REP,250025,11,16,160,187,
Garvin,Governor,Kimberly Willis,IND,250025,0,0,5,5,
Garvin,Governor,Richard Prawdzienski,IND,250025,0,0,3,3,
Garvin,Lieutenant Governor,Cathy Cummings,DEM,250025,6,3,61,70,
Garvin,Lieutenant Governor,Todd Lamb,REP,250025,11,21,209,241,
Garvin,Superintendent of Public Instruction,John Cox,DEM,250025,6,11,115,132,
Garvin,Superintendent of Public Instruction,Joy Hofmeister,REP,250025,11,13,154,178,
Garvin,Commissioner of Labor,Mike Workman,DEM,250025,4,7,90,101,
Garvin,Commissioner of Labor,Mark Costello,REP,250025,13,17,172,202,
Garvin,U.S. Senate,Matt Silverstein,DEM,250025,4,4,59,67,
Garvin,U.S. Senate,Jim Inhofe,REP,250025,13,19,201,233,
Garvin,U.S. Senate,Aaron Delozier,IND,250025,0,1,3,4,
Garvin,U.S. Senate,Ray Woods,IND,250025,0,0,2,2,
Garvin,U.S. Senate,Joan Farr,IND,250025,0,0,4,4,
Garvin,U.S. Senate,Connie Johnson,DEM,250025,4,5,54,63,
Garvin,U.S. Senate,James Lankford,REP,250025,13,16,210,239,
Garvin,U.S. Senate,Mark Beard,IND,250025,0,3,8,11,
Garvin,U.S. House,Bert Smith,DEM,250025,2,0,51,53,04
Garvin,U.S. House,Tom Cole,REP,250025,15,23,205,243,04
Garvin,U.S. House,Dennis Johnson,IND,250025,0,1,14,15,04
Garvin,State House,Joni Johnson,DEM,250025,6,8,82,96,20
Garvin,State House,Bobby Cleveland,REP,250025,11,16,182,209,20
Grady,Governor,Joe Dorman,DEM,260001,4,15,196,215,
Grady,Governor,Mary Fallin,REP,260001,8,22,207,237,
Grady,Governor,Kimberly Willis,IND,260001,0,0,7,7,
Grady,Governor,Richard Prawdzienski,IND,260001,0,0,4,4,
Grady,Lieutenant Governor,Cathy Cummings,DEM,260001,4,7,116,127,
Grady,Lieutenant Governor,Todd Lamb,REP,260001,8,30,297,335,
Grady,Superintendent of Public Instruction,John Cox,DEM,260001,6,18,207,231,
Grady,Superintendent of Public Instruction,Joy Hofmeister,REP,260001,5,19,203,227,
Grady,Commissioner of Labor,Mike Workman,DEM,260001,8,10,146,164,
Grady,Commissioner of Labor,Mark Costello,REP,260001,4,24,247,275,
Grady,U.S. Senate,Matt Silverstein,DEM,260001,4,6,95,105,
Grady,U.S. Senate,Jim Inhofe,REP,260001,7,31,303,341,
Grady,U.S. Senate,Aaron Delozier,IND,260001,0,0,4,4,
Grady,U.S. Senate,Ray Woods,IND,260001,1,0,4,5,
Grady,U.S. Senate,Joan Farr,IND,260001,0,0,7,7,
Grady,U.S. Senate,Connie Johnson,DEM,260001,4,8,90,102,
Grady,U.S. Senate,James Lankford,REP,260001,7,28,303,338,
Grady,U.S. Senate,Mark Beard,IND,260001,1,1,21,23,
Grady,U.S. House,Bert Smith,DEM,260001,2,5,87,94,04
Grady,U.S. House,Tom Cole,REP,260001,8,32,315,355,04
Grady,U.S. House,Dennis Johnson,IND,260001,2,0,11,13,04
Grady,State House,David Perryman,DEM,260001,4,16,221,241,56
Grady,State House,Chuck Utsler,REP,260001,8,20,192,220,56
Grady,Governor,Joe Dorman,DEM,260002,10,22,246,278,
Grady,Governor,Mary Fallin,REP,260002,2,44,306,352,
Grady,Governor,Kimberly Willis,IND,260002,0,1,4,5,
Grady,Governor,Richard Prawdzienski,IND,260002,1,0,1,2,
Grady,Lieutenant Governor,Cathy Cummings,DEM,260002,4,10,131,145,
Grady,Lieutenant Governor,Todd Lamb,REP,260002,9,57,418,484,
Grady,Superintendent of Public Instruction,John Cox,DEM,260002,9,25,244,278,
Grady,Superintendent of Public Instruction,Joy Hofmeister,REP,260002,4,40,304,348,
Grady,Commissioner of Labor,Mike Workman,DEM,260002,6,16,173,195,
Grady,Commissioner of Labor,Mark Costello,REP,260002,7,46,360,413,
Grady,U.S. Senate,Matt Silverstein,DEM,260002,5,9,117,131,
Grady,U.S. Senate,Jim Inhofe,REP,260002,8,58,420,486,
Grady,U.S. Senate,Aaron Delozier,IND,260002,0,0,4,4,
Grady,U.S. Senate,Ray Woods,IND,260002,0,0,6,6,
Grady,U.S. Senate,Joan Farr,IND,260002,0,0,1,1,
Grady,U.S. Senate,Connie Johnson,DEM,260002,6,11,97,114,
Grady,U.S. Senate,James Lankford,REP,260002,7,53,433,493,
Grady,U.S. Senate,Mark Beard,IND,260002,0,2,22,24,
Grady,U.S. House,Bert Smith,DEM,260002,4,11,101,116,04
Grady,U.S. House,Tom Cole,REP,260002,8,55,441,504,04
Grady,U.S. House,Dennis Johnson,IND,260002,1,0,14,15,04
Grady,State House,David Perryman,DEM,260002,9,29,282,320,56
Grady,State House,Chuck Utsler,REP,260002,4,38,273,315,56
Grady,Governor,Joe Dorman,DEM,260003,4,15,237,256,
Grady,Governor,Mary Fallin,REP,260003,5,19,211,235,
Grady,Governor,Kimberly Willis,IND,260003,0,0,7,7,
Grady,Governor,Richard Prawdzienski,IND,260003,0,0,2,2,
Grady,Lieutenant Governor,Cathy Cummings,DEM,260003,5,8,140,153,
Grady,Lieutenant Governor,Todd Lamb,REP,260003,4,27,313,344,
Grady,Superintendent of Public Instruction,John Cox,DEM,260003,4,13,226,243,
Grady,Superintendent of Public Instruction,Joy Hofmeister,REP,260003,5,22,229,256,
Grady,Commissioner of Labor,Mike Workman,DEM,260003,3,8,183,194,
Grady,Commissioner of Labor,Mark Costello,REP,260003,5,26,261,292,
Grady,U.S. Senate,Matt Silverstein,DEM,260003,4,4,125,133,
Grady,U.S. Senate,Jim Inhofe,REP,260003,5,29,321,355,
Grady,U.S. Senate,Aaron Delozier,IND,260003,0,0,0,0,
Grady,U.S. Senate,Ray Woods,IND,260003,0,0,4,4,
Grady,U.S. Senate,Joan Farr,IND,260003,0,1,4,5,
Grady,U.S. Senate,Connie Johnson,DEM,260003,4,5,131,140,
Grady,U.S. Senate,James Lankford,REP,260003,4,29,308,341,
Grady,U.S. Senate,Mark Beard,IND,260003,1,1,16,18,
Grady,U.S. House,Bert Smith,DEM,260003,2,4,106,112,04
Grady,U.S. House,Tom Cole,REP,260003,6,30,335,371,04
Grady,U.S. House,Dennis Johnson,IND,260003,1,0,15,16,04
Grady,Governor,Joe Dorman,DEM,260005,6,23,166,195,
Grady,Governor,Mary Fallin,REP,260005,1,18,96,115,
Grady,Governor,Kimberly Willis,IND,260005,0,0,3,3,
Grady,Governor,Richard Prawdzienski,IND,260005,0,0,3,3,
Grady,Lieutenant Governor,Cathy Cummings,DEM,260005,6,16,141,163,
Grady,Lieutenant Governor,Todd Lamb,REP,260005,1,24,126,151,
Grady,Superintendent of Public Instruction,John Cox,DEM,260005,7,21,163,191,
Grady,Superintendent of Public Instruction,Joy Hofmeister,REP,260005,0,19,105,124,
Grady,Commissioner of Labor,Mike Workman,DEM,260005,5,19,149,173,
Grady,Commissioner of Labor,Mark Costello,REP,260005,2,20,114,136,
Grady,U.S. Senate,Matt Silverstein,DEM,260005,5,15,117,137,
Grady,U.S. Senate,Jim Inhofe,REP,260005,1,25,136,162,
Grady,U.S. Senate,Aaron Delozier,IND,260005,0,0,4,4,
Grady,U.S. Senate,Ray Woods,IND,260005,0,0,9,9,
Grady,U.S. Senate,Joan Farr,IND,260005,1,0,2,3,
Grady,U.S. Senate,Connie Johnson,DEM,260005,6,17,125,148,
Grady,U.S. Senate,James Lankford,REP,260005,0,24,130,154,
Grady,U.S. Senate,Mark Beard,IND,260005,0,1,13,14,
Grady,U.S. House,Bert Smith,DEM,260005,5,13,110,128,04
Grady,U.S. House,Tom Cole,REP,260005,2,25,143,170,04
Grady,U.S. House,Dennis Johnson,IND,260005,0,2,15,17,04
Grady,State House,David Perryman,DEM,260005,6,28,181,215,56
Grady,State House,Chuck Utsler,REP,260005,1,13,86,100,56
Grady,Governor,Joe Dorman,DEM,260006,5,25,173,203,
Grady,Governor,Mary Fallin,REP,260006,8,11,159,178,
Grady,Governor,Kimberly Willis,IND,260006,0,1,4,5,
Grady,Governor,Richard Prawdzienski,IND,260006,0,0,1,1,
Grady,Lieutenant Governor,Cathy Cummings,DEM,260006,5,15,121,141,
Grady,Lieutenant Governor,Todd Lamb,REP,260006,8,22,215,245,
Grady,Superintendent of Public Instruction,John Cox,DEM,260006,5,22,171,198,
Grady,Superintendent of Public Instruction,Joy Hofmeister,REP,260006,8,15,165,188,
Grady,Commissioner of Labor,Mike Workman,DEM,260006,4,20,151,175,
Grady,Commissioner of Labor,Mark Costello,REP,260006,9,16,180,205,
Grady,U.S. Senate,Matt Silverstein,DEM,260006,4,13,103,120,
Grady,U.S. Senate,Jim Inhofe,REP,260006,9,23,218,250,
Grady,U.S. Senate,Aaron Delozier,IND,260006,0,0,1,1,
Grady,U.S. Senate,Ray Woods,IND,260006,0,0,7,7,
Grady,U.S. Senate,Joan Farr,IND,260006,0,1,6,7,
Grady,U.S. Senate,Connie Johnson,DEM,260006,5,19,103,127,
Grady,U.S. Senate,James Lankford,REP,260006,8,17,221,246,
Grady,U.S. Senate,Mark Beard,IND,260006,0,1,12,13,
Grady,U.S. House,Bert Smith,DEM,260006,4,14,100,118,04
Grady,U.S. House,Tom Cole,REP,260006,9,23,222,254,04
Grady,U.S. House,Dennis Johnson,IND,260006,0,0,14,14,04
Grady,State House,David Perryman,DEM,260006,9,25,178,212,56
Grady,State House,Chuck Utsler,REP,260006,4,12,160,176,56
Grady,Governor,Joe Dorman,DEM,260008,4,13,200,217,
Grady,Governor,Mary Fallin,REP,260008,4,8,144,156,
Grady,Governor,Kimberly Willis,IND,260008,0,0,6,6,
Grady,Governor,Richard Prawdzienski,IND,260008,0,0,4,4,
Grady,Lieutenant Governor,Cathy Cummings,DEM,260008,3,9,139,151,
Grady,Lieutenant Governor,Todd Lamb,REP,260008,5,12,213,230,
Grady,Superintendent of Public Instruction,John Cox,DEM,260008,4,12,178,194,
Grady,Superintendent of Public Instruction,Joy Hofmeister,REP,260008,4,9,173,186,
Grady,Commissioner of Labor,Mike Workman,DEM,260008,4,12,163,179,
Grady,Commissioner of Labor,Mark Costello,REP,260008,4,9,186,199,
Grady,U.S. Senate,Matt Silverstein,DEM,260008,3,11,108,122,
Grady,U.S. Senate,Jim Inhofe,REP,260008,5,10,220,235,
Grady,U.S. Senate,Aaron Delozier,IND,260008,0,0,8,8,
Grady,U.S. Senate,Ray Woods,IND,260008,0,0,6,6,
Grady,U.S. Senate,Joan Farr,IND,260008,0,0,12,12,
Grady,U.S. Senate,Connie Johnson,DEM,260008,3,10,110,123,
Grady,U.S. Senate,James Lankford,REP,260008,5,12,223,240,
Grady,U.S. Senate,Mark Beard,IND,260008,0,0,22,22,
Grady,U.S. House,Bert Smith,DEM,260008,3,8,100,111,04
Grady,U.S. House,Tom Cole,REP,260008,5,14,236,255,04
Grady,U.S. House,Dennis Johnson,IND,260008,0,0,17,17,04
Grady,State House,David Perryman,DEM,260008,3,13,206,222,56
Grady,State House,Chuck Utsler,REP,260008,5,9,148,162,56
Grady,Governor,Joe Dorman,DEM,260009,7,33,282,322,
Grady,Governor,Mary Fallin,REP,260009,8,39,239,286,
Grady,Governor,Kimberly Willis,IND,260009,0,0,1,1,
Grady,Governor,Richard Prawdzienski,IND,260009,0,1,1,2,
Grady,Lieutenant Governor,Cathy Cummings,DEM,260009,8,30,191,229,
Grady,Lieutenant Governor,Todd Lamb,REP,260009,7,43,326,376,
Grady,Superintendent of Public Instruction,John Cox,DEM,260009,7,39,254,300,
Grady,Superintendent of Public Instruction,Joy Hofmeister,REP,260009,8,34,263,305,
Grady,Commissioner of Labor,Mike Workman,DEM,260009,8,29,218,255,
Grady,Commissioner of Labor,Mark Costello,REP,260009,7,42,295,344,
Grady,U.S. Senate,Matt Silverstein,DEM,260009,4,27,160,191,
Grady,U.S. Senate,Jim Inhofe,REP,260009,11,44,332,387,
Grady,U.S. Senate,Aaron Delozier,IND,260009,0,0,6,6,
Grady,U.S. Senate,Ray Woods,IND,260009,0,0,7,7,
Grady,U.S. Senate,Joan Farr,IND,260009,0,0,11,11,
Grady,U.S. Senate,Connie Johnson,DEM,260009,5,26,166,197,
Grady,U.S. Senate,James Lankford,REP,260009,8,44,326,378,
Grady,U.S. Senate,Mark Beard,IND,260009,2,3,25,30,
Grady,U.S. House,Bert Smith,DEM,260009,4,24,140,168,04
Grady,U.S. House,Tom Cole,REP,260009,11,48,357,416,04
Grady,U.S. House,Dennis Johnson,IND,260009,0,0,17,17,04
Grady,State House,David Perryman,DEM,260009,7,38,277,322,56
Grady,State House,Chuck Utsler,REP,260009,8,35,242,285,56
Grady,Governor,Joe Dorman,DEM,260011,4,17,91,112,
Grady,Governor,Mary Fallin,REP,260011,7,19,103,129,
Grady,Governor,Kimberly Willis,IND,260011,0,0,1,1,
Grady,Governor,Richard Prawdzienski,IND,260011,0,1,1,2,
Grady,Lieutenant Governor,Cathy Cummings,DEM,260011,3,12,45,60,
Grady,Lieutenant Governor,Todd Lamb,REP,260011,8,25,149,182,
Grady,Superintendent of Public Instruction,John Cox,DEM,260011,5,19,86,110,
Grady,Superintendent of Public Instruction,Joy Hofmeister,REP,260011,6,17,109,132,
Grady,Commissioner of Labor,Mike Workman,DEM,260011,3,16,57,76,
Grady,Commissioner of Labor,Mark Costello,REP,260011,8,19,131,158,
Grady,U.S. Senate,Matt Silverstein,DEM,260011,3,11,30,44,
Grady,U.S. Senate,Jim Inhofe,REP,260011,8,25,161,194,
Grady,U.S. Senate,Aaron Delozier,IND,260011,0,0,1,1,
Grady,U.S. Senate,Ray Woods,IND,260011,0,1,2,3,
Grady,U.S. Senate,Joan Farr,IND,260011,0,0,1,1,
Grady,U.S. Senate,Connie Johnson,DEM,260011,2,12,32,46,
Grady,U.S. Senate,James Lankford,REP,260011,9,24,161,194,
Grady,U.S. Senate,Mark Beard,IND,260011,0,1,2,3,
Grady,U.S. House,Bert Smith,DEM,260011,3,10,30,43,04
Grady,U.S. House,Tom Cole,REP,260011,8,23,160,191,04
Grady,U.S. House,Dennis Johnson,IND,260011,0,2,5,7,04
Grady,Governor,Joe Dorman,DEM,260016,0,0,46,46,
Grady,Governor,Mary Fallin,REP,260016,1,4,50,55,
Grady,Governor,Kimberly Willis,IND,260016,2,0,3,5,
Grady,Governor,Richard Prawdzienski,IND,260016,1,0,1,2,
Grady,Lieutenant Governor,Cathy Cummings,DEM,260016,1,1,30,32,
Grady,Lieutenant Governor,Todd Lamb,REP,260016,3,3,69,75,
Grady,Superintendent of Public Instruction,John Cox,DEM,260016,1,2,35,38,
Grady,Superintendent of Public Instruction,Joy Hofmeister,REP,260016,3,2,65,70,
Grady,Commissioner of Labor,Mike Workman,DEM,260016,2,2,33,37,
Grady,Commissioner of Labor,Mark Costello,REP,260016,2,2,63,67,
Grady,U.S. Senate,Matt Silverstein,DEM,260016,1,2,15,18,
Grady,U.S. Senate,Jim Inhofe,REP,260016,2,2,85,89,
Grady,U.S. Senate,Aaron Delozier,IND,260016,0,0,0,0,
Grady,U.S. Senate,Ray Woods,IND,260016,1,0,0,1,
Grady,U.S. Senate,Joan Farr,IND,260016,0,0,0,0,
Grady,U.S. Senate,Connie Johnson,DEM,260016,1,3,20,24,
Grady,U.S. Senate,James Lankford,REP,260016,2,1,76,79,
Grady,U.S. Senate,Mark Beard,IND,260016,1,0,4,5,
Grady,U.S. House,Bert Smith,DEM,260016,1,0,17,18,04
Grady,U.S. House,Tom Cole,REP,260016,2,4,79,85,04
Grady,U.S. House,Dennis Johnson,IND,260016,1,0,3,4,04
Grady,Governor,Joe Dorman,DEM,260017,0,2,70,72,
Grady,Governor,Mary Fallin,REP,260017,2,1,88,91,
Grady,Governor,Kimberly Willis,IND,260017,0,0,5,5,
Grady,Governor,Richard Prawdzienski,IND,260017,0,0,1,1,
Grady,Lieutenant Governor,Cathy Cummings,DEM,260017,0,1,50,51,
Grady,Lieutenant Governor,Todd Lamb,REP,260017,2,2,112,116,
Grady,Superintendent of Public Instruction,John Cox,DEM,260017,1,1,77,79,
Grady,Superintendent of Public Instruction,Joy Hofmeister,REP,260017,1,2,86,89,
Grady,Commissioner of Labor,Mike Workman,DEM,260017,0,2,65,67,
Grady,Commissioner of Labor,Mark Costello,REP,260017,2,1,94,97,
Grady,U.S. Senate,Matt Silverstein,DEM,260017,0,1,37,38,
Grady,U.S. Senate,Jim Inhofe,REP,260017,2,2,118,122,
Grady,U.S. Senate,Aaron Delozier,IND,260017,0,0,2,2,
Grady,U.S. Senate,Ray Woods,IND,260017,0,0,1,1,
Grady,U.S. Senate,Joan Farr,IND,260017,0,0,3,3,
Grady,U.S. Senate,Connie Johnson,DEM,260017,0,1,30,31,
Grady,U.S. Senate,James Lankford,REP,260017,2,2,125,129,
Grady,U.S. Senate,Mark Beard,IND,260017,0,0,9,9,
Grady,U.S. House,Bert Smith,DEM,260017,0,0,26,26,04
Grady,U.S. House,Tom Cole,REP,260017,2,3,126,131,04
Grady,U.S. House,Dennis Johnson,IND,260017,0,0,10,10,04
Grady,State House,David Perryman,DEM,260017,0,1,86,87,56
Grady,State House,Chuck Utsler,REP,260017,2,2,76,80,56
Grady,Governor,Joe Dorman,DEM,260020,5,13,110,128,
Grady,Governor,Mary Fallin,REP,260020,3,5,81,89,
Grady,Governor,Kimberly Willis,IND,260020,0,1,1,2,
Grady,Governor,Richard Prawdzienski,IND,260020,0,0,2,2,
Grady,Lieutenant Governor,Cathy Cummings,DEM,260020,3,9,60,72,
Grady,Lieutenant Governor,Todd Lamb,REP,260020,5,10,132,147,
Grady,Superintendent of Public Instruction,John Cox,DEM,260020,6,12,101,119,
Grady,Superintendent of Public Instruction,Joy Hofmeister,REP,260020,2,7,90,99,
Grady,Commissioner of Labor,Mike Workman,DEM,260020,6,13,87,106,
Grady,Commissioner of Labor,Mark Costello,REP,260020,2,6,95,103,
Grady,U.S. Senate,Matt Silverstein,DEM,260020,2,8,51,61,
Grady,U.S. Senate,Jim Inhofe,REP,260020,6,11,136,153,
Grady,U.S. Senate,Aaron Delozier,IND,260020,0,0,1,1,
Grady,U.S. Senate,Ray Woods,IND,260020,0,0,2,2,
Grady,U.S. Senate,Joan Farr,IND,260020,0,0,2,2,
Grady,U.S. Senate,Connie Johnson,DEM,260020,3,9,50,62,
Grady,U.S. Senate,James Lankford,REP,260020,5,9,135,149,
Grady,U.S. Senate,Mark Beard,IND,260020,0,1,9,10,
Grady,U.S. House,Bert Smith,DEM,260020,3,8,48,59,04
Grady,U.S. House,Tom Cole,REP,260020,5,11,140,156,04
Grady,U.S. House,Dennis Johnson,IND,260020,0,0,6,6,04
Grady,Governor,Joe Dorman,DEM,260021,1,4,96,101,
Grady,Governor,Mary Fallin,REP,260021,1,4,72,77,
Grady,Governor,Kimberly Willis,IND,260021,0,1,4,5,
Grady,Governor,Richard Prawdzienski,IND,260021,0,0,1,1,
Grady,Lieutenant Governor,Cathy Cummings,DEM,260021,0,2,49,51,
Grady,Lieutenant Governor,Todd Lamb,REP,260021,2,7,120,129,
Grady,Superintendent of Public Instruction,John Cox,DEM,260021,0,6,85,91,
Grady,Superintendent of Public Instruction,Joy Hofmeister,REP,260021,2,3,86,91,
Grady,Commissioner of Labor,Mike Workman,DEM,260021,0,3,76,79,
Grady,Commissioner of Labor,Mark Costello,REP,260021,2,6,91,99,
Grady,U.S. Senate,Matt Silverstein,DEM,260021,0,1,41,42,
Grady,U.S. Senate,Jim Inhofe,REP,260021,2,7,125,134,
Grady,U.S. Senate,Aaron Delozier,IND,260021,0,0,1,1,
Grady,U.S. Senate,Ray Woods,IND,260021,0,0,1,1,
Grady,U.S. Senate,Joan Farr,IND,260021,0,1,2,3,
Grady,U.S. Senate,Connie Johnson,DEM,260021,0,2,44,46,
Grady,U.S. Senate,James Lankford,REP,260021,2,7,116,125,
Grady,U.S. Senate,Mark Beard,IND,260021,0,0,7,7,
Grady,U.S. House,Bert Smith,DEM,260021,0,2,35,37,04
Grady,U.S. House,Tom Cole,REP,260021,2,7,131,140,04
Grady,U.S. House,Dennis Johnson,IND,260021,0,0,4,4,04
Grady,State House,David Perryman,DEM,260021,0,3,76,79,56
Grady,State House,Chuck Utsler,REP,260021,2,6,96,104,56
Grady,Governor,Joe Dorman,DEM,260023,1,5,55,61,
Grady,Governor,Mary Fallin,REP,260023,0,1,37,38,
Grady,Governor,Kimberly Willis,IND,260023,0,0,1,1,
Grady,Governor,Richard Prawdzienski,IND,260023,0,0,0,0,
Grady,Lieutenant Governor,Cathy Cummings,DEM,260023,1,4,26,31,
Grady,Lieutenant Governor,Todd Lamb,REP,260023,0,2,66,68,
Grady,Superintendent of Public Instruction,John Cox,DEM,260023,0,5,31,36,
Grady,Superintendent of Public Instruction,Joy Hofmeister,REP,260023,1,1,62,64,
Grady,Commissioner of Labor,Mike Workman,DEM,260023,1,4,31,36,
Grady,Commissioner of Labor,Mark Costello,REP,260023,0,2,59,61,
Grady,U.S. Senate,Matt Silverstein,DEM,260023,0,2,19,21,
Grady,U.S. Senate,Jim Inhofe,REP,260023,1,4,70,75,
Grady,U.S. Senate,Aaron Delozier,IND,260023,0,0,2,2,
Grady,U.S. Senate,Ray Woods,IND,260023,0,0,1,1,
Grady,U.S. Senate,Joan Farr,IND,260023,0,0,1,1,
Grady,U.S. Senate,Connie Johnson,DEM,260023,0,2,16,18,
Grady,U.S. Senate,James Lankford,REP,260023,1,4,73,78,
Grady,U.S. Senate,Mark Beard,IND,260023,0,0,4,4,
Grady,U.S. House,Bert Smith,DEM,260023,0,2,14,16,04
Grady,U.S. House,Tom Cole,REP,260023,0,4,75,79,04
Grady,U.S. House,Dennis Johnson,IND,260023,1,0,5,6,04
Grady,Governor,Joe Dorman,DEM,260025,1,13,148,162,
Grady,Governor,Mary Fallin,REP,260025,3,10,143,156,
Grady,Governor,Kimberly Willis,IND,260025,1,0,0,1,
Grady,Governor,Richard Prawdzienski,IND,260025,0,0,2,2,
Grady,Lieutenant Governor,Cathy Cummings,DEM,260025,0,5,76,81,
Grady,Lieutenant Governor,Todd Lamb,REP,260025,5,18,219,242,
Grady,Superintendent of Public Instruction,John Cox,DEM,260025,2,13,133,148,
Grady,Superintendent of Public Instruction,Joy Hofmeister,REP,260025,3,10,158,171,
Grady,Commissioner of Labor,Mike Workman,DEM,260025,0,8,108,116,
Grady,Commissioner of Labor,Mark Costello,REP,260025,5,15,182,202,
Grady,U.S. Senate,Matt Silverstein,DEM,260025,0,8,63,71,
Grady,U.S. Senate,Jim Inhofe,REP,260025,3,15,224,242,
Grady,U.S. Senate,Aaron Delozier,IND,260025,0,0,3,3,
Grady,U.S. Senate,Ray Woods,IND,260025,1,0,4,5,
Grady,U.S. Senate,Joan Farr,IND,260025,1,0,1,2,
Grady,U.S. Senate,Connie Johnson,DEM,260025,0,6,61,67,
Grady,U.S. Senate,James Lankford,REP,260025,5,17,226,248,
Grady,U.S. Senate,Mark Beard,IND,260025,0,0,8,8,
Grady,U.S. House,Bert Smith,DEM,260025,0,6,55,61,04
Grady,U.S. House,Tom Cole,REP,260025,5,16,228,249,04
Grady,U.S. House,Dennis Johnson,IND,260025,0,1,13,14,04
Grady,Governor,Joe Dorman,DEM,260026,6,6,68,80,
Grady,Governor,Mary Fallin,REP,260026,7,0,48,55,
Grady,Governor,Kimberly Willis,IND,260026,0,0,1,1,
Grady,Governor,Richard Prawdzienski,IND,260026,0,0,3,3,
Grady,Lieutenant Governor,Cathy Cummings,DEM,260026,5,1,34,40,
Grady,Lieutenant Governor,Todd Lamb,REP,260026,8,5,86,99,
Grady,Superintendent of Public Instruction,John Cox,DEM,260026,5,3,59,67,
Grady,Superintendent of Public Instruction,Joy Hofmeister,REP,260026,6,3,62,71,
Grady,Commissioner of Labor,Mike Workman,DEM,260026,5,3,55,63,
Grady,Commissioner of Labor,Mark Costello,REP,260026,7,3,64,74,
Grady,U.S. Senate,Matt Silverstein,DEM,260026,3,2,30,35,
Grady,U.S. Senate,Jim Inhofe,REP,260026,10,4,84,98,
Grady,U.S. Senate,Aaron Delozier,IND,260026,0,0,3,3,
Grady,U.S. Senate,Ray Woods,IND,260026,0,0,2,2,
Grady,U.S. Senate,Joan Farr,IND,260026,0,0,1,1,
Grady,U.S. Senate,Connie Johnson,DEM,260026,2,0,32,34,
Grady,U.S. Senate,James Lankford,REP,260026,11,5,82,98,
Grady,U.S. Senate,Mark Beard,IND,260026,0,1,5,6,
Grady,U.S. House,Bert Smith,DEM,260026,2,0,27,29,04
Grady,U.S. House,Tom Cole,REP,260026,11,5,86,102,04
Grady,U.S. House,Dennis Johnson,IND,260026,0,1,7,8,04
Grady,Governor,Joe Dorman,DEM,260027,3,9,102,114,
Grady,Governor,Mary Fallin,REP,260027,1,25,107,133,
Grady,Governor,Kimberly Willis,IND,260027,2,0,3,5,
Grady,Governor,Richard Prawdzienski,IND,260027,0,0,1,1,
Grady,Lieutenant Governor,Cathy Cummings,DEM,260027,4,7,45,56,
Grady,Lieutenant Governor,Todd Lamb,REP,260027,2,27,168,197,
Grady,Superintendent of Public Instruction,John Cox,DEM,260027,2,10,99,111,
Grady,Superintendent of Public Instruction,Joy Hofmeister,REP,260027,4,24,114,142,
Grady,Commissioner of Labor,Mike Workman,DEM,260027,2,7,75,84,
Grady,Commissioner of Labor,Mark Costello,REP,260027,4,26,133,163,
Grady,U.S. Senate,Matt Silverstein,DEM,260027,2,7,45,54,
Grady,U.S. Senate,Jim Inhofe,REP,260027,4,27,160,191,
Grady,U.S. Senate,Aaron Delozier,IND,260027,0,0,2,2,
Grady,U.S. Senate,Ray Woods,IND,260027,0,0,2,2,
Grady,U.S. Senate,Joan Farr,IND,260027,0,0,2,2,
Grady,U.S. Senate,Connie Johnson,DEM,260027,3,6,36,45,
Grady,U.S. Senate,James Lankford,REP,260027,2,28,167,197,
Grady,U.S. Senate,Mark Beard,IND,260027,1,0,10,11,
Grady,U.S. House,Bert Smith,DEM,260027,3,5,39,47,04
Grady,U.S. House,Tom Cole,REP,260027,3,28,160,191,04
Grady,U.S. House,Dennis Johnson,IND,260027,0,1,14,15,04
Grady,State House,David Perryman,DEM,260027,3,10,90,103,56
Grady,State House,Chuck Utsler,REP,260027,3,24,123,150,56
Grady,Governor,Joe Dorman,DEM,260028,7,7,165,179,
Grady,Governor,Mary Fallin,REP,260028,15,4,275,294,
Grady,Governor,Kimberly Willis,IND,260028,0,0,11,11,
Grady,Governor,Richard Prawdzienski,IND,260028,0,0,4,4,
Grady,Lieutenant Governor,Cathy Cummings,DEM,260028,6,3,90,99,
Grady,Lieutenant Governor,Todd Lamb,REP,260028,16,8,361,385,
Grady,Superintendent of Public Instruction,John Cox,DEM,260028,11,5,178,194,
Grady,Superintendent of Public Instruction,Joy Hofmeister,REP,260028,11,6,272,289,
Grady,Commissioner of Labor,Mike Workman,DEM,260028,7,4,115,126,
Grady,Commissioner of Labor,Mark Costello,REP,260028,15,7,328,350,
Grady,U.S. Senate,Matt Silverstein,DEM,260028,7,3,76,86,
Grady,U.S. Senate,Jim Inhofe,REP,260028,14,8,356,378,
Grady,U.S. Senate,Aaron Delozier,IND,260028,0,0,6,6,
Grady,U.S. Senate,Ray Woods,IND,260028,0,0,8,8,
Grady,U.S. Senate,Joan Farr,IND,260028,1,0,3,4,
Grady,U.S. Senate,Connie Johnson,DEM,260028,7,2,75,84,
Grady,U.S. Senate,James Lankford,REP,260028,15,9,364,388,
Grady,U.S. Senate,Mark Beard,IND,260028,0,0,15,15,
Grady,U.S. House,Bert Smith,DEM,260028,7,3,76,86,04
Grady,U.S. House,Tom Cole,REP,260028,13,8,355,376,04
Grady,U.S. House,Dennis Johnson,IND,260028,2,0,22,24,04
Grady,Governor,Joe Dorman,DEM,260029,8,4,269,281,
Grady,Governor,Mary Fallin,REP,260029,16,10,467,493,
Grady,Governor,Kimberly Willis,IND,260029,0,0,16,16,
Grady,Governor,Richard Prawdzienski,IND,260029,0,0,6,6,
Grady,Lieutenant Governor,Cathy Cummings,DEM,260029,5,2,150,157,
Grady,Lieutenant Governor,Todd Lamb,REP,260029,19,12,604,635,
Grady,Superintendent of Public Instruction,John Cox,DEM,260029,8,3,323,334,
Grady,Superintendent of Public Instruction,Joy Hofmeister,REP,260029,16,11,429,456,
Grady,Commissioner of Labor,Mike Workman,DEM,260029,7,1,249,257,
Grady,Commissioner of Labor,Mark Costello,REP,260029,16,13,487,516,
Grady,U.S. Senate,Matt Silverstein,DEM,260029,4,2,135,141,
Grady,U.S. Senate,Jim Inhofe,REP,260029,20,12,595,627,
Grady,U.S. Senate,Aaron Delozier,IND,260029,0,0,3,3,
Grady,U.S. Senate,Ray Woods,IND,260029,0,0,15,15,
Grady,U.S. Senate,Joan Farr,IND,260029,0,0,4,4,
Grady,U.S. Senate,Connie Johnson,DEM,260029,4,0,128,132,
Grady,U.S. Senate,James Lankford,REP,260029,20,14,611,645,
Grady,U.S. Senate,Mark Beard,IND,260029,0,0,19,19,
Grady,U.S. House,Bert Smith,DEM,260029,4,0,127,131,04
Grady,U.S. House,Tom Cole,REP,260029,20,14,606,640,04
Grady,U.S. House,Dennis Johnson,IND,260029,0,0,18,18,04
Grady,State House,David Perryman,DEM,260029,6,2,261,269,56
Grady,State House,Chuck Utsler,REP,260029,17,12,497,526,56
Grady,Governor,Joe Dorman,DEM,260031,1,3,92,96,
Grady,Governor,Mary Fallin,REP,260031,2,4,154,160,
Grady,Governor,Kimberly Willis,IND,260031,0,0,3,3,
Grady,Governor,Richard Prawdzienski,IND,260031,0,0,1,1,
Grady,Lieutenant Governor,Cathy Cummings,DEM,260031,1,1,56,58,
Grady,Lieutenant Governor,Todd Lamb,REP,260031,2,6,194,202,
Grady,Superintendent of Public Instruction,John Cox,DEM,260031,2,2,103,107,
Grady,Superintendent of Public Instruction,Joy Hofmeister,REP,260031,1,5,144,150,
Grady,Commissioner of Labor,Mike Workman,DEM,260031,2,2,84,88,
Grady,Commissioner of Labor,Mark Costello,REP,260031,1,3,160,164,
Grady,U.S. Senate,Matt Silverstein,DEM,260031,0,1,43,44,
Grady,U.S. Senate,Jim Inhofe,REP,260031,3,5,201,209,
Grady,U.S. Senate,Aaron Delozier,IND,260031,0,0,2,2,
Grady,U.S. Senate,Ray Woods,IND,260031,0,0,0,0,
Grady,U.S. Senate,Joan Farr,IND,260031,0,0,5,5,
Grady,U.S. Senate,Connie Johnson,DEM,260031,0,2,52,54,
Grady,U.S. Senate,James Lankford,REP,260031,2,5,189,196,
Grady,U.S. Senate,Mark Beard,IND,260031,1,0,10,11,
Grady,U.S. House,Bert Smith,DEM,260031,0,1,49,50,04
Grady,U.S. House,Tom Cole,REP,260031,2,5,194,201,04
Grady,U.S. House,Dennis Johnson,IND,260031,0,0,8,8,04
Grady,Governor,Joe Dorman,DEM,260032,10,12,260,282,
Grady,Governor,Mary Fallin,REP,260032,9,32,233,274,
Grady,Governor,Kimberly Willis,IND,260032,0,0,6,6,
Grady,Governor,Richard Prawdzienski,IND,260032,0,0,5,5,
Grady,Lieutenant Governor,Cathy Cummings,DEM,260032,6,8,147,161,
Grady,Lieutenant Governor,Todd Lamb,REP,260032,13,36,352,401,
Grady,Superintendent of Public Instruction,John Cox,DEM,260032,7,16,229,252,
Grady,Superintendent of Public Instruction,Joy Hofmeister,REP,260032,12,28,273,313,
Grady,Commissioner of Labor,Mike Workman,DEM,260032,6,8,197,211,
Grady,Commissioner of Labor,Mark Costello,REP,260032,12,34,286,332,
Grady,U.S. Senate,Matt Silverstein,DEM,260032,3,7,106,116,
Grady,U.S. Senate,Jim Inhofe,REP,260032,14,37,378,429,
Grady,U.S. Senate,Aaron Delozier,IND,260032,0,0,5,5,
Grady,U.S. Senate,Ray Woods,IND,260032,0,0,4,4,
Grady,U.S. Senate,Joan Farr,IND,260032,1,0,7,8,
Grady,U.S. Senate,Connie Johnson,DEM,260032,1,6,127,134,
Grady,U.S. Senate,James Lankford,REP,260032,15,36,343,394,
Grady,U.S. Senate,Mark Beard,IND,260032,3,1,33,37,
Grady,U.S. House,Bert Smith,DEM,260032,3,7,97,107,04
Grady,U.S. House,Tom Cole,REP,260032,15,37,386,438,04
Grady,U.S. House,Dennis Johnson,IND,260032,1,0,20,21,04
Grady,Governor,Joe Dorman,DEM,260033,0,7,69,76,
Grady,Governor,Mary Fallin,REP,260033,3,6,60,69,
Grady,Governor,Kimberly Willis,IND,260033,0,0,3,3,
Grady,Governor,Richard Prawdzienski,IND,260033,0,0,1,1,
Grady,Lieutenant Governor,Cathy Cummings,DEM,260033,0,4,47,51,
Grady,Lieutenant Governor,Todd Lamb,REP,260033,3,7,87,97,
Grady,Superintendent of Public Instruction,John Cox,DEM,260033,1,7,69,77,
Grady,Superintendent of Public Instruction,Joy Hofmeister,REP,260033,2,4,65,71,
Grady,Commissioner of Labor,Mike Workman,DEM,260033,0,4,54,58,
Grady,Commissioner of Labor,Mark Costello,REP,260033,3,6,79,88,
Grady,U.S. Senate,Matt Silverstein,DEM,260033,0,6,31,37,
Grady,U.S. Senate,Jim Inhofe,REP,260033,3,5,96,104,
Grady,U.S. Senate,Aaron Delozier,IND,260033,0,0,0,0,
Grady,U.S. Senate,Ray Woods,IND,260033,0,0,3,3,
Grady,U.S. Senate,Joan Farr,IND,260033,0,0,2,2,
Grady,U.S. Senate,Connie Johnson,DEM,260033,0,5,31,36,
Grady,U.S. Senate,James Lankford,REP,260033,3,5,95,103,
Grady,U.S. Senate,Mark Beard,IND,260033,0,1,8,9,
Grady,U.S. House,Bert Smith,DEM,260033,0,3,36,39,04
Grady,U.S. House,Tom Cole,REP,260033,3,7,95,105,04
Grady,U.S. House,Dennis Johnson,IND,260033,0,0,2,2,04
Grady,State House,David Perryman,DEM,260033,0,8,81,89,56
Grady,State House,Chuck Utsler,REP,260033,3,5,53,61,56
Grady,Governor,Joe Dorman,DEM,260035,0,2,41,43,
Grady,Governor,Mary Fallin,REP,260035,0,1,53,54,
Grady,Governor,Kimberly Willis,IND,260035,0,0,1,1,
Grady,Governor,Richard Prawdzienski,IND,260035,0,0,2,2,
Grady,Lieutenant Governor,Cathy Cummings,DEM,260035,0,0,20,20,
Grady,Lieutenant Governor,Todd Lamb,REP,260035,0,3,74,77,
Grady,Superintendent of Public Instruction,John Cox,DEM,260035,0,2,34,36,
Grady,Superintendent of Public Instruction,Joy Hofmeister,REP,260035,0,1,61,62,
Grady,Commissioner of Labor,Mike Workman,DEM,260035,0,1,36,37,
Grady,Commissioner of Labor,Mark Costello,REP,260035,0,2,57,59,
Grady,U.S. Senate,Matt Silverstein,DEM,260035,0,1,14,15,
Grady,U.S. Senate,Jim Inhofe,REP,260035,0,2,79,81,
Grady,U.S. Senate,Aaron Delozier,IND,260035,0,0,0,0,
Grady,U.S. Senate,Ray Woods,IND,260035,0,0,0,0,
Grady,U.S. Senate,Joan Farr,IND,260035,0,0,2,2,
Grady,U.S. Senate,Connie Johnson,DEM,260035,0,1,18,19,
Grady,U.S. Senate,James Lankford,REP,260035,0,2,75,77,
Grady,U.S. Senate,Mark Beard,IND,260035,0,0,3,3,
Grady,U.S. House,Bert Smith,DEM,260035,0,0,16,16,04
Grady,U.S. House,Tom Cole,REP,260035,0,3,75,78,04
Grady,U.S. House,Dennis Johnson,IND,260035,0,0,4,4,04
Grady,State House,David Perryman,DEM,260035,0,1,21,22,56
Grady,State House,Chuck Utsler,REP,260035,0,2,75,77,56
Grady,Governor,Joe Dorman,DEM,260036,27,18,662,707,
Grady,Governor,Mary Fallin,REP,260036,8,9,265,282,
Grady,Governor,Kimberly Willis,IND,260036,0,1,6,7,
Grady,Governor,Richard Prawdzienski,IND,260036,0,0,3,3,
Grady,Lieutenant Governor,Cathy Cummings,DEM,260036,20,10,337,367,
Grady,Lieutenant Governor,Todd Lamb,REP,260036,15,18,583,616,
Grady,Superintendent of Public Instruction,John Cox,DEM,260036,19,14,504,537,
Grady,Superintendent of Public Instruction,Joy Hofmeister,REP,260036,15,14,415,444,
Grady,Commissioner of Labor,Mike Workman,DEM,260036,22,12,423,457,
Grady,Commissioner of Labor,Mark Costello,REP,260036,13,16,480,509,
Grady,U.S. Senate,Matt Silverstein,DEM,260036,16,4,245,265,
Grady,U.S. Senate,Jim Inhofe,REP,260036,18,22,634,674,
Grady,U.S. Senate,Aaron Delozier,IND,260036,0,0,7,7,
Grady,U.S. Senate,Ray Woods,IND,260036,1,2,20,23,
Grady,U.S. Senate,Joan Farr,IND,260036,0,0,15,15,
Grady,U.S. Senate,Connie Johnson,DEM,260036,15,5,245,265,
Grady,U.S. Senate,James Lankford,REP,260036,19,21,614,654,
Grady,U.S. Senate,Mark Beard,IND,260036,0,2,61,63,
Grady,U.S. House,Bert Smith,DEM,260036,15,6,222,243,04
Grady,U.S. House,Tom Cole,REP,260036,19,18,655,692,04
Grady,U.S. House,Dennis Johnson,IND,260036,1,4,46,51,04
Grady,State House,Toni Hasenbeck,DEM,260036,25,17,528,570,65
Grady,State House,Scooter Park,REP,260036,10,11,394,415,65
Grady,Governor,Joe Dorman,DEM,260037,18,7,272,297,
Grady,Governor,Mary Fallin,REP,260037,50,34,760,844,
Grady,Governor,Kimberly Willis,IND,260037,0,1,24,25,
Grady,Governor,Richard Prawdzienski,IND,260037,2,0,16,18,
Grady,Lieutenant Governor,Cathy Cummings,DEM,260037,16,4,167,187,
Grady,Lieutenant Governor,Todd Lamb,REP,260037,54,38,904,996,
Grady,Superintendent of Public Instruction,John Cox,DEM,260037,19,13,307,339,
Grady,Superintendent of Public Instruction,Joy Hofmeister,REP,260037,51,29,759,839,
Grady,Commissioner of Labor,Mike Workman,DEM,260037,18,6,211,235,
Grady,Commissioner of Labor,Mark Costello,REP,260037,52,35,841,928,
Grady,U.S. Senate,Matt Silverstein,DEM,260037,16,5,134,155,
Grady,U.S. Senate,Jim Inhofe,REP,260037,52,37,898,987,
Grady,U.S. Senate,Aaron Delozier,IND,260037,1,0,6,7,
Grady,U.S. Senate,Ray Woods,IND,260037,0,0,16,16,
Grady,U.S. Senate,Joan Farr,IND,260037,1,0,15,16,
Grady,U.S. Senate,Connie Johnson,DEM,260037,13,3,138,154,
Grady,U.S. Senate,James Lankford,REP,260037,57,39,900,996,
Grady,U.S. Senate,Mark Beard,IND,260037,0,0,35,35,
Grady,U.S. House,Bert Smith,DEM,260037,12,2,121,135,04
Grady,U.S. House,Tom Cole,REP,260037,56,40,903,999,04
Grady,U.S. House,Dennis Johnson,IND,260037,2,0,50,52,04
Grady,Governor,Joe Dorman,DEM,260038,5,5,248,258,
Grady,Governor,Mary Fallin,REP,260038,21,8,547,576,
Grady,Governor,Kimberly Willis,IND,260038,2,0,20,22,
Grady,Governor,Richard Prawdzienski,IND,260038,0,0,6,6,
Grady,Lieutenant Governor,Cathy Cummings,DEM,260038,6,1,168,175,
Grady,Lieutenant Governor,Todd Lamb,REP,260038,22,12,652,686,
Grady,Superintendent of Public Instruction,John Cox,DEM,260038,7,4,289,300,
Grady,Superintendent of Public Instruction,Joy Hofmeister,REP,260038,21,9,526,556,
Grady,Commissioner of Labor,Mike Workman,DEM,260038,8,2,213,223,
Grady,Commissioner of Labor,Mark Costello,REP,260038,20,11,599,630,
Grady,U.S. Senate,Matt Silverstein,DEM,260038,5,1,145,151,
Grady,U.S. Senate,Jim Inhofe,REP,260038,23,12,639,674,
Grady,U.S. Senate,Aaron Delozier,IND,260038,0,0,15,15,
Grady,U.S. Senate,Ray Woods,IND,260038,0,0,10,10,
Grady,U.S. Senate,Joan Farr,IND,260038,0,0,6,6,
Grady,U.S. Senate,Connie Johnson,DEM,260038,6,0,133,139,
Grady,U.S. Senate,James Lankford,REP,260038,22,13,657,692,
Grady,U.S. Senate,Mark Beard,IND,260038,0,0,29,29,
Grady,U.S. House,Bert Smith,DEM,260038,4,0,120,124,04
Grady,U.S. House,Tom Cole,REP,260038,24,13,650,687,04
Grady,U.S. House,Dennis Johnson,IND,260038,0,0,47,47,04
Grady,Governor,Joe Dorman,DEM,260039,4,5,186,195,
Grady,Governor,Mary Fallin,REP,260039,6,21,381,408,
Grady,Governor,Kimberly Willis,IND,260039,0,0,12,12,
Grady,Governor,Richard Prawdzienski,IND,260039,0,0,7,7,
Grady,Lieutenant Governor,Cathy Cummings,DEM,260039,2,1,103,106,
Grady,Lieutenant Governor,Todd Lamb,REP,260039,8,25,478,511,
Grady,Superintendent of Public Instruction,John Cox,DEM,260039,4,2,211,217,
Grady,Superintendent of Public Instruction,Joy Hofmeister,REP,260039,6,24,370,400,
Grady,Commissioner of Labor,Mike Workman,DEM,260039,3,1,135,139,
Grady,Commissioner of Labor,Mark Costello,REP,260039,7,24,431,462,
Grady,U.S. Senate,Matt Silverstein,DEM,260039,1,3,88,92,
Grady,U.S. Senate,Jim Inhofe,REP,260039,9,23,479,511,
Grady,U.S. Senate,Aaron Delozier,IND,260039,0,0,3,3,
Grady,U.S. Senate,Ray Woods,IND,260039,0,0,8,8,
Grady,U.S. Senate,Joan Farr,IND,260039,0,0,5,5,
Grady,U.S. Senate,Connie Johnson,DEM,260039,1,2,85,88,
Grady,U.S. Senate,James Lankford,REP,260039,9,24,482,515,
Grady,U.S. Senate,Mark Beard,IND,260039,0,0,16,16,
Grady,U.S. House,Bert Smith,DEM,260039,0,2,68,70,04
Grady,U.S. House,Tom Cole,REP,260039,10,23,492,525,04
Grady,U.S. House,Dennis Johnson,IND,260039,0,1,23,24,04
Grady,Governor,Joe Dorman,DEM,260040,16,5,288,309,
Grady,Governor,Mary Fallin,REP,260040,23,11,540,574,
Grady,Governor,Kimberly Willis,IND,260040,0,0,15,15,
Grady,Governor,Richard Prawdzienski,IND,260040,1,0,17,18,
Grady,Lieutenant Governor,Cathy Cummings,DEM,260040,13,1,169,183,
Grady,Lieutenant Governor,Todd Lamb,REP,260040,27,15,686,728,
Grady,Superintendent of Public Instruction,John Cox,DEM,260040,15,4,300,319,
Grady,Superintendent of Public Instruction,Joy Hofmeister,REP,260040,25,12,550,587,
Grady,Commissioner of Labor,Mike Workman,DEM,260040,13,2,208,223,
Grady,Commissioner of Labor,Mark Costello,REP,260040,25,14,628,667,
Grady,U.S. Senate,Matt Silverstein,DEM,260040,11,3,133,147,
Grady,U.S. Senate,Jim Inhofe,REP,260040,30,13,700,743,
Grady,U.S. Senate,Aaron Delozier,IND,260040,0,0,4,4,
Grady,U.S. Senate,Ray Woods,IND,260040,0,0,9,9,
Grady,U.S. Senate,Joan Farr,IND,260040,1,0,6,7,
Grady,U.S. Senate,Connie Johnson,DEM,260040,10,1,128,139,
Grady,U.S. Senate,James Lankford,REP,260040,31,15,703,749,
Grady,U.S. Senate,Mark Beard,IND,260040,1,0,25,26,
Grady,U.S. House,Bert Smith,DEM,260040,10,2,121,133,04
Grady,U.S. House,Tom Cole,REP,260040,30,13,705,748,04
Grady,U.S. House,Dennis Johnson,IND,260040,2,1,29,32,04
Grady,Governor,Joe Dorman,DEM,260041,5,4,274,283,
Grady,Governor,Mary Fallin,REP,260041,25,11,581,617,
Grady,Governor,Kimberly Willis,IND,260041,1,0,21,22,
Grady,Governor,Richard Prawdzienski,IND,260041,0,1,10,11,
Grady,Lieutenant Governor,Cathy Cummings,DEM,260041,7,0,171,178,
Grady,Lieutenant Governor,Todd Lamb,REP,260041,25,16,712,753,
Grady,Superintendent of Public Instruction,John Cox,DEM,260041,8,3,315,326,
Grady,Superintendent of Public Instruction,Joy Hofmeister,REP,260041,23,13,572,608,
Grady,Commissioner of Labor,Mike Workman,DEM,260041,6,4,212,222,
Grady,Commissioner of Labor,Mark Costello,REP,260041,24,12,651,687,
Grady,U.S. Senate,Matt Silverstein,DEM,260041,3,1,159,163,
Grady,U.S. Senate,Jim Inhofe,REP,260041,25,15,695,735,
Grady,U.S. Senate,Aaron Delozier,IND,260041,0,0,3,3,
Grady,U.S. Senate,Ray Woods,IND,260041,3,0,20,23,
Grady,U.S. Senate,Joan Farr,IND,260041,1,0,8,9,
Grady,U.S. Senate,Connie Johnson,DEM,260041,3,1,150,154,
Grady,U.S. Senate,James Lankford,REP,260041,26,15,712,753,
Grady,U.S. Senate,Mark Beard,IND,260041,3,0,27,30,
Grady,U.S. House,Bert Smith,DEM,260041,3,0,134,137,04
Grady,U.S. House,Tom Cole,REP,260041,24,15,713,752,04
Grady,U.S. House,Dennis Johnson,IND,260041,5,1,34,40,04
Grant,Governor,Joe Dorman,DEM,270011,0,3,36,39,
Grant,Governor,Mary Fallin,REP,270011,1,1,46,48,
Grant,Governor,Kimberly Willis,IND,270011,0,0,1,1,
Grant,Governor,Richard Prawdzienski,IND,270011,0,0,1,1,
Grant,Lieutenant Governor,Cathy Cummings,DEM,270011,0,2,17,19,
Grant,Lieutenant Governor,Todd Lamb,REP,270011,1,2,67,70,
Grant,Superintendent of Public Instruction,John Cox,DEM,270011,0,2,40,42,
Grant,Superintendent of Public Instruction,Joy Hofmeister,REP,270011,1,2,42,45,
Grant,Commissioner of Labor,Mike Workman,DEM,270011,0,2,35,37,
Grant,Commissioner of Labor,Mark Costello,REP,270011,1,2,46,49,
Grant,U.S. Senate,Matt Silverstein,DEM,270011,0,1,17,18,
Grant,U.S. Senate,Jim Inhofe,REP,270011,1,3,64,68,
Grant,U.S. Senate,Aaron Delozier,IND,270011,0,0,2,2,
Grant,U.S. Senate,Ray Woods,IND,270011,0,0,0,0,
Grant,U.S. Senate,Joan Farr,IND,270011,0,0,1,1,
Grant,U.S. Senate,Connie Johnson,DEM,270011,0,3,23,26,
Grant,U.S. Senate,James Lankford,REP,270011,1,1,57,59,
Grant,U.S. Senate,Mark Beard,IND,270011,0,0,3,3,
Grant,U.S. House,Frankie Robbins,DEM,270011,0,1,18,19,03
Grant,U.S. House,Frank Lucas,REP,270011,1,3,66,70,03
Grant,Governor,Joe Dorman,DEM,270017,1,0,71,72,
Grant,Governor,Mary Fallin,REP,270017,6,9,128,143,
Grant,Governor,Kimberly Willis,IND,270017,0,0,4,4,
Grant,Governor,Richard Prawdzienski,IND,270017,0,0,0,0,
Grant,Lieutenant Governor,Cathy Cummings,DEM,270017,0,0,21,21,
Grant,Lieutenant Governor,Todd Lamb,REP,270017,7,10,183,200,
Grant,Superintendent of Public Instruction,John Cox,DEM,270017,1,3,70,74,
Grant,Superintendent of Public Instruction,Joy Hofmeister,REP,270017,6,7,134,147,
Grant,Commissioner of Labor,Mike Workman,DEM,270017,1,0,37,38,
Grant,Commissioner of Labor,Mark Costello,REP,270017,6,10,159,175,
Grant,U.S. Senate,Matt Silverstein,DEM,270017,0,0,15,15,
Grant,U.S. Senate,Jim Inhofe,REP,270017,6,10,183,199,
Grant,U.S. Senate,Aaron Delozier,IND,270017,0,0,1,1,
Grant,U.S. Senate,Ray Woods,IND,270017,1,0,3,4,
Grant,U.S. Senate,Joan Farr,IND,270017,0,0,0,0,
Grant,U.S. Senate,Connie Johnson,DEM,270017,1,1,22,24,
Grant,U.S. Senate,James Lankford,REP,270017,6,9,178,193,
Grant,U.S. Senate,Mark Beard,IND,270017,0,0,4,4,
Grant,U.S. House,Frankie Robbins,DEM,270017,1,0,24,25,03
Grant,U.S. House,Frank Lucas,REP,270017,6,10,180,196,03
Grant,Governor,Joe Dorman,DEM,270023,5,3,154,162,
Grant,Governor,Mary Fallin,REP,270023,3,6,213,222,
Grant,Governor,Kimberly Willis,IND,270023,1,0,12,13,
Grant,Governor,Richard Prawdzienski,IND,270023,0,0,7,7,
Grant,Lieutenant Governor,Cathy Cummings,DEM,270023,3,1,52,56,
Grant,Lieutenant Governor,Todd Lamb,REP,270023,6,8,332,346,
Grant,Superintendent of Public Instruction,John Cox,DEM,270023,4,3,177,184,
Grant,Superintendent of Public Instruction,Joy Hofmeister,REP,270023,5,6,207,218,
Grant,Commissioner of Labor,Mike Workman,DEM,270023,1,3,105,109,
Grant,Commissioner of Labor,Mark Costello,REP,270023,5,6,275,286,
Grant,U.S. Senate,Matt Silverstein,DEM,270023,1,1,50,52,
Grant,U.S. Senate,Jim Inhofe,REP,270023,7,8,322,337,
Grant,U.S. Senate,Aaron Delozier,IND,270023,0,0,3,3,
Grant,U.S. Senate,Ray Woods,IND,270023,0,0,4,4,
Grant,U.S. Senate,Joan Farr,IND,270023,0,0,5,5,
Grant,U.S. Senate,Connie Johnson,DEM,270023,2,1,58,61,
Grant,U.S. Senate,James Lankford,REP,270023,6,8,313,327,
Grant,U.S. Senate,Mark Beard,IND,270023,0,0,13,13,
Grant,U.S. House,Frankie Robbins,DEM,270023,1,2,63,66,03
Grant,U.S. House,Frank Lucas,REP,270023,8,7,320,335,03
Grant,Governor,Joe Dorman,DEM,270025,6,4,62,72,
Grant,Governor,Mary Fallin,REP,270025,13,7,131,151,
Grant,Governor,Kimberly Willis,IND,270025,1,0,8,9,
Grant,Governor,Richard Prawdzienski,IND,270025,0,0,0,0,
Grant,Lieutenant Governor,Cathy Cummings,DEM,270025,6,1,36,43,
Grant,Lieutenant Governor,Todd Lamb,REP,270025,14,10,161,185,
Grant,Superintendent of Public Instruction,John Cox,DEM,270025,6,5,71,82,
Grant,Superintendent of Public Instruction,Joy Hofmeister,REP,270025,14,6,130,150,
Grant,Commissioner of Labor,Mike Workman,DEM,270025,7,4,57,68,
Grant,Commissioner of Labor,Mark Costello,REP,270025,13,6,140,159,
Grant,U.S. Senate,Matt Silverstein,DEM,270025,6,5,35,46,
Grant,U.S. Senate,Jim Inhofe,REP,270025,12,6,162,180,
Grant,U.S. Senate,Aaron Delozier,IND,270025,0,0,0,0,
Grant,U.S. Senate,Ray Woods,IND,270025,0,0,0,0,
Grant,U.S. Senate,Joan Farr,IND,270025,2,0,3,5,
Grant,U.S. Senate,Connie Johnson,DEM,270025,7,3,42,52,
Grant,U.S. Senate,James Lankford,REP,270025,12,7,155,174,
Grant,U.S. Senate,Mark Beard,IND,270025,1,1,3,5,
Grant,U.S. House,Frankie Robbins,DEM,270025,7,3,43,53,03
Grant,U.S. House,Frank Lucas,REP,270025,13,8,158,179,03
Grant,Governor,Joe Dorman,DEM,270026,1,1,63,65,
Grant,Governor,Mary Fallin,REP,270026,1,0,103,104,
Grant,Governor,Kimberly Willis,IND,270026,0,0,8,8,
Grant,Governor,Richard Prawdzienski,IND,270026,0,0,2,2,
Grant,Lieutenant Governor,Cathy Cummings,DEM,270026,1,0,25,26,
Grant,Lieutenant Governor,Todd Lamb,REP,270026,1,1,150,152,
Grant,Superintendent of Public Instruction,John Cox,DEM,270026,1,1,73,75,
Grant,Superintendent of Public Instruction,Joy Hofmeister,REP,270026,1,0,101,102,
Grant,Commissioner of Labor,Mike Workman,DEM,270026,1,0,45,46,
Grant,Commissioner of Labor,Mark Costello,REP,270026,1,1,129,131,
Grant,U.S. Senate,Matt Silverstein,DEM,270026,1,1,25,27,
Grant,U.S. Senate,Jim Inhofe,REP,270026,1,0,143,144,
Grant,U.S. Senate,Aaron Delozier,IND,270026,0,0,1,1,
Grant,U.S. Senate,Ray Woods,IND,270026,0,0,3,3,
Grant,U.S. Senate,Joan Farr,IND,270026,0,0,2,2,
Grant,U.S. Senate,Connie Johnson,DEM,270026,1,0,21,22,
Grant,U.S. Senate,James Lankford,REP,270026,1,1,148,150,
Grant,U.S. Senate,Mark Beard,IND,270026,0,0,6,6,
Grant,U.S. House,Frankie Robbins,DEM,270026,1,1,26,28,03
Grant,U.S. House,Frank Lucas,REP,270026,1,0,148,149,03
Grant,Governor,Joe Dorman,DEM,270029,2,4,43,49,
Grant,Governor,Mary Fallin,REP,270029,2,12,97,111,
Grant,Governor,Kimberly Willis,IND,270029,0,0,2,2,
Grant,Governor,Richard Prawdzienski,IND,270029,0,0,2,2,
Grant,Lieutenant Governor,Cathy Cummings,DEM,270029,1,1,16,18,
Grant,Lieutenant Governor,Todd Lamb,REP,270029,3,15,127,145,
Grant,Superintendent of Public Instruction,John Cox,DEM,270029,1,5,51,57,
Grant,Superintendent of Public Instruction,Joy Hofmeister,REP,270029,3,10,91,104,
Grant,Commissioner of Labor,Mike Workman,DEM,270029,2,4,32,38,
Grant,Commissioner of Labor,Mark Costello,REP,270029,2,9,106,117,
Grant,U.S. Senate,Matt Silverstein,DEM,270029,0,2,18,20,
Grant,U.S. Senate,Jim Inhofe,REP,270029,3,13,118,134,
Grant,U.S. Senate,Aaron Delozier,IND,270029,0,0,1,1,
Grant,U.S. Senate,Ray Woods,IND,270029,0,0,1,1,
Grant,U.S. Senate,Joan Farr,IND,270029,0,0,3,3,
Grant,U.S. Senate,Connie Johnson,DEM,270029,0,3,24,27,
Grant,U.S. Senate,James Lankford,REP,270029,3,13,112,128,
Grant,U.S. Senate,Mark Beard,IND,270029,0,0,7,7,
Grant,U.S. House,Frankie Robbins,DEM,270029,0,3,34,37,03
Grant,U.S. House,Frank Lucas,REP,270029,3,12,110,125,03
Grant,Governor,Joe Dorman,DEM,270030,9,16,74,99,
Grant,Governor,Mary Fallin,REP,270030,6,25,169,200,
Grant,Governor,Kimberly Willis,IND,270030,0,0,9,9,
Grant,Governor,Richard Prawdzienski,IND,270030,0,1,2,3,
Grant,Lieutenant Governor,Cathy Cummings,DEM,270030,6,11,45,62,
Grant,Lieutenant Governor,Todd Lamb,REP,270030,9,31,207,247,
Grant,Superintendent of Public Instruction,John Cox,DEM,270030,8,14,90,112,
Grant,Superintendent of Public Instruction,Joy Hofmeister,REP,270030,6,27,161,194,
Grant,Commissioner of Labor,Mike Workman,DEM,270030,8,15,69,92,
Grant,Commissioner of Labor,Mark Costello,REP,270030,7,24,176,207,
Grant,U.S. Senate,Matt Silverstein,DEM,270030,6,9,34,49,
Grant,U.S. Senate,Jim Inhofe,REP,270030,9,30,201,240,
Grant,U.S. Senate,Aaron Delozier,IND,270030,0,1,4,5,
Grant,U.S. Senate,Ray Woods,IND,270030,0,0,6,6,
Grant,U.S. Senate,Joan Farr,IND,270030,0,1,6,7,
Grant,U.S. Senate,Connie Johnson,DEM,270030,6,8,39,53,
Grant,U.S. Senate,James Lankford,REP,270030,9,32,204,245,
Grant,U.S. Senate,Mark Beard,IND,270030,0,2,10,12,
Grant,U.S. House,Frankie Robbins,DEM,270030,7,19,72,98,03
Grant,U.S. House,Frank Lucas,REP,270030,8,23,182,213,03
Greer,Governor,Joe Dorman,DEM,280101,0,24,123,147,
Greer,Governor,Mary Fallin,REP,280101,13,46,169,228,
Greer,Governor,Kimberly Willis,IND,280101,1,1,9,11,
Greer,Governor,Richard Prawdzienski,IND,280101,0,1,8,9,
Greer,Lieutenant Governor,Cathy Cummings,DEM,280101,0,18,102,120,
Greer,Lieutenant Governor,Todd Lamb,REP,280101,14,52,205,271,
Greer,Superintendent of Public Instruction,John Cox,DEM,280101,1,40,160,201,
Greer,Superintendent of Public Instruction,Joy Hofmeister,REP,280101,13,31,140,184,
Greer,Commissioner of Labor,Mike Workman,DEM,280101,1,29,132,162,
Greer,Commissioner of Labor,Mark Costello,REP,280101,13,38,163,214,
Greer,U.S. Senate,Matt Silverstein,DEM,280101,0,14,86,100,
Greer,U.S. Senate,Jim Inhofe,REP,280101,14,56,210,280,
Greer,U.S. Senate,Aaron Delozier,IND,280101,0,0,2,2,
Greer,U.S. Senate,Ray Woods,IND,280101,0,0,9,9,
Greer,U.S. Senate,Joan Farr,IND,280101,0,1,2,3,
Greer,U.S. Senate,Connie Johnson,DEM,280101,0,13,88,101,
Greer,U.S. Senate,James Lankford,REP,280101,12,55,205,272,
Greer,U.S. Senate,Mark Beard,IND,280101,1,2,12,15,
Greer,U.S. House,Frankie Robbins,DEM,280101,0,17,80,97,03
Greer,U.S. House,Frank Lucas,REP,280101,14,53,228,295,03
Greer,Governor,Joe Dorman,DEM,280102,8,25,155,188,
Greer,Governor,Mary Fallin,REP,280102,3,30,183,216,
Greer,Governor,Kimberly Willis,IND,280102,0,0,5,5,
Greer,Governor,Richard Prawdzienski,IND,280102,0,1,3,4,
Greer,Lieutenant Governor,Cathy Cummings,DEM,280102,4,15,111,130,
Greer,Lieutenant Governor,Todd Lamb,REP,280102,7,40,233,280,
Greer,Superintendent of Public Instruction,John Cox,DEM,280102,6,26,187,219,
Greer,Superintendent of Public Instruction,Joy Hofmeister,REP,280102,5,27,151,183,
Greer,Commissioner of Labor,Mike Workman,DEM,280102,5,22,147,174,
Greer,Commissioner of Labor,Mark Costello,REP,280102,5,29,182,216,
Greer,U.S. Senate,Matt Silverstein,DEM,280102,3,13,90,106,
Greer,U.S. Senate,Jim Inhofe,REP,280102,8,37,239,284,
Greer,U.S. Senate,Aaron Delozier,IND,280102,0,2,4,6,
Greer,U.S. Senate,Ray Woods,IND,280102,0,2,5,7,
Greer,U.S. Senate,Joan Farr,IND,280102,0,1,4,5,
Greer,U.S. Senate,Connie Johnson,DEM,280102,3,18,101,122,
Greer,U.S. Senate,James Lankford,REP,280102,8,34,226,268,
Greer,U.S. Senate,Mark Beard,IND,280102,0,2,14,16,
Greer,U.S. House,Frankie Robbins,DEM,280102,2,17,92,111,03
Greer,U.S. House,Frank Lucas,REP,280102,9,37,249,295,03
Greer,Governor,Joe Dorman,DEM,280103,0,1,6,7,
Greer,Governor,Mary Fallin,REP,280103,0,4,10,14,
Greer,Governor,Kimberly Willis,IND,280103,0,0,0,0,
Greer,Governor,Richard Prawdzienski,IND,280103,0,0,1,1,
Greer,Lieutenant Governor,Cathy Cummings,DEM,280103,0,0,3,3,
Greer,Lieutenant Governor,Todd Lamb,REP,280103,0,5,14,19,
Greer,Superintendent of Public Instruction,John Cox,DEM,280103,0,4,8,12,
Greer,Superintendent of Public Instruction,Joy Hofmeister,REP,280103,0,1,9,10,
Greer,Commissioner of Labor,Mike Workman,DEM,280103,0,2,6,8,
Greer,Commissioner of Labor,Mark Costello,REP,280103,0,3,10,13,
Greer,U.S. Senate,Matt Silverstein,DEM,280103,0,0,1,1,
Greer,U.S. Senate,Jim Inhofe,REP,280103,0,5,15,20,
Greer,U.S. Senate,Aaron Delozier,IND,280103,0,0,1,1,
Greer,U.S. Senate,Ray Woods,IND,280103,0,0,1,1,
Greer,U.S. Senate,Joan Farr,IND,280103,0,0,0,0,
Greer,U.S. Senate,Connie Johnson,DEM,280103,0,0,1,1,
Greer,U.S. Senate,James Lankford,REP,280103,0,5,15,20,
Greer,U.S. Senate,Mark Beard,IND,280103,0,0,1,1,
Greer,U.S. House,Frankie Robbins,DEM,280103,0,0,3,3,03
Greer,U.S. House,Frank Lucas,REP,280103,0,5,14,19,03
Greer,Governor,Joe Dorman,DEM,280105,1,2,33,36,
Greer,Governor,Mary Fallin,REP,280105,1,3,43,47,
Greer,Governor,Kimberly Willis,IND,280105,0,0,1,1,
Greer,Governor,Richard Prawdzienski,IND,280105,0,0,0,0,
Greer,Lieutenant Governor,Cathy Cummings,DEM,280105,0,2,21,23,
Greer,Lieutenant Governor,Todd Lamb,REP,280105,2,3,52,57,
Greer,Superintendent of Public Instruction,John Cox,DEM,280105,2,3,43,48,
Greer,Superintendent of Public Instruction,Joy Hofmeister,REP,280105,0,2,29,31,
Greer,Commissioner of Labor,Mike Workman,DEM,280105,1,2,33,36,
Greer,Commissioner of Labor,Mark Costello,REP,280105,1,3,34,38,
Greer,U.S. Senate,Matt Silverstein,DEM,280105,0,0,14,14,
Greer,U.S. Senate,Jim Inhofe,REP,280105,2,5,61,68,
Greer,U.S. Senate,Aaron Delozier,IND,280105,0,0,0,0,
Greer,U.S. Senate,Ray Woods,IND,280105,0,0,2,2,
Greer,U.S. Senate,Joan Farr,IND,280105,0,0,0,0,
Greer,U.S. Senate,Connie Johnson,DEM,280105,0,1,18,19,
Greer,U.S. Senate,James Lankford,REP,280105,2,4,53,59,
Greer,U.S. Senate,Mark Beard,IND,280105,0,0,3,3,
Greer,U.S. House,Frankie Robbins,DEM,280105,0,1,13,14,03
Greer,U.S. House,Frank Lucas,REP,280105,2,4,63,69,03
Greer,Governor,Joe Dorman,DEM,280106,0,1,20,21,
Greer,Governor,Mary Fallin,REP,280106,3,5,39,47,
Greer,Governor,Kimberly Willis,IND,280106,0,0,2,2,
Greer,Governor,Richard Prawdzienski,IND,280106,0,0,2,2,
Greer,Lieutenant Governor,Cathy Cummings,DEM,280106,0,1,8,9,
Greer,Lieutenant Governor,Todd Lamb,REP,280106,3,5,54,62,
Greer,Superintendent of Public Instruction,John Cox,DEM,280106,0,2,21,23,
Greer,Superintendent of Public Instruction,Joy Hofmeister,REP,280106,3,4,39,46,
Greer,Commissioner of Labor,Mike Workman,DEM,280106,0,1,13,14,
Greer,Commissioner of Labor,Mark Costello,REP,280106,3,5,47,55,
Greer,U.S. Senate,Matt Silverstein,DEM,280106,0,1,7,8,
Greer,U.S. Senate,Jim Inhofe,REP,280106,3,5,52,60,
Greer,U.S. Senate,Aaron Delozier,IND,280106,0,0,2,2,
Greer,U.S. Senate,Ray Woods,IND,280106,0,0,1,1,
Greer,U.S. Senate,Joan Farr,IND,280106,0,0,1,1,
Greer,U.S. Senate,Connie Johnson,DEM,280106,0,1,4,5,
Greer,U.S. Senate,James Lankford,REP,280106,3,5,56,64,
Greer,U.S. Senate,Mark Beard,IND,280106,0,0,3,3,
Greer,U.S. House,Frankie Robbins,DEM,280106,0,1,5,6,03
Greer,U.S. House,Frank Lucas,REP,280106,3,5,58,66,03
Greer,Governor,Joe Dorman,DEM,280202,0,7,120,127,
Greer,Governor,Mary Fallin,REP,280202,0,11,158,169,
Greer,Governor,Kimberly Willis,IND,280202,0,0,9,9,
Greer,Governor,Richard Prawdzienski,IND,280202,0,0,4,4,
Greer,Lieutenant Governor,Cathy Cummings,DEM,280202,0,3,71,74,
Greer,Lieutenant Governor,Todd Lamb,REP,280202,0,15,218,233,
Greer,Superintendent of Public Instruction,John Cox,DEM,280202,0,7,144,151,
Greer,Superintendent of Public Instruction,Joy Hofmeister,REP,280202,0,10,145,155,
Greer,Commissioner of Labor,Mike Workman,DEM,280202,0,7,95,102,
Greer,Commissioner of Labor,Mark Costello,REP,280202,0,10,186,196,
Greer,U.S. Senate,Matt Silverstein,DEM,280202,0,5,60,65,
Greer,U.S. Senate,Jim Inhofe,REP,280202,0,13,223,236,
Greer,U.S. Senate,Aaron Delozier,IND,280202,0,0,2,2,
Greer,U.S. Senate,Ray Woods,IND,280202,0,0,3,3,
Greer,U.S. Senate,Joan Farr,IND,280202,0,0,2,2,
Greer,U.S. Senate,Connie Johnson,DEM,280202,0,4,53,57,
Greer,U.S. Senate,James Lankford,REP,280202,0,14,230,244,
Greer,U.S. Senate,Mark Beard,IND,280202,0,0,5,5,
Greer,U.S. House,Frankie Robbins,DEM,280202,0,4,50,54,03
Greer,U.S. House,Frank Lucas,REP,280202,0,14,238,252,03
Greer,Governor,Joe Dorman,DEM,280203,2,3,57,62,
Greer,Governor,Mary Fallin,REP,280203,4,7,66,77,
Greer,Governor,Kimberly Willis,IND,280203,0,0,2,2,
Greer,Governor,Richard Prawdzienski,IND,280203,0,0,0,0,
Greer,Lieutenant Governor,Cathy Cummings,DEM,280203,1,0,44,45,
Greer,Lieutenant Governor,Todd Lamb,REP,280203,5,9,80,94,
Greer,Superintendent of Public Instruction,John Cox,DEM,280203,2,2,61,65,
Greer,Superintendent of Public Instruction,Joy Hofmeister,REP,280203,4,7,60,71,
Greer,Commissioner of Labor,Mike Workman,DEM,280203,0,3,49,52,
Greer,Commissioner of Labor,Mark Costello,REP,280203,6,6,63,75,
Greer,U.S. Senate,Matt Silverstein,DEM,280203,1,0,32,33,
Greer,U.S. Senate,Jim Inhofe,REP,280203,5,9,88,102,
Greer,U.S. Senate,Aaron Delozier,IND,280203,0,0,2,2,
Greer,U.S. Senate,Ray Woods,IND,280203,0,0,3,3,
Greer,U.S. Senate,Joan Farr,IND,280203,0,0,1,1,
Greer,U.S. Senate,Connie Johnson,DEM,280203,1,0,39,40,
Greer,U.S. Senate,James Lankford,REP,280203,5,10,82,97,
Greer,U.S. Senate,Mark Beard,IND,280203,0,0,4,4,
Greer,U.S. House,Frankie Robbins,DEM,280203,0,0,24,24,03
Greer,U.S. House,Frank Lucas,REP,280203,6,10,98,114,03
Greer,Governor,Joe Dorman,DEM,280302,0,1,27,28,
Greer,Governor,Mary Fallin,REP,280302,0,1,21,22,
Greer,Governor,Kimberly Willis,IND,280302,0,0,1,1,
Greer,Governor,Richard Prawdzienski,IND,280302,0,0,1,1,
Greer,Lieutenant Governor,Cathy Cummings,DEM,280302,0,0,15,15,
Greer,Lieutenant Governor,Todd Lamb,REP,280302,0,2,34,36,
Greer,Superintendent of Public Instruction,John Cox,DEM,280302,0,1,32,33,
Greer,Superintendent of Public Instruction,Joy Hofmeister,REP,280302,0,1,16,17,
Greer,Commissioner of Labor,Mike Workman,DEM,280302,0,0,26,26,
Greer,Commissioner of Labor,Mark Costello,REP,280302,0,2,21,23,
Greer,U.S. Senate,Matt Silverstein,DEM,280302,0,0,15,15,
Greer,U.S. Senate,Jim Inhofe,REP,280302,0,2,33,35,
Greer,U.S. Senate,Aaron Delozier,IND,280302,0,0,0,0,
Greer,U.S. Senate,Ray Woods,IND,280302,0,0,1,1,
Greer,U.S. Senate,Joan Farr,IND,280302,0,0,1,1,
Greer,U.S. Senate,Connie Johnson,DEM,280302,0,0,15,15,
Greer,U.S. Senate,James Lankford,REP,280302,0,2,30,32,
Greer,U.S. Senate,Mark Beard,IND,280302,0,0,3,3,
Greer,U.S. House,Frankie Robbins,DEM,280302,0,0,14,14,03
Greer,U.S. House,Frank Lucas,REP,280302,0,2,34,36,03
Harmon,Governor,Joe Dorman,DEM,290101,2,1,21,24,
Harmon,Governor,Mary Fallin,REP,290101,1,0,12,13,
Harmon,Governor,Kimberly Willis,IND,290101,0,0,0,0,
Harmon,Governor,Richard Prawdzienski,IND,290101,1,0,0,1,
Harmon,Lieutenant Governor,Cathy Cummings,DEM,290101,2,0,12,14,
Harmon,Lieutenant Governor,Todd Lamb,REP,290101,2,1,21,24,
Harmon,Superintendent of Public Instruction,John Cox,DEM,290101,4,1,24,29,
Harmon,Superintendent of Public Instruction,Joy Hofmeister,REP,290101,0,0,9,9,
Harmon,Commissioner of Labor,Mike Workman,DEM,290101,2,0,19,21,
Harmon,Commissioner of Labor,Mark Costello,REP,290101,2,1,12,15,
Harmon,U.S. Senate,Matt Silverstein,DEM,290101,2,1,8,11,
Harmon,U.S. Senate,Jim Inhofe,REP,290101,2,0,23,25,
Harmon,U.S. Senate,Aaron Delozier,IND,290101,0,0,0,0,
Harmon,U.S. Senate,Ray Woods,IND,290101,0,0,2,2,
Harmon,U.S. Senate,Joan Farr,IND,290101,0,0,0,0,
Harmon,U.S. Senate,Connie Johnson,DEM,290101,2,0,8,10,
Harmon,U.S. Senate,James Lankford,REP,290101,2,1,24,27,
Harmon,U.S. Senate,Mark Beard,IND,290101,0,0,1,1,
Harmon,U.S. House,Frankie Robbins,DEM,290101,2,0,11,13,03
Harmon,U.S. House,Frank Lucas,REP,290101,2,1,22,25,03
Harmon,Governor,Joe Dorman,DEM,290102,1,12,92,105,
Harmon,Governor,Mary Fallin,REP,290102,2,12,137,151,
Harmon,Governor,Kimberly Willis,IND,290102,0,0,2,2,
Harmon,Governor,Richard Prawdzienski,IND,290102,0,0,1,1,
Harmon,Lieutenant Governor,Cathy Cummings,DEM,290102,0,8,47,55,
Harmon,Lieutenant Governor,Todd Lamb,REP,290102,3,16,182,201,
Harmon,Superintendent of Public Instruction,John Cox,DEM,290102,1,13,118,132,
Harmon,Superintendent of Public Instruction,Joy Hofmeister,REP,290102,2,11,111,124,
Harmon,Commissioner of Labor,Mike Workman,DEM,290102,1,10,97,108,
Harmon,Commissioner of Labor,Mark Costello,REP,290102,2,12,117,131,
Harmon,U.S. Senate,Matt Silverstein,DEM,290102,0,7,41,48,
Harmon,U.S. Senate,Jim Inhofe,REP,290102,3,16,182,201,
Harmon,U.S. Senate,Aaron Delozier,IND,290102,0,0,0,0,
Harmon,U.S. Senate,Ray Woods,IND,290102,0,0,3,3,
Harmon,U.S. Senate,Joan Farr,IND,290102,0,0,1,1,
Harmon,U.S. Senate,Connie Johnson,DEM,290102,0,7,46,53,
Harmon,U.S. Senate,James Lankford,REP,290102,3,17,176,196,
Harmon,U.S. Senate,Mark Beard,IND,290102,0,0,7,7,
Harmon,U.S. House,Frankie Robbins,DEM,290102,0,6,38,44,03
Harmon,U.S. House,Frank Lucas,REP,290102,3,18,193,214,03
Harmon,Governor,Joe Dorman,DEM,290201,2,0,56,58,
Harmon,Governor,Mary Fallin,REP,290201,0,11,70,81,
Harmon,Governor,Kimberly Willis,IND,290201,0,0,1,1,
Harmon,Governor,Richard Prawdzienski,IND,290201,0,0,2,2,
Harmon,Lieutenant Governor,Cathy Cummings,DEM,290201,0,2,36,38,
Harmon,Lieutenant Governor,Todd Lamb,REP,290201,2,9,91,102,
Harmon,Superintendent of Public Instruction,John Cox,DEM,290201,2,3,59,64,
Harmon,Superintendent of Public Instruction,Joy Hofmeister,REP,290201,0,8,67,75,
Harmon,Commissioner of Labor,Mike Workman,DEM,290201,2,0,57,59,
Harmon,Commissioner of Labor,Mark Costello,REP,290201,0,10,65,75,
Harmon,U.S. Senate,Matt Silverstein,DEM,290201,0,0,30,30,
Harmon,U.S. Senate,Jim Inhofe,REP,290201,2,11,96,109,
Harmon,U.S. Senate,Aaron Delozier,IND,290201,0,0,0,0,
Harmon,U.S. Senate,Ray Woods,IND,290201,0,0,2,2,
Harmon,U.S. Senate,Joan Farr,IND,290201,0,0,1,1,
Harmon,U.S. Senate,Connie Johnson,DEM,290201,0,0,34,34,
Harmon,U.S. Senate,James Lankford,REP,290201,1,11,89,101,
Harmon,U.S. Senate,Mark Beard,IND,290201,0,0,7,7,
Harmon,U.S. House,Frankie Robbins,DEM,290201,0,0,33,33,03
Harmon,U.S. House,Frank Lucas,REP,290201,2,11,97,110,03
Harmon,Governor,Joe Dorman,DEM,290203,0,0,6,6,
Harmon,Governor,Mary Fallin,REP,290203,0,3,12,15,
Harmon,Governor,Kimberly Willis,IND,290203,0,0,0,0,
Harmon,Governor,Richard Prawdzienski,IND,290203,0,0,0,0,
Harmon,Lieutenant Governor,Cathy Cummings,DEM,290203,0,0,3,3,
Harmon,Lieutenant Governor,Todd Lamb,REP,290203,0,3,15,18,
Harmon,Superintendent of Public Instruction,John Cox,DEM,290203,0,0,5,5,
Harmon,Superintendent of Public Instruction,Joy Hofmeister,REP,290203,0,3,13,16,
Harmon,Commissioner of Labor,Mike Workman,DEM,290203,0,0,5,5,
Harmon,Commissioner of Labor,Mark Costello,REP,290203,0,3,12,15,
Harmon,U.S. Senate,Matt Silverstein,DEM,290203,0,0,3,3,
Harmon,U.S. Senate,Jim Inhofe,REP,290203,0,3,14,17,
Harmon,U.S. Senate,Aaron Delozier,IND,290203,0,0,0,0,
Harmon,U.S. Senate,Ray Woods,IND,290203,0,0,0,0,
Harmon,U.S. Senate,Joan Farr,IND,290203,0,0,1,1,
Harmon,U.S. Senate,Connie Johnson,DEM,290203,0,0,2,2,
Harmon,U.S. Senate,James Lankford,REP,290203,0,2,16,18,
Harmon,U.S. Senate,Mark Beard,IND,290203,0,1,0,1,
Harmon,U.S. House,Frankie Robbins,DEM,290203,0,0,3,3,03
Harmon,U.S. House,Frank Lucas,REP,290203,0,3,15,18,03
Harmon,Governor,Joe Dorman,DEM,290204,0,0,10,10,
Harmon,Governor,Mary Fallin,REP,290204,0,1,8,9,
Harmon,Governor,Kimberly Willis,IND,290204,0,0,0,0,
Harmon,Governor,Richard Prawdzienski,IND,290204,0,0,0,0,
Harmon,Lieutenant Governor,Cathy Cummings,DEM,290204,0,0,4,4,
Harmon,Lieutenant Governor,Todd Lamb,REP,290204,0,1,14,15,
Harmon,Superintendent of Public Instruction,John Cox,DEM,290204,0,1,11,12,
Harmon,Superintendent of Public Instruction,Joy Hofmeister,REP,290204,0,0,7,7,
Harmon,Commissioner of Labor,Mike Workman,DEM,290204,0,1,10,11,
Harmon,Commissioner of Labor,Mark Costello,REP,290204,0,0,8,8,
Harmon,U.S. Senate,Matt Silverstein,DEM,290204,0,0,3,3,
Harmon,U.S. Senate,Jim Inhofe,REP,290204,0,1,15,16,
Harmon,U.S. Senate,Aaron Delozier,IND,290204,0,0,0,0,
Harmon,U.S. Senate,Ray Woods,IND,290204,0,0,0,0,
Harmon,U.S. Senate,Joan Farr,IND,290204,0,0,0,0,
Harmon,U.S. Senate,Connie Johnson,DEM,290204,0,0,6,6,
Harmon,U.S. Senate,James Lankford,REP,290204,0,1,12,13,
Harmon,U.S. Senate,Mark Beard,IND,290204,0,0,0,0,
Harmon,U.S. House,Frankie Robbins,DEM,290204,0,0,2,2,03
Harmon,U.S. House,Frank Lucas,REP,290204,0,1,16,17,03
Harmon,Governor,Joe Dorman,DEM,290301,2,2,39,43,
Harmon,Governor,Mary Fallin,REP,290301,2,4,61,67,
Harmon,Governor,Kimberly Willis,IND,290301,0,0,0,0,
Harmon,Governor,Richard Prawdzienski,IND,290301,0,0,0,0,
Harmon,Lieutenant Governor,Cathy Cummings,DEM,290301,1,2,23,26,
Harmon,Lieutenant Governor,Todd Lamb,REP,290301,3,4,78,85,
Harmon,Superintendent of Public Instruction,John Cox,DEM,290301,4,2,53,59,
Harmon,Superintendent of Public Instruction,Joy Hofmeister,REP,290301,0,4,48,52,
Harmon,Commissioner of Labor,Mike Workman,DEM,290301,2,3,34,39,
Harmon,Commissioner of Labor,Mark Costello,REP,290301,2,3,65,70,
Harmon,U.S. Senate,Matt Silverstein,DEM,290301,0,1,21,22,
Harmon,U.S. Senate,Jim Inhofe,REP,290301,3,5,77,85,
Harmon,U.S. Senate,Aaron Delozier,IND,290301,0,0,1,1,
Harmon,U.S. Senate,Ray Woods,IND,290301,0,0,2,2,
Harmon,U.S. Senate,Joan Farr,IND,290301,1,0,0,1,
Harmon,U.S. Senate,Connie Johnson,DEM,290301,1,1,24,26,
Harmon,U.S. Senate,James Lankford,REP,290301,3,5,76,84,
Harmon,U.S. Senate,Mark Beard,IND,290301,0,0,0,0,
Harmon,U.S. House,Frankie Robbins,DEM,290301,1,1,23,25,03
Harmon,U.S. House,Frank Lucas,REP,290301,3,5,78,86,03
Harmon,Governor,Joe Dorman,DEM,290302,0,1,22,23,
Harmon,Governor,Mary Fallin,REP,290302,1,5,62,68,
Harmon,Governor,Kimberly Willis,IND,290302,0,0,3,3,
Harmon,Governor,Richard Prawdzienski,IND,290302,0,0,3,3,
Harmon,Lieutenant Governor,Cathy Cummings,DEM,290302,0,0,12,12,
Harmon,Lieutenant Governor,Todd Lamb,REP,290302,1,6,77,84,
Harmon,Superintendent of Public Instruction,John Cox,DEM,290302,0,1,34,35,
Harmon,Superintendent of Public Instruction,Joy Hofmeister,REP,290302,1,5,53,59,
Harmon,Commissioner of Labor,Mike Workman,DEM,290302,0,1,20,21,
Harmon,Commissioner of Labor,Mark Costello,REP,290302,1,5,64,70,
Harmon,U.S. Senate,Matt Silverstein,DEM,290302,0,0,11,11,
Harmon,U.S. Senate,Jim Inhofe,REP,290302,1,6,78,85,
Harmon,U.S. Senate,Aaron Delozier,IND,290302,0,0,0,0,
Harmon,U.S. Senate,Ray Woods,IND,290302,0,0,0,0,
Harmon,U.S. Senate,Joan Farr,IND,290302,0,0,0,0,
Harmon,U.S. Senate,Connie Johnson,DEM,290302,0,0,12,12,
Harmon,U.S. Senate,James Lankford,REP,290302,1,6,75,82,
Harmon,U.S. Senate,Mark Beard,IND,290302,0,0,3,3,
Harmon,U.S. House,Frankie Robbins,DEM,290302,0,0,12,12,03
Harmon,U.S. House,Frank Lucas,REP,290302,1,6,77,84,03
Harper,Governor,Joe Dorman,DEM,300201,1,3,111,115,
Harper,Governor,Mary Fallin,REP,300201,17,7,256,280,
Harper,Governor,Kimberly Willis,IND,300201,0,0,10,10,
Harper,Governor,Richard Prawdzienski,IND,300201,0,1,3,4,
Harper,Lieutenant Governor,Cathy Cummings,DEM,300201,0,1,44,45,
Harper,Lieutenant Governor,Todd Lamb,REP,300201,17,10,337,364,
Harper,Superintendent of Public Instruction,John Cox,DEM,300201,3,3,153,159,
Harper,Superintendent of Public Instruction,Joy Hofmeister,REP,300201,15,7,221,243,
Harper,Commissioner of Labor,Mike Workman,DEM,300201,0,0,88,88,
Harper,Commissioner of Labor,Mark Costello,REP,300201,17,11,280,308,
Harper,U.S. Senate,Matt Silverstein,DEM,300201,0,0,30,30,
Harper,U.S. Senate,Jim Inhofe,REP,300201,18,11,341,370,
Harper,U.S. Senate,Aaron Delozier,IND,300201,0,0,3,3,
Harper,U.S. Senate,Ray Woods,IND,300201,0,0,2,2,
Harper,U.S. Senate,Joan Farr,IND,300201,0,0,6,6,
Harper,U.S. Senate,Connie Johnson,DEM,300201,0,1,38,39,
Harper,U.S. Senate,James Lankford,REP,300201,17,9,329,355,
Harper,U.S. Senate,Mark Beard,IND,300201,0,0,15,15,
Harper,U.S. House,Frankie Robbins,DEM,300201,0,0,30,30,03
Harper,U.S. House,Frank Lucas,REP,300201,18,11,350,379,03
Harper,Governor,Joe Dorman,DEM,300203,0,0,14,14,
Harper,Governor,Mary Fallin,REP,300203,2,2,59,63,
Harper,Governor,Kimberly Willis,IND,300203,0,0,3,3,
Harper,Governor,Richard Prawdzienski,IND,300203,0,0,0,0,
Harper,Lieutenant Governor,Cathy Cummings,DEM,300203,0,0,7,7,
Harper,Lieutenant Governor,Todd Lamb,REP,300203,2,2,68,72,
Harper,Superintendent of Public Instruction,John Cox,DEM,300203,0,0,23,23,
Harper,Superintendent of Public Instruction,Joy Hofmeister,REP,300203,2,2,52,56,
Harper,Commissioner of Labor,Mike Workman,DEM,300203,0,1,12,13,
Harper,Commissioner of Labor,Mark Costello,REP,300203,2,1,61,64,
Harper,U.S. Senate,Matt Silverstein,DEM,300203,0,0,10,10,
Harper,U.S. Senate,Jim Inhofe,REP,300203,2,1,64,67,
Harper,U.S. Senate,Aaron Delozier,IND,300203,0,0,0,0,
Harper,U.S. Senate,Ray Woods,IND,300203,0,0,1,1,
Harper,U.S. Senate,Joan Farr,IND,300203,0,0,1,1,
Harper,U.S. Senate,Connie Johnson,DEM,300203,0,0,10,10,
Harper,U.S. Senate,James Lankford,REP,300203,2,2,64,68,
Harper,U.S. Senate,Mark Beard,IND,300203,0,0,1,1,
Harper,U.S. House,Frankie Robbins,DEM,300203,0,1,8,9,03
Harper,U.S. House,Frank Lucas,REP,300203,2,1,67,70,03
Harper,Governor,Joe Dorman,DEM,300301,0,4,57,61,
Harper,Governor,Mary Fallin,REP,300301,1,12,123,136,
Harper,Governor,Kimberly Willis,IND,300301,0,0,2,2,
Harper,Governor,Richard Prawdzienski,IND,300301,0,0,1,1,
Harper,Lieutenant Governor,Cathy Cummings,DEM,300301,0,0,37,37,
Harper,Lieutenant Governor,Todd Lamb,REP,300301,1,16,146,163,
Harper,Superintendent of Public Instruction,John Cox,DEM,300301,0,6,94,100,
Harper,Superintendent of Public Instruction,Joy Hofmeister,REP,300301,1,10,88,99,
Harper,Commissioner of Labor,Mike Workman,DEM,300301,0,5,52,57,
Harper,Commissioner of Labor,Mark Costello,REP,300301,1,10,127,138,
Harper,U.S. Senate,Matt Silverstein,DEM,300301,0,2,24,26,
Harper,U.S. Senate,Jim Inhofe,REP,300301,1,13,155,169,
Harper,U.S. Senate,Aaron Delozier,IND,300301,0,0,1,1,
Harper,U.S. Senate,Ray Woods,IND,300301,0,1,2,3,
Harper,U.S. Senate,Joan Farr,IND,300301,0,0,1,1,
Harper,U.S. Senate,Connie Johnson,DEM,300301,0,2,25,27,
Harper,U.S. Senate,James Lankford,REP,300301,1,13,153,167,
Harper,U.S. Senate,Mark Beard,IND,300301,0,1,3,4,
Harper,U.S. House,Frankie Robbins,DEM,300301,0,3,28,31,03
Harper,U.S. House,Frank Lucas,REP,300301,1,13,155,169,03
Harper,Governor,Joe Dorman,DEM,300302,1,1,8,10,
Harper,Governor,Mary Fallin,REP,300302,1,1,34,36,
Harper,Governor,Kimberly Willis,IND,300302,0,0,1,1,
Harper,Governor,Richard Prawdzienski,IND,300302,0,0,0,0,
Harper,Lieutenant Governor,Cathy Cummings,DEM,300302,0,1,5,6,
Harper,Lieutenant Governor,Todd Lamb,REP,300302,2,1,38,41,
Harper,Superintendent of Public Instruction,John Cox,DEM,300302,2,1,16,19,
Harper,Superintendent of Public Instruction,Joy Hofmeister,REP,300302,0,1,26,27,
Harper,Commissioner of Labor,Mike Workman,DEM,300302,0,0,5,5,
Harper,Commissioner of Labor,Mark Costello,REP,300302,2,2,37,41,
Harper,U.S. Senate,Matt Silverstein,DEM,300302,0,0,3,3,
Harper,U.S. Senate,Jim Inhofe,REP,300302,2,2,39,43,
Harper,U.S. Senate,Aaron Delozier,IND,300302,0,0,0,0,
Harper,U.S. Senate,Ray Woods,IND,300302,0,0,1,1,
Harper,U.S. Senate,Joan Farr,IND,300302,0,0,0,0,
Harper,U.S. Senate,Connie Johnson,DEM,300302,0,0,3,3,
Harper,U.S. Senate,James Lankford,REP,300302,2,2,38,42,
Harper,U.S. Senate,Mark Beard,IND,300302,0,0,2,2,
Harper,U.S. House,Frankie Robbins,DEM,300302,0,0,3,3,03
Harper,U.S. House,Frank Lucas,REP,300302,2,2,40,44,03
Harper,Governor,Joe Dorman,DEM,300303,2,3,17,22,
Harper,Governor,Mary Fallin,REP,300303,1,6,51,58,
Harper,Governor,Kimberly Willis,IND,300303,0,0,0,0,
Harper,Governor,Richard Prawdzienski,IND,300303,0,0,1,1,
Harper,Lieutenant Governor,Cathy Cummings,DEM,300303,1,1,5,7,
Harper,Lieutenant Governor,Todd Lamb,REP,300303,2,8,64,74,
Harper,Superintendent of Public Instruction,John Cox,DEM,300303,0,7,26,33,
Harper,Superintendent of Public Instruction,Joy Hofmeister,REP,300303,3,2,43,48,
Harper,Commissioner of Labor,Mike Workman,DEM,300303,0,3,8,11,
Harper,Commissioner of Labor,Mark Costello,REP,300303,3,6,60,69,
Harper,U.S. Senate,Matt Silverstein,DEM,300303,0,0,1,1,
Harper,U.S. Senate,Jim Inhofe,REP,300303,3,8,66,77,
Harper,U.S. Senate,Aaron Delozier,IND,300303,0,0,0,0,
Harper,U.S. Senate,Ray Woods,IND,300303,0,1,1,2,
Harper,U.S. Senate,Joan Farr,IND,300303,0,0,1,1,
Harper,U.S. Senate,Connie Johnson,DEM,300303,0,2,2,4,
Harper,U.S. Senate,James Lankford,REP,300303,3,7,66,76,
Harper,U.S. Senate,Mark Beard,IND,300303,0,0,1,1,
Harper,U.S. House,Frankie Robbins,DEM,300303,0,0,5,5,03
Harper,U.S. House,Frank Lucas,REP,300303,3,9,64,76,03
Harper,Governor,Joe Dorman,DEM,300402,1,10,56,67,
Harper,Governor,Mary Fallin,REP,300402,2,16,159,177,
Harper,Governor,Kimberly Willis,IND,300402,0,0,12,12,
Harper,Governor,Richard Prawdzienski,IND,300402,0,0,4,4,
Harper,Lieutenant Governor,Cathy Cummings,DEM,300402,1,3,35,39,
Harper,Lieutenant Governor,Todd Lamb,REP,300402,2,25,193,220,
Harper,Superintendent of Public Instruction,John Cox,DEM,300402,1,13,103,117,
Harper,Superintendent of Public Instruction,Joy Hofmeister,REP,300402,2,15,126,143,
Harper,Commissioner of Labor,Mike Workman,DEM,300402,2,2,62,66,
Harper,Commissioner of Labor,Mark Costello,REP,300402,1,24,159,184,
Harper,U.S. Senate,Matt Silverstein,DEM,300402,1,0,27,28,
Harper,U.S. Senate,Jim Inhofe,REP,300402,2,27,187,216,
Harper,U.S. Senate,Aaron Delozier,IND,300402,0,0,3,3,
Harper,U.S. Senate,Ray Woods,IND,300402,1,1,9,11,
Harper,U.S. Senate,Joan Farr,IND,300402,0,0,5,5,
Harper,U.S. Senate,Connie Johnson,DEM,300402,1,0,23,24,
Harper,U.S. Senate,James Lankford,REP,300402,2,27,187,216,
Harper,U.S. Senate,Mark Beard,IND,300402,1,1,20,22,
Harper,U.S. House,Frankie Robbins,DEM,300402,2,1,31,34,03
Harper,U.S. House,Frank Lucas,REP,300402,2,27,200,229,03
Haskell,Governor,Joe Dorman,DEM,310007,1,0,60,61,
Haskell,Governor,Mary Fallin,REP,310007,0,1,64,65,
Haskell,Governor,Kimberly Willis,IND,310007,0,0,7,7,
Haskell,Governor,Richard Prawdzienski,IND,310007,0,0,1,1,
Haskell,Lieutenant Governor,Cathy Cummings,DEM,310007,1,0,34,35,
Haskell,Lieutenant Governor,Todd Lamb,REP,310007,0,1,98,99,
Haskell,Superintendent of Public Instruction,John Cox,DEM,310007,1,0,79,80,
Haskell,Superintendent of Public Instruction,Joy Hofmeister,REP,310007,0,1,54,55,
Haskell,Commissioner of Labor,Mike Workman,DEM,310007,1,0,53,54,
Haskell,Commissioner of Labor,Mark Costello,REP,310007,0,1,79,80,
Haskell,U.S. Senate,Matt Silverstein,DEM,310007,1,0,24,25,
Haskell,U.S. Senate,Jim Inhofe,REP,310007,0,1,102,103,
Haskell,U.S. Senate,Aaron Delozier,IND,310007,0,0,0,0,
Haskell,U.S. Senate,Ray Woods,IND,310007,0,0,5,5,
Haskell,U.S. Senate,Joan Farr,IND,310007,0,0,2,2,
Haskell,U.S. Senate,Connie Johnson,DEM,310007,1,0,28,29,
Haskell,U.S. Senate,James Lankford,REP,310007,0,1,96,97,
Haskell,U.S. Senate,Mark Beard,IND,310007,0,0,8,8,
Haskell,U.S. House,Earl Everett,DEM,310007,1,0,22,23,02
Haskell,U.S. House,Markwayne Mullin,REP,310007,0,1,103,104,02
Haskell,U.S. House,Jon Douthitt,IND,310007,0,0,7,7,02
Haskell,Governor,Joe Dorman,DEM,310009,0,1,28,29,
Haskell,Governor,Mary Fallin,REP,310009,0,2,35,37,
Haskell,Governor,Kimberly Willis,IND,310009,0,0,0,0,
Haskell,Governor,Richard Prawdzienski,IND,310009,0,0,0,0,
Haskell,Lieutenant Governor,Cathy Cummings,DEM,310009,0,1,20,21,
Haskell,Lieutenant Governor,Todd Lamb,REP,310009,0,2,43,45,
Haskell,Superintendent of Public Instruction,John Cox,DEM,310009,0,1,38,39,
Haskell,Superintendent of Public Instruction,Joy Hofmeister,REP,310009,0,2,25,27,
Haskell,Commissioner of Labor,Mike Workman,DEM,310009,0,2,28,30,
Haskell,Commissioner of Labor,Mark Costello,REP,310009,0,1,33,34,
Haskell,U.S. Senate,Matt Silverstein,DEM,310009,0,1,19,20,
Haskell,U.S. Senate,Jim Inhofe,REP,310009,0,2,42,44,
Haskell,U.S. Senate,Aaron Delozier,IND,310009,0,0,0,0,
Haskell,U.S. Senate,Ray Woods,IND,310009,0,0,0,0,
Haskell,U.S. Senate,Joan Farr,IND,310009,0,0,1,1,
Haskell,U.S. Senate,Connie Johnson,DEM,310009,0,0,21,21,
Haskell,U.S. Senate,James Lankford,REP,310009,0,3,40,43,
Haskell,U.S. Senate,Mark Beard,IND,310009,0,0,2,2,
Haskell,U.S. House,Earl Everett,DEM,310009,0,0,19,19,02
Haskell,U.S. House,Markwayne Mullin,REP,310009,0,3,44,47,02
Haskell,U.S. House,Jon Douthitt,IND,310009,0,0,0,0,02
Haskell,Governor,Joe Dorman,DEM,310011,0,2,29,31,
Haskell,Governor,Mary Fallin,REP,310011,2,2,50,54,
Haskell,Governor,Kimberly Willis,IND,310011,0,0,0,0,
Haskell,Governor,Richard Prawdzienski,IND,310011,0,0,0,0,
Haskell,Lieutenant Governor,Cathy Cummings,DEM,310011,0,1,19,20,
Haskell,Lieutenant Governor,Todd Lamb,REP,310011,2,3,58,63,
Haskell,Superintendent of Public Instruction,John Cox,DEM,310011,0,2,39,41,
Haskell,Superintendent of Public Instruction,Joy Hofmeister,REP,310011,2,2,39,43,
Haskell,Commissioner of Labor,Mike Workman,DEM,310011,0,1,26,27,
Haskell,Commissioner of Labor,Mark Costello,REP,310011,2,3,52,57,
Haskell,U.S. Senate,Matt Silverstein,DEM,310011,0,0,18,18,
Haskell,U.S. Senate,Jim Inhofe,REP,310011,2,3,61,66,
Haskell,U.S. Senate,Aaron Delozier,IND,310011,0,0,0,0,
Haskell,U.S. Senate,Ray Woods,IND,310011,0,1,0,1,
Haskell,U.S. Senate,Joan Farr,IND,310011,0,0,0,0,
Haskell,U.S. Senate,Connie Johnson,DEM,310011,0,0,21,21,
Haskell,U.S. Senate,James Lankford,REP,310011,2,4,56,62,
Haskell,U.S. Senate,Mark Beard,IND,310011,0,0,2,2,
Haskell,U.S. House,Earl Everett,DEM,310011,0,0,15,15,02
Haskell,U.S. House,Markwayne Mullin,REP,310011,2,3,64,69,02
Haskell,U.S. House,Jon Douthitt,IND,310011,0,1,0,1,02
Haskell,Governor,Joe Dorman,DEM,310015,4,16,71,91,
Haskell,Governor,Mary Fallin,REP,310015,1,6,85,92,
Haskell,Governor,Kimberly Willis,IND,310015,0,0,1,1,
Haskell,Governor,Richard Prawdzienski,IND,310015,0,0,0,0,
Haskell,Lieutenant Governor,Cathy Cummings,DEM,310015,4,9,42,55,
Haskell,Lieutenant Governor,Todd Lamb,REP,310015,1,12,113,126,
Haskell,Superintendent of Public Instruction,John Cox,DEM,310015,4,18,87,109,
Haskell,Superintendent of Public Instruction,Joy Hofmeister,REP,310015,1,4,69,74,
Haskell,Commissioner of Labor,Mike Workman,DEM,310015,4,12,60,76,
Haskell,Commissioner of Labor,Mark Costello,REP,310015,1,9,89,99,
Haskell,U.S. Senate,Matt Silverstein,DEM,310015,4,8,46,58,
Haskell,U.S. Senate,Jim Inhofe,REP,310015,1,14,106,121,
Haskell,U.S. Senate,Aaron Delozier,IND,310015,0,0,1,1,
Haskell,U.S. Senate,Ray Woods,IND,310015,0,0,2,2,
Haskell,U.S. Senate,Joan Farr,IND,310015,0,0,2,2,
Haskell,U.S. Senate,Connie Johnson,DEM,310015,4,7,43,54,
Haskell,U.S. Senate,James Lankford,REP,310015,1,14,107,122,
Haskell,U.S. Senate,Mark Beard,IND,310015,0,0,6,6,
Haskell,U.S. House,Earl Everett,DEM,310015,4,6,34,44,02
Haskell,U.S. House,Markwayne Mullin,REP,310015,1,16,115,132,02
Haskell,U.S. House,Jon Douthitt,IND,310015,0,0,7,7,02
Haskell,Governor,Joe Dorman,DEM,310016,1,7,77,85,
Haskell,Governor,Mary Fallin,REP,310016,3,14,72,89,
Haskell,Governor,Kimberly Willis,IND,310016,0,0,6,6,
Haskell,Governor,Richard Prawdzienski,IND,310016,0,0,1,1,
Haskell,Lieutenant Governor,Cathy Cummings,DEM,310016,0,4,53,57,
Haskell,Lieutenant Governor,Todd Lamb,REP,310016,4,17,102,123,
Haskell,Superintendent of Public Instruction,John Cox,DEM,310016,3,9,91,103,
Haskell,Superintendent of Public Instruction,Joy Hofmeister,REP,310016,1,12,64,77,
Haskell,Commissioner of Labor,Mike Workman,DEM,310016,1,9,61,71,
Haskell,Commissioner of Labor,Mark Costello,REP,310016,3,12,87,102,
Haskell,U.S. Senate,Matt Silverstein,DEM,310016,0,6,51,57,
Haskell,U.S. Senate,Jim Inhofe,REP,310016,2,15,102,119,
Haskell,U.S. Senate,Aaron Delozier,IND,310016,0,0,0,0,
Haskell,U.S. Senate,Ray Woods,IND,310016,2,0,2,4,
Haskell,U.S. Senate,Joan Farr,IND,310016,0,0,1,1,
Haskell,U.S. Senate,Connie Johnson,DEM,310016,1,7,43,51,
Haskell,U.S. Senate,James Lankford,REP,310016,3,14,106,123,
Haskell,U.S. Senate,Mark Beard,IND,310016,0,0,4,4,
Haskell,U.S. House,Earl Everett,DEM,310016,2,5,34,41,02
Haskell,U.S. House,Markwayne Mullin,REP,310016,2,16,114,132,02
Haskell,U.S. House,Jon Douthitt,IND,310016,0,0,8,8,02
Haskell,Governor,Joe Dorman,DEM,310019,3,4,144,151,
Haskell,Governor,Mary Fallin,REP,310019,0,7,119,126,
Haskell,Governor,Kimberly Willis,IND,310019,0,0,4,4,
Haskell,Governor,Richard Prawdzienski,IND,310019,0,0,3,3,
Haskell,Lieutenant Governor,Cathy Cummings,DEM,310019,3,4,98,105,
Haskell,Lieutenant Governor,Todd Lamb,REP,310019,0,7,172,179,
Haskell,Superintendent of Public Instruction,John Cox,DEM,310019,3,6,190,199,
Haskell,Superintendent of Public Instruction,Joy Hofmeister,REP,310019,0,5,80,85,
Haskell,Commissioner of Labor,Mike Workman,DEM,310019,3,6,137,146,
Haskell,Commissioner of Labor,Mark Costello,REP,310019,0,5,130,135,
Haskell,U.S. Senate,Matt Silverstein,DEM,310019,3,1,90,94,
Haskell,U.S. Senate,Jim Inhofe,REP,310019,0,10,172,182,
Haskell,U.S. Senate,Aaron Delozier,IND,310019,0,0,0,0,
Haskell,U.S. Senate,Ray Woods,IND,310019,0,0,7,7,
Haskell,U.S. Senate,Joan Farr,IND,310019,0,0,0,0,
Haskell,U.S. Senate,Connie Johnson,DEM,310019,3,3,88,94,
Haskell,U.S. Senate,James Lankford,REP,310019,0,7,172,179,
Haskell,U.S. Senate,Mark Beard,IND,310019,0,0,9,9,
Haskell,U.S. House,Earl Everett,DEM,310019,3,1,83,87,02
Haskell,U.S. House,Markwayne Mullin,REP,310019,0,10,182,192,02
Haskell,U.S. House,Jon Douthitt,IND,310019,0,0,3,3,02
Haskell,Governor,Joe Dorman,DEM,310023,1,4,160,165,
Haskell,Governor,Mary Fallin,REP,310023,5,14,125,144,
Haskell,Governor,Kimberly Willis,IND,310023,0,1,8,9,
Haskell,Governor,Richard Prawdzienski,IND,310023,0,0,4,4,
Haskell,Lieutenant Governor,Cathy Cummings,DEM,310023,1,4,112,117,
Haskell,Lieutenant Governor,Todd Lamb,REP,310023,5,15,181,201,
Haskell,Superintendent of Public Instruction,John Cox,DEM,310023,3,5,184,192,
Haskell,Superintendent of Public Instruction,Joy Hofmeister,REP,310023,3,14,113,130,
Haskell,Commissioner of Labor,Mike Workman,DEM,310023,3,5,156,164,
Haskell,Commissioner of Labor,Mark Costello,REP,310023,3,14,137,154,
Haskell,U.S. Senate,Matt Silverstein,DEM,310023,0,4,97,101,
Haskell,U.S. Senate,Jim Inhofe,REP,310023,6,15,188,209,
Haskell,U.S. Senate,Aaron Delozier,IND,310023,0,0,3,3,
Haskell,U.S. Senate,Ray Woods,IND,310023,0,0,3,3,
Haskell,U.S. Senate,Joan Farr,IND,310023,0,0,2,2,
Haskell,U.S. Senate,Connie Johnson,DEM,310023,1,3,97,101,
Haskell,U.S. Senate,James Lankford,REP,310023,5,16,184,205,
Haskell,U.S. Senate,Mark Beard,IND,310023,0,0,10,10,
Haskell,U.S. House,Earl Everett,DEM,310023,0,2,87,89,02
Haskell,U.S. House,Markwayne Mullin,REP,310023,5,16,201,222,02
Haskell,U.S. House,Jon Douthitt,IND,310023,1,1,7,9,02
Haskell,Governor,Joe Dorman,DEM,310027,5,22,133,160,
Haskell,Governor,Mary Fallin,REP,310027,5,24,163,192,
Haskell,Governor,Kimberly Willis,IND,310027,0,1,3,4,
Haskell,Governor,Richard Prawdzienski,IND,310027,0,0,0,0,
Haskell,Lieutenant Governor,Cathy Cummings,DEM,310027,6,15,84,105,
Haskell,Lieutenant Governor,Todd Lamb,REP,310027,4,31,211,246,
Haskell,Superintendent of Public Instruction,John Cox,DEM,310027,5,25,164,194,
Haskell,Superintendent of Public Instruction,Joy Hofmeister,REP,310027,5,21,133,159,
Haskell,Commissioner of Labor,Mike Workman,DEM,310027,6,21,115,142,
Haskell,Commissioner of Labor,Mark Costello,REP,310027,4,23,172,199,
Haskell,U.S. Senate,Matt Silverstein,DEM,310027,4,13,69,86,
Haskell,U.S. Senate,Jim Inhofe,REP,310027,6,31,220,257,
Haskell,U.S. Senate,Aaron Delozier,IND,310027,0,0,1,1,
Haskell,U.S. Senate,Ray Woods,IND,310027,0,0,4,4,
Haskell,U.S. Senate,Joan Farr,IND,310027,0,2,3,5,
Haskell,U.S. Senate,Connie Johnson,DEM,310027,5,16,70,91,
Haskell,U.S. Senate,James Lankford,REP,310027,5,28,214,247,
Haskell,U.S. Senate,Mark Beard,IND,310027,0,3,10,13,
Haskell,U.S. House,Earl Everett,DEM,310027,5,12,47,64,02
Haskell,U.S. House,Markwayne Mullin,REP,310027,5,33,242,280,02
Haskell,U.S. House,Jon Douthitt,IND,310027,0,1,8,9,02
Haskell,Governor,Joe Dorman,DEM,310030,2,8,84,94,
Haskell,Governor,Mary Fallin,REP,310030,0,10,102,112,
Haskell,Governor,Kimberly Willis,IND,310030,0,0,3,3,
Haskell,Governor,Richard Prawdzienski,IND,310030,0,0,0,0,
Haskell,Lieutenant Governor,Cathy Cummings,DEM,310030,1,8,47,56,
Haskell,Lieutenant Governor,Todd Lamb,REP,310030,1,10,141,152,
Haskell,Superintendent of Public Instruction,John Cox,DEM,310030,2,8,101,111,
Haskell,Superintendent of Public Instruction,Joy Hofmeister,REP,310030,0,10,88,98,
Haskell,Commissioner of Labor,Mike Workman,DEM,310030,1,7,65,73,
Haskell,Commissioner of Labor,Mark Costello,REP,310030,1,11,121,133,
Haskell,U.S. Senate,Matt Silverstein,DEM,310030,0,6,41,47,
Haskell,U.S. Senate,Jim Inhofe,REP,310030,2,12,143,157,
Haskell,U.S. Senate,Aaron Delozier,IND,310030,0,0,1,1,
Haskell,U.S. Senate,Ray Woods,IND,310030,0,0,0,0,
Haskell,U.S. Senate,Joan Farr,IND,310030,0,0,1,1,
Haskell,U.S. Senate,Connie Johnson,DEM,310030,1,6,45,52,
Haskell,U.S. Senate,James Lankford,REP,310030,1,12,142,155,
Haskell,U.S. Senate,Mark Beard,IND,310030,0,0,2,2,
Haskell,U.S. House,Earl Everett,DEM,310030,0,4,31,35,02
Haskell,U.S. House,Markwayne Mullin,REP,310030,2,12,146,160,02
Haskell,U.S. House,Jon Douthitt,IND,310030,0,2,9,11,02
Haskell,Governor,Joe Dorman,DEM,310031,8,13,165,186,
Haskell,Governor,Mary Fallin,REP,310031,4,12,194,210,
Haskell,Governor,Kimberly Willis,IND,310031,0,0,5,5,
Haskell,Governor,Richard Prawdzienski,IND,310031,0,0,2,2,
Haskell,Lieutenant Governor,Cathy Cummings,DEM,310031,9,8,132,149,
Haskell,Lieutenant Governor,Todd Lamb,REP,310031,3,17,232,252,
Haskell,Superintendent of Public Instruction,John Cox,DEM,310031,9,13,185,207,
Haskell,Superintendent of Public Instruction,Joy Hofmeister,REP,310031,3,12,177,192,
Haskell,Commissioner of Labor,Mike Workman,DEM,310031,9,13,154,176,
Haskell,Commissioner of Labor,Mark Costello,REP,310031,3,12,203,218,
Haskell,U.S. Senate,Matt Silverstein,DEM,310031,9,6,112,127,
Haskell,U.S. Senate,Jim Inhofe,REP,310031,3,19,240,262,
Haskell,U.S. Senate,Aaron Delozier,IND,310031,0,0,3,3,
Haskell,U.S. Senate,Ray Woods,IND,310031,0,0,6,6,
Haskell,U.S. Senate,Joan Farr,IND,310031,0,0,3,3,
Haskell,U.S. Senate,Connie Johnson,DEM,310031,9,6,113,128,
Haskell,U.S. Senate,James Lankford,REP,310031,3,19,233,255,
Haskell,U.S. Senate,Mark Beard,IND,310031,0,0,15,15,
Haskell,U.S. House,Earl Everett,DEM,310031,9,4,105,118,02
Haskell,U.S. House,Markwayne Mullin,REP,310031,3,20,243,266,02
Haskell,U.S. House,Jon Douthitt,IND,310031,0,1,15,16,02
Haskell,Governor,Joe Dorman,DEM,310032,5,2,116,123,
Haskell,Governor,Mary Fallin,REP,310032,0,5,128,133,
Haskell,Governor,Kimberly Willis,IND,310032,0,0,3,3,
Haskell,Governor,Richard Prawdzienski,IND,310032,0,0,4,4,
Haskell,Lieutenant Governor,Cathy Cummings,DEM,310032,5,1,87,93,
Haskell,Lieutenant Governor,Todd Lamb,REP,310032,0,6,164,170,
Haskell,Superintendent of Public Instruction,John Cox,DEM,310032,5,6,156,167,
Haskell,Superintendent of Public Instruction,Joy Hofmeister,REP,310032,0,1,97,98,
Haskell,Commissioner of Labor,Mike Workman,DEM,310032,5,2,119,126,
Haskell,Commissioner of Labor,Mark Costello,REP,310032,0,5,129,134,
Haskell,U.S. Senate,Matt Silverstein,DEM,310032,4,2,83,89,
Haskell,U.S. Senate,Jim Inhofe,REP,310032,1,5,155,161,
Haskell,U.S. Senate,Aaron Delozier,IND,310032,0,0,5,5,
Haskell,U.S. Senate,Ray Woods,IND,310032,0,0,6,6,
Haskell,U.S. Senate,Joan Farr,IND,310032,0,0,1,1,
Haskell,U.S. Senate,Connie Johnson,DEM,310032,5,1,78,84,
Haskell,U.S. Senate,James Lankford,REP,310032,0,6,164,170,
Haskell,U.S. Senate,Mark Beard,IND,310032,0,0,6,6,
Haskell,U.S. House,Earl Everett,DEM,310032,3,0,67,70,02
Haskell,U.S. House,Markwayne Mullin,REP,310032,1,7,172,180,02
Haskell,U.S. House,Jon Douthitt,IND,310032,0,0,12,12,02
Hughes,Governor,Joe Dorman,DEM,320010,0,0,0,0,
Hughes,Governor,Mary Fallin,REP,320010,0,0,0,0,
Hughes,Governor,Kimberly Willis,IND,320010,0,0,0,0,
Hughes,Governor,Richard Prawdzienski,IND,320010,0,0,0,0,
Hughes,Lieutenant Governor,Cathy Cummings,DEM,320010,0,0,0,0,
Hughes,Lieutenant Governor,Todd Lamb,REP,320010,0,0,0,0,
Hughes,Superintendent of Public Instruction,John Cox,DEM,320010,0,0,0,0,
Hughes,Superintendent of Public Instruction,Joy Hofmeister,REP,320010,0,0,0,0,
Hughes,Commissioner of Labor,Mike Workman,DEM,320010,0,0,0,0,
Hughes,Commissioner of Labor,Mark Costello,REP,320010,0,0,0,0,
Hughes,U.S. Senate,Matt Silverstein,DEM,320010,0,0,0,0,
Hughes,U.S. Senate,Jim Inhofe,REP,320010,0,0,0,0,
Hughes,U.S. Senate,Aaron Delozier,IND,320010,0,0,0,0,
Hughes,U.S. Senate,Ray Woods,IND,320010,0,0,0,0,
Hughes,U.S. Senate,Joan Farr,IND,320010,0,0,0,0,
Hughes,U.S. Senate,Connie Johnson,DEM,320010,0,0,0,0,
Hughes,U.S. Senate,James Lankford,REP,320010,0,0,0,0,
Hughes,U.S. Senate,Mark Beard,IND,320010,0,0,0,0,
Hughes,U.S. House,Earl Everett,DEM,320010,0,0,0,0,02
Hughes,U.S. House,Markwayne Mullin,REP,320010,0,0,0,0,02
Hughes,U.S. House,Jon Douthitt,IND,320010,0,0,0,0,02
Hughes,Governor,Joe Dorman,DEM,320011,2,11,137,150,
Hughes,Governor,Mary Fallin,REP,320011,14,16,173,203,
Hughes,Governor,Kimberly Willis,IND,320011,1,0,3,4,
Hughes,Governor,Richard Prawdzienski,IND,320011,0,1,7,8,
Hughes,Lieutenant Governor,Cathy Cummings,DEM,320011,3,6,100,109,
Hughes,Lieutenant Governor,Todd Lamb,REP,320011,14,22,216,252,
Hughes,Superintendent of Public Instruction,John Cox,DEM,320011,6,14,169,189,
Hughes,Superintendent of Public Instruction,Joy Hofmeister,REP,320011,11,13,144,168,
Hughes,Commissioner of Labor,Mike Workman,DEM,320011,5,16,152,173,
Hughes,Commissioner of Labor,Mark Costello,REP,320011,12,12,158,182,
Hughes,U.S. Senate,Matt Silverstein,DEM,320011,2,6,78,86,
Hughes,U.S. Senate,Jim Inhofe,REP,320011,15,23,224,262,
Hughes,U.S. Senate,Aaron Delozier,IND,320011,0,0,7,7,
Hughes,U.S. Senate,Ray Woods,IND,320011,0,0,4,4,
Hughes,U.S. Senate,Joan Farr,IND,320011,0,0,3,3,
Hughes,U.S. Senate,Connie Johnson,DEM,320011,2,6,94,102,
Hughes,U.S. Senate,James Lankford,REP,320011,15,19,210,244,
Hughes,U.S. Senate,Mark Beard,IND,320011,0,3,12,15,
Hughes,U.S. House,Earl Everett,DEM,320011,2,12,108,122,02
Hughes,U.S. House,Markwayne Mullin,REP,320011,15,15,186,216,02
Hughes,U.S. House,Jon Douthitt,IND,320011,0,1,19,20,02
Hughes,Governor,Joe Dorman,DEM,320012,3,8,87,98,
Hughes,Governor,Mary Fallin,REP,320012,7,11,100,118,
Hughes,Governor,Kimberly Willis,IND,320012,0,0,4,4,
Hughes,Governor,Richard Prawdzienski,IND,320012,0,0,1,1,
Hughes,Lieutenant Governor,Cathy Cummings,DEM,320012,5,1,66,72,
Hughes,Lieutenant Governor,Todd Lamb,REP,320012,5,17,124,146,
Hughes,Superintendent of Public Instruction,John Cox,DEM,320012,7,13,110,130,
Hughes,Superintendent of Public Instruction,Joy Hofmeister,REP,320012,3,6,77,86,
Hughes,Commissioner of Labor,Mike Workman,DEM,320012,6,9,89,104,
Hughes,Commissioner of Labor,Mark Costello,REP,320012,5,8,97,110,
Hughes,U.S. Senate,Matt Silverstein,DEM,320012,3,4,48,55,
Hughes,U.S. Senate,Jim Inhofe,REP,320012,4,14,137,155,
Hughes,U.S. Senate,Aaron Delozier,IND,320012,1,0,1,2,
Hughes,U.S. Senate,Ray Woods,IND,320012,2,0,2,4,
Hughes,U.S. Senate,Joan Farr,IND,320012,0,0,2,2,
Hughes,U.S. Senate,Connie Johnson,DEM,320012,5,4,53,62,
Hughes,U.S. Senate,James Lankford,REP,320012,5,14,130,149,
Hughes,U.S. Senate,Mark Beard,IND,320012,0,0,7,7,
Hughes,U.S. House,Earl Everett,DEM,320012,6,6,68,80,02
Hughes,U.S. House,Markwayne Mullin,REP,320012,4,12,108,124,02
Hughes,U.S. House,Jon Douthitt,IND,320012,0,0,14,14,02
Hughes,Governor,Joe Dorman,DEM,320016,0,8,33,41,
Hughes,Governor,Mary Fallin,REP,320016,0,5,44,49,
Hughes,Governor,Kimberly Willis,IND,320016,0,1,4,5,
Hughes,Governor,Richard Prawdzienski,IND,320016,0,0,2,2,
Hughes,Lieutenant Governor,Cathy Cummings,DEM,320016,0,4,23,27,
Hughes,Lieutenant Governor,Todd Lamb,REP,320016,0,9,58,67,
Hughes,Superintendent of Public Instruction,John Cox,DEM,320016,0,9,43,52,
Hughes,Superintendent of Public Instruction,Joy Hofmeister,REP,320016,0,5,38,43,
Hughes,Commissioner of Labor,Mike Workman,DEM,320016,0,8,39,47,
Hughes,Commissioner of Labor,Mark Costello,REP,320016,0,4,39,43,
Hughes,U.S. Senate,Matt Silverstein,DEM,320016,0,4,18,22,
Hughes,U.S. Senate,Jim Inhofe,REP,320016,0,9,59,68,
Hughes,U.S. Senate,Aaron Delozier,IND,320016,0,0,0,0,
Hughes,U.S. Senate,Ray Woods,IND,320016,0,0,2,2,
Hughes,U.S. Senate,Joan Farr,IND,320016,0,1,2,3,
Hughes,U.S. Senate,Connie Johnson,DEM,320016,0,4,18,22,
Hughes,U.S. Senate,James Lankford,REP,320016,0,10,62,72,
Hughes,U.S. Senate,Mark Beard,IND,320016,0,0,3,3,
Hughes,U.S. House,Earl Everett,DEM,320016,0,5,31,36,02
Hughes,U.S. House,Markwayne Mullin,REP,320016,0,6,41,47,02
Hughes,U.S. House,Jon Douthitt,IND,320016,0,1,7,8,02
Hughes,Governor,Joe Dorman,DEM,320018,3,4,57,64,
Hughes,Governor,Mary Fallin,REP,320018,1,1,86,88,
Hughes,Governor,Kimberly Willis,IND,320018,0,0,1,1,
Hughes,Governor,Richard Prawdzienski,IND,320018,0,0,0,0,
Hughes,Lieutenant Governor,Cathy Cummings,DEM,320018,1,3,33,37,
Hughes,Lieutenant Governor,Todd Lamb,REP,320018,3,1,109,113,
Hughes,Superintendent of Public Instruction,John Cox,DEM,320018,2,4,63,69,
Hughes,Superintendent of Public Instruction,Joy Hofmeister,REP,320018,1,0,81,82,
Hughes,Commissioner of Labor,Mike Workman,DEM,320018,3,3,63,69,
Hughes,Commissioner of Labor,Mark Costello,REP,320018,1,1,77,79,
Hughes,U.S. Senate,Matt Silverstein,DEM,320018,0,3,34,37,
Hughes,U.S. Senate,Jim Inhofe,REP,320018,4,1,108,113,
Hughes,U.S. Senate,Aaron Delozier,IND,320018,0,0,1,1,
Hughes,U.S. Senate,Ray Woods,IND,320018,0,0,3,3,
Hughes,U.S. Senate,Joan Farr,IND,320018,0,0,0,0,
Hughes,U.S. Senate,Connie Johnson,DEM,320018,0,3,31,34,
Hughes,U.S. Senate,James Lankford,REP,320018,4,1,113,118,
Hughes,U.S. Senate,Mark Beard,IND,320018,0,0,2,2,
Hughes,U.S. House,Earl Everett,DEM,320018,0,3,42,45,02
Hughes,U.S. House,Markwayne Mullin,REP,320018,4,2,90,96,02
Hughes,U.S. House,Jon Douthitt,IND,320018,0,0,9,9,02
Hughes,Governor,Joe Dorman,DEM,320019,0,0,33,33,
Hughes,Governor,Mary Fallin,REP,320019,0,2,28,30,
Hughes,Governor,Kimberly Willis,IND,320019,0,1,2,3,
Hughes,Governor,Richard Prawdzienski,IND,320019,0,0,3,3,
Hughes,Lieutenant Governor,Cathy Cummings,DEM,320019,0,0,24,24,
Hughes,Lieutenant Governor,Todd Lamb,REP,320019,0,3,42,45,
Hughes,Superintendent of Public Instruction,John Cox,DEM,320019,0,0,41,41,
Hughes,Superintendent of Public Instruction,Joy Hofmeister,REP,320019,0,3,24,27,
Hughes,Commissioner of Labor,Mike Workman,DEM,320019,0,0,41,41,
Hughes,Commissioner of Labor,Mark Costello,REP,320019,0,3,24,27,
Hughes,U.S. Senate,Matt Silverstein,DEM,320019,0,0,18,18,
Hughes,U.S. Senate,Jim Inhofe,REP,320019,0,3,43,46,
Hughes,U.S. Senate,Aaron Delozier,IND,320019,0,0,2,2,
Hughes,U.S. Senate,Ray Woods,IND,320019,0,0,1,1,
Hughes,U.S. Senate,Joan Farr,IND,320019,0,0,2,2,
Hughes,U.S. Senate,Connie Johnson,DEM,320019,0,0,19,19,
Hughes,U.S. Senate,James Lankford,REP,320019,0,3,43,46,
Hughes,U.S. Senate,Mark Beard,IND,320019,0,0,3,3,
Hughes,U.S. House,Earl Everett,DEM,320019,0,0,26,26,02
Hughes,U.S. House,Markwayne Mullin,REP,320019,0,3,35,38,02
Hughes,U.S. House,Jon Douthitt,IND,320019,0,0,5,5,02
Hughes,Governor,Joe Dorman,DEM,320020,4,5,188,197,
Hughes,Governor,Mary Fallin,REP,320020,12,6,210,228,
Hughes,Governor,Kimberly Willis,IND,320020,0,0,6,6,
Hughes,Governor,Richard Prawdzienski,IND,320020,1,0,3,4,
Hughes,Lieutenant Governor,Cathy Cummings,DEM,320020,4,4,154,162,
Hughes,Lieutenant Governor,Todd Lamb,REP,320020,13,7,248,268,
Hughes,Superintendent of Public Instruction,John Cox,DEM,320020,3,6,227,236,
Hughes,Superintendent of Public Instruction,Joy Hofmeister,REP,320020,14,5,173,192,
Hughes,Commissioner of Labor,Mike Workman,DEM,320020,4,5,202,211,
Hughes,Commissioner of Labor,Mark Costello,REP,320020,13,6,192,211,
Hughes,U.S. Senate,Matt Silverstein,DEM,320020,4,3,132,139,
Hughes,U.S. Senate,Jim Inhofe,REP,320020,13,7,257,277,
Hughes,U.S. Senate,Aaron Delozier,IND,320020,0,1,7,8,
Hughes,U.S. Senate,Ray Woods,IND,320020,0,0,3,3,
Hughes,U.S. Senate,Joan Farr,IND,320020,0,0,1,1,
Hughes,U.S. Senate,Connie Johnson,DEM,320020,2,3,127,132,
Hughes,U.S. Senate,James Lankford,REP,320020,15,7,267,289,
Hughes,U.S. Senate,Mark Beard,IND,320020,0,1,9,10,
Hughes,U.S. House,Earl Everett,DEM,320020,3,2,153,158,02
Hughes,U.S. House,Markwayne Mullin,REP,320020,13,9,227,249,02
Hughes,U.S. House,Jon Douthitt,IND,320020,1,0,20,21,02
Hughes,Governor,Joe Dorman,DEM,320021,2,5,72,79,
Hughes,Governor,Mary Fallin,REP,320021,5,8,80,93,
Hughes,Governor,Kimberly Willis,IND,320021,0,0,3,3,
Hughes,Governor,Richard Prawdzienski,IND,320021,0,0,1,1,
Hughes,Lieutenant Governor,Cathy Cummings,DEM,320021,3,8,55,66,
Hughes,Lieutenant Governor,Todd Lamb,REP,320021,4,5,101,110,
Hughes,Superintendent of Public Instruction,John Cox,DEM,320021,3,10,94,107,
Hughes,Superintendent of Public Instruction,Joy Hofmeister,REP,320021,4,3,59,66,
Hughes,Commissioner of Labor,Mike Workman,DEM,320021,3,9,85,97,
Hughes,Commissioner of Labor,Mark Costello,REP,320021,4,4,64,72,
Hughes,U.S. Senate,Matt Silverstein,DEM,320021,3,4,48,55,
Hughes,U.S. Senate,Jim Inhofe,REP,320021,4,8,100,112,
Hughes,U.S. Senate,Aaron Delozier,IND,320021,0,0,2,2,
Hughes,U.S. Senate,Ray Woods,IND,320021,0,1,1,2,
Hughes,U.S. Senate,Joan Farr,IND,320021,0,0,2,2,
Hughes,U.S. Senate,Connie Johnson,DEM,320021,2,6,51,59,
Hughes,U.S. Senate,James Lankford,REP,320021,4,7,103,114,
Hughes,U.S. Senate,Mark Beard,IND,320021,1,0,2,3,
Hughes,U.S. House,Earl Everett,DEM,320021,3,6,54,63,02
Hughes,U.S. House,Markwayne Mullin,REP,320021,4,6,91,101,02
Hughes,U.S. House,Jon Douthitt,IND,320021,0,1,8,9,02
Hughes,Governor,Joe Dorman,DEM,320022,1,1,57,59,
Hughes,Governor,Mary Fallin,REP,320022,2,2,79,83,
Hughes,Governor,Kimberly Willis,IND,320022,0,0,3,3,
Hughes,Governor,Richard Prawdzienski,IND,320022,0,0,3,3,
Hughes,Lieutenant Governor,Cathy Cummings,DEM,320022,1,1,51,53,
Hughes,Lieutenant Governor,Todd Lamb,REP,320022,2,2,88,92,
Hughes,Superintendent of Public Instruction,John Cox,DEM,320022,1,0,73,74,
Hughes,Superintendent of Public Instruction,Joy Hofmeister,REP,320022,2,3,65,70,
Hughes,Commissioner of Labor,Mike Workman,DEM,320022,1,0,66,67,
Hughes,Commissioner of Labor,Mark Costello,REP,320022,2,2,70,74,
Hughes,U.S. Senate,Matt Silverstein,DEM,320022,1,0,47,48,
Hughes,U.S. Senate,Jim Inhofe,REP,320022,2,3,91,96,
Hughes,U.S. Senate,Aaron Delozier,IND,320022,0,0,1,1,
Hughes,U.S. Senate,Ray Woods,IND,320022,0,0,1,1,
Hughes,U.S. Senate,Joan Farr,IND,320022,0,0,0,0,
Hughes,U.S. Senate,Connie Johnson,DEM,320022,1,0,50,51,
Hughes,U.S. Senate,James Lankford,REP,320022,2,2,87,91,
Hughes,U.S. Senate,Mark Beard,IND,320022,0,0,3,3,
Hughes,U.S. House,Earl Everett,DEM,320022,1,0,49,50,02
Hughes,U.S. House,Markwayne Mullin,REP,320022,2,3,84,89,02
Hughes,U.S. House,Jon Douthitt,IND,320022,0,0,6,6,02
Hughes,Governor,Joe Dorman,DEM,320023,2,4,34,40,
Hughes,Governor,Mary Fallin,REP,320023,0,6,43,49,
Hughes,Governor,Kimberly Willis,IND,320023,0,0,5,5,
Hughes,Governor,Richard Prawdzienski,IND,320023,0,0,2,2,
Hughes,Lieutenant Governor,Cathy Cummings,DEM,320023,0,4,27,31,
Hughes,Lieutenant Governor,Todd Lamb,REP,320023,2,7,55,64,
Hughes,Superintendent of Public Instruction,John Cox,DEM,320023,2,4,49,55,
Hughes,Superintendent of Public Instruction,Joy Hofmeister,REP,320023,0,5,33,38,
Hughes,Commissioner of Labor,Mike Workman,DEM,320023,0,6,45,51,
Hughes,Commissioner of Labor,Mark Costello,REP,320023,2,5,36,43,
Hughes,U.S. Senate,Matt Silverstein,DEM,320023,0,2,23,25,
Hughes,U.S. Senate,Jim Inhofe,REP,320023,2,9,52,63,
Hughes,U.S. Senate,Aaron Delozier,IND,320023,0,0,2,2,
Hughes,U.S. Senate,Ray Woods,IND,320023,0,0,4,4,
Hughes,U.S. Senate,Joan Farr,IND,320023,0,0,1,1,
Hughes,U.S. Senate,Connie Johnson,DEM,320023,0,2,24,26,
Hughes,U.S. Senate,James Lankford,REP,320023,2,9,56,67,
Hughes,U.S. Senate,Mark Beard,IND,320023,0,0,3,3,
Hughes,U.S. House,Earl Everett,DEM,320023,0,4,33,37,02
Hughes,U.S. House,Markwayne Mullin,REP,320023,2,7,44,53,02
Hughes,U.S. House,Jon Douthitt,IND,320023,0,0,6,6,02
Hughes,Governor,Joe Dorman,DEM,320030,0,1,58,59,
Hughes,Governor,Mary Fallin,REP,320030,2,0,61,63,
Hughes,Governor,Kimberly Willis,IND,320030,0,0,1,1,
Hughes,Governor,Richard Prawdzienski,IND,320030,0,0,3,3,
Hughes,Lieutenant Governor,Cathy Cummings,DEM,320030,0,1,48,49,
Hughes,Lieutenant Governor,Todd Lamb,REP,320030,2,0,75,77,
Hughes,Superintendent of Public Instruction,John Cox,DEM,320030,0,1,75,76,
Hughes,Superintendent of Public Instruction,Joy Hofmeister,REP,320030,2,0,47,49,
Hughes,Commissioner of Labor,Mike Workman,DEM,320030,0,1,70,71,
Hughes,Commissioner of Labor,Mark Costello,REP,320030,2,0,53,55,
Hughes,U.S. Senate,Matt Silverstein,DEM,320030,0,1,34,35,
Hughes,U.S. Senate,Jim Inhofe,REP,320030,2,0,81,83,
Hughes,U.S. Senate,Aaron Delozier,IND,320030,0,0,4,4,
Hughes,U.S. Senate,Ray Woods,IND,320030,0,0,2,2,
Hughes,U.S. Senate,Joan Farr,IND,320030,0,0,2,2,
Hughes,U.S. Senate,Connie Johnson,DEM,320030,0,1,38,39,
Hughes,U.S. Senate,James Lankford,REP,320030,2,0,78,80,
Hughes,U.S. Senate,Mark Beard,IND,320030,0,0,5,5,
Hughes,U.S. House,Earl Everett,DEM,320030,0,1,46,47,02
Hughes,U.S. House,Markwayne Mullin,REP,320030,2,0,64,66,02
Hughes,U.S. House,Jon Douthitt,IND,320030,0,0,11,11,02
Hughes,Governor,Joe Dorman,DEM,320031,0,3,58,61,
Hughes,Governor,Mary Fallin,REP,320031,0,3,110,113,
Hughes,Governor,Kimberly Willis,IND,320031,0,0,2,2,
Hughes,Governor,Richard Prawdzienski,IND,320031,0,0,3,3,
Hughes,Lieutenant Governor,Cathy Cummings,DEM,320031,0,3,50,53,
Hughes,Lieutenant Governor,Todd Lamb,REP,320031,0,3,123,126,
Hughes,Superintendent of Public Instruction,John Cox,DEM,320031,0,3,78,81,
Hughes,Superintendent of Public Instruction,Joy Hofmeister,REP,320031,0,3,95,98,
Hughes,Commissioner of Labor,Mike Workman,DEM,320031,0,3,77,80,
Hughes,Commissioner of Labor,Mark Costello,REP,320031,0,3,91,94,
Hughes,U.S. Senate,Matt Silverstein,DEM,320031,0,2,35,37,
Hughes,U.S. Senate,Jim Inhofe,REP,320031,0,3,130,133,
Hughes,U.S. Senate,Aaron Delozier,IND,320031,0,0,2,2,
Hughes,U.S. Senate,Ray Woods,IND,320031,0,1,4,5,
Hughes,U.S. Senate,Joan Farr,IND,320031,0,0,1,1,
Hughes,U.S. Senate,Connie Johnson,DEM,320031,0,2,35,37,
Hughes,U.S. Senate,James Lankford,REP,320031,0,4,134,138,
Hughes,U.S. Senate,Mark Beard,IND,320031,0,0,4,4,
Hughes,U.S. House,Earl Everett,DEM,320031,0,2,51,53,02
Hughes,U.S. House,Markwayne Mullin,REP,320031,0,4,114,118,02
Hughes,U.S. House,Jon Douthitt,IND,320031,0,0,6,6,02
Hughes,Governor,Joe Dorman,DEM,320032,0,0,81,81,
Hughes,Governor,Mary Fallin,REP,320032,3,2,59,64,
Hughes,Governor,Kimberly Willis,IND,320032,0,0,5,5,
Hughes,Governor,Richard Prawdzienski,IND,320032,0,0,4,4,
Hughes,Lieutenant Governor,Cathy Cummings,DEM,320032,0,0,63,63,
Hughes,Lieutenant Governor,Todd Lamb,REP,320032,3,2,85,90,
Hughes,Superintendent of Public Instruction,John Cox,DEM,320032,0,0,96,96,
Hughes,Superintendent of Public Instruction,Joy Hofmeister,REP,320032,3,2,53,58,
Hughes,Commissioner of Labor,Mike Workman,DEM,320032,0,1,85,86,
Hughes,Commissioner of Labor,Mark Costello,REP,320032,3,1,63,67,
Hughes,U.S. Senate,Matt Silverstein,DEM,320032,0,0,55,55,
Hughes,U.S. Senate,Jim Inhofe,REP,320032,3,2,89,94,
Hughes,U.S. Senate,Aaron Delozier,IND,320032,0,0,0,0,
Hughes,U.S. Senate,Ray Woods,IND,320032,0,0,3,3,
Hughes,U.S. Senate,Joan Farr,IND,320032,0,0,2,2,
Hughes,U.S. Senate,Connie Johnson,DEM,320032,0,0,61,61,
Hughes,U.S. Senate,James Lankford,REP,320032,3,2,83,88,
Hughes,U.S. Senate,Mark Beard,IND,320032,0,0,5,5,
Hughes,U.S. House,Earl Everett,DEM,320032,0,0,71,71,02
Hughes,U.S. House,Markwayne Mullin,REP,320032,3,2,71,76,02
Hughes,U.S. House,Jon Douthitt,IND,320032,0,0,5,5,02
Hughes,Governor,Joe Dorman,DEM,320033,2,2,54,58,
Hughes,Governor,Mary Fallin,REP,320033,0,4,95,99,
Hughes,Governor,Kimberly Willis,IND,320033,0,0,6,6,
Hughes,Governor,Richard Prawdzienski,IND,320033,0,0,6,6,
Hughes,Lieutenant Governor,Cathy Cummings,DEM,320033,2,1,45,48,
Hughes,Lieutenant Governor,Todd Lamb,REP,320033,0,5,114,119,
Hughes,Superintendent of Public Instruction,John Cox,DEM,320033,2,4,77,83,
Hughes,Superintendent of Public Instruction,Joy Hofmeister,REP,320033,0,2,83,85,
Hughes,Commissioner of Labor,Mike Workman,DEM,320033,2,3,65,70,
Hughes,Commissioner of Labor,Mark Costello,REP,320033,0,1,89,90,
Hughes,U.S. Senate,Matt Silverstein,DEM,320033,2,0,28,30,
Hughes,U.S. Senate,Jim Inhofe,REP,320033,0,6,123,129,
Hughes,U.S. Senate,Aaron Delozier,IND,320033,0,0,1,1,
Hughes,U.S. Senate,Ray Woods,IND,320033,0,0,4,4,
Hughes,U.S. Senate,Joan Farr,IND,320033,0,0,2,2,
Hughes,U.S. Senate,Connie Johnson,DEM,320033,2,0,38,40,
Hughes,U.S. Senate,James Lankford,REP,320033,0,6,115,121,
Hughes,U.S. Senate,Mark Beard,IND,320033,0,0,8,8,
Hughes,U.S. House,Earl Everett,DEM,320033,2,1,44,47,02
Hughes,U.S. House,Markwayne Mullin,REP,320033,0,5,102,107,02
Hughes,U.S. House,Jon Douthitt,IND,320033,0,0,12,12,02
Hughes,Governor,Joe Dorman,DEM,320034,0,2,49,51,
Hughes,Governor,Mary Fallin,REP,320034,0,3,52,55,
Hughes,Governor,Kimberly Willis,IND,320034,0,0,3,3,
Hughes,Governor,Richard Prawdzienski,IND,320034,0,0,3,3,
Hughes,Lieutenant Governor,Cathy Cummings,DEM,320034,0,1,24,25,
Hughes,Lieutenant Governor,Todd Lamb,REP,320034,0,4,79,83,
Hughes,Superintendent of Public Instruction,John Cox,DEM,320034,0,3,66,69,
Hughes,Superintendent of Public Instruction,Joy Hofmeister,REP,320034,0,2,39,41,
Hughes,Commissioner of Labor,Mike Workman,DEM,320034,0,2,47,49,
Hughes,Commissioner of Labor,Mark Costello,REP,320034,0,3,55,58,
Hughes,U.S. Senate,Matt Silverstein,DEM,320034,0,0,23,23,
Hughes,U.S. Senate,Jim Inhofe,REP,320034,0,5,76,81,
Hughes,U.S. Senate,Aaron Delozier,IND,320034,0,0,1,1,
Hughes,U.S. Senate,Ray Woods,IND,320034,0,0,3,3,
Hughes,U.S. Senate,Joan Farr,IND,320034,0,0,3,3,
Hughes,U.S. Senate,Connie Johnson,DEM,320034,0,1,22,23,
Hughes,U.S. Senate,James Lankford,REP,320034,0,4,79,83,
Hughes,U.S. Senate,Mark Beard,IND,320034,0,0,5,5,
Hughes,U.S. House,Earl Everett,DEM,320034,0,0,27,27,02
Hughes,U.S. House,Markwayne Mullin,REP,320034,0,5,73,78,02
Hughes,U.S. House,Jon Douthitt,IND,320034,0,0,6,6,02
Hughes,Governor,Joe Dorman,DEM,320035,3,18,170,191,
Hughes,Governor,Mary Fallin,REP,320035,3,11,206,220,
Hughes,Governor,Kimberly Willis,IND,320035,0,0,9,9,
Hughes,Governor,Richard Prawdzienski,IND,320035,0,0,2,2,
Hughes,Lieutenant Governor,Cathy Cummings,DEM,320035,2,14,135,151,
Hughes,Lieutenant Governor,Todd Lamb,REP,320035,3,16,249,268,
Hughes,Superintendent of Public Instruction,John Cox,DEM,320035,3,17,210,230,
Hughes,Superintendent of Public Instruction,Joy Hofmeister,REP,320035,3,12,172,187,
Hughes,Commissioner of Labor,Mike Workman,DEM,320035,4,18,197,219,
Hughes,Commissioner of Labor,Mark Costello,REP,320035,1,10,184,195,
Hughes,U.S. Senate,Matt Silverstein,DEM,320035,2,12,111,125,
Hughes,U.S. Senate,Jim Inhofe,REP,320035,3,17,255,275,
Hughes,U.S. Senate,Aaron Delozier,IND,320035,0,1,2,3,
Hughes,U.S. Senate,Ray Woods,IND,320035,0,0,12,12,
Hughes,U.S. Senate,Joan Farr,IND,320035,0,0,6,6,
Hughes,U.S. Senate,Connie Johnson,DEM,320035,2,13,113,128,
Hughes,U.S. Senate,James Lankford,REP,320035,2,16,256,274,
Hughes,U.S. Senate,Mark Beard,IND,320035,0,1,13,14,
Hughes,U.S. House,Earl Everett,DEM,320035,1,15,126,142,02
Hughes,U.S. House,Markwayne Mullin,REP,320035,3,13,235,251,02
Hughes,U.S. House,Jon Douthitt,IND,320035,0,0,21,21,02
Jackson,Governor,Joe Dorman,DEM,330001,3,20,114,137,
Jackson,Governor,Mary Fallin,REP,330001,18,73,498,589,
Jackson,Governor,Kimberly Willis,IND,330001,1,0,7,8,
Jackson,Governor,Richard Prawdzienski,IND,330001,0,0,4,4,
Jackson,Lieutenant Governor,Cathy Cummings,DEM,330001,2,12,73,87,
Jackson,Lieutenant Governor,Todd Lamb,REP,330001,18,81,554,653,
Jackson,Superintendent of Public Instruction,John Cox,DEM,330001,2,18,119,139,
Jackson,Superintendent of Public Instruction,Joy Hofmeister,REP,330001,18,74,505,597,
Jackson,Commissioner of Labor,Mike Workman,DEM,330001,2,16,106,124,
Jackson,Commissioner of Labor,Mark Costello,REP,330001,18,75,505,598,
Jackson,U.S. Senate,Matt Silverstein,DEM,330001,1,9,63,73,
Jackson,U.S. Senate,Jim Inhofe,REP,330001,19,84,545,648,
Jackson,U.S. Senate,Aaron Delozier,IND,330001,1,0,3,4,
Jackson,U.S. Senate,Ray Woods,IND,330001,0,0,8,8,
Jackson,U.S. Senate,Joan Farr,IND,330001,0,0,7,7,
Jackson,U.S. Senate,Connie Johnson,DEM,330001,1,10,66,77,
Jackson,U.S. Senate,James Lankford,REP,330001,18,83,545,646,
Jackson,U.S. Senate,Mark Beard,IND,330001,2,0,18,20,
Jackson,U.S. House,Frankie Robbins,DEM,330001,3,10,73,86,03
Jackson,U.S. House,Frank Lucas,REP,330001,17,82,551,650,03
Jackson,Governor,Joe Dorman,DEM,330002,1,8,52,61,
Jackson,Governor,Mary Fallin,REP,330002,3,29,168,200,
Jackson,Governor,Kimberly Willis,IND,330002,0,1,1,2,
Jackson,Governor,Richard Prawdzienski,IND,330002,0,0,2,2,
Jackson,Lieutenant Governor,Cathy Cummings,DEM,330002,1,4,26,31,
Jackson,Lieutenant Governor,Todd Lamb,REP,330002,3,34,196,233,
Jackson,Superintendent of Public Instruction,John Cox,DEM,330002,1,7,50,58,
Jackson,Superintendent of Public Instruction,Joy Hofmeister,REP,330002,3,30,171,204,
Jackson,Commissioner of Labor,Mike Workman,DEM,330002,1,5,40,46,
Jackson,Commissioner of Labor,Mark Costello,REP,330002,3,32,170,205,
Jackson,U.S. Senate,Matt Silverstein,DEM,330002,1,2,23,26,
Jackson,U.S. Senate,Jim Inhofe,REP,330002,3,35,195,233,
Jackson,U.S. Senate,Aaron Delozier,IND,330002,0,0,1,1,
Jackson,U.S. Senate,Ray Woods,IND,330002,0,0,0,0,
Jackson,U.S. Senate,Joan Farr,IND,330002,0,0,2,2,
Jackson,U.S. Senate,Connie Johnson,DEM,330002,1,2,29,32,
Jackson,U.S. Senate,James Lankford,REP,330002,3,36,187,226,
Jackson,U.S. Senate,Mark Beard,IND,330002,0,0,4,4,
Jackson,U.S. House,Frankie Robbins,DEM,330002,1,3,22,26,03
Jackson,U.S. House,Frank Lucas,REP,330002,3,34,199,236,03
Jackson,Governor,Joe Dorman,DEM,330003,1,5,75,81,
Jackson,Governor,Mary Fallin,REP,330003,3,9,127,139,
Jackson,Governor,Kimberly Willis,IND,330003,1,0,9,10,
Jackson,Governor,Richard Prawdzienski,IND,330003,0,0,2,2,
Jackson,Lieutenant Governor,Cathy Cummings,DEM,330003,1,4,69,74,
Jackson,Lieutenant Governor,Todd Lamb,REP,330003,4,10,144,158,
Jackson,Superintendent of Public Instruction,John Cox,DEM,330003,1,6,81,88,
Jackson,Superintendent of Public Instruction,Joy Hofmeister,REP,330003,4,8,131,143,
Jackson,Commissioner of Labor,Mike Workman,DEM,330003,1,5,75,81,
Jackson,Commissioner of Labor,Mark Costello,REP,330003,4,9,137,150,
Jackson,U.S. Senate,Matt Silverstein,DEM,330003,0,4,62,66,
Jackson,U.S. Senate,Jim Inhofe,REP,330003,5,10,141,156,
Jackson,U.S. Senate,Aaron Delozier,IND,330003,0,0,2,2,
Jackson,U.S. Senate,Ray Woods,IND,330003,0,0,5,5,
Jackson,U.S. Senate,Joan Farr,IND,330003,0,0,3,3,
Jackson,U.S. Senate,Connie Johnson,DEM,330003,1,5,68,74,
Jackson,U.S. Senate,James Lankford,REP,330003,4,9,141,154,
Jackson,U.S. Senate,Mark Beard,IND,330003,0,0,4,4,
Jackson,U.S. House,Frankie Robbins,DEM,330003,1,5,71,77,03
Jackson,U.S. House,Frank Lucas,REP,330003,4,9,142,155,03
Jackson,Governor,Joe Dorman,DEM,330006,3,11,113,127,
Jackson,Governor,Mary Fallin,REP,330006,12,37,398,447,
Jackson,Governor,Kimberly Willis,IND,330006,0,0,9,9,
Jackson,Governor,Richard Prawdzienski,IND,330006,0,1,7,8,
Jackson,Lieutenant Governor,Cathy Cummings,DEM,330006,0,7,74,81,
Jackson,Lieutenant Governor,Todd Lamb,REP,330006,15,43,450,508,
Jackson,Superintendent of Public Instruction,John Cox,DEM,330006,3,11,114,128,
Jackson,Superintendent of Public Instruction,Joy Hofmeister,REP,330006,12,39,411,462,
Jackson,Commissioner of Labor,Mike Workman,DEM,330006,2,8,118,128,
Jackson,Commissioner of Labor,Mark Costello,REP,330006,12,40,393,445,
Jackson,U.S. Senate,Matt Silverstein,DEM,330006,2,6,65,73,
Jackson,U.S. Senate,Jim Inhofe,REP,330006,13,44,450,507,
Jackson,U.S. Senate,Aaron Delozier,IND,330006,0,0,2,2,
Jackson,U.S. Senate,Ray Woods,IND,330006,0,0,5,5,
Jackson,U.S. Senate,Joan Farr,IND,330006,0,0,3,3,
Jackson,U.S. Senate,Connie Johnson,DEM,330006,1,7,71,79,
Jackson,U.S. Senate,James Lankford,REP,330006,14,43,443,500,
Jackson,U.S. Senate,Mark Beard,IND,330006,0,0,14,14,
Jackson,U.S. House,Frankie Robbins,DEM,330006,0,7,74,81,03
Jackson,U.S. House,Frank Lucas,REP,330006,15,43,451,509,03
Jackson,Governor,Joe Dorman,DEM,330007,1,4,93,98,
Jackson,Governor,Mary Fallin,REP,330007,5,8,168,181,
Jackson,Governor,Kimberly Willis,IND,330007,0,0,10,10,
Jackson,Governor,Richard Prawdzienski,IND,330007,1,1,3,5,
Jackson,Lieutenant Governor,Cathy Cummings,DEM,330007,2,5,80,87,
Jackson,Lieutenant Governor,Todd Lamb,REP,330007,5,8,194,207,
Jackson,Superintendent of Public Instruction,John Cox,DEM,330007,3,5,100,108,
Jackson,Superintendent of Public Instruction,Joy Hofmeister,REP,330007,4,8,173,185,
Jackson,Commissioner of Labor,Mike Workman,DEM,330007,2,6,95,103,
Jackson,Commissioner of Labor,Mark Costello,REP,330007,5,6,176,187,
Jackson,U.S. Senate,Matt Silverstein,DEM,330007,2,3,74,79,
Jackson,U.S. Senate,Jim Inhofe,REP,330007,5,10,192,207,
Jackson,U.S. Senate,Aaron Delozier,IND,330007,0,0,2,2,
Jackson,U.S. Senate,Ray Woods,IND,330007,0,0,2,2,
Jackson,U.S. Senate,Joan Farr,IND,330007,0,0,3,3,
Jackson,U.S. Senate,Connie Johnson,DEM,330007,2,2,75,79,
Jackson,U.S. Senate,James Lankford,REP,330007,5,11,195,211,
Jackson,U.S. Senate,Mark Beard,IND,330007,0,0,3,3,
Jackson,U.S. House,Frankie Robbins,DEM,330007,2,4,78,84,03
Jackson,U.S. House,Frank Lucas,REP,330007,5,9,195,209,03
Jackson,Governor,Joe Dorman,DEM,330010,0,6,68,74,
Jackson,Governor,Mary Fallin,REP,330010,1,14,117,132,
Jackson,Governor,Kimberly Willis,IND,330010,0,1,7,8,
Jackson,Governor,Richard Prawdzienski,IND,330010,0,0,2,2,
Jackson,Lieutenant Governor,Cathy Cummings,DEM,330010,0,3,70,73,
Jackson,Lieutenant Governor,Todd Lamb,REP,330010,1,18,123,142,
Jackson,Superintendent of Public Instruction,John Cox,DEM,330010,1,6,79,86,
Jackson,Superintendent of Public Instruction,Joy Hofmeister,REP,330010,0,14,114,128,
Jackson,Commissioner of Labor,Mike Workman,DEM,330010,1,6,82,89,
Jackson,Commissioner of Labor,Mark Costello,REP,330010,0,12,110,122,
Jackson,U.S. Senate,Matt Silverstein,DEM,330010,0,3,58,61,
Jackson,U.S. Senate,Jim Inhofe,REP,330010,1,17,126,144,
Jackson,U.S. Senate,Aaron Delozier,IND,330010,0,0,4,4,
Jackson,U.S. Senate,Ray Woods,IND,330010,0,0,2,2,
Jackson,U.S. Senate,Joan Farr,IND,330010,0,1,4,5,
Jackson,U.S. Senate,Connie Johnson,DEM,330010,0,3,64,67,
Jackson,U.S. Senate,James Lankford,REP,330010,1,18,122,141,
Jackson,U.S. Senate,Mark Beard,IND,330010,0,0,7,7,
Jackson,U.S. House,Frankie Robbins,DEM,330010,0,4,68,72,03
Jackson,U.S. House,Frank Lucas,REP,330010,1,17,125,143,03
Jackson,Governor,Joe Dorman,DEM,330014,1,7,113,121,
Jackson,Governor,Mary Fallin,REP,330014,4,28,352,384,
Jackson,Governor,Kimberly Willis,IND,330014,0,0,5,5,
Jackson,Governor,Richard Prawdzienski,IND,330014,0,0,8,8,
Jackson,Lieutenant Governor,Cathy Cummings,DEM,330014,1,5,99,105,
Jackson,Lieutenant Governor,Todd Lamb,REP,330014,4,30,380,414,
Jackson,Superintendent of Public Instruction,John Cox,DEM,330014,1,8,137,146,
Jackson,Superintendent of Public Instruction,Joy Hofmeister,REP,330014,4,27,337,368,
Jackson,Commissioner of Labor,Mike Workman,DEM,330014,1,5,129,135,
Jackson,Commissioner of Labor,Mark Costello,REP,330014,4,30,339,373,
Jackson,U.S. Senate,Matt Silverstein,DEM,330014,1,5,94,100,
Jackson,U.S. Senate,Jim Inhofe,REP,330014,4,30,373,407,
Jackson,U.S. Senate,Aaron Delozier,IND,330014,0,0,1,1,
Jackson,U.S. Senate,Ray Woods,IND,330014,0,0,3,3,
Jackson,U.S. Senate,Joan Farr,IND,330014,0,0,8,8,
Jackson,U.S. Senate,Connie Johnson,DEM,330014,1,6,91,98,
Jackson,U.S. Senate,James Lankford,REP,330014,4,29,376,409,
Jackson,U.S. Senate,Mark Beard,IND,330014,0,0,11,11,
Jackson,U.S. House,Frankie Robbins,DEM,330014,1,5,93,99,03
Jackson,U.S. House,Frank Lucas,REP,330014,4,30,385,419,03
Jackson,Governor,Joe Dorman,DEM,330016,0,1,65,66,
Jackson,Governor,Mary Fallin,REP,330016,1,9,171,181,
Jackson,Governor,Kimberly Willis,IND,330016,0,1,4,5,
Jackson,Governor,Richard Prawdzienski,IND,330016,0,0,2,2,
Jackson,Lieutenant Governor,Cathy Cummings,DEM,330016,1,1,46,48,
Jackson,Lieutenant Governor,Todd Lamb,REP,330016,0,10,194,204,
Jackson,Superintendent of Public Instruction,John Cox,DEM,330016,0,2,73,75,
Jackson,Superintendent of Public Instruction,Joy Hofmeister,REP,330016,1,9,165,175,
Jackson,Commissioner of Labor,Mike Workman,DEM,330016,0,2,53,55,
Jackson,Commissioner of Labor,Mark Costello,REP,330016,1,9,183,193,
Jackson,U.S. Senate,Matt Silverstein,DEM,330016,0,1,32,33,
Jackson,U.S. Senate,Jim Inhofe,REP,330016,1,9,201,211,
Jackson,U.S. Senate,Aaron Delozier,IND,330016,0,1,2,3,
Jackson,U.S. Senate,Ray Woods,IND,330016,0,0,0,0,
Jackson,U.S. Senate,Joan Farr,IND,330016,0,0,4,4,
Jackson,U.S. Senate,Connie Johnson,DEM,330016,0,1,32,33,
Jackson,U.S. Senate,James Lankford,REP,330016,1,10,194,205,
Jackson,U.S. Senate,Mark Beard,IND,330016,0,0,14,14,
Jackson,U.S. House,Frankie Robbins,DEM,330016,0,1,29,30,03
Jackson,U.S. House,Frank Lucas,REP,330016,1,10,208,219,03
Jackson,Governor,Joe Dorman,DEM,330017,0,4,43,47,
Jackson,Governor,Mary Fallin,REP,330017,2,7,121,130,
Jackson,Governor,Kimberly Willis,IND,330017,0,0,1,1,
Jackson,Governor,Richard Prawdzienski,IND,330017,0,0,1,1,
Jackson,Lieutenant Governor,Cathy Cummings,DEM,330017,0,0,20,20,
Jackson,Lieutenant Governor,Todd Lamb,REP,330017,2,11,146,159,
Jackson,Superintendent of Public Instruction,John Cox,DEM,330017,0,6,58,64,
Jackson,Superintendent of Public Instruction,Joy Hofmeister,REP,330017,2,4,108,114,
Jackson,Commissioner of Labor,Mike Workman,DEM,330017,0,3,36,39,
Jackson,Commissioner of Labor,Mark Costello,REP,330017,2,7,129,138,
Jackson,U.S. Senate,Matt Silverstein,DEM,330017,0,1,25,26,
Jackson,U.S. Senate,Jim Inhofe,REP,330017,2,10,138,150,
Jackson,U.S. Senate,Aaron Delozier,IND,330017,0,0,0,0,
Jackson,U.S. Senate,Ray Woods,IND,330017,0,0,3,3,
Jackson,U.S. Senate,Joan Farr,IND,330017,0,0,0,0,
Jackson,U.S. Senate,Connie Johnson,DEM,330017,0,0,15,15,
Jackson,U.S. Senate,James Lankford,REP,330017,2,10,145,157,
Jackson,U.S. Senate,Mark Beard,IND,330017,0,0,5,5,
Jackson,U.S. House,Frankie Robbins,DEM,330017,0,0,19,19,03
Jackson,U.S. House,Frank Lucas,REP,330017,2,10,147,159,03
Jackson,Governor,Joe Dorman,DEM,330018,0,0,27,27,
Jackson,Governor,Mary Fallin,REP,330018,0,0,76,76,
Jackson,Governor,Kimberly Willis,IND,330018,0,0,1,1,
Jackson,Governor,Richard Prawdzienski,IND,330018,0,0,1,1,
Jackson,Lieutenant Governor,Cathy Cummings,DEM,330018,0,0,18,18,
Jackson,Lieutenant Governor,Todd Lamb,REP,330018,0,0,85,85,
Jackson,Superintendent of Public Instruction,John Cox,DEM,330018,0,0,38,38,
Jackson,Superintendent of Public Instruction,Joy Hofmeister,REP,330018,0,0,67,67,
Jackson,Commissioner of Labor,Mike Workman,DEM,330018,0,0,27,27,
Jackson,Commissioner of Labor,Mark Costello,REP,330018,0,0,74,74,
Jackson,U.S. Senate,Matt Silverstein,DEM,330018,0,0,13,13,
Jackson,U.S. Senate,Jim Inhofe,REP,330018,0,0,90,90,
Jackson,U.S. Senate,Aaron Delozier,IND,330018,0,0,0,0,
Jackson,U.S. Senate,Ray Woods,IND,330018,0,0,0,0,
Jackson,U.S. Senate,Joan Farr,IND,330018,0,0,0,0,
Jackson,U.S. Senate,Connie Johnson,DEM,330018,0,0,17,17,
Jackson,U.S. Senate,James Lankford,REP,330018,0,0,84,84,
Jackson,U.S. Senate,Mark Beard,IND,330018,0,0,2,2,
Jackson,U.S. House,Frankie Robbins,DEM,330018,0,0,11,11,03
Jackson,U.S. House,Frank Lucas,REP,330018,0,0,91,91,03
Jackson,Governor,Joe Dorman,DEM,330019,0,9,14,23,
Jackson,Governor,Mary Fallin,REP,330019,2,5,59,66,
Jackson,Governor,Kimberly Willis,IND,330019,0,0,3,3,
Jackson,Governor,Richard Prawdzienski,IND,330019,0,0,1,1,
Jackson,Lieutenant Governor,Cathy Cummings,DEM,330019,0,3,14,17,
Jackson,Lieutenant Governor,Todd Lamb,REP,330019,2,11,63,76,
Jackson,Superintendent of Public Instruction,John Cox,DEM,330019,1,5,17,23,
Jackson,Superintendent of Public Instruction,Joy Hofmeister,REP,330019,1,9,60,70,
Jackson,Commissioner of Labor,Mike Workman,DEM,330019,0,6,25,31,
Jackson,Commissioner of Labor,Mark Costello,REP,330019,2,8,53,63,
Jackson,U.S. Senate,Matt Silverstein,DEM,330019,0,3,8,11,
Jackson,U.S. Senate,Jim Inhofe,REP,330019,2,11,67,80,
Jackson,U.S. Senate,Aaron Delozier,IND,330019,0,0,0,0,
Jackson,U.S. Senate,Ray Woods,IND,330019,0,0,1,1,
Jackson,U.S. Senate,Joan Farr,IND,330019,0,0,2,2,
Jackson,U.S. Senate,Connie Johnson,DEM,330019,0,3,10,13,
Jackson,U.S. Senate,James Lankford,REP,330019,2,11,66,79,
Jackson,U.S. Senate,Mark Beard,IND,330019,0,0,2,2,
Jackson,U.S. House,Frankie Robbins,DEM,330019,0,3,8,11,03
Jackson,U.S. House,Frank Lucas,REP,330019,2,11,70,83,03
Jackson,Governor,Joe Dorman,DEM,330020,0,13,59,72,
Jackson,Governor,Mary Fallin,REP,330020,10,39,204,253,
Jackson,Governor,Kimberly Willis,IND,330020,0,0,7,7,
Jackson,Governor,Richard Prawdzienski,IND,330020,0,0,4,4,
Jackson,Lieutenant Governor,Cathy Cummings,DEM,330020,0,7,35,42,
Jackson,Lieutenant Governor,Todd Lamb,REP,330020,10,44,238,292,
Jackson,Superintendent of Public Instruction,John Cox,DEM,330020,0,16,68,84,
Jackson,Superintendent of Public Instruction,Joy Hofmeister,REP,330020,10,36,202,248,
Jackson,Commissioner of Labor,Mike Workman,DEM,330020,0,10,53,63,
Jackson,Commissioner of Labor,Mark Costello,REP,330020,10,40,220,270,
Jackson,U.S. Senate,Matt Silverstein,DEM,330020,0,6,35,41,
Jackson,U.S. Senate,Jim Inhofe,REP,330020,10,45,228,283,
Jackson,U.S. Senate,Aaron Delozier,IND,330020,0,0,0,0,
Jackson,U.S. Senate,Ray Woods,IND,330020,0,1,2,3,
Jackson,U.S. Senate,Joan Farr,IND,330020,0,0,7,7,
Jackson,U.S. Senate,Connie Johnson,DEM,330020,0,6,31,37,
Jackson,U.S. Senate,James Lankford,REP,330020,10,42,237,289,
Jackson,U.S. Senate,Mark Beard,IND,330020,0,2,5,7,
Jackson,U.S. House,Frankie Robbins,DEM,330020,0,7,32,39,03
Jackson,U.S. House,Frank Lucas,REP,330020,10,44,242,296,03
Jackson,Governor,Joe Dorman,DEM,330021,0,0,10,10,
Jackson,Governor,Mary Fallin,REP,330021,1,8,52,61,
Jackson,Governor,Kimberly Willis,IND,330021,0,0,1,1,
Jackson,Governor,Richard Prawdzienski,IND,330021,0,0,1,1,
Jackson,Lieutenant Governor,Cathy Cummings,DEM,330021,0,0,8,8,
Jackson,Lieutenant Governor,Todd Lamb,REP,330021,1,8,56,65,
Jackson,Superintendent of Public Instruction,John Cox,DEM,330021,0,0,11,11,
Jackson,Superintendent of Public Instruction,Joy Hofmeister,REP,330021,1,8,53,62,
Jackson,Commissioner of Labor,Mike Workman,DEM,330021,0,1,14,15,
Jackson,Commissioner of Labor,Mark Costello,REP,330021,1,7,50,58,
Jackson,U.S. Senate,Matt Silverstein,DEM,330021,0,0,7,7,
Jackson,U.S. Senate,Jim Inhofe,REP,330021,1,8,54,63,
Jackson,U.S. Senate,Aaron Delozier,IND,330021,0,0,0,0,
Jackson,U.S. Senate,Ray Woods,IND,330021,0,0,0,0,
Jackson,U.S. Senate,Joan Farr,IND,330021,0,0,3,3,
Jackson,U.S. Senate,Connie Johnson,DEM,330021,0,0,6,6,
Jackson,U.S. Senate,James Lankford,REP,330021,1,8,54,63,
Jackson,U.S. Senate,Mark Beard,IND,330021,0,0,3,3,
Jackson,U.S. House,Frankie Robbins,DEM,330021,0,0,5,5,03
Jackson,U.S. House,Frank Lucas,REP,330021,1,8,57,66,03
Jackson,Governor,Joe Dorman,DEM,330023,0,7,32,39,
Jackson,Governor,Mary Fallin,REP,330023,5,18,127,150,
Jackson,Governor,Kimberly Willis,IND,330023,0,1,4,5,
Jackson,Governor,Richard Prawdzienski,IND,330023,0,0,2,2,
Jackson,Lieutenant Governor,Cathy Cummings,DEM,330023,0,4,19,23,
Jackson,Lieutenant Governor,Todd Lamb,REP,330023,5,23,146,174,
Jackson,Superintendent of Public Instruction,John Cox,DEM,330023,0,7,33,40,
Jackson,Superintendent of Public Instruction,Joy Hofmeister,REP,330023,5,20,131,156,
Jackson,Commissioner of Labor,Mike Workman,DEM,330023,0,7,30,37,
Jackson,Commissioner of Labor,Mark Costello,REP,330023,5,20,134,159,
Jackson,U.S. Senate,Matt Silverstein,DEM,330023,0,4,11,15,
Jackson,U.S. Senate,Jim Inhofe,REP,330023,5,22,152,179,
Jackson,U.S. Senate,Aaron Delozier,IND,330023,0,0,0,0,
Jackson,U.S. Senate,Ray Woods,IND,330023,0,1,1,2,
Jackson,U.S. Senate,Joan Farr,IND,330023,0,0,1,1,
Jackson,U.S. Senate,Connie Johnson,DEM,330023,0,6,15,21,
Jackson,U.S. Senate,James Lankford,REP,330023,5,19,147,171,
Jackson,U.S. Senate,Mark Beard,IND,330023,0,2,4,6,
Jackson,U.S. House,Frankie Robbins,DEM,330023,0,5,12,17,03
Jackson,U.S. House,Frank Lucas,REP,330023,5,22,154,181,03
Jackson,Governor,Joe Dorman,DEM,330024,0,1,34,35,
Jackson,Governor,Mary Fallin,REP,330024,1,0,81,82,
Jackson,Governor,Kimberly Willis,IND,330024,0,0,0,0,
Jackson,Governor,Richard Prawdzienski,IND,330024,0,0,0,0,
Jackson,Lieutenant Governor,Cathy Cummings,DEM,330024,0,0,21,21,
Jackson,Lieutenant Governor,Todd Lamb,REP,330024,1,1,93,95,
Jackson,Superintendent of Public Instruction,John Cox,DEM,330024,1,1,50,52,
Jackson,Superintendent of Public Instruction,Joy Hofmeister,REP,330024,0,0,65,65,
Jackson,Commissioner of Labor,Mike Workman,DEM,330024,1,0,31,32,
Jackson,Commissioner of Labor,Mark Costello,REP,330024,0,1,82,83,
Jackson,U.S. Senate,Matt Silverstein,DEM,330024,0,0,16,16,
Jackson,U.S. Senate,Jim Inhofe,REP,330024,1,1,95,97,
Jackson,U.S. Senate,Aaron Delozier,IND,330024,0,0,0,0,
Jackson,U.S. Senate,Ray Woods,IND,330024,0,0,2,2,
Jackson,U.S. Senate,Joan Farr,IND,330024,0,0,0,0,
Jackson,U.S. Senate,Connie Johnson,DEM,330024,0,0,20,20,
Jackson,U.S. Senate,James Lankford,REP,330024,1,1,92,94,
Jackson,U.S. Senate,Mark Beard,IND,330024,0,0,1,1,
Jackson,U.S. House,Frankie Robbins,DEM,330024,0,0,17,17,03
Jackson,U.S. House,Frank Lucas,REP,330024,1,1,96,98,03
Jefferson,Governor,Joe Dorman,DEM,340001,1,14,80,95,
Jefferson,Governor,Mary Fallin,REP,340001,2,10,84,96,
Jefferson,Governor,Kimberly Willis,IND,340001,0,0,8,8,
Jefferson,Governor,Richard Prawdzienski,IND,340001,0,2,0,2,
Jefferson,Lieutenant Governor,Cathy Cummings,DEM,340001,1,7,47,55,
Jefferson,Lieutenant Governor,Todd Lamb,REP,340001,2,18,121,141,
Jefferson,Superintendent of Public Instruction,John Cox,DEM,340001,1,12,88,101,
Jefferson,Superintendent of Public Instruction,Joy Hofmeister,REP,340001,2,13,83,98,
Jefferson,Commissioner of Labor,Mike Workman,DEM,340001,1,8,63,72,
Jefferson,Commissioner of Labor,Mark Costello,REP,340001,2,16,104,122,
Jefferson,U.S. Senate,Matt Silverstein,DEM,340001,1,8,40,49,
Jefferson,U.S. Senate,Jim Inhofe,REP,340001,2,17,122,141,
Jefferson,U.S. Senate,Aaron Delozier,IND,340001,0,0,0,0,
Jefferson,U.S. Senate,Ray Woods,IND,340001,0,0,6,6,
Jefferson,U.S. Senate,Joan Farr,IND,340001,0,0,4,4,
Jefferson,U.S. Senate,Connie Johnson,DEM,340001,1,8,47,56,
Jefferson,U.S. Senate,James Lankford,REP,340001,2,16,107,125,
Jefferson,U.S. Senate,Mark Beard,IND,340001,0,0,14,14,
Jefferson,U.S. House,Bert Smith,DEM,340001,1,7,31,39,04
Jefferson,U.S. House,Tom Cole,REP,340001,2,18,126,146,04
Jefferson,U.S. House,Dennis Johnson,IND,340001,0,0,12,12,04
Jefferson,Governor,Joe Dorman,DEM,340002,3,13,67,83,
Jefferson,Governor,Mary Fallin,REP,340002,1,7,68,76,
Jefferson,Governor,Kimberly Willis,IND,340002,0,0,4,4,
Jefferson,Governor,Richard Prawdzienski,IND,340002,0,0,2,2,
Jefferson,Lieutenant Governor,Cathy Cummings,DEM,340002,2,4,31,37,
Jefferson,Lieutenant Governor,Todd Lamb,REP,340002,2,16,109,127,
Jefferson,Superintendent of Public Instruction,John Cox,DEM,340002,3,12,69,84,
Jefferson,Superintendent of Public Instruction,Joy Hofmeister,REP,340002,1,8,71,80,
Jefferson,Commissioner of Labor,Mike Workman,DEM,340002,3,4,35,42,
Jefferson,Commissioner of Labor,Mark Costello,REP,340002,1,13,104,118,
Jefferson,U.S. Senate,Matt Silverstein,DEM,340002,1,5,19,25,
Jefferson,U.S. Senate,Jim Inhofe,REP,340002,3,14,109,126,
Jefferson,U.S. Senate,Aaron Delozier,IND,340002,0,0,4,4,
Jefferson,U.S. Senate,Ray Woods,IND,340002,0,1,3,4,
Jefferson,U.S. Senate,Joan Farr,IND,340002,0,0,5,5,
Jefferson,U.S. Senate,Connie Johnson,DEM,340002,2,6,23,31,
Jefferson,U.S. Senate,James Lankford,REP,340002,2,14,108,124,
Jefferson,U.S. Senate,Mark Beard,IND,340002,0,0,9,9,
Jefferson,U.S. House,Bert Smith,DEM,340002,2,3,19,24,04
Jefferson,U.S. House,Tom Cole,REP,340002,2,15,106,123,04
Jefferson,U.S. House,Dennis Johnson,IND,340002,0,2,15,17,04
Jefferson,Governor,Joe Dorman,DEM,340003,1,5,18,24,
Jefferson,Governor,Mary Fallin,REP,340003,0,5,51,56,
Jefferson,Governor,Kimberly Willis,IND,340003,0,0,1,1,
Jefferson,Governor,Richard Prawdzienski,IND,340003,0,0,0,0,
Jefferson,Lieutenant Governor,Cathy Cummings,DEM,340003,0,3,12,15,
Jefferson,Lieutenant Governor,Todd Lamb,REP,340003,1,7,59,67,
Jefferson,Superintendent of Public Instruction,John Cox,DEM,340003,1,4,27,32,
Jefferson,Superintendent of Public Instruction,Joy Hofmeister,REP,340003,0,6,44,50,
Jefferson,Commissioner of Labor,Mike Workman,DEM,340003,0,2,10,12,
Jefferson,Commissioner of Labor,Mark Costello,REP,340003,1,8,59,68,
Jefferson,U.S. Senate,Matt Silverstein,DEM,340003,1,3,8,12,
Jefferson,U.S. Senate,Jim Inhofe,REP,340003,0,7,62,69,
Jefferson,U.S. Senate,Aaron Delozier,IND,340003,0,0,1,1,
Jefferson,U.S. Senate,Ray Woods,IND,340003,0,0,0,0,
Jefferson,U.S. Senate,Joan Farr,IND,340003,0,0,0,0,
Jefferson,U.S. Senate,Connie Johnson,DEM,340003,0,2,12,14,
Jefferson,U.S. Senate,James Lankford,REP,340003,1,7,56,64,
Jefferson,U.S. Senate,Mark Beard,IND,340003,0,1,1,2,
Jefferson,U.S. House,Bert Smith,DEM,340003,0,1,7,8,04
Jefferson,U.S. House,Tom Cole,REP,340003,0,8,61,69,04
Jefferson,U.S. House,Dennis Johnson,IND,340003,1,1,3,5,04
Jefferson,Governor,Joe Dorman,DEM,340004,1,2,20,23,
Jefferson,Governor,Mary Fallin,REP,340004,1,0,32,33,
Jefferson,Governor,Kimberly Willis,IND,340004,0,0,0,0,
Jefferson,Governor,Richard Prawdzienski,IND,340004,0,1,0,1,
Jefferson,Lieutenant Governor,Cathy Cummings,DEM,340004,1,2,9,12,
Jefferson,Lieutenant Governor,Todd Lamb,REP,340004,1,1,43,45,
Jefferson,Superintendent of Public Instruction,John Cox,DEM,340004,1,2,23,26,
Jefferson,Superintendent of Public Instruction,Joy Hofmeister,REP,340004,1,1,28,30,
Jefferson,Commissioner of Labor,Mike Workman,DEM,340004,1,2,16,19,
Jefferson,Commissioner of Labor,Mark Costello,REP,340004,1,1,35,37,
Jefferson,U.S. Senate,Matt Silverstein,DEM,340004,1,2,11,14,
Jefferson,U.S. Senate,Jim Inhofe,REP,340004,1,1,40,42,
Jefferson,U.S. Senate,Aaron Delozier,IND,340004,0,0,0,0,
Jefferson,U.S. Senate,Ray Woods,IND,340004,0,0,0,0,
Jefferson,U.S. Senate,Joan Farr,IND,340004,0,0,0,0,
Jefferson,U.S. Senate,Connie Johnson,DEM,340004,1,2,13,16,
Jefferson,U.S. Senate,James Lankford,REP,340004,1,1,38,40,
Jefferson,U.S. Senate,Mark Beard,IND,340004,0,0,0,0,
Jefferson,U.S. House,Bert Smith,DEM,340004,1,2,11,14,04
Jefferson,U.S. House,Tom Cole,REP,340004,1,0,41,42,04
Jefferson,U.S. House,Dennis Johnson,IND,340004,0,1,0,1,04
Jefferson,Governor,Joe Dorman,DEM,340005,1,1,14,16,
Jefferson,Governor,Mary Fallin,REP,340005,0,0,12,12,
Jefferson,Governor,Kimberly Willis,IND,340005,0,0,1,1,
Jefferson,Governor,Richard Prawdzienski,IND,340005,0,0,2,2,
Jefferson,Lieutenant Governor,Cathy Cummings,DEM,340005,1,1,10,12,
Jefferson,Lieutenant Governor,Todd Lamb,REP,340005,0,0,18,18,
Jefferson,Superintendent of Public Instruction,John Cox,DEM,340005,1,1,15,17,
Jefferson,Superintendent of Public Instruction,Joy Hofmeister,REP,340005,0,0,13,13,
Jefferson,Commissioner of Labor,Mike Workman,DEM,340005,1,1,14,16,
Jefferson,Commissioner of Labor,Mark Costello,REP,340005,0,0,14,14,
Jefferson,U.S. Senate,Matt Silverstein,DEM,340005,0,1,5,6,
Jefferson,U.S. Senate,Jim Inhofe,REP,340005,1,0,21,22,
Jefferson,U.S. Senate,Aaron Delozier,IND,340005,0,0,0,0,
Jefferson,U.S. Senate,Ray Woods,IND,340005,0,0,0,0,
Jefferson,U.S. Senate,Joan Farr,IND,340005,0,0,0,0,
Jefferson,U.S. Senate,Connie Johnson,DEM,340005,0,1,8,9,
Jefferson,U.S. Senate,James Lankford,REP,340005,1,0,18,19,
Jefferson,U.S. Senate,Mark Beard,IND,340005,0,0,1,1,
Jefferson,U.S. House,Bert Smith,DEM,340005,1,1,5,7,04
Jefferson,U.S. House,Tom Cole,REP,340005,0,0,21,21,04
Jefferson,U.S. House,Dennis Johnson,IND,340005,0,0,2,2,04
Jefferson,Governor,Joe Dorman,DEM,340006,3,7,77,87,
Jefferson,Governor,Mary Fallin,REP,340006,1,7,101,109,
Jefferson,Governor,Kimberly Willis,IND,340006,0,0,4,4,
Jefferson,Governor,Richard Prawdzienski,IND,340006,0,0,2,2,
Jefferson,Lieutenant Governor,Cathy Cummings,DEM,340006,3,4,49,56,
Jefferson,Lieutenant Governor,Todd Lamb,REP,340006,1,11,136,148,
Jefferson,Superintendent of Public Instruction,John Cox,DEM,340006,3,7,78,88,
Jefferson,Superintendent of Public Instruction,Joy Hofmeister,REP,340006,1,8,109,118,
Jefferson,Commissioner of Labor,Mike Workman,DEM,340006,3,7,60,70,
Jefferson,Commissioner of Labor,Mark Costello,REP,340006,1,8,116,125,
Jefferson,U.S. Senate,Matt Silverstein,DEM,340006,3,4,35,42,
Jefferson,U.S. Senate,Jim Inhofe,REP,340006,1,11,137,149,
Jefferson,U.S. Senate,Aaron Delozier,IND,340006,0,0,3,3,
Jefferson,U.S. Senate,Ray Woods,IND,340006,0,0,5,5,
Jefferson,U.S. Senate,Joan Farr,IND,340006,0,0,3,3,
Jefferson,U.S. Senate,Connie Johnson,DEM,340006,3,4,49,56,
Jefferson,U.S. Senate,James Lankford,REP,340006,1,9,123,133,
Jefferson,U.S. Senate,Mark Beard,IND,340006,0,2,7,9,
Jefferson,U.S. House,Bert Smith,DEM,340006,3,5,36,44,04
Jefferson,U.S. House,Tom Cole,REP,340006,1,10,140,151,04
Jefferson,U.S. House,Dennis Johnson,IND,340006,0,0,10,10,04
Jefferson,Governor,Joe Dorman,DEM,340007,0,3,47,50,
Jefferson,Governor,Mary Fallin,REP,340007,2,0,37,39,
Jefferson,Governor,Kimberly Willis,IND,340007,0,0,3,3,
Jefferson,Governor,Richard Prawdzienski,IND,340007,0,0,0,0,
Jefferson,Lieutenant Governor,Cathy Cummings,DEM,340007,0,2,42,44,
Jefferson,Lieutenant Governor,Todd Lamb,REP,340007,2,1,45,48,
Jefferson,Superintendent of Public Instruction,John Cox,DEM,340007,0,3,58,61,
Jefferson,Superintendent of Public Instruction,Joy Hofmeister,REP,340007,2,0,31,33,
Jefferson,Commissioner of Labor,Mike Workman,DEM,340007,0,3,46,49,
Jefferson,Commissioner of Labor,Mark Costello,REP,340007,2,0,40,42,
Jefferson,U.S. Senate,Matt Silverstein,DEM,340007,0,2,38,40,
Jefferson,U.S. Senate,Jim Inhofe,REP,340007,2,1,43,46,
Jefferson,U.S. Senate,Aaron Delozier,IND,340007,0,0,0,0,
Jefferson,U.S. Senate,Ray Woods,IND,340007,0,0,2,2,
Jefferson,U.S. Senate,Joan Farr,IND,340007,0,0,4,4,
Jefferson,U.S. Senate,Connie Johnson,DEM,340007,0,2,42,44,
Jefferson,U.S. Senate,James Lankford,REP,340007,2,1,36,39,
Jefferson,U.S. Senate,Mark Beard,IND,340007,0,0,9,9,
Jefferson,U.S. House,Bert Smith,DEM,340007,0,1,37,38,04
Jefferson,U.S. House,Tom Cole,REP,340007,2,1,47,50,04
Jefferson,U.S. House,Dennis Johnson,IND,340007,0,1,5,6,04
Jefferson,Governor,Joe Dorman,DEM,340008,2,0,4,6,
Jefferson,Governor,Mary Fallin,REP,340008,0,1,17,18,
Jefferson,Governor,Kimberly Willis,IND,340008,0,0,0,0,
Jefferson,Governor,Richard Prawdzienski,IND,340008,0,0,0,0,
Jefferson,Lieutenant Governor,Cathy Cummings,DEM,340008,2,0,5,7,
Jefferson,Lieutenant Governor,Todd Lamb,REP,340008,0,1,16,17,
Jefferson,Superintendent of Public Instruction,John Cox,DEM,340008,2,0,12,14,
Jefferson,Superintendent of Public Instruction,Joy Hofmeister,REP,340008,0,1,8,9,
Jefferson,Commissioner of Labor,Mike Workman,DEM,340008,2,0,6,8,
Jefferson,Commissioner of Labor,Mark Costello,REP,340008,0,1,13,14,
Jefferson,U.S. Senate,Matt Silverstein,DEM,340008,2,0,5,7,
Jefferson,U.S. Senate,Jim Inhofe,REP,340008,0,1,15,16,
Jefferson,U.S. Senate,Aaron Delozier,IND,340008,0,0,0,0,
Jefferson,U.S. Senate,Ray Woods,IND,340008,0,0,0,0,
Jefferson,U.S. Senate,Joan Farr,IND,340008,0,0,1,1,
Jefferson,U.S. Senate,Connie Johnson,DEM,340008,2,0,5,7,
Jefferson,U.S. Senate,James Lankford,REP,340008,0,1,14,15,
Jefferson,U.S. Senate,Mark Beard,IND,340008,0,0,1,1,
Jefferson,U.S. House,Bert Smith,DEM,340008,2,0,4,6,04
Jefferson,U.S. House,Tom Cole,REP,340008,0,1,16,17,04
Jefferson,U.S. House,Dennis Johnson,IND,340008,0,0,1,1,04
Jefferson,Governor,Joe Dorman,DEM,340009,2,4,155,161,
Jefferson,Governor,Mary Fallin,REP,340009,4,3,181,188,
Jefferson,Governor,Kimberly Willis,IND,340009,0,0,11,11,
Jefferson,Governor,Richard Prawdzienski,IND,340009,0,0,4,4,
Jefferson,Lieutenant Governor,Cathy Cummings,DEM,340009,1,2,104,107,
Jefferson,Lieutenant Governor,Todd Lamb,REP,340009,5,5,242,252,
Jefferson,Superintendent of Public Instruction,John Cox,DEM,340009,4,3,179,186,
Jefferson,Superintendent of Public Instruction,Joy Hofmeister,REP,340009,2,4,166,172,
Jefferson,Commissioner of Labor,Mike Workman,DEM,340009,1,2,129,132,
Jefferson,Commissioner of Labor,Mark Costello,REP,340009,5,5,210,220,
Jefferson,U.S. Senate,Matt Silverstein,DEM,340009,2,2,81,85,
Jefferson,U.S. Senate,Jim Inhofe,REP,340009,4,4,248,256,
Jefferson,U.S. Senate,Aaron Delozier,IND,340009,0,0,0,0,
Jefferson,U.S. Senate,Ray Woods,IND,340009,0,0,6,6,
Jefferson,U.S. Senate,Joan Farr,IND,340009,0,1,9,10,
Jefferson,U.S. Senate,Connie Johnson,DEM,340009,1,3,86,90,
Jefferson,U.S. Senate,James Lankford,REP,340009,5,3,251,259,
Jefferson,U.S. Senate,Mark Beard,IND,340009,0,1,9,10,
Jefferson,U.S. House,Bert Smith,DEM,340009,2,3,71,76,04
Jefferson,U.S. House,Tom Cole,REP,340009,4,4,263,271,04
Jefferson,U.S. House,Dennis Johnson,IND,340009,0,0,14,14,04
Jefferson,Governor,Joe Dorman,DEM,340010,0,0,10,10,
Jefferson,Governor,Mary Fallin,REP,340010,0,1,12,13,
Jefferson,Governor,Kimberly Willis,IND,340010,0,0,0,0,
Jefferson,Governor,Richard Prawdzienski,IND,340010,0,0,0,0,
Jefferson,Lieutenant Governor,Cathy Cummings,DEM,340010,0,0,5,5,
Jefferson,Lieutenant Governor,Todd Lamb,REP,340010,0,1,17,18,
Jefferson,Superintendent of Public Instruction,John Cox,DEM,340010,0,0,9,9,
Jefferson,Superintendent of Public Instruction,Joy Hofmeister,REP,340010,0,1,13,14,
Jefferson,Commissioner of Labor,Mike Workman,DEM,340010,0,0,9,9,
Jefferson,Commissioner of Labor,Mark Costello,REP,340010,0,1,13,14,
Jefferson,U.S. Senate,Matt Silverstein,DEM,340010,0,0,4,4,
Jefferson,U.S. Senate,Jim Inhofe,REP,340010,0,1,18,19,
Jefferson,U.S. Senate,Aaron Delozier,IND,340010,0,0,0,0,
Jefferson,U.S. Senate,Ray Woods,IND,340010,0,0,0,0,
Jefferson,U.S. Senate,Joan Farr,IND,340010,0,0,0,0,
Jefferson,U.S. Senate,Connie Johnson,DEM,340010,0,0,4,4,
Jefferson,U.S. Senate,James Lankford,REP,340010,0,1,17,18,
Jefferson,U.S. Senate,Mark Beard,IND,340010,0,0,1,1,
Jefferson,U.S. House,Bert Smith,DEM,340010,0,0,4,4,04
Jefferson,U.S. House,Tom Cole,REP,340010,0,1,17,18,04
Jefferson,U.S. House,Dennis Johnson,IND,340010,0,0,0,0,04
Johnston,Governor,Joe Dorman,DEM,350001,0,21,72,93,
Johnston,Governor,Mary Fallin,REP,350001,2,18,77,97,
Johnston,Governor,Kimberly Willis,IND,350001,0,2,4,6,
Johnston,Governor,Richard Prawdzienski,IND,350001,0,0,3,3,
Johnston,Lieutenant Governor,Cathy Cummings,DEM,350001,0,14,46,60,
Johnston,Lieutenant Governor,Todd Lamb,REP,350001,2,26,111,139,
Johnston,Superintendent of Public Instruction,John Cox,DEM,350001,0,24,76,100,
Johnston,Superintendent of Public Instruction,Joy Hofmeister,REP,350001,2,16,81,99,
Johnston,Commissioner of Labor,Mike Workman,DEM,350001,0,16,56,72,
Johnston,Commissioner of Labor,Mark Costello,REP,350001,2,24,101,127,
Johnston,U.S. Senate,Matt Silverstein,DEM,350001,0,9,32,41,
Johnston,U.S. Senate,Jim Inhofe,REP,350001,2,30,121,153,
Johnston,U.S. Senate,Aaron Delozier,IND,350001,0,1,0,1,
Johnston,U.S. Senate,Ray Woods,IND,350001,0,1,1,2,
Johnston,U.S. Senate,Joan Farr,IND,350001,0,0,3,3,
Johnston,U.S. Senate,Connie Johnson,DEM,350001,0,9,38,47,
Johnston,U.S. Senate,James Lankford,REP,350001,2,30,113,145,
Johnston,U.S. Senate,Mark Beard,IND,350001,0,1,7,8,
Johnston,U.S. House,Earl Everett,DEM,350001,0,8,29,37,02
Johnston,U.S. House,Markwayne Mullin,REP,350001,0,33,121,154,02
Johnston,U.S. House,Jon Douthitt,IND,350001,2,0,8,10,02
Johnston,State Senate,Joe Hill,DEM,350001,2,20,61,83,6
Johnston,State Senate,Josh Brecheen,REP,350001,0,20,93,113,6
Johnston,State Senate,Vicki Gaylor,IND,350001,0,1,4,5,6
Johnston,Governor,Joe Dorman,DEM,350002,0,7,68,75,
Johnston,Governor,Mary Fallin,REP,350002,2,5,61,68,
Johnston,Governor,Kimberly Willis,IND,350002,0,0,5,5,
Johnston,Governor,Richard Prawdzienski,IND,350002,0,0,0,0,
Johnston,Lieutenant Governor,Cathy Cummings,DEM,350002,0,5,55,60,
Johnston,Lieutenant Governor,Todd Lamb,REP,350002,2,7,79,88,
Johnston,Superintendent of Public Instruction,John Cox,DEM,350002,0,8,72,80,
Johnston,Superintendent of Public Instruction,Joy Hofmeister,REP,350002,2,4,58,64,
Johnston,Commissioner of Labor,Mike Workman,DEM,350002,0,6,63,69,
Johnston,Commissioner of Labor,Mark Costello,REP,350002,2,6,69,77,
Johnston,U.S. Senate,Matt Silverstein,DEM,350002,0,7,43,50,
Johnston,U.S. Senate,Jim Inhofe,REP,350002,2,5,79,86,
Johnston,U.S. Senate,Aaron Delozier,IND,350002,0,0,3,3,
Johnston,U.S. Senate,Ray Woods,IND,350002,0,0,6,6,
Johnston,U.S. Senate,Joan Farr,IND,350002,0,0,2,2,
Johnston,U.S. Senate,Connie Johnson,DEM,350002,0,6,45,51,
Johnston,U.S. Senate,James Lankford,REP,350002,2,6,79,87,
Johnston,U.S. Senate,Mark Beard,IND,350002,0,0,9,9,
Johnston,U.S. House,Earl Everett,DEM,350002,0,6,37,43,02
Johnston,U.S. House,Markwayne Mullin,REP,350002,2,6,84,92,02
Johnston,U.S. House,Jon Douthitt,IND,350002,0,0,11,11,02
Johnston,State Senate,Chequita Williams,DEM,350002,0,4,36,40,14
Johnston,State Senate,Frank Simpson,REP,350002,2,8,97,107,14
Johnston,Governor,Joe Dorman,DEM,350003,0,11,45,56,
Johnston,Governor,Mary Fallin,REP,350003,4,10,45,59,
Johnston,Governor,Kimberly Willis,IND,350003,0,1,4,5,
Johnston,Governor,Richard Prawdzienski,IND,350003,0,0,3,3,
Johnston,Lieutenant Governor,Cathy Cummings,DEM,350003,0,7,36,43,
Johnston,Lieutenant Governor,Todd Lamb,REP,350003,4,15,60,79,
Johnston,Superintendent of Public Instruction,John Cox,DEM,350003,0,9,49,58,
Johnston,Superintendent of Public Instruction,Joy Hofmeister,REP,350003,4,13,48,65,
Johnston,Commissioner of Labor,Mike Workman,DEM,350003,0,7,37,44,
Johnston,Commissioner of Labor,Mark Costello,REP,350003,4,15,58,77,
Johnston,U.S. Senate,Matt Silverstein,DEM,350003,2,6,22,30,
Johnston,U.S. Senate,Jim Inhofe,REP,350003,2,15,65,82,
Johnston,U.S. Senate,Aaron Delozier,IND,350003,0,1,1,2,
Johnston,U.S. Senate,Ray Woods,IND,350003,0,0,6,6,
Johnston,U.S. Senate,Joan Farr,IND,350003,0,0,3,3,
Johnston,U.S. Senate,Connie Johnson,DEM,350003,0,5,29,34,
Johnston,U.S. Senate,James Lankford,REP,350003,3,16,59,78,
Johnston,U.S. Senate,Mark Beard,IND,350003,1,0,8,9,
Johnston,U.S. House,Earl Everett,DEM,350003,0,8,24,32,02
Johnston,U.S. House,Markwayne Mullin,REP,350003,4,13,59,76,02
Johnston,U.S. House,Jon Douthitt,IND,350003,0,1,14,15,02
Johnston,State Senate,Chequita Williams,DEM,350003,0,3,19,22,14
Johnston,State Senate,Frank Simpson,REP,350003,4,19,78,101,14
Johnston,Governor,Joe Dorman,DEM,350004,3,28,158,189,
Johnston,Governor,Mary Fallin,REP,350004,3,24,122,149,
Johnston,Governor,Kimberly Willis,IND,350004,0,2,12,14,
Johnston,Governor,Richard Prawdzienski,IND,350004,0,0,8,8,
Johnston,Lieutenant Governor,Cathy Cummings,DEM,350004,4,24,117,145,
Johnston,Lieutenant Governor,Todd Lamb,REP,350004,2,30,183,215,
Johnston,Superintendent of Public Instruction,John Cox,DEM,350004,4,30,175,209,
Johnston,Superintendent of Public Instruction,Joy Hofmeister,REP,350004,2,24,125,151,
Johnston,Commissioner of Labor,Mike Workman,DEM,350004,4,22,131,157,
Johnston,Commissioner of Labor,Mark Costello,REP,350004,2,32,166,200,
Johnston,U.S. Senate,Matt Silverstein,DEM,350004,4,15,93,112,
Johnston,U.S. Senate,Jim Inhofe,REP,350004,3,38,192,233,
Johnston,U.S. Senate,Aaron Delozier,IND,350004,0,0,6,6,
Johnston,U.S. Senate,Ray Woods,IND,350004,0,0,5,5,
Johnston,U.S. Senate,Joan Farr,IND,350004,0,0,5,5,
Johnston,U.S. Senate,Connie Johnson,DEM,350004,4,21,92,117,
Johnston,U.S. Senate,James Lankford,REP,350004,2,30,187,219,
Johnston,U.S. Senate,Mark Beard,IND,350004,0,2,16,18,
Johnston,U.S. House,Earl Everett,DEM,350004,4,13,87,104,02
Johnston,U.S. House,Markwayne Mullin,REP,350004,3,36,191,230,02
Johnston,U.S. House,Jon Douthitt,IND,350004,0,4,19,23,02
Johnston,State Senate,Chequita Williams,DEM,350004,4,11,80,95,14
Johnston,State Senate,Frank Simpson,REP,350004,3,43,217,263,14
Johnston,Governor,Joe Dorman,DEM,350005,0,2,103,105,
Johnston,Governor,Mary Fallin,REP,350005,0,4,141,145,
Johnston,Governor,Kimberly Willis,IND,350005,0,0,5,5,
Johnston,Governor,Richard Prawdzienski,IND,350005,0,0,2,2,
Johnston,Lieutenant Governor,Cathy Cummings,DEM,350005,0,2,85,87,
Johnston,Lieutenant Governor,Todd Lamb,REP,350005,0,4,164,168,
Johnston,Superintendent of Public Instruction,John Cox,DEM,350005,0,3,119,122,
Johnston,Superintendent of Public Instruction,Joy Hofmeister,REP,350005,0,3,126,129,
Johnston,Commissioner of Labor,Mike Workman,DEM,350005,0,2,99,101,
Johnston,Commissioner of Labor,Mark Costello,REP,350005,0,4,147,151,
Johnston,U.S. Senate,Matt Silverstein,DEM,350005,0,1,57,58,
Johnston,U.S. Senate,Jim Inhofe,REP,350005,0,5,184,189,
Johnston,U.S. Senate,Aaron Delozier,IND,350005,0,0,0,0,
Johnston,U.S. Senate,Ray Woods,IND,350005,0,0,8,8,
Johnston,U.S. Senate,Joan Farr,IND,350005,0,0,2,2,
Johnston,U.S. Senate,Connie Johnson,DEM,350005,0,2,69,71,
Johnston,U.S. Senate,James Lankford,REP,350005,0,4,166,170,
Johnston,U.S. Senate,Mark Beard,IND,350005,0,0,13,13,
Johnston,U.S. House,Earl Everett,DEM,350005,0,2,59,61,02
Johnston,U.S. House,Markwayne Mullin,REP,350005,0,4,178,182,02
Johnston,U.S. House,Jon Douthitt,IND,350005,0,0,12,12,02
Johnston,State Senate,Chequita Williams,DEM,350005,0,1,45,46,14
Johnston,State Senate,Frank Simpson,REP,350005,0,5,205,210,14
Johnston,Governor,Joe Dorman,DEM,350006,0,6,83,89,
Johnston,Governor,Mary Fallin,REP,350006,0,7,65,72,
Johnston,Governor,Kimberly Willis,IND,350006,0,0,1,1,
Johnston,Governor,Richard Prawdzienski,IND,350006,0,0,3,3,
Johnston,Lieutenant Governor,Cathy Cummings,DEM,350006,0,3,65,68,
Johnston,Lieutenant Governor,Todd Lamb,REP,350006,0,10,87,97,
Johnston,Superintendent of Public Instruction,John Cox,DEM,350006,0,5,82,87,
Johnston,Superintendent of Public Instruction,Joy Hofmeister,REP,350006,0,7,68,75,
Johnston,Commissioner of Labor,Mike Workman,DEM,350006,0,5,74,79,
Johnston,Commissioner of Labor,Mark Costello,REP,350006,0,8,76,84,
Johnston,U.S. Senate,Matt Silverstein,DEM,350006,0,3,46,49,
Johnston,U.S. Senate,Jim Inhofe,REP,350006,0,10,100,110,
Johnston,U.S. Senate,Aaron Delozier,IND,350006,0,0,2,2,
Johnston,U.S. Senate,Ray Woods,IND,350006,0,0,2,2,
Johnston,U.S. Senate,Joan Farr,IND,350006,0,0,1,1,
Johnston,U.S. Senate,Connie Johnson,DEM,350006,0,5,56,61,
Johnston,U.S. Senate,James Lankford,REP,350006,0,8,86,94,
Johnston,U.S. Senate,Mark Beard,IND,350006,0,0,9,9,
Johnston,U.S. House,Earl Everett,DEM,350006,0,3,40,43,02
Johnston,U.S. House,Markwayne Mullin,REP,350006,0,10,104,114,02
Johnston,U.S. House,Jon Douthitt,IND,350006,0,0,7,7,02
Johnston,State Senate,Chequita Williams,DEM,350006,0,3,46,49,14
Johnston,State Senate,Frank Simpson,REP,350006,0,10,104,114,14
Johnston,Governor,Joe Dorman,DEM,350007,0,0,1,1,
Johnston,Governor,Mary Fallin,REP,350007,0,0,5,5,
Johnston,Governor,Kimberly Willis,IND,350007,0,0,0,0,
Johnston,Governor,Richard Prawdzienski,IND,350007,0,0,0,0,
Johnston,Lieutenant Governor,Cathy Cummings,DEM,350007,0,0,1,1,
Johnston,Lieutenant Governor,Todd Lamb,REP,350007,0,0,5,5,
Johnston,Superintendent of Public Instruction,John Cox,DEM,350007,0,0,2,2,
Johnston,Superintendent of Public Instruction,Joy Hofmeister,REP,350007,0,0,4,4,
Johnston,Commissioner of Labor,Mike Workman,DEM,350007,0,0,0,0,
Johnston,Commissioner of Labor,Mark Costello,REP,350007,0,0,6,6,
Johnston,U.S. Senate,Matt Silverstein,DEM,350007,0,0,0,0,
Johnston,U.S. Senate,Jim Inhofe,REP,350007,0,0,6,6,
Johnston,U.S. Senate,Aaron Delozier,IND,350007,0,0,0,0,
Johnston,U.S. Senate,Ray Woods,IND,350007,0,0,0,0,
Johnston,U.S. Senate,Joan Farr,IND,350007,0,0,0,0,
Johnston,U.S. Senate,Connie Johnson,DEM,350007,0,0,0,0,
Johnston,U.S. Senate,James Lankford,REP,350007,0,0,5,5,
Johnston,U.S. Senate,Mark Beard,IND,350007,0,0,1,1,
Johnston,U.S. House,Earl Everett,DEM,350007,0,0,0,0,02
Johnston,U.S. House,Markwayne Mullin,REP,350007,0,0,6,6,02
Johnston,U.S. House,Jon Douthitt,IND,350007,0,0,0,0,02
Johnston,State Senate,Joe Hill,DEM,350007,0,0,0,0,6
Johnston,State Senate,Josh Brecheen,REP,350007,0,0,4,4,6
Johnston,State Senate,Vicki Gaylor,IND,350007,0,0,2,2,6
Johnston,Governor,Joe Dorman,DEM,350008,0,1,66,67,
Johnston,Governor,Mary Fallin,REP,350008,0,0,67,67,
Johnston,Governor,Kimberly Willis,IND,350008,0,0,5,5,
Johnston,Governor,Richard Prawdzienski,IND,350008,0,0,2,2,
Johnston,Lieutenant Governor,Cathy Cummings,DEM,350008,0,1,41,42,
Johnston,Lieutenant Governor,Todd Lamb,REP,350008,0,0,97,97,
Johnston,Superintendent of Public Instruction,John Cox,DEM,350008,0,1,68,69,
Johnston,Superintendent of Public Instruction,Joy Hofmeister,REP,350008,0,0,70,70,
Johnston,Commissioner of Labor,Mike Workman,DEM,350008,0,1,54,55,
Johnston,Commissioner of Labor,Mark Costello,REP,350008,0,0,82,82,
Johnston,U.S. Senate,Matt Silverstein,DEM,350008,0,1,24,25,
Johnston,U.S. Senate,Jim Inhofe,REP,350008,0,0,104,104,
Johnston,U.S. Senate,Aaron Delozier,IND,350008,0,0,3,3,
Johnston,U.S. Senate,Ray Woods,IND,350008,0,0,3,3,
Johnston,U.S. Senate,Joan Farr,IND,350008,0,0,5,5,
Johnston,U.S. Senate,Connie Johnson,DEM,350008,0,1,35,36,
Johnston,U.S. Senate,James Lankford,REP,350008,0,0,93,93,
Johnston,U.S. Senate,Mark Beard,IND,350008,0,0,10,10,
Johnston,U.S. House,Earl Everett,DEM,350008,0,1,21,22,02
Johnston,U.S. House,Markwayne Mullin,REP,350008,0,0,111,111,02
Johnston,U.S. House,Jon Douthitt,IND,350008,0,0,6,6,02
Johnston,State Senate,Chequita Williams,DEM,350008,0,0,29,29,14
Johnston,State Senate,Frank Simpson,REP,350008,0,1,109,110,14
Johnston,Governor,Joe Dorman,DEM,350009,3,3,47,53,
Johnston,Governor,Mary Fallin,REP,350009,3,5,35,43,
Johnston,Governor,Kimberly Willis,IND,350009,0,0,0,0,
Johnston,Governor,Richard Prawdzienski,IND,350009,0,0,2,2,
Johnston,Lieutenant Governor,Cathy Cummings,DEM,350009,0,3,33,36,
Johnston,Lieutenant Governor,Todd Lamb,REP,350009,6,5,50,61,
Johnston,Superintendent of Public Instruction,John Cox,DEM,350009,0,2,48,50,
Johnston,Superintendent of Public Instruction,Joy Hofmeister,REP,350009,6,6,33,45,
Johnston,Commissioner of Labor,Mike Workman,DEM,350009,2,2,43,47,
Johnston,Commissioner of Labor,Mark Costello,REP,350009,3,6,36,45,
Johnston,U.S. Senate,Matt Silverstein,DEM,350009,0,2,32,34,
Johnston,U.S. Senate,Jim Inhofe,REP,350009,6,6,45,57,
Johnston,U.S. Senate,Aaron Delozier,IND,350009,0,0,2,2,
Johnston,U.S. Senate,Ray Woods,IND,350009,0,0,1,1,
Johnston,U.S. Senate,Joan Farr,IND,350009,0,0,1,1,
Johnston,U.S. Senate,Connie Johnson,DEM,350009,2,1,29,32,
Johnston,U.S. Senate,James Lankford,REP,350009,4,7,45,56,
Johnston,U.S. Senate,Mark Beard,IND,350009,0,0,5,5,
Johnston,U.S. House,Earl Everett,DEM,350009,2,1,28,31,02
Johnston,U.S. House,Markwayne Mullin,REP,350009,4,6,49,59,02
Johnston,U.S. House,Jon Douthitt,IND,350009,0,1,3,4,02
Johnston,State Senate,Chequita Williams,DEM,350009,0,2,24,26,14
Johnston,State Senate,Frank Simpson,REP,350009,6,6,57,69,14
Johnston,Governor,Joe Dorman,DEM,350010,0,0,30,30,
Johnston,Governor,Mary Fallin,REP,350010,0,1,34,35,
Johnston,Governor,Kimberly Willis,IND,350010,0,0,2,2,
Johnston,Governor,Richard Prawdzienski,IND,350010,0,0,2,2,
Johnston,Lieutenant Governor,Cathy Cummings,DEM,350010,0,0,16,16,
Johnston,Lieutenant Governor,Todd Lamb,REP,350010,0,1,49,50,
Johnston,Superintendent of Public Instruction,John Cox,DEM,350010,0,0,33,33,
Johnston,Superintendent of Public Instruction,Joy Hofmeister,REP,350010,0,1,33,34,
Johnston,Commissioner of Labor,Mike Workman,DEM,350010,0,1,21,22,
Johnston,Commissioner of Labor,Mark Costello,REP,350010,0,0,41,41,
Johnston,U.S. Senate,Matt Silverstein,DEM,350010,0,0,18,18,
Johnston,U.S. Senate,Jim Inhofe,REP,350010,0,1,48,49,
Johnston,U.S. Senate,Aaron Delozier,IND,350010,0,0,0,0,
Johnston,U.S. Senate,Ray Woods,IND,350010,0,0,1,1,
Johnston,U.S. Senate,Joan Farr,IND,350010,0,0,1,1,
Johnston,U.S. Senate,Connie Johnson,DEM,350010,0,0,20,20,
Johnston,U.S. Senate,James Lankford,REP,350010,0,1,41,42,
Johnston,U.S. Senate,Mark Beard,IND,350010,0,0,1,1,
Johnston,U.S. House,Earl Everett,DEM,350010,0,0,13,13,02
Johnston,U.S. House,Markwayne Mullin,REP,350010,0,1,52,53,02
Johnston,U.S. House,Jon Douthitt,IND,350010,0,0,2,2,02
Johnston,State Senate,Chequita Williams,DEM,350010,0,0,14,14,14
Johnston,State Senate,Frank Simpson,REP,350010,0,1,49,50,14
Johnston,Governor,Joe Dorman,DEM,350011,1,0,71,72,
Johnston,Governor,Mary Fallin,REP,350011,2,2,48,52,
Johnston,Governor,Kimberly Willis,IND,350011,0,0,6,6,
Johnston,Governor,Richard Prawdzienski,IND,350011,0,0,1,1,
Johnston,Lieutenant Governor,Cathy Cummings,DEM,350011,1,0,51,52,
Johnston,Lieutenant Governor,Todd Lamb,REP,350011,2,2,75,79,
Johnston,Superintendent of Public Instruction,John Cox,DEM,350011,1,0,78,79,
Johnston,Superintendent of Public Instruction,Joy Hofmeister,REP,350011,2,2,47,51,
Johnston,Commissioner of Labor,Mike Workman,DEM,350011,1,0,59,60,
Johnston,Commissioner of Labor,Mark Costello,REP,350011,2,2,65,69,
Johnston,U.S. Senate,Matt Silverstein,DEM,350011,1,0,36,37,
Johnston,U.S. Senate,Jim Inhofe,REP,350011,2,2,86,90,
Johnston,U.S. Senate,Aaron Delozier,IND,350011,0,0,2,2,
Johnston,U.S. Senate,Ray Woods,IND,350011,0,0,0,0,
Johnston,U.S. Senate,Joan Farr,IND,350011,0,0,3,3,
Johnston,U.S. Senate,Connie Johnson,DEM,350011,1,0,47,48,
Johnston,U.S. Senate,James Lankford,REP,350011,2,2,74,78,
Johnston,U.S. Senate,Mark Beard,IND,350011,0,0,4,4,
Johnston,U.S. House,Earl Everett,DEM,350011,1,0,33,34,02
Johnston,U.S. House,Markwayne Mullin,REP,350011,2,2,84,88,02
Johnston,U.S. House,Jon Douthitt,IND,350011,0,0,10,10,02
Johnston,State Senate,Joe Hill,DEM,350011,1,0,63,64,6
Johnston,State Senate,Josh Brecheen,REP,350011,2,2,64,68,6
Johnston,State Senate,Vicki Gaylor,IND,350011,0,0,1,1,6
Johnston,Governor,Joe Dorman,DEM,350012,1,4,110,115,
Johnston,Governor,Mary Fallin,REP,350012,1,6,139,146,
Johnston,Governor,Kimberly Willis,IND,350012,0,0,12,12,
Johnston,Governor,Richard Prawdzienski,IND,350012,0,0,3,3,
Johnston,Lieutenant Governor,Cathy Cummings,DEM,350012,0,4,87,91,
Johnston,Lieutenant Governor,Todd Lamb,REP,350012,2,6,172,180,
Johnston,Superintendent of Public Instruction,John Cox,DEM,350012,1,5,135,141,
Johnston,Superintendent of Public Instruction,Joy Hofmeister,REP,350012,1,5,122,128,
Johnston,Commissioner of Labor,Mike Workman,DEM,350012,0,4,99,103,
Johnston,Commissioner of Labor,Mark Costello,REP,350012,2,6,155,163,
Johnston,U.S. Senate,Matt Silverstein,DEM,350012,1,3,62,66,
Johnston,U.S. Senate,Jim Inhofe,REP,350012,1,7,189,197,
Johnston,U.S. Senate,Aaron Delozier,IND,350012,0,0,1,1,
Johnston,U.S. Senate,Ray Woods,IND,350012,0,0,7,7,
Johnston,U.S. Senate,Joan Farr,IND,350012,0,0,5,5,
Johnston,U.S. Senate,Connie Johnson,DEM,350012,0,3,72,75,
Johnston,U.S. Senate,James Lankford,REP,350012,2,6,169,177,
Johnston,U.S. Senate,Mark Beard,IND,350012,0,1,16,17,
Johnston,U.S. House,Earl Everett,DEM,350012,1,3,58,62,02
Johnston,U.S. House,Markwayne Mullin,REP,350012,1,7,189,197,02
Johnston,U.S. House,Jon Douthitt,IND,350012,0,0,12,12,02
Johnston,State Senate,Joe Hill,DEM,350012,0,4,91,95,6
Johnston,State Senate,Josh Brecheen,REP,350012,2,6,165,173,6
Johnston,State Senate,Vicki Gaylor,IND,350012,0,0,8,8,6
Johnston,Governor,Joe Dorman,DEM,350013,6,10,137,153,
Johnston,Governor,Mary Fallin,REP,350013,5,13,143,161,
Johnston,Governor,Kimberly Willis,IND,350013,1,1,7,9,
Johnston,Governor,Richard Prawdzienski,IND,350013,0,0,3,3,
Johnston,Lieutenant Governor,Cathy Cummings,DEM,350013,3,8,103,114,
Johnston,Lieutenant Governor,Todd Lamb,REP,350013,8,16,186,210,
Johnston,Superintendent of Public Instruction,John Cox,DEM,350013,5,13,137,155,
Johnston,Superintendent of Public Instruction,Joy Hofmeister,REP,350013,5,11,149,165,
Johnston,Commissioner of Labor,Mike Workman,DEM,350013,3,8,123,134,
Johnston,Commissioner of Labor,Mark Costello,REP,350013,8,16,162,186,
Johnston,U.S. Senate,Matt Silverstein,DEM,350013,4,5,76,85,
Johnston,U.S. Senate,Jim Inhofe,REP,350013,7,17,205,229,
Johnston,U.S. Senate,Aaron Delozier,IND,350013,1,0,0,1,
Johnston,U.S. Senate,Ray Woods,IND,350013,0,0,3,3,
Johnston,U.S. Senate,Joan Farr,IND,350013,0,1,4,5,
Johnston,U.S. Senate,Connie Johnson,DEM,350013,2,8,87,97,
Johnston,U.S. Senate,James Lankford,REP,350013,9,14,185,208,
Johnston,U.S. Senate,Mark Beard,IND,350013,1,1,17,19,
Johnston,U.S. House,Earl Everett,DEM,350013,3,7,73,83,02
Johnston,U.S. House,Markwayne Mullin,REP,350013,7,17,200,224,02
Johnston,U.S. House,Jon Douthitt,IND,350013,1,0,16,17,02
Johnston,State Senate,Joe Hill,DEM,350013,3,12,126,141,6
Johnston,State Senate,Josh Brecheen,REP,350013,9,12,159,180,6
Johnston,State Senate,Vicki Gaylor,IND,350013,0,0,4,4,6
Johnston,Governor,Joe Dorman,DEM,350014,0,0,21,21,
Johnston,Governor,Mary Fallin,REP,350014,0,3,31,34,
Johnston,Governor,Kimberly Willis,IND,350014,0,0,1,1,
Johnston,Governor,Richard Prawdzienski,IND,350014,0,0,1,1,
Johnston,Lieutenant Governor,Cathy Cummings,DEM,350014,0,1,10,11,
Johnston,Lieutenant Governor,Todd Lamb,REP,350014,0,2,42,44,
Johnston,Superintendent of Public Instruction,John Cox,DEM,350014,0,1,27,28,
Johnston,Superintendent of Public Instruction,Joy Hofmeister,REP,350014,0,2,22,24,
Johnston,Commissioner of Labor,Mike Workman,DEM,350014,0,1,17,18,
Johnston,Commissioner of Labor,Mark Costello,REP,350014,0,2,34,36,
Johnston,U.S. Senate,Matt Silverstein,DEM,350014,0,1,7,8,
Johnston,U.S. Senate,Jim Inhofe,REP,350014,0,2,46,48,
Johnston,U.S. Senate,Aaron Delozier,IND,350014,0,0,1,1,
Johnston,U.S. Senate,Ray Woods,IND,350014,0,0,0,0,
Johnston,U.S. Senate,Joan Farr,IND,350014,0,0,0,0,
Johnston,U.S. Senate,Connie Johnson,DEM,350014,0,1,12,13,
Johnston,U.S. Senate,James Lankford,REP,350014,0,2,41,43,
Johnston,U.S. Senate,Mark Beard,IND,350014,0,0,0,0,
Johnston,U.S. House,Earl Everett,DEM,350014,0,0,6,6,02
Johnston,U.S. House,Markwayne Mullin,REP,350014,0,3,46,49,02
Johnston,U.S. House,Jon Douthitt,IND,350014,0,0,2,2,02
Johnston,State Senate,Chequita Williams,DEM,350014,0,0,5,5,14
Johnston,State Senate,Frank Simpson,REP,350014,0,3,47,50,14
Kay,Governor,Joe Dorman,DEM,360001,6,22,157,185,
Kay,Governor,Mary Fallin,REP,360001,9,39,288,336,
Kay,Governor,Kimberly Willis,IND,360001,0,3,9,12,
Kay,Governor,Richard Prawdzienski,IND,360001,0,0,5,5,
Kay,Lieutenant Governor,Cathy Cummings,DEM,360001,3,13,111,127,
Kay,Lieutenant Governor,Todd Lamb,REP,360001,12,51,347,410,
Kay,Superintendent of Public Instruction,John Cox,DEM,360001,6,17,195,218,
Kay,Superintendent of Public Instruction,Joy Hofmeister,REP,360001,9,46,261,316,
Kay,Commissioner of Labor,Mike Workman,DEM,360001,5,16,146,167,
Kay,Commissioner of Labor,Mark Costello,REP,360001,10,47,308,365,
Kay,U.S. Senate,Matt Silverstein,DEM,360001,3,10,87,100,
Kay,U.S. Senate,Jim Inhofe,REP,360001,12,52,351,415,
Kay,U.S. Senate,Aaron Delozier,IND,360001,0,1,6,7,
Kay,U.S. Senate,Ray Woods,IND,360001,0,1,4,5,
Kay,U.S. Senate,Joan Farr,IND,360001,0,0,8,8,
Kay,U.S. Senate,Connie Johnson,DEM,360001,4,13,90,107,
Kay,U.S. Senate,James Lankford,REP,360001,10,48,352,410,
Kay,U.S. Senate,Mark Beard,IND,360001,1,3,16,20,
Kay,U.S. House,Frankie Robbins,DEM,360001,4,11,105,120,03
Kay,U.S. House,Frank Lucas,REP,360001,11,52,354,417,03
Kay,Governor,Joe Dorman,DEM,360101,1,7,180,188,
Kay,Governor,Mary Fallin,REP,360101,4,1,222,227,
Kay,Governor,Kimberly Willis,IND,360101,0,0,6,6,
Kay,Governor,Richard Prawdzienski,IND,360101,0,0,6,6,
Kay,Lieutenant Governor,Cathy Cummings,DEM,360101,1,6,94,101,
Kay,Lieutenant Governor,Todd Lamb,REP,360101,4,2,314,320,
Kay,Superintendent of Public Instruction,John Cox,DEM,360101,1,7,183,191,
Kay,Superintendent of Public Instruction,Joy Hofmeister,REP,360101,4,1,225,230,
Kay,Commissioner of Labor,Mike Workman,DEM,360101,1,6,138,145,
Kay,Commissioner of Labor,Mark Costello,REP,360101,4,2,266,272,
Kay,U.S. Senate,Matt Silverstein,DEM,360101,1,5,98,104,
Kay,U.S. Senate,Jim Inhofe,REP,360101,4,2,297,303,
Kay,U.S. Senate,Aaron Delozier,IND,360101,0,0,4,4,
Kay,U.S. Senate,Ray Woods,IND,360101,0,0,5,5,
Kay,U.S. Senate,Joan Farr,IND,360101,0,0,6,6,
Kay,U.S. Senate,Connie Johnson,DEM,360101,1,6,104,111,
Kay,U.S. Senate,James Lankford,REP,360101,4,2,289,295,
Kay,U.S. Senate,Mark Beard,IND,360101,0,0,19,19,
Kay,U.S. House,Frankie Robbins,DEM,360101,1,5,91,97,03
Kay,U.S. House,Frank Lucas,REP,360101,4,2,318,324,03
Kay,Governor,Joe Dorman,DEM,360103,2,2,142,146,
Kay,Governor,Mary Fallin,REP,360103,12,4,214,230,
Kay,Governor,Kimberly Willis,IND,360103,0,0,10,10,
Kay,Governor,Richard Prawdzienski,IND,360103,0,2,7,9,
Kay,Lieutenant Governor,Cathy Cummings,DEM,360103,1,1,84,86,
Kay,Lieutenant Governor,Todd Lamb,REP,360103,13,6,285,304,
Kay,Superintendent of Public Instruction,John Cox,DEM,360103,2,3,166,171,
Kay,Superintendent of Public Instruction,Joy Hofmeister,REP,360103,12,4,204,220,
Kay,Commissioner of Labor,Mike Workman,DEM,360103,0,1,110,111,
Kay,Commissioner of Labor,Mark Costello,REP,360103,14,6,252,272,
Kay,U.S. Senate,Matt Silverstein,DEM,360103,1,1,63,65,
Kay,U.S. Senate,Jim Inhofe,REP,360103,13,4,285,302,
Kay,U.S. Senate,Aaron Delozier,IND,360103,0,0,2,2,
Kay,U.S. Senate,Ray Woods,IND,360103,0,0,10,10,
Kay,U.S. Senate,Joan Farr,IND,360103,0,2,6,8,
Kay,U.S. Senate,Connie Johnson,DEM,360103,0,2,77,79,
Kay,U.S. Senate,James Lankford,REP,360103,13,5,277,295,
Kay,U.S. Senate,Mark Beard,IND,360103,1,0,14,15,
Kay,U.S. House,Frankie Robbins,DEM,360103,0,1,74,75,03
Kay,U.S. House,Frank Lucas,REP,360103,14,6,293,313,03
Kay,Governor,Joe Dorman,DEM,360202,4,2,148,154,
Kay,Governor,Mary Fallin,REP,360202,4,10,251,265,
Kay,Governor,Kimberly Willis,IND,360202,0,0,10,10,
Kay,Governor,Richard Prawdzienski,IND,360202,0,0,4,4,
Kay,Lieutenant Governor,Cathy Cummings,DEM,360202,3,0,98,101,
Kay,Lieutenant Governor,Todd Lamb,REP,360202,4,12,313,329,
Kay,Superintendent of Public Instruction,John Cox,DEM,360202,5,3,163,171,
Kay,Superintendent of Public Instruction,Joy Hofmeister,REP,360202,3,9,247,259,
Kay,Commissioner of Labor,Mike Workman,DEM,360202,2,1,140,143,
Kay,Commissioner of Labor,Mark Costello,REP,360202,5,10,266,281,
Kay,U.S. Senate,Matt Silverstein,DEM,360202,2,1,82,85,
Kay,U.S. Senate,Jim Inhofe,REP,360202,6,11,307,324,
Kay,U.S. Senate,Aaron Delozier,IND,360202,0,0,3,3,
Kay,U.S. Senate,Ray Woods,IND,360202,0,0,9,9,
Kay,U.S. Senate,Joan Farr,IND,360202,0,0,11,11,
Kay,U.S. Senate,Connie Johnson,DEM,360202,2,0,90,92,
Kay,U.S. Senate,James Lankford,REP,360202,6,12,307,325,
Kay,U.S. Senate,Mark Beard,IND,360202,0,0,15,15,
Kay,U.S. House,Frankie Robbins,DEM,360202,2,0,97,99,03
Kay,U.S. House,Frank Lucas,REP,360202,5,12,313,330,03
Kay,Governor,Joe Dorman,DEM,360205,2,0,164,166,
Kay,Governor,Mary Fallin,REP,360205,6,4,245,255,
Kay,Governor,Kimberly Willis,IND,360205,0,0,13,13,
Kay,Governor,Richard Prawdzienski,IND,360205,0,1,9,10,
Kay,Lieutenant Governor,Cathy Cummings,DEM,360205,1,0,128,129,
Kay,Lieutenant Governor,Todd Lamb,REP,360205,7,5,303,315,
Kay,Superintendent of Public Instruction,John Cox,DEM,360205,2,1,205,208,
Kay,Superintendent of Public Instruction,Joy Hofmeister,REP,360205,6,4,225,235,
Kay,Commissioner of Labor,Mike Workman,DEM,360205,1,1,152,154,
Kay,Commissioner of Labor,Mark Costello,REP,360205,7,4,273,284,
Kay,U.S. Senate,Matt Silverstein,DEM,360205,0,0,99,99,
Kay,U.S. Senate,Jim Inhofe,REP,360205,8,5,297,310,
Kay,U.S. Senate,Aaron Delozier,IND,360205,0,0,7,7,
Kay,U.S. Senate,Ray Woods,IND,360205,0,0,14,14,
Kay,U.S. Senate,Joan Farr,IND,360205,0,0,13,13,
Kay,U.S. Senate,Connie Johnson,DEM,360205,2,0,112,114,
Kay,U.S. Senate,James Lankford,REP,360205,5,5,295,305,
Kay,U.S. Senate,Mark Beard,IND,360205,1,0,22,23,
Kay,U.S. House,Frankie Robbins,DEM,360205,0,0,130,130,03
Kay,U.S. House,Frank Lucas,REP,360205,8,4,300,312,03
Kay,Governor,Joe Dorman,DEM,360206,4,3,217,224,
Kay,Governor,Mary Fallin,REP,360206,6,6,427,439,
Kay,Governor,Kimberly Willis,IND,360206,0,0,18,18,
Kay,Governor,Richard Prawdzienski,IND,360206,1,0,8,9,
Kay,Lieutenant Governor,Cathy Cummings,DEM,360206,2,2,120,124,
Kay,Lieutenant Governor,Todd Lamb,REP,360206,9,7,549,565,
Kay,Superintendent of Public Instruction,John Cox,DEM,360206,1,4,272,277,
Kay,Superintendent of Public Instruction,Joy Hofmeister,REP,360206,10,5,394,409,
Kay,Commissioner of Labor,Mike Workman,DEM,360206,3,2,177,182,
Kay,Commissioner of Labor,Mark Costello,REP,360206,8,7,480,495,
Kay,U.S. Senate,Matt Silverstein,DEM,360206,2,1,105,108,
Kay,U.S. Senate,Jim Inhofe,REP,360206,8,8,542,558,
Kay,U.S. Senate,Aaron Delozier,IND,360206,0,0,0,0,
Kay,U.S. Senate,Ray Woods,IND,360206,2,0,11,13,
Kay,U.S. Senate,Joan Farr,IND,360206,0,0,10,10,
Kay,U.S. Senate,Connie Johnson,DEM,360206,4,1,110,115,
Kay,U.S. Senate,James Lankford,REP,360206,7,8,536,551,
Kay,U.S. Senate,Mark Beard,IND,360206,1,0,23,24,
Kay,U.S. House,Frankie Robbins,DEM,360206,2,1,111,114,03
Kay,U.S. House,Frank Lucas,REP,360206,10,8,556,574,03
Kay,Governor,Joe Dorman,DEM,360400,0,4,8,12,
Kay,Governor,Mary Fallin,REP,360400,2,0,48,50,
Kay,Governor,Kimberly Willis,IND,360400,0,0,3,3,
Kay,Governor,Richard Prawdzienski,IND,360400,0,0,3,3,
Kay,Lieutenant Governor,Cathy Cummings,DEM,360400,0,4,7,11,
Kay,Lieutenant Governor,Todd Lamb,REP,360400,2,0,55,57,
Kay,Superintendent of Public Instruction,John Cox,DEM,360400,0,4,14,18,
Kay,Superintendent of Public Instruction,Joy Hofmeister,REP,360400,2,0,48,50,
Kay,Commissioner of Labor,Mike Workman,DEM,360400,0,4,12,16,
Kay,Commissioner of Labor,Mark Costello,REP,360400,2,0,49,51,
Kay,U.S. Senate,Matt Silverstein,DEM,360400,0,3,6,9,
Kay,U.S. Senate,Jim Inhofe,REP,360400,2,0,54,56,
Kay,U.S. Senate,Aaron Delozier,IND,360400,0,0,1,1,
Kay,U.S. Senate,Ray Woods,IND,360400,0,0,0,0,
Kay,U.S. Senate,Joan Farr,IND,360400,0,1,0,1,
Kay,U.S. Senate,Connie Johnson,DEM,360400,0,4,6,10,
Kay,U.S. Senate,James Lankford,REP,360400,2,0,53,55,
Kay,U.S. Senate,Mark Beard,IND,360400,0,0,3,3,
Kay,U.S. House,Frankie Robbins,DEM,360400,0,2,8,10,03
Kay,U.S. House,Frank Lucas,REP,360400,2,2,53,57,03
Kay,Governor,Joe Dorman,DEM,360401,0,2,11,13,
Kay,Governor,Mary Fallin,REP,360401,4,5,19,28,
Kay,Governor,Kimberly Willis,IND,360401,0,0,2,2,
Kay,Governor,Richard Prawdzienski,IND,360401,0,0,0,0,
Kay,Lieutenant Governor,Cathy Cummings,DEM,360401,0,2,6,8,
Kay,Lieutenant Governor,Todd Lamb,REP,360401,4,5,25,34,
Kay,Superintendent of Public Instruction,John Cox,DEM,360401,0,2,13,15,
Kay,Superintendent of Public Instruction,Joy Hofmeister,REP,360401,4,6,19,29,
Kay,Commissioner of Labor,Mike Workman,DEM,360401,0,2,7,9,
Kay,Commissioner of Labor,Mark Costello,REP,360401,4,5,25,34,
Kay,U.S. Senate,Matt Silverstein,DEM,360401,0,1,7,8,
Kay,U.S. Senate,Jim Inhofe,REP,360401,4,5,24,33,
Kay,U.S. Senate,Aaron Delozier,IND,360401,0,0,0,0,
Kay,U.S. Senate,Ray Woods,IND,360401,0,1,0,1,
Kay,U.S. Senate,Joan Farr,IND,360401,0,0,1,1,
Kay,U.S. Senate,Connie Johnson,DEM,360401,0,2,7,9,
Kay,U.S. Senate,James Lankford,REP,360401,4,5,25,34,
Kay,U.S. Senate,Mark Beard,IND,360401,0,0,0,0,
Kay,U.S. House,Frankie Robbins,DEM,360401,0,2,6,8,03
Kay,U.S. House,Frank Lucas,REP,360401,4,5,26,35,03
Kay,Governor,Joe Dorman,DEM,360403,1,5,66,72,
Kay,Governor,Mary Fallin,REP,360403,8,14,162,184,
Kay,Governor,Kimberly Willis,IND,360403,0,1,4,5,
Kay,Governor,Richard Prawdzienski,IND,360403,0,1,2,3,
Kay,Lieutenant Governor,Cathy Cummings,DEM,360403,1,3,48,52,
Kay,Lieutenant Governor,Todd Lamb,REP,360403,8,18,183,209,
Kay,Superintendent of Public Instruction,John Cox,DEM,360403,2,10,100,112,
Kay,Superintendent of Public Instruction,Joy Hofmeister,REP,360403,7,11,135,153,
Kay,Commissioner of Labor,Mike Workman,DEM,360403,3,5,67,75,
Kay,Commissioner of Labor,Mark Costello,REP,360403,6,14,163,183,
Kay,U.S. Senate,Matt Silverstein,DEM,360403,1,3,49,53,
Kay,U.S. Senate,Jim Inhofe,REP,360403,8,18,177,203,
Kay,U.S. Senate,Aaron Delozier,IND,360403,0,0,1,1,
Kay,U.S. Senate,Ray Woods,IND,360403,0,0,4,4,
Kay,U.S. Senate,Joan Farr,IND,360403,0,0,3,3,
Kay,U.S. Senate,Connie Johnson,DEM,360403,1,4,44,49,
Kay,U.S. Senate,James Lankford,REP,360403,8,17,179,204,
Kay,U.S. Senate,Mark Beard,IND,360403,0,0,11,11,
Kay,U.S. House,Frankie Robbins,DEM,360403,2,2,47,51,03
Kay,U.S. House,Frank Lucas,REP,360403,7,19,186,212,03
Kay,Governor,Joe Dorman,DEM,360404,0,1,31,32,
Kay,Governor,Mary Fallin,REP,360404,0,4,61,65,
Kay,Governor,Kimberly Willis,IND,360404,0,0,4,4,
Kay,Governor,Richard Prawdzienski,IND,360404,0,0,1,1,
Kay,Lieutenant Governor,Cathy Cummings,DEM,360404,0,1,20,21,
Kay,Lieutenant Governor,Todd Lamb,REP,360404,0,3,77,80,
Kay,Superintendent of Public Instruction,John Cox,DEM,360404,0,3,38,41,
Kay,Superintendent of Public Instruction,Joy Hofmeister,REP,360404,0,1,59,60,
Kay,Commissioner of Labor,Mike Workman,DEM,360404,0,1,26,27,
Kay,Commissioner of Labor,Mark Costello,REP,360404,0,4,69,73,
Kay,U.S. Senate,Matt Silverstein,DEM,360404,0,1,15,16,
Kay,U.S. Senate,Jim Inhofe,REP,360404,0,3,75,78,
Kay,U.S. Senate,Aaron Delozier,IND,360404,0,0,1,1,
Kay,U.S. Senate,Ray Woods,IND,360404,0,0,3,3,
Kay,U.S. Senate,Joan Farr,IND,360404,0,0,3,3,
Kay,U.S. Senate,Connie Johnson,DEM,360404,0,1,18,19,
Kay,U.S. Senate,James Lankford,REP,360404,0,3,76,79,
Kay,U.S. Senate,Mark Beard,IND,360404,0,0,2,2,
Kay,U.S. House,Frankie Robbins,DEM,360404,0,1,19,20,03
Kay,U.S. House,Frank Lucas,REP,360404,0,3,76,79,03
Kay,Governor,Joe Dorman,DEM,360406,0,1,45,46,
Kay,Governor,Mary Fallin,REP,360406,3,3,102,108,
Kay,Governor,Kimberly Willis,IND,360406,0,0,1,1,
Kay,Governor,Richard Prawdzienski,IND,360406,0,0,3,3,
Kay,Lieutenant Governor,Cathy Cummings,DEM,360406,0,1,21,22,
Kay,Lieutenant Governor,Todd Lamb,REP,360406,3,3,126,132,
Kay,Superintendent of Public Instruction,John Cox,DEM,360406,0,3,58,61,
Kay,Superintendent of Public Instruction,Joy Hofmeister,REP,360406,3,1,88,92,
Kay,Commissioner of Labor,Mike Workman,DEM,360406,0,2,37,39,
Kay,Commissioner of Labor,Mark Costello,REP,360406,3,1,107,111,
Kay,U.S. Senate,Matt Silverstein,DEM,360406,0,1,23,24,
Kay,U.S. Senate,Jim Inhofe,REP,360406,3,3,123,129,
Kay,U.S. Senate,Aaron Delozier,IND,360406,0,0,1,1,
Kay,U.S. Senate,Ray Woods,IND,360406,0,0,1,1,
Kay,U.S. Senate,Joan Farr,IND,360406,0,0,1,1,
Kay,U.S. Senate,Connie Johnson,DEM,360406,0,1,23,24,
Kay,U.S. Senate,James Lankford,REP,360406,3,3,119,125,
Kay,U.S. Senate,Mark Beard,IND,360406,0,0,5,5,
Kay,U.S. House,Frankie Robbins,DEM,360406,0,0,25,25,03
Kay,U.S. House,Frank Lucas,REP,360406,3,4,123,130,03
Kay,Governor,Joe Dorman,DEM,360407,0,0,4,4,
Kay,Governor,Mary Fallin,REP,360407,2,2,16,20,
Kay,Governor,Kimberly Willis,IND,360407,0,0,0,0,
Kay,Governor,Richard Prawdzienski,IND,360407,0,0,0,0,
Kay,Lieutenant Governor,Cathy Cummings,DEM,360407,0,0,0,0,
Kay,Lieutenant Governor,Todd Lamb,REP,360407,2,2,19,23,
Kay,Superintendent of Public Instruction,John Cox,DEM,360407,0,0,4,4,
Kay,Superintendent of Public Instruction,Joy Hofmeister,REP,360407,2,2,16,20,
Kay,Commissioner of Labor,Mike Workman,DEM,360407,2,0,3,5,
Kay,Commissioner of Labor,Mark Costello,REP,360407,0,2,17,19,
Kay,U.S. Senate,Matt Silverstein,DEM,360407,0,0,0,0,
Kay,U.S. Senate,Jim Inhofe,REP,360407,2,2,20,24,
Kay,U.S. Senate,Aaron Delozier,IND,360407,0,0,0,0,
Kay,U.S. Senate,Ray Woods,IND,360407,0,0,0,0,
Kay,U.S. Senate,Joan Farr,IND,360407,0,0,0,0,
Kay,U.S. Senate,Connie Johnson,DEM,360407,0,0,0,0,
Kay,U.S. Senate,James Lankford,REP,360407,2,2,19,23,
Kay,U.S. Senate,Mark Beard,IND,360407,0,0,1,1,
Kay,U.S. House,Frankie Robbins,DEM,360407,0,0,1,1,03
Kay,U.S. House,Frank Lucas,REP,360407,2,2,19,23,03
Kay,Governor,Joe Dorman,DEM,360409,1,0,16,17,
Kay,Governor,Mary Fallin,REP,360409,1,0,26,27,
Kay,Governor,Kimberly Willis,IND,360409,0,0,0,0,
Kay,Governor,Richard Prawdzienski,IND,360409,0,0,0,0,
Kay,Lieutenant Governor,Cathy Cummings,DEM,360409,1,0,6,7,
Kay,Lieutenant Governor,Todd Lamb,REP,360409,1,0,36,37,
Kay,Superintendent of Public Instruction,John Cox,DEM,360409,1,0,16,17,
Kay,Superintendent of Public Instruction,Joy Hofmeister,REP,360409,1,0,26,27,
Kay,Commissioner of Labor,Mike Workman,DEM,360409,1,0,11,12,
Kay,Commissioner of Labor,Mark Costello,REP,360409,1,0,31,32,
Kay,U.S. Senate,Matt Silverstein,DEM,360409,1,0,5,6,
Kay,U.S. Senate,Jim Inhofe,REP,360409,1,0,37,38,
Kay,U.S. Senate,Aaron Delozier,IND,360409,0,0,0,0,
Kay,U.S. Senate,Ray Woods,IND,360409,0,0,0,0,
Kay,U.S. Senate,Joan Farr,IND,360409,0,0,0,0,
Kay,U.S. Senate,Connie Johnson,DEM,360409,1,0,7,8,
Kay,U.S. Senate,James Lankford,REP,360409,1,0,33,34,
Kay,U.S. Senate,Mark Beard,IND,360409,0,0,2,2,
Kay,U.S. House,Frankie Robbins,DEM,360409,1,0,9,10,03
Kay,U.S. House,Frank Lucas,REP,360409,1,0,33,34,03
Kay,Governor,Joe Dorman,DEM,360411,0,1,30,31,
Kay,Governor,Mary Fallin,REP,360411,1,3,54,58,
Kay,Governor,Kimberly Willis,IND,360411,0,0,2,2,
Kay,Governor,Richard Prawdzienski,IND,360411,0,0,3,3,
Kay,Lieutenant Governor,Cathy Cummings,DEM,360411,0,0,22,22,
Kay,Lieutenant Governor,Todd Lamb,REP,360411,1,4,66,71,
Kay,Superintendent of Public Instruction,John Cox,DEM,360411,0,0,36,36,
Kay,Superintendent of Public Instruction,Joy Hofmeister,REP,360411,1,4,51,56,
Kay,Commissioner of Labor,Mike Workman,DEM,360411,1,0,28,29,
Kay,Commissioner of Labor,Mark Costello,REP,360411,0,4,60,64,
Kay,U.S. Senate,Matt Silverstein,DEM,360411,0,0,17,17,
Kay,U.S. Senate,Jim Inhofe,REP,360411,1,4,68,73,
Kay,U.S. Senate,Aaron Delozier,IND,360411,0,0,0,0,
Kay,U.S. Senate,Ray Woods,IND,360411,0,0,2,2,
Kay,U.S. Senate,Joan Farr,IND,360411,0,0,1,1,
Kay,U.S. Senate,Connie Johnson,DEM,360411,0,0,16,16,
Kay,U.S. Senate,James Lankford,REP,360411,1,4,68,73,
Kay,U.S. Senate,Mark Beard,IND,360411,0,0,5,5,
Kay,U.S. House,Frankie Robbins,DEM,360411,0,1,19,20,03
Kay,U.S. House,Frank Lucas,REP,360411,1,3,70,74,03
Kay,Governor,Joe Dorman,DEM,360412,0,0,50,50,
Kay,Governor,Mary Fallin,REP,360412,2,3,79,84,
Kay,Governor,Kimberly Willis,IND,360412,0,0,4,4,
Kay,Governor,Richard Prawdzienski,IND,360412,0,0,0,0,
Kay,Lieutenant Governor,Cathy Cummings,DEM,360412,0,0,45,45,
Kay,Lieutenant Governor,Todd Lamb,REP,360412,2,3,87,92,
Kay,Superintendent of Public Instruction,John Cox,DEM,360412,0,0,50,50,
Kay,Superintendent of Public Instruction,Joy Hofmeister,REP,360412,2,3,82,87,
Kay,Commissioner of Labor,Mike Workman,DEM,360412,0,0,47,47,
Kay,Commissioner of Labor,Mark Costello,REP,360412,2,3,80,85,
Kay,U.S. Senate,Matt Silverstein,DEM,360412,0,0,33,33,
Kay,U.S. Senate,Jim Inhofe,REP,360412,2,3,90,95,
Kay,U.S. Senate,Aaron Delozier,IND,360412,0,0,1,1,
Kay,U.S. Senate,Ray Woods,IND,360412,0,0,5,5,
Kay,U.S. Senate,Joan Farr,IND,360412,0,0,3,3,
Kay,U.S. Senate,Connie Johnson,DEM,360412,0,0,33,33,
Kay,U.S. Senate,James Lankford,REP,360412,2,3,88,93,
Kay,U.S. Senate,Mark Beard,IND,360412,0,0,9,9,
Kay,U.S. House,Frankie Robbins,DEM,360412,0,0,42,42,03
Kay,U.S. House,Frank Lucas,REP,360412,2,3,89,94,03
Kay,Governor,Joe Dorman,DEM,360413,8,6,189,203,
Kay,Governor,Mary Fallin,REP,360413,14,18,379,411,
Kay,Governor,Kimberly Willis,IND,360413,0,0,7,7,
Kay,Governor,Richard Prawdzienski,IND,360413,0,0,1,1,
Kay,Lieutenant Governor,Cathy Cummings,DEM,360413,7,5,130,142,
Kay,Lieutenant Governor,Todd Lamb,REP,360413,15,19,444,478,
Kay,Superintendent of Public Instruction,John Cox,DEM,360413,6,7,204,217,
Kay,Superintendent of Public Instruction,Joy Hofmeister,REP,360413,16,17,371,404,
Kay,Commissioner of Labor,Mike Workman,DEM,360413,8,5,155,168,
Kay,Commissioner of Labor,Mark Costello,REP,360413,14,18,406,438,
Kay,U.S. Senate,Matt Silverstein,DEM,360413,7,5,122,134,
Kay,U.S. Senate,Jim Inhofe,REP,360413,15,18,442,475,
Kay,U.S. Senate,Aaron Delozier,IND,360413,0,0,1,1,
Kay,U.S. Senate,Ray Woods,IND,360413,0,0,3,3,
Kay,U.S. Senate,Joan Farr,IND,360413,0,0,5,5,
Kay,U.S. Senate,Connie Johnson,DEM,360413,6,4,115,125,
Kay,U.S. Senate,James Lankford,REP,360413,16,19,451,486,
Kay,U.S. Senate,Mark Beard,IND,360413,0,0,9,9,
Kay,U.S. House,Frankie Robbins,DEM,360413,6,5,120,131,03
Kay,U.S. House,Frank Lucas,REP,360413,16,18,455,489,03
Kay,Governor,Joe Dorman,DEM,360419,5,0,107,112,
Kay,Governor,Mary Fallin,REP,360419,8,2,164,174,
Kay,Governor,Kimberly Willis,IND,360419,0,0,3,3,
Kay,Governor,Richard Prawdzienski,IND,360419,0,0,5,5,
Kay,Lieutenant Governor,Cathy Cummings,DEM,360419,5,0,80,85,
Kay,Lieutenant Governor,Todd Lamb,REP,360419,8,2,199,209,
Kay,Superintendent of Public Instruction,John Cox,DEM,360419,5,0,118,123,
Kay,Superintendent of Public Instruction,Joy Hofmeister,REP,360419,7,2,160,169,
Kay,Commissioner of Labor,Mike Workman,DEM,360419,5,0,109,114,
Kay,Commissioner of Labor,Mark Costello,REP,360419,7,2,162,171,
Kay,U.S. Senate,Matt Silverstein,DEM,360419,5,0,67,72,
Kay,U.S. Senate,Jim Inhofe,REP,360419,8,2,194,204,
Kay,U.S. Senate,Aaron Delozier,IND,360419,0,0,4,4,
Kay,U.S. Senate,Ray Woods,IND,360419,0,0,10,10,
Kay,U.S. Senate,Joan Farr,IND,360419,0,0,6,6,
Kay,U.S. Senate,Connie Johnson,DEM,360419,5,0,77,82,
Kay,U.S. Senate,James Lankford,REP,360419,8,2,193,203,
Kay,U.S. Senate,Mark Beard,IND,360419,0,0,10,10,
Kay,U.S. House,Frankie Robbins,DEM,360419,5,0,77,82,03
Kay,U.S. House,Frank Lucas,REP,360419,8,2,203,213,03
Kay,Governor,Joe Dorman,DEM,360420,1,0,57,58,
Kay,Governor,Mary Fallin,REP,360420,4,5,109,118,
Kay,Governor,Kimberly Willis,IND,360420,0,0,3,3,
Kay,Governor,Richard Prawdzienski,IND,360420,0,0,1,1,
Kay,Lieutenant Governor,Cathy Cummings,DEM,360420,0,1,41,42,
Kay,Lieutenant Governor,Todd Lamb,REP,360420,5,4,129,138,
Kay,Superintendent of Public Instruction,John Cox,DEM,360420,1,0,69,70,
Kay,Superintendent of Public Instruction,Joy Hofmeister,REP,360420,4,5,101,110,
Kay,Commissioner of Labor,Mike Workman,DEM,360420,0,0,64,64,
Kay,Commissioner of Labor,Mark Costello,REP,360420,5,5,105,115,
Kay,U.S. Senate,Matt Silverstein,DEM,360420,0,0,36,36,
Kay,U.S. Senate,Jim Inhofe,REP,360420,5,5,126,136,
Kay,U.S. Senate,Aaron Delozier,IND,360420,0,0,1,1,
Kay,U.S. Senate,Ray Woods,IND,360420,0,0,5,5,
Kay,U.S. Senate,Joan Farr,IND,360420,0,0,1,1,
Kay,U.S. Senate,Connie Johnson,DEM,360420,0,1,42,43,
Kay,U.S. Senate,James Lankford,REP,360420,5,4,121,130,
Kay,U.S. Senate,Mark Beard,IND,360420,0,0,6,6,
Kay,U.S. House,Frankie Robbins,DEM,360420,0,0,36,36,03
Kay,U.S. House,Frank Lucas,REP,360420,5,5,132,142,03
Kay,Governor,Joe Dorman,DEM,360503,5,8,231,244,
Kay,Governor,Mary Fallin,REP,360503,10,10,336,356,
Kay,Governor,Kimberly Willis,IND,360503,0,0,12,12,
Kay,Governor,Richard Prawdzienski,IND,360503,0,0,6,6,
Kay,Lieutenant Governor,Cathy Cummings,DEM,360503,2,5,167,174,
Kay,Lieutenant Governor,Todd Lamb,REP,360503,13,13,417,443,
Kay,Superintendent of Public Instruction,John Cox,DEM,360503,5,8,213,226,
Kay,Superintendent of Public Instruction,Joy Hofmeister,REP,360503,10,10,371,391,
Kay,Commissioner of Labor,Mike Workman,DEM,360503,2,6,197,205,
Kay,Commissioner of Labor,Mark Costello,REP,360503,13,12,383,408,
Kay,U.S. Senate,Matt Silverstein,DEM,360503,4,6,151,161,
Kay,U.S. Senate,Jim Inhofe,REP,360503,12,12,402,426,
Kay,U.S. Senate,Aaron Delozier,IND,360503,0,0,9,9,
Kay,U.S. Senate,Ray Woods,IND,360503,0,0,13,13,
Kay,U.S. Senate,Joan Farr,IND,360503,0,0,8,8,
Kay,U.S. Senate,Connie Johnson,DEM,360503,3,6,151,160,
Kay,U.S. Senate,James Lankford,REP,360503,13,12,408,433,
Kay,U.S. Senate,Mark Beard,IND,360503,0,0,25,25,
Kay,U.S. House,Frankie Robbins,DEM,360503,1,5,161,167,03
Kay,U.S. House,Frank Lucas,REP,360503,15,13,424,452,03
Kay,Governor,Joe Dorman,DEM,360507,9,6,89,104,
Kay,Governor,Mary Fallin,REP,360507,4,2,181,187,
Kay,Governor,Kimberly Willis,IND,360507,0,1,13,14,
Kay,Governor,Richard Prawdzienski,IND,360507,0,0,6,6,
Kay,Lieutenant Governor,Cathy Cummings,DEM,360507,5,5,75,85,
Kay,Lieutenant Governor,Todd Lamb,REP,360507,8,4,214,226,
Kay,Superintendent of Public Instruction,John Cox,DEM,360507,5,5,95,105,
Kay,Superintendent of Public Instruction,Joy Hofmeister,REP,360507,8,4,192,204,
Kay,Commissioner of Labor,Mike Workman,DEM,360507,5,5,105,115,
Kay,Commissioner of Labor,Mark Costello,REP,360507,8,4,176,188,
Kay,U.S. Senate,Matt Silverstein,DEM,360507,7,5,60,72,
Kay,U.S. Senate,Jim Inhofe,REP,360507,6,4,208,218,
Kay,U.S. Senate,Aaron Delozier,IND,360507,0,0,5,5,
Kay,U.S. Senate,Ray Woods,IND,360507,0,0,9,9,
Kay,U.S. Senate,Joan Farr,IND,360507,0,0,6,6,
Kay,U.S. Senate,Connie Johnson,DEM,360507,7,5,63,75,
Kay,U.S. Senate,James Lankford,REP,360507,6,3,207,216,
Kay,U.S. Senate,Mark Beard,IND,360507,0,1,19,20,
Kay,U.S. House,Frankie Robbins,DEM,360507,6,6,76,88,03
Kay,U.S. House,Frank Lucas,REP,360507,7,3,210,220,03
Kay,Governor,Joe Dorman,DEM,360516,0,0,134,134,
Kay,Governor,Mary Fallin,REP,360516,3,2,126,131,
Kay,Governor,Kimberly Willis,IND,360516,0,0,3,3,
Kay,Governor,Richard Prawdzienski,IND,360516,0,1,9,10,
Kay,Lieutenant Governor,Cathy Cummings,DEM,360516,0,1,123,124,
Kay,Lieutenant Governor,Todd Lamb,REP,360516,3,2,147,152,
Kay,Superintendent of Public Instruction,John Cox,DEM,360516,0,1,129,130,
Kay,Superintendent of Public Instruction,Joy Hofmeister,REP,360516,2,2,140,144,
Kay,Commissioner of Labor,Mike Workman,DEM,360516,0,1,119,120,
Kay,Commissioner of Labor,Mark Costello,REP,360516,2,2,147,151,
Kay,U.S. Senate,Matt Silverstein,DEM,360516,0,0,108,108,
Kay,U.S. Senate,Jim Inhofe,REP,360516,3,2,148,153,
Kay,U.S. Senate,Aaron Delozier,IND,360516,0,0,2,2,
Kay,U.S. Senate,Ray Woods,IND,360516,0,1,4,5,
Kay,U.S. Senate,Joan Farr,IND,360516,0,0,6,6,
Kay,U.S. Senate,Connie Johnson,DEM,360516,0,0,112,112,
Kay,U.S. Senate,James Lankford,REP,360516,2,2,144,148,
Kay,U.S. Senate,Mark Beard,IND,360516,1,1,13,15,
Kay,U.S. House,Frankie Robbins,DEM,360516,0,1,114,115,03
Kay,U.S. House,Frank Lucas,REP,360516,3,2,155,160,03
Kay,Governor,Joe Dorman,DEM,360517,1,6,165,172,
Kay,Governor,Mary Fallin,REP,360517,1,5,167,173,
Kay,Governor,Kimberly Willis,IND,360517,0,0,18,18,
Kay,Governor,Richard Prawdzienski,IND,360517,0,0,2,2,
Kay,Lieutenant Governor,Cathy Cummings,DEM,360517,1,5,139,145,
Kay,Lieutenant Governor,Todd Lamb,REP,360517,1,6,215,222,
Kay,Superintendent of Public Instruction,John Cox,DEM,360517,1,6,166,173,
Kay,Superintendent of Public Instruction,Joy Hofmeister,REP,360517,1,5,186,192,
Kay,Commissioner of Labor,Mike Workman,DEM,360517,1,5,159,165,
Kay,Commissioner of Labor,Mark Costello,REP,360517,1,6,188,195,
Kay,U.S. Senate,Matt Silverstein,DEM,360517,1,4,132,137,
Kay,U.S. Senate,Jim Inhofe,REP,360517,1,6,201,208,
Kay,U.S. Senate,Aaron Delozier,IND,360517,0,1,4,5,
Kay,U.S. Senate,Ray Woods,IND,360517,0,0,7,7,
Kay,U.S. Senate,Joan Farr,IND,360517,0,0,7,7,
Kay,U.S. Senate,Connie Johnson,DEM,360517,1,5,130,136,
Kay,U.S. Senate,James Lankford,REP,360517,1,6,204,211,
Kay,U.S. Senate,Mark Beard,IND,360517,0,0,19,19,
Kay,U.S. House,Frankie Robbins,DEM,360517,0,4,139,143,03
Kay,U.S. House,Frank Lucas,REP,360517,2,7,212,221,03
Kay,Governor,Joe Dorman,DEM,360527,4,7,183,194,
Kay,Governor,Mary Fallin,REP,360527,10,4,339,353,
Kay,Governor,Kimberly Willis,IND,360527,0,0,8,8,
Kay,Governor,Richard Prawdzienski,IND,360527,0,0,1,1,
Kay,Lieutenant Governor,Cathy Cummings,DEM,360527,3,5,127,135,
Kay,Lieutenant Governor,Todd Lamb,REP,360527,12,6,400,418,
Kay,Superintendent of Public Instruction,John Cox,DEM,360527,4,6,180,190,
Kay,Superintendent of Public Instruction,Joy Hofmeister,REP,360527,11,5,349,365,
Kay,Commissioner of Labor,Mike Workman,DEM,360527,4,6,158,168,
Kay,Commissioner of Labor,Mark Costello,REP,360527,11,5,365,381,
Kay,U.S. Senate,Matt Silverstein,DEM,360527,2,4,113,119,
Kay,U.S. Senate,Jim Inhofe,REP,360527,12,6,403,421,
Kay,U.S. Senate,Aaron Delozier,IND,360527,0,1,3,4,
Kay,U.S. Senate,Ray Woods,IND,360527,0,0,6,6,
Kay,U.S. Senate,Joan Farr,IND,360527,1,0,4,5,
Kay,U.S. Senate,Connie Johnson,DEM,360527,1,7,120,128,
Kay,U.S. Senate,James Lankford,REP,360527,13,4,398,415,
Kay,U.S. Senate,Mark Beard,IND,360527,0,0,13,13,
Kay,U.S. House,Frankie Robbins,DEM,360527,1,5,114,120,03
Kay,U.S. House,Frank Lucas,REP,360527,12,6,416,434,03
Kay,Governor,Joe Dorman,DEM,360530,6,5,172,183,
Kay,Governor,Mary Fallin,REP,360530,11,5,237,253,
Kay,Governor,Kimberly Willis,IND,360530,2,0,12,14,
Kay,Governor,Richard Prawdzienski,IND,360530,0,0,2,2,
Kay,Lieutenant Governor,Cathy Cummings,DEM,360530,3,3,120,126,
Kay,Lieutenant Governor,Todd Lamb,REP,360530,16,7,302,325,
Kay,Superintendent of Public Instruction,John Cox,DEM,360530,5,5,175,185,
Kay,Superintendent of Public Instruction,Joy Hofmeister,REP,360530,14,5,243,262,
Kay,Commissioner of Labor,Mike Workman,DEM,360530,5,5,148,158,
Kay,Commissioner of Labor,Mark Costello,REP,360530,14,5,271,290,
Kay,U.S. Senate,Matt Silverstein,DEM,360530,2,4,116,122,
Kay,U.S. Senate,Jim Inhofe,REP,360530,14,6,296,316,
Kay,U.S. Senate,Aaron Delozier,IND,360530,0,0,1,1,
Kay,U.S. Senate,Ray Woods,IND,360530,1,0,5,6,
Kay,U.S. Senate,Joan Farr,IND,360530,1,0,4,5,
Kay,U.S. Senate,Connie Johnson,DEM,360530,3,3,107,113,
Kay,U.S. Senate,James Lankford,REP,360530,14,7,301,322,
Kay,U.S. Senate,Mark Beard,IND,360530,2,0,14,16,
Kay,U.S. House,Frankie Robbins,DEM,360530,3,4,111,118,03
Kay,U.S. House,Frank Lucas,REP,360530,16,6,312,334,03
Kay,Governor,Joe Dorman,DEM,360532,5,8,169,182,
Kay,Governor,Mary Fallin,REP,360532,9,8,347,364,
Kay,Governor,Kimberly Willis,IND,360532,0,0,6,6,
Kay,Governor,Richard Prawdzienski,IND,360532,0,0,3,3,
Kay,Lieutenant Governor,Cathy Cummings,DEM,360532,5,4,114,123,
Kay,Lieutenant Governor,Todd Lamb,REP,360532,9,12,411,432,
Kay,Superintendent of Public Instruction,John Cox,DEM,360532,4,7,180,191,
Kay,Superintendent of Public Instruction,Joy Hofmeister,REP,360532,10,9,342,361,
Kay,Commissioner of Labor,Mike Workman,DEM,360532,5,3,144,152,
Kay,Commissioner of Labor,Mark Costello,REP,360532,9,12,367,388,
Kay,U.S. Senate,Matt Silverstein,DEM,360532,3,3,104,110,
Kay,U.S. Senate,Jim Inhofe,REP,360532,12,12,402,426,
Kay,U.S. Senate,Aaron Delozier,IND,360532,0,0,2,2,
Kay,U.S. Senate,Ray Woods,IND,360532,0,0,6,6,
Kay,U.S. Senate,Joan Farr,IND,360532,0,1,9,10,
Kay,U.S. Senate,Connie Johnson,DEM,360532,4,4,109,117,
Kay,U.S. Senate,James Lankford,REP,360532,12,12,397,421,
Kay,U.S. Senate,Mark Beard,IND,360532,0,0,16,16,
Kay,U.S. House,Frankie Robbins,DEM,360532,3,5,109,117,03
Kay,U.S. House,Frank Lucas,REP,360532,13,11,412,436,03
Kay,Governor,Joe Dorman,DEM,360533,1,4,173,178,
Kay,Governor,Mary Fallin,REP,360533,6,7,302,315,
Kay,Governor,Kimberly Willis,IND,360533,0,0,11,11,
Kay,Governor,Richard Prawdzienski,IND,360533,0,0,0,0,
Kay,Lieutenant Governor,Cathy Cummings,DEM,360533,1,3,122,126,
Kay,Lieutenant Governor,Todd Lamb,REP,360533,6,8,361,375,
Kay,Superintendent of Public Instruction,John Cox,DEM,360533,1,5,169,175,
Kay,Superintendent of Public Instruction,Joy Hofmeister,REP,360533,5,6,312,323,
Kay,Commissioner of Labor,Mike Workman,DEM,360533,1,4,143,148,
Kay,Commissioner of Labor,Mark Costello,REP,360533,6,7,327,340,
Kay,U.S. Senate,Matt Silverstein,DEM,360533,1,3,107,111,
Kay,U.S. Senate,Jim Inhofe,REP,360533,6,8,360,374,
Kay,U.S. Senate,Aaron Delozier,IND,360533,0,0,6,6,
Kay,U.S. Senate,Ray Woods,IND,360533,0,0,5,5,
Kay,U.S. Senate,Joan Farr,IND,360533,0,0,5,5,
Kay,U.S. Senate,Connie Johnson,DEM,360533,1,3,114,118,
Kay,U.S. Senate,James Lankford,REP,360533,6,8,349,363,
Kay,U.S. Senate,Mark Beard,IND,360533,0,0,19,19,
Kay,U.S. House,Frankie Robbins,DEM,360533,1,2,120,123,03
Kay,U.S. House,Frank Lucas,REP,360533,6,9,361,376,03
Kay,Governor,Joe Dorman,DEM,360534,5,4,235,244,
Kay,Governor,Mary Fallin,REP,360534,13,15,418,446,
Kay,Governor,Kimberly Willis,IND,360534,0,0,8,8,
Kay,Governor,Richard Prawdzienski,IND,360534,0,0,10,10,
Kay,Lieutenant Governor,Cathy Cummings,DEM,360534,5,4,147,156,
Kay,Lieutenant Governor,Todd Lamb,REP,360534,13,15,522,550,
Kay,Superintendent of Public Instruction,John Cox,DEM,360534,6,5,234,245,
Kay,Superintendent of Public Instruction,Joy Hofmeister,REP,360534,12,14,433,459,
Kay,Commissioner of Labor,Mike Workman,DEM,360534,5,4,183,192,
Kay,Commissioner of Labor,Mark Costello,REP,360534,13,14,473,500,
Kay,U.S. Senate,Matt Silverstein,DEM,360534,3,4,141,148,
Kay,U.S. Senate,Jim Inhofe,REP,360534,14,15,510,539,
Kay,U.S. Senate,Aaron Delozier,IND,360534,1,0,7,8,
Kay,U.S. Senate,Ray Woods,IND,360534,0,0,8,8,
Kay,U.S. Senate,Joan Farr,IND,360534,0,0,1,1,
Kay,U.S. Senate,Connie Johnson,DEM,360534,3,3,139,145,
Kay,U.S. Senate,James Lankford,REP,360534,14,15,517,546,
Kay,U.S. Senate,Mark Beard,IND,360534,1,0,11,12,
Kay,U.S. House,Frankie Robbins,DEM,360534,3,3,140,146,03
Kay,U.S. House,Frank Lucas,REP,360534,15,15,528,558,03
Kay,Governor,Joe Dorman,DEM,360535,6,10,187,203,
Kay,Governor,Mary Fallin,REP,360535,24,16,434,474,
Kay,Governor,Kimberly Willis,IND,360535,0,0,4,4,
Kay,Governor,Richard Prawdzienski,IND,360535,0,0,3,3,
Kay,Lieutenant Governor,Cathy Cummings,DEM,360535,6,9,128,143,
Kay,Lieutenant Governor,Todd Lamb,REP,360535,24,17,495,536,
Kay,Superintendent of Public Instruction,John Cox,DEM,360535,9,11,200,220,
Kay,Superintendent of Public Instruction,Joy Hofmeister,REP,360535,21,15,423,459,
Kay,Commissioner of Labor,Mike Workman,DEM,360535,6,8,141,155,
Kay,Commissioner of Labor,Mark Costello,REP,360535,24,17,470,511,
Kay,U.S. Senate,Matt Silverstein,DEM,360535,6,8,112,126,
Kay,U.S. Senate,Jim Inhofe,REP,360535,24,17,491,532,
Kay,U.S. Senate,Aaron Delozier,IND,360535,0,0,3,3,
Kay,U.S. Senate,Ray Woods,IND,360535,0,0,5,5,
Kay,U.S. Senate,Joan Farr,IND,360535,0,1,4,5,
Kay,U.S. Senate,Connie Johnson,DEM,360535,6,9,114,129,
Kay,U.S. Senate,James Lankford,REP,360535,24,16,497,537,
Kay,U.S. Senate,Mark Beard,IND,360535,0,1,13,14,
Kay,U.S. House,Frankie Robbins,DEM,360535,6,7,110,123,03
Kay,U.S. House,Frank Lucas,REP,360535,24,18,514,556,03
Kingfisher,Governor,Joe Dorman,DEM,370101,6,20,127,153,
Kingfisher,Governor,Mary Fallin,REP,370101,12,49,467,528,
Kingfisher,Governor,Kimberly Willis,IND,370101,0,0,16,16,
Kingfisher,Governor,Richard Prawdzienski,IND,370101,0,0,6,6,
Kingfisher,Lieutenant Governor,Cathy Cummings,DEM,370101,5,11,77,93,
Kingfisher,Lieutenant Governor,Todd Lamb,REP,370101,13,58,540,611,
Kingfisher,Superintendent of Public Instruction,John Cox,DEM,370101,7,23,161,191,
Kingfisher,Superintendent of Public Instruction,Joy Hofmeister,REP,370101,10,46,456,512,
Kingfisher,Commissioner of Labor,Mike Workman,DEM,370101,8,14,119,141,
Kingfisher,Commissioner of Labor,Mark Costello,REP,370101,9,52,489,550,
Kingfisher,U.S. Senate,Matt Silverstein,DEM,370101,5,14,54,73,
Kingfisher,U.S. Senate,Jim Inhofe,REP,370101,13,54,547,614,
Kingfisher,U.S. Senate,Aaron Delozier,IND,370101,0,0,2,2,
Kingfisher,U.S. Senate,Ray Woods,IND,370101,0,0,5,5,
Kingfisher,U.S. Senate,Joan Farr,IND,370101,0,1,5,6,
Kingfisher,U.S. Senate,Connie Johnson,DEM,370101,5,12,63,80,
Kingfisher,U.S. Senate,James Lankford,REP,370101,13,57,545,615,
Kingfisher,U.S. Senate,Mark Beard,IND,370101,0,0,12,12,
Kingfisher,U.S. House,Frankie Robbins,DEM,370101,5,14,55,74,03
Kingfisher,U.S. House,Frank Lucas,REP,370101,13,55,565,633,03
Kingfisher,State Senate,Kevin Black,DEM,370101,7,8,80,95,26
Kingfisher,State Senate,Darcy Jech,REP,370101,11,60,539,610,26
Kingfisher,Governor,Joe Dorman,DEM,370102,1,4,29,34,
Kingfisher,Governor,Mary Fallin,REP,370102,1,11,112,124,
Kingfisher,Governor,Kimberly Willis,IND,370102,0,0,0,0,
Kingfisher,Governor,Richard Prawdzienski,IND,370102,0,0,2,2,
Kingfisher,Lieutenant Governor,Cathy Cummings,DEM,370102,1,3,14,18,
Kingfisher,Lieutenant Governor,Todd Lamb,REP,370102,1,10,130,141,
Kingfisher,Superintendent of Public Instruction,John Cox,DEM,370102,1,6,45,52,
Kingfisher,Superintendent of Public Instruction,Joy Hofmeister,REP,370102,1,8,96,105,
Kingfisher,Commissioner of Labor,Mike Workman,DEM,370102,1,4,24,29,
Kingfisher,Commissioner of Labor,Mark Costello,REP,370102,1,11,117,129,
Kingfisher,U.S. Senate,Matt Silverstein,DEM,370102,1,2,11,14,
Kingfisher,U.S. Senate,Jim Inhofe,REP,370102,1,13,129,143,
Kingfisher,U.S. Senate,Aaron Delozier,IND,370102,0,0,2,2,
Kingfisher,U.S. Senate,Ray Woods,IND,370102,0,0,0,0,
Kingfisher,U.S. Senate,Joan Farr,IND,370102,0,0,2,2,
Kingfisher,U.S. Senate,Connie Johnson,DEM,370102,1,0,9,10,
Kingfisher,U.S. Senate,James Lankford,REP,370102,1,15,133,149,
Kingfisher,U.S. Senate,Mark Beard,IND,370102,0,0,2,2,
Kingfisher,U.S. House,Frankie Robbins,DEM,370102,1,0,13,14,03
Kingfisher,U.S. House,Frank Lucas,REP,370102,1,15,130,146,03
Kingfisher,Governor,Joe Dorman,DEM,370103,0,6,37,43,
Kingfisher,Governor,Mary Fallin,REP,370103,4,18,159,181,
Kingfisher,Governor,Kimberly Willis,IND,370103,0,0,3,3,
Kingfisher,Governor,Richard Prawdzienski,IND,370103,0,0,2,2,
Kingfisher,Lieutenant Governor,Cathy Cummings,DEM,370103,0,5,17,22,
Kingfisher,Lieutenant Governor,Todd Lamb,REP,370103,4,19,184,207,
Kingfisher,Superintendent of Public Instruction,John Cox,DEM,370103,0,4,56,60,
Kingfisher,Superintendent of Public Instruction,Joy Hofmeister,REP,370103,4,19,143,166,
Kingfisher,Commissioner of Labor,Mike Workman,DEM,370103,0,5,26,31,
Kingfisher,Commissioner of Labor,Mark Costello,REP,370103,4,19,172,195,
Kingfisher,U.S. Senate,Matt Silverstein,DEM,370103,0,1,14,15,
Kingfisher,U.S. Senate,Jim Inhofe,REP,370103,3,23,183,209,
Kingfisher,U.S. Senate,Aaron Delozier,IND,370103,1,0,2,3,
Kingfisher,U.S. Senate,Ray Woods,IND,370103,0,0,0,0,
Kingfisher,U.S. Senate,Joan Farr,IND,370103,0,0,1,1,
Kingfisher,U.S. Senate,Connie Johnson,DEM,370103,0,2,13,15,
Kingfisher,U.S. Senate,James Lankford,REP,370103,4,21,183,208,
Kingfisher,U.S. Senate,Mark Beard,IND,370103,0,1,5,6,
Kingfisher,U.S. House,Frankie Robbins,DEM,370103,1,2,15,18,03
Kingfisher,U.S. House,Frank Lucas,REP,370103,3,22,186,211,03
Kingfisher,Governor,Joe Dorman,DEM,370105,0,2,78,80,
Kingfisher,Governor,Mary Fallin,REP,370105,2,4,213,219,
Kingfisher,Governor,Kimberly Willis,IND,370105,0,0,7,7,
Kingfisher,Governor,Richard Prawdzienski,IND,370105,0,1,3,4,
Kingfisher,Lieutenant Governor,Cathy Cummings,DEM,370105,0,1,52,53,
Kingfisher,Lieutenant Governor,Todd Lamb,REP,370105,2,6,247,255,
Kingfisher,Superintendent of Public Instruction,John Cox,DEM,370105,0,4,102,106,
Kingfisher,Superintendent of Public Instruction,Joy Hofmeister,REP,370105,2,3,195,200,
Kingfisher,Commissioner of Labor,Mike Workman,DEM,370105,0,2,75,77,
Kingfisher,Commissioner of Labor,Mark Costello,REP,370105,2,5,217,224,
Kingfisher,U.S. Senate,Matt Silverstein,DEM,370105,0,1,45,46,
Kingfisher,U.S. Senate,Jim Inhofe,REP,370105,2,6,243,251,
Kingfisher,U.S. Senate,Aaron Delozier,IND,370105,0,0,2,2,
Kingfisher,U.S. Senate,Ray Woods,IND,370105,0,0,3,3,
Kingfisher,U.S. Senate,Joan Farr,IND,370105,0,0,5,5,
Kingfisher,U.S. Senate,Connie Johnson,DEM,370105,0,1,47,48,
Kingfisher,U.S. Senate,James Lankford,REP,370105,2,6,239,247,
Kingfisher,U.S. Senate,Mark Beard,IND,370105,0,0,13,13,
Kingfisher,U.S. House,Frankie Robbins,DEM,370105,0,0,39,39,03
Kingfisher,U.S. House,Frank Lucas,REP,370105,2,7,258,267,03
Kingfisher,Governor,Joe Dorman,DEM,370106,1,0,6,7,
Kingfisher,Governor,Mary Fallin,REP,370106,2,2,54,58,
Kingfisher,Governor,Kimberly Willis,IND,370106,0,0,0,0,
Kingfisher,Governor,Richard Prawdzienski,IND,370106,0,0,0,0,
Kingfisher,Lieutenant Governor,Cathy Cummings,DEM,370106,1,0,5,6,
Kingfisher,Lieutenant Governor,Todd Lamb,REP,370106,2,2,55,59,
Kingfisher,Superintendent of Public Instruction,John Cox,DEM,370106,2,0,10,12,
Kingfisher,Superintendent of Public Instruction,Joy Hofmeister,REP,370106,1,2,50,53,
Kingfisher,Commissioner of Labor,Mike Workman,DEM,370106,1,0,7,8,
Kingfisher,Commissioner of Labor,Mark Costello,REP,370106,2,2,53,57,
Kingfisher,U.S. Senate,Matt Silverstein,DEM,370106,0,0,2,2,
Kingfisher,U.S. Senate,Jim Inhofe,REP,370106,3,2,58,63,
Kingfisher,U.S. Senate,Aaron Delozier,IND,370106,0,0,0,0,
Kingfisher,U.S. Senate,Ray Woods,IND,370106,0,0,0,0,
Kingfisher,U.S. Senate,Joan Farr,IND,370106,0,0,0,0,
Kingfisher,U.S. Senate,Connie Johnson,DEM,370106,1,0,3,4,
Kingfisher,U.S. Senate,James Lankford,REP,370106,2,2,57,61,
Kingfisher,U.S. Senate,Mark Beard,IND,370106,0,0,0,0,
Kingfisher,U.S. House,Frankie Robbins,DEM,370106,0,0,2,2,03
Kingfisher,U.S. House,Frank Lucas,REP,370106,3,2,58,63,03
Kingfisher,Governor,Joe Dorman,DEM,370201,3,3,196,202,
Kingfisher,Governor,Mary Fallin,REP,370201,4,6,421,431,
Kingfisher,Governor,Kimberly Willis,IND,370201,0,0,14,14,
Kingfisher,Governor,Richard Prawdzienski,IND,370201,0,0,9,9,
Kingfisher,Lieutenant Governor,Cathy Cummings,DEM,370201,3,2,83,88,
Kingfisher,Lieutenant Governor,Todd Lamb,REP,370201,4,7,556,567,
Kingfisher,Superintendent of Public Instruction,John Cox,DEM,370201,3,3,202,208,
Kingfisher,Superintendent of Public Instruction,Joy Hofmeister,REP,370201,4,5,435,444,
Kingfisher,Commissioner of Labor,Mike Workman,DEM,370201,2,3,128,133,
Kingfisher,Commissioner of Labor,Mark Costello,REP,370201,5,4,499,508,
Kingfisher,U.S. Senate,Matt Silverstein,DEM,370201,3,0,69,72,
Kingfisher,U.S. Senate,Jim Inhofe,REP,370201,4,9,552,565,
Kingfisher,U.S. Senate,Aaron Delozier,IND,370201,0,0,2,2,
Kingfisher,U.S. Senate,Ray Woods,IND,370201,0,0,10,10,
Kingfisher,U.S. Senate,Joan Farr,IND,370201,0,0,6,6,
Kingfisher,U.S. Senate,Connie Johnson,DEM,370201,3,0,71,74,
Kingfisher,U.S. Senate,James Lankford,REP,370201,4,9,555,568,
Kingfisher,U.S. Senate,Mark Beard,IND,370201,0,0,13,13,
Kingfisher,U.S. House,Frankie Robbins,DEM,370201,3,2,68,73,03
Kingfisher,U.S. House,Frank Lucas,REP,370201,3,7,568,578,03
Kingfisher,Governor,Joe Dorman,DEM,370203,0,1,24,25,
Kingfisher,Governor,Mary Fallin,REP,370203,12,0,54,66,
Kingfisher,Governor,Kimberly Willis,IND,370203,0,0,1,1,
Kingfisher,Governor,Richard Prawdzienski,IND,370203,0,0,2,2,
Kingfisher,Lieutenant Governor,Cathy Cummings,DEM,370203,0,1,14,15,
Kingfisher,Lieutenant Governor,Todd Lamb,REP,370203,12,0,66,78,
Kingfisher,Superintendent of Public Instruction,John Cox,DEM,370203,2,0,31,33,
Kingfisher,Superintendent of Public Instruction,Joy Hofmeister,REP,370203,10,1,48,59,
Kingfisher,Commissioner of Labor,Mike Workman,DEM,370203,1,1,11,13,
Kingfisher,Commissioner of Labor,Mark Costello,REP,370203,11,0,68,79,
Kingfisher,U.S. Senate,Matt Silverstein,DEM,370203,1,1,7,9,
Kingfisher,U.S. Senate,Jim Inhofe,REP,370203,11,0,74,85,
Kingfisher,U.S. Senate,Aaron Delozier,IND,370203,0,0,0,0,
Kingfisher,U.S. Senate,Ray Woods,IND,370203,0,0,0,0,
Kingfisher,U.S. Senate,Joan Farr,IND,370203,0,0,0,0,
Kingfisher,U.S. Senate,Connie Johnson,DEM,370203,0,1,10,11,
Kingfisher,U.S. Senate,James Lankford,REP,370203,12,0,71,83,
Kingfisher,U.S. Senate,Mark Beard,IND,370203,0,0,0,0,
Kingfisher,U.S. House,Frankie Robbins,DEM,370203,2,1,8,11,03
Kingfisher,U.S. House,Frank Lucas,REP,370203,10,0,73,83,03
Kingfisher,Governor,Joe Dorman,DEM,370204,0,3,62,65,
Kingfisher,Governor,Mary Fallin,REP,370204,1,6,125,132,
Kingfisher,Governor,Kimberly Willis,IND,370204,0,0,3,3,
Kingfisher,Governor,Richard Prawdzienski,IND,370204,0,0,1,1,
Kingfisher,Lieutenant Governor,Cathy Cummings,DEM,370204,0,2,33,35,
Kingfisher,Lieutenant Governor,Todd Lamb,REP,370204,1,7,157,165,
Kingfisher,Superintendent of Public Instruction,John Cox,DEM,370204,0,3,75,78,
Kingfisher,Superintendent of Public Instruction,Joy Hofmeister,REP,370204,1,6,115,122,
Kingfisher,Commissioner of Labor,Mike Workman,DEM,370204,0,1,54,55,
Kingfisher,Commissioner of Labor,Mark Costello,REP,370204,1,8,130,139,
Kingfisher,U.S. Senate,Matt Silverstein,DEM,370204,0,1,27,28,
Kingfisher,U.S. Senate,Jim Inhofe,REP,370204,1,8,160,169,
Kingfisher,U.S. Senate,Aaron Delozier,IND,370204,0,0,0,0,
Kingfisher,U.S. Senate,Ray Woods,IND,370204,0,0,0,0,
Kingfisher,U.S. Senate,Joan Farr,IND,370204,0,0,2,2,
Kingfisher,U.S. Senate,Connie Johnson,DEM,370204,0,1,31,32,
Kingfisher,U.S. Senate,James Lankford,REP,370204,1,8,150,159,
Kingfisher,U.S. Senate,Mark Beard,IND,370204,0,0,6,6,
Kingfisher,U.S. House,Frankie Robbins,DEM,370204,0,0,30,30,03
Kingfisher,U.S. House,Frank Lucas,REP,370204,1,9,157,167,03
Kingfisher,Governor,Joe Dorman,DEM,370301,2,20,185,207,
Kingfisher,Governor,Mary Fallin,REP,370301,14,40,430,484,
Kingfisher,Governor,Kimberly Willis,IND,370301,0,2,10,12,
Kingfisher,Governor,Richard Prawdzienski,IND,370301,0,0,4,4,
Kingfisher,Lieutenant Governor,Cathy Cummings,DEM,370301,1,15,97,113,
Kingfisher,Lieutenant Governor,Todd Lamb,REP,370301,15,47,533,595,
Kingfisher,Superintendent of Public Instruction,John Cox,DEM,370301,3,19,218,240,
Kingfisher,Superintendent of Public Instruction,Joy Hofmeister,REP,370301,13,42,410,465,
Kingfisher,Commissioner of Labor,Mike Workman,DEM,370301,0,15,153,168,
Kingfisher,Commissioner of Labor,Mark Costello,REP,370301,14,46,463,523,
Kingfisher,U.S. Senate,Matt Silverstein,DEM,370301,1,13,73,87,
Kingfisher,U.S. Senate,Jim Inhofe,REP,370301,15,47,536,598,
Kingfisher,U.S. Senate,Aaron Delozier,IND,370301,0,0,5,5,
Kingfisher,U.S. Senate,Ray Woods,IND,370301,0,1,12,13,
Kingfisher,U.S. Senate,Joan Farr,IND,370301,0,0,4,4,
Kingfisher,U.S. Senate,Connie Johnson,DEM,370301,0,17,86,103,
Kingfisher,U.S. Senate,James Lankford,REP,370301,16,44,526,586,
Kingfisher,U.S. Senate,Mark Beard,IND,370301,0,1,16,17,
Kingfisher,U.S. House,Frankie Robbins,DEM,370301,0,13,83,96,03
Kingfisher,U.S. House,Frank Lucas,REP,370301,16,49,547,612,03
Kingfisher,State Senate,Kevin Black,DEM,370301,0,17,90,107,26
Kingfisher,State Senate,Darcy Jech,REP,370301,16,45,540,601,26
Kingfisher,Governor,Joe Dorman,DEM,370302,1,1,77,79,
Kingfisher,Governor,Mary Fallin,REP,370302,5,3,179,187,
Kingfisher,Governor,Kimberly Willis,IND,370302,0,0,2,2,
Kingfisher,Governor,Richard Prawdzienski,IND,370302,0,0,2,2,
Kingfisher,Lieutenant Governor,Cathy Cummings,DEM,370302,0,1,43,44,
Kingfisher,Lieutenant Governor,Todd Lamb,REP,370302,6,3,217,226,
Kingfisher,Superintendent of Public Instruction,John Cox,DEM,370302,1,3,105,109,
Kingfisher,Superintendent of Public Instruction,Joy Hofmeister,REP,370302,5,1,155,161,
Kingfisher,Commissioner of Labor,Mike Workman,DEM,370302,0,1,60,61,
Kingfisher,Commissioner of Labor,Mark Costello,REP,370302,5,3,195,203,
Kingfisher,U.S. Senate,Matt Silverstein,DEM,370302,1,1,27,29,
Kingfisher,U.S. Senate,Jim Inhofe,REP,370302,5,3,223,231,
Kingfisher,U.S. Senate,Aaron Delozier,IND,370302,0,0,3,3,
Kingfisher,U.S. Senate,Ray Woods,IND,370302,0,0,2,2,
Kingfisher,U.S. Senate,Joan Farr,IND,370302,0,0,3,3,
Kingfisher,U.S. Senate,Connie Johnson,DEM,370302,1,1,36,38,
Kingfisher,U.S. Senate,James Lankford,REP,370302,5,3,217,225,
Kingfisher,U.S. Senate,Mark Beard,IND,370302,0,0,6,6,
Kingfisher,U.S. House,Frankie Robbins,DEM,370302,0,1,29,30,03
Kingfisher,U.S. House,Frank Lucas,REP,370302,6,3,231,240,03
Kingfisher,Governor,Joe Dorman,DEM,370303,0,1,12,13,
Kingfisher,Governor,Mary Fallin,REP,370303,0,10,44,54,
Kingfisher,Governor,Kimberly Willis,IND,370303,0,0,1,1,
Kingfisher,Governor,Richard Prawdzienski,IND,370303,0,0,2,2,
Kingfisher,Lieutenant Governor,Cathy Cummings,DEM,370303,0,0,4,4,
Kingfisher,Lieutenant Governor,Todd Lamb,REP,370303,0,11,55,66,
Kingfisher,Superintendent of Public Instruction,John Cox,DEM,370303,0,1,6,7,
Kingfisher,Superintendent of Public Instruction,Joy Hofmeister,REP,370303,0,10,53,63,
Kingfisher,Commissioner of Labor,Mike Workman,DEM,370303,0,1,7,8,
Kingfisher,Commissioner of Labor,Mark Costello,REP,370303,0,9,51,60,
Kingfisher,U.S. Senate,Matt Silverstein,DEM,370303,0,0,2,2,
Kingfisher,U.S. Senate,Jim Inhofe,REP,370303,0,11,55,66,
Kingfisher,U.S. Senate,Aaron Delozier,IND,370303,0,0,1,1,
Kingfisher,U.S. Senate,Ray Woods,IND,370303,0,0,1,1,
Kingfisher,U.S. Senate,Joan Farr,IND,370303,0,0,0,0,
Kingfisher,U.S. Senate,Connie Johnson,DEM,370303,0,0,1,1,
Kingfisher,U.S. Senate,James Lankford,REP,370303,0,11,55,66,
Kingfisher,U.S. Senate,Mark Beard,IND,370303,0,0,2,2,
Kingfisher,U.S. House,Frankie Robbins,DEM,370303,0,1,5,6,03
Kingfisher,U.S. House,Frank Lucas,REP,370303,0,10,54,64,03
Kingfisher,State Senate,Kevin Black,DEM,370303,0,0,6,6,26
Kingfisher,State Senate,Darcy Jech,REP,370303,0,11,53,64,26
Kingfisher,Governor,Joe Dorman,DEM,370304,1,0,19,20,
Kingfisher,Governor,Mary Fallin,REP,370304,2,7,83,92,
Kingfisher,Governor,Kimberly Willis,IND,370304,0,0,1,1,
Kingfisher,Governor,Richard Prawdzienski,IND,370304,0,0,1,1,
Kingfisher,Lieutenant Governor,Cathy Cummings,DEM,370304,0,0,15,15,
Kingfisher,Lieutenant Governor,Todd Lamb,REP,370304,3,7,90,100,
Kingfisher,Superintendent of Public Instruction,John Cox,DEM,370304,0,1,35,36,
Kingfisher,Superintendent of Public Instruction,Joy Hofmeister,REP,370304,3,6,70,79,
Kingfisher,Commissioner of Labor,Mike Workman,DEM,370304,0,0,23,23,
Kingfisher,Commissioner of Labor,Mark Costello,REP,370304,3,7,81,91,
Kingfisher,U.S. Senate,Matt Silverstein,DEM,370304,0,0,10,10,
Kingfisher,U.S. Senate,Jim Inhofe,REP,370304,3,7,95,105,
Kingfisher,U.S. Senate,Aaron Delozier,IND,370304,0,0,0,0,
Kingfisher,U.S. Senate,Ray Woods,IND,370304,0,0,0,0,
Kingfisher,U.S. Senate,Joan Farr,IND,370304,0,0,0,0,
Kingfisher,U.S. Senate,Connie Johnson,DEM,370304,0,0,14,14,
Kingfisher,U.S. Senate,James Lankford,REP,370304,3,7,89,99,
Kingfisher,U.S. Senate,Mark Beard,IND,370304,0,0,2,2,
Kingfisher,U.S. House,Frankie Robbins,DEM,370304,0,0,10,10,03
Kingfisher,U.S. House,Frank Lucas,REP,370304,3,7,95,105,03
Kingfisher,Governor,Joe Dorman,DEM,370305,1,4,14,19,
Kingfisher,Governor,Mary Fallin,REP,370305,6,6,85,97,
Kingfisher,Governor,Kimberly Willis,IND,370305,0,0,1,1,
Kingfisher,Governor,Richard Prawdzienski,IND,370305,0,0,0,0,
Kingfisher,Lieutenant Governor,Cathy Cummings,DEM,370305,0,2,4,6,
Kingfisher,Lieutenant Governor,Todd Lamb,REP,370305,7,8,96,111,
Kingfisher,Superintendent of Public Instruction,John Cox,DEM,370305,2,5,27,34,
Kingfisher,Superintendent of Public Instruction,Joy Hofmeister,REP,370305,5,5,72,82,
Kingfisher,Commissioner of Labor,Mike Workman,DEM,370305,0,3,14,17,
Kingfisher,Commissioner of Labor,Mark Costello,REP,370305,7,7,86,100,
Kingfisher,U.S. Senate,Matt Silverstein,DEM,370305,1,0,4,5,
Kingfisher,U.S. Senate,Jim Inhofe,REP,370305,6,10,95,111,
Kingfisher,U.S. Senate,Aaron Delozier,IND,370305,0,0,0,0,
Kingfisher,U.S. Senate,Ray Woods,IND,370305,0,0,1,1,
Kingfisher,U.S. Senate,Joan Farr,IND,370305,0,0,0,0,
Kingfisher,U.S. Senate,Connie Johnson,DEM,370305,1,1,5,7,
Kingfisher,U.S. Senate,James Lankford,REP,370305,6,9,93,108,
Kingfisher,U.S. Senate,Mark Beard,IND,370305,0,0,2,2,
Kingfisher,U.S. House,Frankie Robbins,DEM,370305,0,0,3,3,03
Kingfisher,U.S. House,Frank Lucas,REP,370305,7,10,97,114,03
Kingfisher,Governor,Joe Dorman,DEM,370306,0,0,1,1,
Kingfisher,Governor,Mary Fallin,REP,370306,0,2,7,9,
Kingfisher,Governor,Kimberly Willis,IND,370306,0,0,0,0,
Kingfisher,Governor,Richard Prawdzienski,IND,370306,0,0,0,0,
Kingfisher,Lieutenant Governor,Cathy Cummings,DEM,370306,0,0,1,1,
Kingfisher,Lieutenant Governor,Todd Lamb,REP,370306,0,2,7,9,
Kingfisher,Superintendent of Public Instruction,John Cox,DEM,370306,0,0,4,4,
Kingfisher,Superintendent of Public Instruction,Joy Hofmeister,REP,370306,0,2,4,6,
Kingfisher,Commissioner of Labor,Mike Workman,DEM,370306,0,0,2,2,
Kingfisher,Commissioner of Labor,Mark Costello,REP,370306,0,2,6,8,
Kingfisher,U.S. Senate,Matt Silverstein,DEM,370306,0,0,0,0,
Kingfisher,U.S. Senate,Jim Inhofe,REP,370306,0,2,8,10,
Kingfisher,U.S. Senate,Aaron Delozier,IND,370306,0,0,0,0,
Kingfisher,U.S. Senate,Ray Woods,IND,370306,0,0,0,0,
Kingfisher,U.S. Senate,Joan Farr,IND,370306,0,0,0,0,
Kingfisher,U.S. Senate,Connie Johnson,DEM,370306,0,0,2,2,
Kingfisher,U.S. Senate,James Lankford,REP,370306,0,2,6,8,
Kingfisher,U.S. Senate,Mark Beard,IND,370306,0,0,0,0,
Kingfisher,U.S. House,Frankie Robbins,DEM,370306,0,0,1,1,03
Kingfisher,U.S. House,Frank Lucas,REP,370306,0,2,6,8,03
Kiowa,Governor,Joe Dorman,DEM,380001,13,22,177,212,
Kiowa,Governor,Mary Fallin,REP,380001,4,30,262,296,
Kiowa,Governor,Kimberly Willis,IND,380001,0,0,10,10,
Kiowa,Governor,Richard Prawdzienski,IND,380001,0,1,2,3,
Kiowa,Lieutenant Governor,Cathy Cummings,DEM,380001,12,13,103,128,
Kiowa,Lieutenant Governor,Todd Lamb,REP,380001,5,41,343,389,
Kiowa,Superintendent of Public Instruction,John Cox,DEM,380001,13,18,166,197,
Kiowa,Superintendent of Public Instruction,Joy Hofmeister,REP,380001,4,34,280,318,
Kiowa,Commissioner of Labor,Mike Workman,DEM,380001,10,20,151,181,
Kiowa,Commissioner of Labor,Mark Costello,REP,380001,5,30,276,311,
Kiowa,U.S. Senate,Matt Silverstein,DEM,380001,11,9,70,90,
Kiowa,U.S. Senate,Jim Inhofe,REP,380001,6,44,369,419,
Kiowa,U.S. Senate,Aaron Delozier,IND,380001,0,1,3,4,
Kiowa,U.S. Senate,Ray Woods,IND,380001,0,0,6,6,
Kiowa,U.S. Senate,Joan Farr,IND,380001,0,0,1,1,
Kiowa,U.S. Senate,Connie Johnson,DEM,380001,10,9,69,88,
Kiowa,U.S. Senate,James Lankford,REP,380001,6,42,371,419,
Kiowa,U.S. Senate,Mark Beard,IND,380001,0,2,8,10,
Kiowa,U.S. House,Frankie Robbins,DEM,380001,10,8,63,81,03
Kiowa,U.S. House,Frank Lucas,REP,380001,6,46,386,438,03
Kiowa,Governor,Joe Dorman,DEM,380002,0,3,45,48,
Kiowa,Governor,Mary Fallin,REP,380002,0,4,58,62,
Kiowa,Governor,Kimberly Willis,IND,380002,0,0,2,2,
Kiowa,Governor,Richard Prawdzienski,IND,380002,0,0,0,0,
Kiowa,Lieutenant Governor,Cathy Cummings,DEM,380002,0,2,20,22,
Kiowa,Lieutenant Governor,Todd Lamb,REP,380002,0,5,84,89,
Kiowa,Superintendent of Public Instruction,John Cox,DEM,380002,0,2,51,53,
Kiowa,Superintendent of Public Instruction,Joy Hofmeister,REP,380002,0,5,53,58,
Kiowa,Commissioner of Labor,Mike Workman,DEM,380002,0,2,37,39,
Kiowa,Commissioner of Labor,Mark Costello,REP,380002,0,4,64,68,
Kiowa,U.S. Senate,Matt Silverstein,DEM,380002,0,1,16,17,
Kiowa,U.S. Senate,Jim Inhofe,REP,380002,0,6,86,92,
Kiowa,U.S. Senate,Aaron Delozier,IND,380002,0,0,1,1,
Kiowa,U.S. Senate,Ray Woods,IND,380002,0,0,1,1,
Kiowa,U.S. Senate,Joan Farr,IND,380002,0,0,1,1,
Kiowa,U.S. Senate,Connie Johnson,DEM,380002,0,1,18,19,
Kiowa,U.S. Senate,James Lankford,REP,380002,0,6,86,92,
Kiowa,U.S. Senate,Mark Beard,IND,380002,0,0,1,1,
Kiowa,U.S. House,Frankie Robbins,DEM,380002,0,1,14,15,03
Kiowa,U.S. House,Frank Lucas,REP,380002,0,6,91,97,03
Kiowa,Governor,Joe Dorman,DEM,380004,5,22,137,164,
Kiowa,Governor,Mary Fallin,REP,380004,3,25,165,193,
Kiowa,Governor,Kimberly Willis,IND,380004,0,0,5,5,
Kiowa,Governor,Richard Prawdzienski,IND,380004,0,0,5,5,
Kiowa,Lieutenant Governor,Cathy Cummings,DEM,380004,5,9,61,75,
Kiowa,Lieutenant Governor,Todd Lamb,REP,380004,3,37,248,288,
Kiowa,Superintendent of Public Instruction,John Cox,DEM,380004,6,19,119,144,
Kiowa,Superintendent of Public Instruction,Joy Hofmeister,REP,380004,2,28,190,220,
Kiowa,Commissioner of Labor,Mike Workman,DEM,380004,5,16,117,138,
Kiowa,Commissioner of Labor,Mark Costello,REP,380004,3,23,180,206,
Kiowa,U.S. Senate,Matt Silverstein,DEM,380004,4,9,65,78,
Kiowa,U.S. Senate,Jim Inhofe,REP,380004,4,36,239,279,
Kiowa,U.S. Senate,Aaron Delozier,IND,380004,0,0,0,0,
Kiowa,U.S. Senate,Ray Woods,IND,380004,0,0,1,1,
Kiowa,U.S. Senate,Joan Farr,IND,380004,0,0,2,2,
Kiowa,U.S. Senate,Connie Johnson,DEM,380004,5,13,65,83,
Kiowa,U.S. Senate,James Lankford,REP,380004,3,33,240,276,
Kiowa,U.S. Senate,Mark Beard,IND,380004,0,0,6,6,
Kiowa,U.S. House,Frankie Robbins,DEM,380004,4,9,53,66,03
Kiowa,U.S. House,Frank Lucas,REP,380004,4,38,258,300,03
Kiowa,Governor,Joe Dorman,DEM,380005,0,2,13,15,
Kiowa,Governor,Mary Fallin,REP,380005,0,0,10,10,
Kiowa,Governor,Kimberly Willis,IND,380005,0,0,2,2,
Kiowa,Governor,Richard Prawdzienski,IND,380005,0,0,1,1,
Kiowa,Lieutenant Governor,Cathy Cummings,DEM,380005,0,1,10,11,
Kiowa,Lieutenant Governor,Todd Lamb,REP,380005,0,1,15,16,
Kiowa,Superintendent of Public Instruction,John Cox,DEM,380005,0,2,12,14,
Kiowa,Superintendent of Public Instruction,Joy Hofmeister,REP,380005,0,0,14,14,
Kiowa,Commissioner of Labor,Mike Workman,DEM,380005,0,1,14,15,
Kiowa,Commissioner of Labor,Mark Costello,REP,380005,0,1,11,12,
Kiowa,U.S. Senate,Matt Silverstein,DEM,380005,0,2,8,10,
Kiowa,U.S. Senate,Jim Inhofe,REP,380005,0,0,15,15,
Kiowa,U.S. Senate,Aaron Delozier,IND,380005,0,0,1,1,
Kiowa,U.S. Senate,Ray Woods,IND,380005,0,0,0,0,
Kiowa,U.S. Senate,Joan Farr,IND,380005,0,0,2,2,
Kiowa,U.S. Senate,Connie Johnson,DEM,380005,0,1,6,7,
Kiowa,U.S. Senate,James Lankford,REP,380005,0,1,19,20,
Kiowa,U.S. Senate,Mark Beard,IND,380005,0,0,1,1,
Kiowa,U.S. House,Frankie Robbins,DEM,380005,0,1,11,12,03
Kiowa,U.S. House,Frank Lucas,REP,380005,0,1,15,16,03
Kiowa,Governor,Joe Dorman,DEM,380006,2,3,53,58,
Kiowa,Governor,Mary Fallin,REP,380006,2,2,54,58,
Kiowa,Governor,Kimberly Willis,IND,380006,0,0,2,2,
Kiowa,Governor,Richard Prawdzienski,IND,380006,0,0,0,0,
Kiowa,Lieutenant Governor,Cathy Cummings,DEM,380006,2,1,40,43,
Kiowa,Lieutenant Governor,Todd Lamb,REP,380006,2,4,70,76,
Kiowa,Superintendent of Public Instruction,John Cox,DEM,380006,2,1,61,64,
Kiowa,Superintendent of Public Instruction,Joy Hofmeister,REP,380006,2,4,49,55,
Kiowa,Commissioner of Labor,Mike Workman,DEM,380006,2,0,54,56,
Kiowa,Commissioner of Labor,Mark Costello,REP,380006,2,4,53,59,
Kiowa,U.S. Senate,Matt Silverstein,DEM,380006,2,0,28,30,
Kiowa,U.S. Senate,Jim Inhofe,REP,380006,2,5,78,85,
Kiowa,U.S. Senate,Aaron Delozier,IND,380006,0,0,0,0,
Kiowa,U.S. Senate,Ray Woods,IND,380006,0,0,1,1,
Kiowa,U.S. Senate,Joan Farr,IND,380006,0,0,3,3,
Kiowa,U.S. Senate,Connie Johnson,DEM,380006,2,0,39,41,
Kiowa,U.S. Senate,James Lankford,REP,380006,2,5,69,76,
Kiowa,U.S. Senate,Mark Beard,IND,380006,0,0,2,2,
Kiowa,U.S. House,Frankie Robbins,DEM,380006,2,0,28,30,03
Kiowa,U.S. House,Frank Lucas,REP,380006,2,5,81,88,03
Kiowa,State House,David Perryman,DEM,380006,2,4,71,77,56
Kiowa,State House,Chuck Utsler,REP,380006,2,1,38,41,56
Kiowa,Governor,Joe Dorman,DEM,380007,0,0,1,1,
Kiowa,Governor,Mary Fallin,REP,380007,0,0,2,2,
Kiowa,Governor,Kimberly Willis,IND,380007,0,0,0,0,
Kiowa,Governor,Richard Prawdzienski,IND,380007,0,0,0,0,
Kiowa,Lieutenant Governor,Cathy Cummings,DEM,380007,0,0,0,0,
Kiowa,Lieutenant Governor,Todd Lamb,REP,380007,0,0,3,3,
Kiowa,Superintendent of Public Instruction,John Cox,DEM,380007,0,0,0,0,
Kiowa,Superintendent of Public Instruction,Joy Hofmeister,REP,380007,0,0,3,3,
Kiowa,Commissioner of Labor,Mike Workman,DEM,380007,0,0,1,1,
Kiowa,Commissioner of Labor,Mark Costello,REP,380007,0,0,2,2,
Kiowa,U.S. Senate,Matt Silverstein,DEM,380007,0,0,0,0,
Kiowa,U.S. Senate,Jim Inhofe,REP,380007,0,0,3,3,
Kiowa,U.S. Senate,Aaron Delozier,IND,380007,0,0,0,0,
Kiowa,U.S. Senate,Ray Woods,IND,380007,0,0,0,0,
Kiowa,U.S. Senate,Joan Farr,IND,380007,0,0,0,0,
Kiowa,U.S. Senate,Connie Johnson,DEM,380007,0,0,0,0,
Kiowa,U.S. Senate,James Lankford,REP,380007,0,0,3,3,
Kiowa,U.S. Senate,Mark Beard,IND,380007,0,0,0,0,
Kiowa,U.S. House,Frankie Robbins,DEM,380007,0,0,0,0,03
Kiowa,U.S. House,Frank Lucas,REP,380007,0,0,3,3,03
Kiowa,State House,David Perryman,DEM,380007,0,0,1,1,56
Kiowa,State House,Chuck Utsler,REP,380007,0,0,2,2,56
Kiowa,Governor,Joe Dorman,DEM,380008,0,2,52,54,
Kiowa,Governor,Mary Fallin,REP,380008,2,7,92,101,
Kiowa,Governor,Kimberly Willis,IND,380008,0,0,3,3,
Kiowa,Governor,Richard Prawdzienski,IND,380008,0,0,2,2,
Kiowa,Lieutenant Governor,Cathy Cummings,DEM,380008,0,1,34,35,
Kiowa,Lieutenant Governor,Todd Lamb,REP,380008,2,8,115,125,
Kiowa,Superintendent of Public Instruction,John Cox,DEM,380008,0,3,70,73,
Kiowa,Superintendent of Public Instruction,Joy Hofmeister,REP,380008,2,6,79,87,
Kiowa,Commissioner of Labor,Mike Workman,DEM,380008,0,2,59,61,
Kiowa,Commissioner of Labor,Mark Costello,REP,380008,2,7,86,95,
Kiowa,U.S. Senate,Matt Silverstein,DEM,380008,0,2,31,33,
Kiowa,U.S. Senate,Jim Inhofe,REP,380008,1,7,114,122,
Kiowa,U.S. Senate,Aaron Delozier,IND,380008,1,0,2,3,
Kiowa,U.S. Senate,Ray Woods,IND,380008,0,0,1,1,
Kiowa,U.S. Senate,Joan Farr,IND,380008,0,0,1,1,
Kiowa,U.S. Senate,Connie Johnson,DEM,380008,0,1,32,33,
Kiowa,U.S. Senate,James Lankford,REP,380008,1,8,113,122,
Kiowa,U.S. Senate,Mark Beard,IND,380008,1,0,4,5,
Kiowa,U.S. House,Frankie Robbins,DEM,380008,0,0,27,27,03
Kiowa,U.S. House,Frank Lucas,REP,380008,2,9,122,133,03
Kiowa,Governor,Joe Dorman,DEM,380009,0,4,8,12,
Kiowa,Governor,Mary Fallin,REP,380009,0,0,14,14,
Kiowa,Governor,Kimberly Willis,IND,380009,0,0,0,0,
Kiowa,Governor,Richard Prawdzienski,IND,380009,0,0,0,0,
Kiowa,Lieutenant Governor,Cathy Cummings,DEM,380009,0,2,3,5,
Kiowa,Lieutenant Governor,Todd Lamb,REP,380009,0,2,19,21,
Kiowa,Superintendent of Public Instruction,John Cox,DEM,380009,0,4,9,13,
Kiowa,Superintendent of Public Instruction,Joy Hofmeister,REP,380009,0,0,13,13,
Kiowa,Commissioner of Labor,Mike Workman,DEM,380009,0,2,8,10,
Kiowa,Commissioner of Labor,Mark Costello,REP,380009,0,2,13,15,
Kiowa,U.S. Senate,Matt Silverstein,DEM,380009,0,2,3,5,
Kiowa,U.S. Senate,Jim Inhofe,REP,380009,0,2,19,21,
Kiowa,U.S. Senate,Aaron Delozier,IND,380009,0,0,0,0,
Kiowa,U.S. Senate,Ray Woods,IND,380009,0,0,0,0,
Kiowa,U.S. Senate,Joan Farr,IND,380009,0,0,0,0,
Kiowa,U.S. Senate,Connie Johnson,DEM,380009,0,4,3,7,
Kiowa,U.S. Senate,James Lankford,REP,380009,0,0,19,19,
Kiowa,U.S. Senate,Mark Beard,IND,380009,0,0,0,0,
Kiowa,U.S. House,Frankie Robbins,DEM,380009,0,0,2,2,03
Kiowa,U.S. House,Frank Lucas,REP,380009,0,4,20,24,03
Kiowa,State House,David Perryman,DEM,380009,0,3,12,15,56
Kiowa,State House,Chuck Utsler,REP,380009,0,1,10,11,56
Kiowa,Governor,Joe Dorman,DEM,380010,4,3,189,196,
Kiowa,Governor,Mary Fallin,REP,380010,7,5,153,165,
Kiowa,Governor,Kimberly Willis,IND,380010,0,0,4,4,
Kiowa,Governor,Richard Prawdzienski,IND,380010,0,0,4,4,
Kiowa,Lieutenant Governor,Cathy Cummings,DEM,380010,4,3,108,115,
Kiowa,Lieutenant Governor,Todd Lamb,REP,380010,7,5,239,251,
Kiowa,Superintendent of Public Instruction,John Cox,DEM,380010,5,5,182,192,
Kiowa,Superintendent of Public Instruction,Joy Hofmeister,REP,380010,6,3,161,170,
Kiowa,Commissioner of Labor,Mike Workman,DEM,380010,4,3,154,161,
Kiowa,Commissioner of Labor,Mark Costello,REP,380010,7,5,176,188,
Kiowa,U.S. Senate,Matt Silverstein,DEM,380010,3,3,85,91,
Kiowa,U.S. Senate,Jim Inhofe,REP,380010,8,5,255,268,
Kiowa,U.S. Senate,Aaron Delozier,IND,380010,0,0,3,3,
Kiowa,U.S. Senate,Ray Woods,IND,380010,0,0,2,2,
Kiowa,U.S. Senate,Joan Farr,IND,380010,0,0,4,4,
Kiowa,U.S. Senate,Connie Johnson,DEM,380010,5,2,96,103,
Kiowa,U.S. Senate,James Lankford,REP,380010,5,6,244,255,
Kiowa,U.S. Senate,Mark Beard,IND,380010,0,0,8,8,
Kiowa,U.S. House,Frankie Robbins,DEM,380010,3,2,76,81,03
Kiowa,U.S. House,Frank Lucas,REP,380010,7,6,270,283,03
Kiowa,State House,David Perryman,DEM,380010,7,7,229,243,56
Kiowa,State House,Chuck Utsler,REP,380010,4,1,117,122,56
Kiowa,Governor,Joe Dorman,DEM,380011,0,4,12,16,
Kiowa,Governor,Mary Fallin,REP,380011,0,4,47,51,
Kiowa,Governor,Kimberly Willis,IND,380011,0,0,1,1,
Kiowa,Governor,Richard Prawdzienski,IND,380011,0,0,2,2,
Kiowa,Lieutenant Governor,Cathy Cummings,DEM,380011,0,4,8,12,
Kiowa,Lieutenant Governor,Todd Lamb,REP,380011,0,4,54,58,
Kiowa,Superintendent of Public Instruction,John Cox,DEM,380011,0,4,18,22,
Kiowa,Superintendent of Public Instruction,Joy Hofmeister,REP,380011,0,4,44,48,
Kiowa,Commissioner of Labor,Mike Workman,DEM,380011,0,4,15,19,
Kiowa,Commissioner of Labor,Mark Costello,REP,380011,0,4,47,51,
Kiowa,U.S. Senate,Matt Silverstein,DEM,380011,0,4,7,11,
Kiowa,U.S. Senate,Jim Inhofe,REP,380011,0,4,55,59,
Kiowa,U.S. Senate,Aaron Delozier,IND,380011,0,0,0,0,
Kiowa,U.S. Senate,Ray Woods,IND,380011,0,0,0,0,
Kiowa,U.S. Senate,Joan Farr,IND,380011,0,0,0,0,
Kiowa,U.S. Senate,Connie Johnson,DEM,380011,0,4,5,9,
Kiowa,U.S. Senate,James Lankford,REP,380011,0,4,57,61,
Kiowa,U.S. Senate,Mark Beard,IND,380011,0,0,0,0,
Kiowa,U.S. House,Frankie Robbins,DEM,380011,0,4,8,12,03
Kiowa,U.S. House,Frank Lucas,REP,380011,0,4,54,58,03
Kiowa,Governor,Joe Dorman,DEM,380014,4,0,183,187,
Kiowa,Governor,Mary Fallin,REP,380014,3,1,177,181,
Kiowa,Governor,Kimberly Willis,IND,380014,0,0,4,4,
Kiowa,Governor,Richard Prawdzienski,IND,380014,0,0,2,2,
Kiowa,Lieutenant Governor,Cathy Cummings,DEM,380014,3,0,127,130,
Kiowa,Lieutenant Governor,Todd Lamb,REP,380014,4,1,238,243,
Kiowa,Superintendent of Public Instruction,John Cox,DEM,380014,4,0,197,201,
Kiowa,Superintendent of Public Instruction,Joy Hofmeister,REP,380014,3,1,167,171,
Kiowa,Commissioner of Labor,Mike Workman,DEM,380014,3,0,172,175,
Kiowa,Commissioner of Labor,Mark Costello,REP,380014,3,1,186,190,
Kiowa,U.S. Senate,Matt Silverstein,DEM,380014,3,0,106,109,
Kiowa,U.S. Senate,Jim Inhofe,REP,380014,4,1,249,254,
Kiowa,U.S. Senate,Aaron Delozier,IND,380014,0,0,4,4,
Kiowa,U.S. Senate,Ray Woods,IND,380014,0,0,3,3,
Kiowa,U.S. Senate,Joan Farr,IND,380014,0,0,4,4,
Kiowa,U.S. Senate,Connie Johnson,DEM,380014,3,0,113,116,
Kiowa,U.S. Senate,James Lankford,REP,380014,4,1,238,243,
Kiowa,U.S. Senate,Mark Beard,IND,380014,0,0,13,13,
Kiowa,U.S. House,Frankie Robbins,DEM,380014,3,0,108,111,03
Kiowa,U.S. House,Frank Lucas,REP,380014,4,1,258,263,03
Kiowa,Governor,Joe Dorman,DEM,380015,5,3,44,52,
Kiowa,Governor,Mary Fallin,REP,380015,0,5,47,52,
Kiowa,Governor,Kimberly Willis,IND,380015,0,0,4,4,
Kiowa,Governor,Richard Prawdzienski,IND,380015,0,0,2,2,
Kiowa,Lieutenant Governor,Cathy Cummings,DEM,380015,2,0,25,27,
Kiowa,Lieutenant Governor,Todd Lamb,REP,380015,4,8,71,83,
Kiowa,Superintendent of Public Instruction,John Cox,DEM,380015,2,4,49,55,
Kiowa,Superintendent of Public Instruction,Joy Hofmeister,REP,380015,3,4,48,55,
Kiowa,Commissioner of Labor,Mike Workman,DEM,380015,2,1,42,45,
Kiowa,Commissioner of Labor,Mark Costello,REP,380015,4,7,50,61,
Kiowa,U.S. Senate,Matt Silverstein,DEM,380015,2,1,20,23,
Kiowa,U.S. Senate,Jim Inhofe,REP,380015,4,7,73,84,
Kiowa,U.S. Senate,Aaron Delozier,IND,380015,0,0,2,2,
Kiowa,U.S. Senate,Ray Woods,IND,380015,0,0,1,1,
Kiowa,U.S. Senate,Joan Farr,IND,380015,0,0,0,0,
Kiowa,U.S. Senate,Connie Johnson,DEM,380015,2,0,17,19,
Kiowa,U.S. Senate,James Lankford,REP,380015,4,7,75,86,
Kiowa,U.S. Senate,Mark Beard,IND,380015,0,0,2,2,
Kiowa,U.S. House,Frankie Robbins,DEM,380015,2,0,14,16,03
Kiowa,U.S. House,Frank Lucas,REP,380015,4,8,81,93,03
Kiowa,State House,David Perryman,DEM,380015,5,7,66,78,56
Kiowa,State House,Chuck Utsler,REP,380015,1,1,27,29,56
Kiowa,Governor,Joe Dorman,DEM,380016,3,0,19,22,
Kiowa,Governor,Mary Fallin,REP,380016,3,0,41,44,
Kiowa,Governor,Kimberly Willis,IND,380016,0,0,1,1,
Kiowa,Governor,Richard Prawdzienski,IND,380016,0,0,0,0,
Kiowa,Lieutenant Governor,Cathy Cummings,DEM,380016,3,0,12,15,
Kiowa,Lieutenant Governor,Todd Lamb,REP,380016,3,0,49,52,
Kiowa,Superintendent of Public Instruction,John Cox,DEM,380016,5,0,28,33,
Kiowa,Superintendent of Public Instruction,Joy Hofmeister,REP,380016,1,0,30,31,
Kiowa,Commissioner of Labor,Mike Workman,DEM,380016,3,0,20,23,
Kiowa,Commissioner of Labor,Mark Costello,REP,380016,2,0,37,39,
Kiowa,U.S. Senate,Matt Silverstein,DEM,380016,2,0,12,14,
Kiowa,U.S. Senate,Jim Inhofe,REP,380016,3,0,49,52,
Kiowa,U.S. Senate,Aaron Delozier,IND,380016,0,0,0,0,
Kiowa,U.S. Senate,Ray Woods,IND,380016,0,0,0,0,
Kiowa,U.S. Senate,Joan Farr,IND,380016,0,0,0,0,
Kiowa,U.S. Senate,Connie Johnson,DEM,380016,3,0,12,15,
Kiowa,U.S. Senate,James Lankford,REP,380016,3,0,48,51,
Kiowa,U.S. Senate,Mark Beard,IND,380016,0,0,1,1,
Kiowa,U.S. House,Frankie Robbins,DEM,380016,1,0,10,11,03
Kiowa,U.S. House,Frank Lucas,REP,380016,5,0,51,56,03
Kiowa,Governor,Joe Dorman,DEM,380022,2,0,51,53,
Kiowa,Governor,Mary Fallin,REP,380022,4,1,71,76,
Kiowa,Governor,Kimberly Willis,IND,380022,0,0,2,2,
Kiowa,Governor,Richard Prawdzienski,IND,380022,0,0,2,2,
Kiowa,Lieutenant Governor,Cathy Cummings,DEM,380022,1,0,33,34,
Kiowa,Lieutenant Governor,Todd Lamb,REP,380022,5,1,91,97,
Kiowa,Superintendent of Public Instruction,John Cox,DEM,380022,2,0,60,62,
Kiowa,Superintendent of Public Instruction,Joy Hofmeister,REP,380022,4,1,65,70,
Kiowa,Commissioner of Labor,Mike Workman,DEM,380022,3,0,43,46,
Kiowa,Commissioner of Labor,Mark Costello,REP,380022,3,1,79,83,
Kiowa,U.S. Senate,Matt Silverstein,DEM,380022,1,0,28,29,
Kiowa,U.S. Senate,Jim Inhofe,REP,380022,5,1,97,103,
Kiowa,U.S. Senate,Aaron Delozier,IND,380022,0,0,0,0,
Kiowa,U.S. Senate,Ray Woods,IND,380022,0,0,2,2,
Kiowa,U.S. Senate,Joan Farr,IND,380022,0,0,0,0,
Kiowa,U.S. Senate,Connie Johnson,DEM,380022,1,0,34,35,
Kiowa,U.S. Senate,James Lankford,REP,380022,4,1,87,92,
Kiowa,U.S. Senate,Mark Beard,IND,380022,1,0,5,6,
Kiowa,U.S. House,Frankie Robbins,DEM,380022,2,0,31,33,03
Kiowa,U.S. House,Frank Lucas,REP,380022,4,1,93,98,03
Latimer,Governor,Joe Dorman,DEM,390001,2,14,145,161,
Latimer,Governor,Mary Fallin,REP,390001,6,6,76,88,
Latimer,Governor,Kimberly Willis,IND,390001,0,0,4,4,
Latimer,Governor,Richard Prawdzienski,IND,390001,0,0,2,2,
Latimer,Lieutenant Governor,Cathy Cummings,DEM,390001,3,13,102,118,
Latimer,Lieutenant Governor,Todd Lamb,REP,390001,5,7,125,137,
Latimer,Superintendent of Public Instruction,John Cox,DEM,390001,3,18,160,181,
Latimer,Superintendent of Public Instruction,Joy Hofmeister,REP,390001,4,2,69,75,
Latimer,Commissioner of Labor,Mike Workman,DEM,390001,3,14,132,149,
Latimer,Commissioner of Labor,Mark Costello,REP,390001,4,5,87,96,
Latimer,U.S. Senate,Matt Silverstein,DEM,390001,2,8,82,92,
Latimer,U.S. Senate,Jim Inhofe,REP,390001,6,12,134,152,
Latimer,U.S. Senate,Aaron Delozier,IND,390001,0,0,1,1,
Latimer,U.S. Senate,Ray Woods,IND,390001,0,0,3,3,
Latimer,U.S. Senate,Joan Farr,IND,390001,0,0,5,5,
Latimer,U.S. Senate,Connie Johnson,DEM,390001,2,10,88,100,
Latimer,U.S. Senate,James Lankford,REP,390001,5,9,123,137,
Latimer,U.S. Senate,Mark Beard,IND,390001,0,1,15,16,
Latimer,U.S. House,Earl Everett,DEM,390001,3,7,77,87,02
Latimer,U.S. House,Markwayne Mullin,REP,390001,5,12,137,154,02
Latimer,U.S. House,Jon Douthitt,IND,390001,0,1,11,12,02
Latimer,State House,Brian Renegar,DEM,390001,4,18,163,185,17
Latimer,State House,Micah Thompson,REP,390001,4,2,64,70,17
Latimer,Governor,Joe Dorman,DEM,390002,8,21,164,193,
Latimer,Governor,Mary Fallin,REP,390002,4,8,77,89,
Latimer,Governor,Kimberly Willis,IND,390002,0,1,7,8,
Latimer,Governor,Richard Prawdzienski,IND,390002,0,0,3,3,
Latimer,Lieutenant Governor,Cathy Cummings,DEM,390002,6,19,111,136,
Latimer,Lieutenant Governor,Todd Lamb,REP,390002,5,11,140,156,
Latimer,Superintendent of Public Instruction,John Cox,DEM,390002,9,24,172,205,
Latimer,Superintendent of Public Instruction,Joy Hofmeister,REP,390002,3,6,78,87,
Latimer,Commissioner of Labor,Mike Workman,DEM,390002,9,20,143,172,
Latimer,Commissioner of Labor,Mark Costello,REP,390002,3,9,103,115,
Latimer,U.S. Senate,Matt Silverstein,DEM,390002,7,15,96,118,
Latimer,U.S. Senate,Jim Inhofe,REP,390002,5,15,143,163,
Latimer,U.S. Senate,Aaron Delozier,IND,390002,0,0,4,4,
Latimer,U.S. Senate,Ray Woods,IND,390002,0,0,1,1,
Latimer,U.S. Senate,Joan Farr,IND,390002,0,0,3,3,
Latimer,U.S. Senate,Connie Johnson,DEM,390002,9,16,96,121,
Latimer,U.S. Senate,James Lankford,REP,390002,3,13,142,158,
Latimer,U.S. Senate,Mark Beard,IND,390002,0,1,10,11,
Latimer,U.S. House,Earl Everett,DEM,390002,7,15,81,103,02
Latimer,U.S. House,Markwayne Mullin,REP,390002,3,15,162,180,02
Latimer,U.S. House,Jon Douthitt,IND,390002,1,0,5,6,02
Latimer,State House,Brian Renegar,DEM,390002,9,22,181,212,17
Latimer,State House,Micah Thompson,REP,390002,3,8,67,78,17
Latimer,Governor,Joe Dorman,DEM,390003,0,23,53,76,
Latimer,Governor,Mary Fallin,REP,390003,0,12,68,80,
Latimer,Governor,Kimberly Willis,IND,390003,0,0,1,1,
Latimer,Governor,Richard Prawdzienski,IND,390003,0,0,2,2,
Latimer,Lieutenant Governor,Cathy Cummings,DEM,390003,0,16,30,46,
Latimer,Lieutenant Governor,Todd Lamb,REP,390003,0,19,94,113,
Latimer,Superintendent of Public Instruction,John Cox,DEM,390003,0,29,63,92,
Latimer,Superintendent of Public Instruction,Joy Hofmeister,REP,390003,0,6,61,67,
Latimer,Commissioner of Labor,Mike Workman,DEM,390003,0,20,54,74,
Latimer,Commissioner of Labor,Mark Costello,REP,390003,0,14,67,81,
Latimer,U.S. Senate,Matt Silverstein,DEM,390003,0,11,25,36,
Latimer,U.S. Senate,Jim Inhofe,REP,390003,0,24,97,121,
Latimer,U.S. Senate,Aaron Delozier,IND,390003,0,0,0,0,
Latimer,U.S. Senate,Ray Woods,IND,390003,0,0,0,0,
Latimer,U.S. Senate,Joan Farr,IND,390003,0,0,1,1,
Latimer,U.S. Senate,Connie Johnson,DEM,390003,0,17,26,43,
Latimer,U.S. Senate,James Lankford,REP,390003,0,17,95,112,
Latimer,U.S. Senate,Mark Beard,IND,390003,0,0,1,1,
Latimer,U.S. House,Earl Everett,DEM,390003,0,10,16,26,02
Latimer,U.S. House,Markwayne Mullin,REP,390003,0,25,101,126,02
Latimer,U.S. House,Jon Douthitt,IND,390003,0,0,5,5,02
Latimer,State House,Brian Renegar,DEM,390003,0,31,73,104,17
Latimer,State House,Micah Thompson,REP,390003,0,4,50,54,17
Latimer,Governor,Joe Dorman,DEM,390004,0,12,54,66,
Latimer,Governor,Mary Fallin,REP,390004,2,4,40,46,
Latimer,Governor,Kimberly Willis,IND,390004,0,0,8,8,
Latimer,Governor,Richard Prawdzienski,IND,390004,0,0,1,1,
Latimer,Lieutenant Governor,Cathy Cummings,DEM,390004,0,10,45,55,
Latimer,Lieutenant Governor,Todd Lamb,REP,390004,2,6,58,66,
Latimer,Superintendent of Public Instruction,John Cox,DEM,390004,0,11,57,68,
Latimer,Superintendent of Public Instruction,Joy Hofmeister,REP,390004,2,5,45,52,
Latimer,Commissioner of Labor,Mike Workman,DEM,390004,0,9,53,62,
Latimer,Commissioner of Labor,Mark Costello,REP,390004,2,7,48,57,
Latimer,U.S. Senate,Matt Silverstein,DEM,390004,0,9,30,39,
Latimer,U.S. Senate,Jim Inhofe,REP,390004,2,7,64,73,
Latimer,U.S. Senate,Aaron Delozier,IND,390004,0,0,0,0,
Latimer,U.S. Senate,Ray Woods,IND,390004,0,0,5,5,
Latimer,U.S. Senate,Joan Farr,IND,390004,0,0,3,3,
Latimer,U.S. Senate,Connie Johnson,DEM,390004,0,9,42,51,
Latimer,U.S. Senate,James Lankford,REP,390004,2,8,58,68,
Latimer,U.S. Senate,Mark Beard,IND,390004,0,0,3,3,
Latimer,U.S. House,Earl Everett,DEM,390004,0,7,31,38,02
Latimer,U.S. House,Markwayne Mullin,REP,390004,2,10,63,75,02
Latimer,U.S. House,Jon Douthitt,IND,390004,0,0,6,6,02
Latimer,State House,Brian Renegar,DEM,390004,0,12,67,79,17
Latimer,State House,Micah Thompson,REP,390004,2,5,35,42,17
Latimer,Governor,Joe Dorman,DEM,390005,1,12,120,133,
Latimer,Governor,Mary Fallin,REP,390005,3,11,126,140,
Latimer,Governor,Kimberly Willis,IND,390005,0,1,2,3,
Latimer,Governor,Richard Prawdzienski,IND,390005,0,1,3,4,
Latimer,Lieutenant Governor,Cathy Cummings,DEM,390005,0,11,81,92,
Latimer,Lieutenant Governor,Todd Lamb,REP,390005,4,14,170,188,
Latimer,Superintendent of Public Instruction,John Cox,DEM,390005,2,12,134,148,
Latimer,Superintendent of Public Instruction,Joy Hofmeister,REP,390005,2,13,118,133,
Latimer,Commissioner of Labor,Mike Workman,DEM,390005,1,12,112,125,
Latimer,Commissioner of Labor,Mark Costello,REP,390005,3,12,137,152,
Latimer,U.S. Senate,Matt Silverstein,DEM,390005,0,8,63,71,
Latimer,U.S. Senate,Jim Inhofe,REP,390005,4,14,179,197,
Latimer,U.S. Senate,Aaron Delozier,IND,390005,0,0,2,2,
Latimer,U.S. Senate,Ray Woods,IND,390005,0,2,6,8,
Latimer,U.S. Senate,Joan Farr,IND,390005,0,0,2,2,
Latimer,U.S. Senate,Connie Johnson,DEM,390005,0,8,77,85,
Latimer,U.S. Senate,James Lankford,REP,390005,3,13,164,180,
Latimer,U.S. Senate,Mark Beard,IND,390005,1,2,10,13,
Latimer,U.S. House,Earl Everett,DEM,390005,0,7,66,73,02
Latimer,U.S. House,Markwayne Mullin,REP,390005,4,17,177,198,02
Latimer,U.S. House,Jon Douthitt,IND,390005,0,1,5,6,02
Latimer,State House,Brian Renegar,DEM,390005,2,14,168,184,17
Latimer,State House,Micah Thompson,REP,390005,2,11,81,94,17
Latimer,Governor,Joe Dorman,DEM,390006,2,1,37,40,
Latimer,Governor,Mary Fallin,REP,390006,0,3,39,42,
Latimer,Governor,Kimberly Willis,IND,390006,0,0,1,1,
Latimer,Governor,Richard Prawdzienski,IND,390006,0,0,3,3,
Latimer,Lieutenant Governor,Cathy Cummings,DEM,390006,2,0,29,31,
Latimer,Lieutenant Governor,Todd Lamb,REP,390006,0,4,50,54,
Latimer,Superintendent of Public Instruction,John Cox,DEM,390006,1,0,44,45,
Latimer,Superintendent of Public Instruction,Joy Hofmeister,REP,390006,1,4,35,40,
Latimer,Commissioner of Labor,Mike Workman,DEM,390006,2,0,29,31,
Latimer,Commissioner of Labor,Mark Costello,REP,390006,0,4,48,52,
Latimer,U.S. Senate,Matt Silverstein,DEM,390006,2,0,21,23,
Latimer,U.S. Senate,Jim Inhofe,REP,390006,0,4,57,61,
Latimer,U.S. Senate,Aaron Delozier,IND,390006,0,0,1,1,
Latimer,U.S. Senate,Ray Woods,IND,390006,0,0,0,0,
Latimer,U.S. Senate,Joan Farr,IND,390006,0,0,1,1,
Latimer,U.S. Senate,Connie Johnson,DEM,390006,2,0,24,26,
Latimer,U.S. Senate,James Lankford,REP,390006,0,4,52,56,
Latimer,U.S. Senate,Mark Beard,IND,390006,0,0,4,4,
Latimer,U.S. House,Earl Everett,DEM,390006,2,0,20,22,02
Latimer,U.S. House,Markwayne Mullin,REP,390006,0,4,53,57,02
Latimer,U.S. House,Jon Douthitt,IND,390006,0,0,6,6,02
Latimer,State House,Brian Renegar,DEM,390006,2,4,41,47,17
Latimer,State House,Micah Thompson,REP,390006,0,0,39,39,17
Latimer,Governor,Joe Dorman,DEM,390007,0,1,32,33,
Latimer,Governor,Mary Fallin,REP,390007,0,5,53,58,
Latimer,Governor,Kimberly Willis,IND,390007,0,0,4,4,
Latimer,Governor,Richard Prawdzienski,IND,390007,0,1,5,6,
Latimer,Lieutenant Governor,Cathy Cummings,DEM,390007,0,1,34,35,
Latimer,Lieutenant Governor,Todd Lamb,REP,390007,0,6,59,65,
Latimer,Superintendent of Public Instruction,John Cox,DEM,390007,0,1,45,46,
Latimer,Superintendent of Public Instruction,Joy Hofmeister,REP,390007,0,6,47,53,
Latimer,Commissioner of Labor,Mike Workman,DEM,390007,0,1,35,36,
Latimer,Commissioner of Labor,Mark Costello,REP,390007,0,6,57,63,
Latimer,U.S. Senate,Matt Silverstein,DEM,390007,0,1,24,25,
Latimer,U.S. Senate,Jim Inhofe,REP,390007,0,5,62,67,
Latimer,U.S. Senate,Aaron Delozier,IND,390007,0,0,2,2,
Latimer,U.S. Senate,Ray Woods,IND,390007,0,0,3,3,
Latimer,U.S. Senate,Joan Farr,IND,390007,0,1,2,3,
Latimer,U.S. Senate,Connie Johnson,DEM,390007,0,1,27,28,
Latimer,U.S. Senate,James Lankford,REP,390007,0,6,57,63,
Latimer,U.S. Senate,Mark Beard,IND,390007,0,0,10,10,
Latimer,U.S. House,Earl Everett,DEM,390007,0,1,27,28,02
Latimer,U.S. House,Markwayne Mullin,REP,390007,0,6,61,67,02
Latimer,U.S. House,Jon Douthitt,IND,390007,0,0,5,5,02
Latimer,State House,Brian Renegar,DEM,390007,0,4,48,52,17
Latimer,State House,Micah Thompson,REP,390007,0,3,46,49,17
Latimer,Governor,Joe Dorman,DEM,390008,1,3,119,123,
Latimer,Governor,Mary Fallin,REP,390008,2,4,87,93,
Latimer,Governor,Kimberly Willis,IND,390008,0,0,5,5,
Latimer,Governor,Richard Prawdzienski,IND,390008,0,0,3,3,
Latimer,Lieutenant Governor,Cathy Cummings,DEM,390008,1,1,85,87,
Latimer,Lieutenant Governor,Todd Lamb,REP,390008,2,6,129,137,
Latimer,Superintendent of Public Instruction,John Cox,DEM,390008,1,3,119,123,
Latimer,Superintendent of Public Instruction,Joy Hofmeister,REP,390008,2,4,95,101,
Latimer,Commissioner of Labor,Mike Workman,DEM,390008,1,3,107,111,
Latimer,Commissioner of Labor,Mark Costello,REP,390008,2,4,101,107,
Latimer,U.S. Senate,Matt Silverstein,DEM,390008,1,1,73,75,
Latimer,U.S. Senate,Jim Inhofe,REP,390008,2,6,133,141,
Latimer,U.S. Senate,Aaron Delozier,IND,390008,0,0,4,4,
Latimer,U.S. Senate,Ray Woods,IND,390008,0,0,0,0,
Latimer,U.S. Senate,Joan Farr,IND,390008,0,0,1,1,
Latimer,U.S. Senate,Connie Johnson,DEM,390008,1,0,71,72,
Latimer,U.S. Senate,James Lankford,REP,390008,2,6,128,136,
Latimer,U.S. Senate,Mark Beard,IND,390008,0,1,14,15,
Latimer,U.S. House,Earl Everett,DEM,390008,1,1,65,67,02
Latimer,U.S. House,Markwayne Mullin,REP,390008,2,6,136,144,02
Latimer,U.S. House,Jon Douthitt,IND,390008,0,0,9,9,02
Latimer,State House,Brian Renegar,DEM,390008,2,4,142,148,17
Latimer,State House,Micah Thompson,REP,390008,1,2,68,71,17
Latimer,Governor,Joe Dorman,DEM,390009,8,1,78,87,
Latimer,Governor,Mary Fallin,REP,390009,0,3,59,62,
Latimer,Governor,Kimberly Willis,IND,390009,0,0,3,3,
Latimer,Governor,Richard Prawdzienski,IND,390009,0,0,1,1,
Latimer,Lieutenant Governor,Cathy Cummings,DEM,390009,8,1,50,59,
Latimer,Lieutenant Governor,Todd Lamb,REP,390009,0,3,92,95,
Latimer,Superintendent of Public Instruction,John Cox,DEM,390009,8,1,84,93,
Latimer,Superintendent of Public Instruction,Joy Hofmeister,REP,390009,0,3,58,61,
Latimer,Commissioner of Labor,Mike Workman,DEM,390009,8,1,70,79,
Latimer,Commissioner of Labor,Mark Costello,REP,390009,0,3,70,73,
Latimer,U.S. Senate,Matt Silverstein,DEM,390009,8,1,50,59,
Latimer,U.S. Senate,Jim Inhofe,REP,390009,0,3,86,89,
Latimer,U.S. Senate,Aaron Delozier,IND,390009,0,0,2,2,
Latimer,U.S. Senate,Ray Woods,IND,390009,0,0,2,2,
Latimer,U.S. Senate,Joan Farr,IND,390009,0,0,1,1,
Latimer,U.S. Senate,Connie Johnson,DEM,390009,8,1,53,62,
Latimer,U.S. Senate,James Lankford,REP,390009,0,3,86,89,
Latimer,U.S. Senate,Mark Beard,IND,390009,0,0,3,3,
Latimer,U.S. House,Earl Everett,DEM,390009,8,1,39,48,02
Latimer,U.S. House,Markwayne Mullin,REP,390009,0,3,88,91,02
Latimer,U.S. House,Jon Douthitt,IND,390009,0,0,12,12,02
Latimer,State House,Brian Renegar,DEM,390009,8,1,88,97,17
Latimer,State House,Micah Thompson,REP,390009,0,3,54,57,17
Latimer,Governor,Joe Dorman,DEM,390010,0,7,80,87,
Latimer,Governor,Mary Fallin,REP,390010,3,3,85,91,
Latimer,Governor,Kimberly Willis,IND,390010,0,1,2,3,
Latimer,Governor,Richard Prawdzienski,IND,390010,0,0,0,0,
Latimer,Lieutenant Governor,Cathy Cummings,DEM,390010,0,6,54,60,
Latimer,Lieutenant Governor,Todd Lamb,REP,390010,3,5,114,122,
Latimer,Superintendent of Public Instruction,John Cox,DEM,390010,0,10,91,101,
Latimer,Superintendent of Public Instruction,Joy Hofmeister,REP,390010,3,1,77,81,
Latimer,Commissioner of Labor,Mike Workman,DEM,390010,1,10,80,91,
Latimer,Commissioner of Labor,Mark Costello,REP,390010,2,1,87,90,
Latimer,U.S. Senate,Matt Silverstein,DEM,390010,0,7,53,60,
Latimer,U.S. Senate,Jim Inhofe,REP,390010,3,3,111,117,
Latimer,U.S. Senate,Aaron Delozier,IND,390010,0,0,1,1,
Latimer,U.S. Senate,Ray Woods,IND,390010,0,1,0,1,
Latimer,U.S. Senate,Joan Farr,IND,390010,0,0,2,2,
Latimer,U.S. Senate,Connie Johnson,DEM,390010,0,7,55,62,
Latimer,U.S. Senate,James Lankford,REP,390010,3,3,107,113,
Latimer,U.S. Senate,Mark Beard,IND,390010,0,0,7,7,
Latimer,U.S. House,Earl Everett,DEM,390010,0,3,47,50,02
Latimer,U.S. House,Markwayne Mullin,REP,390010,3,6,116,125,02
Latimer,U.S. House,Jon Douthitt,IND,390010,0,1,5,6,02
Latimer,State House,Brian Renegar,DEM,390010,1,10,101,112,17
Latimer,State House,Micah Thompson,REP,390010,2,0,67,69,17
Latimer,Governor,Joe Dorman,DEM,390011,9,9,187,205,
Latimer,Governor,Mary Fallin,REP,390011,7,5,154,166,
Latimer,Governor,Kimberly Willis,IND,390011,0,0,5,5,
Latimer,Governor,Richard Prawdzienski,IND,390011,0,0,5,5,
Latimer,Lieutenant Governor,Cathy Cummings,DEM,390011,7,6,149,162,
Latimer,Lieutenant Governor,Todd Lamb,REP,390011,9,9,200,218,
Latimer,Superintendent of Public Instruction,John Cox,DEM,390011,9,12,218,239,
Latimer,Superintendent of Public Instruction,Joy Hofmeister,REP,390011,7,3,133,143,
Latimer,Commissioner of Labor,Mike Workman,DEM,390011,9,7,184,200,
Latimer,Commissioner of Labor,Mark Costello,REP,390011,6,6,156,168,
Latimer,U.S. Senate,Matt Silverstein,DEM,390011,8,5,120,133,
Latimer,U.S. Senate,Jim Inhofe,REP,390011,7,9,222,238,
Latimer,U.S. Senate,Aaron Delozier,IND,390011,0,0,1,1,
Latimer,U.S. Senate,Ray Woods,IND,390011,0,1,4,5,
Latimer,U.S. Senate,Joan Farr,IND,390011,0,0,3,3,
Latimer,U.S. Senate,Connie Johnson,DEM,390011,9,5,139,153,
Latimer,U.S. Senate,James Lankford,REP,390011,7,9,201,217,
Latimer,U.S. Senate,Mark Beard,IND,390011,0,1,10,11,
Latimer,U.S. House,Earl Everett,DEM,390011,6,3,112,121,02
Latimer,U.S. House,Markwayne Mullin,REP,390011,10,11,227,248,02
Latimer,U.S. House,Jon Douthitt,IND,390011,0,1,13,14,02
Latimer,State House,Brian Renegar,DEM,390011,10,12,234,256,17
Latimer,State House,Micah Thompson,REP,390011,6,3,116,125,17
Latimer,Governor,Joe Dorman,DEM,390012,2,4,56,62,
Latimer,Governor,Mary Fallin,REP,390012,3,5,53,61,
Latimer,Governor,Kimberly Willis,IND,390012,0,0,3,3,
Latimer,Governor,Richard Prawdzienski,IND,390012,0,0,0,0,
Latimer,Lieutenant Governor,Cathy Cummings,DEM,390012,2,2,48,52,
Latimer,Lieutenant Governor,Todd Lamb,REP,390012,3,6,61,70,
Latimer,Superintendent of Public Instruction,John Cox,DEM,390012,3,5,74,82,
Latimer,Superintendent of Public Instruction,Joy Hofmeister,REP,390012,2,4,37,43,
Latimer,Commissioner of Labor,Mike Workman,DEM,390012,2,3,60,65,
Latimer,Commissioner of Labor,Mark Costello,REP,390012,3,6,47,56,
Latimer,U.S. Senate,Matt Silverstein,DEM,390012,2,1,42,45,
Latimer,U.S. Senate,Jim Inhofe,REP,390012,3,7,60,70,
Latimer,U.S. Senate,Aaron Delozier,IND,390012,0,0,0,0,
Latimer,U.S. Senate,Ray Woods,IND,390012,0,0,6,6,
Latimer,U.S. Senate,Joan Farr,IND,390012,0,1,2,3,
Latimer,U.S. Senate,Connie Johnson,DEM,390012,2,3,41,46,
Latimer,U.S. Senate,James Lankford,REP,390012,3,5,59,67,
Latimer,U.S. Senate,Mark Beard,IND,390012,0,1,11,12,
Latimer,U.S. House,Earl Everett,DEM,390012,2,1,35,38,02
Latimer,U.S. House,Markwayne Mullin,REP,390012,3,7,63,73,02
Latimer,U.S. House,Jon Douthitt,IND,390012,0,0,9,9,02
Latimer,State House,Brian Renegar,DEM,390012,5,6,81,92,17
Latimer,State House,Micah Thompson,REP,390012,0,3,28,31,17
Leflore,Governor,Joe Dorman,DEM,400101,0,4,65,69,
Leflore,Governor,Mary Fallin,REP,400101,6,4,123,133,
Leflore,Governor,Kimberly Willis,IND,400101,0,0,5,5,
Leflore,Governor,Richard Prawdzienski,IND,400101,0,0,1,1,
Leflore,Lieutenant Governor,Cathy Cummings,DEM,400101,1,5,61,67,
Leflore,Lieutenant Governor,Todd Lamb,REP,400101,5,3,132,140,
Leflore,Superintendent of Public Instruction,John Cox,DEM,400101,3,5,94,102,
Leflore,Superintendent of Public Instruction,Joy Hofmeister,REP,400101,3,3,98,104,
Leflore,Commissioner of Labor,Mike Workman,DEM,400101,2,5,67,74,
Leflore,Commissioner of Labor,Mark Costello,REP,400101,3,3,120,126,
Leflore,U.S. Senate,Matt Silverstein,DEM,400101,1,5,42,48,
Leflore,U.S. Senate,Jim Inhofe,REP,400101,5,3,146,154,
Leflore,U.S. Senate,Aaron Delozier,IND,400101,0,0,0,0,
Leflore,U.S. Senate,Ray Woods,IND,400101,0,0,4,4,
Leflore,U.S. Senate,Joan Farr,IND,400101,0,0,1,1,
Leflore,U.S. Senate,Connie Johnson,DEM,400101,1,4,57,62,
Leflore,U.S. Senate,James Lankford,REP,400101,5,3,134,142,
Leflore,U.S. Senate,Mark Beard,IND,400101,0,1,2,3,
Leflore,U.S. House,Earl Everett,DEM,400101,1,5,43,49,02
Leflore,U.S. House,Markwayne Mullin,REP,400101,5,3,142,150,02
Leflore,U.S. House,Jon Douthitt,IND,400101,0,0,8,8,02
Leflore,State Senate,Ann Weaver,DEM,400101,1,5,58,64,4
Leflore,State Senate,Mark Allen,REP,400101,5,3,136,144,4
Leflore,Governor,Joe Dorman,DEM,400102,3,2,104,109,
Leflore,Governor,Mary Fallin,REP,400102,1,6,163,170,
Leflore,Governor,Kimberly Willis,IND,400102,0,0,8,8,
Leflore,Governor,Richard Prawdzienski,IND,400102,0,0,2,2,
Leflore,Lieutenant Governor,Cathy Cummings,DEM,400102,2,1,104,107,
Leflore,Lieutenant Governor,Todd Lamb,REP,400102,2,7,175,184,
Leflore,Superintendent of Public Instruction,John Cox,DEM,400102,3,4,157,164,
Leflore,Superintendent of Public Instruction,Joy Hofmeister,REP,400102,1,4,120,125,
Leflore,Commissioner of Labor,Mike Workman,DEM,400102,1,1,110,112,
Leflore,Commissioner of Labor,Mark Costello,REP,400102,2,7,162,171,
Leflore,U.S. Senate,Matt Silverstein,DEM,400102,2,1,62,65,
Leflore,U.S. Senate,Jim Inhofe,REP,400102,2,7,205,214,
Leflore,U.S. Senate,Aaron Delozier,IND,400102,0,0,1,1,
Leflore,U.S. Senate,Ray Woods,IND,400102,0,0,3,3,
Leflore,U.S. Senate,Joan Farr,IND,400102,0,0,5,5,
Leflore,U.S. Senate,Connie Johnson,DEM,400102,1,1,76,78,
Leflore,U.S. Senate,James Lankford,REP,400102,2,7,189,198,
Leflore,U.S. Senate,Mark Beard,IND,400102,0,0,10,10,
Leflore,U.S. House,Earl Everett,DEM,400102,1,1,73,75,02
Leflore,U.S. House,Markwayne Mullin,REP,400102,3,7,195,205,02
Leflore,U.S. House,Jon Douthitt,IND,400102,0,0,7,7,02
Leflore,State Senate,Ann Weaver,DEM,400102,1,1,79,81,4
Leflore,State Senate,Mark Allen,REP,400102,3,7,201,211,4
Leflore,State House,James Lockhart,DEM,400102,1,4,139,144,3
Leflore,State House,Traci Barnes,REP,400102,3,4,140,147,3
Leflore,Governor,Joe Dorman,DEM,400103,1,2,120,123,
Leflore,Governor,Mary Fallin,REP,400103,4,9,196,209,
Leflore,Governor,Kimberly Willis,IND,400103,0,0,6,6,
Leflore,Governor,Richard Prawdzienski,IND,400103,0,0,4,4,
Leflore,Lieutenant Governor,Cathy Cummings,DEM,400103,2,3,98,103,
Leflore,Lieutenant Governor,Todd Lamb,REP,400103,3,8,224,235,
Leflore,Superintendent of Public Instruction,John Cox,DEM,400103,3,4,162,169,
Leflore,Superintendent of Public Instruction,Joy Hofmeister,REP,400103,2,7,163,172,
Leflore,Commissioner of Labor,Mike Workman,DEM,400103,2,4,104,110,
Leflore,Commissioner of Labor,Mark Costello,REP,400103,3,7,213,223,
Leflore,U.S. Senate,Matt Silverstein,DEM,400103,1,0,68,69,
Leflore,U.S. Senate,Jim Inhofe,REP,400103,4,10,238,252,
Leflore,U.S. Senate,Aaron Delozier,IND,400103,0,1,4,5,
Leflore,U.S. Senate,Ray Woods,IND,400103,0,0,5,5,
Leflore,U.S. Senate,Joan Farr,IND,400103,0,0,6,6,
Leflore,U.S. Senate,Connie Johnson,DEM,400103,2,2,77,81,
Leflore,U.S. Senate,James Lankford,REP,400103,3,9,231,243,
Leflore,U.S. Senate,Mark Beard,IND,400103,0,0,12,12,
Leflore,U.S. House,Earl Everett,DEM,400103,2,1,74,77,02
Leflore,U.S. House,Markwayne Mullin,REP,400103,3,10,233,246,02
Leflore,U.S. House,Jon Douthitt,IND,400103,0,0,14,14,02
Leflore,State Senate,Ann Weaver,DEM,400103,2,3,91,96,4
Leflore,State Senate,Mark Allen,REP,400103,3,8,234,245,4
Leflore,State House,James Lockhart,DEM,400103,4,5,161,170,3
Leflore,State House,Traci Barnes,REP,400103,1,6,162,169,3
Leflore,Governor,Joe Dorman,DEM,400104,6,3,88,97,
Leflore,Governor,Mary Fallin,REP,400104,0,3,19,22,
Leflore,Governor,Kimberly Willis,IND,400104,0,0,3,3,
Leflore,Governor,Richard Prawdzienski,IND,400104,0,0,0,0,
Leflore,Lieutenant Governor,Cathy Cummings,DEM,400104,6,3,90,99,
Leflore,Lieutenant Governor,Todd Lamb,REP,400104,0,3,19,22,
Leflore,Superintendent of Public Instruction,John Cox,DEM,400104,6,3,92,101,
Leflore,Superintendent of Public Instruction,Joy Hofmeister,REP,400104,0,3,17,20,
Leflore,Commissioner of Labor,Mike Workman,DEM,400104,6,3,87,96,
Leflore,Commissioner of Labor,Mark Costello,REP,400104,0,3,22,25,
Leflore,U.S. Senate,Matt Silverstein,DEM,400104,6,3,83,92,
Leflore,U.S. Senate,Jim Inhofe,REP,400104,0,3,23,26,
Leflore,U.S. Senate,Aaron Delozier,IND,400104,0,0,1,1,
Leflore,U.S. Senate,Ray Woods,IND,400104,0,0,2,2,
Leflore,U.S. Senate,Joan Farr,IND,400104,0,0,0,0,
Leflore,U.S. Senate,Connie Johnson,DEM,400104,6,3,86,95,
Leflore,U.S. Senate,James Lankford,REP,400104,0,3,22,25,
Leflore,U.S. Senate,Mark Beard,IND,400104,0,0,1,1,
Leflore,U.S. House,Earl Everett,DEM,400104,6,3,84,93,02
Leflore,U.S. House,Markwayne Mullin,REP,400104,0,3,23,26,02
Leflore,U.S. House,Jon Douthitt,IND,400104,0,0,1,1,02
Leflore,State Senate,Ann Weaver,DEM,400104,6,3,89,98,4
Leflore,State Senate,Mark Allen,REP,400104,0,3,21,24,4
Leflore,State House,James Lockhart,DEM,400104,6,3,94,103,3
Leflore,State House,Traci Barnes,REP,400104,0,3,16,19,3
Leflore,Governor,Joe Dorman,DEM,400105,0,3,113,116,
Leflore,Governor,Mary Fallin,REP,400105,0,10,265,275,
Leflore,Governor,Kimberly Willis,IND,400105,0,0,11,11,
Leflore,Governor,Richard Prawdzienski,IND,400105,0,1,5,6,
Leflore,Lieutenant Governor,Cathy Cummings,DEM,400105,0,2,122,124,
Leflore,Lieutenant Governor,Todd Lamb,REP,400105,0,12,264,276,
Leflore,Superintendent of Public Instruction,John Cox,DEM,400105,0,8,173,181,
Leflore,Superintendent of Public Instruction,Joy Hofmeister,REP,400105,0,6,214,220,
Leflore,Commissioner of Labor,Mike Workman,DEM,400105,0,3,128,131,
Leflore,Commissioner of Labor,Mark Costello,REP,400105,0,11,254,265,
Leflore,U.S. Senate,Matt Silverstein,DEM,400105,0,2,77,79,
Leflore,U.S. Senate,Jim Inhofe,REP,400105,0,12,295,307,
Leflore,U.S. Senate,Aaron Delozier,IND,400105,0,0,6,6,
Leflore,U.S. Senate,Ray Woods,IND,400105,0,0,3,3,
Leflore,U.S. Senate,Joan Farr,IND,400105,0,0,11,11,
Leflore,U.S. Senate,Connie Johnson,DEM,400105,0,3,88,91,
Leflore,U.S. Senate,James Lankford,REP,400105,0,11,281,292,
Leflore,U.S. Senate,Mark Beard,IND,400105,0,0,17,17,
Leflore,U.S. House,Earl Everett,DEM,400105,0,3,87,90,02
Leflore,U.S. House,Markwayne Mullin,REP,400105,0,11,285,296,02
Leflore,U.S. House,Jon Douthitt,IND,400105,0,0,18,18,02
Leflore,State Senate,Ann Weaver,DEM,400105,0,2,87,89,4
Leflore,State Senate,Mark Allen,REP,400105,0,12,309,321,4
Leflore,State House,James Lockhart,DEM,400105,0,5,213,218,3
Leflore,State House,Traci Barnes,REP,400105,0,9,182,191,3
Leflore,Governor,Joe Dorman,DEM,400106,2,0,91,93,
Leflore,Governor,Mary Fallin,REP,400106,2,5,212,219,
Leflore,Governor,Kimberly Willis,IND,400106,0,0,7,7,
Leflore,Governor,Richard Prawdzienski,IND,400106,0,2,0,2,
Leflore,Lieutenant Governor,Cathy Cummings,DEM,400106,2,1,89,92,
Leflore,Lieutenant Governor,Todd Lamb,REP,400106,2,6,217,225,
Leflore,Superintendent of Public Instruction,John Cox,DEM,400106,4,1,129,134,
Leflore,Superintendent of Public Instruction,Joy Hofmeister,REP,400106,0,6,175,181,
Leflore,Commissioner of Labor,Mike Workman,DEM,400106,1,1,96,98,
Leflore,Commissioner of Labor,Mark Costello,REP,400106,2,6,202,210,
Leflore,U.S. Senate,Matt Silverstein,DEM,400106,2,1,68,71,
Leflore,U.S. Senate,Jim Inhofe,REP,400106,2,6,232,240,
Leflore,U.S. Senate,Aaron Delozier,IND,400106,0,0,3,3,
Leflore,U.S. Senate,Ray Woods,IND,400106,0,0,0,0,
Leflore,U.S. Senate,Joan Farr,IND,400106,0,0,4,4,
Leflore,U.S. Senate,Connie Johnson,DEM,400106,3,3,69,75,
Leflore,U.S. Senate,James Lankford,REP,400106,0,4,223,227,
Leflore,U.S. Senate,Mark Beard,IND,400106,1,0,11,12,
Leflore,U.S. House,Earl Everett,DEM,400106,2,1,65,68,02
Leflore,U.S. House,Markwayne Mullin,REP,400106,2,4,226,232,02
Leflore,U.S. House,Jon Douthitt,IND,400106,0,2,11,13,02
Leflore,State Senate,Ann Weaver,DEM,400106,3,2,92,97,4
Leflore,State Senate,Mark Allen,REP,400106,1,5,217,223,4
Leflore,State House,James Lockhart,DEM,400106,2,2,142,146,3
Leflore,State House,Traci Barnes,REP,400106,2,5,164,171,3
Leflore,Governor,Joe Dorman,DEM,400107,2,4,121,127,
Leflore,Governor,Mary Fallin,REP,400107,2,12,321,335,
Leflore,Governor,Kimberly Willis,IND,400107,1,0,7,8,
Leflore,Governor,Richard Prawdzienski,IND,400107,0,0,12,12,
Leflore,Lieutenant Governor,Cathy Cummings,DEM,400107,2,2,124,128,
Leflore,Lieutenant Governor,Todd Lamb,REP,400107,3,14,329,346,
Leflore,Superintendent of Public Instruction,John Cox,DEM,400107,4,5,186,195,
Leflore,Superintendent of Public Instruction,Joy Hofmeister,REP,400107,1,11,272,284,
Leflore,Commissioner of Labor,Mike Workman,DEM,400107,3,4,142,149,
Leflore,Commissioner of Labor,Mark Costello,REP,400107,2,12,306,320,
Leflore,U.S. Senate,Matt Silverstein,DEM,400107,2,2,97,101,
Leflore,U.S. Senate,Jim Inhofe,REP,400107,2,14,339,355,
Leflore,U.S. Senate,Aaron Delozier,IND,400107,0,0,3,3,
Leflore,U.S. Senate,Ray Woods,IND,400107,1,0,7,8,
Leflore,U.S. Senate,Joan Farr,IND,400107,0,0,10,10,
Leflore,U.S. Senate,Connie Johnson,DEM,400107,3,2,105,110,
Leflore,U.S. Senate,James Lankford,REP,400107,2,14,333,349,
Leflore,U.S. Senate,Mark Beard,IND,400107,0,0,15,15,
Leflore,U.S. House,Earl Everett,DEM,400107,2,2,99,103,02
Leflore,U.S. House,Markwayne Mullin,REP,400107,2,13,340,355,02
Leflore,U.S. House,Jon Douthitt,IND,400107,1,1,16,18,02
Leflore,State Senate,Ann Weaver,DEM,400107,3,5,130,138,4
Leflore,State Senate,Mark Allen,REP,400107,2,11,332,345,4
Leflore,State House,James Lockhart,DEM,400107,3,6,206,215,3
Leflore,State House,Traci Barnes,REP,400107,2,10,258,270,3
Leflore,Governor,Joe Dorman,DEM,400108,2,1,84,87,
Leflore,Governor,Mary Fallin,REP,400108,5,2,188,195,
Leflore,Governor,Kimberly Willis,IND,400108,0,0,11,11,
Leflore,Governor,Richard Prawdzienski,IND,400108,0,0,3,3,
Leflore,Lieutenant Governor,Cathy Cummings,DEM,400108,3,0,86,89,
Leflore,Lieutenant Governor,Todd Lamb,REP,400108,4,3,198,205,
Leflore,Superintendent of Public Instruction,John Cox,DEM,400108,4,0,120,124,
Leflore,Superintendent of Public Instruction,Joy Hofmeister,REP,400108,3,3,160,166,
Leflore,Commissioner of Labor,Mike Workman,DEM,400108,3,0,98,101,
Leflore,Commissioner of Labor,Mark Costello,REP,400108,4,3,178,185,
Leflore,U.S. Senate,Matt Silverstein,DEM,400108,2,0,78,80,
Leflore,U.S. Senate,Jim Inhofe,REP,400108,5,3,192,200,
Leflore,U.S. Senate,Aaron Delozier,IND,400108,0,0,3,3,
Leflore,U.S. Senate,Ray Woods,IND,400108,0,0,4,4,
Leflore,U.S. Senate,Joan Farr,IND,400108,0,0,8,8,
Leflore,U.S. Senate,Connie Johnson,DEM,400108,1,0,76,77,
Leflore,U.S. Senate,James Lankford,REP,400108,5,3,193,201,
Leflore,U.S. Senate,Mark Beard,IND,400108,1,0,12,13,
Leflore,U.S. House,Earl Everett,DEM,400108,2,0,77,79,02
Leflore,U.S. House,Markwayne Mullin,REP,400108,5,3,191,199,02
Leflore,U.S. House,Jon Douthitt,IND,400108,0,0,14,14,02
Leflore,State Senate,Ann Weaver,DEM,400108,2,0,103,105,4
Leflore,State Senate,Mark Allen,REP,400108,5,3,183,191,4
Leflore,State House,James Lockhart,DEM,400108,4,1,152,157,3
Leflore,State House,Traci Barnes,REP,400108,3,2,131,136,3
Leflore,Governor,Joe Dorman,DEM,400109,1,11,148,160,
Leflore,Governor,Mary Fallin,REP,400109,2,27,206,235,
Leflore,Governor,Kimberly Willis,IND,400109,0,1,9,10,
Leflore,Governor,Richard Prawdzienski,IND,400109,0,0,7,7,
Leflore,Lieutenant Governor,Cathy Cummings,DEM,400109,1,9,143,153,
Leflore,Lieutenant Governor,Todd Lamb,REP,400109,2,29,223,254,
Leflore,Superintendent of Public Instruction,John Cox,DEM,400109,1,15,178,194,
Leflore,Superintendent of Public Instruction,Joy Hofmeister,REP,400109,2,24,187,213,
Leflore,Commissioner of Labor,Mike Workman,DEM,400109,1,11,138,150,
Leflore,Commissioner of Labor,Mark Costello,REP,400109,2,28,225,255,
Leflore,U.S. Senate,Matt Silverstein,DEM,400109,1,8,97,106,
Leflore,U.S. Senate,Jim Inhofe,REP,400109,2,30,250,282,
Leflore,U.S. Senate,Aaron Delozier,IND,400109,0,0,5,5,
Leflore,U.S. Senate,Ray Woods,IND,400109,0,1,8,9,
Leflore,U.S. Senate,Joan Farr,IND,400109,0,0,8,8,
Leflore,U.S. Senate,Connie Johnson,DEM,400109,1,8,109,118,
Leflore,U.S. Senate,James Lankford,REP,400109,2,28,231,261,
Leflore,U.S. Senate,Mark Beard,IND,400109,0,3,28,31,
Leflore,U.S. House,Earl Everett,DEM,400109,1,10,95,106,02
Leflore,U.S. House,Markwayne Mullin,REP,400109,2,28,250,280,02
Leflore,U.S. House,Jon Douthitt,IND,400109,0,1,23,24,02
Leflore,State Senate,Ann Weaver,DEM,400109,1,10,134,145,4
Leflore,State Senate,Mark Allen,REP,400109,2,29,233,264,4
Leflore,State House,James Lockhart,DEM,400109,1,17,210,228,3
Leflore,State House,Traci Barnes,REP,400109,2,22,158,182,3
Leflore,Governor,Joe Dorman,DEM,400110,1,4,133,138,
Leflore,Governor,Mary Fallin,REP,400110,0,3,141,144,
Leflore,Governor,Kimberly Willis,IND,400110,0,0,15,15,
Leflore,Governor,Richard Prawdzienski,IND,400110,0,0,5,5,
Leflore,Lieutenant Governor,Cathy Cummings,DEM,400110,1,3,117,121,
Leflore,Lieutenant Governor,Todd Lamb,REP,400110,0,4,171,175,
Leflore,Superintendent of Public Instruction,John Cox,DEM,400110,1,4,174,179,
Leflore,Superintendent of Public Instruction,Joy Hofmeister,REP,400110,0,3,117,120,
Leflore,Commissioner of Labor,Mike Workman,DEM,400110,1,4,136,141,
Leflore,Commissioner of Labor,Mark Costello,REP,400110,0,2,149,151,
Leflore,U.S. Senate,Matt Silverstein,DEM,400110,1,3,95,99,
Leflore,U.S. Senate,Jim Inhofe,REP,400110,0,4,172,176,
Leflore,U.S. Senate,Aaron Delozier,IND,400110,0,0,2,2,
Leflore,U.S. Senate,Ray Woods,IND,400110,0,0,3,3,
Leflore,U.S. Senate,Joan Farr,IND,400110,0,0,17,17,
Leflore,U.S. Senate,Connie Johnson,DEM,400110,1,2,105,108,
Leflore,U.S. Senate,James Lankford,REP,400110,0,5,161,166,
Leflore,U.S. Senate,Mark Beard,IND,400110,0,0,21,21,
Leflore,U.S. House,Earl Everett,DEM,400110,1,3,102,106,02
Leflore,U.S. House,Markwayne Mullin,REP,400110,0,3,167,170,02
Leflore,U.S. House,Jon Douthitt,IND,400110,0,1,15,16,02
Leflore,State Senate,Ann Weaver,DEM,400110,1,4,136,141,4
Leflore,State Senate,Mark Allen,REP,400110,0,3,161,164,4
Leflore,Governor,Joe Dorman,DEM,400111,2,5,147,154,
Leflore,Governor,Mary Fallin,REP,400111,2,15,225,242,
Leflore,Governor,Kimberly Willis,IND,400111,0,0,19,19,
Leflore,Governor,Richard Prawdzienski,IND,400111,0,1,3,4,
Leflore,Lieutenant Governor,Cathy Cummings,DEM,400111,1,3,135,139,
Leflore,Lieutenant Governor,Todd Lamb,REP,400111,3,18,251,272,
Leflore,Superintendent of Public Instruction,John Cox,DEM,400111,2,6,199,207,
Leflore,Superintendent of Public Instruction,Joy Hofmeister,REP,400111,2,15,189,206,
Leflore,Commissioner of Labor,Mike Workman,DEM,400111,2,4,135,141,
Leflore,Commissioner of Labor,Mark Costello,REP,400111,2,16,251,269,
Leflore,U.S. Senate,Matt Silverstein,DEM,400111,2,4,99,105,
Leflore,U.S. Senate,Jim Inhofe,REP,400111,2,17,257,276,
Leflore,U.S. Senate,Aaron Delozier,IND,400111,0,0,4,4,
Leflore,U.S. Senate,Ray Woods,IND,400111,0,0,14,14,
Leflore,U.S. Senate,Joan Farr,IND,400111,0,0,15,15,
Leflore,U.S. Senate,Connie Johnson,DEM,400111,1,2,107,110,
Leflore,U.S. Senate,James Lankford,REP,400111,3,19,257,279,
Leflore,U.S. Senate,Mark Beard,IND,400111,0,0,25,25,
Leflore,U.S. House,Earl Everett,DEM,400111,2,3,89,94,02
Leflore,U.S. House,Markwayne Mullin,REP,400111,2,18,275,295,02
Leflore,U.S. House,Jon Douthitt,IND,400111,0,0,26,26,02
Leflore,State Senate,Ann Weaver,DEM,400111,2,4,161,167,4
Leflore,State Senate,Mark Allen,REP,400111,2,17,234,253,4
Leflore,Governor,Joe Dorman,DEM,400112,0,1,41,42,
Leflore,Governor,Mary Fallin,REP,400112,0,4,29,33,
Leflore,Governor,Kimberly Willis,IND,400112,0,0,5,5,
Leflore,Governor,Richard Prawdzienski,IND,400112,0,0,0,0,
Leflore,Lieutenant Governor,Cathy Cummings,DEM,400112,0,1,39,40,
Leflore,Lieutenant Governor,Todd Lamb,REP,400112,0,4,34,38,
Leflore,Superintendent of Public Instruction,John Cox,DEM,400112,0,1,49,50,
Leflore,Superintendent of Public Instruction,Joy Hofmeister,REP,400112,0,4,23,27,
Leflore,Commissioner of Labor,Mike Workman,DEM,400112,0,1,43,44,
Leflore,Commissioner of Labor,Mark Costello,REP,400112,0,4,30,34,
Leflore,U.S. Senate,Matt Silverstein,DEM,400112,0,1,32,33,
Leflore,U.S. Senate,Jim Inhofe,REP,400112,0,4,36,40,
Leflore,U.S. Senate,Aaron Delozier,IND,400112,0,0,2,2,
Leflore,U.S. Senate,Ray Woods,IND,400112,0,0,1,1,
Leflore,U.S. Senate,Joan Farr,IND,400112,0,0,3,3,
Leflore,U.S. Senate,Connie Johnson,DEM,400112,0,1,33,34,
Leflore,U.S. Senate,James Lankford,REP,400112,0,4,34,38,
Leflore,U.S. Senate,Mark Beard,IND,400112,0,0,6,6,
Leflore,U.S. House,Earl Everett,DEM,400112,0,1,31,32,02
Leflore,U.S. House,Markwayne Mullin,REP,400112,0,4,38,42,02
Leflore,U.S. House,Jon Douthitt,IND,400112,0,0,5,5,02
Leflore,State Senate,Ann Weaver,DEM,400112,0,1,32,33,4
Leflore,State Senate,Mark Allen,REP,400112,0,4,43,47,4
Leflore,Governor,Joe Dorman,DEM,400113,4,6,56,66,
Leflore,Governor,Mary Fallin,REP,400113,4,9,98,111,
Leflore,Governor,Kimberly Willis,IND,400113,0,0,7,7,
Leflore,Governor,Richard Prawdzienski,IND,400113,0,0,1,1,
Leflore,Lieutenant Governor,Cathy Cummings,DEM,400113,3,3,53,59,
Leflore,Lieutenant Governor,Todd Lamb,REP,400113,5,12,104,121,
Leflore,Superintendent of Public Instruction,John Cox,DEM,400113,6,8,82,96,
Leflore,Superintendent of Public Instruction,Joy Hofmeister,REP,400113,2,7,79,88,
Leflore,Commissioner of Labor,Mike Workman,DEM,400113,3,5,71,79,
Leflore,Commissioner of Labor,Mark Costello,REP,400113,4,10,86,100,
Leflore,U.S. Senate,Matt Silverstein,DEM,400113,4,3,35,42,
Leflore,U.S. Senate,Jim Inhofe,REP,400113,3,11,116,130,
Leflore,U.S. Senate,Aaron Delozier,IND,400113,0,0,1,1,
Leflore,U.S. Senate,Ray Woods,IND,400113,1,0,2,3,
Leflore,U.S. Senate,Joan Farr,IND,400113,0,1,4,5,
Leflore,U.S. Senate,Connie Johnson,DEM,400113,4,2,50,56,
Leflore,U.S. Senate,James Lankford,REP,400113,4,12,100,116,
Leflore,U.S. Senate,Mark Beard,IND,400113,0,1,10,11,
Leflore,U.S. House,Earl Everett,DEM,400113,4,2,49,55,02
Leflore,U.S. House,Markwayne Mullin,REP,400113,3,13,102,118,02
Leflore,U.S. House,Jon Douthitt,IND,400113,0,0,8,8,02
Leflore,State Senate,Ann Weaver,DEM,400113,3,4,48,55,4
Leflore,State Senate,Mark Allen,REP,400113,5,11,114,130,4
Leflore,Governor,Joe Dorman,DEM,400114,0,0,41,41,
Leflore,Governor,Mary Fallin,REP,400114,0,1,38,39,
Leflore,Governor,Kimberly Willis,IND,400114,0,0,3,3,
Leflore,Governor,Richard Prawdzienski,IND,400114,0,0,1,1,
Leflore,Lieutenant Governor,Cathy Cummings,DEM,400114,0,1,40,41,
Leflore,Lieutenant Governor,Todd Lamb,REP,400114,0,0,42,42,
Leflore,Superintendent of Public Instruction,John Cox,DEM,400114,0,0,51,51,
Leflore,Superintendent of Public Instruction,Joy Hofmeister,REP,400114,0,1,33,34,
Leflore,Commissioner of Labor,Mike Workman,DEM,400114,0,0,40,40,
Leflore,Commissioner of Labor,Mark Costello,REP,400114,0,1,42,43,
Leflore,U.S. Senate,Matt Silverstein,DEM,400114,0,0,34,34,
Leflore,U.S. Senate,Jim Inhofe,REP,400114,0,0,44,44,
Leflore,U.S. Senate,Aaron Delozier,IND,400114,0,1,1,2,
Leflore,U.S. Senate,Ray Woods,IND,400114,0,0,4,4,
Leflore,U.S. Senate,Joan Farr,IND,400114,0,0,0,0,
Leflore,U.S. Senate,Connie Johnson,DEM,400114,0,0,33,33,
Leflore,U.S. Senate,James Lankford,REP,400114,0,0,45,45,
Leflore,U.S. Senate,Mark Beard,IND,400114,0,1,5,6,
Leflore,U.S. House,Earl Everett,DEM,400114,0,0,28,28,02
Leflore,U.S. House,Markwayne Mullin,REP,400114,0,0,47,47,02
Leflore,U.S. House,Jon Douthitt,IND,400114,0,1,8,9,02
Leflore,State Senate,Ann Weaver,DEM,400114,0,0,45,45,4
Leflore,State Senate,Mark Allen,REP,400114,0,1,39,40,4
Leflore,Governor,Joe Dorman,DEM,400201,0,0,20,20,
Leflore,Governor,Mary Fallin,REP,400201,0,4,36,40,
Leflore,Governor,Kimberly Willis,IND,400201,0,2,0,2,
Leflore,Governor,Richard Prawdzienski,IND,400201,0,0,5,5,
Leflore,Lieutenant Governor,Cathy Cummings,DEM,400201,0,1,10,11,
Leflore,Lieutenant Governor,Todd Lamb,REP,400201,0,5,50,55,
Leflore,Superintendent of Public Instruction,John Cox,DEM,400201,0,1,29,30,
Leflore,Superintendent of Public Instruction,Joy Hofmeister,REP,400201,0,5,31,36,
Leflore,Commissioner of Labor,Mike Workman,DEM,400201,0,0,19,19,
Leflore,Commissioner of Labor,Mark Costello,REP,400201,0,5,41,46,
Leflore,U.S. Senate,Matt Silverstein,DEM,400201,0,0,13,13,
Leflore,U.S. Senate,Jim Inhofe,REP,400201,0,6,43,49,
Leflore,U.S. Senate,Aaron Delozier,IND,400201,0,0,1,1,
Leflore,U.S. Senate,Ray Woods,IND,400201,0,0,1,1,
Leflore,U.S. Senate,Joan Farr,IND,400201,0,0,1,1,
Leflore,U.S. Senate,Connie Johnson,DEM,400201,0,0,13,13,
Leflore,U.S. Senate,James Lankford,REP,400201,0,6,46,52,
Leflore,U.S. Senate,Mark Beard,IND,400201,0,0,2,2,
Leflore,U.S. House,Earl Everett,DEM,400201,0,0,13,13,02
Leflore,U.S. House,Markwayne Mullin,REP,400201,0,6,47,53,02
Leflore,U.S. House,Jon Douthitt,IND,400201,0,0,1,1,02
Leflore,State Senate,Ann Weaver,DEM,400201,0,0,18,18,4
Leflore,State Senate,Mark Allen,REP,400201,0,6,43,49,4
Leflore,Governor,Joe Dorman,DEM,400202,2,6,45,53,
Leflore,Governor,Mary Fallin,REP,400202,3,3,41,47,
Leflore,Governor,Kimberly Willis,IND,400202,0,0,3,3,
Leflore,Governor,Richard Prawdzienski,IND,400202,0,0,2,2,
Leflore,Lieutenant Governor,Cathy Cummings,DEM,400202,2,4,39,45,
Leflore,Lieutenant Governor,Todd Lamb,REP,400202,3,4,52,59,
Leflore,Superintendent of Public Instruction,John Cox,DEM,400202,3,5,51,59,
Leflore,Superintendent of Public Instruction,Joy Hofmeister,REP,400202,2,3,39,44,
Leflore,Commissioner of Labor,Mike Workman,DEM,400202,3,5,44,52,
Leflore,Commissioner of Labor,Mark Costello,REP,400202,2,3,43,48,
Leflore,U.S. Senate,Matt Silverstein,DEM,400202,2,4,34,40,
Leflore,U.S. Senate,Jim Inhofe,REP,400202,3,4,51,58,
Leflore,U.S. Senate,Aaron Delozier,IND,400202,0,0,1,1,
Leflore,U.S. Senate,Ray Woods,IND,400202,0,0,3,3,
Leflore,U.S. Senate,Joan Farr,IND,400202,0,0,1,1,
Leflore,U.S. Senate,Connie Johnson,DEM,400202,2,4,31,37,
Leflore,U.S. Senate,James Lankford,REP,400202,3,4,55,62,
Leflore,U.S. Senate,Mark Beard,IND,400202,0,0,4,4,
Leflore,U.S. House,Earl Everett,DEM,400202,1,4,30,35,02
Leflore,U.S. House,Markwayne Mullin,REP,400202,3,4,55,62,02
Leflore,U.S. House,Jon Douthitt,IND,400202,1,0,4,5,02
Leflore,State Senate,Curtis Mcdaniel,DEM,400202,3,5,43,51,5
Leflore,State Senate,Joseph Silk,REP,400202,2,3,46,51,5
Leflore,State House,James Lockhart,DEM,400202,3,7,65,75,3
Leflore,State House,Traci Barnes,REP,400202,2,3,26,31,3
Leflore,Governor,Joe Dorman,DEM,400203,6,50,273,329,
Leflore,Governor,Mary Fallin,REP,400203,5,62,362,429,
Leflore,Governor,Kimberly Willis,IND,400203,0,8,17,25,
Leflore,Governor,Richard Prawdzienski,IND,400203,0,0,9,9,
Leflore,Lieutenant Governor,Cathy Cummings,DEM,400203,3,43,233,279,
Leflore,Lieutenant Governor,Todd Lamb,REP,400203,8,76,419,503,
Leflore,Superintendent of Public Instruction,John Cox,DEM,400203,6,63,328,397,
Leflore,Superintendent of Public Instruction,Joy Hofmeister,REP,400203,4,56,325,385,
Leflore,Commissioner of Labor,Mike Workman,DEM,400203,3,57,252,312,
Leflore,Commissioner of Labor,Mark Costello,REP,400203,7,60,385,452,
Leflore,U.S. Senate,Matt Silverstein,DEM,400203,1,31,183,215,
Leflore,U.S. Senate,Jim Inhofe,REP,400203,10,82,439,531,
Leflore,U.S. Senate,Aaron Delozier,IND,400203,0,0,6,6,
Leflore,U.S. Senate,Ray Woods,IND,400203,0,1,14,15,
Leflore,U.S. Senate,Joan Farr,IND,400203,0,4,17,21,
Leflore,U.S. Senate,Connie Johnson,DEM,400203,1,35,180,216,
Leflore,U.S. Senate,James Lankford,REP,400203,9,74,437,520,
Leflore,U.S. Senate,Mark Beard,IND,400203,0,9,37,46,
Leflore,U.S. House,Earl Everett,DEM,400203,3,30,158,191,02
Leflore,U.S. House,Markwayne Mullin,REP,400203,7,80,457,544,02
Leflore,U.S. House,Jon Douthitt,IND,400203,0,9,40,49,02
Leflore,State Senate,Ann Weaver,DEM,400203,4,61,269,334,4
Leflore,State Senate,Mark Allen,REP,400203,7,59,390,456,4
Leflore,State House,James Lockhart,DEM,400203,1,77,320,398,3
Leflore,State House,Traci Barnes,REP,400203,10,45,340,395,3
Leflore,Governor,Joe Dorman,DEM,400204,1,24,180,205,
Leflore,Governor,Mary Fallin,REP,400204,3,16,229,248,
Leflore,Governor,Kimberly Willis,IND,400204,0,3,13,16,
Leflore,Governor,Richard Prawdzienski,IND,400204,0,0,3,3,
Leflore,Lieutenant Governor,Cathy Cummings,DEM,400204,1,21,164,186,
Leflore,Lieutenant Governor,Todd Lamb,REP,400204,3,21,257,281,
Leflore,Superintendent of Public Instruction,John Cox,DEM,400204,1,24,232,257,
Leflore,Superintendent of Public Instruction,Joy Hofmeister,REP,400204,3,18,185,206,
Leflore,Commissioner of Labor,Mike Workman,DEM,400204,1,21,169,191,
Leflore,Commissioner of Labor,Mark Costello,REP,400204,3,20,243,266,
Leflore,U.S. Senate,Matt Silverstein,DEM,400204,1,14,131,146,
Leflore,U.S. Senate,Jim Inhofe,REP,400204,3,28,269,300,
Leflore,U.S. Senate,Aaron Delozier,IND,400204,0,0,3,3,
Leflore,U.S. Senate,Ray Woods,IND,400204,0,0,7,7,
Leflore,U.S. Senate,Joan Farr,IND,400204,0,1,9,10,
Leflore,U.S. Senate,Connie Johnson,DEM,400204,1,17,142,160,
Leflore,U.S. Senate,James Lankford,REP,400204,3,23,261,287,
Leflore,U.S. Senate,Mark Beard,IND,400204,0,1,17,18,
Leflore,U.S. House,Earl Everett,DEM,400204,1,15,128,144,02
Leflore,U.S. House,Markwayne Mullin,REP,400204,3,26,272,301,02
Leflore,U.S. House,Jon Douthitt,IND,400204,0,1,23,24,02
Leflore,State Senate,Ann Weaver,DEM,400204,1,27,188,216,4
Leflore,State Senate,Mark Allen,REP,400204,3,16,236,255,4
Leflore,State House,James Lockhart,DEM,400204,2,30,216,248,3
Leflore,State House,Traci Barnes,REP,400204,2,14,209,225,3
Leflore,Governor,Joe Dorman,DEM,400205,5,10,84,99,
Leflore,Governor,Mary Fallin,REP,400205,3,14,79,96,
Leflore,Governor,Kimberly Willis,IND,400205,0,0,7,7,
Leflore,Governor,Richard Prawdzienski,IND,400205,0,0,2,2,
Leflore,Lieutenant Governor,Cathy Cummings,DEM,400205,1,10,78,89,
Leflore,Lieutenant Governor,Todd Lamb,REP,400205,7,14,94,115,
Leflore,Superintendent of Public Instruction,John Cox,DEM,400205,7,14,100,121,
Leflore,Superintendent of Public Instruction,Joy Hofmeister,REP,400205,1,10,70,81,
Leflore,Commissioner of Labor,Mike Workman,DEM,400205,7,11,84,102,
Leflore,Commissioner of Labor,Mark Costello,REP,400205,1,12,84,97,
Leflore,U.S. Senate,Matt Silverstein,DEM,400205,5,7,64,76,
Leflore,U.S. Senate,Jim Inhofe,REP,400205,3,14,100,117,
Leflore,U.S. Senate,Aaron Delozier,IND,400205,0,0,0,0,
Leflore,U.S. Senate,Ray Woods,IND,400205,0,2,4,6,
Leflore,U.S. Senate,Joan Farr,IND,400205,0,1,3,4,
Leflore,U.S. Senate,Connie Johnson,DEM,400205,4,7,70,81,
Leflore,U.S. Senate,James Lankford,REP,400205,3,17,92,112,
Leflore,U.S. Senate,Mark Beard,IND,400205,1,0,5,6,
Leflore,U.S. House,Earl Everett,DEM,400205,5,9,60,74,02
Leflore,U.S. House,Markwayne Mullin,REP,400205,3,15,101,119,02
Leflore,U.S. House,Jon Douthitt,IND,400205,0,0,8,8,02
Leflore,State Senate,Ann Weaver,DEM,400205,4,10,91,105,4
Leflore,State Senate,Mark Allen,REP,400205,4,14,81,99,4
Leflore,State House,James Lockhart,DEM,400205,6,15,113,134,3
Leflore,State House,Traci Barnes,REP,400205,2,8,58,68,3
Leflore,Governor,Joe Dorman,DEM,400207,0,23,134,157,
Leflore,Governor,Mary Fallin,REP,400207,0,30,186,216,
Leflore,Governor,Kimberly Willis,IND,400207,0,2,20,22,
Leflore,Governor,Richard Prawdzienski,IND,400207,0,0,5,5,
Leflore,Lieutenant Governor,Cathy Cummings,DEM,400207,0,19,126,145,
Leflore,Lieutenant Governor,Todd Lamb,REP,400207,0,36,217,253,
Leflore,Superintendent of Public Instruction,John Cox,DEM,400207,0,26,174,200,
Leflore,Superintendent of Public Instruction,Joy Hofmeister,REP,400207,0,27,164,191,
Leflore,Commissioner of Labor,Mike Workman,DEM,400207,0,22,133,155,
Leflore,Commissioner of Labor,Mark Costello,REP,400207,0,33,201,234,
Leflore,U.S. Senate,Matt Silverstein,DEM,400207,0,13,89,102,
Leflore,U.S. Senate,Jim Inhofe,REP,400207,0,41,224,265,
Leflore,U.S. Senate,Aaron Delozier,IND,400207,0,0,4,4,
Leflore,U.S. Senate,Ray Woods,IND,400207,0,0,8,8,
Leflore,U.S. Senate,Joan Farr,IND,400207,0,2,17,19,
Leflore,U.S. Senate,Connie Johnson,DEM,400207,0,15,99,114,
Leflore,U.S. Senate,James Lankford,REP,400207,0,37,219,256,
Leflore,U.S. Senate,Mark Beard,IND,400207,0,3,21,24,
Leflore,U.S. House,Earl Everett,DEM,400207,0,14,82,96,02
Leflore,U.S. House,Markwayne Mullin,REP,400207,0,39,228,267,02
Leflore,U.S. House,Jon Douthitt,IND,400207,0,1,28,29,02
Leflore,State Senate,Ann Weaver,DEM,400207,0,26,142,168,4
Leflore,State Senate,Mark Allen,REP,400207,0,28,200,228,4
Leflore,State House,James Lockhart,DEM,400207,0,27,172,199,3
Leflore,State House,Traci Barnes,REP,400207,0,27,170,197,3
Leflore,Governor,Joe Dorman,DEM,400208,3,17,148,168,
Leflore,Governor,Mary Fallin,REP,400208,5,20,180,205,
Leflore,Governor,Kimberly Willis,IND,400208,1,0,27,28,
Leflore,Governor,Richard Prawdzienski,IND,400208,0,1,4,5,
Leflore,Lieutenant Governor,Cathy Cummings,DEM,400208,5,17,141,163,
Leflore,Lieutenant Governor,Todd Lamb,REP,400208,4,21,220,245,
Leflore,Superintendent of Public Instruction,John Cox,DEM,400208,6,22,188,216,
Leflore,Superintendent of Public Instruction,Joy Hofmeister,REP,400208,3,16,163,182,
Leflore,Commissioner of Labor,Mike Workman,DEM,400208,6,16,144,166,
Leflore,Commissioner of Labor,Mark Costello,REP,400208,3,22,205,230,
Leflore,U.S. Senate,Matt Silverstein,DEM,400208,3,12,111,126,
Leflore,U.S. Senate,Jim Inhofe,REP,400208,6,23,224,253,
Leflore,U.S. Senate,Aaron Delozier,IND,400208,0,0,3,3,
Leflore,U.S. Senate,Ray Woods,IND,400208,0,1,8,9,
Leflore,U.S. Senate,Joan Farr,IND,400208,0,1,11,12,
Leflore,U.S. Senate,Connie Johnson,DEM,400208,5,13,120,138,
Leflore,U.S. Senate,James Lankford,REP,400208,4,23,200,227,
Leflore,U.S. Senate,Mark Beard,IND,400208,0,1,30,31,
Leflore,U.S. House,Earl Everett,DEM,400208,3,12,109,124,02
Leflore,U.S. House,Markwayne Mullin,REP,400208,4,25,214,243,02
Leflore,U.S. House,Jon Douthitt,IND,400208,2,0,29,31,02
Leflore,State Senate,Ann Weaver,DEM,400208,3,16,162,181,4
Leflore,State Senate,Mark Allen,REP,400208,6,22,199,227,4
Leflore,State House,James Lockhart,DEM,400208,7,29,218,254,3
Leflore,State House,Traci Barnes,REP,400208,2,9,142,153,3
Leflore,Governor,Joe Dorman,DEM,400210,1,28,142,171,
Leflore,Governor,Mary Fallin,REP,400210,6,22,221,249,
Leflore,Governor,Kimberly Willis,IND,400210,0,0,9,9,
Leflore,Governor,Richard Prawdzienski,IND,400210,0,0,3,3,
Leflore,Lieutenant Governor,Cathy Cummings,DEM,400210,1,15,124,140,
Leflore,Lieutenant Governor,Todd Lamb,REP,400210,6,34,250,290,
Leflore,Superintendent of Public Instruction,John Cox,DEM,400210,1,34,193,228,
Leflore,Superintendent of Public Instruction,Joy Hofmeister,REP,400210,6,16,180,202,
Leflore,Commissioner of Labor,Mike Workman,DEM,400210,0,21,126,147,
Leflore,Commissioner of Labor,Mark Costello,REP,400210,7,29,243,279,
Leflore,U.S. Senate,Matt Silverstein,DEM,400210,0,12,94,106,
Leflore,U.S. Senate,Jim Inhofe,REP,400210,7,38,271,316,
Leflore,U.S. Senate,Aaron Delozier,IND,400210,0,0,2,2,
Leflore,U.S. Senate,Ray Woods,IND,400210,0,0,3,3,
Leflore,U.S. Senate,Joan Farr,IND,400210,0,0,4,4,
Leflore,U.S. Senate,Connie Johnson,DEM,400210,0,16,100,116,
Leflore,U.S. Senate,James Lankford,REP,400210,7,34,254,295,
Leflore,U.S. Senate,Mark Beard,IND,400210,0,0,17,17,
Leflore,U.S. House,Earl Everett,DEM,400210,0,12,84,96,02
Leflore,U.S. House,Markwayne Mullin,REP,400210,7,36,272,315,02
Leflore,U.S. House,Jon Douthitt,IND,400210,0,2,14,16,02
Leflore,State Senate,Ann Weaver,DEM,400210,1,23,141,165,4
Leflore,State Senate,Mark Allen,REP,400210,6,27,233,266,4
Leflore,State House,James Lockhart,DEM,400210,2,34,205,241,3
Leflore,State House,Traci Barnes,REP,400210,5,16,169,190,3
Leflore,Governor,Joe Dorman,DEM,400211,0,10,150,160,
Leflore,Governor,Mary Fallin,REP,400211,0,4,155,159,
Leflore,Governor,Kimberly Willis,IND,400211,0,0,12,12,
Leflore,Governor,Richard Prawdzienski,IND,400211,0,0,8,8,
Leflore,Lieutenant Governor,Cathy Cummings,DEM,400211,0,5,137,142,
Leflore,Lieutenant Governor,Todd Lamb,REP,400211,0,9,184,193,
Leflore,Superintendent of Public Instruction,John Cox,DEM,400211,0,10,191,201,
Leflore,Superintendent of Public Instruction,Joy Hofmeister,REP,400211,0,4,132,136,
Leflore,Commissioner of Labor,Mike Workman,DEM,400211,0,9,147,156,
Leflore,Commissioner of Labor,Mark Costello,REP,400211,0,5,169,174,
Leflore,U.S. Senate,Matt Silverstein,DEM,400211,0,4,96,100,
Leflore,U.S. Senate,Jim Inhofe,REP,400211,0,9,204,213,
Leflore,U.S. Senate,Aaron Delozier,IND,400211,0,0,8,8,
Leflore,U.S. Senate,Ray Woods,IND,400211,0,1,6,7,
Leflore,U.S. Senate,Joan Farr,IND,400211,0,0,11,11,
Leflore,U.S. Senate,Connie Johnson,DEM,400211,0,7,111,118,
Leflore,U.S. Senate,James Lankford,REP,400211,0,7,186,193,
Leflore,U.S. Senate,Mark Beard,IND,400211,0,0,20,20,
Leflore,U.S. House,Earl Everett,DEM,400211,0,6,100,106,02
Leflore,U.S. House,Markwayne Mullin,REP,400211,0,8,200,208,02
Leflore,U.S. House,Jon Douthitt,IND,400211,0,0,17,17,02
Leflore,State Senate,Curtis Mcdaniel,DEM,400211,0,10,160,170,5
Leflore,State Senate,Joseph Silk,REP,400211,0,4,160,164,5
Leflore,State House,James Lockhart,DEM,400211,0,13,197,210,3
Leflore,State House,Traci Barnes,REP,400211,0,1,127,128,3
Leflore,Governor,Joe Dorman,DEM,400212,3,22,216,241,
Leflore,Governor,Mary Fallin,REP,400212,5,33,237,275,
Leflore,Governor,Kimberly Willis,IND,400212,0,0,13,13,
Leflore,Governor,Richard Prawdzienski,IND,400212,0,0,11,11,
Leflore,Lieutenant Governor,Cathy Cummings,DEM,400212,3,21,192,216,
Leflore,Lieutenant Governor,Todd Lamb,REP,400212,5,34,275,314,
Leflore,Superintendent of Public Instruction,John Cox,DEM,400212,5,31,285,321,
Leflore,Superintendent of Public Instruction,Joy Hofmeister,REP,400212,3,24,182,209,
Leflore,Commissioner of Labor,Mike Workman,DEM,400212,3,23,213,239,
Leflore,Commissioner of Labor,Mark Costello,REP,400212,5,32,245,282,
Leflore,U.S. Senate,Matt Silverstein,DEM,400212,2,15,134,151,
Leflore,U.S. Senate,Jim Inhofe,REP,400212,6,38,323,367,
Leflore,U.S. Senate,Aaron Delozier,IND,400212,0,0,1,1,
Leflore,U.S. Senate,Ray Woods,IND,400212,0,1,6,7,
Leflore,U.S. Senate,Joan Farr,IND,400212,0,1,8,9,
Leflore,U.S. Senate,Connie Johnson,DEM,400212,2,15,160,177,
Leflore,U.S. Senate,James Lankford,REP,400212,6,39,277,322,
Leflore,U.S. Senate,Mark Beard,IND,400212,0,1,34,35,
Leflore,U.S. House,Earl Everett,DEM,400212,2,16,131,149,02
Leflore,U.S. House,Markwayne Mullin,REP,400212,6,36,294,336,02
Leflore,U.S. House,Jon Douthitt,IND,400212,0,2,42,44,02
Leflore,State Senate,Ann Weaver,DEM,400212,3,25,228,256,4
Leflore,State Senate,Mark Allen,REP,400212,5,30,246,281,4
Leflore,State House,James Lockhart,DEM,400212,5,30,289,324,3
Leflore,State House,Traci Barnes,REP,400212,3,25,185,213,3
Leflore,Governor,Joe Dorman,DEM,400213,1,2,22,25,
Leflore,Governor,Mary Fallin,REP,400213,0,2,22,24,
Leflore,Governor,Kimberly Willis,IND,400213,0,0,1,1,
Leflore,Governor,Richard Prawdzienski,IND,400213,0,0,4,4,
Leflore,Lieutenant Governor,Cathy Cummings,DEM,400213,1,2,17,20,
Leflore,Lieutenant Governor,Todd Lamb,REP,400213,0,2,30,32,
Leflore,Superintendent of Public Instruction,John Cox,DEM,400213,1,2,27,30,
Leflore,Superintendent of Public Instruction,Joy Hofmeister,REP,400213,0,2,22,24,
Leflore,Commissioner of Labor,Mike Workman,DEM,400213,1,2,21,24,
Leflore,Commissioner of Labor,Mark Costello,REP,400213,0,2,27,29,
Leflore,U.S. Senate,Matt Silverstein,DEM,400213,0,2,13,15,
Leflore,U.S. Senate,Jim Inhofe,REP,400213,1,2,32,35,
Leflore,U.S. Senate,Aaron Delozier,IND,400213,0,0,2,2,
Leflore,U.S. Senate,Ray Woods,IND,400213,0,0,1,1,
Leflore,U.S. Senate,Joan Farr,IND,400213,0,0,1,1,
Leflore,U.S. Senate,Connie Johnson,DEM,400213,0,2,14,16,
Leflore,U.S. Senate,James Lankford,REP,400213,0,2,31,33,
Leflore,U.S. Senate,Mark Beard,IND,400213,0,0,2,2,
Leflore,U.S. House,Earl Everett,DEM,400213,0,1,14,15,02
Leflore,U.S. House,Markwayne Mullin,REP,400213,1,2,28,31,02
Leflore,U.S. House,Jon Douthitt,IND,400213,0,1,6,7,02
Leflore,State Senate,Curtis Mcdaniel,DEM,400213,1,3,24,28,5
Leflore,State Senate,Joseph Silk,REP,400213,0,1,24,25,5
Leflore,State House,Brian Renegar,DEM,400213,1,2,25,28,17
Leflore,State House,Micah Thompson,REP,400213,0,2,23,25,17
Leflore,Governor,Joe Dorman,DEM,400214,2,1,37,40,
Leflore,Governor,Mary Fallin,REP,400214,0,0,20,20,
Leflore,Governor,Kimberly Willis,IND,400214,0,1,1,2,
Leflore,Governor,Richard Prawdzienski,IND,400214,0,0,2,2,
Leflore,Lieutenant Governor,Cathy Cummings,DEM,400214,1,1,26,28,
Leflore,Lieutenant Governor,Todd Lamb,REP,400214,1,1,33,35,
Leflore,Superintendent of Public Instruction,John Cox,DEM,400214,2,1,47,50,
Leflore,Superintendent of Public Instruction,Joy Hofmeister,REP,400214,0,1,11,12,
Leflore,Commissioner of Labor,Mike Workman,DEM,400214,2,1,36,39,
Leflore,Commissioner of Labor,Mark Costello,REP,400214,0,1,23,24,
Leflore,U.S. Senate,Matt Silverstein,DEM,400214,1,1,27,29,
Leflore,U.S. Senate,Jim Inhofe,REP,400214,1,1,31,33,
Leflore,U.S. Senate,Aaron Delozier,IND,400214,0,0,0,0,
Leflore,U.S. Senate,Ray Woods,IND,400214,0,0,4,4,
Leflore,U.S. Senate,Joan Farr,IND,400214,0,0,0,0,
Leflore,U.S. Senate,Connie Johnson,DEM,400214,1,0,28,29,
Leflore,U.S. Senate,James Lankford,REP,400214,1,2,23,26,
Leflore,U.S. Senate,Mark Beard,IND,400214,0,0,8,8,
Leflore,U.S. House,Earl Everett,DEM,400214,1,0,28,29,02
Leflore,U.S. House,Markwayne Mullin,REP,400214,1,2,22,25,02
Leflore,U.S. House,Jon Douthitt,IND,400214,0,0,9,9,02
Leflore,State Senate,Curtis Mcdaniel,DEM,400214,2,1,39,42,5
Leflore,State Senate,Joseph Silk,REP,400214,0,1,20,21,5
Leflore,State House,Brian Renegar,DEM,400214,2,2,38,42,17
Leflore,State House,Micah Thompson,REP,400214,0,0,21,21,17
Leflore,Governor,Joe Dorman,DEM,400215,1,2,86,89,
Leflore,Governor,Mary Fallin,REP,400215,2,3,62,67,
Leflore,Governor,Kimberly Willis,IND,400215,0,0,10,10,
Leflore,Governor,Richard Prawdzienski,IND,400215,0,0,1,1,
Leflore,Lieutenant Governor,Cathy Cummings,DEM,400215,1,0,62,63,
Leflore,Lieutenant Governor,Todd Lamb,REP,400215,2,4,93,99,
Leflore,Superintendent of Public Instruction,John Cox,DEM,400215,3,2,115,120,
Leflore,Superintendent of Public Instruction,Joy Hofmeister,REP,400215,0,3,45,48,
Leflore,Commissioner of Labor,Mike Workman,DEM,400215,2,0,75,77,
Leflore,Commissioner of Labor,Mark Costello,REP,400215,1,4,82,87,
Leflore,U.S. Senate,Matt Silverstein,DEM,400215,2,1,58,61,
Leflore,U.S. Senate,Jim Inhofe,REP,400215,1,3,98,102,
Leflore,U.S. Senate,Aaron Delozier,IND,400215,0,0,0,0,
Leflore,U.S. Senate,Ray Woods,IND,400215,0,0,0,0,
Leflore,U.S. Senate,Joan Farr,IND,400215,0,1,3,4,
Leflore,U.S. Senate,Connie Johnson,DEM,400215,1,0,55,56,
Leflore,U.S. Senate,James Lankford,REP,400215,2,3,96,101,
Leflore,U.S. Senate,Mark Beard,IND,400215,0,1,8,9,
Leflore,U.S. House,Earl Everett,DEM,400215,2,0,59,61,02
Leflore,U.S. House,Markwayne Mullin,REP,400215,1,5,95,101,02
Leflore,U.S. House,Jon Douthitt,IND,400215,0,0,6,6,02
Leflore,State Senate,Curtis Mcdaniel,DEM,400215,2,1,84,87,5
Leflore,State Senate,Joseph Silk,REP,400215,1,4,73,78,5
Leflore,State House,Brian Renegar,DEM,400215,2,1,89,92,17
Leflore,State House,Micah Thompson,REP,400215,1,4,70,75,17
Leflore,Governor,Joe Dorman,DEM,400301,1,0,85,86,
Leflore,Governor,Mary Fallin,REP,400301,3,0,73,76,
Leflore,Governor,Kimberly Willis,IND,400301,0,0,2,2,
Leflore,Governor,Richard Prawdzienski,IND,400301,0,0,5,5,
Leflore,Lieutenant Governor,Cathy Cummings,DEM,400301,1,0,63,64,
Leflore,Lieutenant Governor,Todd Lamb,REP,400301,3,0,100,103,
Leflore,Superintendent of Public Instruction,John Cox,DEM,400301,3,0,101,104,
Leflore,Superintendent of Public Instruction,Joy Hofmeister,REP,400301,1,0,65,66,
Leflore,Commissioner of Labor,Mike Workman,DEM,400301,1,0,83,84,
Leflore,Commissioner of Labor,Mark Costello,REP,400301,3,0,82,85,
Leflore,U.S. Senate,Matt Silverstein,DEM,400301,0,0,55,55,
Leflore,U.S. Senate,Jim Inhofe,REP,400301,4,0,101,105,
Leflore,U.S. Senate,Aaron Delozier,IND,400301,0,0,2,2,
Leflore,U.S. Senate,Ray Woods,IND,400301,0,0,3,3,
Leflore,U.S. Senate,Joan Farr,IND,400301,0,0,2,2,
Leflore,U.S. Senate,Connie Johnson,DEM,400301,0,0,59,59,
Leflore,U.S. Senate,James Lankford,REP,400301,3,0,96,99,
Leflore,U.S. Senate,Mark Beard,IND,400301,1,0,10,11,
Leflore,U.S. House,Earl Everett,DEM,400301,0,0,54,54,02
Leflore,U.S. House,Markwayne Mullin,REP,400301,4,0,104,108,02
Leflore,U.S. House,Jon Douthitt,IND,400301,0,0,5,5,02
Leflore,State Senate,Curtis Mcdaniel,DEM,400301,0,0,78,78,5
Leflore,State Senate,Joseph Silk,REP,400301,4,0,86,90,5
Leflore,State House,Brian Renegar,DEM,400301,1,0,80,81,17
Leflore,State House,Micah Thompson,REP,400301,3,0,83,86,17
Leflore,Governor,Joe Dorman,DEM,400302,0,4,130,134,
Leflore,Governor,Mary Fallin,REP,400302,4,2,116,122,
Leflore,Governor,Kimberly Willis,IND,400302,0,0,7,7,
Leflore,Governor,Richard Prawdzienski,IND,400302,0,0,4,4,
Leflore,Lieutenant Governor,Cathy Cummings,DEM,400302,0,3,94,97,
Leflore,Lieutenant Governor,Todd Lamb,REP,400302,4,3,159,166,
Leflore,Superintendent of Public Instruction,John Cox,DEM,400302,0,5,154,159,
Leflore,Superintendent of Public Instruction,Joy Hofmeister,REP,400302,4,1,101,106,
Leflore,Commissioner of Labor,Mike Workman,DEM,400302,0,4,115,119,
Leflore,Commissioner of Labor,Mark Costello,REP,400302,4,2,133,139,
Leflore,U.S. Senate,Matt Silverstein,DEM,400302,0,3,70,73,
Leflore,U.S. Senate,Jim Inhofe,REP,400302,4,3,164,171,
Leflore,U.S. Senate,Aaron Delozier,IND,400302,0,0,9,9,
Leflore,U.S. Senate,Ray Woods,IND,400302,0,0,8,8,
Leflore,U.S. Senate,Joan Farr,IND,400302,0,0,4,4,
Leflore,U.S. Senate,Connie Johnson,DEM,400302,0,3,76,79,
Leflore,U.S. Senate,James Lankford,REP,400302,4,3,156,163,
Leflore,U.S. Senate,Mark Beard,IND,400302,0,0,21,21,
Leflore,U.S. House,Earl Everett,DEM,400302,0,3,70,73,02
Leflore,U.S. House,Markwayne Mullin,REP,400302,4,3,172,179,02
Leflore,U.S. House,Jon Douthitt,IND,400302,0,0,13,13,02
Leflore,State Senate,Curtis Mcdaniel,DEM,400302,0,5,125,130,5
Leflore,State Senate,Joseph Silk,REP,400302,4,1,128,133,5
Leflore,State House,Johnny Tadlock,DEM,400302,0,4,119,123,1
Leflore,State House,J. Longacre,REP,400302,4,2,131,137,1
Leflore,Governor,Joe Dorman,DEM,400303,0,1,41,42,
Leflore,Governor,Mary Fallin,REP,400303,0,0,56,56,
Leflore,Governor,Kimberly Willis,IND,400303,0,0,6,6,
Leflore,Governor,Richard Prawdzienski,IND,400303,1,0,5,6,
Leflore,Lieutenant Governor,Cathy Cummings,DEM,400303,0,1,30,31,
Leflore,Lieutenant Governor,Todd Lamb,REP,400303,1,0,77,78,
Leflore,Superintendent of Public Instruction,John Cox,DEM,400303,0,0,55,55,
Leflore,Superintendent of Public Instruction,Joy Hofmeister,REP,400303,1,1,53,55,
Leflore,Commissioner of Labor,Mike Workman,DEM,400303,0,1,44,45,
Leflore,Commissioner of Labor,Mark Costello,REP,400303,1,0,61,62,
Leflore,U.S. Senate,Matt Silverstein,DEM,400303,0,1,28,29,
Leflore,U.S. Senate,Jim Inhofe,REP,400303,1,0,69,70,
Leflore,U.S. Senate,Aaron Delozier,IND,400303,0,0,0,0,
Leflore,U.S. Senate,Ray Woods,IND,400303,0,0,3,3,
Leflore,U.S. Senate,Joan Farr,IND,400303,0,0,3,3,
Leflore,U.S. Senate,Connie Johnson,DEM,400303,0,1,28,29,
Leflore,U.S. Senate,James Lankford,REP,400303,1,0,66,67,
Leflore,U.S. Senate,Mark Beard,IND,400303,0,0,12,12,
Leflore,U.S. House,Earl Everett,DEM,400303,0,1,27,28,02
Leflore,U.S. House,Markwayne Mullin,REP,400303,1,0,63,64,02
Leflore,U.S. House,Jon Douthitt,IND,400303,0,0,13,13,02
Leflore,State Senate,Curtis Mcdaniel,DEM,400303,0,1,43,44,5
Leflore,State Senate,Joseph Silk,REP,400303,1,0,62,63,5
Leflore,State House,Johnny Tadlock,DEM,400303,0,1,39,40,1
Leflore,State House,J. Longacre,REP,400303,1,0,63,64,1
Leflore,Governor,Joe Dorman,DEM,400304,0,1,45,46,
Leflore,Governor,Mary Fallin,REP,400304,1,3,91,95,
Leflore,Governor,Kimberly Willis,IND,400304,0,0,5,5,
Leflore,Governor,Richard Prawdzienski,IND,400304,0,0,2,2,
Leflore,Lieutenant Governor,Cathy Cummings,DEM,400304,0,1,40,41,
Leflore,Lieutenant Governor,Todd Lamb,REP,400304,1,3,98,102,
Leflore,Superintendent of Public Instruction,John Cox,DEM,400304,0,1,69,70,
Leflore,Superintendent of Public Instruction,Joy Hofmeister,REP,400304,1,2,72,75,
Leflore,Commissioner of Labor,Mike Workman,DEM,400304,0,1,47,48,
Leflore,Commissioner of Labor,Mark Costello,REP,400304,1,2,88,91,
Leflore,U.S. Senate,Matt Silverstein,DEM,400304,0,1,29,30,
Leflore,U.S. Senate,Jim Inhofe,REP,400304,1,3,107,111,
Leflore,U.S. Senate,Aaron Delozier,IND,400304,0,0,0,0,
Leflore,U.S. Senate,Ray Woods,IND,400304,0,0,3,3,
Leflore,U.S. Senate,Joan Farr,IND,400304,0,0,3,3,
Leflore,U.S. Senate,Connie Johnson,DEM,400304,0,1,32,33,
Leflore,U.S. Senate,James Lankford,REP,400304,1,3,101,105,
Leflore,U.S. Senate,Mark Beard,IND,400304,0,0,5,5,
Leflore,U.S. House,Earl Everett,DEM,400304,0,1,28,29,02
Leflore,U.S. House,Markwayne Mullin,REP,400304,1,3,106,110,02
Leflore,U.S. House,Jon Douthitt,IND,400304,0,0,3,3,02
Leflore,State Senate,Curtis Mcdaniel,DEM,400304,0,1,82,83,5
Leflore,State Senate,Joseph Silk,REP,400304,1,3,64,68,5
Leflore,State House,Johnny Tadlock,DEM,400304,0,1,49,50,1
Leflore,State House,J. Longacre,REP,400304,1,3,92,96,1
Leflore,Governor,Joe Dorman,DEM,400305,0,2,48,50,
Leflore,Governor,Mary Fallin,REP,400305,2,0,62,64,
Leflore,Governor,Kimberly Willis,IND,400305,0,0,2,2,
Leflore,Governor,Richard Prawdzienski,IND,400305,0,0,5,5,
Leflore,Lieutenant Governor,Cathy Cummings,DEM,400305,0,2,39,41,
Leflore,Lieutenant Governor,Todd Lamb,REP,400305,2,0,78,80,
Leflore,Superintendent of Public Instruction,John Cox,DEM,400305,0,2,61,63,
Leflore,Superintendent of Public Instruction,Joy Hofmeister,REP,400305,2,0,54,56,
Leflore,Commissioner of Labor,Mike Workman,DEM,400305,0,2,50,52,
Leflore,Commissioner of Labor,Mark Costello,REP,400305,2,0,66,68,
Leflore,U.S. Senate,Matt Silverstein,DEM,400305,0,2,37,39,
Leflore,U.S. Senate,Jim Inhofe,REP,400305,2,0,75,77,
Leflore,U.S. Senate,Aaron Delozier,IND,400305,0,0,0,0,
Leflore,U.S. Senate,Ray Woods,IND,400305,0,0,3,3,
Leflore,U.S. Senate,Joan Farr,IND,400305,0,0,3,3,
Leflore,U.S. Senate,Connie Johnson,DEM,400305,0,2,39,41,
Leflore,U.S. Senate,James Lankford,REP,400305,2,0,72,74,
Leflore,U.S. Senate,Mark Beard,IND,400305,0,0,5,5,
Leflore,U.S. House,Earl Everett,DEM,400305,0,2,35,37,02
Leflore,U.S. House,Markwayne Mullin,REP,400305,2,0,74,76,02
Leflore,U.S. House,Jon Douthitt,IND,400305,0,0,7,7,02
Leflore,State Senate,Curtis Mcdaniel,DEM,400305,0,2,52,54,5
Leflore,State Senate,Joseph Silk,REP,400305,2,0,65,67,5
Leflore,State House,Johnny Tadlock,DEM,400305,0,2,59,61,1
Leflore,State House,J. Longacre,REP,400305,2,0,54,56,1
Leflore,Governor,Joe Dorman,DEM,400306,1,2,15,18,
Leflore,Governor,Mary Fallin,REP,400306,1,2,33,36,
Leflore,Governor,Kimberly Willis,IND,400306,0,0,1,1,
Leflore,Governor,Richard Prawdzienski,IND,400306,0,0,1,1,
Leflore,Lieutenant Governor,Cathy Cummings,DEM,400306,0,2,6,8,
Leflore,Lieutenant Governor,Todd Lamb,REP,400306,2,2,42,46,
Leflore,Superintendent of Public Instruction,John Cox,DEM,400306,2,2,18,22,
Leflore,Superintendent of Public Instruction,Joy Hofmeister,REP,400306,0,2,34,36,
Leflore,Commissioner of Labor,Mike Workman,DEM,400306,0,2,12,14,
Leflore,Commissioner of Labor,Mark Costello,REP,400306,2,2,33,37,
Leflore,U.S. Senate,Matt Silverstein,DEM,400306,0,0,5,5,
Leflore,U.S. Senate,Jim Inhofe,REP,400306,2,2,47,51,
Leflore,U.S. Senate,Aaron Delozier,IND,400306,0,0,0,0,
Leflore,U.S. Senate,Ray Woods,IND,400306,0,0,0,0,
Leflore,U.S. Senate,Joan Farr,IND,400306,0,2,0,2,
Leflore,U.S. Senate,Connie Johnson,DEM,400306,0,2,5,7,
Leflore,U.S. Senate,James Lankford,REP,400306,2,2,41,45,
Leflore,U.S. Senate,Mark Beard,IND,400306,0,0,3,3,
Leflore,U.S. House,Earl Everett,DEM,400306,0,2,4,6,02
Leflore,U.S. House,Markwayne Mullin,REP,400306,2,2,43,47,02
Leflore,U.S. House,Jon Douthitt,IND,400306,0,0,1,1,02
Leflore,State Senate,Curtis Mcdaniel,DEM,400306,1,2,19,22,5
Leflore,State Senate,Joseph Silk,REP,400306,1,2,30,33,5
Leflore,State House,Johnny Tadlock,DEM,400306,1,3,10,14,1
Leflore,State House,J. Longacre,REP,400306,1,1,35,37,1
Leflore,Governor,Joe Dorman,DEM,400309,2,0,25,27,
Leflore,Governor,Mary Fallin,REP,400309,0,0,28,28,
Leflore,Governor,Kimberly Willis,IND,400309,0,0,0,0,
Leflore,Governor,Richard Prawdzienski,IND,400309,0,0,0,0,
Leflore,Lieutenant Governor,Cathy Cummings,DEM,400309,0,0,19,19,
Leflore,Lieutenant Governor,Todd Lamb,REP,400309,2,0,32,34,
Leflore,Superintendent of Public Instruction,John Cox,DEM,400309,1,0,27,28,
Leflore,Superintendent of Public Instruction,Joy Hofmeister,REP,400309,1,0,26,27,
Leflore,Commissioner of Labor,Mike Workman,DEM,400309,1,0,22,23,
Leflore,Commissioner of Labor,Mark Costello,REP,400309,1,0,29,30,
Leflore,U.S. Senate,Matt Silverstein,DEM,400309,2,0,16,18,
Leflore,U.S. Senate,Jim Inhofe,REP,400309,0,0,32,32,
Leflore,U.S. Senate,Aaron Delozier,IND,400309,0,0,1,1,
Leflore,U.S. Senate,Ray Woods,IND,400309,0,0,1,1,
Leflore,U.S. Senate,Joan Farr,IND,400309,0,0,2,2,
Leflore,U.S. Senate,Connie Johnson,DEM,400309,0,0,15,15,
Leflore,U.S. Senate,James Lankford,REP,400309,1,0,34,35,
Leflore,U.S. Senate,Mark Beard,IND,400309,1,0,2,3,
Leflore,U.S. House,Earl Everett,DEM,400309,1,0,17,18,02
Leflore,U.S. House,Markwayne Mullin,REP,400309,1,0,31,32,02
Leflore,U.S. House,Jon Douthitt,IND,400309,0,0,4,4,02
Leflore,State Senate,Curtis Mcdaniel,DEM,400309,0,0,25,25,5
Leflore,State Senate,Joseph Silk,REP,400309,2,0,25,27,5
Leflore,State House,James Lockhart,DEM,400309,1,0,39,40,3
Leflore,State House,Traci Barnes,REP,400309,1,0,14,15,3
Leflore,Governor,Joe Dorman,DEM,400310,4,6,202,212,
Leflore,Governor,Mary Fallin,REP,400310,5,13,167,185,
Leflore,Governor,Kimberly Willis,IND,400310,0,0,12,12,
Leflore,Governor,Richard Prawdzienski,IND,400310,0,1,12,13,
Leflore,Lieutenant Governor,Cathy Cummings,DEM,400310,4,6,160,170,
Leflore,Lieutenant Governor,Todd Lamb,REP,400310,5,14,230,249,
Leflore,Superintendent of Public Instruction,John Cox,DEM,400310,7,13,251,271,
Leflore,Superintendent of Public Instruction,Joy Hofmeister,REP,400310,2,7,141,150,
Leflore,Commissioner of Labor,Mike Workman,DEM,400310,4,12,188,204,
Leflore,Commissioner of Labor,Mark Costello,REP,400310,5,8,194,207,
Leflore,U.S. Senate,Matt Silverstein,DEM,400310,4,5,119,128,
Leflore,U.S. Senate,Jim Inhofe,REP,400310,5,15,251,271,
Leflore,U.S. Senate,Aaron Delozier,IND,400310,0,0,4,4,
Leflore,U.S. Senate,Ray Woods,IND,400310,0,0,11,11,
Leflore,U.S. Senate,Joan Farr,IND,400310,0,0,5,5,
Leflore,U.S. Senate,Connie Johnson,DEM,400310,4,8,132,144,
Leflore,U.S. Senate,James Lankford,REP,400310,5,12,241,258,
Leflore,U.S. Senate,Mark Beard,IND,400310,0,0,17,17,
Leflore,U.S. House,Earl Everett,DEM,400310,4,10,118,132,02
Leflore,U.S. House,Markwayne Mullin,REP,400310,5,10,258,273,02
Leflore,U.S. House,Jon Douthitt,IND,400310,0,0,14,14,02
Leflore,State Senate,Curtis Mcdaniel,DEM,400310,4,12,222,238,5
Leflore,State Senate,Joseph Silk,REP,400310,5,8,167,180,5
Leflore,State House,James Lockhart,DEM,400310,4,18,270,292,3
Leflore,State House,Traci Barnes,REP,400310,5,2,124,131,3
Leflore,Governor,Joe Dorman,DEM,400311,2,4,151,157,
Leflore,Governor,Mary Fallin,REP,400311,3,5,107,115,
Leflore,Governor,Kimberly Willis,IND,400311,0,0,8,8,
Leflore,Governor,Richard Prawdzienski,IND,400311,0,0,5,5,
Leflore,Lieutenant Governor,Cathy Cummings,DEM,400311,2,5,119,126,
Leflore,Lieutenant Governor,Todd Lamb,REP,400311,3,4,145,152,
Leflore,Superintendent of Public Instruction,John Cox,DEM,400311,2,3,157,162,
Leflore,Superintendent of Public Instruction,Joy Hofmeister,REP,400311,3,5,109,117,
Leflore,Commissioner of Labor,Mike Workman,DEM,400311,2,3,133,138,
Leflore,Commissioner of Labor,Mark Costello,REP,400311,3,4,122,129,
Leflore,U.S. Senate,Matt Silverstein,DEM,400311,1,3,91,95,
Leflore,U.S. Senate,Jim Inhofe,REP,400311,4,6,168,178,
Leflore,U.S. Senate,Aaron Delozier,IND,400311,0,0,1,1,
Leflore,U.S. Senate,Ray Woods,IND,400311,0,0,1,1,
Leflore,U.S. Senate,Joan Farr,IND,400311,0,0,5,5,
Leflore,U.S. Senate,Connie Johnson,DEM,400311,2,5,95,102,
Leflore,U.S. Senate,James Lankford,REP,400311,3,4,160,167,
Leflore,U.S. Senate,Mark Beard,IND,400311,0,0,11,11,
Leflore,U.S. House,Earl Everett,DEM,400311,2,3,84,89,02
Leflore,U.S. House,Markwayne Mullin,REP,400311,3,5,171,179,02
Leflore,U.S. House,Jon Douthitt,IND,400311,0,1,8,9,02
Leflore,State Senate,Curtis Mcdaniel,DEM,400311,2,3,147,152,5
Leflore,State Senate,Joseph Silk,REP,400311,3,6,115,124,5
Leflore,State House,James Lockhart,DEM,400311,2,5,183,190,3
Leflore,State House,Traci Barnes,REP,400311,3,4,87,94,3
Leflore,Governor,Joe Dorman,DEM,400312,0,3,120,123,
Leflore,Governor,Mary Fallin,REP,400312,0,1,66,67,
Leflore,Governor,Kimberly Willis,IND,400312,0,0,4,4,
Leflore,Governor,Richard Prawdzienski,IND,400312,0,0,1,1,
Leflore,Lieutenant Governor,Cathy Cummings,DEM,400312,0,3,83,86,
Leflore,Lieutenant Governor,Todd Lamb,REP,400312,0,1,102,103,
Leflore,Superintendent of Public Instruction,John Cox,DEM,400312,0,4,140,144,
Leflore,Superintendent of Public Instruction,Joy Hofmeister,REP,400312,0,0,46,46,
Leflore,Commissioner of Labor,Mike Workman,DEM,400312,0,3,103,106,
Leflore,Commissioner of Labor,Mark Costello,REP,400312,0,0,78,78,
Leflore,U.S. Senate,Matt Silverstein,DEM,400312,0,2,79,81,
Leflore,U.S. Senate,Jim Inhofe,REP,400312,0,2,104,106,
Leflore,U.S. Senate,Aaron Delozier,IND,400312,0,0,2,2,
Leflore,U.S. Senate,Ray Woods,IND,400312,0,0,2,2,
Leflore,U.S. Senate,Joan Farr,IND,400312,0,0,2,2,
Leflore,U.S. Senate,Connie Johnson,DEM,400312,0,2,75,77,
Leflore,U.S. Senate,James Lankford,REP,400312,0,2,99,101,
Leflore,U.S. Senate,Mark Beard,IND,400312,0,0,10,10,
Leflore,U.S. House,Earl Everett,DEM,400312,0,1,69,70,02
Leflore,U.S. House,Markwayne Mullin,REP,400312,0,3,112,115,02
Leflore,U.S. House,Jon Douthitt,IND,400312,0,0,6,6,02
Leflore,State Senate,Curtis Mcdaniel,DEM,400312,0,4,118,122,5
Leflore,State Senate,Joseph Silk,REP,400312,0,0,65,65,5
Leflore,State House,James Lockhart,DEM,400312,0,3,159,162,3
Leflore,State House,Traci Barnes,REP,400312,0,1,33,34,3
Lincoln,Governor,Joe Dorman,DEM,410001,7,1,116,124,
Lincoln,Governor,Mary Fallin,REP,410001,16,4,227,247,
Lincoln,Governor,Kimberly Willis,IND,410001,0,0,9,9,
Lincoln,Governor,Richard Prawdzienski,IND,410001,0,0,5,5,
Lincoln,Lieutenant Governor,Cathy Cummings,DEM,410001,8,1,82,91,
Lincoln,Lieutenant Governor,Todd Lamb,REP,410001,15,3,271,289,
Lincoln,Superintendent of Public Instruction,John Cox,DEM,410001,11,2,147,160,
Lincoln,Superintendent of Public Instruction,Joy Hofmeister,REP,410001,12,3,205,220,
Lincoln,Commissioner of Labor,Mike Workman,DEM,410001,11,1,130,142,
Lincoln,Commissioner of Labor,Mark Costello,REP,410001,12,3,218,233,
Lincoln,U.S. Senate,Matt Silverstein,DEM,410001,4,1,72,77,
Lincoln,U.S. Senate,Jim Inhofe,REP,410001,18,4,275,297,
Lincoln,U.S. Senate,Aaron Delozier,IND,410001,0,0,3,3,
Lincoln,U.S. Senate,Ray Woods,IND,410001,1,0,3,4,
Lincoln,U.S. Senate,Joan Farr,IND,410001,0,0,2,2,
Lincoln,U.S. Senate,Connie Johnson,DEM,410001,4,1,68,73,
Lincoln,U.S. Senate,James Lankford,REP,410001,15,4,279,298,
Lincoln,U.S. Senate,Mark Beard,IND,410001,4,0,10,14,
Lincoln,U.S. House,Frankie Robbins,DEM,410001,8,1,75,84,03
Lincoln,U.S. House,Frank Lucas,REP,410001,15,4,279,298,03
Lincoln,State Senate,Marilyn Rainwater,DEM,410001,3,0,61,64,28
Lincoln,State Senate,Jason Smalley,REP,410001,20,5,297,322,28
Lincoln,State House,Michial Poteet,DEM,410001,9,1,126,136,32
Lincoln,State House,Kevin Wallace,REP,410001,13,4,229,246,32
Lincoln,Governor,Joe Dorman,DEM,410002,1,6,130,137,
Lincoln,Governor,Mary Fallin,REP,410002,8,12,317,337,
Lincoln,Governor,Kimberly Willis,IND,410002,1,1,4,6,
Lincoln,Governor,Richard Prawdzienski,IND,410002,0,0,2,2,
Lincoln,Lieutenant Governor,Cathy Cummings,DEM,410002,3,5,89,97,
Lincoln,Lieutenant Governor,Todd Lamb,REP,410002,7,14,359,380,
Lincoln,Superintendent of Public Instruction,John Cox,DEM,410002,3,8,154,165,
Lincoln,Superintendent of Public Instruction,Joy Hofmeister,REP,410002,7,11,294,312,
Lincoln,Commissioner of Labor,Mike Workman,DEM,410002,4,6,129,139,
Lincoln,Commissioner of Labor,Mark Costello,REP,410002,6,12,304,322,
Lincoln,U.S. Senate,Matt Silverstein,DEM,410002,0,4,75,79,
Lincoln,U.S. Senate,Jim Inhofe,REP,410002,9,14,365,388,
Lincoln,U.S. Senate,Aaron Delozier,IND,410002,0,0,5,5,
Lincoln,U.S. Senate,Ray Woods,IND,410002,0,0,2,2,
Lincoln,U.S. Senate,Joan Farr,IND,410002,0,1,4,5,
Lincoln,U.S. Senate,Connie Johnson,DEM,410002,2,3,69,74,
Lincoln,U.S. Senate,James Lankford,REP,410002,8,15,374,397,
Lincoln,U.S. Senate,Mark Beard,IND,410002,0,0,9,9,
Lincoln,U.S. House,Frankie Robbins,DEM,410002,2,4,78,84,03
Lincoln,U.S. House,Frank Lucas,REP,410002,8,15,371,394,03
Lincoln,State Senate,Marilyn Rainwater,DEM,410002,0,4,52,56,28
Lincoln,State Senate,Jason Smalley,REP,410002,10,15,401,426,28
Lincoln,State House,Michial Poteet,DEM,410002,2,9,130,141,32
Lincoln,State House,Kevin Wallace,REP,410002,8,10,320,338,32
Lincoln,Governor,Joe Dorman,DEM,410003,2,22,176,200,
Lincoln,Governor,Mary Fallin,REP,410003,5,32,311,348,
Lincoln,Governor,Kimberly Willis,IND,410003,0,2,12,14,
Lincoln,Governor,Richard Prawdzienski,IND,410003,0,0,11,11,
Lincoln,Lieutenant Governor,Cathy Cummings,DEM,410003,3,13,111,127,
Lincoln,Lieutenant Governor,Todd Lamb,REP,410003,5,43,399,447,
Lincoln,Superintendent of Public Instruction,John Cox,DEM,410003,5,20,233,258,
Lincoln,Superintendent of Public Instruction,Joy Hofmeister,REP,410003,2,35,276,313,
Lincoln,Commissioner of Labor,Mike Workman,DEM,410003,2,19,166,187,
Lincoln,Commissioner of Labor,Mark Costello,REP,410003,5,36,340,381,
Lincoln,U.S. Senate,Matt Silverstein,DEM,410003,1,11,92,104,
Lincoln,U.S. Senate,Jim Inhofe,REP,410003,7,43,402,452,
Lincoln,U.S. Senate,Aaron Delozier,IND,410003,0,0,3,3,
Lincoln,U.S. Senate,Ray Woods,IND,410003,0,1,6,7,
Lincoln,U.S. Senate,Joan Farr,IND,410003,0,1,5,6,
Lincoln,U.S. Senate,Connie Johnson,DEM,410003,2,12,92,106,
Lincoln,U.S. Senate,James Lankford,REP,410003,6,41,404,451,
Lincoln,U.S. Senate,Mark Beard,IND,410003,0,2,17,19,
Lincoln,U.S. House,Frankie Robbins,DEM,410003,2,12,113,127,03
Lincoln,U.S. House,Frank Lucas,REP,410003,6,43,396,445,03
Lincoln,State Senate,Marilyn Rainwater,DEM,410003,1,10,87,98,28
Lincoln,State Senate,Jason Smalley,REP,410003,7,46,426,479,28
Lincoln,State House,Michial Poteet,DEM,410003,2,24,200,226,32
Lincoln,State House,Kevin Wallace,REP,410003,6,32,307,345,32
Lincoln,Governor,Joe Dorman,DEM,410004,3,2,81,86,
Lincoln,Governor,Mary Fallin,REP,410004,6,3,159,168,
Lincoln,Governor,Kimberly Willis,IND,410004,0,0,4,4,
Lincoln,Governor,Richard Prawdzienski,IND,410004,0,0,4,4,
Lincoln,Lieutenant Governor,Cathy Cummings,DEM,410004,3,2,47,52,
Lincoln,Lieutenant Governor,Todd Lamb,REP,410004,6,3,201,210,
Lincoln,Superintendent of Public Instruction,John Cox,DEM,410004,2,2,91,95,
Lincoln,Superintendent of Public Instruction,Joy Hofmeister,REP,410004,7,3,156,166,
Lincoln,Commissioner of Labor,Mike Workman,DEM,410004,1,2,77,80,
Lincoln,Commissioner of Labor,Mark Costello,REP,410004,8,3,165,176,
Lincoln,U.S. Senate,Matt Silverstein,DEM,410004,3,2,40,45,
Lincoln,U.S. Senate,Jim Inhofe,REP,410004,6,3,200,209,
Lincoln,U.S. Senate,Aaron Delozier,IND,410004,0,0,3,3,
Lincoln,U.S. Senate,Ray Woods,IND,410004,0,0,5,5,
Lincoln,U.S. Senate,Joan Farr,IND,410004,0,0,2,2,
Lincoln,U.S. Senate,Connie Johnson,DEM,410004,2,1,43,46,
Lincoln,U.S. Senate,James Lankford,REP,410004,7,4,193,204,
Lincoln,U.S. Senate,Mark Beard,IND,410004,0,0,11,11,
Lincoln,U.S. House,Frankie Robbins,DEM,410004,0,1,50,51,03
Lincoln,U.S. House,Frank Lucas,REP,410004,9,4,198,211,03
Lincoln,State Senate,Marilyn Rainwater,DEM,410004,0,1,51,52,28
Lincoln,State Senate,Jason Smalley,REP,410004,9,4,198,211,28
Lincoln,State House,Michial Poteet,DEM,410004,3,2,111,116,32
Lincoln,State House,Kevin Wallace,REP,410004,6,3,137,146,32
Lincoln,Governor,Joe Dorman,DEM,410005,1,16,152,169,
Lincoln,Governor,Mary Fallin,REP,410005,8,15,244,267,
Lincoln,Governor,Kimberly Willis,IND,410005,0,1,13,14,
Lincoln,Governor,Richard Prawdzienski,IND,410005,1,0,9,10,
Lincoln,Lieutenant Governor,Cathy Cummings,DEM,410005,0,8,112,120,
Lincoln,Lieutenant Governor,Todd Lamb,REP,410005,10,24,297,331,
Lincoln,Superintendent of Public Instruction,John Cox,DEM,410005,2,20,186,208,
Lincoln,Superintendent of Public Instruction,Joy Hofmeister,REP,410005,6,12,227,245,
Lincoln,Commissioner of Labor,Mike Workman,DEM,410005,2,11,144,157,
Lincoln,Commissioner of Labor,Mark Costello,REP,410005,8,20,259,287,
Lincoln,U.S. Senate,Matt Silverstein,DEM,410005,1,7,89,97,
Lincoln,U.S. Senate,Jim Inhofe,REP,410005,9,24,311,344,
Lincoln,U.S. Senate,Aaron Delozier,IND,410005,0,0,1,1,
Lincoln,U.S. Senate,Ray Woods,IND,410005,0,0,4,4,
Lincoln,U.S. Senate,Joan Farr,IND,410005,0,0,6,6,
Lincoln,U.S. Senate,Connie Johnson,DEM,410005,1,7,91,99,
Lincoln,U.S. Senate,James Lankford,REP,410005,9,25,307,341,
Lincoln,U.S. Senate,Mark Beard,IND,410005,0,0,14,14,
Lincoln,U.S. House,Frankie Robbins,DEM,410005,1,7,97,105,03
Lincoln,U.S. House,Frank Lucas,REP,410005,9,25,315,349,03
Lincoln,State Senate,Marilyn Rainwater,DEM,410005,1,8,113,122,28
Lincoln,State Senate,Jason Smalley,REP,410005,9,24,299,332,28
Lincoln,State House,Michial Poteet,DEM,410005,5,18,268,291,32
Lincoln,State House,Kevin Wallace,REP,410005,5,14,153,172,32
Lincoln,Governor,Joe Dorman,DEM,410006,0,3,85,88,
Lincoln,Governor,Mary Fallin,REP,410006,3,3,99,105,
Lincoln,Governor,Kimberly Willis,IND,410006,0,0,7,7,
Lincoln,Governor,Richard Prawdzienski,IND,410006,0,0,2,2,
Lincoln,Lieutenant Governor,Cathy Cummings,DEM,410006,1,0,62,63,
Lincoln,Lieutenant Governor,Todd Lamb,REP,410006,2,6,129,137,
Lincoln,Superintendent of Public Instruction,John Cox,DEM,410006,0,3,105,108,
Lincoln,Superintendent of Public Instruction,Joy Hofmeister,REP,410006,3,1,86,90,
Lincoln,Commissioner of Labor,Mike Workman,DEM,410006,0,0,82,82,
Lincoln,Commissioner of Labor,Mark Costello,REP,410006,3,6,107,116,
Lincoln,U.S. Senate,Matt Silverstein,DEM,410006,0,0,57,57,
Lincoln,U.S. Senate,Jim Inhofe,REP,410006,3,6,124,133,
Lincoln,U.S. Senate,Aaron Delozier,IND,410006,0,0,4,4,
Lincoln,U.S. Senate,Ray Woods,IND,410006,0,0,4,4,
Lincoln,U.S. Senate,Joan Farr,IND,410006,0,0,3,3,
Lincoln,U.S. Senate,Connie Johnson,DEM,410006,0,0,51,51,
Lincoln,U.S. Senate,James Lankford,REP,410006,3,6,132,141,
Lincoln,U.S. Senate,Mark Beard,IND,410006,0,0,9,9,
Lincoln,U.S. House,Frankie Robbins,DEM,410006,0,0,58,58,03
Lincoln,U.S. House,Frank Lucas,REP,410006,3,6,133,142,03
Lincoln,State Senate,Marilyn Rainwater,DEM,410006,1,1,65,67,28
Lincoln,State Senate,Jason Smalley,REP,410006,2,5,127,134,28
Lincoln,State House,Michial Poteet,DEM,410006,1,4,129,134,32
Lincoln,State House,Kevin Wallace,REP,410006,1,2,63,66,32
Lincoln,Governor,Joe Dorman,DEM,410007,1,4,124,129,
Lincoln,Governor,Mary Fallin,REP,410007,4,4,135,143,
Lincoln,Governor,Kimberly Willis,IND,410007,0,0,6,6,
Lincoln,Governor,Richard Prawdzienski,IND,410007,0,0,5,5,
Lincoln,Lieutenant Governor,Cathy Cummings,DEM,410007,0,4,93,97,
Lincoln,Lieutenant Governor,Todd Lamb,REP,410007,4,4,175,183,
Lincoln,Superintendent of Public Instruction,John Cox,DEM,410007,1,4,137,142,
Lincoln,Superintendent of Public Instruction,Joy Hofmeister,REP,410007,3,4,129,136,
Lincoln,Commissioner of Labor,Mike Workman,DEM,410007,2,4,118,124,
Lincoln,Commissioner of Labor,Mark Costello,REP,410007,2,4,138,144,
Lincoln,U.S. Senate,Matt Silverstein,DEM,410007,0,3,77,80,
Lincoln,U.S. Senate,Jim Inhofe,REP,410007,5,5,177,187,
Lincoln,U.S. Senate,Aaron Delozier,IND,410007,0,0,3,3,
Lincoln,U.S. Senate,Ray Woods,IND,410007,0,0,4,4,
Lincoln,U.S. Senate,Joan Farr,IND,410007,0,0,5,5,
Lincoln,U.S. Senate,Connie Johnson,DEM,410007,0,3,83,86,
Lincoln,U.S. Senate,James Lankford,REP,410007,5,4,170,179,
Lincoln,U.S. Senate,Mark Beard,IND,410007,0,0,13,13,
Lincoln,U.S. House,Frankie Robbins,DEM,410007,0,4,85,89,03
Lincoln,U.S. House,Frank Lucas,REP,410007,5,4,182,191,03
Lincoln,State Senate,Marilyn Rainwater,DEM,410007,1,2,90,93,28
Lincoln,State Senate,Jason Smalley,REP,410007,4,6,177,187,28
Lincoln,State House,Michial Poteet,DEM,410007,5,4,152,161,32
Lincoln,State House,Kevin Wallace,REP,410007,0,4,114,118,32
Lincoln,Governor,Joe Dorman,DEM,410008,3,16,214,233,
Lincoln,Governor,Mary Fallin,REP,410008,12,18,385,415,
Lincoln,Governor,Kimberly Willis,IND,410008,0,0,18,18,
Lincoln,Governor,Richard Prawdzienski,IND,410008,0,0,4,4,
Lincoln,Lieutenant Governor,Cathy Cummings,DEM,410008,3,9,129,141,
Lincoln,Lieutenant Governor,Todd Lamb,REP,410008,12,25,488,525,
Lincoln,Superintendent of Public Instruction,John Cox,DEM,410008,4,17,251,272,
Lincoln,Superintendent of Public Instruction,Joy Hofmeister,REP,410008,11,17,362,390,
Lincoln,Commissioner of Labor,Mike Workman,DEM,410008,3,13,198,214,
Lincoln,Commissioner of Labor,Mark Costello,REP,410008,12,20,401,433,
Lincoln,U.S. Senate,Matt Silverstein,DEM,410008,3,10,122,135,
Lincoln,U.S. Senate,Jim Inhofe,REP,410008,11,24,469,504,
Lincoln,U.S. Senate,Aaron Delozier,IND,410008,1,0,6,7,
Lincoln,U.S. Senate,Ray Woods,IND,410008,0,0,11,11,
Lincoln,U.S. Senate,Joan Farr,IND,410008,0,0,3,3,
Lincoln,U.S. Senate,Connie Johnson,DEM,410008,3,11,121,135,
Lincoln,U.S. Senate,James Lankford,REP,410008,12,23,475,510,
Lincoln,U.S. Senate,Mark Beard,IND,410008,0,0,20,20,
Lincoln,U.S. House,Frankie Robbins,DEM,410008,3,7,116,126,03
Lincoln,U.S. House,Frank Lucas,REP,410008,12,27,502,541,03
Lincoln,State Senate,Marilyn Rainwater,DEM,410008,3,9,125,137,28
Lincoln,State Senate,Jason Smalley,REP,410008,12,25,490,527,28
Lincoln,State House,Michial Poteet,DEM,410008,3,14,187,204,32
Lincoln,State House,Kevin Wallace,REP,410008,12,19,430,461,32
Lincoln,Governor,Joe Dorman,DEM,410009,1,8,100,109,
Lincoln,Governor,Mary Fallin,REP,410009,7,31,220,258,
Lincoln,Governor,Kimberly Willis,IND,410009,0,0,6,6,
Lincoln,Governor,Richard Prawdzienski,IND,410009,0,1,4,5,
Lincoln,Lieutenant Governor,Cathy Cummings,DEM,410009,1,8,64,73,
Lincoln,Lieutenant Governor,Todd Lamb,REP,410009,7,32,266,305,
Lincoln,Superintendent of Public Instruction,John Cox,DEM,410009,1,14,125,140,
Lincoln,Superintendent of Public Instruction,Joy Hofmeister,REP,410009,7,26,202,235,
Lincoln,Commissioner of Labor,Mike Workman,DEM,410009,1,10,92,103,
Lincoln,Commissioner of Labor,Mark Costello,REP,410009,7,30,226,263,
Lincoln,U.S. Senate,Matt Silverstein,DEM,410009,1,4,56,61,
Lincoln,U.S. Senate,Jim Inhofe,REP,410009,7,34,259,300,
Lincoln,U.S. Senate,Aaron Delozier,IND,410009,0,0,2,2,
Lincoln,U.S. Senate,Ray Woods,IND,410009,0,0,5,5,
Lincoln,U.S. Senate,Joan Farr,IND,410009,0,1,4,5,
Lincoln,U.S. Senate,Connie Johnson,DEM,410009,1,7,60,68,
Lincoln,U.S. Senate,James Lankford,REP,410009,7,32,259,298,
Lincoln,U.S. Senate,Mark Beard,IND,410009,0,1,10,11,
Lincoln,U.S. House,Frankie Robbins,DEM,410009,1,5,70,76,03
Lincoln,U.S. House,Frank Lucas,REP,410009,7,35,256,298,03
Lincoln,State Senate,Marilyn Rainwater,DEM,410009,1,8,64,73,28
Lincoln,State Senate,Jason Smalley,REP,410009,7,32,263,302,28
Lincoln,State House,Michial Poteet,DEM,410009,1,9,107,117,32
Lincoln,State House,Kevin Wallace,REP,410009,7,31,221,259,32
Lincoln,Governor,Joe Dorman,DEM,410010,0,22,172,194,
Lincoln,Governor,Mary Fallin,REP,410010,6,59,330,395,
Lincoln,Governor,Kimberly Willis,IND,410010,0,3,12,15,
Lincoln,Governor,Richard Prawdzienski,IND,410010,1,0,5,6,
Lincoln,Lieutenant Governor,Cathy Cummings,DEM,410010,2,7,108,117,
Lincoln,Lieutenant Governor,Todd Lamb,REP,410010,5,77,411,493,
Lincoln,Superintendent of Public Instruction,John Cox,DEM,410010,4,26,199,229,
Lincoln,Superintendent of Public Instruction,Joy Hofmeister,REP,410010,2,57,322,381,
Lincoln,Commissioner of Labor,Mike Workman,DEM,410010,0,20,154,174,
Lincoln,Commissioner of Labor,Mark Costello,REP,410010,6,61,358,425,
Lincoln,U.S. Senate,Matt Silverstein,DEM,410010,0,8,81,89,
Lincoln,U.S. Senate,Jim Inhofe,REP,410010,5,73,418,496,
Lincoln,U.S. Senate,Aaron Delozier,IND,410010,1,0,2,3,
Lincoln,U.S. Senate,Ray Woods,IND,410010,0,2,5,7,
Lincoln,U.S. Senate,Joan Farr,IND,410010,1,1,9,11,
Lincoln,U.S. Senate,Connie Johnson,DEM,410010,0,6,98,104,
Lincoln,U.S. Senate,James Lankford,REP,410010,6,75,412,493,
Lincoln,U.S. Senate,Mark Beard,IND,410010,1,2,11,14,
Lincoln,U.S. House,Frankie Robbins,DEM,410010,0,9,94,103,03
Lincoln,U.S. House,Frank Lucas,REP,410010,6,75,424,505,03
Lincoln,State Senate,Marilyn Rainwater,DEM,410010,1,9,94,104,28
Lincoln,State Senate,Jason Smalley,REP,410010,6,75,426,507,28
Lincoln,State House,Michial Poteet,DEM,410010,0,32,215,247,32
Lincoln,State House,Kevin Wallace,REP,410010,7,51,304,362,32
Lincoln,Governor,Joe Dorman,DEM,410011,2,30,171,203,
Lincoln,Governor,Mary Fallin,REP,410011,8,29,229,266,
Lincoln,Governor,Kimberly Willis,IND,410011,0,2,10,12,
Lincoln,Governor,Richard Prawdzienski,IND,410011,0,0,3,3,
Lincoln,Lieutenant Governor,Cathy Cummings,DEM,410011,2,21,115,138,
Lincoln,Lieutenant Governor,Todd Lamb,REP,410011,8,40,297,345,
Lincoln,Superintendent of Public Instruction,John Cox,DEM,410011,2,29,200,231,
Lincoln,Superintendent of Public Instruction,Joy Hofmeister,REP,410011,8,32,206,246,
Lincoln,Commissioner of Labor,Mike Workman,DEM,410011,2,30,140,172,
Lincoln,Commissioner of Labor,Mark Costello,REP,410011,8,30,263,301,
Lincoln,U.S. Senate,Matt Silverstein,DEM,410011,3,21,101,125,
Lincoln,U.S. Senate,Jim Inhofe,REP,410011,7,39,295,341,
Lincoln,U.S. Senate,Aaron Delozier,IND,410011,0,2,3,5,
Lincoln,U.S. Senate,Ray Woods,IND,410011,0,0,5,5,
Lincoln,U.S. Senate,Joan Farr,IND,410011,0,0,4,4,
Lincoln,U.S. Senate,Connie Johnson,DEM,410011,2,21,106,129,
Lincoln,U.S. Senate,James Lankford,REP,410011,8,39,296,343,
Lincoln,U.S. Senate,Mark Beard,IND,410011,0,2,10,12,
Lincoln,U.S. House,Frankie Robbins,DEM,410011,2,18,113,133,03
Lincoln,U.S. House,Frank Lucas,REP,410011,8,43,298,349,03
Lincoln,State Senate,Marilyn Rainwater,DEM,410011,1,16,106,123,28
Lincoln,State Senate,Jason Smalley,REP,410011,9,45,302,356,28
Lincoln,State House,Michial Poteet,DEM,410011,2,30,178,210,32
Lincoln,State House,Kevin Wallace,REP,410011,8,30,229,267,32
Lincoln,Governor,Joe Dorman,DEM,410012,5,22,158,185,
Lincoln,Governor,Mary Fallin,REP,410012,3,35,202,240,
Lincoln,Governor,Kimberly Willis,IND,410012,0,1,12,13,
Lincoln,Governor,Richard Prawdzienski,IND,410012,0,0,4,4,
Lincoln,Lieutenant Governor,Cathy Cummings,DEM,410012,2,11,99,112,
Lincoln,Lieutenant Governor,Todd Lamb,REP,410012,6,47,276,329,
Lincoln,Superintendent of Public Instruction,John Cox,DEM,410012,3,24,170,197,
Lincoln,Superintendent of Public Instruction,Joy Hofmeister,REP,410012,5,33,204,242,
Lincoln,Commissioner of Labor,Mike Workman,DEM,410012,3,21,127,151,
Lincoln,Commissioner of Labor,Mark Costello,REP,410012,5,34,237,276,
Lincoln,U.S. Senate,Matt Silverstein,DEM,410012,3,14,88,105,
Lincoln,U.S. Senate,Jim Inhofe,REP,410012,4,42,275,321,
Lincoln,U.S. Senate,Aaron Delozier,IND,410012,0,0,4,4,
Lincoln,U.S. Senate,Ray Woods,IND,410012,0,2,7,9,
Lincoln,U.S. Senate,Joan Farr,IND,410012,0,0,1,1,
Lincoln,U.S. Senate,Connie Johnson,DEM,410012,3,12,94,109,
Lincoln,U.S. Senate,James Lankford,REP,410012,5,46,269,320,
Lincoln,U.S. Senate,Mark Beard,IND,410012,0,0,12,12,
Lincoln,U.S. House,Frankie Robbins,DEM,410012,2,12,89,103,03
Lincoln,U.S. House,Frank Lucas,REP,410012,6,46,286,338,03
Lincoln,State Senate,Marilyn Rainwater,DEM,410012,3,13,86,102,28
Lincoln,State Senate,Jason Smalley,REP,410012,5,45,288,338,28
Lincoln,State House,Michial Poteet,DEM,410012,3,25,182,210,32
Lincoln,State House,Kevin Wallace,REP,410012,5,31,193,229,32
Lincoln,Governor,Joe Dorman,DEM,410013,2,2,37,41,
Lincoln,Governor,Mary Fallin,REP,410013,3,1,93,97,
Lincoln,Governor,Kimberly Willis,IND,410013,0,1,2,3,
Lincoln,Governor,Richard Prawdzienski,IND,410013,0,0,2,2,
Lincoln,Lieutenant Governor,Cathy Cummings,DEM,410013,0,0,26,26,
Lincoln,Lieutenant Governor,Todd Lamb,REP,410013,5,4,106,115,
Lincoln,Superintendent of Public Instruction,John Cox,DEM,410013,0,2,50,52,
Lincoln,Superintendent of Public Instruction,Joy Hofmeister,REP,410013,5,2,82,89,
Lincoln,Commissioner of Labor,Mike Workman,DEM,410013,0,2,36,38,
Lincoln,Commissioner of Labor,Mark Costello,REP,410013,5,2,93,100,
Lincoln,U.S. Senate,Matt Silverstein,DEM,410013,0,1,28,29,
Lincoln,U.S. Senate,Jim Inhofe,REP,410013,5,3,106,114,
Lincoln,U.S. Senate,Aaron Delozier,IND,410013,0,0,0,0,
Lincoln,U.S. Senate,Ray Woods,IND,410013,0,0,1,1,
Lincoln,U.S. Senate,Joan Farr,IND,410013,0,0,0,0,
Lincoln,U.S. Senate,Connie Johnson,DEM,410013,0,0,24,24,
Lincoln,U.S. Senate,James Lankford,REP,410013,3,4,109,116,
Lincoln,U.S. Senate,Mark Beard,IND,410013,2,0,2,4,
Lincoln,U.S. House,Frankie Robbins,DEM,410013,0,1,28,29,03
Lincoln,U.S. House,Frank Lucas,REP,410013,5,3,106,114,03
Lincoln,State Senate,Marilyn Rainwater,DEM,410013,1,0,25,26,28
Lincoln,State Senate,Jason Smalley,REP,410013,4,4,108,116,28
Lincoln,State House,Michial Poteet,DEM,410013,1,2,43,46,32
Lincoln,State House,Kevin Wallace,REP,410013,4,2,92,98,32
Lincoln,Governor,Joe Dorman,DEM,410015,3,0,174,177,
Lincoln,Governor,Mary Fallin,REP,410015,10,12,374,396,
Lincoln,Governor,Kimberly Willis,IND,410015,1,0,14,15,
Lincoln,Governor,Richard Prawdzienski,IND,410015,0,0,11,11,
Lincoln,Lieutenant Governor,Cathy Cummings,DEM,410015,2,1,130,133,
Lincoln,Lieutenant Governor,Todd Lamb,REP,410015,12,10,439,461,
Lincoln,Superintendent of Public Instruction,John Cox,DEM,410015,6,1,220,227,
Lincoln,Superintendent of Public Instruction,Joy Hofmeister,REP,410015,8,11,349,368,
Lincoln,Commissioner of Labor,Mike Workman,DEM,410015,2,2,180,184,
Lincoln,Commissioner of Labor,Mark Costello,REP,410015,11,9,384,404,
Lincoln,U.S. Senate,Matt Silverstein,DEM,410015,2,1,114,117,
Lincoln,U.S. Senate,Jim Inhofe,REP,410015,12,11,434,457,
Lincoln,U.S. Senate,Aaron Delozier,IND,410015,0,0,5,5,
Lincoln,U.S. Senate,Ray Woods,IND,410015,0,0,8,8,
Lincoln,U.S. Senate,Joan Farr,IND,410015,0,0,10,10,
Lincoln,U.S. Senate,Connie Johnson,DEM,410015,2,1,117,120,
Lincoln,U.S. Senate,James Lankford,REP,410015,12,11,436,459,
Lincoln,U.S. Senate,Mark Beard,IND,410015,0,0,18,18,
Lincoln,U.S. House,Frankie Robbins,DEM,410015,2,1,133,136,03
Lincoln,U.S. House,Frank Lucas,REP,410015,12,11,435,458,03
Lincoln,State Senate,Marilyn Rainwater,DEM,410015,2,2,151,155,28
Lincoln,State Senate,Jason Smalley,REP,410015,12,10,416,438,28
Lincoln,State House,Michial Poteet,DEM,410015,4,3,181,188,32
Lincoln,State House,Kevin Wallace,REP,410015,9,9,385,403,32
Lincoln,Governor,Joe Dorman,DEM,410016,2,5,112,119,
Lincoln,Governor,Mary Fallin,REP,410016,5,8,281,294,
Lincoln,Governor,Kimberly Willis,IND,410016,0,0,16,16,
Lincoln,Governor,Richard Prawdzienski,IND,410016,1,0,7,8,
Lincoln,Lieutenant Governor,Cathy Cummings,DEM,410016,1,2,80,83,
Lincoln,Lieutenant Governor,Todd Lamb,REP,410016,7,11,338,356,
Lincoln,Superintendent of Public Instruction,John Cox,DEM,410016,4,7,160,171,
Lincoln,Superintendent of Public Instruction,Joy Hofmeister,REP,410016,3,6,256,265,
Lincoln,Commissioner of Labor,Mike Workman,DEM,410016,4,5,115,124,
Lincoln,Commissioner of Labor,Mark Costello,REP,410016,4,8,295,307,
Lincoln,U.S. Senate,Matt Silverstein,DEM,410016,0,4,70,74,
Lincoln,U.S. Senate,Jim Inhofe,REP,410016,7,9,327,343,
Lincoln,U.S. Senate,Aaron Delozier,IND,410016,0,0,2,2,
Lincoln,U.S. Senate,Ray Woods,IND,410016,0,0,7,7,
Lincoln,U.S. Senate,Joan Farr,IND,410016,1,0,9,10,
Lincoln,U.S. Senate,Connie Johnson,DEM,410016,1,5,67,73,
Lincoln,U.S. Senate,James Lankford,REP,410016,6,8,330,344,
Lincoln,U.S. Senate,Mark Beard,IND,410016,1,0,18,19,
Lincoln,U.S. House,Frankie Robbins,DEM,410016,1,3,75,79,03
Lincoln,U.S. House,Frank Lucas,REP,410016,7,10,340,357,03
Lincoln,State Senate,Marilyn Rainwater,DEM,410016,2,5,91,98,28
Lincoln,State Senate,Jason Smalley,REP,410016,6,8,325,339,28
Lincoln,State House,Michial Poteet,DEM,410016,3,5,137,145,32
Lincoln,State House,Kevin Wallace,REP,410016,5,8,280,293,32
Lincoln,Governor,Joe Dorman,DEM,410017,3,10,48,61,
Lincoln,Governor,Mary Fallin,REP,410017,7,5,80,92,
Lincoln,Governor,Kimberly Willis,IND,410017,0,0,3,3,
Lincoln,Governor,Richard Prawdzienski,IND,410017,0,0,3,3,
Lincoln,Lieutenant Governor,Cathy Cummings,DEM,410017,3,6,39,48,
Lincoln,Lieutenant Governor,Todd Lamb,REP,410017,7,9,92,108,
Lincoln,Superintendent of Public Instruction,John Cox,DEM,410017,5,7,69,81,
Lincoln,Superintendent of Public Instruction,Joy Hofmeister,REP,410017,5,7,60,72,
Lincoln,Commissioner of Labor,Mike Workman,DEM,410017,3,9,53,65,
Lincoln,Commissioner of Labor,Mark Costello,REP,410017,7,5,76,88,
Lincoln,U.S. Senate,Matt Silverstein,DEM,410017,3,2,36,41,
Lincoln,U.S. Senate,Jim Inhofe,REP,410017,7,12,88,107,
Lincoln,U.S. Senate,Aaron Delozier,IND,410017,0,0,4,4,
Lincoln,U.S. Senate,Ray Woods,IND,410017,0,0,2,2,
Lincoln,U.S. Senate,Joan Farr,IND,410017,0,0,2,2,
Lincoln,U.S. Senate,Connie Johnson,DEM,410017,3,6,31,40,
Lincoln,U.S. Senate,James Lankford,REP,410017,7,9,94,110,
Lincoln,U.S. Senate,Mark Beard,IND,410017,0,0,8,8,
Lincoln,U.S. House,Frankie Robbins,DEM,410017,3,4,37,44,03
Lincoln,U.S. House,Frank Lucas,REP,410017,7,11,95,113,03
Lincoln,State Senate,Marilyn Rainwater,DEM,410017,3,5,31,39,28
Lincoln,State Senate,Jason Smalley,REP,410017,7,10,99,116,28
Lincoln,State House,Michial Poteet,DEM,410017,3,8,58,69,32
Lincoln,State House,Kevin Wallace,REP,410017,7,7,75,89,32
Lincoln,Governor,Joe Dorman,DEM,410018,4,3,120,127,
Lincoln,Governor,Mary Fallin,REP,410018,1,11,162,174,
Lincoln,Governor,Kimberly Willis,IND,410018,0,0,13,13,
Lincoln,Governor,Richard Prawdzienski,IND,410018,0,1,2,3,
Lincoln,Lieutenant Governor,Cathy Cummings,DEM,410018,4,3,90,97,
Lincoln,Lieutenant Governor,Todd Lamb,REP,410018,1,12,203,216,
Lincoln,Superintendent of Public Instruction,John Cox,DEM,410018,4,5,155,164,
Lincoln,Superintendent of Public Instruction,Joy Hofmeister,REP,410018,1,10,142,153,
Lincoln,Commissioner of Labor,Mike Workman,DEM,410018,4,2,123,129,
Lincoln,Commissioner of Labor,Mark Costello,REP,410018,1,13,160,174,
Lincoln,U.S. Senate,Matt Silverstein,DEM,410018,4,2,75,81,
Lincoln,U.S. Senate,Jim Inhofe,REP,410018,1,13,204,218,
Lincoln,U.S. Senate,Aaron Delozier,IND,410018,0,0,2,2,
Lincoln,U.S. Senate,Ray Woods,IND,410018,0,0,10,10,
Lincoln,U.S. Senate,Joan Farr,IND,410018,0,0,6,6,
Lincoln,U.S. Senate,Connie Johnson,DEM,410018,4,2,82,88,
Lincoln,U.S. Senate,James Lankford,REP,410018,1,12,201,214,
Lincoln,U.S. Senate,Mark Beard,IND,410018,0,1,14,15,
Lincoln,U.S. House,Frankie Robbins,DEM,410018,4,2,87,93,03
Lincoln,U.S. House,Frank Lucas,REP,410018,1,13,205,219,03
Lincoln,State Senate,Marilyn Rainwater,DEM,410018,4,3,86,93,28
Lincoln,State Senate,Jason Smalley,REP,410018,1,12,208,221,28
Lincoln,State House,Michial Poteet,DEM,410018,4,5,136,145,32
Lincoln,State House,Kevin Wallace,REP,410018,1,10,156,167,32
Lincoln,Governor,Joe Dorman,DEM,410019,5,1,144,150,
Lincoln,Governor,Mary Fallin,REP,410019,9,9,243,261,
Lincoln,Governor,Kimberly Willis,IND,410019,0,0,11,11,
Lincoln,Governor,Richard Prawdzienski,IND,410019,0,0,7,7,
Lincoln,Lieutenant Governor,Cathy Cummings,DEM,410019,3,1,88,92,
Lincoln,Lieutenant Governor,Todd Lamb,REP,410019,11,9,313,333,
Lincoln,Superintendent of Public Instruction,John Cox,DEM,410019,5,2,157,164,
Lincoln,Superintendent of Public Instruction,Joy Hofmeister,REP,410019,9,8,240,257,
Lincoln,Commissioner of Labor,Mike Workman,DEM,410019,6,1,143,150,
Lincoln,Commissioner of Labor,Mark Costello,REP,410019,8,9,248,265,
Lincoln,U.S. Senate,Matt Silverstein,DEM,410019,2,2,74,78,
Lincoln,U.S. Senate,Jim Inhofe,REP,410019,11,8,311,330,
Lincoln,U.S. Senate,Aaron Delozier,IND,410019,0,0,6,6,
Lincoln,U.S. Senate,Ray Woods,IND,410019,1,0,9,10,
Lincoln,U.S. Senate,Joan Farr,IND,410019,0,0,3,3,
Lincoln,U.S. Senate,Connie Johnson,DEM,410019,1,2,67,70,
Lincoln,U.S. Senate,James Lankford,REP,410019,12,8,322,342,
Lincoln,U.S. Senate,Mark Beard,IND,410019,1,0,15,16,
Lincoln,U.S. House,Frankie Robbins,DEM,410019,3,2,75,80,03
Lincoln,U.S. House,Frank Lucas,REP,410019,11,8,329,348,03
Lincoln,State Senate,Marilyn Rainwater,DEM,410019,2,1,90,93,28
Lincoln,State Senate,Jason Smalley,REP,410019,12,9,310,331,28
Lincoln,State House,Michial Poteet,DEM,410019,5,0,154,159,32
Lincoln,State House,Kevin Wallace,REP,410019,9,10,246,265,32
Lincoln,Governor,Joe Dorman,DEM,410020,1,0,86,87,
Lincoln,Governor,Mary Fallin,REP,410020,3,7,161,171,
Lincoln,Governor,Kimberly Willis,IND,410020,0,0,13,13,
Lincoln,Governor,Richard Prawdzienski,IND,410020,0,0,6,6,
Lincoln,Lieutenant Governor,Cathy Cummings,DEM,410020,1,0,65,66,
Lincoln,Lieutenant Governor,Todd Lamb,REP,410020,3,7,202,212,
Lincoln,Superintendent of Public Instruction,John Cox,DEM,410020,1,0,88,89,
Lincoln,Superintendent of Public Instruction,Joy Hofmeister,REP,410020,3,7,175,185,
Lincoln,Commissioner of Labor,Mike Workman,DEM,410020,1,0,85,86,
Lincoln,Commissioner of Labor,Mark Costello,REP,410020,3,7,181,191,
Lincoln,U.S. Senate,Matt Silverstein,DEM,410020,1,0,61,62,
Lincoln,U.S. Senate,Jim Inhofe,REP,410020,3,7,193,203,
Lincoln,U.S. Senate,Aaron Delozier,IND,410020,0,0,3,3,
Lincoln,U.S. Senate,Ray Woods,IND,410020,0,0,5,5,
Lincoln,U.S. Senate,Joan Farr,IND,410020,0,0,4,4,
Lincoln,U.S. Senate,Connie Johnson,DEM,410020,1,0,58,59,
Lincoln,U.S. Senate,James Lankford,REP,410020,3,7,197,207,
Lincoln,U.S. Senate,Mark Beard,IND,410020,0,0,12,12,
Lincoln,U.S. House,Frankie Robbins,DEM,410020,1,0,67,68,03
Lincoln,U.S. House,Frank Lucas,REP,410020,3,7,200,210,03
Lincoln,State Senate,Marilyn Rainwater,DEM,410020,1,0,74,75,28
Lincoln,State Senate,Jason Smalley,REP,410020,3,7,193,203,28
Lincoln,State House,Michial Poteet,DEM,410020,1,0,75,76,32
Lincoln,State House,Kevin Wallace,REP,410020,3,7,191,201,32
Lincoln,Governor,Joe Dorman,DEM,410021,2,5,173,180,
Lincoln,Governor,Mary Fallin,REP,410021,7,8,338,353,
Lincoln,Governor,Kimberly Willis,IND,410021,0,0,12,12,
Lincoln,Governor,Richard Prawdzienski,IND,410021,0,1,10,11,
Lincoln,Lieutenant Governor,Cathy Cummings,DEM,410021,2,5,127,134,
Lincoln,Lieutenant Governor,Todd Lamb,REP,410021,8,9,403,420,
Lincoln,Superintendent of Public Instruction,John Cox,DEM,410021,3,8,226,237,
Lincoln,Superintendent of Public Instruction,Joy Hofmeister,REP,410021,7,6,303,316,
Lincoln,Commissioner of Labor,Mike Workman,DEM,410021,5,5,177,187,
Lincoln,Commissioner of Labor,Mark Costello,REP,410021,5,9,344,358,
Lincoln,U.S. Senate,Matt Silverstein,DEM,410021,3,3,103,109,
Lincoln,U.S. Senate,Jim Inhofe,REP,410021,6,11,407,424,
Lincoln,U.S. Senate,Aaron Delozier,IND,410021,1,0,9,10,
Lincoln,U.S. Senate,Ray Woods,IND,410021,0,0,5,5,
Lincoln,U.S. Senate,Joan Farr,IND,410021,0,0,7,7,
Lincoln,U.S. Senate,Connie Johnson,DEM,410021,3,2,93,98,
Lincoln,U.S. Senate,James Lankford,REP,410021,5,12,419,436,
Lincoln,U.S. Senate,Mark Beard,IND,410021,2,0,20,22,
Lincoln,U.S. House,Frankie Robbins,DEM,410021,2,2,123,127,03
Lincoln,U.S. House,Frank Lucas,REP,410021,8,12,406,426,03
Lincoln,State Senate,Marilyn Rainwater,DEM,410021,1,1,111,113,28
Lincoln,State Senate,Jason Smalley,REP,410021,9,12,416,437,28
Lincoln,State House,Michial Poteet,DEM,410021,5,6,188,199,32
Lincoln,State House,Kevin Wallace,REP,410021,4,7,340,351,32
Lincoln,Governor,Joe Dorman,DEM,410022,4,3,195,202,
Lincoln,Governor,Mary Fallin,REP,410022,8,2,340,350,
Lincoln,Governor,Kimberly Willis,IND,410022,0,0,7,7,
Lincoln,Governor,Richard Prawdzienski,IND,410022,0,0,8,8,
Lincoln,Lieutenant Governor,Cathy Cummings,DEM,410022,2,2,133,137,
Lincoln,Lieutenant Governor,Todd Lamb,REP,410022,10,3,410,423,
Lincoln,Superintendent of Public Instruction,John Cox,DEM,410022,7,2,260,269,
Lincoln,Superintendent of Public Instruction,Joy Hofmeister,REP,410022,5,3,284,292,
Lincoln,Commissioner of Labor,Mike Workman,DEM,410022,5,2,187,194,
Lincoln,Commissioner of Labor,Mark Costello,REP,410022,7,3,348,358,
Lincoln,U.S. Senate,Matt Silverstein,DEM,410022,3,2,113,118,
Lincoln,U.S. Senate,Jim Inhofe,REP,410022,9,2,423,434,
Lincoln,U.S. Senate,Aaron Delozier,IND,410022,0,1,3,4,
Lincoln,U.S. Senate,Ray Woods,IND,410022,0,0,4,4,
Lincoln,U.S. Senate,Joan Farr,IND,410022,0,0,3,3,
Lincoln,U.S. Senate,Connie Johnson,DEM,410022,3,1,111,115,
Lincoln,U.S. Senate,James Lankford,REP,410022,9,3,428,440,
Lincoln,U.S. Senate,Mark Beard,IND,410022,0,1,10,11,
Lincoln,U.S. House,Frankie Robbins,DEM,410022,2,3,123,128,03
Lincoln,U.S. House,Frank Lucas,REP,410022,9,2,422,433,03
Lincoln,State Senate,Marilyn Rainwater,DEM,410022,1,1,127,129,28
Lincoln,State Senate,Jason Smalley,REP,410022,10,4,422,436,28
Lincoln,State House,Michial Poteet,DEM,410022,5,2,225,232,32
Lincoln,State House,Kevin Wallace,REP,410022,6,3,319,328,32
Logan,Governor,Joe Dorman,DEM,420101,6,4,52,62,
Logan,Governor,Mary Fallin,REP,420101,14,5,203,222,
Logan,Governor,Kimberly Willis,IND,420101,0,0,3,3,
Logan,Governor,Richard Prawdzienski,IND,420101,0,0,2,2,
Logan,Lieutenant Governor,Cathy Cummings,DEM,420101,3,4,25,32,
Logan,Lieutenant Governor,Todd Lamb,REP,420101,19,5,233,257,
Logan,Superintendent of Public Instruction,John Cox,DEM,420101,6,5,71,82,
Logan,Superintendent of Public Instruction,Joy Hofmeister,REP,420101,16,4,185,205,
Logan,Commissioner of Labor,Mike Workman,DEM,420101,2,2,30,34,
Logan,Commissioner of Labor,Mark Costello,REP,420101,19,7,224,250,
Logan,U.S. Senate,Matt Silverstein,DEM,420101,5,3,15,23,
Logan,U.S. Senate,Jim Inhofe,REP,420101,17,6,232,255,
Logan,U.S. Senate,Aaron Delozier,IND,420101,0,0,1,1,
Logan,U.S. Senate,Ray Woods,IND,420101,0,0,2,2,
Logan,U.S. Senate,Joan Farr,IND,420101,0,0,6,6,
Logan,U.S. Senate,Connie Johnson,DEM,420101,3,4,23,30,
Logan,U.S. Senate,James Lankford,REP,420101,17,5,236,258,
Logan,U.S. Senate,Mark Beard,IND,420101,1,0,1,2,
Logan,U.S. House,Frankie Robbins,DEM,420101,5,4,26,35,03
Logan,U.S. House,Frank Lucas,REP,420101,15,5,229,249,03
Logan,Governor,Joe Dorman,DEM,420102,6,14,129,149,
Logan,Governor,Mary Fallin,REP,420102,17,52,296,365,
Logan,Governor,Kimberly Willis,IND,420102,0,3,7,10,
Logan,Governor,Richard Prawdzienski,IND,420102,0,2,8,10,
Logan,Lieutenant Governor,Cathy Cummings,DEM,420102,6,14,87,107,
Logan,Lieutenant Governor,Todd Lamb,REP,420102,17,57,351,425,
Logan,Superintendent of Public Instruction,John Cox,DEM,420102,8,19,142,169,
Logan,Superintendent of Public Instruction,Joy Hofmeister,REP,420102,15,50,296,361,
Logan,Commissioner of Labor,Mike Workman,DEM,420102,5,14,99,118,
Logan,Commissioner of Labor,Mark Costello,REP,420102,18,56,331,405,
Logan,U.S. Senate,Matt Silverstein,DEM,420102,5,14,79,98,
Logan,U.S. Senate,Jim Inhofe,REP,420102,17,55,345,417,
Logan,U.S. Senate,Aaron Delozier,IND,420102,0,0,6,6,
Logan,U.S. Senate,Ray Woods,IND,420102,1,1,2,4,
Logan,U.S. Senate,Joan Farr,IND,420102,0,1,4,5,
Logan,U.S. Senate,Connie Johnson,DEM,420102,4,13,70,87,
Logan,U.S. Senate,James Lankford,REP,420102,19,55,361,435,
Logan,U.S. Senate,Mark Beard,IND,420102,0,2,6,8,
Logan,U.S. House,Frankie Robbins,DEM,420102,4,13,81,98,03
Logan,U.S. House,Frank Lucas,REP,420102,19,58,349,426,03
Logan,Governor,Joe Dorman,DEM,420103,20,19,262,301,
Logan,Governor,Mary Fallin,REP,420103,39,39,712,790,
Logan,Governor,Kimberly Willis,IND,420103,1,1,17,19,
Logan,Governor,Richard Prawdzienski,IND,420103,2,0,14,16,
Logan,Lieutenant Governor,Cathy Cummings,DEM,420103,17,11,187,215,
Logan,Lieutenant Governor,Todd Lamb,REP,420103,44,48,819,911,
Logan,Superintendent of Public Instruction,John Cox,DEM,420103,24,24,268,316,
Logan,Superintendent of Public Instruction,Joy Hofmeister,REP,420103,37,35,728,800,
Logan,Commissioner of Labor,Mike Workman,DEM,420103,17,13,187,217,
Logan,Commissioner of Labor,Mark Costello,REP,420103,44,45,803,892,
Logan,U.S. Senate,Matt Silverstein,DEM,420103,20,14,166,200,
Logan,U.S. Senate,Jim Inhofe,REP,420103,40,45,811,896,
Logan,U.S. Senate,Aaron Delozier,IND,420103,0,0,6,6,
Logan,U.S. Senate,Ray Woods,IND,420103,2,0,10,12,
Logan,U.S. Senate,Joan Farr,IND,420103,1,0,9,10,
Logan,U.S. Senate,Connie Johnson,DEM,420103,16,12,157,185,
Logan,U.S. Senate,James Lankford,REP,420103,39,46,824,909,
Logan,U.S. Senate,Mark Beard,IND,420103,7,1,20,28,
Logan,U.S. House,Frankie Robbins,DEM,420103,19,13,160,192,03
Logan,U.S. House,Frank Lucas,REP,420103,43,46,834,923,03
Logan,Governor,Joe Dorman,DEM,420104,10,10,151,171,
Logan,Governor,Mary Fallin,REP,420104,22,33,459,514,
Logan,Governor,Kimberly Willis,IND,420104,0,0,14,14,
Logan,Governor,Richard Prawdzienski,IND,420104,0,0,7,7,
Logan,Lieutenant Governor,Cathy Cummings,DEM,420104,7,11,100,118,
Logan,Lieutenant Governor,Todd Lamb,REP,420104,25,32,530,587,
Logan,Superintendent of Public Instruction,John Cox,DEM,420104,9,14,169,192,
Logan,Superintendent of Public Instruction,Joy Hofmeister,REP,420104,23,29,458,510,
Logan,Commissioner of Labor,Mike Workman,DEM,420104,7,9,111,127,
Logan,Commissioner of Labor,Mark Costello,REP,420104,25,34,510,569,
Logan,U.S. Senate,Matt Silverstein,DEM,420104,7,8,94,109,
Logan,U.S. Senate,Jim Inhofe,REP,420104,24,33,519,576,
Logan,U.S. Senate,Aaron Delozier,IND,420104,0,1,5,6,
Logan,U.S. Senate,Ray Woods,IND,420104,0,0,6,6,
Logan,U.S. Senate,Joan Farr,IND,420104,0,2,7,9,
Logan,U.S. Senate,Connie Johnson,DEM,420104,7,9,90,106,
Logan,U.S. Senate,James Lankford,REP,420104,24,34,522,580,
Logan,U.S. Senate,Mark Beard,IND,420104,0,1,20,21,
Logan,U.S. House,Frankie Robbins,DEM,420104,8,8,93,109,03
Logan,U.S. House,Frank Lucas,REP,420104,23,36,537,596,03
Logan,Governor,Joe Dorman,DEM,420105,4,15,142,161,
Logan,Governor,Mary Fallin,REP,420105,7,53,273,333,
Logan,Governor,Kimberly Willis,IND,420105,1,1,13,15,
Logan,Governor,Richard Prawdzienski,IND,420105,0,0,7,7,
Logan,Lieutenant Governor,Cathy Cummings,DEM,420105,5,12,88,105,
Logan,Lieutenant Governor,Todd Lamb,REP,420105,6,57,347,410,
Logan,Superintendent of Public Instruction,John Cox,DEM,420105,6,21,166,193,
Logan,Superintendent of Public Instruction,Joy Hofmeister,REP,420105,5,47,264,316,
Logan,Commissioner of Labor,Mike Workman,DEM,420105,4,12,111,127,
Logan,Commissioner of Labor,Mark Costello,REP,420105,7,55,318,380,
Logan,U.S. Senate,Matt Silverstein,DEM,420105,2,12,85,99,
Logan,U.S. Senate,Jim Inhofe,REP,420105,9,56,329,394,
Logan,U.S. Senate,Aaron Delozier,IND,420105,0,0,6,6,
Logan,U.S. Senate,Ray Woods,IND,420105,0,1,7,8,
Logan,U.S. Senate,Joan Farr,IND,420105,1,0,5,6,
Logan,U.S. Senate,Connie Johnson,DEM,420105,3,10,88,101,
Logan,U.S. Senate,James Lankford,REP,420105,9,57,330,396,
Logan,U.S. Senate,Mark Beard,IND,420105,0,2,19,21,
Logan,U.S. House,Frankie Robbins,DEM,420105,3,10,88,101,03
Logan,U.S. House,Frank Lucas,REP,420105,8,59,342,409,03
Logan,Governor,Joe Dorman,DEM,420106,18,13,171,202,
Logan,Governor,Mary Fallin,REP,420106,21,38,489,548,
Logan,Governor,Kimberly Willis,IND,420106,2,0,14,16,
Logan,Governor,Richard Prawdzienski,IND,420106,2,0,5,7,
Logan,Lieutenant Governor,Cathy Cummings,DEM,420106,15,11,118,144,
Logan,Lieutenant Governor,Todd Lamb,REP,420106,28,40,565,633,
Logan,Superintendent of Public Instruction,John Cox,DEM,420106,17,12,174,203,
Logan,Superintendent of Public Instruction,Joy Hofmeister,REP,420106,26,39,502,567,
Logan,Commissioner of Labor,Mike Workman,DEM,420106,16,10,124,150,
Logan,Commissioner of Labor,Mark Costello,REP,420106,25,41,541,607,
Logan,U.S. Senate,Matt Silverstein,DEM,420106,12,12,108,132,
Logan,U.S. Senate,Jim Inhofe,REP,420106,27,38,557,622,
Logan,U.S. Senate,Aaron Delozier,IND,420106,0,0,5,5,
Logan,U.S. Senate,Ray Woods,IND,420106,2,0,8,10,
Logan,U.S. Senate,Joan Farr,IND,420106,1,1,3,5,
Logan,U.S. Senate,Connie Johnson,DEM,420106,14,8,94,116,
Logan,U.S. Senate,James Lankford,REP,420106,27,42,561,630,
Logan,U.S. Senate,Mark Beard,IND,420106,2,1,21,24,
Logan,U.S. House,Frankie Robbins,DEM,420106,14,9,106,129,03
Logan,U.S. House,Frank Lucas,REP,420106,29,42,568,639,03
Logan,Governor,Joe Dorman,DEM,420201,0,1,54,55,
Logan,Governor,Mary Fallin,REP,420201,0,2,37,39,
Logan,Governor,Kimberly Willis,IND,420201,0,0,4,4,
Logan,Governor,Richard Prawdzienski,IND,420201,0,1,0,1,
Logan,Lieutenant Governor,Cathy Cummings,DEM,420201,0,0,29,29,
Logan,Lieutenant Governor,Todd Lamb,REP,420201,0,4,65,69,
Logan,Superintendent of Public Instruction,John Cox,DEM,420201,0,0,53,53,
Logan,Superintendent of Public Instruction,Joy Hofmeister,REP,420201,0,4,41,45,
Logan,Commissioner of Labor,Mike Workman,DEM,420201,0,0,35,35,
Logan,Commissioner of Labor,Mark Costello,REP,420201,0,4,56,60,
Logan,U.S. Senate,Matt Silverstein,DEM,420201,0,0,27,27,
Logan,U.S. Senate,Jim Inhofe,REP,420201,0,4,62,66,
Logan,U.S. Senate,Aaron Delozier,IND,420201,0,0,1,1,
Logan,U.S. Senate,Ray Woods,IND,420201,0,0,2,2,
Logan,U.S. Senate,Joan Farr,IND,420201,0,0,1,1,
Logan,U.S. Senate,Connie Johnson,DEM,420201,0,0,30,30,
Logan,U.S. Senate,James Lankford,REP,420201,0,3,62,65,
Logan,U.S. Senate,Mark Beard,IND,420201,0,1,3,4,
Logan,U.S. House,Frankie Robbins,DEM,420201,0,0,26,26,03
Logan,U.S. House,Frank Lucas,REP,420201,0,4,68,72,03
Logan,Governor,Joe Dorman,DEM,420203,7,7,76,90,
Logan,Governor,Mary Fallin,REP,420203,12,4,88,104,
Logan,Governor,Kimberly Willis,IND,420203,0,0,3,3,
Logan,Governor,Richard Prawdzienski,IND,420203,0,0,2,2,
Logan,Lieutenant Governor,Cathy Cummings,DEM,420203,7,7,48,62,
Logan,Lieutenant Governor,Todd Lamb,REP,420203,13,4,121,138,
Logan,Superintendent of Public Instruction,John Cox,DEM,420203,12,8,85,105,
Logan,Superintendent of Public Instruction,Joy Hofmeister,REP,420203,8,3,83,94,
Logan,Commissioner of Labor,Mike Workman,DEM,420203,7,7,61,75,
Logan,Commissioner of Labor,Mark Costello,REP,420203,13,4,101,118,
Logan,U.S. Senate,Matt Silverstein,DEM,420203,7,6,39,52,
Logan,U.S. Senate,Jim Inhofe,REP,420203,13,4,123,140,
Logan,U.S. Senate,Aaron Delozier,IND,420203,0,0,3,3,
Logan,U.S. Senate,Ray Woods,IND,420203,0,0,2,2,
Logan,U.S. Senate,Joan Farr,IND,420203,0,0,3,3,
Logan,U.S. Senate,Connie Johnson,DEM,420203,7,7,46,60,
Logan,U.S. Senate,James Lankford,REP,420203,13,4,118,135,
Logan,U.S. Senate,Mark Beard,IND,420203,0,0,5,5,
Logan,U.S. House,Frankie Robbins,DEM,420203,9,6,42,57,03
Logan,U.S. House,Frank Lucas,REP,420203,10,5,126,141,03
Logan,State House,Michial Poteet,DEM,420203,9,7,64,80,32
Logan,State House,Kevin Wallace,REP,420203,11,4,103,118,32
Logan,Governor,Joe Dorman,DEM,420204,5,28,237,270,
Logan,Governor,Mary Fallin,REP,420204,7,51,396,454,
Logan,Governor,Kimberly Willis,IND,420204,0,3,13,16,
Logan,Governor,Richard Prawdzienski,IND,420204,0,0,9,9,
Logan,Lieutenant Governor,Cathy Cummings,DEM,420204,5,21,176,202,
Logan,Lieutenant Governor,Todd Lamb,REP,420204,7,61,478,546,
Logan,Superintendent of Public Instruction,John Cox,DEM,420204,5,31,238,274,
Logan,Superintendent of Public Instruction,Joy Hofmeister,REP,420204,8,51,416,475,
Logan,Commissioner of Labor,Mike Workman,DEM,420204,4,25,203,232,
Logan,Commissioner of Labor,Mark Costello,REP,420204,8,54,440,502,
Logan,U.S. Senate,Matt Silverstein,DEM,420204,4,19,144,167,
Logan,U.S. Senate,Jim Inhofe,REP,420204,9,59,482,550,
Logan,U.S. Senate,Aaron Delozier,IND,420204,0,0,5,5,
Logan,U.S. Senate,Ray Woods,IND,420204,0,1,9,10,
Logan,U.S. Senate,Joan Farr,IND,420204,0,2,13,15,
Logan,U.S. Senate,Connie Johnson,DEM,420204,4,20,169,193,
Logan,U.S. Senate,James Lankford,REP,420204,9,59,470,538,
Logan,U.S. Senate,Mark Beard,IND,420204,0,2,19,21,
Logan,U.S. House,Frankie Robbins,DEM,420204,4,21,170,195,03
Logan,U.S. House,Frank Lucas,REP,420204,9,59,488,556,03
Logan,Governor,Joe Dorman,DEM,420205,8,22,266,296,
Logan,Governor,Mary Fallin,REP,420205,16,40,581,637,
Logan,Governor,Kimberly Willis,IND,420205,0,0,23,23,
Logan,Governor,Richard Prawdzienski,IND,420205,0,1,20,21,
Logan,Lieutenant Governor,Cathy Cummings,DEM,420205,8,15,193,216,
Logan,Lieutenant Governor,Todd Lamb,REP,420205,16,48,699,763,
Logan,Superintendent of Public Instruction,John Cox,DEM,420205,14,18,274,306,
Logan,Superintendent of Public Instruction,Joy Hofmeister,REP,420205,10,44,615,669,
Logan,Commissioner of Labor,Mike Workman,DEM,420205,10,17,225,252,
Logan,Commissioner of Labor,Mark Costello,REP,420205,14,45,652,711,
Logan,U.S. Senate,Matt Silverstein,DEM,420205,4,14,162,180,
Logan,U.S. Senate,Jim Inhofe,REP,420205,19,46,700,765,
Logan,U.S. Senate,Aaron Delozier,IND,420205,0,0,9,9,
Logan,U.S. Senate,Ray Woods,IND,420205,1,2,14,17,
Logan,U.S. Senate,Joan Farr,IND,420205,0,1,6,7,
Logan,U.S. Senate,Connie Johnson,DEM,420205,8,14,157,179,
Logan,U.S. Senate,James Lankford,REP,420205,16,48,703,767,
Logan,U.S. Senate,Mark Beard,IND,420205,0,1,32,33,
Logan,U.S. House,Frankie Robbins,DEM,420205,5,14,167,186,03
Logan,U.S. House,Frank Lucas,REP,420205,19,49,721,789,03
Logan,Governor,Joe Dorman,DEM,420206,4,8,209,221,
Logan,Governor,Mary Fallin,REP,420206,13,19,428,460,
Logan,Governor,Kimberly Willis,IND,420206,1,1,16,18,
Logan,Governor,Richard Prawdzienski,IND,420206,0,0,8,8,
Logan,Lieutenant Governor,Cathy Cummings,DEM,420206,4,8,167,179,
Logan,Lieutenant Governor,Todd Lamb,REP,420206,14,20,490,524,
Logan,Superintendent of Public Instruction,John Cox,DEM,420206,3,13,242,258,
Logan,Superintendent of Public Instruction,Joy Hofmeister,REP,420206,15,15,413,443,
Logan,Commissioner of Labor,Mike Workman,DEM,420206,4,8,170,182,
Logan,Commissioner of Labor,Mark Costello,REP,420206,14,20,476,510,
Logan,U.S. Senate,Matt Silverstein,DEM,420206,4,4,140,148,
Logan,U.S. Senate,Jim Inhofe,REP,420206,14,21,489,524,
Logan,U.S. Senate,Aaron Delozier,IND,420206,0,1,8,9,
Logan,U.S. Senate,Ray Woods,IND,420206,0,1,12,13,
Logan,U.S. Senate,Joan Farr,IND,420206,0,1,8,9,
Logan,U.S. Senate,Connie Johnson,DEM,420206,5,6,142,153,
Logan,U.S. Senate,James Lankford,REP,420206,13,22,494,529,
Logan,U.S. Senate,Mark Beard,IND,420206,0,1,22,23,
Logan,U.S. House,Frankie Robbins,DEM,420206,4,6,151,161,03
Logan,U.S. House,Frank Lucas,REP,420206,14,22,502,538,03
Logan,Governor,Joe Dorman,DEM,420207,18,10,193,221,
Logan,Governor,Mary Fallin,REP,420207,22,30,492,544,
Logan,Governor,Kimberly Willis,IND,420207,0,0,16,16,
Logan,Governor,Richard Prawdzienski,IND,420207,0,0,13,13,
Logan,Lieutenant Governor,Cathy Cummings,DEM,420207,15,5,148,168,
Logan,Lieutenant Governor,Todd Lamb,REP,420207,25,35,563,623,
Logan,Superintendent of Public Instruction,John Cox,DEM,420207,19,11,214,244,
Logan,Superintendent of Public Instruction,Joy Hofmeister,REP,420207,21,28,498,547,
Logan,Commissioner of Labor,Mike Workman,DEM,420207,13,9,155,177,
Logan,Commissioner of Labor,Mark Costello,REP,420207,28,29,552,609,
Logan,U.S. Senate,Matt Silverstein,DEM,420207,14,6,126,146,
Logan,U.S. Senate,Jim Inhofe,REP,420207,26,31,560,617,
Logan,U.S. Senate,Aaron Delozier,IND,420207,0,0,4,4,
Logan,U.S. Senate,Ray Woods,IND,420207,0,1,10,11,
Logan,U.S. Senate,Joan Farr,IND,420207,1,2,13,16,
Logan,U.S. Senate,Connie Johnson,DEM,420207,13,7,117,137,
Logan,U.S. Senate,James Lankford,REP,420207,25,32,574,631,
Logan,U.S. Senate,Mark Beard,IND,420207,3,1,22,26,
Logan,U.S. House,Frankie Robbins,DEM,420207,14,7,133,154,03
Logan,U.S. House,Frank Lucas,REP,420207,27,33,576,636,03
Logan,Governor,Joe Dorman,DEM,420301,0,0,21,21,
Logan,Governor,Mary Fallin,REP,420301,2,5,80,87,
Logan,Governor,Kimberly Willis,IND,420301,0,0,1,1,
Logan,Governor,Richard Prawdzienski,IND,420301,0,0,3,3,
Logan,Lieutenant Governor,Cathy Cummings,DEM,420301,0,0,5,5,
Logan,Lieutenant Governor,Todd Lamb,REP,420301,2,5,101,108,
Logan,Superintendent of Public Instruction,John Cox,DEM,420301,2,0,25,27,
Logan,Superintendent of Public Instruction,Joy Hofmeister,REP,420301,0,5,80,85,
Logan,Commissioner of Labor,Mike Workman,DEM,420301,0,0,15,15,
Logan,Commissioner of Labor,Mark Costello,REP,420301,2,5,88,95,
Logan,U.S. Senate,Matt Silverstein,DEM,420301,0,0,5,5,
Logan,U.S. Senate,Jim Inhofe,REP,420301,2,5,99,106,
Logan,U.S. Senate,Aaron Delozier,IND,420301,0,0,0,0,
Logan,U.S. Senate,Ray Woods,IND,420301,0,0,0,0,
Logan,U.S. Senate,Joan Farr,IND,420301,0,0,2,2,
Logan,U.S. Senate,Connie Johnson,DEM,420301,0,0,5,5,
Logan,U.S. Senate,James Lankford,REP,420301,2,5,97,104,
Logan,U.S. Senate,Mark Beard,IND,420301,0,0,3,3,
Logan,U.S. House,Frankie Robbins,DEM,420301,0,0,5,5,03
Logan,U.S. House,Frank Lucas,REP,420301,2,5,100,107,03
Logan,Governor,Joe Dorman,DEM,420302,1,0,20,21,
Logan,Governor,Mary Fallin,REP,420302,1,1,49,51,
Logan,Governor,Kimberly Willis,IND,420302,0,0,3,3,
Logan,Governor,Richard Prawdzienski,IND,420302,0,0,0,0,
Logan,Lieutenant Governor,Cathy Cummings,DEM,420302,0,0,8,8,
Logan,Lieutenant Governor,Todd Lamb,REP,420302,2,1,64,67,
Logan,Superintendent of Public Instruction,John Cox,DEM,420302,1,0,26,27,
Logan,Superintendent of Public Instruction,Joy Hofmeister,REP,420302,1,1,46,48,
Logan,Commissioner of Labor,Mike Workman,DEM,420302,1,0,23,24,
Logan,Commissioner of Labor,Mark Costello,REP,420302,1,1,48,50,
Logan,U.S. Senate,Matt Silverstein,DEM,420302,1,0,10,11,
Logan,U.S. Senate,Jim Inhofe,REP,420302,1,1,60,62,
Logan,U.S. Senate,Aaron Delozier,IND,420302,0,0,0,0,
Logan,U.S. Senate,Ray Woods,IND,420302,0,0,2,2,
Logan,U.S. Senate,Joan Farr,IND,420302,0,0,0,0,
Logan,U.S. Senate,Connie Johnson,DEM,420302,0,0,8,8,
Logan,U.S. Senate,James Lankford,REP,420302,2,1,64,67,
Logan,U.S. Senate,Mark Beard,IND,420302,0,0,0,0,
Logan,U.S. House,Frankie Robbins,DEM,420302,0,0,3,3,03
Logan,U.S. House,Frank Lucas,REP,420302,2,1,69,72,03
Logan,Governor,Joe Dorman,DEM,420303,5,3,195,203,
Logan,Governor,Mary Fallin,REP,420303,9,12,468,489,
Logan,Governor,Kimberly Willis,IND,420303,0,0,8,8,
Logan,Governor,Richard Prawdzienski,IND,420303,0,1,8,9,
Logan,Lieutenant Governor,Cathy Cummings,DEM,420303,4,2,137,143,
Logan,Lieutenant Governor,Todd Lamb,REP,420303,10,14,542,566,
Logan,Superintendent of Public Instruction,John Cox,DEM,420303,4,5,230,239,
Logan,Superintendent of Public Instruction,Joy Hofmeister,REP,420303,10,11,449,470,
Logan,Commissioner of Labor,Mike Workman,DEM,420303,5,4,199,208,
Logan,Commissioner of Labor,Mark Costello,REP,420303,9,12,471,492,
Logan,U.S. Senate,Matt Silverstein,DEM,420303,4,2,113,119,
Logan,U.S. Senate,Jim Inhofe,REP,420303,10,13,547,570,
Logan,U.S. Senate,Aaron Delozier,IND,420303,0,0,2,2,
Logan,U.S. Senate,Ray Woods,IND,420303,0,1,10,11,
Logan,U.S. Senate,Joan Farr,IND,420303,0,0,6,6,
Logan,U.S. Senate,Connie Johnson,DEM,420303,3,2,116,121,
Logan,U.S. Senate,James Lankford,REP,420303,10,14,538,562,
Logan,U.S. Senate,Mark Beard,IND,420303,0,0,22,22,
Logan,U.S. House,Frankie Robbins,DEM,420303,3,2,121,126,03
Logan,U.S. House,Frank Lucas,REP,420303,10,14,552,576,03
Logan,Governor,Joe Dorman,DEM,420304,2,2,45,49,
Logan,Governor,Mary Fallin,REP,420304,5,8,148,161,
Logan,Governor,Kimberly Willis,IND,420304,0,0,4,4,
Logan,Governor,Richard Prawdzienski,IND,420304,0,0,0,0,
Logan,Lieutenant Governor,Cathy Cummings,DEM,420304,2,0,19,21,
Logan,Lieutenant Governor,Todd Lamb,REP,420304,5,10,178,193,
Logan,Superintendent of Public Instruction,John Cox,DEM,420304,4,0,69,73,
Logan,Superintendent of Public Instruction,Joy Hofmeister,REP,420304,3,10,125,138,
Logan,Commissioner of Labor,Mike Workman,DEM,420304,1,0,36,37,
Logan,Commissioner of Labor,Mark Costello,REP,420304,5,9,154,168,
Logan,U.S. Senate,Matt Silverstein,DEM,420304,1,0,21,22,
Logan,U.S. Senate,Jim Inhofe,REP,420304,6,10,166,182,
Logan,U.S. Senate,Aaron Delozier,IND,420304,0,0,0,0,
Logan,U.S. Senate,Ray Woods,IND,420304,0,0,6,6,
Logan,U.S. Senate,Joan Farr,IND,420304,0,0,3,3,
Logan,U.S. Senate,Connie Johnson,DEM,420304,1,0,25,26,
Logan,U.S. Senate,James Lankford,REP,420304,6,10,163,179,
Logan,U.S. Senate,Mark Beard,IND,420304,0,0,7,7,
Logan,U.S. House,Frankie Robbins,DEM,420304,1,0,22,23,03
Logan,U.S. House,Frank Lucas,REP,420304,6,10,174,190,03
Logan,Governor,Joe Dorman,DEM,420305,2,15,146,163,
Logan,Governor,Mary Fallin,REP,420305,21,26,278,325,
Logan,Governor,Kimberly Willis,IND,420305,0,0,13,13,
Logan,Governor,Richard Prawdzienski,IND,420305,0,0,2,2,
Logan,Lieutenant Governor,Cathy Cummings,DEM,420305,2,12,110,124,
Logan,Lieutenant Governor,Todd Lamb,REP,420305,21,28,327,376,
Logan,Superintendent of Public Instruction,John Cox,DEM,420305,6,15,160,181,
Logan,Superintendent of Public Instruction,Joy Hofmeister,REP,420305,17,23,274,314,
Logan,Commissioner of Labor,Mike Workman,DEM,420305,1,15,127,143,
Logan,Commissioner of Labor,Mark Costello,REP,420305,21,25,302,348,
Logan,U.S. Senate,Matt Silverstein,DEM,420305,2,13,96,111,
Logan,U.S. Senate,Jim Inhofe,REP,420305,21,28,327,376,
Logan,U.S. Senate,Aaron Delozier,IND,420305,0,0,3,3,
Logan,U.S. Senate,Ray Woods,IND,420305,0,0,6,6,
Logan,U.S. Senate,Joan Farr,IND,420305,0,0,7,7,
Logan,U.S. Senate,Connie Johnson,DEM,420305,2,10,98,110,
Logan,U.S. Senate,James Lankford,REP,420305,20,28,332,380,
Logan,U.S. Senate,Mark Beard,IND,420305,1,0,10,11,
Logan,U.S. House,Frankie Robbins,DEM,420305,1,10,103,114,03
Logan,U.S. House,Frank Lucas,REP,420305,22,31,332,385,03
Logan,Governor,Joe Dorman,DEM,420306,4,2,80,86,
Logan,Governor,Mary Fallin,REP,420306,3,6,105,114,
Logan,Governor,Kimberly Willis,IND,420306,0,1,5,6,
Logan,Governor,Richard Prawdzienski,IND,420306,0,0,3,3,
Logan,Lieutenant Governor,Cathy Cummings,DEM,420306,4,2,48,54,
Logan,Lieutenant Governor,Todd Lamb,REP,420306,3,7,145,155,
Logan,Superintendent of Public Instruction,John Cox,DEM,420306,5,3,85,93,
Logan,Superintendent of Public Instruction,Joy Hofmeister,REP,420306,2,6,106,114,
Logan,Commissioner of Labor,Mike Workman,DEM,420306,4,2,69,75,
Logan,Commissioner of Labor,Mark Costello,REP,420306,2,7,121,130,
Logan,U.S. Senate,Matt Silverstein,DEM,420306,5,2,49,56,
Logan,U.S. Senate,Jim Inhofe,REP,420306,2,7,133,142,
Logan,U.S. Senate,Aaron Delozier,IND,420306,0,0,1,1,
Logan,U.S. Senate,Ray Woods,IND,420306,0,0,4,4,
Logan,U.S. Senate,Joan Farr,IND,420306,0,0,5,5,
Logan,U.S. Senate,Connie Johnson,DEM,420306,5,2,54,61,
Logan,U.S. Senate,James Lankford,REP,420306,2,6,129,137,
Logan,U.S. Senate,Mark Beard,IND,420306,0,1,10,11,
Logan,U.S. House,Frankie Robbins,DEM,420306,5,2,51,58,03
Logan,U.S. House,Frank Lucas,REP,420306,2,7,142,151,03
Logan,Governor,Joe Dorman,DEM,420307,11,20,249,280,
Logan,Governor,Mary Fallin,REP,420307,24,26,300,350,
Logan,Governor,Kimberly Willis,IND,420307,0,2,11,13,
Logan,Governor,Richard Prawdzienski,IND,420307,1,0,10,11,
Logan,Lieutenant Governor,Cathy Cummings,DEM,420307,10,20,188,218,
Logan,Lieutenant Governor,Todd Lamb,REP,420307,26,28,381,435,
Logan,Superintendent of Public Instruction,John Cox,DEM,420307,12,23,250,285,
Logan,Superintendent of Public Instruction,Joy Hofmeister,REP,420307,24,24,315,363,
Logan,Commissioner of Labor,Mike Workman,DEM,420307,12,24,203,239,
Logan,Commissioner of Labor,Mark Costello,REP,420307,23,24,355,402,
Logan,U.S. Senate,Matt Silverstein,DEM,420307,9,19,177,205,
Logan,U.S. Senate,Jim Inhofe,REP,420307,27,25,363,415,
Logan,U.S. Senate,Aaron Delozier,IND,420307,0,1,8,9,
Logan,U.S. Senate,Ray Woods,IND,420307,0,0,9,9,
Logan,U.S. Senate,Joan Farr,IND,420307,0,2,11,13,
Logan,U.S. Senate,Connie Johnson,DEM,420307,10,19,182,211,
Logan,U.S. Senate,James Lankford,REP,420307,25,29,369,423,
Logan,U.S. Senate,Mark Beard,IND,420307,1,0,15,16,
Logan,U.S. House,Frankie Robbins,DEM,420307,11,17,179,207,03
Logan,U.S. House,Frank Lucas,REP,420307,26,31,383,440,03
Logan,Governor,Joe Dorman,DEM,420308,4,28,247,279,
Logan,Governor,Mary Fallin,REP,420308,4,23,236,263,
Logan,Governor,Kimberly Willis,IND,420308,1,0,15,16,
Logan,Governor,Richard Prawdzienski,IND,420308,0,0,6,6,
Logan,Lieutenant Governor,Cathy Cummings,DEM,420308,4,24,200,228,
Logan,Lieutenant Governor,Todd Lamb,REP,420308,5,27,302,334,
Logan,Superintendent of Public Instruction,John Cox,DEM,420308,6,29,242,277,
Logan,Superintendent of Public Instruction,Joy Hofmeister,REP,420308,3,22,258,283,
Logan,Commissioner of Labor,Mike Workman,DEM,420308,5,23,211,239,
Logan,Commissioner of Labor,Mark Costello,REP,420308,4,27,285,316,
Logan,U.S. Senate,Matt Silverstein,DEM,420308,3,21,173,197,
Logan,U.S. Senate,Jim Inhofe,REP,420308,6,29,309,344,
Logan,U.S. Senate,Aaron Delozier,IND,420308,0,0,5,5,
Logan,U.S. Senate,Ray Woods,IND,420308,0,0,6,6,
Logan,U.S. Senate,Joan Farr,IND,420308,0,1,10,11,
Logan,U.S. Senate,Connie Johnson,DEM,420308,3,21,193,217,
Logan,U.S. Senate,James Lankford,REP,420308,5,30,282,317,
Logan,U.S. Senate,Mark Beard,IND,420308,0,0,25,25,
Logan,U.S. House,Frankie Robbins,DEM,420308,2,21,189,212,03
Logan,U.S. House,Frank Lucas,REP,420308,5,30,309,344,03
Logan,Governor,Joe Dorman,DEM,420309,0,2,17,19,
Logan,Governor,Mary Fallin,REP,420309,0,0,11,11,
Logan,Governor,Kimberly Willis,IND,420309,0,0,0,0,
Logan,Governor,Richard Prawdzienski,IND,420309,0,0,0,0,
Logan,Lieutenant Governor,Cathy Cummings,DEM,420309,0,2,11,13,
Logan,Lieutenant Governor,Todd Lamb,REP,420309,0,0,17,17,
Logan,Superintendent of Public Instruction,John Cox,DEM,420309,0,2,16,18,
Logan,Superintendent of Public Instruction,Joy Hofmeister,REP,420309,0,0,12,12,
Logan,Commissioner of Labor,Mike Workman,DEM,420309,0,2,16,18,
Logan,Commissioner of Labor,Mark Costello,REP,420309,0,0,12,12,
Logan,U.S. Senate,Matt Silverstein,DEM,420309,0,2,13,15,
Logan,U.S. Senate,Jim Inhofe,REP,420309,0,0,14,14,
Logan,U.S. Senate,Aaron Delozier,IND,420309,0,0,0,0,
Logan,U.S. Senate,Ray Woods,IND,420309,0,0,1,1,
Logan,U.S. Senate,Joan Farr,IND,420309,0,0,0,0,
Logan,U.S. Senate,Connie Johnson,DEM,420309,0,2,10,12,
Logan,U.S. Senate,James Lankford,REP,420309,0,0,18,18,
Logan,U.S. Senate,Mark Beard,IND,420309,0,0,0,0,
Logan,U.S. House,Frankie Robbins,DEM,420309,0,2,11,13,03
Logan,U.S. House,Frank Lucas,REP,420309,0,0,17,17,03
Logan,Governor,Joe Dorman,DEM,420310,2,3,137,142,
Logan,Governor,Mary Fallin,REP,420310,0,0,3,3,
Logan,Governor,Kimberly Willis,IND,420310,1,0,2,3,
Logan,Governor,Richard Prawdzienski,IND,420310,0,0,2,2,
Logan,Lieutenant Governor,Cathy Cummings,DEM,420310,3,3,136,142,
Logan,Lieutenant Governor,Todd Lamb,REP,420310,0,0,6,6,
Logan,Superintendent of Public Instruction,John Cox,DEM,420310,3,3,134,140,
Logan,Superintendent of Public Instruction,Joy Hofmeister,REP,420310,0,0,8,8,
Logan,Commissioner of Labor,Mike Workman,DEM,420310,2,3,134,139,
Logan,Commissioner of Labor,Mark Costello,REP,420310,1,0,8,9,
Logan,U.S. Senate,Matt Silverstein,DEM,420310,2,2,130,134,
Logan,U.S. Senate,Jim Inhofe,REP,420310,0,1,6,7,
Logan,U.S. Senate,Aaron Delozier,IND,420310,1,0,0,1,
Logan,U.S. Senate,Ray Woods,IND,420310,0,0,4,4,
Logan,U.S. Senate,Joan Farr,IND,420310,0,0,2,2,
Logan,U.S. Senate,Connie Johnson,DEM,420310,3,3,135,141,
Logan,U.S. Senate,James Lankford,REP,420310,0,0,6,6,
Logan,U.S. Senate,Mark Beard,IND,420310,0,0,3,3,
Logan,U.S. House,Frankie Robbins,DEM,420310,3,2,130,135,03
Logan,U.S. House,Frank Lucas,REP,420310,0,1,11,12,03
Logan,State House,Michial Poteet,DEM,420310,3,3,142,148,32
Logan,State House,Kevin Wallace,REP,420310,0,0,2,2,32
Love,Governor,Joe Dorman,DEM,430101,2,9,92,103,
Love,Governor,Mary Fallin,REP,430101,9,7,95,111,
Love,Governor,Kimberly Willis,IND,430101,0,1,6,7,
Love,Governor,Richard Prawdzienski,IND,430101,0,0,5,5,
Love,Lieutenant Governor,Cathy Cummings,DEM,430101,2,10,63,75,
Love,Lieutenant Governor,Todd Lamb,REP,430101,8,7,129,144,
Love,Superintendent of Public Instruction,John Cox,DEM,430101,3,12,91,106,
Love,Superintendent of Public Instruction,Joy Hofmeister,REP,430101,7,5,104,116,
Love,Commissioner of Labor,Mike Workman,DEM,430101,3,10,68,81,
Love,Commissioner of Labor,Mark Costello,REP,430101,7,7,122,136,
Love,U.S. Senate,Matt Silverstein,DEM,430101,2,7,51,60,
Love,U.S. Senate,Jim Inhofe,REP,430101,9,9,140,158,
Love,U.S. Senate,Aaron Delozier,IND,430101,0,1,4,5,
Love,U.S. Senate,Ray Woods,IND,430101,0,0,0,0,
Love,U.S. Senate,Joan Farr,IND,430101,0,0,2,2,
Love,U.S. Senate,Connie Johnson,DEM,430101,2,10,55,67,
Love,U.S. Senate,James Lankford,REP,430101,7,7,130,144,
Love,U.S. Senate,Mark Beard,IND,430101,0,0,8,8,
Love,U.S. House,Bert Smith,DEM,430101,2,8,41,51,04
Love,U.S. House,Tom Cole,REP,430101,8,7,149,164,04
Love,U.S. House,Dennis Johnson,IND,430101,0,2,6,8,04
Love,State Senate,Chequita Williams,DEM,430101,2,7,45,54,14
Love,State Senate,Frank Simpson,REP,430101,8,10,151,169,14
Love,State House,Jessica Pfau,DEM,430101,1,9,53,63,49
Love,State House,Tommy Hardin,REP,430101,8,8,144,160,49
Love,Governor,Joe Dorman,DEM,430102,0,5,84,89,
Love,Governor,Mary Fallin,REP,430102,0,13,112,125,
Love,Governor,Kimberly Willis,IND,430102,0,0,4,4,
Love,Governor,Richard Prawdzienski,IND,430102,0,0,1,1,
Love,Lieutenant Governor,Cathy Cummings,DEM,430102,0,4,59,63,
Love,Lieutenant Governor,Todd Lamb,REP,430102,0,14,134,148,
Love,Superintendent of Public Instruction,John Cox,DEM,430102,0,10,103,113,
Love,Superintendent of Public Instruction,Joy Hofmeister,REP,430102,0,8,93,101,
Love,Commissioner of Labor,Mike Workman,DEM,430102,0,6,67,73,
Love,Commissioner of Labor,Mark Costello,REP,430102,0,12,123,135,
Love,U.S. Senate,Matt Silverstein,DEM,430102,0,2,50,52,
Love,U.S. Senate,Jim Inhofe,REP,430102,0,16,147,163,
Love,U.S. Senate,Aaron Delozier,IND,430102,0,0,1,1,
Love,U.S. Senate,Ray Woods,IND,430102,0,0,2,2,
Love,U.S. Senate,Joan Farr,IND,430102,0,0,2,2,
Love,U.S. Senate,Connie Johnson,DEM,430102,0,4,57,61,
Love,U.S. Senate,James Lankford,REP,430102,0,14,134,148,
Love,U.S. Senate,Mark Beard,IND,430102,0,0,3,3,
Love,U.S. House,Bert Smith,DEM,430102,0,1,45,46,04
Love,U.S. House,Tom Cole,REP,430102,0,17,149,166,04
Love,U.S. House,Dennis Johnson,IND,430102,0,0,5,5,04
Love,State Senate,Chequita Williams,DEM,430102,0,1,44,45,14
Love,State Senate,Frank Simpson,REP,430102,0,17,155,172,14
Love,State House,Jessica Pfau,DEM,430102,0,1,47,48,49
Love,State House,Tommy Hardin,REP,430102,0,17,154,171,49
Love,Governor,Joe Dorman,DEM,430103,0,9,85,94,
Love,Governor,Mary Fallin,REP,430103,0,12,166,178,
Love,Governor,Kimberly Willis,IND,430103,0,0,5,5,
Love,Governor,Richard Prawdzienski,IND,430103,0,0,1,1,
Love,Lieutenant Governor,Cathy Cummings,DEM,430103,0,5,70,75,
Love,Lieutenant Governor,Todd Lamb,REP,430103,0,16,185,201,
Love,Superintendent of Public Instruction,John Cox,DEM,430103,0,9,105,114,
Love,Superintendent of Public Instruction,Joy Hofmeister,REP,430103,0,11,143,154,
Love,Commissioner of Labor,Mike Workman,DEM,430103,0,5,84,89,
Love,Commissioner of Labor,Mark Costello,REP,430103,0,13,161,174,
Love,U.S. Senate,Matt Silverstein,DEM,430103,0,6,59,65,
Love,U.S. Senate,Jim Inhofe,REP,430103,0,15,190,205,
Love,U.S. Senate,Aaron Delozier,IND,430103,0,0,2,2,
Love,U.S. Senate,Ray Woods,IND,430103,0,0,5,5,
Love,U.S. Senate,Joan Farr,IND,430103,0,0,1,1,
Love,U.S. Senate,Connie Johnson,DEM,430103,0,4,62,66,
Love,U.S. Senate,James Lankford,REP,430103,0,14,171,185,
Love,U.S. Senate,Mark Beard,IND,430103,0,1,17,18,
Love,U.S. House,Bert Smith,DEM,430103,0,5,52,57,04
Love,U.S. House,Tom Cole,REP,430103,0,16,193,209,04
Love,U.S. House,Dennis Johnson,IND,430103,0,0,12,12,04
Love,State Senate,Chequita Williams,DEM,430103,0,6,54,60,14
Love,State Senate,Frank Simpson,REP,430103,0,15,202,217,14
Love,State House,Jessica Pfau,DEM,430103,0,6,75,81,49
Love,State House,Tommy Hardin,REP,430103,0,15,181,196,49
Love,Governor,Joe Dorman,DEM,430204,3,11,68,82,
Love,Governor,Mary Fallin,REP,430204,1,5,78,84,
Love,Governor,Kimberly Willis,IND,430204,0,1,9,10,
Love,Governor,Richard Prawdzienski,IND,430204,0,1,2,3,
Love,Lieutenant Governor,Cathy Cummings,DEM,430204,2,9,60,71,
Love,Lieutenant Governor,Todd Lamb,REP,430204,2,8,91,101,
Love,Superintendent of Public Instruction,John Cox,DEM,430204,2,13,85,100,
Love,Superintendent of Public Instruction,Joy Hofmeister,REP,430204,2,4,66,72,
Love,Commissioner of Labor,Mike Workman,DEM,430204,1,10,64,75,
Love,Commissioner of Labor,Mark Costello,REP,430204,3,7,81,91,
Love,U.S. Senate,Matt Silverstein,DEM,430204,2,5,41,48,
Love,U.S. Senate,Jim Inhofe,REP,430204,2,11,107,120,
Love,U.S. Senate,Aaron Delozier,IND,430204,0,1,1,2,
Love,U.S. Senate,Ray Woods,IND,430204,0,1,2,3,
Love,U.S. Senate,Joan Farr,IND,430204,0,0,4,4,
Love,U.S. Senate,Connie Johnson,DEM,430204,2,9,54,65,
Love,U.S. Senate,James Lankford,REP,430204,2,5,92,99,
Love,U.S. Senate,Mark Beard,IND,430204,0,3,4,7,
Love,U.S. House,Bert Smith,DEM,430204,1,6,42,49,04
Love,U.S. House,Tom Cole,REP,430204,3,11,107,121,04
Love,U.S. House,Dennis Johnson,IND,430204,0,1,5,6,04
Love,State Senate,Chequita Williams,DEM,430204,1,7,38,46,14
Love,State Senate,Frank Simpson,REP,430204,3,10,114,127,14
Love,State House,Jessica Pfau,DEM,430204,1,9,53,63,49
Love,State House,Tommy Hardin,REP,430204,3,9,99,111,49
Love,Governor,Joe Dorman,DEM,430205,1,5,103,109,
Love,Governor,Mary Fallin,REP,430205,7,21,150,178,
Love,Governor,Kimberly Willis,IND,430205,0,0,10,10,
Love,Governor,Richard Prawdzienski,IND,430205,0,0,4,4,
Love,Lieutenant Governor,Cathy Cummings,DEM,430205,1,6,75,82,
Love,Lieutenant Governor,Todd Lamb,REP,430205,7,20,188,215,
Love,Superintendent of Public Instruction,John Cox,DEM,430205,1,7,126,134,
Love,Superintendent of Public Instruction,Joy Hofmeister,REP,430205,7,18,137,162,
Love,Commissioner of Labor,Mike Workman,DEM,430205,1,5,90,96,
Love,Commissioner of Labor,Mark Costello,REP,430205,7,18,167,192,
Love,U.S. Senate,Matt Silverstein,DEM,430205,1,3,57,61,
Love,U.S. Senate,Jim Inhofe,REP,430205,7,22,202,231,
Love,U.S. Senate,Aaron Delozier,IND,430205,0,0,2,2,
Love,U.S. Senate,Ray Woods,IND,430205,0,0,4,4,
Love,U.S. Senate,Joan Farr,IND,430205,0,1,3,4,
Love,U.S. Senate,Connie Johnson,DEM,430205,1,4,69,74,
Love,U.S. Senate,James Lankford,REP,430205,7,18,182,207,
Love,U.S. Senate,Mark Beard,IND,430205,0,1,13,14,
Love,U.S. House,Bert Smith,DEM,430205,1,3,57,61,04
Love,U.S. House,Tom Cole,REP,430205,7,22,199,228,04
Love,U.S. House,Dennis Johnson,IND,430205,0,1,11,12,04
Love,State Senate,Chequita Williams,DEM,430205,1,3,56,60,14
Love,State Senate,Frank Simpson,REP,430205,7,23,205,235,14
Love,State House,Jessica Pfau,DEM,430205,1,5,91,97,49
Love,State House,Tommy Hardin,REP,430205,7,21,177,205,49
Love,Governor,Joe Dorman,DEM,430206,1,4,50,55,
Love,Governor,Mary Fallin,REP,430206,2,6,44,52,
Love,Governor,Kimberly Willis,IND,430206,0,1,2,3,
Love,Governor,Richard Prawdzienski,IND,430206,0,0,0,0,
Love,Lieutenant Governor,Cathy Cummings,DEM,430206,1,4,40,45,
Love,Lieutenant Governor,Todd Lamb,REP,430206,2,7,53,62,
Love,Superintendent of Public Instruction,John Cox,DEM,430206,1,4,46,51,
Love,Superintendent of Public Instruction,Joy Hofmeister,REP,430206,2,6,48,56,
Love,Commissioner of Labor,Mike Workman,DEM,430206,1,7,44,52,
Love,Commissioner of Labor,Mark Costello,REP,430206,2,4,50,56,
Love,U.S. Senate,Matt Silverstein,DEM,430206,0,2,26,28,
Love,U.S. Senate,Jim Inhofe,REP,430206,3,9,68,80,
Love,U.S. Senate,Aaron Delozier,IND,430206,0,0,1,1,
Love,U.S. Senate,Ray Woods,IND,430206,0,0,0,0,
Love,U.S. Senate,Joan Farr,IND,430206,0,0,1,1,
Love,U.S. Senate,Connie Johnson,DEM,430206,1,3,37,41,
Love,U.S. Senate,James Lankford,REP,430206,2,7,52,61,
Love,U.S. Senate,Mark Beard,IND,430206,0,1,5,6,
Love,U.S. House,Bert Smith,DEM,430206,0,4,23,27,04
Love,U.S. House,Tom Cole,REP,430206,3,7,67,77,04
Love,U.S. House,Dennis Johnson,IND,430206,0,0,5,5,04
Love,State Senate,Chequita Williams,DEM,430206,0,1,27,28,14
Love,State Senate,Frank Simpson,REP,430206,3,10,69,82,14
Love,State House,Jessica Pfau,DEM,430206,0,1,30,31,49
Love,State House,Tommy Hardin,REP,430206,3,10,66,79,49
Love,Governor,Joe Dorman,DEM,430207,0,3,29,32,
Love,Governor,Mary Fallin,REP,430207,0,1,19,20,
Love,Governor,Kimberly Willis,IND,430207,0,0,2,2,
Love,Governor,Richard Prawdzienski,IND,430207,0,0,1,1,
Love,Lieutenant Governor,Cathy Cummings,DEM,430207,0,1,28,29,
Love,Lieutenant Governor,Todd Lamb,REP,430207,0,3,20,23,
Love,Superintendent of Public Instruction,John Cox,DEM,430207,0,4,42,46,
Love,Superintendent of Public Instruction,Joy Hofmeister,REP,430207,0,0,7,7,
Love,Commissioner of Labor,Mike Workman,DEM,430207,0,3,34,37,
Love,Commissioner of Labor,Mark Costello,REP,430207,0,1,13,14,
Love,U.S. Senate,Matt Silverstein,DEM,430207,0,0,21,21,
Love,U.S. Senate,Jim Inhofe,REP,430207,0,4,20,24,
Love,U.S. Senate,Aaron Delozier,IND,430207,0,0,1,1,
Love,U.S. Senate,Ray Woods,IND,430207,0,0,5,5,
Love,U.S. Senate,Joan Farr,IND,430207,0,0,2,2,
Love,U.S. Senate,Connie Johnson,DEM,430207,0,0,29,29,
Love,U.S. Senate,James Lankford,REP,430207,0,4,13,17,
Love,U.S. Senate,Mark Beard,IND,430207,0,0,6,6,
Love,U.S. House,Bert Smith,DEM,430207,0,0,19,19,04
Love,U.S. House,Tom Cole,REP,430207,0,4,26,30,04
Love,U.S. House,Dennis Johnson,IND,430207,0,0,5,5,04
Love,State Senate,Chequita Williams,DEM,430207,0,0,22,22,14
Love,State Senate,Frank Simpson,REP,430207,0,4,27,31,14
Love,State House,Jessica Pfau,DEM,430207,0,0,21,21,49
Love,State House,Tommy Hardin,REP,430207,0,4,28,32,49
Love,Governor,Joe Dorman,DEM,430208,0,1,24,25,
Love,Governor,Mary Fallin,REP,430208,0,2,10,12,
Love,Governor,Kimberly Willis,IND,430208,0,0,3,3,
Love,Governor,Richard Prawdzienski,IND,430208,0,0,0,0,
Love,Lieutenant Governor,Cathy Cummings,DEM,430208,0,3,21,24,
Love,Lieutenant Governor,Todd Lamb,REP,430208,0,0,15,15,
Love,Superintendent of Public Instruction,John Cox,DEM,430208,0,3,25,28,
Love,Superintendent of Public Instruction,Joy Hofmeister,REP,430208,0,0,12,12,
Love,Commissioner of Labor,Mike Workman,DEM,430208,0,3,19,22,
Love,Commissioner of Labor,Mark Costello,REP,430208,0,0,17,17,
Love,U.S. Senate,Matt Silverstein,DEM,430208,0,0,14,14,
Love,U.S. Senate,Jim Inhofe,REP,430208,0,3,20,23,
Love,U.S. Senate,Aaron Delozier,IND,430208,0,0,0,0,
Love,U.S. Senate,Ray Woods,IND,430208,0,0,0,0,
Love,U.S. Senate,Joan Farr,IND,430208,0,0,2,2,
Love,U.S. Senate,Connie Johnson,DEM,430208,0,1,15,16,
Love,U.S. Senate,James Lankford,REP,430208,0,2,21,23,
Love,U.S. Senate,Mark Beard,IND,430208,0,0,1,1,
Love,U.S. House,Bert Smith,DEM,430208,0,0,13,13,04
Love,U.S. House,Tom Cole,REP,430208,0,3,23,26,04
Love,U.S. House,Dennis Johnson,IND,430208,0,0,1,1,04
Love,State Senate,Chequita Williams,DEM,430208,0,0,12,12,14
Love,State Senate,Frank Simpson,REP,430208,0,3,26,29,14
Love,State House,Jessica Pfau,DEM,430208,0,0,13,13,49
Love,State House,Tommy Hardin,REP,430208,0,3,24,27,49
Love,Governor,Joe Dorman,DEM,430310,1,7,88,96,
Love,Governor,Mary Fallin,REP,430310,0,8,99,107,
Love,Governor,Kimberly Willis,IND,430310,0,0,8,8,
Love,Governor,Richard Prawdzienski,IND,430310,0,0,4,4,
Love,Lieutenant Governor,Cathy Cummings,DEM,430310,1,7,78,86,
Love,Lieutenant Governor,Todd Lamb,REP,430310,0,8,115,123,
Love,Superintendent of Public Instruction,John Cox,DEM,430310,1,11,95,107,
Love,Superintendent of Public Instruction,Joy Hofmeister,REP,430310,0,4,97,101,
Love,Commissioner of Labor,Mike Workman,DEM,430310,1,8,84,93,
Love,Commissioner of Labor,Mark Costello,REP,430310,0,7,104,111,
Love,U.S. Senate,Matt Silverstein,DEM,430310,1,4,58,63,
Love,U.S. Senate,Jim Inhofe,REP,430310,0,10,132,142,
Love,U.S. Senate,Aaron Delozier,IND,430310,0,0,1,1,
Love,U.S. Senate,Ray Woods,IND,430310,0,1,2,3,
Love,U.S. Senate,Joan Farr,IND,430310,0,0,3,3,
Love,U.S. Senate,Connie Johnson,DEM,430310,1,8,73,82,
Love,U.S. Senate,James Lankford,REP,430310,0,7,110,117,
Love,U.S. Senate,Mark Beard,IND,430310,0,0,10,10,
Love,U.S. House,Bert Smith,DEM,430310,1,4,59,64,04
Love,U.S. House,Tom Cole,REP,430310,0,11,134,145,04
Love,U.S. House,Dennis Johnson,IND,430310,0,0,2,2,04
Love,State Senate,Chequita Williams,DEM,430310,1,6,60,67,14
Love,State Senate,Frank Simpson,REP,430310,0,9,136,145,14
Love,State House,Jessica Pfau,DEM,430310,1,7,76,84,49
Love,State House,Tommy Hardin,REP,430310,0,8,123,131,49
Love,Governor,Joe Dorman,DEM,430311,1,1,79,81,
Love,Governor,Mary Fallin,REP,430311,1,9,124,134,
Love,Governor,Kimberly Willis,IND,430311,0,0,5,5,
Love,Governor,Richard Prawdzienski,IND,430311,0,0,4,4,
Love,Lieutenant Governor,Cathy Cummings,DEM,430311,1,1,62,64,
Love,Lieutenant Governor,Todd Lamb,REP,430311,1,9,146,156,
Love,Superintendent of Public Instruction,John Cox,DEM,430311,1,1,92,94,
Love,Superintendent of Public Instruction,Joy Hofmeister,REP,430311,1,9,117,127,
Love,Commissioner of Labor,Mike Workman,DEM,430311,1,1,74,76,
Love,Commissioner of Labor,Mark Costello,REP,430311,1,9,131,141,
Love,U.S. Senate,Matt Silverstein,DEM,430311,1,1,44,46,
Love,U.S. Senate,Jim Inhofe,REP,430311,1,9,157,167,
Love,U.S. Senate,Aaron Delozier,IND,430311,0,0,2,2,
Love,U.S. Senate,Ray Woods,IND,430311,0,0,4,4,
Love,U.S. Senate,Joan Farr,IND,430311,0,0,3,3,
Love,U.S. Senate,Connie Johnson,DEM,430311,1,1,56,58,
Love,U.S. Senate,James Lankford,REP,430311,1,10,144,155,
Love,U.S. Senate,Mark Beard,IND,430311,0,0,10,10,
Love,U.S. House,Bert Smith,DEM,430311,0,0,45,45,04
Love,U.S. House,Tom Cole,REP,430311,2,10,158,170,04
Love,U.S. House,Dennis Johnson,IND,430311,0,1,8,9,04
Love,State Senate,Chequita Williams,DEM,430311,0,2,47,49,14
Love,State Senate,Frank Simpson,REP,430311,2,9,164,175,14
Love,State House,Jessica Pfau,DEM,430311,1,1,70,72,49
Love,State House,Tommy Hardin,REP,430311,1,10,142,153,49
Love,Governor,Joe Dorman,DEM,430312,3,6,60,69,
Love,Governor,Mary Fallin,REP,430312,0,4,122,126,
Love,Governor,Kimberly Willis,IND,430312,0,0,9,9,
Love,Governor,Richard Prawdzienski,IND,430312,0,0,1,1,
Love,Lieutenant Governor,Cathy Cummings,DEM,430312,3,2,54,59,
Love,Lieutenant Governor,Todd Lamb,REP,430312,0,8,138,146,
Love,Superintendent of Public Instruction,John Cox,DEM,430312,3,3,76,82,
Love,Superintendent of Public Instruction,Joy Hofmeister,REP,430312,0,7,114,121,
Love,Commissioner of Labor,Mike Workman,DEM,430312,3,4,60,67,
Love,Commissioner of Labor,Mark Costello,REP,430312,0,6,127,133,
Love,U.S. Senate,Matt Silverstein,DEM,430312,2,2,34,38,
Love,U.S. Senate,Jim Inhofe,REP,430312,1,8,148,157,
Love,U.S. Senate,Aaron Delozier,IND,430312,0,0,2,2,
Love,U.S. Senate,Ray Woods,IND,430312,0,0,4,4,
Love,U.S. Senate,Joan Farr,IND,430312,0,0,3,3,
Love,U.S. Senate,Connie Johnson,DEM,430312,3,3,49,55,
Love,U.S. Senate,James Lankford,REP,430312,0,7,133,140,
Love,U.S. Senate,Mark Beard,IND,430312,0,0,9,9,
Love,U.S. House,Bert Smith,DEM,430312,2,2,37,41,04
Love,U.S. House,Tom Cole,REP,430312,1,8,148,157,04
Love,U.S. House,Dennis Johnson,IND,430312,0,0,8,8,04
Love,State Senate,Chequita Williams,DEM,430312,2,2,42,46,14
Love,State Senate,Frank Simpson,REP,430312,1,8,150,159,14
Love,State House,Jessica Pfau,DEM,430312,3,3,48,54,49
Love,State House,Tommy Hardin,REP,430312,0,7,144,151,49
Love,Governor,Joe Dorman,DEM,430313,0,0,42,42,
Love,Governor,Mary Fallin,REP,430313,1,4,45,50,
Love,Governor,Kimberly Willis,IND,430313,0,0,2,2,
Love,Governor,Richard Prawdzienski,IND,430313,0,0,1,1,
Love,Lieutenant Governor,Cathy Cummings,DEM,430313,0,0,39,39,
Love,Lieutenant Governor,Todd Lamb,REP,430313,1,4,47,52,
Love,Superintendent of Public Instruction,John Cox,DEM,430313,0,0,47,47,
Love,Superintendent of Public Instruction,Joy Hofmeister,REP,430313,1,4,41,46,
Love,Commissioner of Labor,Mike Workman,DEM,430313,0,0,41,41,
Love,Commissioner of Labor,Mark Costello,REP,430313,1,3,44,48,
Love,U.S. Senate,Matt Silverstein,DEM,430313,0,0,24,24,
Love,U.S. Senate,Jim Inhofe,REP,430313,1,4,59,64,
Love,U.S. Senate,Aaron Delozier,IND,430313,0,0,1,1,
Love,U.S. Senate,Ray Woods,IND,430313,0,0,0,0,
Love,U.S. Senate,Joan Farr,IND,430313,0,0,5,5,
Love,U.S. Senate,Connie Johnson,DEM,430313,0,0,31,31,
Love,U.S. Senate,James Lankford,REP,430313,1,4,54,59,
Love,U.S. Senate,Mark Beard,IND,430313,0,0,4,4,
Love,U.S. House,Bert Smith,DEM,430313,0,0,27,27,04
Love,U.S. House,Tom Cole,REP,430313,1,4,62,67,04
Love,U.S. House,Dennis Johnson,IND,430313,0,0,3,3,04
Love,State Senate,Chequita Williams,DEM,430313,0,0,26,26,14
Love,State Senate,Frank Simpson,REP,430313,1,4,63,68,14
Love,State House,Jessica Pfau,DEM,430313,0,1,37,38,49
Love,State House,Tommy Hardin,REP,430313,1,3,52,56,49
Mcclain,Governor,Joe Dorman,DEM,440001,0,0,56,56,
Mcclain,Governor,Mary Fallin,REP,440001,1,0,108,109,
Mcclain,Governor,Kimberly Willis,IND,440001,0,0,3,3,
Mcclain,Governor,Richard Prawdzienski,IND,440001,0,0,2,2,
Mcclain,Lieutenant Governor,Cathy Cummings,DEM,440001,0,0,27,27,
Mcclain,Lieutenant Governor,Todd Lamb,REP,440001,1,0,138,139,
Mcclain,Superintendent of Public Instruction,John Cox,DEM,440001,0,0,76,76,
Mcclain,Superintendent of Public Instruction,Joy Hofmeister,REP,440001,1,0,90,91,
Mcclain,Commissioner of Labor,Mike Workman,DEM,440001,0,0,47,47,
Mcclain,Commissioner of Labor,Mark Costello,REP,440001,1,0,111,112,
Mcclain,U.S. Senate,Matt Silverstein,DEM,440001,0,0,23,23,
Mcclain,U.S. Senate,Jim Inhofe,REP,440001,1,0,139,140,
Mcclain,U.S. Senate,Aaron Delozier,IND,440001,0,0,1,1,
Mcclain,U.S. Senate,Ray Woods,IND,440001,0,0,2,2,
Mcclain,U.S. Senate,Joan Farr,IND,440001,0,0,1,1,
Mcclain,U.S. Senate,Connie Johnson,DEM,440001,0,0,26,26,
Mcclain,U.S. Senate,James Lankford,REP,440001,1,0,138,139,
Mcclain,U.S. Senate,Mark Beard,IND,440001,0,0,2,2,
Mcclain,U.S. House,Bert Smith,DEM,440001,0,0,18,18,04
Mcclain,U.S. House,Tom Cole,REP,440001,1,0,146,147,04
Mcclain,U.S. House,Dennis Johnson,IND,440001,0,0,2,2,04
Mcclain,State House,Joni Johnson,DEM,440001,0,0,40,40,20
Mcclain,State House,Bobby Cleveland,REP,440001,1,0,116,117,20
Mcclain,Governor,Joe Dorman,DEM,440002,3,0,39,42,
Mcclain,Governor,Mary Fallin,REP,440002,5,0,100,105,
Mcclain,Governor,Kimberly Willis,IND,440002,0,0,2,2,
Mcclain,Governor,Richard Prawdzienski,IND,440002,0,0,2,2,
Mcclain,Lieutenant Governor,Cathy Cummings,DEM,440002,3,0,26,29,
Mcclain,Lieutenant Governor,Todd Lamb,REP,440002,5,0,117,122,
Mcclain,Superintendent of Public Instruction,John Cox,DEM,440002,5,0,55,60,
Mcclain,Superintendent of Public Instruction,Joy Hofmeister,REP,440002,3,0,87,90,
Mcclain,Commissioner of Labor,Mike Workman,DEM,440002,3,0,42,45,
Mcclain,Commissioner of Labor,Mark Costello,REP,440002,5,0,97,102,
Mcclain,U.S. Senate,Matt Silverstein,DEM,440002,2,0,20,22,
Mcclain,U.S. Senate,Jim Inhofe,REP,440002,6,0,113,119,
Mcclain,U.S. Senate,Aaron Delozier,IND,440002,0,0,3,3,
Mcclain,U.S. Senate,Ray Woods,IND,440002,0,0,0,0,
Mcclain,U.S. Senate,Joan Farr,IND,440002,0,0,5,5,
Mcclain,U.S. Senate,Connie Johnson,DEM,440002,3,0,22,25,
Mcclain,U.S. Senate,James Lankford,REP,440002,5,0,118,123,
Mcclain,U.S. Senate,Mark Beard,IND,440002,0,0,3,3,
Mcclain,U.S. House,Bert Smith,DEM,440002,2,0,21,23,04
Mcclain,U.S. House,Tom Cole,REP,440002,6,0,116,122,04
Mcclain,U.S. House,Dennis Johnson,IND,440002,0,0,6,6,04
Mcclain,State House,Joni Johnson,DEM,440002,3,0,29,32,20
Mcclain,State House,Bobby Cleveland,REP,440002,5,0,112,117,20
Mcclain,Governor,Joe Dorman,DEM,440003,5,10,57,72,
Mcclain,Governor,Mary Fallin,REP,440003,0,6,58,64,
Mcclain,Governor,Kimberly Willis,IND,440003,0,0,2,2,
Mcclain,Governor,Richard Prawdzienski,IND,440003,0,1,1,2,
Mcclain,Lieutenant Governor,Cathy Cummings,DEM,440003,3,8,35,46,
Mcclain,Lieutenant Governor,Todd Lamb,REP,440003,2,9,83,94,
Mcclain,Superintendent of Public Instruction,John Cox,DEM,440003,3,8,58,69,
Mcclain,Superintendent of Public Instruction,Joy Hofmeister,REP,440003,2,9,58,69,
Mcclain,Commissioner of Labor,Mike Workman,DEM,440003,3,8,56,67,
Mcclain,Commissioner of Labor,Mark Costello,REP,440003,2,9,58,69,
Mcclain,U.S. Senate,Matt Silverstein,DEM,440003,3,5,27,35,
Mcclain,U.S. Senate,Jim Inhofe,REP,440003,2,12,83,97,
Mcclain,U.S. Senate,Aaron Delozier,IND,440003,0,0,1,1,
Mcclain,U.S. Senate,Ray Woods,IND,440003,0,0,1,1,
Mcclain,U.S. Senate,Joan Farr,IND,440003,0,0,3,3,
Mcclain,U.S. Senate,Connie Johnson,DEM,440003,3,3,36,42,
Mcclain,U.S. Senate,James Lankford,REP,440003,2,13,81,96,
Mcclain,U.S. Senate,Mark Beard,IND,440003,0,1,2,3,
Mcclain,U.S. House,Bert Smith,DEM,440003,3,5,25,33,04
Mcclain,U.S. House,Tom Cole,REP,440003,2,11,86,99,04
Mcclain,U.S. House,Dennis Johnson,IND,440003,0,1,5,6,04
Mcclain,State House,Joni Johnson,DEM,440003,3,7,38,48,20
Mcclain,State House,Bobby Cleveland,REP,440003,2,10,79,91,20
Mcclain,Governor,Joe Dorman,DEM,440004,2,3,76,81,
Mcclain,Governor,Mary Fallin,REP,440004,3,6,113,122,
Mcclain,Governor,Kimberly Willis,IND,440004,0,0,6,6,
Mcclain,Governor,Richard Prawdzienski,IND,440004,0,0,4,4,
Mcclain,Lieutenant Governor,Cathy Cummings,DEM,440004,2,2,60,64,
Mcclain,Lieutenant Governor,Todd Lamb,REP,440004,3,7,136,146,
Mcclain,Superintendent of Public Instruction,John Cox,DEM,440004,2,7,91,100,
Mcclain,Superintendent of Public Instruction,Joy Hofmeister,REP,440004,3,2,104,109,
Mcclain,Commissioner of Labor,Mike Workman,DEM,440004,3,3,83,89,
Mcclain,Commissioner of Labor,Mark Costello,REP,440004,2,6,107,115,
Mcclain,U.S. Senate,Matt Silverstein,DEM,440004,2,2,50,54,
Mcclain,U.S. Senate,Jim Inhofe,REP,440004,3,7,137,147,
Mcclain,U.S. Senate,Aaron Delozier,IND,440004,0,0,4,4,
Mcclain,U.S. Senate,Ray Woods,IND,440004,0,0,2,2,
Mcclain,U.S. Senate,Joan Farr,IND,440004,0,0,3,3,
Mcclain,U.S. Senate,Connie Johnson,DEM,440004,2,2,60,64,
Mcclain,U.S. Senate,James Lankford,REP,440004,3,7,136,146,
Mcclain,U.S. Senate,Mark Beard,IND,440004,0,0,3,3,
Mcclain,U.S. House,Bert Smith,DEM,440004,2,2,50,54,04
Mcclain,U.S. House,Tom Cole,REP,440004,3,7,141,151,04
Mcclain,U.S. House,Dennis Johnson,IND,440004,0,0,7,7,04
Mcclain,Governor,Joe Dorman,DEM,440005,4,5,102,111,
Mcclain,Governor,Mary Fallin,REP,440005,17,5,187,209,
Mcclain,Governor,Kimberly Willis,IND,440005,0,0,3,3,
Mcclain,Governor,Richard Prawdzienski,IND,440005,1,0,2,3,
Mcclain,Lieutenant Governor,Cathy Cummings,DEM,440005,5,1,63,69,
Mcclain,Lieutenant Governor,Todd Lamb,REP,440005,17,9,231,257,
Mcclain,Superintendent of Public Instruction,John Cox,DEM,440005,10,4,96,110,
Mcclain,Superintendent of Public Instruction,Joy Hofmeister,REP,440005,12,6,196,214,
Mcclain,Commissioner of Labor,Mike Workman,DEM,440005,7,3,79,89,
Mcclain,Commissioner of Labor,Mark Costello,REP,440005,14,7,208,229,
Mcclain,U.S. Senate,Matt Silverstein,DEM,440005,4,1,49,54,
Mcclain,U.S. Senate,Jim Inhofe,REP,440005,15,9,237,261,
Mcclain,U.S. Senate,Aaron Delozier,IND,440005,1,0,0,1,
Mcclain,U.S. Senate,Ray Woods,IND,440005,2,0,6,8,
Mcclain,U.S. Senate,Joan Farr,IND,440005,0,0,2,2,
Mcclain,U.S. Senate,Connie Johnson,DEM,440005,4,2,45,51,
Mcclain,U.S. Senate,James Lankford,REP,440005,17,8,240,265,
Mcclain,U.S. Senate,Mark Beard,IND,440005,1,0,7,8,
Mcclain,U.S. House,Bert Smith,DEM,440005,4,1,41,46,04
Mcclain,U.S. House,Tom Cole,REP,440005,17,9,246,272,04
Mcclain,U.S. House,Dennis Johnson,IND,440005,1,0,6,7,04
Mcclain,Governor,Joe Dorman,DEM,440006,2,28,161,191,
Mcclain,Governor,Mary Fallin,REP,440006,11,58,242,311,
Mcclain,Governor,Kimberly Willis,IND,440006,0,1,7,8,
Mcclain,Governor,Richard Prawdzienski,IND,440006,0,0,7,7,
Mcclain,Lieutenant Governor,Cathy Cummings,DEM,440006,2,14,96,112,
Mcclain,Lieutenant Governor,Todd Lamb,REP,440006,11,73,318,402,
Mcclain,Superintendent of Public Instruction,John Cox,DEM,440006,3,39,165,207,
Mcclain,Superintendent of Public Instruction,Joy Hofmeister,REP,440006,10,48,250,308,
Mcclain,Commissioner of Labor,Mike Workman,DEM,440006,3,21,119,143,
Mcclain,Commissioner of Labor,Mark Costello,REP,440006,9,63,285,357,
Mcclain,U.S. Senate,Matt Silverstein,DEM,440006,2,15,71,88,
Mcclain,U.S. Senate,Jim Inhofe,REP,440006,11,72,328,411,
Mcclain,U.S. Senate,Aaron Delozier,IND,440006,0,0,2,2,
Mcclain,U.S. Senate,Ray Woods,IND,440006,0,0,5,5,
Mcclain,U.S. Senate,Joan Farr,IND,440006,0,0,5,5,
Mcclain,U.S. Senate,Connie Johnson,DEM,440006,2,10,73,85,
Mcclain,U.S. Senate,James Lankford,REP,440006,11,76,326,413,
Mcclain,U.S. Senate,Mark Beard,IND,440006,0,1,15,16,
Mcclain,U.S. House,Bert Smith,DEM,440006,2,12,62,76,04
Mcclain,U.S. House,Tom Cole,REP,440006,11,72,335,418,04
Mcclain,U.S. House,Dennis Johnson,IND,440006,0,3,17,20,04
Mcclain,Governor,Joe Dorman,DEM,440007,0,11,69,80,
Mcclain,Governor,Mary Fallin,REP,440007,3,8,110,121,
Mcclain,Governor,Kimberly Willis,IND,440007,0,0,1,1,
Mcclain,Governor,Richard Prawdzienski,IND,440007,0,0,1,1,
Mcclain,Lieutenant Governor,Cathy Cummings,DEM,440007,1,7,43,51,
Mcclain,Lieutenant Governor,Todd Lamb,REP,440007,2,12,138,152,
Mcclain,Superintendent of Public Instruction,John Cox,DEM,440007,2,9,81,92,
Mcclain,Superintendent of Public Instruction,Joy Hofmeister,REP,440007,1,10,101,112,
Mcclain,Commissioner of Labor,Mike Workman,DEM,440007,1,8,58,67,
Mcclain,Commissioner of Labor,Mark Costello,REP,440007,2,11,120,133,
Mcclain,U.S. Senate,Matt Silverstein,DEM,440007,0,6,41,47,
Mcclain,U.S. Senate,Jim Inhofe,REP,440007,3,13,135,151,
Mcclain,U.S. Senate,Aaron Delozier,IND,440007,0,0,0,0,
Mcclain,U.S. Senate,Ray Woods,IND,440007,0,0,2,2,
Mcclain,U.S. Senate,Joan Farr,IND,440007,0,0,3,3,
Mcclain,U.S. Senate,Connie Johnson,DEM,440007,1,7,42,50,
Mcclain,U.S. Senate,James Lankford,REP,440007,2,13,134,149,
Mcclain,U.S. Senate,Mark Beard,IND,440007,0,0,7,7,
Mcclain,U.S. House,Bert Smith,DEM,440007,1,4,37,42,04
Mcclain,U.S. House,Tom Cole,REP,440007,2,15,137,154,04
Mcclain,U.S. House,Dennis Johnson,IND,440007,0,1,8,9,04
Mcclain,Governor,Joe Dorman,DEM,440008,3,1,170,174,
Mcclain,Governor,Mary Fallin,REP,440008,4,3,255,262,
Mcclain,Governor,Kimberly Willis,IND,440008,0,0,4,4,
Mcclain,Governor,Richard Prawdzienski,IND,440008,0,1,5,6,
Mcclain,Lieutenant Governor,Cathy Cummings,DEM,440008,3,1,91,95,
Mcclain,Lieutenant Governor,Todd Lamb,REP,440008,4,4,339,347,
Mcclain,Superintendent of Public Instruction,John Cox,DEM,440008,5,0,189,194,
Mcclain,Superintendent of Public Instruction,Joy Hofmeister,REP,440008,2,5,239,246,
Mcclain,Commissioner of Labor,Mike Workman,DEM,440008,4,2,131,137,
Mcclain,Commissioner of Labor,Mark Costello,REP,440008,3,3,291,297,
Mcclain,U.S. Senate,Matt Silverstein,DEM,440008,2,1,70,73,
Mcclain,U.S. Senate,Jim Inhofe,REP,440008,5,4,350,359,
Mcclain,U.S. Senate,Aaron Delozier,IND,440008,0,0,7,7,
Mcclain,U.S. Senate,Ray Woods,IND,440008,0,0,3,3,
Mcclain,U.S. Senate,Joan Farr,IND,440008,0,0,1,1,
Mcclain,U.S. Senate,Connie Johnson,DEM,440008,2,0,68,70,
Mcclain,U.S. Senate,James Lankford,REP,440008,5,5,356,366,
Mcclain,U.S. Senate,Mark Beard,IND,440008,0,0,9,9,
Mcclain,U.S. House,Bert Smith,DEM,440008,2,1,62,65,04
Mcclain,U.S. House,Tom Cole,REP,440008,5,4,356,365,04
Mcclain,U.S. House,Dennis Johnson,IND,440008,0,0,15,15,04
Mcclain,Governor,Joe Dorman,DEM,440009,7,3,148,158,
Mcclain,Governor,Mary Fallin,REP,440009,13,6,270,289,
Mcclain,Governor,Kimberly Willis,IND,440009,0,0,8,8,
Mcclain,Governor,Richard Prawdzienski,IND,440009,0,0,4,4,
Mcclain,Lieutenant Governor,Cathy Cummings,DEM,440009,6,1,108,115,
Mcclain,Lieutenant Governor,Todd Lamb,REP,440009,15,8,324,347,
Mcclain,Superintendent of Public Instruction,John Cox,DEM,440009,12,3,168,183,
Mcclain,Superintendent of Public Instruction,Joy Hofmeister,REP,440009,9,6,264,279,
Mcclain,Commissioner of Labor,Mike Workman,DEM,440009,3,2,130,135,
Mcclain,Commissioner of Labor,Mark Costello,REP,440009,17,6,294,317,
Mcclain,U.S. Senate,Matt Silverstein,DEM,440009,5,2,108,115,
Mcclain,U.S. Senate,Jim Inhofe,REP,440009,16,7,313,336,
Mcclain,U.S. Senate,Aaron Delozier,IND,440009,0,0,3,3,
Mcclain,U.S. Senate,Ray Woods,IND,440009,0,0,2,2,
Mcclain,U.S. Senate,Joan Farr,IND,440009,0,0,7,7,
Mcclain,U.S. Senate,Connie Johnson,DEM,440009,6,0,102,108,
Mcclain,U.S. Senate,James Lankford,REP,440009,15,9,314,338,
Mcclain,U.S. Senate,Mark Beard,IND,440009,0,0,16,16,
Mcclain,U.S. House,Bert Smith,DEM,440009,6,1,89,96,04
Mcclain,U.S. House,Tom Cole,REP,440009,15,7,327,349,04
Mcclain,U.S. House,Dennis Johnson,IND,440009,0,1,17,18,04
Mcclain,State House,Joni Johnson,DEM,440009,2,1,124,127,20
Mcclain,State House,Bobby Cleveland,REP,440009,19,8,303,330,20
Mcclain,Governor,Joe Dorman,DEM,440010,1,0,38,39,
Mcclain,Governor,Mary Fallin,REP,440010,2,7,73,82,
Mcclain,Governor,Kimberly Willis,IND,440010,0,0,0,0,
Mcclain,Governor,Richard Prawdzienski,IND,440010,0,0,3,3,
Mcclain,Lieutenant Governor,Cathy Cummings,DEM,440010,1,0,29,30,
Mcclain,Lieutenant Governor,Todd Lamb,REP,440010,2,7,85,94,
Mcclain,Superintendent of Public Instruction,John Cox,DEM,440010,1,1,42,44,
Mcclain,Superintendent of Public Instruction,Joy Hofmeister,REP,440010,2,6,72,80,
Mcclain,Commissioner of Labor,Mike Workman,DEM,440010,1,0,35,36,
Mcclain,Commissioner of Labor,Mark Costello,REP,440010,2,7,78,87,
Mcclain,U.S. Senate,Matt Silverstein,DEM,440010,1,0,26,27,
Mcclain,U.S. Senate,Jim Inhofe,REP,440010,2,7,85,94,
Mcclain,U.S. Senate,Aaron Delozier,IND,440010,0,0,0,0,
Mcclain,U.S. Senate,Ray Woods,IND,440010,0,0,2,2,
Mcclain,U.S. Senate,Joan Farr,IND,440010,0,0,1,1,
Mcclain,U.S. Senate,Connie Johnson,DEM,440010,1,0,23,24,
Mcclain,U.S. Senate,James Lankford,REP,440010,2,7,88,97,
Mcclain,U.S. Senate,Mark Beard,IND,440010,0,0,3,3,
Mcclain,U.S. House,Bert Smith,DEM,440010,1,0,22,23,04
Mcclain,U.S. House,Tom Cole,REP,440010,2,7,88,97,04
Mcclain,U.S. House,Dennis Johnson,IND,440010,0,0,4,4,04
Mcclain,Governor,Joe Dorman,DEM,440011,3,2,63,68,
Mcclain,Governor,Mary Fallin,REP,440011,4,4,117,125,
Mcclain,Governor,Kimberly Willis,IND,440011,0,0,2,2,
Mcclain,Governor,Richard Prawdzienski,IND,440011,0,0,4,4,
Mcclain,Lieutenant Governor,Cathy Cummings,DEM,440011,3,2,43,48,
Mcclain,Lieutenant Governor,Todd Lamb,REP,440011,4,4,139,147,
Mcclain,Superintendent of Public Instruction,John Cox,DEM,440011,3,2,67,72,
Mcclain,Superintendent of Public Instruction,Joy Hofmeister,REP,440011,4,4,115,123,
Mcclain,Commissioner of Labor,Mike Workman,DEM,440011,3,2,54,59,
Mcclain,Commissioner of Labor,Mark Costello,REP,440011,4,4,126,134,
Mcclain,U.S. Senate,Matt Silverstein,DEM,440011,3,2,36,41,
Mcclain,U.S. Senate,Jim Inhofe,REP,440011,4,3,138,145,
Mcclain,U.S. Senate,Aaron Delozier,IND,440011,0,0,6,6,
Mcclain,U.S. Senate,Ray Woods,IND,440011,0,0,1,1,
Mcclain,U.S. Senate,Joan Farr,IND,440011,0,0,3,3,
Mcclain,U.S. Senate,Connie Johnson,DEM,440011,3,2,38,43,
Mcclain,U.S. Senate,James Lankford,REP,440011,4,4,143,151,
Mcclain,U.S. Senate,Mark Beard,IND,440011,0,0,5,5,
Mcclain,U.S. House,Bert Smith,DEM,440011,3,2,34,39,04
Mcclain,U.S. House,Tom Cole,REP,440011,4,4,139,147,04
Mcclain,U.S. House,Dennis Johnson,IND,440011,0,0,11,11,04
Mcclain,Governor,Joe Dorman,DEM,440012,10,1,231,242,
Mcclain,Governor,Mary Fallin,REP,440012,15,14,390,419,
Mcclain,Governor,Kimberly Willis,IND,440012,0,0,11,11,
Mcclain,Governor,Richard Prawdzienski,IND,440012,0,0,8,8,
Mcclain,Lieutenant Governor,Cathy Cummings,DEM,440012,9,1,142,152,
Mcclain,Lieutenant Governor,Todd Lamb,REP,440012,16,14,501,531,
Mcclain,Superintendent of Public Instruction,John Cox,DEM,440012,10,2,256,268,
Mcclain,Superintendent of Public Instruction,Joy Hofmeister,REP,440012,15,12,380,407,
Mcclain,Commissioner of Labor,Mike Workman,DEM,440012,9,1,191,201,
Mcclain,Commissioner of Labor,Mark Costello,REP,440012,14,13,441,468,
Mcclain,U.S. Senate,Matt Silverstein,DEM,440012,6,1,125,132,
Mcclain,U.S. Senate,Jim Inhofe,REP,440012,17,14,487,518,
Mcclain,U.S. Senate,Aaron Delozier,IND,440012,1,0,3,4,
Mcclain,U.S. Senate,Ray Woods,IND,440012,1,0,11,12,
Mcclain,U.S. Senate,Joan Farr,IND,440012,0,0,9,9,
Mcclain,U.S. Senate,Connie Johnson,DEM,440012,6,1,118,125,
Mcclain,U.S. Senate,James Lankford,REP,440012,18,14,499,531,
Mcclain,U.S. Senate,Mark Beard,IND,440012,1,0,24,25,
Mcclain,U.S. House,Bert Smith,DEM,440012,7,1,104,112,04
Mcclain,U.S. House,Tom Cole,REP,440012,19,14,499,532,04
Mcclain,U.S. House,Dennis Johnson,IND,440012,0,0,33,33,04
Mcclain,Governor,Joe Dorman,DEM,440013,10,1,296,307,
Mcclain,Governor,Mary Fallin,REP,440013,38,10,587,635,
Mcclain,Governor,Kimberly Willis,IND,440013,0,1,13,14,
Mcclain,Governor,Richard Prawdzienski,IND,440013,0,0,10,10,
Mcclain,Lieutenant Governor,Cathy Cummings,DEM,440013,8,2,195,205,
Mcclain,Lieutenant Governor,Todd Lamb,REP,440013,40,10,712,762,
Mcclain,Superintendent of Public Instruction,John Cox,DEM,440013,14,3,314,331,
Mcclain,Superintendent of Public Instruction,Joy Hofmeister,REP,440013,34,9,586,629,
Mcclain,Commissioner of Labor,Mike Workman,DEM,440013,11,1,239,251,
Mcclain,Commissioner of Labor,Mark Costello,REP,440013,36,11,647,694,
Mcclain,U.S. Senate,Matt Silverstein,DEM,440013,9,2,168,179,
Mcclain,U.S. Senate,Jim Inhofe,REP,440013,37,10,707,754,
Mcclain,U.S. Senate,Aaron Delozier,IND,440013,0,0,9,9,
Mcclain,U.S. Senate,Ray Woods,IND,440013,0,0,11,11,
Mcclain,U.S. Senate,Joan Farr,IND,440013,2,0,8,10,
Mcclain,U.S. Senate,Connie Johnson,DEM,440013,8,2,177,187,
Mcclain,U.S. Senate,James Lankford,REP,440013,39,10,704,753,
Mcclain,U.S. Senate,Mark Beard,IND,440013,1,0,21,22,
Mcclain,U.S. House,Bert Smith,DEM,440013,8,1,163,172,04
Mcclain,U.S. House,Tom Cole,REP,440013,37,11,710,758,04
Mcclain,U.S. House,Dennis Johnson,IND,440013,3,0,31,34,04
Mcclain,State House,Joni Johnson,DEM,440013,9,2,198,209,20
Mcclain,State House,Bobby Cleveland,REP,440013,39,10,701,750,20
Mcclain,Governor,Joe Dorman,DEM,440014,7,0,76,83,
Mcclain,Governor,Mary Fallin,REP,440014,4,0,242,246,
Mcclain,Governor,Kimberly Willis,IND,440014,0,0,5,5,
Mcclain,Governor,Richard Prawdzienski,IND,440014,0,0,2,2,
Mcclain,Lieutenant Governor,Cathy Cummings,DEM,440014,7,0,55,62,
Mcclain,Lieutenant Governor,Todd Lamb,REP,440014,4,0,271,275,
Mcclain,Superintendent of Public Instruction,John Cox,DEM,440014,4,0,103,107,
Mcclain,Superintendent of Public Instruction,Joy Hofmeister,REP,440014,7,0,219,226,
Mcclain,Commissioner of Labor,Mike Workman,DEM,440014,3,0,71,74,
Mcclain,Commissioner of Labor,Mark Costello,REP,440014,6,0,249,255,
Mcclain,U.S. Senate,Matt Silverstein,DEM,440014,5,0,42,47,
Mcclain,U.S. Senate,Jim Inhofe,REP,440014,5,0,268,273,
Mcclain,U.S. Senate,Aaron Delozier,IND,440014,0,0,3,3,
Mcclain,U.S. Senate,Ray Woods,IND,440014,0,0,6,6,
Mcclain,U.S. Senate,Joan Farr,IND,440014,0,0,6,6,
Mcclain,U.S. Senate,Connie Johnson,DEM,440014,4,0,41,45,
Mcclain,U.S. Senate,James Lankford,REP,440014,7,0,279,286,
Mcclain,U.S. Senate,Mark Beard,IND,440014,0,0,7,7,
Mcclain,U.S. House,Bert Smith,DEM,440014,3,0,37,40,04
Mcclain,U.S. House,Tom Cole,REP,440014,8,0,278,286,04
Mcclain,U.S. House,Dennis Johnson,IND,440014,0,0,12,12,04
Mcclain,State House,Joni Johnson,DEM,440014,4,0,60,64,20
Mcclain,State House,Bobby Cleveland,REP,440014,7,0,265,272,20
Mcclain,Governor,Joe Dorman,DEM,440015,8,3,167,178,
Mcclain,Governor,Mary Fallin,REP,440015,21,3,323,347,
Mcclain,Governor,Kimberly Willis,IND,440015,0,0,9,9,
Mcclain,Governor,Richard Prawdzienski,IND,440015,0,0,7,7,
Mcclain,Lieutenant Governor,Cathy Cummings,DEM,440015,7,3,111,121,
Mcclain,Lieutenant Governor,Todd Lamb,REP,440015,21,3,394,418,
Mcclain,Superintendent of Public Instruction,John Cox,DEM,440015,9,3,184,196,
Mcclain,Superintendent of Public Instruction,Joy Hofmeister,REP,440015,20,3,319,342,
Mcclain,Commissioner of Labor,Mike Workman,DEM,440015,4,2,136,142,
Mcclain,Commissioner of Labor,Mark Costello,REP,440015,24,4,359,387,
Mcclain,U.S. Senate,Matt Silverstein,DEM,440015,6,2,89,97,
Mcclain,U.S. Senate,Jim Inhofe,REP,440015,22,4,392,418,
Mcclain,U.S. Senate,Aaron Delozier,IND,440015,0,0,7,7,
Mcclain,U.S. Senate,Ray Woods,IND,440015,0,0,11,11,
Mcclain,U.S. Senate,Joan Farr,IND,440015,0,0,5,5,
Mcclain,U.S. Senate,Connie Johnson,DEM,440015,6,2,83,91,
Mcclain,U.S. Senate,James Lankford,REP,440015,23,4,405,432,
Mcclain,U.S. Senate,Mark Beard,IND,440015,0,0,17,17,
Mcclain,U.S. House,Bert Smith,DEM,440015,6,2,82,90,04
Mcclain,U.S. House,Tom Cole,REP,440015,23,4,394,421,04
Mcclain,U.S. House,Dennis Johnson,IND,440015,0,0,29,29,04
Mcclain,Governor,Joe Dorman,DEM,440016,18,3,248,269,
Mcclain,Governor,Mary Fallin,REP,440016,20,6,313,339,
Mcclain,Governor,Kimberly Willis,IND,440016,1,0,12,13,
Mcclain,Governor,Richard Prawdzienski,IND,440016,0,0,5,5,
Mcclain,Lieutenant Governor,Cathy Cummings,DEM,440016,18,3,149,170,
Mcclain,Lieutenant Governor,Todd Lamb,REP,440016,21,6,427,454,
Mcclain,Superintendent of Public Instruction,John Cox,DEM,440016,20,3,271,294,
Mcclain,Superintendent of Public Instruction,Joy Hofmeister,REP,440016,18,6,304,328,
Mcclain,Commissioner of Labor,Mike Workman,DEM,440016,19,3,195,217,
Mcclain,Commissioner of Labor,Mark Costello,REP,440016,18,6,367,391,
Mcclain,U.S. Senate,Matt Silverstein,DEM,440016,13,3,124,140,
Mcclain,U.S. Senate,Jim Inhofe,REP,440016,26,6,431,463,
Mcclain,U.S. Senate,Aaron Delozier,IND,440016,0,0,5,5,
Mcclain,U.S. Senate,Ray Woods,IND,440016,1,0,8,9,
Mcclain,U.S. Senate,Joan Farr,IND,440016,0,0,6,6,
Mcclain,U.S. Senate,Connie Johnson,DEM,440016,10,3,127,140,
Mcclain,U.S. Senate,James Lankford,REP,440016,29,6,436,471,
Mcclain,U.S. Senate,Mark Beard,IND,440016,0,0,14,14,
Mcclain,U.S. House,Bert Smith,DEM,440016,9,2,99,110,04
Mcclain,U.S. House,Tom Cole,REP,440016,30,7,458,495,04
Mcclain,U.S. House,Dennis Johnson,IND,440016,0,0,19,19,04
Mcclain,Governor,Joe Dorman,DEM,440017,1,0,21,22,
Mcclain,Governor,Mary Fallin,REP,440017,2,0,85,87,
Mcclain,Governor,Kimberly Willis,IND,440017,0,0,1,1,
Mcclain,Governor,Richard Prawdzienski,IND,440017,0,0,1,1,
Mcclain,Lieutenant Governor,Cathy Cummings,DEM,440017,0,0,14,14,
Mcclain,Lieutenant Governor,Todd Lamb,REP,440017,3,0,93,96,
Mcclain,Superintendent of Public Instruction,John Cox,DEM,440017,3,0,35,38,
Mcclain,Superintendent of Public Instruction,Joy Hofmeister,REP,440017,0,0,71,71,
Mcclain,Commissioner of Labor,Mike Workman,DEM,440017,1,0,22,23,
Mcclain,Commissioner of Labor,Mark Costello,REP,440017,2,0,84,86,
Mcclain,U.S. Senate,Matt Silverstein,DEM,440017,2,0,10,12,
Mcclain,U.S. Senate,Jim Inhofe,REP,440017,1,0,95,96,
Mcclain,U.S. Senate,Aaron Delozier,IND,440017,0,0,0,0,
Mcclain,U.S. Senate,Ray Woods,IND,440017,0,0,1,1,
Mcclain,U.S. Senate,Joan Farr,IND,440017,0,0,0,0,
Mcclain,U.S. Senate,Connie Johnson,DEM,440017,1,0,10,11,
Mcclain,U.S. Senate,James Lankford,REP,440017,2,0,95,97,
Mcclain,U.S. Senate,Mark Beard,IND,440017,0,0,2,2,
Mcclain,U.S. House,Bert Smith,DEM,440017,1,0,10,11,04
Mcclain,U.S. House,Tom Cole,REP,440017,2,0,96,98,04
Mcclain,U.S. House,Dennis Johnson,IND,440017,0,0,2,2,04
Mcclain,State House,Joni Johnson,DEM,440017,1,0,20,21,20
Mcclain,State House,Bobby Cleveland,REP,440017,2,0,87,89,20
Mcclain,Governor,Joe Dorman,DEM,440018,4,0,102,106,
Mcclain,Governor,Mary Fallin,REP,440018,6,0,188,194,
Mcclain,Governor,Kimberly Willis,IND,440018,0,0,1,1,
Mcclain,Governor,Richard Prawdzienski,IND,440018,0,0,3,3,
Mcclain,Lieutenant Governor,Cathy Cummings,DEM,440018,2,0,53,55,
Mcclain,Lieutenant Governor,Todd Lamb,REP,440018,8,0,241,249,
Mcclain,Superintendent of Public Instruction,John Cox,DEM,440018,3,0,106,109,
Mcclain,Superintendent of Public Instruction,Joy Hofmeister,REP,440018,6,0,189,195,
Mcclain,Commissioner of Labor,Mike Workman,DEM,440018,3,0,65,68,
Mcclain,Commissioner of Labor,Mark Costello,REP,440018,6,0,226,232,
Mcclain,U.S. Senate,Matt Silverstein,DEM,440018,2,0,42,44,
Mcclain,U.S. Senate,Jim Inhofe,REP,440018,8,0,240,248,
Mcclain,U.S. Senate,Aaron Delozier,IND,440018,0,0,5,5,
Mcclain,U.S. Senate,Ray Woods,IND,440018,0,0,4,4,
Mcclain,U.S. Senate,Joan Farr,IND,440018,0,0,4,4,
Mcclain,U.S. Senate,Connie Johnson,DEM,440018,2,0,41,43,
Mcclain,U.S. Senate,James Lankford,REP,440018,8,0,248,256,
Mcclain,U.S. Senate,Mark Beard,IND,440018,0,0,6,6,
Mcclain,U.S. House,Bert Smith,DEM,440018,2,0,41,43,04
Mcclain,U.S. House,Tom Cole,REP,440018,8,0,243,251,04
Mcclain,U.S. House,Dennis Johnson,IND,440018,0,0,9,9,04
Mcclain,State House,Joni Johnson,DEM,440018,3,0,52,55,20
Mcclain,State House,Bobby Cleveland,REP,440018,7,0,238,245,20
Mcclain,Governor,Joe Dorman,DEM,440019,12,6,143,161,
Mcclain,Governor,Mary Fallin,REP,440019,13,6,232,251,
Mcclain,Governor,Kimberly Willis,IND,440019,0,1,11,12,
Mcclain,Governor,Richard Prawdzienski,IND,440019,0,0,7,7,
Mcclain,Lieutenant Governor,Cathy Cummings,DEM,440019,6,3,92,101,
Mcclain,Lieutenant Governor,Todd Lamb,REP,440019,19,10,291,320,
Mcclain,Superintendent of Public Instruction,John Cox,DEM,440019,15,6,159,180,
Mcclain,Superintendent of Public Instruction,Joy Hofmeister,REP,440019,10,7,226,243,
Mcclain,Commissioner of Labor,Mike Workman,DEM,440019,12,6,116,134,
Mcclain,Commissioner of Labor,Mark Costello,REP,440019,10,7,256,273,
Mcclain,U.S. Senate,Matt Silverstein,DEM,440019,4,4,73,81,
Mcclain,U.S. Senate,Jim Inhofe,REP,440019,19,9,301,329,
Mcclain,U.S. Senate,Aaron Delozier,IND,440019,0,0,3,3,
Mcclain,U.S. Senate,Ray Woods,IND,440019,1,0,6,7,
Mcclain,U.S. Senate,Joan Farr,IND,440019,0,0,7,7,
Mcclain,U.S. Senate,Connie Johnson,DEM,440019,5,3,75,83,
Mcclain,U.S. Senate,James Lankford,REP,440019,18,10,295,323,
Mcclain,U.S. Senate,Mark Beard,IND,440019,1,0,21,22,
Mcclain,U.S. House,Bert Smith,DEM,440019,3,4,67,74,04
Mcclain,U.S. House,Tom Cole,REP,440019,20,8,299,327,04
Mcclain,U.S. House,Dennis Johnson,IND,440019,1,1,25,27,04
Mcclain,Governor,Joe Dorman,DEM,440020,0,1,96,97,
Mcclain,Governor,Mary Fallin,REP,440020,4,7,187,198,
Mcclain,Governor,Kimberly Willis,IND,440020,0,1,9,10,
Mcclain,Governor,Richard Prawdzienski,IND,440020,1,0,4,5,
Mcclain,Lieutenant Governor,Cathy Cummings,DEM,440020,0,2,54,56,
Mcclain,Lieutenant Governor,Todd Lamb,REP,440020,4,7,242,253,
Mcclain,Superintendent of Public Instruction,John Cox,DEM,440020,2,3,106,111,
Mcclain,Superintendent of Public Instruction,Joy Hofmeister,REP,440020,3,6,188,197,
Mcclain,Commissioner of Labor,Mike Workman,DEM,440020,1,1,82,84,
Mcclain,Commissioner of Labor,Mark Costello,REP,440020,4,8,209,221,
Mcclain,U.S. Senate,Matt Silverstein,DEM,440020,1,1,40,42,
Mcclain,U.S. Senate,Jim Inhofe,REP,440020,3,7,244,254,
Mcclain,U.S. Senate,Aaron Delozier,IND,440020,0,0,4,4,
Mcclain,U.S. Senate,Ray Woods,IND,440020,1,0,5,6,
Mcclain,U.S. Senate,Joan Farr,IND,440020,0,1,3,4,
Mcclain,U.S. Senate,Connie Johnson,DEM,440020,1,0,48,49,
Mcclain,U.S. Senate,James Lankford,REP,440020,4,8,237,249,
Mcclain,U.S. Senate,Mark Beard,IND,440020,0,1,10,11,
Mcclain,U.S. House,Bert Smith,DEM,440020,1,0,42,43,04
Mcclain,U.S. House,Tom Cole,REP,440020,3,8,244,255,04
Mcclain,U.S. House,Dennis Johnson,IND,440020,1,1,10,12,04
Mcclain,State House,Joni Johnson,DEM,440020,1,1,70,72,20
Mcclain,State House,Bobby Cleveland,REP,440020,4,8,226,238,20
Mcclain,Governor,Joe Dorman,DEM,440021,1,20,109,130,
Mcclain,Governor,Mary Fallin,REP,440021,3,11,126,140,
Mcclain,Governor,Kimberly Willis,IND,440021,0,0,12,12,
Mcclain,Governor,Richard Prawdzienski,IND,440021,0,0,2,2,
Mcclain,Lieutenant Governor,Cathy Cummings,DEM,440021,1,15,81,97,
Mcclain,Lieutenant Governor,Todd Lamb,REP,440021,3,16,168,187,
Mcclain,Superintendent of Public Instruction,John Cox,DEM,440021,1,23,106,130,
Mcclain,Superintendent of Public Instruction,Joy Hofmeister,REP,440021,3,8,140,151,
Mcclain,Commissioner of Labor,Mike Workman,DEM,440021,1,21,98,120,
Mcclain,Commissioner of Labor,Mark Costello,REP,440021,2,8,146,156,
Mcclain,U.S. Senate,Matt Silverstein,DEM,440021,0,15,70,85,
Mcclain,U.S. Senate,Jim Inhofe,REP,440021,4,16,169,189,
Mcclain,U.S. Senate,Aaron Delozier,IND,440021,0,0,2,2,
Mcclain,U.S. Senate,Ray Woods,IND,440021,0,0,2,2,
Mcclain,U.S. Senate,Joan Farr,IND,440021,0,0,5,5,
Mcclain,U.S. Senate,Connie Johnson,DEM,440021,1,17,74,92,
Mcclain,U.S. Senate,James Lankford,REP,440021,3,14,165,182,
Mcclain,U.S. Senate,Mark Beard,IND,440021,0,0,9,9,
Mcclain,U.S. House,Bert Smith,DEM,440021,0,16,61,77,04
Mcclain,U.S. House,Tom Cole,REP,440021,4,15,169,188,04
Mcclain,U.S. House,Dennis Johnson,IND,440021,0,0,17,17,04
Mcclain,Governor,Joe Dorman,DEM,440023,2,19,115,136,
Mcclain,Governor,Mary Fallin,REP,440023,4,28,237,269,
Mcclain,Governor,Kimberly Willis,IND,440023,0,1,4,5,
Mcclain,Governor,Richard Prawdzienski,IND,440023,0,1,5,6,
Mcclain,Lieutenant Governor,Cathy Cummings,DEM,440023,1,10,77,88,
Mcclain,Lieutenant Governor,Todd Lamb,REP,440023,5,37,284,326,
Mcclain,Superintendent of Public Instruction,John Cox,DEM,440023,3,17,111,131,
Mcclain,Superintendent of Public Instruction,Joy Hofmeister,REP,440023,3,31,250,284,
Mcclain,Commissioner of Labor,Mike Workman,DEM,440023,1,18,96,115,
Mcclain,Commissioner of Labor,Mark Costello,REP,440023,4,27,255,286,
Mcclain,U.S. Senate,Matt Silverstein,DEM,440023,1,10,58,69,
Mcclain,U.S. Senate,Jim Inhofe,REP,440023,5,37,290,332,
Mcclain,U.S. Senate,Aaron Delozier,IND,440023,0,0,1,1,
Mcclain,U.S. Senate,Ray Woods,IND,440023,0,0,4,4,
Mcclain,U.S. Senate,Joan Farr,IND,440023,0,0,9,9,
Mcclain,U.S. Senate,Connie Johnson,DEM,440023,1,11,61,73,
Mcclain,U.S. Senate,James Lankford,REP,440023,5,36,284,325,
Mcclain,U.S. Senate,Mark Beard,IND,440023,0,1,16,17,
Mcclain,U.S. House,Bert Smith,DEM,440023,1,8,55,64,04
Mcclain,U.S. House,Tom Cole,REP,440023,5,39,292,336,04
Mcclain,U.S. House,Dennis Johnson,IND,440023,0,0,12,12,04
Mcclain,State House,Joni Johnson,DEM,440023,1,15,83,99,20
Mcclain,State House,Bobby Cleveland,REP,440023,4,32,276,312,20
Mcclain,Governor,Joe Dorman,DEM,440024,8,31,159,198,
Mcclain,Governor,Mary Fallin,REP,440024,5,21,225,251,
Mcclain,Governor,Kimberly Willis,IND,440024,0,0,13,13,
Mcclain,Governor,Richard Prawdzienski,IND,440024,0,0,4,4,
Mcclain,Lieutenant Governor,Cathy Cummings,DEM,440024,7,11,112,130,
Mcclain,Lieutenant Governor,Todd Lamb,REP,440024,6,42,289,337,
Mcclain,Superintendent of Public Instruction,John Cox,DEM,440024,9,32,190,231,
Mcclain,Superintendent of Public Instruction,Joy Hofmeister,REP,440024,4,20,210,234,
Mcclain,Commissioner of Labor,Mike Workman,DEM,440024,8,19,153,180,
Mcclain,Commissioner of Labor,Mark Costello,REP,440024,5,33,235,273,
Mcclain,U.S. Senate,Matt Silverstein,DEM,440024,6,11,98,115,
Mcclain,U.S. Senate,Jim Inhofe,REP,440024,7,40,293,340,
Mcclain,U.S. Senate,Aaron Delozier,IND,440024,0,0,4,4,
Mcclain,U.S. Senate,Ray Woods,IND,440024,0,0,2,2,
Mcclain,U.S. Senate,Joan Farr,IND,440024,0,1,2,3,
Mcclain,U.S. Senate,Connie Johnson,DEM,440024,7,12,97,116,
Mcclain,U.S. Senate,James Lankford,REP,440024,6,41,290,337,
Mcclain,U.S. Senate,Mark Beard,IND,440024,0,0,10,10,
Mcclain,U.S. House,Bert Smith,DEM,440024,6,11,90,107,04
Mcclain,U.S. House,Tom Cole,REP,440024,7,40,293,340,04
Mcclain,U.S. House,Dennis Johnson,IND,440024,0,1,15,16,04
Mcclain,Governor,Joe Dorman,DEM,440026,0,3,34,37,
Mcclain,Governor,Mary Fallin,REP,440026,3,9,70,82,
Mcclain,Governor,Kimberly Willis,IND,440026,0,1,3,4,
Mcclain,Governor,Richard Prawdzienski,IND,440026,0,0,2,2,
Mcclain,Lieutenant Governor,Cathy Cummings,DEM,440026,0,3,22,25,
Mcclain,Lieutenant Governor,Todd Lamb,REP,440026,3,11,88,102,
Mcclain,Superintendent of Public Instruction,John Cox,DEM,440026,0,4,39,43,
Mcclain,Superintendent of Public Instruction,Joy Hofmeister,REP,440026,3,10,71,84,
Mcclain,Commissioner of Labor,Mike Workman,DEM,440026,0,4,29,33,
Mcclain,Commissioner of Labor,Mark Costello,REP,440026,3,10,78,91,
Mcclain,U.S. Senate,Matt Silverstein,DEM,440026,0,4,17,21,
Mcclain,U.S. Senate,Jim Inhofe,REP,440026,3,10,82,95,
Mcclain,U.S. Senate,Aaron Delozier,IND,440026,0,0,2,2,
Mcclain,U.S. Senate,Ray Woods,IND,440026,0,0,4,4,
Mcclain,U.S. Senate,Joan Farr,IND,440026,0,0,2,2,
Mcclain,U.S. Senate,Connie Johnson,DEM,440026,0,4,17,21,
Mcclain,U.S. Senate,James Lankford,REP,440026,3,10,89,102,
Mcclain,U.S. Senate,Mark Beard,IND,440026,0,0,4,4,
Mcclain,U.S. House,Bert Smith,DEM,440026,0,3,15,18,04
Mcclain,U.S. House,Tom Cole,REP,440026,3,10,87,100,04
Mcclain,U.S. House,Dennis Johnson,IND,440026,0,1,7,8,04
Mcclain,Governor,Joe Dorman,DEM,440027,2,0,62,64,
Mcclain,Governor,Mary Fallin,REP,440027,4,4,157,165,
Mcclain,Governor,Kimberly Willis,IND,440027,0,0,4,4,
Mcclain,Governor,Richard Prawdzienski,IND,440027,1,0,1,2,
Mcclain,Lieutenant Governor,Cathy Cummings,DEM,440027,0,0,34,34,
Mcclain,Lieutenant Governor,Todd Lamb,REP,440027,7,4,190,201,
Mcclain,Superintendent of Public Instruction,John Cox,DEM,440027,4,0,63,67,
Mcclain,Superintendent of Public Instruction,Joy Hofmeister,REP,440027,3,4,161,168,
Mcclain,Commissioner of Labor,Mike Workman,DEM,440027,1,1,43,45,
Mcclain,Commissioner of Labor,Mark Costello,REP,440027,6,3,169,178,
Mcclain,U.S. Senate,Matt Silverstein,DEM,440027,1,0,27,28,
Mcclain,U.S. Senate,Jim Inhofe,REP,440027,6,4,189,199,
Mcclain,U.S. Senate,Aaron Delozier,IND,440027,0,0,0,0,
Mcclain,U.S. Senate,Ray Woods,IND,440027,0,0,4,4,
Mcclain,U.S. Senate,Joan Farr,IND,440027,0,0,3,3,
Mcclain,U.S. Senate,Connie Johnson,DEM,440027,0,0,25,25,
Mcclain,U.S. Senate,James Lankford,REP,440027,7,4,191,202,
Mcclain,U.S. Senate,Mark Beard,IND,440027,0,0,6,6,
Mcclain,U.S. House,Bert Smith,DEM,440027,0,0,24,24,04
Mcclain,U.S. House,Tom Cole,REP,440027,7,4,193,204,04
Mcclain,U.S. House,Dennis Johnson,IND,440027,0,0,6,6,04
Mcclain,State House,Joni Johnson,DEM,440027,1,0,37,38,20
Mcclain,State House,Bobby Cleveland,REP,440027,6,4,183,193,20
Mcclain,Governor,Joe Dorman,DEM,440028,5,2,101,108,
Mcclain,Governor,Mary Fallin,REP,440028,11,3,157,171,
Mcclain,Governor,Kimberly Willis,IND,440028,0,0,0,0,
Mcclain,Governor,Richard Prawdzienski,IND,440028,0,1,4,5,
Mcclain,Lieutenant Governor,Cathy Cummings,DEM,440028,5,1,72,78,
Mcclain,Lieutenant Governor,Todd Lamb,REP,440028,11,5,188,204,
Mcclain,Superintendent of Public Instruction,John Cox,DEM,440028,7,1,94,102,
Mcclain,Superintendent of Public Instruction,Joy Hofmeister,REP,440028,9,5,167,181,
Mcclain,Commissioner of Labor,Mike Workman,DEM,440028,5,2,75,82,
Mcclain,Commissioner of Labor,Mark Costello,REP,440028,11,4,178,193,
Mcclain,U.S. Senate,Matt Silverstein,DEM,440028,3,1,60,64,
Mcclain,U.S. Senate,Jim Inhofe,REP,440028,13,5,196,214,
Mcclain,U.S. Senate,Aaron Delozier,IND,440028,0,0,2,2,
Mcclain,U.S. Senate,Ray Woods,IND,440028,0,0,4,4,
Mcclain,U.S. Senate,Joan Farr,IND,440028,0,0,0,0,
Mcclain,U.S. Senate,Connie Johnson,DEM,440028,3,1,68,72,
Mcclain,U.S. Senate,James Lankford,REP,440028,12,5,187,204,
Mcclain,U.S. Senate,Mark Beard,IND,440028,1,0,7,8,
Mcclain,U.S. House,Bert Smith,DEM,440028,1,1,51,53,04
Mcclain,U.S. House,Tom Cole,REP,440028,14,5,201,220,04
Mcclain,U.S. House,Dennis Johnson,IND,440028,1,0,8,9,04
Mcclain,State House,Joni Johnson,DEM,440028,4,1,71,76,20
Mcclain,State House,Bobby Cleveland,REP,440028,12,5,184,201,20
Mccurtain,Governor,Joe Dorman,DEM,450002,0,4,65,69,
Mccurtain,Governor,Mary Fallin,REP,450002,0,1,33,34,
Mccurtain,Governor,Kimberly Willis,IND,450002,0,0,2,2,
Mccurtain,Governor,Richard Prawdzienski,IND,450002,0,0,3,3,
Mccurtain,Lieutenant Governor,Cathy Cummings,DEM,450002,0,2,60,62,
Mccurtain,Lieutenant Governor,Todd Lamb,REP,450002,0,1,39,40,
Mccurtain,Superintendent of Public Instruction,John Cox,DEM,450002,0,2,68,70,
Mccurtain,Superintendent of Public Instruction,Joy Hofmeister,REP,450002,0,1,34,35,
Mccurtain,Commissioner of Labor,Mike Workman,DEM,450002,0,2,56,58,
Mccurtain,Commissioner of Labor,Mark Costello,REP,450002,0,1,43,44,
Mccurtain,U.S. Senate,Matt Silverstein,DEM,450002,0,0,46,46,
Mccurtain,U.S. Senate,Jim Inhofe,REP,450002,0,4,50,54,
Mccurtain,U.S. Senate,Aaron Delozier,IND,450002,0,0,2,2,
Mccurtain,U.S. Senate,Ray Woods,IND,450002,0,0,1,1,
Mccurtain,U.S. Senate,Joan Farr,IND,450002,0,0,3,3,
Mccurtain,U.S. Senate,Connie Johnson,DEM,450002,0,1,52,53,
Mccurtain,U.S. Senate,James Lankford,REP,450002,0,3,39,42,
Mccurtain,U.S. Senate,Mark Beard,IND,450002,0,0,10,10,
Mccurtain,U.S. House,Earl Everett,DEM,450002,0,0,42,42,02
Mccurtain,U.S. House,Markwayne Mullin,REP,450002,0,4,53,57,02
Mccurtain,U.S. House,Jon Douthitt,IND,450002,0,0,6,6,02
Mccurtain,State Senate,Curtis Mcdaniel,DEM,450002,0,2,62,64,5
Mccurtain,State Senate,Joseph Silk,REP,450002,0,3,40,43,5
Mccurtain,State House,Johnny Tadlock,DEM,450002,0,3,76,79,1
Mccurtain,State House,J. Longacre,REP,450002,0,2,27,29,1
Mccurtain,Governor,Joe Dorman,DEM,450004,3,30,162,195,
Mccurtain,Governor,Mary Fallin,REP,450004,1,45,169,215,
Mccurtain,Governor,Kimberly Willis,IND,450004,0,0,10,10,
Mccurtain,Governor,Richard Prawdzienski,IND,450004,0,0,1,1,
Mccurtain,Lieutenant Governor,Cathy Cummings,DEM,450004,2,29,125,156,
Mccurtain,Lieutenant Governor,Todd Lamb,REP,450004,2,45,213,260,
Mccurtain,Superintendent of Public Instruction,John Cox,DEM,450004,3,34,188,225,
Mccurtain,Superintendent of Public Instruction,Joy Hofmeister,REP,450004,1,39,148,188,
Mccurtain,Commissioner of Labor,Mike Workman,DEM,450004,4,31,150,185,
Mccurtain,Commissioner of Labor,Mark Costello,REP,450004,0,39,178,217,
Mccurtain,U.S. Senate,Matt Silverstein,DEM,450004,2,23,95,120,
Mccurtain,U.S. Senate,Jim Inhofe,REP,450004,2,50,232,284,
Mccurtain,U.S. Senate,Aaron Delozier,IND,450004,0,0,4,4,
Mccurtain,U.S. Senate,Ray Woods,IND,450004,0,0,4,4,
Mccurtain,U.S. Senate,Joan Farr,IND,450004,0,0,4,4,
Mccurtain,U.S. Senate,Connie Johnson,DEM,450004,2,26,106,134,
Mccurtain,U.S. Senate,James Lankford,REP,450004,2,46,212,260,
Mccurtain,U.S. Senate,Mark Beard,IND,450004,0,1,18,19,
Mccurtain,U.S. House,Earl Everett,DEM,450004,2,20,85,107,02
Mccurtain,U.S. House,Markwayne Mullin,REP,450004,2,52,240,294,02
Mccurtain,U.S. House,Jon Douthitt,IND,450004,0,2,9,11,02
Mccurtain,State Senate,Curtis Mcdaniel,DEM,450004,4,39,176,219,5
Mccurtain,State Senate,Joseph Silk,REP,450004,0,36,163,199,5
Mccurtain,State House,Johnny Tadlock,DEM,450004,4,51,239,294,1
Mccurtain,State House,J. Longacre,REP,450004,0,24,99,123,1
Mccurtain,Governor,Joe Dorman,DEM,450005,2,1,88,91,
Mccurtain,Governor,Mary Fallin,REP,450005,2,3,16,21,
Mccurtain,Governor,Kimberly Willis,IND,450005,0,0,4,4,
Mccurtain,Governor,Richard Prawdzienski,IND,450005,0,0,1,1,
Mccurtain,Lieutenant Governor,Cathy Cummings,DEM,450005,2,1,88,91,
Mccurtain,Lieutenant Governor,Todd Lamb,REP,450005,2,3,20,25,
Mccurtain,Superintendent of Public Instruction,John Cox,DEM,450005,4,1,97,102,
Mccurtain,Superintendent of Public Instruction,Joy Hofmeister,REP,450005,0,3,11,14,
Mccurtain,Commissioner of Labor,Mike Workman,DEM,450005,4,1,96,101,
Mccurtain,Commissioner of Labor,Mark Costello,REP,450005,0,3,12,15,
Mccurtain,U.S. Senate,Matt Silverstein,DEM,450005,2,1,83,86,
Mccurtain,U.S. Senate,Jim Inhofe,REP,450005,2,3,23,28,
Mccurtain,U.S. Senate,Aaron Delozier,IND,450005,0,0,1,1,
Mccurtain,U.S. Senate,Ray Woods,IND,450005,0,0,1,1,
Mccurtain,U.S. Senate,Joan Farr,IND,450005,0,0,1,1,
Mccurtain,U.S. Senate,Connie Johnson,DEM,450005,2,1,91,94,
Mccurtain,U.S. Senate,James Lankford,REP,450005,2,3,19,24,
Mccurtain,U.S. Senate,Mark Beard,IND,450005,0,0,0,0,
Mccurtain,U.S. House,Earl Everett,DEM,450005,3,1,84,88,02
Mccurtain,U.S. House,Markwayne Mullin,REP,450005,1,3,23,27,02
Mccurtain,U.S. House,Jon Douthitt,IND,450005,0,0,2,2,02
Mccurtain,State Senate,Curtis Mcdaniel,DEM,450005,4,1,97,102,5
Mccurtain,State Senate,Joseph Silk,REP,450005,0,3,12,15,5
Mccurtain,State House,Johnny Tadlock,DEM,450005,4,1,98,103,1
Mccurtain,State House,J. Longacre,REP,450005,0,3,12,15,1
Mccurtain,Governor,Joe Dorman,DEM,450006,6,20,156,182,
Mccurtain,Governor,Mary Fallin,REP,450006,3,27,153,183,
Mccurtain,Governor,Kimberly Willis,IND,450006,1,1,15,17,
Mccurtain,Governor,Richard Prawdzienski,IND,450006,0,0,7,7,
Mccurtain,Lieutenant Governor,Cathy Cummings,DEM,450006,5,17,117,139,
Mccurtain,Lieutenant Governor,Todd Lamb,REP,450006,4,30,209,243,
Mccurtain,Superintendent of Public Instruction,John Cox,DEM,450006,8,18,179,205,
Mccurtain,Superintendent of Public Instruction,Joy Hofmeister,REP,450006,2,29,146,177,
Mccurtain,Commissioner of Labor,Mike Workman,DEM,450006,7,14,139,160,
Mccurtain,Commissioner of Labor,Mark Costello,REP,450006,2,31,182,215,
Mccurtain,U.S. Senate,Matt Silverstein,DEM,450006,4,16,87,107,
Mccurtain,U.S. Senate,Jim Inhofe,REP,450006,5,31,232,268,
Mccurtain,U.S. Senate,Aaron Delozier,IND,450006,0,0,4,4,
Mccurtain,U.S. Senate,Ray Woods,IND,450006,0,0,3,3,
Mccurtain,U.S. Senate,Joan Farr,IND,450006,0,0,3,3,
Mccurtain,U.S. Senate,Connie Johnson,DEM,450006,5,15,103,123,
Mccurtain,U.S. Senate,James Lankford,REP,450006,4,31,210,245,
Mccurtain,U.S. Senate,Mark Beard,IND,450006,1,1,10,12,
Mccurtain,U.S. House,Earl Everett,DEM,450006,2,12,89,103,02
Mccurtain,U.S. House,Markwayne Mullin,REP,450006,7,34,224,265,02
Mccurtain,U.S. House,Jon Douthitt,IND,450006,1,1,11,13,02
Mccurtain,State Senate,Curtis Mcdaniel,DEM,450006,8,20,171,199,5
Mccurtain,State Senate,Joseph Silk,REP,450006,2,28,160,190,5
Mccurtain,State House,Johnny Tadlock,DEM,450006,8,34,231,273,1
Mccurtain,State House,J. Longacre,REP,450006,1,14,100,115,1
Mccurtain,Governor,Joe Dorman,DEM,450008,1,13,125,139,
Mccurtain,Governor,Mary Fallin,REP,450008,6,22,177,205,
Mccurtain,Governor,Kimberly Willis,IND,450008,0,2,12,14,
Mccurtain,Governor,Richard Prawdzienski,IND,450008,0,1,4,5,
Mccurtain,Lieutenant Governor,Cathy Cummings,DEM,450008,1,13,89,103,
Mccurtain,Lieutenant Governor,Todd Lamb,REP,450008,6,24,222,252,
Mccurtain,Superintendent of Public Instruction,John Cox,DEM,450008,2,17,156,175,
Mccurtain,Superintendent of Public Instruction,Joy Hofmeister,REP,450008,5,17,161,183,
Mccurtain,Commissioner of Labor,Mike Workman,DEM,450008,1,16,109,126,
Mccurtain,Commissioner of Labor,Mark Costello,REP,450008,6,18,202,226,
Mccurtain,U.S. Senate,Matt Silverstein,DEM,450008,1,10,63,74,
Mccurtain,U.S. Senate,Jim Inhofe,REP,450008,6,28,246,280,
Mccurtain,U.S. Senate,Aaron Delozier,IND,450008,0,0,3,3,
Mccurtain,U.S. Senate,Ray Woods,IND,450008,0,0,4,4,
Mccurtain,U.S. Senate,Joan Farr,IND,450008,0,0,2,2,
Mccurtain,U.S. Senate,Connie Johnson,DEM,450008,1,10,70,81,
Mccurtain,U.S. Senate,James Lankford,REP,450008,6,24,231,261,
Mccurtain,U.S. Senate,Mark Beard,IND,450008,0,2,12,14,
Mccurtain,U.S. House,Earl Everett,DEM,450008,1,8,57,66,02
Mccurtain,U.S. House,Markwayne Mullin,REP,450008,6,28,254,288,02
Mccurtain,U.S. House,Jon Douthitt,IND,450008,0,2,7,9,02
Mccurtain,State Senate,Curtis Mcdaniel,DEM,450008,5,15,155,175,5
Mccurtain,State Senate,Joseph Silk,REP,450008,2,22,172,196,5
Mccurtain,State House,Johnny Tadlock,DEM,450008,2,26,221,249,1
Mccurtain,State House,J. Longacre,REP,450008,5,12,106,123,1
Mccurtain,Governor,Joe Dorman,DEM,450009,1,14,142,157,
Mccurtain,Governor,Mary Fallin,REP,450009,1,14,162,177,
Mccurtain,Governor,Kimberly Willis,IND,450009,0,0,12,12,
Mccurtain,Governor,Richard Prawdzienski,IND,450009,0,0,4,4,
Mccurtain,Lieutenant Governor,Cathy Cummings,DEM,450009,1,9,116,126,
Mccurtain,Lieutenant Governor,Todd Lamb,REP,450009,1,18,199,218,
Mccurtain,Superintendent of Public Instruction,John Cox,DEM,450009,1,14,176,191,
Mccurtain,Superintendent of Public Instruction,Joy Hofmeister,REP,450009,1,12,140,153,
Mccurtain,Commissioner of Labor,Mike Workman,DEM,450009,2,13,138,153,
Mccurtain,Commissioner of Labor,Mark Costello,REP,450009,0,13,173,186,
Mccurtain,U.S. Senate,Matt Silverstein,DEM,450009,1,6,95,102,
Mccurtain,U.S. Senate,Jim Inhofe,REP,450009,1,21,206,228,
Mccurtain,U.S. Senate,Aaron Delozier,IND,450009,0,0,5,5,
Mccurtain,U.S. Senate,Ray Woods,IND,450009,0,0,3,3,
Mccurtain,U.S. Senate,Joan Farr,IND,450009,0,1,7,8,
Mccurtain,U.S. Senate,Connie Johnson,DEM,450009,1,8,95,104,
Mccurtain,U.S. Senate,James Lankford,REP,450009,1,19,200,220,
Mccurtain,U.S. Senate,Mark Beard,IND,450009,0,1,16,17,
Mccurtain,U.S. House,Earl Everett,DEM,450009,1,5,90,96,02
Mccurtain,U.S. House,Markwayne Mullin,REP,450009,1,22,212,235,02
Mccurtain,U.S. House,Jon Douthitt,IND,450009,0,0,14,14,02
Mccurtain,State Senate,Curtis Mcdaniel,DEM,450009,1,15,170,186,5
Mccurtain,State Senate,Joseph Silk,REP,450009,1,13,152,166,5
Mccurtain,State House,Johnny Tadlock,DEM,450009,1,20,229,250,1
Mccurtain,State House,J. Longacre,REP,450009,1,8,93,102,1
Mccurtain,Governor,Joe Dorman,DEM,450011,1,3,62,66,
Mccurtain,Governor,Mary Fallin,REP,450011,0,3,38,41,
Mccurtain,Governor,Kimberly Willis,IND,450011,0,0,1,1,
Mccurtain,Governor,Richard Prawdzienski,IND,450011,0,0,1,1,
Mccurtain,Lieutenant Governor,Cathy Cummings,DEM,450011,1,1,36,38,
Mccurtain,Lieutenant Governor,Todd Lamb,REP,450011,0,5,65,70,
Mccurtain,Superintendent of Public Instruction,John Cox,DEM,450011,1,4,74,79,
Mccurtain,Superintendent of Public Instruction,Joy Hofmeister,REP,450011,0,2,29,31,
Mccurtain,Commissioner of Labor,Mike Workman,DEM,450011,1,1,50,52,
Mccurtain,Commissioner of Labor,Mark Costello,REP,450011,0,4,50,54,
Mccurtain,U.S. Senate,Matt Silverstein,DEM,450011,1,1,33,35,
Mccurtain,U.S. Senate,Jim Inhofe,REP,450011,0,5,70,75,
Mccurtain,U.S. Senate,Aaron Delozier,IND,450011,0,0,0,0,
Mccurtain,U.S. Senate,Ray Woods,IND,450011,0,0,1,1,
Mccurtain,U.S. Senate,Joan Farr,IND,450011,0,0,0,0,
Mccurtain,U.S. Senate,Connie Johnson,DEM,450011,1,1,39,41,
Mccurtain,U.S. Senate,James Lankford,REP,450011,0,4,59,63,
Mccurtain,U.S. Senate,Mark Beard,IND,450011,0,0,4,4,
Mccurtain,U.S. House,Earl Everett,DEM,450011,1,1,31,33,02
Mccurtain,U.S. House,Markwayne Mullin,REP,450011,0,4,68,72,02
Mccurtain,U.S. House,Jon Douthitt,IND,450011,0,0,3,3,02
Mccurtain,State Senate,Curtis Mcdaniel,DEM,450011,1,5,53,59,5
Mccurtain,State Senate,Joseph Silk,REP,450011,0,1,51,52,5
Mccurtain,State House,Johnny Tadlock,DEM,450011,1,6,81,88,1
Mccurtain,State House,J. Longacre,REP,450011,0,0,23,23,1
Mccurtain,Governor,Joe Dorman,DEM,450012,0,2,43,45,
Mccurtain,Governor,Mary Fallin,REP,450012,0,0,17,17,
Mccurtain,Governor,Kimberly Willis,IND,450012,0,0,2,2,
Mccurtain,Governor,Richard Prawdzienski,IND,450012,0,0,3,3,
Mccurtain,Lieutenant Governor,Cathy Cummings,DEM,450012,0,2,43,45,
Mccurtain,Lieutenant Governor,Todd Lamb,REP,450012,0,0,22,22,
Mccurtain,Superintendent of Public Instruction,John Cox,DEM,450012,0,2,54,56,
Mccurtain,Superintendent of Public Instruction,Joy Hofmeister,REP,450012,0,0,11,11,
Mccurtain,Commissioner of Labor,Mike Workman,DEM,450012,0,2,48,50,
Mccurtain,Commissioner of Labor,Mark Costello,REP,450012,0,0,17,17,
Mccurtain,U.S. Senate,Matt Silverstein,DEM,450012,0,2,43,45,
Mccurtain,U.S. Senate,Jim Inhofe,REP,450012,0,0,18,18,
Mccurtain,U.S. Senate,Aaron Delozier,IND,450012,0,0,2,2,
Mccurtain,U.S. Senate,Ray Woods,IND,450012,0,0,1,1,
Mccurtain,U.S. Senate,Joan Farr,IND,450012,0,0,2,2,
Mccurtain,U.S. Senate,Connie Johnson,DEM,450012,0,2,46,48,
Mccurtain,U.S. Senate,James Lankford,REP,450012,0,0,16,16,
Mccurtain,U.S. Senate,Mark Beard,IND,450012,0,0,4,4,
Mccurtain,U.S. House,Earl Everett,DEM,450012,0,2,40,42,02
Mccurtain,U.S. House,Markwayne Mullin,REP,450012,0,0,19,19,02
Mccurtain,U.S. House,Jon Douthitt,IND,450012,0,0,6,6,02
Mccurtain,State Senate,Curtis Mcdaniel,DEM,450012,0,2,54,56,5
Mccurtain,State Senate,Joseph Silk,REP,450012,0,0,11,11,5
Mccurtain,State House,Johnny Tadlock,DEM,450012,0,2,60,62,1
Mccurtain,State House,J. Longacre,REP,450012,0,0,7,7,1
Mccurtain,Governor,Joe Dorman,DEM,450013,0,8,90,98,
Mccurtain,Governor,Mary Fallin,REP,450013,0,5,77,82,
Mccurtain,Governor,Kimberly Willis,IND,450013,0,1,9,10,
Mccurtain,Governor,Richard Prawdzienski,IND,450013,0,0,4,4,
Mccurtain,Lieutenant Governor,Cathy Cummings,DEM,450013,0,7,65,72,
Mccurtain,Lieutenant Governor,Todd Lamb,REP,450013,0,7,113,120,
Mccurtain,Superintendent of Public Instruction,John Cox,DEM,450013,0,9,112,121,
Mccurtain,Superintendent of Public Instruction,Joy Hofmeister,REP,450013,0,5,68,73,
Mccurtain,Commissioner of Labor,Mike Workman,DEM,450013,0,9,76,85,
Mccurtain,Commissioner of Labor,Mark Costello,REP,450013,0,5,100,105,
Mccurtain,U.S. Senate,Matt Silverstein,DEM,450013,0,4,48,52,
Mccurtain,U.S. Senate,Jim Inhofe,REP,450013,0,8,117,125,
Mccurtain,U.S. Senate,Aaron Delozier,IND,450013,0,2,8,10,
Mccurtain,U.S. Senate,Ray Woods,IND,450013,0,0,6,6,
Mccurtain,U.S. Senate,Joan Farr,IND,450013,0,0,0,0,
Mccurtain,U.S. Senate,Connie Johnson,DEM,450013,0,5,51,56,
Mccurtain,U.S. Senate,James Lankford,REP,450013,0,9,115,124,
Mccurtain,U.S. Senate,Mark Beard,IND,450013,0,0,14,14,
Mccurtain,U.S. House,Earl Everett,DEM,450013,0,4,59,63,02
Mccurtain,U.S. House,Markwayne Mullin,REP,450013,0,10,117,127,02
Mccurtain,U.S. House,Jon Douthitt,IND,450013,0,0,5,5,02
Mccurtain,State Senate,Curtis Mcdaniel,DEM,450013,0,9,89,98,5
Mccurtain,State Senate,Joseph Silk,REP,450013,0,6,95,101,5
Mccurtain,State House,Johnny Tadlock,DEM,450013,0,11,125,136,1
Mccurtain,State House,J. Longacre,REP,450013,0,4,58,62,1
Mccurtain,Governor,Joe Dorman,DEM,450014,0,1,43,44,
Mccurtain,Governor,Mary Fallin,REP,450014,0,1,58,59,
Mccurtain,Governor,Kimberly Willis,IND,450014,0,0,2,2,
Mccurtain,Governor,Richard Prawdzienski,IND,450014,0,0,0,0,
Mccurtain,Lieutenant Governor,Cathy Cummings,DEM,450014,0,1,39,40,
Mccurtain,Lieutenant Governor,Todd Lamb,REP,450014,0,1,64,65,
Mccurtain,Superintendent of Public Instruction,John Cox,DEM,450014,0,2,68,70,
Mccurtain,Superintendent of Public Instruction,Joy Hofmeister,REP,450014,0,0,35,35,
Mccurtain,Commissioner of Labor,Mike Workman,DEM,450014,0,1,46,47,
Mccurtain,Commissioner of Labor,Mark Costello,REP,450014,0,1,52,53,
Mccurtain,U.S. Senate,Matt Silverstein,DEM,450014,0,1,29,30,
Mccurtain,U.S. Senate,Jim Inhofe,REP,450014,0,1,70,71,
Mccurtain,U.S. Senate,Aaron Delozier,IND,450014,0,0,4,4,
Mccurtain,U.S. Senate,Ray Woods,IND,450014,0,0,1,1,
Mccurtain,U.S. Senate,Joan Farr,IND,450014,0,0,0,0,
Mccurtain,U.S. Senate,Connie Johnson,DEM,450014,0,1,30,31,
Mccurtain,U.S. Senate,James Lankford,REP,450014,0,1,66,67,
Mccurtain,U.S. Senate,Mark Beard,IND,450014,0,0,7,7,
Mccurtain,U.S. House,Earl Everett,DEM,450014,0,1,23,24,02
Mccurtain,U.S. House,Markwayne Mullin,REP,450014,0,1,76,77,02
Mccurtain,U.S. House,Jon Douthitt,IND,450014,0,0,4,4,02
Mccurtain,State Senate,Curtis Mcdaniel,DEM,450014,0,1,45,46,5
Mccurtain,State Senate,Joseph Silk,REP,450014,0,1,62,63,5
Mccurtain,State House,Johnny Tadlock,DEM,450014,0,2,82,84,1
Mccurtain,State House,J. Longacre,REP,450014,0,0,26,26,1
Mccurtain,Governor,Joe Dorman,DEM,450015,0,4,44,48,
Mccurtain,Governor,Mary Fallin,REP,450015,0,5,65,70,
Mccurtain,Governor,Kimberly Willis,IND,450015,0,0,4,4,
Mccurtain,Governor,Richard Prawdzienski,IND,450015,0,0,0,0,
Mccurtain,Lieutenant Governor,Cathy Cummings,DEM,450015,0,4,37,41,
Mccurtain,Lieutenant Governor,Todd Lamb,REP,450015,0,5,69,74,
Mccurtain,Superintendent of Public Instruction,John Cox,DEM,450015,0,5,59,64,
Mccurtain,Superintendent of Public Instruction,Joy Hofmeister,REP,450015,0,4,50,54,
Mccurtain,Commissioner of Labor,Mike Workman,DEM,450015,0,5,35,40,
Mccurtain,Commissioner of Labor,Mark Costello,REP,450015,0,4,72,76,
Mccurtain,U.S. Senate,Matt Silverstein,DEM,450015,0,2,23,25,
Mccurtain,U.S. Senate,Jim Inhofe,REP,450015,0,6,76,82,
Mccurtain,U.S. Senate,Aaron Delozier,IND,450015,0,1,7,8,
Mccurtain,U.S. Senate,Ray Woods,IND,450015,0,0,1,1,
Mccurtain,U.S. Senate,Joan Farr,IND,450015,0,0,0,0,
Mccurtain,U.S. Senate,Connie Johnson,DEM,450015,0,3,27,30,
Mccurtain,U.S. Senate,James Lankford,REP,450015,0,5,74,79,
Mccurtain,U.S. Senate,Mark Beard,IND,450015,0,1,7,8,
Mccurtain,U.S. House,Earl Everett,DEM,450015,0,1,20,21,02
Mccurtain,U.S. House,Markwayne Mullin,REP,450015,0,8,83,91,02
Mccurtain,U.S. House,Jon Douthitt,IND,450015,0,0,5,5,02
Mccurtain,State Senate,Curtis Mcdaniel,DEM,450015,0,3,40,43,5
Mccurtain,State Senate,Joseph Silk,REP,450015,0,6,75,81,5
Mccurtain,State House,Johnny Tadlock,DEM,450015,0,9,84,93,1
Mccurtain,State House,J. Longacre,REP,450015,0,0,30,30,1
Mccurtain,Governor,Joe Dorman,DEM,450017,3,1,81,85,
Mccurtain,Governor,Mary Fallin,REP,450017,4,4,120,128,
Mccurtain,Governor,Kimberly Willis,IND,450017,0,0,7,7,
Mccurtain,Governor,Richard Prawdzienski,IND,450017,0,0,1,1,
Mccurtain,Lieutenant Governor,Cathy Cummings,DEM,450017,3,2,60,65,
Mccurtain,Lieutenant Governor,Todd Lamb,REP,450017,4,3,143,150,
Mccurtain,Superintendent of Public Instruction,John Cox,DEM,450017,3,4,109,116,
Mccurtain,Superintendent of Public Instruction,Joy Hofmeister,REP,450017,1,1,95,97,
Mccurtain,Commissioner of Labor,Mike Workman,DEM,450017,3,0,83,86,
Mccurtain,Commissioner of Labor,Mark Costello,REP,450017,4,5,112,121,
Mccurtain,U.S. Senate,Matt Silverstein,DEM,450017,3,1,48,52,
Mccurtain,U.S. Senate,Jim Inhofe,REP,450017,4,4,152,160,
Mccurtain,U.S. Senate,Aaron Delozier,IND,450017,0,0,4,4,
Mccurtain,U.S. Senate,Ray Woods,IND,450017,0,0,0,0,
Mccurtain,U.S. Senate,Joan Farr,IND,450017,0,0,3,3,
Mccurtain,U.S. Senate,Connie Johnson,DEM,450017,2,1,59,62,
Mccurtain,U.S. Senate,James Lankford,REP,450017,3,4,139,146,
Mccurtain,U.S. Senate,Mark Beard,IND,450017,0,0,9,9,
Mccurtain,U.S. House,Earl Everett,DEM,450017,2,1,47,50,02
Mccurtain,U.S. House,Markwayne Mullin,REP,450017,3,4,153,160,02
Mccurtain,U.S. House,Jon Douthitt,IND,450017,1,0,8,9,02
Mccurtain,State Senate,Curtis Mcdaniel,DEM,450017,5,2,84,91,5
Mccurtain,State Senate,Joseph Silk,REP,450017,2,3,126,131,5
Mccurtain,State House,Johnny Tadlock,DEM,450017,5,4,113,122,1
Mccurtain,State House,J. Longacre,REP,450017,2,1,95,98,1
Mccurtain,Governor,Joe Dorman,DEM,450018,3,8,186,197,
Mccurtain,Governor,Mary Fallin,REP,450018,5,4,230,239,
Mccurtain,Governor,Kimberly Willis,IND,450018,0,1,16,17,
Mccurtain,Governor,Richard Prawdzienski,IND,450018,0,0,4,4,
Mccurtain,Lieutenant Governor,Cathy Cummings,DEM,450018,1,6,126,133,
Mccurtain,Lieutenant Governor,Todd Lamb,REP,450018,7,7,302,316,
Mccurtain,Superintendent of Public Instruction,John Cox,DEM,450018,4,9,250,263,
Mccurtain,Superintendent of Public Instruction,Joy Hofmeister,REP,450018,4,4,185,193,
Mccurtain,Commissioner of Labor,Mike Workman,DEM,450018,3,3,156,162,
Mccurtain,Commissioner of Labor,Mark Costello,REP,450018,4,9,259,272,
Mccurtain,U.S. Senate,Matt Silverstein,DEM,450018,2,3,97,102,
Mccurtain,U.S. Senate,Jim Inhofe,REP,450018,6,7,324,337,
Mccurtain,U.S. Senate,Aaron Delozier,IND,450018,0,0,5,5,
Mccurtain,U.S. Senate,Ray Woods,IND,450018,0,1,1,2,
Mccurtain,U.S. Senate,Joan Farr,IND,450018,0,0,7,7,
Mccurtain,U.S. Senate,Connie Johnson,DEM,450018,2,3,111,116,
Mccurtain,U.S. Senate,James Lankford,REP,450018,6,9,300,315,
Mccurtain,U.S. Senate,Mark Beard,IND,450018,0,1,16,17,
Mccurtain,U.S. House,Earl Everett,DEM,450018,2,4,102,108,02
Mccurtain,U.S. House,Markwayne Mullin,REP,450018,6,6,315,327,02
Mccurtain,U.S. House,Jon Douthitt,IND,450018,0,2,7,9,02
Mccurtain,State Senate,Curtis Mcdaniel,DEM,450018,5,6,190,201,5
Mccurtain,State Senate,Joseph Silk,REP,450018,3,7,248,258,5
Mccurtain,State House,Johnny Tadlock,DEM,450018,4,6,206,216,1
Mccurtain,State House,J. Longacre,REP,450018,4,6,232,242,1
Mccurtain,Governor,Joe Dorman,DEM,450019,3,6,126,135,
Mccurtain,Governor,Mary Fallin,REP,450019,5,8,181,194,
Mccurtain,Governor,Kimberly Willis,IND,450019,1,0,12,13,
Mccurtain,Governor,Richard Prawdzienski,IND,450019,0,0,1,1,
Mccurtain,Lieutenant Governor,Cathy Cummings,DEM,450019,1,2,75,78,
Mccurtain,Lieutenant Governor,Todd Lamb,REP,450019,8,12,239,259,
Mccurtain,Superintendent of Public Instruction,John Cox,DEM,450019,4,7,161,172,
Mccurtain,Superintendent of Public Instruction,Joy Hofmeister,REP,450019,5,6,159,170,
Mccurtain,Commissioner of Labor,Mike Workman,DEM,450019,2,4,88,94,
Mccurtain,Commissioner of Labor,Mark Costello,REP,450019,7,9,216,232,
Mccurtain,U.S. Senate,Matt Silverstein,DEM,450019,1,3,53,57,
Mccurtain,U.S. Senate,Jim Inhofe,REP,450019,7,11,253,271,
Mccurtain,U.S. Senate,Aaron Delozier,IND,450019,1,0,3,4,
Mccurtain,U.S. Senate,Ray Woods,IND,450019,0,0,7,7,
Mccurtain,U.S. Senate,Joan Farr,IND,450019,0,0,1,1,
Mccurtain,U.S. Senate,Connie Johnson,DEM,450019,1,3,60,64,
Mccurtain,U.S. Senate,James Lankford,REP,450019,7,10,245,262,
Mccurtain,U.S. Senate,Mark Beard,IND,450019,1,0,12,13,
Mccurtain,U.S. House,Earl Everett,DEM,450019,3,2,53,58,02
Mccurtain,U.S. House,Markwayne Mullin,REP,450019,6,11,258,275,02
Mccurtain,U.S. House,Jon Douthitt,IND,450019,0,0,6,6,02
Mccurtain,State Senate,Curtis Mcdaniel,DEM,450019,3,5,117,125,5
Mccurtain,State Senate,Joseph Silk,REP,450019,6,9,205,220,5
Mccurtain,State House,Johnny Tadlock,DEM,450019,2,8,138,148,1
Mccurtain,State House,J. Longacre,REP,450019,7,6,183,196,1
Mccurtain,Governor,Joe Dorman,DEM,450020,3,4,81,88,
Mccurtain,Governor,Mary Fallin,REP,450020,1,17,173,191,
Mccurtain,Governor,Kimberly Willis,IND,450020,0,1,10,11,
Mccurtain,Governor,Richard Prawdzienski,IND,450020,0,0,4,4,
Mccurtain,Lieutenant Governor,Cathy Cummings,DEM,450020,3,4,62,69,
Mccurtain,Lieutenant Governor,Todd Lamb,REP,450020,1,18,202,221,
Mccurtain,Superintendent of Public Instruction,John Cox,DEM,450020,2,6,108,116,
Mccurtain,Superintendent of Public Instruction,Joy Hofmeister,REP,450020,2,16,152,170,
Mccurtain,Commissioner of Labor,Mike Workman,DEM,450020,2,4,63,69,
Mccurtain,Commissioner of Labor,Mark Costello,REP,450020,2,18,187,207,
Mccurtain,U.S. Senate,Matt Silverstein,DEM,450020,3,3,44,50,
Mccurtain,U.S. Senate,Jim Inhofe,REP,450020,1,18,216,235,
Mccurtain,U.S. Senate,Aaron Delozier,IND,450020,0,0,4,4,
Mccurtain,U.S. Senate,Ray Woods,IND,450020,0,0,2,2,
Mccurtain,U.S. Senate,Joan Farr,IND,450020,0,1,1,2,
Mccurtain,U.S. Senate,Connie Johnson,DEM,450020,2,4,51,57,
Mccurtain,U.S. Senate,James Lankford,REP,450020,2,16,204,222,
Mccurtain,U.S. Senate,Mark Beard,IND,450020,0,2,8,10,
Mccurtain,U.S. House,Earl Everett,DEM,450020,1,3,45,49,02
Mccurtain,U.S. House,Markwayne Mullin,REP,450020,3,17,212,232,02
Mccurtain,U.S. House,Jon Douthitt,IND,450020,0,2,6,8,02
Mccurtain,State Senate,Curtis Mcdaniel,DEM,450020,2,5,85,92,5
Mccurtain,State Senate,Joseph Silk,REP,450020,2,17,183,202,5
Mccurtain,State House,Johnny Tadlock,DEM,450020,4,7,116,127,1
Mccurtain,State House,J. Longacre,REP,450020,0,15,153,168,1
Mccurtain,Governor,Joe Dorman,DEM,450022,2,3,58,63,
Mccurtain,Governor,Mary Fallin,REP,450022,5,5,134,144,
Mccurtain,Governor,Kimberly Willis,IND,450022,0,0,12,12,
Mccurtain,Governor,Richard Prawdzienski,IND,450022,0,0,4,4,
Mccurtain,Lieutenant Governor,Cathy Cummings,DEM,450022,2,2,41,45,
Mccurtain,Lieutenant Governor,Todd Lamb,REP,450022,5,6,160,171,
Mccurtain,Superintendent of Public Instruction,John Cox,DEM,450022,2,3,93,98,
Mccurtain,Superintendent of Public Instruction,Joy Hofmeister,REP,450022,5,5,105,115,
Mccurtain,Commissioner of Labor,Mike Workman,DEM,450022,2,3,44,49,
Mccurtain,Commissioner of Labor,Mark Costello,REP,450022,5,5,153,163,
Mccurtain,U.S. Senate,Matt Silverstein,DEM,450022,2,1,28,31,
Mccurtain,U.S. Senate,Jim Inhofe,REP,450022,5,7,171,183,
Mccurtain,U.S. Senate,Aaron Delozier,IND,450022,0,0,1,1,
Mccurtain,U.S. Senate,Ray Woods,IND,450022,0,0,2,2,
Mccurtain,U.S. Senate,Joan Farr,IND,450022,0,0,4,4,
Mccurtain,U.S. Senate,Connie Johnson,DEM,450022,2,2,35,39,
Mccurtain,U.S. Senate,James Lankford,REP,450022,5,6,154,165,
Mccurtain,U.S. Senate,Mark Beard,IND,450022,0,0,13,13,
Mccurtain,U.S. House,Earl Everett,DEM,450022,2,0,29,31,02
Mccurtain,U.S. House,Markwayne Mullin,REP,450022,5,7,165,177,02
Mccurtain,U.S. House,Jon Douthitt,IND,450022,0,0,7,7,02
Mccurtain,State Senate,Curtis Mcdaniel,DEM,450022,2,5,64,71,5
Mccurtain,State Senate,Joseph Silk,REP,450022,5,3,146,154,5
Mccurtain,State House,Johnny Tadlock,DEM,450022,3,3,86,92,1
Mccurtain,State House,J. Longacre,REP,450022,3,5,125,133,1
Mccurtain,Governor,Joe Dorman,DEM,450023,2,1,75,78,
Mccurtain,Governor,Mary Fallin,REP,450023,1,3,85,89,
Mccurtain,Governor,Kimberly Willis,IND,450023,0,0,13,13,
Mccurtain,Governor,Richard Prawdzienski,IND,450023,0,2,2,4,
Mccurtain,Lieutenant Governor,Cathy Cummings,DEM,450023,2,1,70,73,
Mccurtain,Lieutenant Governor,Todd Lamb,REP,450023,1,5,97,103,
Mccurtain,Superintendent of Public Instruction,John Cox,DEM,450023,2,2,115,119,
Mccurtain,Superintendent of Public Instruction,Joy Hofmeister,REP,450023,1,4,57,62,
Mccurtain,Commissioner of Labor,Mike Workman,DEM,450023,2,0,90,92,
Mccurtain,Commissioner of Labor,Mark Costello,REP,450023,1,6,76,83,
Mccurtain,U.S. Senate,Matt Silverstein,DEM,450023,2,0,57,59,
Mccurtain,U.S. Senate,Jim Inhofe,REP,450023,1,6,103,110,
Mccurtain,U.S. Senate,Aaron Delozier,IND,450023,0,0,2,2,
Mccurtain,U.S. Senate,Ray Woods,IND,450023,0,0,4,4,
Mccurtain,U.S. Senate,Joan Farr,IND,450023,0,0,4,4,
Mccurtain,U.S. Senate,Connie Johnson,DEM,450023,2,0,62,64,
Mccurtain,U.S. Senate,James Lankford,REP,450023,1,6,96,103,
Mccurtain,U.S. Senate,Mark Beard,IND,450023,0,0,10,10,
Mccurtain,U.S. House,Earl Everett,DEM,450023,2,0,47,49,02
Mccurtain,U.S. House,Markwayne Mullin,REP,450023,1,6,108,115,02
Mccurtain,U.S. House,Jon Douthitt,IND,450023,0,0,15,15,02
Mccurtain,State Senate,Curtis Mcdaniel,DEM,450023,2,1,88,91,5
Mccurtain,State Senate,Joseph Silk,REP,450023,1,5,85,91,5
Mccurtain,State House,Johnny Tadlock,DEM,450023,3,2,67,72,1
Mccurtain,State House,J. Longacre,REP,450023,0,4,108,112,1
Mccurtain,Governor,Joe Dorman,DEM,450024,7,1,42,50,
Mccurtain,Governor,Mary Fallin,REP,450024,2,2,52,56,
Mccurtain,Governor,Kimberly Willis,IND,450024,0,0,3,3,
Mccurtain,Governor,Richard Prawdzienski,IND,450024,0,0,1,1,
Mccurtain,Lieutenant Governor,Cathy Cummings,DEM,450024,7,0,27,34,
Mccurtain,Lieutenant Governor,Todd Lamb,REP,450024,2,3,70,75,
Mccurtain,Superintendent of Public Instruction,John Cox,DEM,450024,7,2,54,63,
Mccurtain,Superintendent of Public Instruction,Joy Hofmeister,REP,450024,2,1,41,44,
Mccurtain,Commissioner of Labor,Mike Workman,DEM,450024,5,2,33,40,
Mccurtain,Commissioner of Labor,Mark Costello,REP,450024,4,1,56,61,
Mccurtain,U.S. Senate,Matt Silverstein,DEM,450024,5,0,20,25,
Mccurtain,U.S. Senate,Jim Inhofe,REP,450024,3,3,67,73,
Mccurtain,U.S. Senate,Aaron Delozier,IND,450024,0,0,4,4,
Mccurtain,U.S. Senate,Ray Woods,IND,450024,0,0,5,5,
Mccurtain,U.S. Senate,Joan Farr,IND,450024,0,0,1,1,
Mccurtain,U.S. Senate,Connie Johnson,DEM,450024,6,0,21,27,
Mccurtain,U.S. Senate,James Lankford,REP,450024,3,3,66,72,
Mccurtain,U.S. Senate,Mark Beard,IND,450024,0,0,6,6,
Mccurtain,U.S. House,Earl Everett,DEM,450024,6,0,22,28,02
Mccurtain,U.S. House,Markwayne Mullin,REP,450024,3,3,67,73,02
Mccurtain,U.S. House,Jon Douthitt,IND,450024,0,0,6,6,02
Mccurtain,State Senate,Curtis Mcdaniel,DEM,450024,7,2,50,59,5
Mccurtain,State Senate,Joseph Silk,REP,450024,2,1,49,52,5
Mccurtain,State House,Johnny Tadlock,DEM,450024,7,1,52,60,1
Mccurtain,State House,J. Longacre,REP,450024,2,3,47,52,1
Mccurtain,Governor,Joe Dorman,DEM,450025,0,1,57,58,
Mccurtain,Governor,Mary Fallin,REP,450025,2,0,92,94,
Mccurtain,Governor,Kimberly Willis,IND,450025,0,0,5,5,
Mccurtain,Governor,Richard Prawdzienski,IND,450025,0,0,1,1,
Mccurtain,Lieutenant Governor,Cathy Cummings,DEM,450025,0,1,39,40,
Mccurtain,Lieutenant Governor,Todd Lamb,REP,450025,2,0,115,117,
Mccurtain,Superintendent of Public Instruction,John Cox,DEM,450025,1,1,74,76,
Mccurtain,Superintendent of Public Instruction,Joy Hofmeister,REP,450025,1,0,81,82,
Mccurtain,Commissioner of Labor,Mike Workman,DEM,450025,0,1,45,46,
Mccurtain,Commissioner of Labor,Mark Costello,REP,450025,2,0,107,109,
Mccurtain,U.S. Senate,Matt Silverstein,DEM,450025,0,1,27,28,
Mccurtain,U.S. Senate,Jim Inhofe,REP,450025,2,0,114,116,
Mccurtain,U.S. Senate,Aaron Delozier,IND,450025,0,0,2,2,
Mccurtain,U.S. Senate,Ray Woods,IND,450025,0,0,5,5,
Mccurtain,U.S. Senate,Joan Farr,IND,450025,0,0,6,6,
Mccurtain,U.S. Senate,Connie Johnson,DEM,450025,0,1,33,34,
Mccurtain,U.S. Senate,James Lankford,REP,450025,2,0,111,113,
Mccurtain,U.S. Senate,Mark Beard,IND,450025,0,0,8,8,
Mccurtain,U.S. House,Earl Everett,DEM,450025,0,1,33,34,02
Mccurtain,U.S. House,Markwayne Mullin,REP,450025,2,0,115,117,02
Mccurtain,U.S. House,Jon Douthitt,IND,450025,0,0,4,4,02
Mccurtain,State Senate,Curtis Mcdaniel,DEM,450025,1,1,72,74,5
Mccurtain,State Senate,Joseph Silk,REP,450025,1,0,85,86,5
Mccurtain,State House,Johnny Tadlock,DEM,450025,1,1,58,60,1
Mccurtain,State House,J. Longacre,REP,450025,1,0,98,99,1
Mccurtain,Governor,Joe Dorman,DEM,450026,0,0,26,26,
Mccurtain,Governor,Mary Fallin,REP,450026,2,1,95,98,
Mccurtain,Governor,Kimberly Willis,IND,450026,0,0,0,0,
Mccurtain,Governor,Richard Prawdzienski,IND,450026,0,0,2,2,
Mccurtain,Lieutenant Governor,Cathy Cummings,DEM,450026,0,0,23,23,
Mccurtain,Lieutenant Governor,Todd Lamb,REP,450026,2,1,99,102,
Mccurtain,Superintendent of Public Instruction,John Cox,DEM,450026,1,0,31,32,
Mccurtain,Superintendent of Public Instruction,Joy Hofmeister,REP,450026,1,1,88,90,
Mccurtain,Commissioner of Labor,Mike Workman,DEM,450026,0,0,21,21,
Mccurtain,Commissioner of Labor,Mark Costello,REP,450026,2,1,96,99,
Mccurtain,U.S. Senate,Matt Silverstein,DEM,450026,0,0,19,19,
Mccurtain,U.S. Senate,Jim Inhofe,REP,450026,2,1,100,103,
Mccurtain,U.S. Senate,Aaron Delozier,IND,450026,0,0,2,2,
Mccurtain,U.S. Senate,Ray Woods,IND,450026,0,0,2,2,
Mccurtain,U.S. Senate,Joan Farr,IND,450026,0,0,0,0,
Mccurtain,U.S. Senate,Connie Johnson,DEM,450026,0,0,21,21,
Mccurtain,U.S. Senate,James Lankford,REP,450026,2,1,99,102,
Mccurtain,U.S. Senate,Mark Beard,IND,450026,0,0,2,2,
Mccurtain,U.S. House,Earl Everett,DEM,450026,0,0,15,15,02
Mccurtain,U.S. House,Markwayne Mullin,REP,450026,2,1,107,110,02
Mccurtain,U.S. House,Jon Douthitt,IND,450026,0,0,3,3,02
Mccurtain,State Senate,Curtis Mcdaniel,DEM,450026,0,1,44,45,5
Mccurtain,State Senate,Joseph Silk,REP,450026,2,0,87,89,5
Mccurtain,State House,Johnny Tadlock,DEM,450026,1,0,31,32,1
Mccurtain,State House,J. Longacre,REP,450026,1,1,98,100,1
Mccurtain,Governor,Joe Dorman,DEM,450027,1,1,49,51,
Mccurtain,Governor,Mary Fallin,REP,450027,0,0,25,25,
Mccurtain,Governor,Kimberly Willis,IND,450027,0,0,6,6,
Mccurtain,Governor,Richard Prawdzienski,IND,450027,0,0,2,2,
Mccurtain,Lieutenant Governor,Cathy Cummings,DEM,450027,0,1,23,24,
Mccurtain,Lieutenant Governor,Todd Lamb,REP,450027,1,0,55,56,
Mccurtain,Superintendent of Public Instruction,John Cox,DEM,450027,1,1,55,57,
Mccurtain,Superintendent of Public Instruction,Joy Hofmeister,REP,450027,0,0,28,28,
Mccurtain,Commissioner of Labor,Mike Workman,DEM,450027,0,0,27,27,
Mccurtain,Commissioner of Labor,Mark Costello,REP,450027,1,1,50,52,
Mccurtain,U.S. Senate,Matt Silverstein,DEM,450027,0,0,15,15,
Mccurtain,U.S. Senate,Jim Inhofe,REP,450027,1,1,61,63,
Mccurtain,U.S. Senate,Aaron Delozier,IND,450027,0,0,2,2,
Mccurtain,U.S. Senate,Ray Woods,IND,450027,0,0,1,1,
Mccurtain,U.S. Senate,Joan Farr,IND,450027,0,0,2,2,
Mccurtain,U.S. Senate,Connie Johnson,DEM,450027,0,0,19,19,
Mccurtain,U.S. Senate,James Lankford,REP,450027,1,1,55,57,
Mccurtain,U.S. Senate,Mark Beard,IND,450027,0,0,4,4,
Mccurtain,U.S. House,Earl Everett,DEM,450027,0,0,20,20,02
Mccurtain,U.S. House,Markwayne Mullin,REP,450027,1,1,54,56,02
Mccurtain,U.S. House,Jon Douthitt,IND,450027,0,0,4,4,02
Mccurtain,State Senate,Curtis Mcdaniel,DEM,450027,0,1,44,45,5
Mccurtain,State Senate,Joseph Silk,REP,450027,1,0,40,41,5
Mccurtain,State House,Johnny Tadlock,DEM,450027,0,1,43,44,1
Mccurtain,State House,J. Longacre,REP,450027,1,0,39,40,1
Mccurtain,Governor,Joe Dorman,DEM,450028,0,0,25,25,
Mccurtain,Governor,Mary Fallin,REP,450028,2,2,26,30,
Mccurtain,Governor,Kimberly Willis,IND,450028,0,0,6,6,
Mccurtain,Governor,Richard Prawdzienski,IND,450028,0,0,0,0,
Mccurtain,Lieutenant Governor,Cathy Cummings,DEM,450028,0,0,6,6,
Mccurtain,Lieutenant Governor,Todd Lamb,REP,450028,2,2,47,51,
Mccurtain,Superintendent of Public Instruction,John Cox,DEM,450028,2,1,26,29,
Mccurtain,Superintendent of Public Instruction,Joy Hofmeister,REP,450028,0,1,32,33,
Mccurtain,Commissioner of Labor,Mike Workman,DEM,450028,0,1,11,12,
Mccurtain,Commissioner of Labor,Mark Costello,REP,450028,2,1,45,48,
Mccurtain,U.S. Senate,Matt Silverstein,DEM,450028,0,0,5,5,
Mccurtain,U.S. Senate,Jim Inhofe,REP,450028,2,2,44,48,
Mccurtain,U.S. Senate,Aaron Delozier,IND,450028,0,0,5,5,
Mccurtain,U.S. Senate,Ray Woods,IND,450028,0,0,3,3,
Mccurtain,U.S. Senate,Joan Farr,IND,450028,0,0,0,0,
Mccurtain,U.S. Senate,Connie Johnson,DEM,450028,0,0,3,3,
Mccurtain,U.S. Senate,James Lankford,REP,450028,2,2,46,50,
Mccurtain,U.S. Senate,Mark Beard,IND,450028,0,0,6,6,
Mccurtain,U.S. House,Earl Everett,DEM,450028,0,0,6,6,02
Mccurtain,U.S. House,Markwayne Mullin,REP,450028,2,2,48,52,02
Mccurtain,U.S. House,Jon Douthitt,IND,450028,0,0,3,3,02
Mccurtain,State Senate,Curtis Mcdaniel,DEM,450028,2,1,20,23,5
Mccurtain,State Senate,Joseph Silk,REP,450028,0,1,40,41,5
Mccurtain,State House,Johnny Tadlock,DEM,450028,0,2,31,33,1
Mccurtain,State House,J. Longacre,REP,450028,2,0,28,30,1
Mccurtain,Governor,Joe Dorman,DEM,450029,0,3,66,69,
Mccurtain,Governor,Mary Fallin,REP,450029,2,3,84,89,
Mccurtain,Governor,Kimberly Willis,IND,450029,0,2,6,8,
Mccurtain,Governor,Richard Prawdzienski,IND,450029,0,0,7,7,
Mccurtain,Lieutenant Governor,Cathy Cummings,DEM,450029,0,3,33,36,
Mccurtain,Lieutenant Governor,Todd Lamb,REP,450029,2,4,125,131,
Mccurtain,Superintendent of Public Instruction,John Cox,DEM,450029,0,3,84,87,
Mccurtain,Superintendent of Public Instruction,Joy Hofmeister,REP,450029,1,4,75,80,
Mccurtain,Commissioner of Labor,Mike Workman,DEM,450029,1,3,53,57,
Mccurtain,Commissioner of Labor,Mark Costello,REP,450029,1,4,102,107,
Mccurtain,U.S. Senate,Matt Silverstein,DEM,450029,0,3,24,27,
Mccurtain,U.S. Senate,Jim Inhofe,REP,450029,2,5,125,132,
Mccurtain,U.S. Senate,Aaron Delozier,IND,450029,0,0,1,1,
Mccurtain,U.S. Senate,Ray Woods,IND,450029,0,0,8,8,
Mccurtain,U.S. Senate,Joan Farr,IND,450029,0,0,3,3,
Mccurtain,U.S. Senate,Connie Johnson,DEM,450029,0,3,27,30,
Mccurtain,U.S. Senate,James Lankford,REP,450029,2,3,122,127,
Mccurtain,U.S. Senate,Mark Beard,IND,450029,0,1,10,11,
Mccurtain,U.S. House,Earl Everett,DEM,450029,0,2,30,32,02
Mccurtain,U.S. House,Markwayne Mullin,REP,450029,2,5,126,133,02
Mccurtain,U.S. House,Jon Douthitt,IND,450029,0,0,4,4,02
Mccurtain,State Senate,Curtis Mcdaniel,DEM,450029,2,5,48,55,5
Mccurtain,State Senate,Joseph Silk,REP,450029,0,3,117,120,5
Mccurtain,State House,Johnny Tadlock,DEM,450029,1,5,84,90,1
Mccurtain,State House,J. Longacre,REP,450029,1,3,81,85,1
Mccurtain,Governor,Joe Dorman,DEM,450031,3,9,131,143,
Mccurtain,Governor,Mary Fallin,REP,450031,2,23,208,233,
Mccurtain,Governor,Kimberly Willis,IND,450031,0,2,13,15,
Mccurtain,Governor,Richard Prawdzienski,IND,450031,0,1,10,11,
Mccurtain,Lieutenant Governor,Cathy Cummings,DEM,450031,2,3,90,95,
Mccurtain,Lieutenant Governor,Todd Lamb,REP,450031,3,32,265,300,
Mccurtain,Superintendent of Public Instruction,John Cox,DEM,450031,3,17,194,214,
Mccurtain,Superintendent of Public Instruction,Joy Hofmeister,REP,450031,2,18,162,182,
Mccurtain,Commissioner of Labor,Mike Workman,DEM,450031,1,5,110,116,
Mccurtain,Commissioner of Labor,Mark Costello,REP,450031,4,28,238,270,
Mccurtain,U.S. Senate,Matt Silverstein,DEM,450031,2,1,56,59,
Mccurtain,U.S. Senate,Jim Inhofe,REP,450031,3,29,290,322,
Mccurtain,U.S. Senate,Aaron Delozier,IND,450031,0,1,4,5,
Mccurtain,U.S. Senate,Ray Woods,IND,450031,0,1,1,2,
Mccurtain,U.S. Senate,Joan Farr,IND,450031,0,3,6,9,
Mccurtain,U.S. Senate,Connie Johnson,DEM,450031,1,3,69,73,
Mccurtain,U.S. Senate,James Lankford,REP,450031,4,30,261,295,
Mccurtain,U.S. Senate,Mark Beard,IND,450031,0,2,18,20,
Mccurtain,U.S. House,Earl Everett,DEM,450031,1,2,63,66,02
Mccurtain,U.S. House,Markwayne Mullin,REP,450031,4,31,284,319,02
Mccurtain,U.S. House,Jon Douthitt,IND,450031,0,2,4,6,02
Mccurtain,State Senate,Curtis Mcdaniel,DEM,450031,3,11,127,141,5
Mccurtain,State Senate,Joseph Silk,REP,450031,2,24,231,257,5
Mccurtain,State House,Johnny Tadlock,DEM,450031,3,12,177,192,1
Mccurtain,State House,J. Longacre,REP,450031,2,22,181,205,1
Mccurtain,Governor,Joe Dorman,DEM,450033,5,17,118,140,
Mccurtain,Governor,Mary Fallin,REP,450033,0,4,75,79,
Mccurtain,Governor,Kimberly Willis,IND,450033,0,1,4,5,
Mccurtain,Governor,Richard Prawdzienski,IND,450033,0,0,4,4,
Mccurtain,Lieutenant Governor,Cathy Cummings,DEM,450033,4,10,74,88,
Mccurtain,Lieutenant Governor,Todd Lamb,REP,450033,1,12,119,132,
Mccurtain,Superintendent of Public Instruction,John Cox,DEM,450033,5,16,130,151,
Mccurtain,Superintendent of Public Instruction,Joy Hofmeister,REP,450033,0,7,63,70,
Mccurtain,Commissioner of Labor,Mike Workman,DEM,450033,5,11,98,114,
Mccurtain,Commissioner of Labor,Mark Costello,REP,450033,0,11,91,102,
Mccurtain,U.S. Senate,Matt Silverstein,DEM,450033,4,8,42,54,
Mccurtain,U.S. Senate,Jim Inhofe,REP,450033,1,10,144,155,
Mccurtain,U.S. Senate,Aaron Delozier,IND,450033,0,0,3,3,
Mccurtain,U.S. Senate,Ray Woods,IND,450033,0,1,3,4,
Mccurtain,U.S. Senate,Joan Farr,IND,450033,0,3,4,7,
Mccurtain,U.S. Senate,Connie Johnson,DEM,450033,4,8,56,68,
Mccurtain,U.S. Senate,James Lankford,REP,450033,1,11,129,141,
Mccurtain,U.S. Senate,Mark Beard,IND,450033,0,3,8,11,
Mccurtain,U.S. House,Earl Everett,DEM,450033,4,6,49,59,02
Mccurtain,U.S. House,Markwayne Mullin,REP,450033,1,13,135,149,02
Mccurtain,U.S. House,Jon Douthitt,IND,450033,0,2,9,11,02
Mccurtain,State Senate,Curtis Mcdaniel,DEM,450033,5,14,128,147,5
Mccurtain,State Senate,Joseph Silk,REP,450033,0,8,71,79,5
Mccurtain,State House,Johnny Tadlock,DEM,450033,5,15,124,144,1
Mccurtain,State House,J. Longacre,REP,450033,0,8,76,84,1
Mccurtain,Governor,Joe Dorman,DEM,450034,0,6,83,89,
Mccurtain,Governor,Mary Fallin,REP,450034,0,2,111,113,
Mccurtain,Governor,Kimberly Willis,IND,450034,0,0,13,13,
Mccurtain,Governor,Richard Prawdzienski,IND,450034,0,1,6,7,
Mccurtain,Lieutenant Governor,Cathy Cummings,DEM,450034,0,5,63,68,
Mccurtain,Lieutenant Governor,Todd Lamb,REP,450034,0,3,145,148,
Mccurtain,Superintendent of Public Instruction,John Cox,DEM,450034,0,6,94,100,
Mccurtain,Superintendent of Public Instruction,Joy Hofmeister,REP,450034,0,3,113,116,
Mccurtain,Commissioner of Labor,Mike Workman,DEM,450034,0,6,68,74,
Mccurtain,Commissioner of Labor,Mark Costello,REP,450034,0,2,134,136,
Mccurtain,U.S. Senate,Matt Silverstein,DEM,450034,0,1,36,37,
Mccurtain,U.S. Senate,Jim Inhofe,REP,450034,0,7,154,161,
Mccurtain,U.S. Senate,Aaron Delozier,IND,450034,0,1,12,13,
Mccurtain,U.S. Senate,Ray Woods,IND,450034,0,0,6,6,
Mccurtain,U.S. Senate,Joan Farr,IND,450034,0,0,3,3,
Mccurtain,U.S. Senate,Connie Johnson,DEM,450034,0,3,41,44,
Mccurtain,U.S. Senate,James Lankford,REP,450034,0,4,148,152,
Mccurtain,U.S. Senate,Mark Beard,IND,450034,0,0,22,22,
Mccurtain,U.S. House,Earl Everett,DEM,450034,0,2,37,39,02
Mccurtain,U.S. House,Markwayne Mullin,REP,450034,0,6,157,163,02
Mccurtain,U.S. House,Jon Douthitt,IND,450034,0,1,14,15,02
Mccurtain,State Senate,Curtis Mcdaniel,DEM,450034,0,6,78,84,5
Mccurtain,State Senate,Joseph Silk,REP,450034,0,3,139,142,5
Mccurtain,State House,Johnny Tadlock,DEM,450034,0,5,112,117,1
Mccurtain,State House,J. Longacre,REP,450034,0,4,103,107,1
Mccurtain,Governor,Joe Dorman,DEM,450035,0,7,152,159,
Mccurtain,Governor,Mary Fallin,REP,450035,0,3,187,190,
Mccurtain,Governor,Kimberly Willis,IND,450035,0,0,15,15,
Mccurtain,Governor,Richard Prawdzienski,IND,450035,0,0,18,18,
Mccurtain,Lieutenant Governor,Cathy Cummings,DEM,450035,0,5,114,119,
Mccurtain,Lieutenant Governor,Todd Lamb,REP,450035,0,4,254,258,
Mccurtain,Superintendent of Public Instruction,John Cox,DEM,450035,0,5,209,214,
Mccurtain,Superintendent of Public Instruction,Joy Hofmeister,REP,450035,0,4,160,164,
Mccurtain,Commissioner of Labor,Mike Workman,DEM,450035,0,5,143,148,
Mccurtain,Commissioner of Labor,Mark Costello,REP,450035,0,4,218,222,
Mccurtain,U.S. Senate,Matt Silverstein,DEM,450035,0,4,99,103,
Mccurtain,U.S. Senate,Jim Inhofe,REP,450035,0,6,259,265,
Mccurtain,U.S. Senate,Aaron Delozier,IND,450035,0,0,4,4,
Mccurtain,U.S. Senate,Ray Woods,IND,450035,0,0,4,4,
Mccurtain,U.S. Senate,Joan Farr,IND,450035,0,0,6,6,
Mccurtain,U.S. Senate,Connie Johnson,DEM,450035,0,7,107,114,
Mccurtain,U.S. Senate,James Lankford,REP,450035,0,2,237,239,
Mccurtain,U.S. Senate,Mark Beard,IND,450035,0,1,26,27,
Mccurtain,U.S. House,Earl Everett,DEM,450035,0,3,84,87,02
Mccurtain,U.S. House,Markwayne Mullin,REP,450035,0,7,274,281,02
Mccurtain,U.S. House,Jon Douthitt,IND,450035,0,0,11,11,02
Mccurtain,State Senate,Curtis Mcdaniel,DEM,450035,0,6,165,171,5
Mccurtain,State Senate,Joseph Silk,REP,450035,0,4,212,216,5
Mccurtain,State House,Johnny Tadlock,DEM,450035,0,6,210,216,1
Mccurtain,State House,J. Longacre,REP,450035,0,4,165,169,1
Mccurtain,Governor,Joe Dorman,DEM,450036,2,5,95,102,
Mccurtain,Governor,Mary Fallin,REP,450036,2,4,163,169,
Mccurtain,Governor,Kimberly Willis,IND,450036,0,1,7,8,
Mccurtain,Governor,Richard Prawdzienski,IND,450036,0,0,6,6,
Mccurtain,Lieutenant Governor,Cathy Cummings,DEM,450036,1,5,71,77,
Mccurtain,Lieutenant Governor,Todd Lamb,REP,450036,3,5,194,202,
Mccurtain,Superintendent of Public Instruction,John Cox,DEM,450036,1,6,133,140,
Mccurtain,Superintendent of Public Instruction,Joy Hofmeister,REP,450036,3,4,132,139,
Mccurtain,Commissioner of Labor,Mike Workman,DEM,450036,1,5,86,92,
Mccurtain,Commissioner of Labor,Mark Costello,REP,450036,2,5,175,182,
Mccurtain,U.S. Senate,Matt Silverstein,DEM,450036,1,4,57,62,
Mccurtain,U.S. Senate,Jim Inhofe,REP,450036,3,4,203,210,
Mccurtain,U.S. Senate,Aaron Delozier,IND,450036,0,1,5,6,
Mccurtain,U.S. Senate,Ray Woods,IND,450036,0,1,1,2,
Mccurtain,U.S. Senate,Joan Farr,IND,450036,0,0,2,2,
Mccurtain,U.S. Senate,Connie Johnson,DEM,450036,0,5,58,63,
Mccurtain,U.S. Senate,James Lankford,REP,450036,4,5,191,200,
Mccurtain,U.S. Senate,Mark Beard,IND,450036,0,0,18,18,
Mccurtain,U.S. House,Earl Everett,DEM,450036,1,5,43,49,02
Mccurtain,U.S. House,Markwayne Mullin,REP,450036,3,5,214,222,02
Mccurtain,U.S. House,Jon Douthitt,IND,450036,0,0,13,13,02
Mccurtain,State Senate,Curtis Mcdaniel,DEM,450036,1,4,85,90,5
Mccurtain,State Senate,Joseph Silk,REP,450036,3,6,191,200,5
Mccurtain,State House,Johnny Tadlock,DEM,450036,1,4,123,128,1
Mccurtain,State House,J. Longacre,REP,450036,3,6,155,164,1
Mccurtain,Governor,Joe Dorman,DEM,450037,2,0,32,34,
Mccurtain,Governor,Mary Fallin,REP,450037,1,0,38,39,
Mccurtain,Governor,Kimberly Willis,IND,450037,0,0,2,2,
Mccurtain,Governor,Richard Prawdzienski,IND,450037,0,0,1,1,
Mccurtain,Lieutenant Governor,Cathy Cummings,DEM,450037,1,0,25,26,
Mccurtain,Lieutenant Governor,Todd Lamb,REP,450037,2,0,47,49,
Mccurtain,Superintendent of Public Instruction,John Cox,DEM,450037,1,0,43,44,
Mccurtain,Superintendent of Public Instruction,Joy Hofmeister,REP,450037,2,0,29,31,
Mccurtain,Commissioner of Labor,Mike Workman,DEM,450037,1,0,34,35,
Mccurtain,Commissioner of Labor,Mark Costello,REP,450037,2,0,37,39,
Mccurtain,U.S. Senate,Matt Silverstein,DEM,450037,1,0,22,23,
Mccurtain,U.S. Senate,Jim Inhofe,REP,450037,2,0,47,49,
Mccurtain,U.S. Senate,Aaron Delozier,IND,450037,0,0,0,0,
Mccurtain,U.S. Senate,Ray Woods,IND,450037,0,0,1,1,
Mccurtain,U.S. Senate,Joan Farr,IND,450037,0,0,3,3,
Mccurtain,U.S. Senate,Connie Johnson,DEM,450037,1,0,20,21,
Mccurtain,U.S. Senate,James Lankford,REP,450037,2,0,48,50,
Mccurtain,U.S. Senate,Mark Beard,IND,450037,0,0,5,5,
Mccurtain,U.S. House,Earl Everett,DEM,450037,0,0,18,18,02
Mccurtain,U.S. House,Markwayne Mullin,REP,450037,2,0,50,52,02
Mccurtain,U.S. House,Jon Douthitt,IND,450037,1,0,4,5,02
Mccurtain,State Senate,Curtis Mcdaniel,DEM,450037,1,0,33,34,5
Mccurtain,State Senate,Joseph Silk,REP,450037,2,0,37,39,5
Mccurtain,State House,Johnny Tadlock,DEM,450037,2,0,37,39,1
Mccurtain,State House,J. Longacre,REP,450037,1,0,36,37,1
Mccurtain,Governor,Joe Dorman,DEM,450038,2,3,186,191,
Mccurtain,Governor,Mary Fallin,REP,450038,3,5,133,141,
Mccurtain,Governor,Kimberly Willis,IND,450038,0,0,14,14,
Mccurtain,Governor,Richard Prawdzienski,IND,450038,0,0,3,3,
Mccurtain,Lieutenant Governor,Cathy Cummings,DEM,450038,3,1,128,132,
Mccurtain,Lieutenant Governor,Todd Lamb,REP,450038,2,7,196,205,
Mccurtain,Superintendent of Public Instruction,John Cox,DEM,450038,2,5,204,211,
Mccurtain,Superintendent of Public Instruction,Joy Hofmeister,REP,450038,3,3,125,131,
Mccurtain,Commissioner of Labor,Mike Workman,DEM,450038,3,4,155,162,
Mccurtain,Commissioner of Labor,Mark Costello,REP,450038,2,4,164,170,
Mccurtain,U.S. Senate,Matt Silverstein,DEM,450038,2,1,85,88,
Mccurtain,U.S. Senate,Jim Inhofe,REP,450038,3,6,230,239,
Mccurtain,U.S. Senate,Aaron Delozier,IND,450038,0,0,10,10,
Mccurtain,U.S. Senate,Ray Woods,IND,450038,0,0,3,3,
Mccurtain,U.S. Senate,Joan Farr,IND,450038,0,0,6,6,
Mccurtain,U.S. Senate,Connie Johnson,DEM,450038,3,2,101,106,
Mccurtain,U.S. Senate,James Lankford,REP,450038,2,5,200,207,
Mccurtain,U.S. Senate,Mark Beard,IND,450038,0,0,28,28,
Mccurtain,U.S. House,Earl Everett,DEM,450038,1,1,89,91,02
Mccurtain,U.S. House,Markwayne Mullin,REP,450038,4,6,225,235,02
Mccurtain,U.S. House,Jon Douthitt,IND,450038,0,0,11,11,02
Mccurtain,State Senate,Curtis Mcdaniel,DEM,450038,0,3,141,144,5
Mccurtain,State Senate,Joseph Silk,REP,450038,5,5,203,213,5
Mccurtain,State House,Johnny Tadlock,DEM,450038,3,8,179,190,1
Mccurtain,State House,J. Longacre,REP,450038,2,0,166,168,1
Mcintosh,Governor,Joe Dorman,DEM,460102,12,3,194,209,
Mcintosh,Governor,Mary Fallin,REP,460102,7,1,190,198,
Mcintosh,Governor,Kimberly Willis,IND,460102,0,0,9,9,
Mcintosh,Governor,Richard Prawdzienski,IND,460102,0,0,2,2,
Mcintosh,Lieutenant Governor,Cathy Cummings,DEM,460102,12,2,147,161,
Mcintosh,Lieutenant Governor,Todd Lamb,REP,460102,7,2,249,258,
Mcintosh,Superintendent of Public Instruction,John Cox,DEM,460102,15,3,232,250,
Mcintosh,Superintendent of Public Instruction,Joy Hofmeister,REP,460102,4,1,164,169,
Mcintosh,Commissioner of Labor,Mike Workman,DEM,460102,14,3,195,212,
Mcintosh,Commissioner of Labor,Mark Costello,REP,460102,5,1,193,199,
Mcintosh,U.S. Senate,Matt Silverstein,DEM,460102,10,2,141,153,
Mcintosh,U.S. Senate,Jim Inhofe,REP,460102,9,2,241,252,
Mcintosh,U.S. Senate,Aaron Delozier,IND,460102,0,0,2,2,
Mcintosh,U.S. Senate,Ray Woods,IND,460102,0,0,5,5,
Mcintosh,U.S. Senate,Joan Farr,IND,460102,0,0,3,3,
Mcintosh,U.S. Senate,Connie Johnson,DEM,460102,14,2,148,164,
Mcintosh,U.S. Senate,James Lankford,REP,460102,4,2,239,245,
Mcintosh,U.S. Senate,Mark Beard,IND,460102,1,0,9,10,
Mcintosh,U.S. House,Earl Everett,DEM,460102,12,2,121,135,02
Mcintosh,U.S. House,Markwayne Mullin,REP,460102,7,2,250,259,02
Mcintosh,U.S. House,Jon Douthitt,IND,460102,0,0,24,24,02
Mcintosh,State Senate,Selina Jayne-Dornan,DEM,460102,15,3,196,214,8
Mcintosh,State Senate,Roger Thompson,REP,460102,4,1,196,201,8
Mcintosh,Governor,Joe Dorman,DEM,460103,3,7,327,337,
Mcintosh,Governor,Mary Fallin,REP,460103,2,7,325,334,
Mcintosh,Governor,Kimberly Willis,IND,460103,0,1,16,17,
Mcintosh,Governor,Richard Prawdzienski,IND,460103,0,0,6,6,
Mcintosh,Lieutenant Governor,Cathy Cummings,DEM,460103,2,6,244,252,
Mcintosh,Lieutenant Governor,Todd Lamb,REP,460103,3,9,424,436,
Mcintosh,Superintendent of Public Instruction,John Cox,DEM,460103,2,10,392,404,
Mcintosh,Superintendent of Public Instruction,Joy Hofmeister,REP,460103,3,5,279,287,
Mcintosh,Commissioner of Labor,Mike Workman,DEM,460103,2,10,335,347,
Mcintosh,Commissioner of Labor,Mark Costello,REP,460103,3,5,318,326,
Mcintosh,U.S. Senate,Matt Silverstein,DEM,460103,2,6,220,228,
Mcintosh,U.S. Senate,Jim Inhofe,REP,460103,3,8,433,444,
Mcintosh,U.S. Senate,Aaron Delozier,IND,460103,0,0,6,6,
Mcintosh,U.S. Senate,Ray Woods,IND,460103,0,1,4,5,
Mcintosh,U.S. Senate,Joan Farr,IND,460103,0,0,9,9,
Mcintosh,U.S. Senate,Connie Johnson,DEM,460103,1,7,230,238,
Mcintosh,U.S. Senate,James Lankford,REP,460103,3,7,416,426,
Mcintosh,U.S. Senate,Mark Beard,IND,460103,0,1,22,23,
Mcintosh,U.S. House,Earl Everett,DEM,460103,1,4,178,183,02
Mcintosh,U.S. House,Markwayne Mullin,REP,460103,3,8,457,468,02
Mcintosh,U.S. House,Jon Douthitt,IND,460103,1,3,35,39,02
Mcintosh,State Senate,Selina Jayne-Dornan,DEM,460103,4,10,290,304,8
Mcintosh,State Senate,Roger Thompson,REP,460103,1,5,382,388,8
Mcintosh,Governor,Joe Dorman,DEM,460104,3,10,167,180,
Mcintosh,Governor,Mary Fallin,REP,460104,2,2,158,162,
Mcintosh,Governor,Kimberly Willis,IND,460104,0,1,5,6,
Mcintosh,Governor,Richard Prawdzienski,IND,460104,0,0,0,0,
Mcintosh,Lieutenant Governor,Cathy Cummings,DEM,460104,3,8,116,127,
Mcintosh,Lieutenant Governor,Todd Lamb,REP,460104,2,5,212,219,
Mcintosh,Superintendent of Public Instruction,John Cox,DEM,460104,3,10,194,207,
Mcintosh,Superintendent of Public Instruction,Joy Hofmeister,REP,460104,2,3,136,141,
Mcintosh,Commissioner of Labor,Mike Workman,DEM,460104,3,7,174,184,
Mcintosh,Commissioner of Labor,Mark Costello,REP,460104,2,6,150,158,
Mcintosh,U.S. Senate,Matt Silverstein,DEM,460104,1,7,115,123,
Mcintosh,U.S. Senate,Jim Inhofe,REP,460104,4,5,210,219,
Mcintosh,U.S. Senate,Aaron Delozier,IND,460104,0,0,2,2,
Mcintosh,U.S. Senate,Ray Woods,IND,460104,0,1,2,3,
Mcintosh,U.S. Senate,Joan Farr,IND,460104,0,0,1,1,
Mcintosh,U.S. Senate,Connie Johnson,DEM,460104,2,5,112,119,
Mcintosh,U.S. Senate,James Lankford,REP,460104,3,8,207,218,
Mcintosh,U.S. Senate,Mark Beard,IND,460104,0,0,10,10,
Mcintosh,U.S. House,Earl Everett,DEM,460104,2,5,81,88,02
Mcintosh,U.S. House,Markwayne Mullin,REP,460104,3,6,228,237,02
Mcintosh,U.S. House,Jon Douthitt,IND,460104,0,2,21,23,02
Mcintosh,State Senate,Selina Jayne-Dornan,DEM,460104,2,5,139,146,8
Mcintosh,State Senate,Roger Thompson,REP,460104,3,8,189,200,8
Mcintosh,Governor,Joe Dorman,DEM,460201,6,29,297,332,
Mcintosh,Governor,Mary Fallin,REP,460201,2,28,271,301,
Mcintosh,Governor,Kimberly Willis,IND,460201,0,0,10,10,
Mcintosh,Governor,Richard Prawdzienski,IND,460201,0,0,5,5,
Mcintosh,Lieutenant Governor,Cathy Cummings,DEM,460201,6,26,225,257,
Mcintosh,Lieutenant Governor,Todd Lamb,REP,460201,2,31,353,386,
Mcintosh,Superintendent of Public Instruction,John Cox,DEM,460201,6,35,330,371,
Mcintosh,Superintendent of Public Instruction,Joy Hofmeister,REP,460201,2,22,248,272,
Mcintosh,Commissioner of Labor,Mike Workman,DEM,460201,6,31,287,324,
Mcintosh,Commissioner of Labor,Mark Costello,REP,460201,2,26,282,310,
Mcintosh,U.S. Senate,Matt Silverstein,DEM,460201,6,19,203,228,
Mcintosh,U.S. Senate,Jim Inhofe,REP,460201,2,37,351,390,
Mcintosh,U.S. Senate,Aaron Delozier,IND,460201,0,0,9,9,
Mcintosh,U.S. Senate,Ray Woods,IND,460201,0,1,6,7,
Mcintosh,U.S. Senate,Joan Farr,IND,460201,0,0,14,14,
Mcintosh,U.S. Senate,Connie Johnson,DEM,460201,6,20,222,248,
Mcintosh,U.S. Senate,James Lankford,REP,460201,2,37,346,385,
Mcintosh,U.S. Senate,Mark Beard,IND,460201,0,0,15,15,
Mcintosh,U.S. House,Earl Everett,DEM,460201,6,16,171,193,02
Mcintosh,U.S. House,Markwayne Mullin,REP,460201,2,38,382,422,02
Mcintosh,U.S. House,Jon Douthitt,IND,460201,0,3,29,32,02
Mcintosh,State Senate,Selina Jayne-Dornan,DEM,460201,6,29,260,295,8
Mcintosh,State Senate,Roger Thompson,REP,460201,2,28,321,351,8
Mcintosh,Governor,Joe Dorman,DEM,460203,6,7,121,134,
Mcintosh,Governor,Mary Fallin,REP,460203,2,15,100,117,
Mcintosh,Governor,Kimberly Willis,IND,460203,0,1,7,8,
Mcintosh,Governor,Richard Prawdzienski,IND,460203,0,0,6,6,
Mcintosh,Lieutenant Governor,Cathy Cummings,DEM,460203,6,4,109,119,
Mcintosh,Lieutenant Governor,Todd Lamb,REP,460203,2,19,122,143,
Mcintosh,Superintendent of Public Instruction,John Cox,DEM,460203,5,6,138,149,
Mcintosh,Superintendent of Public Instruction,Joy Hofmeister,REP,460203,3,17,95,115,
Mcintosh,Commissioner of Labor,Mike Workman,DEM,460203,6,6,136,148,
Mcintosh,Commissioner of Labor,Mark Costello,REP,460203,2,16,92,110,
Mcintosh,U.S. Senate,Matt Silverstein,DEM,460203,5,6,100,111,
Mcintosh,U.S. Senate,Jim Inhofe,REP,460203,2,17,124,143,
Mcintosh,U.S. Senate,Aaron Delozier,IND,460203,0,0,1,1,
Mcintosh,U.S. Senate,Ray Woods,IND,460203,0,0,5,5,
Mcintosh,U.S. Senate,Joan Farr,IND,460203,1,0,3,4,
Mcintosh,U.S. Senate,Connie Johnson,DEM,460203,4,4,91,99,
Mcintosh,U.S. Senate,James Lankford,REP,460203,2,18,130,150,
Mcintosh,U.S. Senate,Mark Beard,IND,460203,2,1,11,14,
Mcintosh,U.S. House,Earl Everett,DEM,460203,4,3,90,97,02
Mcintosh,U.S. House,Markwayne Mullin,REP,460203,3,20,128,151,02
Mcintosh,U.S. House,Jon Douthitt,IND,460203,1,0,12,13,02
Mcintosh,State Senate,Selina Jayne-Dornan,DEM,460203,7,4,106,117,8
Mcintosh,State Senate,Roger Thompson,REP,460203,1,19,129,149,8
Mcintosh,Governor,Joe Dorman,DEM,460205,7,17,200,224,
Mcintosh,Governor,Mary Fallin,REP,460205,18,19,419,456,
Mcintosh,Governor,Kimberly Willis,IND,460205,0,0,24,24,
Mcintosh,Governor,Richard Prawdzienski,IND,460205,0,0,6,6,
Mcintosh,Lieutenant Governor,Cathy Cummings,DEM,460205,7,11,185,203,
Mcintosh,Lieutenant Governor,Todd Lamb,REP,460205,17,25,461,503,
Mcintosh,Superintendent of Public Instruction,John Cox,DEM,460205,8,16,228,252,
Mcintosh,Superintendent of Public Instruction,Joy Hofmeister,REP,460205,17,19,418,454,
Mcintosh,Commissioner of Labor,Mike Workman,DEM,460205,7,15,236,258,
Mcintosh,Commissioner of Labor,Mark Costello,REP,460205,18,20,401,439,
Mcintosh,U.S. Senate,Matt Silverstein,DEM,460205,6,14,161,181,
Mcintosh,U.S. Senate,Jim Inhofe,REP,460205,19,22,465,506,
Mcintosh,U.S. Senate,Aaron Delozier,IND,460205,0,0,5,5,
Mcintosh,U.S. Senate,Ray Woods,IND,460205,0,0,8,8,
Mcintosh,U.S. Senate,Joan Farr,IND,460205,0,0,9,9,
Mcintosh,U.S. Senate,Connie Johnson,DEM,460205,7,11,163,181,
Mcintosh,U.S. Senate,James Lankford,REP,460205,18,25,453,496,
Mcintosh,U.S. Senate,Mark Beard,IND,460205,0,0,28,28,
Mcintosh,U.S. House,Earl Everett,DEM,460205,6,12,159,177,02
Mcintosh,U.S. House,Markwayne Mullin,REP,460205,19,24,458,501,02
Mcintosh,U.S. House,Jon Douthitt,IND,460205,0,0,27,27,02
Mcintosh,State Senate,Selina Jayne-Dornan,DEM,460205,8,17,214,239,8
Mcintosh,State Senate,Roger Thompson,REP,460205,17,18,431,466,8
Mcintosh,Governor,Joe Dorman,DEM,460307,0,10,129,139,
Mcintosh,Governor,Mary Fallin,REP,460307,6,5,144,155,
Mcintosh,Governor,Kimberly Willis,IND,460307,0,0,5,5,
Mcintosh,Governor,Richard Prawdzienski,IND,460307,0,0,4,4,
Mcintosh,Lieutenant Governor,Cathy Cummings,DEM,460307,1,8,100,109,
Mcintosh,Lieutenant Governor,Todd Lamb,REP,460307,5,7,181,193,
Mcintosh,Superintendent of Public Instruction,John Cox,DEM,460307,2,11,162,175,
Mcintosh,Superintendent of Public Instruction,Joy Hofmeister,REP,460307,3,4,116,123,
Mcintosh,Commissioner of Labor,Mike Workman,DEM,460307,3,9,139,151,
Mcintosh,Commissioner of Labor,Mark Costello,REP,460307,3,6,131,140,
Mcintosh,U.S. Senate,Matt Silverstein,DEM,460307,3,7,94,104,
Mcintosh,U.S. Senate,Jim Inhofe,REP,460307,3,8,179,190,
Mcintosh,U.S. Senate,Aaron Delozier,IND,460307,0,0,2,2,
Mcintosh,U.S. Senate,Ray Woods,IND,460307,0,0,4,4,
Mcintosh,U.S. Senate,Joan Farr,IND,460307,0,0,2,2,
Mcintosh,U.S. Senate,Connie Johnson,DEM,460307,0,9,90,99,
Mcintosh,U.S. Senate,James Lankford,REP,460307,6,6,181,193,
Mcintosh,U.S. Senate,Mark Beard,IND,460307,0,0,11,11,
Mcintosh,U.S. House,Earl Everett,DEM,460307,0,8,77,85,02
Mcintosh,U.S. House,Markwayne Mullin,REP,460307,6,7,194,207,02
Mcintosh,U.S. House,Jon Douthitt,IND,460307,0,0,11,11,02
Mcintosh,State Senate,Selina Jayne-Dornan,DEM,460307,2,6,120,128,8
Mcintosh,State Senate,Roger Thompson,REP,460307,4,9,162,175,8
Mcintosh,Governor,Joe Dorman,DEM,460310,0,0,58,58,
Mcintosh,Governor,Mary Fallin,REP,460310,0,1,49,50,
Mcintosh,Governor,Kimberly Willis,IND,460310,0,0,2,2,
Mcintosh,Governor,Richard Prawdzienski,IND,460310,0,0,2,2,
Mcintosh,Lieutenant Governor,Cathy Cummings,DEM,460310,0,0,45,45,
Mcintosh,Lieutenant Governor,Todd Lamb,REP,460310,0,1,65,66,
Mcintosh,Superintendent of Public Instruction,John Cox,DEM,460310,0,0,71,71,
Mcintosh,Superintendent of Public Instruction,Joy Hofmeister,REP,460310,0,1,39,40,
Mcintosh,Commissioner of Labor,Mike Workman,DEM,460310,0,0,53,53,
Mcintosh,Commissioner of Labor,Mark Costello,REP,460310,0,1,53,54,
Mcintosh,U.S. Senate,Matt Silverstein,DEM,460310,0,0,35,35,
Mcintosh,U.S. Senate,Jim Inhofe,REP,460310,0,1,72,73,
Mcintosh,U.S. Senate,Aaron Delozier,IND,460310,0,0,1,1,
Mcintosh,U.S. Senate,Ray Woods,IND,460310,0,0,0,0,
Mcintosh,U.S. Senate,Joan Farr,IND,460310,0,0,4,4,
Mcintosh,U.S. Senate,Connie Johnson,DEM,460310,0,0,37,37,
Mcintosh,U.S. Senate,James Lankford,REP,460310,0,1,69,70,
Mcintosh,U.S. Senate,Mark Beard,IND,460310,0,0,2,2,
Mcintosh,U.S. House,Earl Everett,DEM,460310,0,0,32,32,02
Mcintosh,U.S. House,Markwayne Mullin,REP,460310,0,1,72,73,02
Mcintosh,U.S. House,Jon Douthitt,IND,460310,0,0,5,5,02
Mcintosh,State Senate,Selina Jayne-Dornan,DEM,460310,0,0,60,60,8
Mcintosh,State Senate,Roger Thompson,REP,460310,0,1,54,55,8
Mcintosh,Governor,Joe Dorman,DEM,460311,2,5,80,87,
Mcintosh,Governor,Mary Fallin,REP,460311,3,2,69,74,
Mcintosh,Governor,Kimberly Willis,IND,460311,0,0,4,4,
Mcintosh,Governor,Richard Prawdzienski,IND,460311,0,0,2,2,
Mcintosh,Lieutenant Governor,Cathy Cummings,DEM,460311,1,4,64,69,
Mcintosh,Lieutenant Governor,Todd Lamb,REP,460311,4,3,90,97,
Mcintosh,Superintendent of Public Instruction,John Cox,DEM,460311,2,5,97,104,
Mcintosh,Superintendent of Public Instruction,Joy Hofmeister,REP,460311,3,2,55,60,
Mcintosh,Commissioner of Labor,Mike Workman,DEM,460311,2,5,85,92,
Mcintosh,Commissioner of Labor,Mark Costello,REP,460311,3,2,67,72,
Mcintosh,U.S. Senate,Matt Silverstein,DEM,460311,2,5,67,74,
Mcintosh,U.S. Senate,Jim Inhofe,REP,460311,3,2,84,89,
Mcintosh,U.S. Senate,Aaron Delozier,IND,460311,0,0,0,0,
Mcintosh,U.S. Senate,Ray Woods,IND,460311,0,0,3,3,
Mcintosh,U.S. Senate,Joan Farr,IND,460311,0,0,2,2,
Mcintosh,U.S. Senate,Connie Johnson,DEM,460311,2,4,57,63,
Mcintosh,U.S. Senate,James Lankford,REP,460311,3,3,92,98,
Mcintosh,U.S. Senate,Mark Beard,IND,460311,0,0,6,6,
Mcintosh,U.S. House,Earl Everett,DEM,460311,1,5,46,52,02
Mcintosh,U.S. House,Markwayne Mullin,REP,460311,4,2,101,107,02
Mcintosh,U.S. House,Jon Douthitt,IND,460311,0,0,8,8,02
Mcintosh,State Senate,Selina Jayne-Dornan,DEM,460311,3,5,71,79,8
Mcintosh,State Senate,Roger Thompson,REP,460311,2,2,84,88,8
Mcintosh,Governor,Joe Dorman,DEM,460312,0,0,21,21,
Mcintosh,Governor,Mary Fallin,REP,460312,0,0,38,38,
Mcintosh,Governor,Kimberly Willis,IND,460312,0,0,1,1,
Mcintosh,Governor,Richard Prawdzienski,IND,460312,0,0,0,0,
Mcintosh,Lieutenant Governor,Cathy Cummings,DEM,460312,0,0,22,22,
Mcintosh,Lieutenant Governor,Todd Lamb,REP,460312,0,0,38,38,
Mcintosh,Superintendent of Public Instruction,John Cox,DEM,460312,0,0,30,30,
Mcintosh,Superintendent of Public Instruction,Joy Hofmeister,REP,460312,0,0,30,30,
Mcintosh,Commissioner of Labor,Mike Workman,DEM,460312,0,0,27,27,
Mcintosh,Commissioner of Labor,Mark Costello,REP,460312,0,0,33,33,
Mcintosh,U.S. Senate,Matt Silverstein,DEM,460312,0,0,19,19,
Mcintosh,U.S. Senate,Jim Inhofe,REP,460312,0,0,41,41,
Mcintosh,U.S. Senate,Aaron Delozier,IND,460312,0,0,0,0,
Mcintosh,U.S. Senate,Ray Woods,IND,460312,0,0,0,0,
Mcintosh,U.S. Senate,Joan Farr,IND,460312,0,0,0,0,
Mcintosh,U.S. Senate,Connie Johnson,DEM,460312,0,0,23,23,
Mcintosh,U.S. Senate,James Lankford,REP,460312,0,0,37,37,
Mcintosh,U.S. Senate,Mark Beard,IND,460312,0,0,0,0,
Mcintosh,U.S. House,Earl Everett,DEM,460312,0,0,18,18,02
Mcintosh,U.S. House,Markwayne Mullin,REP,460312,0,0,40,40,02
Mcintosh,U.S. House,Jon Douthitt,IND,460312,0,0,2,2,02
Mcintosh,State Senate,Selina Jayne-Dornan,DEM,460312,0,0,27,27,8
Mcintosh,State Senate,Roger Thompson,REP,460312,0,0,33,33,8
Mcintosh,Governor,Joe Dorman,DEM,460313,1,1,24,26,
Mcintosh,Governor,Mary Fallin,REP,460313,0,0,25,25,
Mcintosh,Governor,Kimberly Willis,IND,460313,0,0,1,1,
Mcintosh,Governor,Richard Prawdzienski,IND,460313,0,0,0,0,
Mcintosh,Lieutenant Governor,Cathy Cummings,DEM,460313,1,1,20,22,
Mcintosh,Lieutenant Governor,Todd Lamb,REP,460313,0,0,30,30,
Mcintosh,Superintendent of Public Instruction,John Cox,DEM,460313,1,1,29,31,
Mcintosh,Superintendent of Public Instruction,Joy Hofmeister,REP,460313,0,0,21,21,
Mcintosh,Commissioner of Labor,Mike Workman,DEM,460313,1,1,24,26,
Mcintosh,Commissioner of Labor,Mark Costello,REP,460313,0,0,26,26,
Mcintosh,U.S. Senate,Matt Silverstein,DEM,460313,1,1,18,20,
Mcintosh,U.S. Senate,Jim Inhofe,REP,460313,0,0,31,31,
Mcintosh,U.S. Senate,Aaron Delozier,IND,460313,0,0,0,0,
Mcintosh,U.S. Senate,Ray Woods,IND,460313,0,0,0,0,
Mcintosh,U.S. Senate,Joan Farr,IND,460313,0,0,1,1,
Mcintosh,U.S. Senate,Connie Johnson,DEM,460313,1,1,18,20,
Mcintosh,U.S. Senate,James Lankford,REP,460313,0,0,30,30,
Mcintosh,U.S. Senate,Mark Beard,IND,460313,0,0,2,2,
Mcintosh,U.S. House,Earl Everett,DEM,460313,1,1,17,19,02
Mcintosh,U.S. House,Markwayne Mullin,REP,460313,0,0,30,30,02
Mcintosh,U.S. House,Jon Douthitt,IND,460313,0,0,3,3,02
Mcintosh,State Senate,Selina Jayne-Dornan,DEM,460313,1,1,25,27,8
Mcintosh,State Senate,Roger Thompson,REP,460313,0,0,25,25,8
Mcintosh,Governor,Joe Dorman,DEM,460314,3,13,181,197,
Mcintosh,Governor,Mary Fallin,REP,460314,7,10,229,246,
Mcintosh,Governor,Kimberly Willis,IND,460314,0,0,10,10,
Mcintosh,Governor,Richard Prawdzienski,IND,460314,0,0,2,2,
Mcintosh,Lieutenant Governor,Cathy Cummings,DEM,460314,3,10,158,171,
Mcintosh,Lieutenant Governor,Todd Lamb,REP,460314,7,13,262,282,
Mcintosh,Superintendent of Public Instruction,John Cox,DEM,460314,4,12,206,222,
Mcintosh,Superintendent of Public Instruction,Joy Hofmeister,REP,460314,6,11,216,233,
Mcintosh,Commissioner of Labor,Mike Workman,DEM,460314,4,14,193,211,
Mcintosh,Commissioner of Labor,Mark Costello,REP,460314,6,9,221,236,
Mcintosh,U.S. Senate,Matt Silverstein,DEM,460314,3,11,142,156,
Mcintosh,U.S. Senate,Jim Inhofe,REP,460314,7,12,269,288,
Mcintosh,U.S. Senate,Aaron Delozier,IND,460314,0,0,0,0,
Mcintosh,U.S. Senate,Ray Woods,IND,460314,0,0,5,5,
Mcintosh,U.S. Senate,Joan Farr,IND,460314,0,0,6,6,
Mcintosh,U.S. Senate,Connie Johnson,DEM,460314,3,11,142,156,
Mcintosh,U.S. Senate,James Lankford,REP,460314,7,11,262,280,
Mcintosh,U.S. Senate,Mark Beard,IND,460314,0,1,14,15,
Mcintosh,U.S. House,Earl Everett,DEM,460314,3,9,111,123,02
Mcintosh,U.S. House,Markwayne Mullin,REP,460314,7,14,287,308,02
Mcintosh,U.S. House,Jon Douthitt,IND,460314,0,0,24,24,02
Mcintosh,State Senate,Selina Jayne-Dornan,DEM,460314,3,7,179,189,8
Mcintosh,State Senate,Roger Thompson,REP,460314,7,15,240,262,8
Mcintosh,Governor,Joe Dorman,DEM,460315,2,2,69,73,
Mcintosh,Governor,Mary Fallin,REP,460315,2,1,73,76,
Mcintosh,Governor,Kimberly Willis,IND,460315,0,0,4,4,
Mcintosh,Governor,Richard Prawdzienski,IND,460315,0,0,3,3,
Mcintosh,Lieutenant Governor,Cathy Cummings,DEM,460315,2,1,52,55,
Mcintosh,Lieutenant Governor,Todd Lamb,REP,460315,2,2,97,101,
Mcintosh,Superintendent of Public Instruction,John Cox,DEM,460315,2,1,87,90,
Mcintosh,Superintendent of Public Instruction,Joy Hofmeister,REP,460315,2,2,61,65,
Mcintosh,Commissioner of Labor,Mike Workman,DEM,460315,4,1,76,81,
Mcintosh,Commissioner of Labor,Mark Costello,REP,460315,0,2,72,74,
Mcintosh,U.S. Senate,Matt Silverstein,DEM,460315,2,2,48,52,
Mcintosh,U.S. Senate,Jim Inhofe,REP,460315,2,1,96,99,
Mcintosh,U.S. Senate,Aaron Delozier,IND,460315,0,0,0,0,
Mcintosh,U.S. Senate,Ray Woods,IND,460315,0,0,4,4,
Mcintosh,U.S. Senate,Joan Farr,IND,460315,0,0,1,1,
Mcintosh,U.S. Senate,Connie Johnson,DEM,460315,2,1,52,55,
Mcintosh,U.S. Senate,James Lankford,REP,460315,2,2,90,94,
Mcintosh,U.S. Senate,Mark Beard,IND,460315,0,0,6,6,
Mcintosh,U.S. House,Earl Everett,DEM,460315,4,1,39,44,02
Mcintosh,U.S. House,Markwayne Mullin,REP,460315,0,2,98,100,02
Mcintosh,U.S. House,Jon Douthitt,IND,460315,0,0,9,9,02
Mcintosh,State Senate,Selina Jayne-Dornan,DEM,460315,4,0,54,58,8
Mcintosh,State Senate,Roger Thompson,REP,460315,0,3,92,95,8
Mcintosh,Governor,Joe Dorman,DEM,460316,1,0,80,81,
Mcintosh,Governor,Mary Fallin,REP,460316,3,3,123,129,
Mcintosh,Governor,Kimberly Willis,IND,460316,0,0,6,6,
Mcintosh,Governor,Richard Prawdzienski,IND,460316,0,0,5,5,
Mcintosh,Lieutenant Governor,Cathy Cummings,DEM,460316,1,0,63,64,
Mcintosh,Lieutenant Governor,Todd Lamb,REP,460316,3,3,150,156,
Mcintosh,Superintendent of Public Instruction,John Cox,DEM,460316,2,1,110,113,
Mcintosh,Superintendent of Public Instruction,Joy Hofmeister,REP,460316,2,2,103,107,
Mcintosh,Commissioner of Labor,Mike Workman,DEM,460316,2,1,92,95,
Mcintosh,Commissioner of Labor,Mark Costello,REP,460316,2,2,117,121,
Mcintosh,U.S. Senate,Matt Silverstein,DEM,460316,1,0,62,63,
Mcintosh,U.S. Senate,Jim Inhofe,REP,460316,3,3,144,150,
Mcintosh,U.S. Senate,Aaron Delozier,IND,460316,0,0,3,3,
Mcintosh,U.S. Senate,Ray Woods,IND,460316,0,0,2,2,
Mcintosh,U.S. Senate,Joan Farr,IND,460316,0,0,2,2,
Mcintosh,U.S. Senate,Connie Johnson,DEM,460316,1,0,67,68,
Mcintosh,U.S. Senate,James Lankford,REP,460316,3,3,141,147,
Mcintosh,U.S. Senate,Mark Beard,IND,460316,0,0,5,5,
Mcintosh,U.S. House,Earl Everett,DEM,460316,0,0,51,51,02
Mcintosh,U.S. House,Markwayne Mullin,REP,460316,4,3,151,158,02
Mcintosh,U.S. House,Jon Douthitt,IND,460316,0,0,11,11,02
Mcintosh,State Senate,Selina Jayne-Dornan,DEM,460316,1,1,79,81,8
Mcintosh,State Senate,Roger Thompson,REP,460316,3,2,132,137,8
Major,Governor,Joe Dorman,DEM,470002,6,6,128,140,
Major,Governor,Mary Fallin,REP,470002,14,13,339,366,
Major,Governor,Kimberly Willis,IND,470002,0,0,10,10,
Major,Governor,Richard Prawdzienski,IND,470002,1,0,4,5,
Major,Lieutenant Governor,Cathy Cummings,DEM,470002,4,1,50,55,
Major,Lieutenant Governor,Todd Lamb,REP,470002,20,18,433,471,
Major,Superintendent of Public Instruction,John Cox,DEM,470002,9,8,133,150,
Major,Superintendent of Public Instruction,Joy Hofmeister,REP,470002,14,10,348,372,
Major,Commissioner of Labor,Mike Workman,DEM,470002,5,3,77,85,
Major,Commissioner of Labor,Mark Costello,REP,470002,18,15,399,432,
Major,U.S. Senate,Matt Silverstein,DEM,470002,4,2,42,48,
Major,U.S. Senate,Jim Inhofe,REP,470002,19,16,406,441,
Major,U.S. Senate,Aaron Delozier,IND,470002,0,0,4,4,
Major,U.S. Senate,Ray Woods,IND,470002,1,1,29,31,
Major,U.S. Senate,Joan Farr,IND,470002,0,0,1,1,
Major,U.S. Senate,Connie Johnson,DEM,470002,3,2,54,59,
Major,U.S. Senate,James Lankford,REP,470002,21,17,420,458,
Major,U.S. Senate,Mark Beard,IND,470002,0,0,9,9,
Major,U.S. House,Frankie Robbins,DEM,470002,2,2,62,66,03
Major,U.S. House,Frank Lucas,REP,470002,21,17,418,456,03
Major,Governor,Joe Dorman,DEM,470004,0,0,35,35,
Major,Governor,Mary Fallin,REP,470004,3,1,76,80,
Major,Governor,Kimberly Willis,IND,470004,0,0,2,2,
Major,Governor,Richard Prawdzienski,IND,470004,0,0,1,1,
Major,Lieutenant Governor,Cathy Cummings,DEM,470004,0,0,13,13,
Major,Lieutenant Governor,Todd Lamb,REP,470004,3,1,99,103,
Major,Superintendent of Public Instruction,John Cox,DEM,470004,0,0,31,31,
Major,Superintendent of Public Instruction,Joy Hofmeister,REP,470004,3,1,80,84,
Major,Commissioner of Labor,Mike Workman,DEM,470004,0,0,24,24,
Major,Commissioner of Labor,Mark Costello,REP,470004,3,1,85,89,
Major,U.S. Senate,Matt Silverstein,DEM,470004,0,0,10,10,
Major,U.S. Senate,Jim Inhofe,REP,470004,2,1,95,98,
Major,U.S. Senate,Aaron Delozier,IND,470004,1,0,0,1,
Major,U.S. Senate,Ray Woods,IND,470004,0,0,9,9,
Major,U.S. Senate,Joan Farr,IND,470004,0,0,0,0,
Major,U.S. Senate,Connie Johnson,DEM,470004,0,0,11,11,
Major,U.S. Senate,James Lankford,REP,470004,3,1,98,102,
Major,U.S. Senate,Mark Beard,IND,470004,0,0,2,2,
Major,U.S. House,Frankie Robbins,DEM,470004,0,0,10,10,03
Major,U.S. House,Frank Lucas,REP,470004,3,1,101,105,03
Major,Governor,Joe Dorman,DEM,470009,0,0,8,8,
Major,Governor,Mary Fallin,REP,470009,1,0,26,27,
Major,Governor,Kimberly Willis,IND,470009,0,0,0,0,
Major,Governor,Richard Prawdzienski,IND,470009,0,0,0,0,
Major,Lieutenant Governor,Cathy Cummings,DEM,470009,0,0,1,1,
Major,Lieutenant Governor,Todd Lamb,REP,470009,1,0,33,34,
Major,Superintendent of Public Instruction,John Cox,DEM,470009,0,0,8,8,
Major,Superintendent of Public Instruction,Joy Hofmeister,REP,470009,1,0,26,27,
Major,Commissioner of Labor,Mike Workman,DEM,470009,0,0,6,6,
Major,Commissioner of Labor,Mark Costello,REP,470009,1,0,27,28,
Major,U.S. Senate,Matt Silverstein,DEM,470009,0,0,2,2,
Major,U.S. Senate,Jim Inhofe,REP,470009,1,0,32,33,
Major,U.S. Senate,Aaron Delozier,IND,470009,0,0,0,0,
Major,U.S. Senate,Ray Woods,IND,470009,0,0,0,0,
Major,U.S. Senate,Joan Farr,IND,470009,0,0,0,0,
Major,U.S. Senate,Connie Johnson,DEM,470009,0,0,1,1,
Major,U.S. Senate,James Lankford,REP,470009,1,0,33,34,
Major,U.S. Senate,Mark Beard,IND,470009,0,0,0,0,
Major,U.S. House,Frankie Robbins,DEM,470009,0,0,2,2,03
Major,U.S. House,Frank Lucas,REP,470009,1,0,32,33,03
Major,Governor,Joe Dorman,DEM,470010,2,0,31,33,
Major,Governor,Mary Fallin,REP,470010,9,4,88,101,
Major,Governor,Kimberly Willis,IND,470010,1,1,2,4,
Major,Governor,Richard Prawdzienski,IND,470010,0,0,0,0,
Major,Lieutenant Governor,Cathy Cummings,DEM,470010,2,1,9,12,
Major,Lieutenant Governor,Todd Lamb,REP,470010,10,4,111,125,
Major,Superintendent of Public Instruction,John Cox,DEM,470010,3,1,27,31,
Major,Superintendent of Public Instruction,Joy Hofmeister,REP,470010,9,4,93,106,
Major,Commissioner of Labor,Mike Workman,DEM,470010,0,2,18,20,
Major,Commissioner of Labor,Mark Costello,REP,470010,10,3,102,115,
Major,U.S. Senate,Matt Silverstein,DEM,470010,2,1,7,10,
Major,U.S. Senate,Jim Inhofe,REP,470010,10,3,110,123,
Major,U.S. Senate,Aaron Delozier,IND,470010,0,0,0,0,
Major,U.S. Senate,Ray Woods,IND,470010,0,0,3,3,
Major,U.S. Senate,Joan Farr,IND,470010,0,1,1,2,
Major,U.S. Senate,Connie Johnson,DEM,470010,2,0,10,12,
Major,U.S. Senate,James Lankford,REP,470010,10,4,111,125,
Major,U.S. Senate,Mark Beard,IND,470010,0,1,0,1,
Major,U.S. House,Frankie Robbins,DEM,470010,2,0,8,10,03
Major,U.S. House,Frank Lucas,REP,470010,10,5,113,128,03
Major,Governor,Joe Dorman,DEM,470015,0,0,44,44,
Major,Governor,Mary Fallin,REP,470015,1,3,85,89,
Major,Governor,Kimberly Willis,IND,470015,1,0,8,9,
Major,Governor,Richard Prawdzienski,IND,470015,0,0,1,1,
Major,Lieutenant Governor,Cathy Cummings,DEM,470015,0,0,10,10,
Major,Lieutenant Governor,Todd Lamb,REP,470015,2,3,130,135,
Major,Superintendent of Public Instruction,John Cox,DEM,470015,0,0,45,45,
Major,Superintendent of Public Instruction,Joy Hofmeister,REP,470015,2,3,94,99,
Major,Commissioner of Labor,Mike Workman,DEM,470015,0,0,16,16,
Major,Commissioner of Labor,Mark Costello,REP,470015,2,3,120,125,
Major,U.S. Senate,Matt Silverstein,DEM,470015,0,0,8,8,
Major,U.S. Senate,Jim Inhofe,REP,470015,1,3,127,131,
Major,U.S. Senate,Aaron Delozier,IND,470015,0,0,2,2,
Major,U.S. Senate,Ray Woods,IND,470015,1,0,2,3,
Major,U.S. Senate,Joan Farr,IND,470015,0,0,0,0,
Major,U.S. Senate,Connie Johnson,DEM,470015,0,0,7,7,
Major,U.S. Senate,James Lankford,REP,470015,2,3,127,132,
Major,U.S. Senate,Mark Beard,IND,470015,0,0,6,6,
Major,U.S. House,Frankie Robbins,DEM,470015,0,0,13,13,03
Major,U.S. House,Frank Lucas,REP,470015,2,3,127,132,03
Major,Governor,Joe Dorman,DEM,470016,0,0,22,22,
Major,Governor,Mary Fallin,REP,470016,0,1,33,34,
Major,Governor,Kimberly Willis,IND,470016,0,0,5,5,
Major,Governor,Richard Prawdzienski,IND,470016,0,0,0,0,
Major,Lieutenant Governor,Cathy Cummings,DEM,470016,0,0,8,8,
Major,Lieutenant Governor,Todd Lamb,REP,470016,0,1,53,54,
Major,Superintendent of Public Instruction,John Cox,DEM,470016,0,0,22,22,
Major,Superintendent of Public Instruction,Joy Hofmeister,REP,470016,0,1,39,40,
Major,Commissioner of Labor,Mike Workman,DEM,470016,0,0,13,13,
Major,Commissioner of Labor,Mark Costello,REP,470016,0,1,46,47,
Major,U.S. Senate,Matt Silverstein,DEM,470016,0,0,6,6,
Major,U.S. Senate,Jim Inhofe,REP,470016,0,1,51,52,
Major,U.S. Senate,Aaron Delozier,IND,470016,0,0,2,2,
Major,U.S. Senate,Ray Woods,IND,470016,0,0,1,1,
Major,U.S. Senate,Joan Farr,IND,470016,0,0,1,1,
Major,U.S. Senate,Connie Johnson,DEM,470016,0,0,8,8,
Major,U.S. Senate,James Lankford,REP,470016,0,1,49,50,
Major,U.S. Senate,Mark Beard,IND,470016,0,0,3,3,
Major,U.S. House,Frankie Robbins,DEM,470016,0,0,8,8,03
Major,U.S. House,Frank Lucas,REP,470016,0,1,52,53,03
Major,Governor,Joe Dorman,DEM,470020,9,26,203,238,
Major,Governor,Mary Fallin,REP,470020,23,38,339,400,
Major,Governor,Kimberly Willis,IND,470020,2,1,16,19,
Major,Governor,Richard Prawdzienski,IND,470020,0,1,6,7,
Major,Lieutenant Governor,Cathy Cummings,DEM,470020,7,10,76,93,
Major,Lieutenant Governor,Todd Lamb,REP,470020,27,56,490,573,
Major,Superintendent of Public Instruction,John Cox,DEM,470020,10,21,188,219,
Major,Superintendent of Public Instruction,Joy Hofmeister,REP,470020,24,45,378,447,
Major,Commissioner of Labor,Mike Workman,DEM,470020,8,16,111,135,
Major,Commissioner of Labor,Mark Costello,REP,470020,25,46,439,510,
Major,U.S. Senate,Matt Silverstein,DEM,470020,3,13,52,68,
Major,U.S. Senate,Jim Inhofe,REP,470020,27,49,450,526,
Major,U.S. Senate,Aaron Delozier,IND,470020,0,1,3,4,
Major,U.S. Senate,Ray Woods,IND,470020,3,3,59,65,
Major,U.S. Senate,Joan Farr,IND,470020,1,0,4,5,
Major,U.S. Senate,Connie Johnson,DEM,470020,5,13,59,77,
Major,U.S. Senate,James Lankford,REP,470020,27,53,490,570,
Major,U.S. Senate,Mark Beard,IND,470020,2,0,18,20,
Major,U.S. House,Frankie Robbins,DEM,470020,5,11,81,97,03
Major,U.S. House,Frank Lucas,REP,470020,29,54,486,569,03
Major,Governor,Joe Dorman,DEM,470022,6,25,142,173,
Major,Governor,Mary Fallin,REP,470022,7,27,286,320,
Major,Governor,Kimberly Willis,IND,470022,0,2,16,18,
Major,Governor,Richard Prawdzienski,IND,470022,1,0,8,9,
Major,Lieutenant Governor,Cathy Cummings,DEM,470022,4,11,44,59,
Major,Lieutenant Governor,Todd Lamb,REP,470022,9,43,408,460,
Major,Superintendent of Public Instruction,John Cox,DEM,470022,7,15,134,156,
Major,Superintendent of Public Instruction,Joy Hofmeister,REP,470022,6,37,315,358,
Major,Commissioner of Labor,Mike Workman,DEM,470022,3,15,93,111,
Major,Commissioner of Labor,Mark Costello,REP,470022,9,35,350,394,
Major,U.S. Senate,Matt Silverstein,DEM,470022,3,8,40,51,
Major,U.S. Senate,Jim Inhofe,REP,470022,8,37,357,402,
Major,U.S. Senate,Aaron Delozier,IND,470022,0,0,3,3,
Major,U.S. Senate,Ray Woods,IND,470022,2,8,48,58,
Major,U.S. Senate,Joan Farr,IND,470022,0,0,3,3,
Major,U.S. Senate,Connie Johnson,DEM,470022,4,7,54,65,
Major,U.S. Senate,James Lankford,REP,470022,9,45,379,433,
Major,U.S. Senate,Mark Beard,IND,470022,0,1,18,19,
Major,U.S. House,Frankie Robbins,DEM,470022,4,9,53,66,03
Major,U.S. House,Frank Lucas,REP,470022,10,44,395,449,03
Marshall,Governor,Joe Dorman,DEM,480101,5,23,169,197,
Marshall,Governor,Mary Fallin,REP,480101,1,28,190,219,
Marshall,Governor,Kimberly Willis,IND,480101,0,0,11,11,
Marshall,Governor,Richard Prawdzienski,IND,480101,0,1,2,3,
Marshall,Lieutenant Governor,Cathy Cummings,DEM,480101,5,13,109,127,
Marshall,Lieutenant Governor,Todd Lamb,REP,480101,1,39,259,299,
Marshall,Superintendent of Public Instruction,John Cox,DEM,480101,5,29,203,237,
Marshall,Superintendent of Public Instruction,Joy Hofmeister,REP,480101,1,23,166,190,
Marshall,Commissioner of Labor,Mike Workman,DEM,480101,4,19,126,149,
Marshall,Commissioner of Labor,Mark Costello,REP,480101,2,31,235,268,
Marshall,U.S. Senate,Matt Silverstein,DEM,480101,5,6,91,102,
Marshall,U.S. Senate,Jim Inhofe,REP,480101,1,44,273,318,
Marshall,U.S. Senate,Aaron Delozier,IND,480101,0,2,3,5,
Marshall,U.S. Senate,Ray Woods,IND,480101,0,0,2,2,
Marshall,U.S. Senate,Joan Farr,IND,480101,0,0,4,4,
Marshall,U.S. Senate,Connie Johnson,DEM,480101,5,13,108,126,
Marshall,U.S. Senate,James Lankford,REP,480101,1,38,254,293,
Marshall,U.S. Senate,Mark Beard,IND,480101,0,1,9,10,
Marshall,U.S. House,Earl Everett,DEM,480101,4,10,74,88,02
Marshall,U.S. House,Markwayne Mullin,REP,480101,2,42,281,325,02
Marshall,U.S. House,Jon Douthitt,IND,480101,0,0,15,15,02
Marshall,State Senate,Joe Hill,DEM,480101,5,26,151,182,6
Marshall,State Senate,Josh Brecheen,REP,480101,1,26,216,243,6
Marshall,State Senate,Vicki Gaylor,IND,480101,0,0,9,9,6
Marshall,State House,Jessica Pfau,DEM,480101,4,5,79,88,49
Marshall,State House,Tommy Hardin,REP,480101,2,46,298,346,49
Marshall,Governor,Joe Dorman,DEM,480102,2,15,106,123,
Marshall,Governor,Mary Fallin,REP,480102,5,19,99,123,
Marshall,Governor,Kimberly Willis,IND,480102,0,1,6,7,
Marshall,Governor,Richard Prawdzienski,IND,480102,0,0,1,1,
Marshall,Lieutenant Governor,Cathy Cummings,DEM,480102,3,9,80,92,
Marshall,Lieutenant Governor,Todd Lamb,REP,480102,4,26,129,159,
Marshall,Superintendent of Public Instruction,John Cox,DEM,480102,7,15,112,134,
Marshall,Superintendent of Public Instruction,Joy Hofmeister,REP,480102,1,20,96,117,
Marshall,Commissioner of Labor,Mike Workman,DEM,480102,6,10,82,98,
Marshall,Commissioner of Labor,Mark Costello,REP,480102,1,24,117,142,
Marshall,U.S. Senate,Matt Silverstein,DEM,480102,3,5,59,67,
Marshall,U.S. Senate,Jim Inhofe,REP,480102,4,27,147,178,
Marshall,U.S. Senate,Aaron Delozier,IND,480102,0,1,0,1,
Marshall,U.S. Senate,Ray Woods,IND,480102,0,1,5,6,
Marshall,U.S. Senate,Joan Farr,IND,480102,0,0,0,0,
Marshall,U.S. Senate,Connie Johnson,DEM,480102,4,7,65,76,
Marshall,U.S. Senate,James Lankford,REP,480102,3,28,135,166,
Marshall,U.S. Senate,Mark Beard,IND,480102,0,0,6,6,
Marshall,U.S. House,Earl Everett,DEM,480102,4,5,48,57,02
Marshall,U.S. House,Markwayne Mullin,REP,480102,3,29,154,186,02
Marshall,U.S. House,Jon Douthitt,IND,480102,0,1,9,10,02
Marshall,State Senate,Joe Hill,DEM,480102,4,11,86,101,6
Marshall,State Senate,Josh Brecheen,REP,480102,2,24,126,152,6
Marshall,State Senate,Vicki Gaylor,IND,480102,1,0,1,2,6
Marshall,State House,Jessica Pfau,DEM,480102,5,6,58,69,49
Marshall,State House,Tommy Hardin,REP,480102,1,29,155,185,49
Marshall,Governor,Joe Dorman,DEM,480105,0,8,89,97,
Marshall,Governor,Mary Fallin,REP,480105,12,8,110,130,
Marshall,Governor,Kimberly Willis,IND,480105,0,0,1,1,
Marshall,Governor,Richard Prawdzienski,IND,480105,0,0,6,6,
Marshall,Lieutenant Governor,Cathy Cummings,DEM,480105,1,7,66,74,
Marshall,Lieutenant Governor,Todd Lamb,REP,480105,11,9,135,155,
Marshall,Superintendent of Public Instruction,John Cox,DEM,480105,1,9,98,108,
Marshall,Superintendent of Public Instruction,Joy Hofmeister,REP,480105,11,7,102,120,
Marshall,Commissioner of Labor,Mike Workman,DEM,480105,0,7,69,76,
Marshall,Commissioner of Labor,Mark Costello,REP,480105,12,9,129,150,
Marshall,U.S. Senate,Matt Silverstein,DEM,480105,0,6,51,57,
Marshall,U.S. Senate,Jim Inhofe,REP,480105,11,10,144,165,
Marshall,U.S. Senate,Aaron Delozier,IND,480105,0,0,1,1,
Marshall,U.S. Senate,Ray Woods,IND,480105,0,0,4,4,
Marshall,U.S. Senate,Joan Farr,IND,480105,1,0,2,3,
Marshall,U.S. Senate,Connie Johnson,DEM,480105,1,6,59,66,
Marshall,U.S. Senate,James Lankford,REP,480105,11,9,132,152,
Marshall,U.S. Senate,Mark Beard,IND,480105,0,1,7,8,
Marshall,U.S. House,Earl Everett,DEM,480105,0,6,40,46,02
Marshall,U.S. House,Markwayne Mullin,REP,480105,12,10,151,173,02
Marshall,U.S. House,Jon Douthitt,IND,480105,0,0,12,12,02
Marshall,State Senate,Joe Hill,DEM,480105,1,8,78,87,6
Marshall,State Senate,Josh Brecheen,REP,480105,10,8,124,142,6
Marshall,State Senate,Vicki Gaylor,IND,480105,1,0,3,4,6
Marshall,State House,Jessica Pfau,DEM,480105,1,3,63,67,49
Marshall,State House,Tommy Hardin,REP,480105,11,13,141,165,49
Marshall,Governor,Joe Dorman,DEM,480106,1,3,66,70,
Marshall,Governor,Mary Fallin,REP,480106,0,5,64,69,
Marshall,Governor,Kimberly Willis,IND,480106,0,0,6,6,
Marshall,Governor,Richard Prawdzienski,IND,480106,0,0,2,2,
Marshall,Lieutenant Governor,Cathy Cummings,DEM,480106,1,3,54,58,
Marshall,Lieutenant Governor,Todd Lamb,REP,480106,0,5,86,91,
Marshall,Superintendent of Public Instruction,John Cox,DEM,480106,1,3,67,71,
Marshall,Superintendent of Public Instruction,Joy Hofmeister,REP,480106,0,5,73,78,
Marshall,Commissioner of Labor,Mike Workman,DEM,480106,1,1,54,56,
Marshall,Commissioner of Labor,Mark Costello,REP,480106,0,7,83,90,
Marshall,U.S. Senate,Matt Silverstein,DEM,480106,1,0,34,35,
Marshall,U.S. Senate,Jim Inhofe,REP,480106,0,8,96,104,
Marshall,U.S. Senate,Aaron Delozier,IND,480106,0,0,0,0,
Marshall,U.S. Senate,Ray Woods,IND,480106,0,0,5,5,
Marshall,U.S. Senate,Joan Farr,IND,480106,0,0,5,5,
Marshall,U.S. Senate,Connie Johnson,DEM,480106,1,1,47,49,
Marshall,U.S. Senate,James Lankford,REP,480106,0,7,80,87,
Marshall,U.S. Senate,Mark Beard,IND,480106,0,0,11,11,
Marshall,U.S. House,Earl Everett,DEM,480106,1,2,41,44,02
Marshall,U.S. House,Markwayne Mullin,REP,480106,0,6,92,98,02
Marshall,U.S. House,Jon Douthitt,IND,480106,0,0,6,6,02
Marshall,State Senate,Joe Hill,DEM,480106,1,3,49,53,6
Marshall,State Senate,Josh Brecheen,REP,480106,0,5,85,90,6
Marshall,State Senate,Vicki Gaylor,IND,480106,0,0,6,6,6
Marshall,State House,Jessica Pfau,DEM,480106,1,2,42,45,49
Marshall,State House,Tommy Hardin,REP,480106,0,6,98,104,49
Marshall,Governor,Joe Dorman,DEM,480201,2,7,67,76,
Marshall,Governor,Mary Fallin,REP,480201,1,11,103,115,
Marshall,Governor,Kimberly Willis,IND,480201,0,0,4,4,
Marshall,Governor,Richard Prawdzienski,IND,480201,0,0,2,2,
Marshall,Lieutenant Governor,Cathy Cummings,DEM,480201,2,1,36,39,
Marshall,Lieutenant Governor,Todd Lamb,REP,480201,1,15,140,156,
Marshall,Superintendent of Public Instruction,John Cox,DEM,480201,1,8,86,95,
Marshall,Superintendent of Public Instruction,Joy Hofmeister,REP,480201,2,9,87,98,
Marshall,Commissioner of Labor,Mike Workman,DEM,480201,1,2,49,52,
Marshall,Commissioner of Labor,Mark Costello,REP,480201,1,14,121,136,
Marshall,U.S. Senate,Matt Silverstein,DEM,480201,1,1,31,33,
Marshall,U.S. Senate,Jim Inhofe,REP,480201,2,16,145,163,
Marshall,U.S. Senate,Aaron Delozier,IND,480201,0,0,0,0,
Marshall,U.S. Senate,Ray Woods,IND,480201,0,1,1,2,
Marshall,U.S. Senate,Joan Farr,IND,480201,0,0,0,0,
Marshall,U.S. Senate,Connie Johnson,DEM,480201,1,2,35,38,
Marshall,U.S. Senate,James Lankford,REP,480201,2,14,135,151,
Marshall,U.S. Senate,Mark Beard,IND,480201,0,0,5,5,
Marshall,U.S. House,Earl Everett,DEM,480201,1,3,27,31,02
Marshall,U.S. House,Markwayne Mullin,REP,480201,2,14,144,160,02
Marshall,U.S. House,Jon Douthitt,IND,480201,0,0,5,5,02
Marshall,State Senate,Joe Hill,DEM,480201,1,2,58,61,6
Marshall,State Senate,Josh Brecheen,REP,480201,2,14,117,133,6
Marshall,State Senate,Vicki Gaylor,IND,480201,0,1,2,3,6
Marshall,State House,Jessica Pfau,DEM,480201,1,3,25,29,49
Marshall,State House,Tommy Hardin,REP,480201,2,14,152,168,49
Marshall,Governor,Joe Dorman,DEM,480202,5,16,104,125,
Marshall,Governor,Mary Fallin,REP,480202,6,7,74,87,
Marshall,Governor,Kimberly Willis,IND,480202,0,0,3,3,
Marshall,Governor,Richard Prawdzienski,IND,480202,1,0,4,5,
Marshall,Lieutenant Governor,Cathy Cummings,DEM,480202,6,14,72,92,
Marshall,Lieutenant Governor,Todd Lamb,REP,480202,6,9,111,126,
Marshall,Superintendent of Public Instruction,John Cox,DEM,480202,8,18,112,138,
Marshall,Superintendent of Public Instruction,Joy Hofmeister,REP,480202,4,5,70,79,
Marshall,Commissioner of Labor,Mike Workman,DEM,480202,8,16,82,106,
Marshall,Commissioner of Labor,Mark Costello,REP,480202,4,7,90,101,
Marshall,U.S. Senate,Matt Silverstein,DEM,480202,5,11,51,67,
Marshall,U.S. Senate,Jim Inhofe,REP,480202,4,12,123,139,
Marshall,U.S. Senate,Aaron Delozier,IND,480202,1,0,4,5,
Marshall,U.S. Senate,Ray Woods,IND,480202,2,0,1,3,
Marshall,U.S. Senate,Joan Farr,IND,480202,0,0,4,4,
Marshall,U.S. Senate,Connie Johnson,DEM,480202,7,13,61,81,
Marshall,U.S. Senate,James Lankford,REP,480202,4,9,111,124,
Marshall,U.S. Senate,Mark Beard,IND,480202,1,0,6,7,
Marshall,U.S. House,Earl Everett,DEM,480202,6,9,54,69,02
Marshall,U.S. House,Markwayne Mullin,REP,480202,5,11,121,137,02
Marshall,U.S. House,Jon Douthitt,IND,480202,1,2,8,11,02
Marshall,State Senate,Joe Hill,DEM,480202,8,15,100,123,6
Marshall,State Senate,Josh Brecheen,REP,480202,4,8,85,97,6
Marshall,State Senate,Vicki Gaylor,IND,480202,0,0,1,1,6
Marshall,State House,Jessica Pfau,DEM,480202,5,6,52,63,49
Marshall,State House,Tommy Hardin,REP,480202,7,17,132,156,49
Marshall,Governor,Joe Dorman,DEM,480204,5,8,144,157,
Marshall,Governor,Mary Fallin,REP,480204,11,14,155,180,
Marshall,Governor,Kimberly Willis,IND,480204,0,0,9,9,
Marshall,Governor,Richard Prawdzienski,IND,480204,0,0,7,7,
Marshall,Lieutenant Governor,Cathy Cummings,DEM,480204,1,5,88,94,
Marshall,Lieutenant Governor,Todd Lamb,REP,480204,15,15,226,256,
Marshall,Superintendent of Public Instruction,John Cox,DEM,480204,6,8,160,174,
Marshall,Superintendent of Public Instruction,Joy Hofmeister,REP,480204,10,13,153,176,
Marshall,Commissioner of Labor,Mike Workman,DEM,480204,4,6,100,110,
Marshall,Commissioner of Labor,Mark Costello,REP,480204,12,14,209,235,
Marshall,U.S. Senate,Matt Silverstein,DEM,480204,1,6,62,69,
Marshall,U.S. Senate,Jim Inhofe,REP,480204,13,16,249,278,
Marshall,U.S. Senate,Aaron Delozier,IND,480204,1,0,0,1,
Marshall,U.S. Senate,Ray Woods,IND,480204,1,0,4,5,
Marshall,U.S. Senate,Joan Farr,IND,480204,0,0,1,1,
Marshall,U.S. Senate,Connie Johnson,DEM,480204,2,4,78,84,
Marshall,U.S. Senate,James Lankford,REP,480204,13,17,227,257,
Marshall,U.S. Senate,Mark Beard,IND,480204,1,1,8,10,
Marshall,U.S. House,Earl Everett,DEM,480204,2,5,63,70,02
Marshall,U.S. House,Markwayne Mullin,REP,480204,14,16,241,271,02
Marshall,U.S. House,Jon Douthitt,IND,480204,0,1,10,11,02
Marshall,State Senate,Joe Hill,DEM,480204,4,9,121,134,6
Marshall,State Senate,Josh Brecheen,REP,480204,10,13,187,210,6
Marshall,State Senate,Vicki Gaylor,IND,480204,2,0,7,9,6
Marshall,State House,Jessica Pfau,DEM,480204,2,4,72,78,49
Marshall,State House,Tommy Hardin,REP,480204,14,18,243,275,49
Marshall,Governor,Joe Dorman,DEM,480206,2,6,90,98,
Marshall,Governor,Mary Fallin,REP,480206,9,9,109,127,
Marshall,Governor,Kimberly Willis,IND,480206,0,0,8,8,
Marshall,Governor,Richard Prawdzienski,IND,480206,0,0,2,2,
Marshall,Lieutenant Governor,Cathy Cummings,DEM,480206,2,2,62,66,
Marshall,Lieutenant Governor,Todd Lamb,REP,480206,9,13,147,169,
Marshall,Superintendent of Public Instruction,John Cox,DEM,480206,3,8,104,115,
Marshall,Superintendent of Public Instruction,Joy Hofmeister,REP,480206,7,7,104,118,
Marshall,Commissioner of Labor,Mike Workman,DEM,480206,3,6,72,81,
Marshall,Commissioner of Labor,Mark Costello,REP,480206,7,8,134,149,
Marshall,U.S. Senate,Matt Silverstein,DEM,480206,2,2,42,46,
Marshall,U.S. Senate,Jim Inhofe,REP,480206,8,13,159,180,
Marshall,U.S. Senate,Aaron Delozier,IND,480206,0,0,1,1,
Marshall,U.S. Senate,Ray Woods,IND,480206,1,0,3,4,
Marshall,U.S. Senate,Joan Farr,IND,480206,0,0,4,4,
Marshall,U.S. Senate,Connie Johnson,DEM,480206,3,3,53,59,
Marshall,U.S. Senate,James Lankford,REP,480206,8,11,146,165,
Marshall,U.S. Senate,Mark Beard,IND,480206,0,0,9,9,
Marshall,U.S. House,Earl Everett,DEM,480206,3,1,42,46,02
Marshall,U.S. House,Markwayne Mullin,REP,480206,8,14,162,184,02
Marshall,U.S. House,Jon Douthitt,IND,480206,0,0,5,5,02
Marshall,State Senate,Joe Hill,DEM,480206,4,6,80,90,6
Marshall,State Senate,Josh Brecheen,REP,480206,7,9,124,140,6
Marshall,State Senate,Vicki Gaylor,IND,480206,0,0,5,5,6
Marshall,State House,Jessica Pfau,DEM,480206,3,2,43,48,49
Marshall,State House,Tommy Hardin,REP,480206,8,13,166,187,49
Marshall,Governor,Joe Dorman,DEM,480302,6,5,108,119,
Marshall,Governor,Mary Fallin,REP,480302,7,12,124,143,
Marshall,Governor,Kimberly Willis,IND,480302,0,1,9,10,
Marshall,Governor,Richard Prawdzienski,IND,480302,0,0,2,2,
Marshall,Lieutenant Governor,Cathy Cummings,DEM,480302,6,2,73,81,
Marshall,Lieutenant Governor,Todd Lamb,REP,480302,7,16,164,187,
Marshall,Superintendent of Public Instruction,John Cox,DEM,480302,8,5,103,116,
Marshall,Superintendent of Public Instruction,Joy Hofmeister,REP,480302,5,13,135,153,
Marshall,Commissioner of Labor,Mike Workman,DEM,480302,6,4,80,90,
Marshall,Commissioner of Labor,Mark Costello,REP,480302,6,13,153,172,
Marshall,U.S. Senate,Matt Silverstein,DEM,480302,5,4,53,62,
Marshall,U.S. Senate,Jim Inhofe,REP,480302,8,11,180,199,
Marshall,U.S. Senate,Aaron Delozier,IND,480302,0,0,1,1,
Marshall,U.S. Senate,Ray Woods,IND,480302,0,2,6,8,
Marshall,U.S. Senate,Joan Farr,IND,480302,0,0,2,2,
Marshall,U.S. Senate,Connie Johnson,DEM,480302,4,2,56,62,
Marshall,U.S. Senate,James Lankford,REP,480302,9,13,164,186,
Marshall,U.S. Senate,Mark Beard,IND,480302,0,2,16,18,
Marshall,U.S. House,Earl Everett,DEM,480302,5,2,44,51,02
Marshall,U.S. House,Markwayne Mullin,REP,480302,6,14,180,200,02
Marshall,U.S. House,Jon Douthitt,IND,480302,0,1,12,13,02
Marshall,State Senate,Joe Hill,DEM,480302,6,7,85,98,6
Marshall,State Senate,Josh Brecheen,REP,480302,7,11,145,163,6
Marshall,State Senate,Vicki Gaylor,IND,480302,0,0,12,12,6
Marshall,State House,Jessica Pfau,DEM,480302,4,3,62,69,49
Marshall,State House,Tommy Hardin,REP,480302,9,15,181,205,49
Marshall,Governor,Joe Dorman,DEM,480303,9,8,189,206,
Marshall,Governor,Mary Fallin,REP,480303,14,25,218,257,
Marshall,Governor,Kimberly Willis,IND,480303,0,3,13,16,
Marshall,Governor,Richard Prawdzienski,IND,480303,0,1,6,7,
Marshall,Lieutenant Governor,Cathy Cummings,DEM,480303,5,4,128,137,
Marshall,Lieutenant Governor,Todd Lamb,REP,480303,18,33,293,344,
Marshall,Superintendent of Public Instruction,John Cox,DEM,480303,6,6,173,185,
Marshall,Superintendent of Public Instruction,Joy Hofmeister,REP,480303,15,30,247,292,
Marshall,Commissioner of Labor,Mike Workman,DEM,480303,4,6,145,155,
Marshall,Commissioner of Labor,Mark Costello,REP,480303,18,31,268,317,
Marshall,U.S. Senate,Matt Silverstein,DEM,480303,5,3,83,91,
Marshall,U.S. Senate,Jim Inhofe,REP,480303,18,31,317,366,
Marshall,U.S. Senate,Aaron Delozier,IND,480303,0,0,2,2,
Marshall,U.S. Senate,Ray Woods,IND,480303,0,1,9,10,
Marshall,U.S. Senate,Joan Farr,IND,480303,0,1,8,9,
Marshall,U.S. Senate,Connie Johnson,DEM,480303,3,4,98,105,
Marshall,U.S. Senate,James Lankford,REP,480303,20,31,291,342,
Marshall,U.S. Senate,Mark Beard,IND,480303,0,2,24,26,
Marshall,U.S. House,Earl Everett,DEM,480303,4,1,86,91,02
Marshall,U.S. House,Markwayne Mullin,REP,480303,16,32,304,352,02
Marshall,U.S. House,Jon Douthitt,IND,480303,1,4,27,32,02
Marshall,State Senate,Joe Hill,DEM,480303,7,8,154,169,6
Marshall,State Senate,Josh Brecheen,REP,480303,16,27,255,298,6
Marshall,State Senate,Vicki Gaylor,IND,480303,0,2,16,18,6
Marshall,State House,Jessica Pfau,DEM,480303,5,4,123,132,49
Marshall,State House,Tommy Hardin,REP,480303,18,33,298,349,49
Marshall,Governor,Joe Dorman,DEM,480304,3,14,209,226,
Marshall,Governor,Mary Fallin,REP,480304,15,21,306,342,
Marshall,Governor,Kimberly Willis,IND,480304,0,0,15,15,
Marshall,Governor,Richard Prawdzienski,IND,480304,0,0,6,6,
Marshall,Lieutenant Governor,Cathy Cummings,DEM,480304,2,12,163,177,
Marshall,Lieutenant Governor,Todd Lamb,REP,480304,16,23,368,407,
Marshall,Superintendent of Public Instruction,John Cox,DEM,480304,5,13,228,246,
Marshall,Superintendent of Public Instruction,Joy Hofmeister,REP,480304,13,21,300,334,
Marshall,Commissioner of Labor,Mike Workman,DEM,480304,6,10,178,194,
Marshall,Commissioner of Labor,Mark Costello,REP,480304,11,24,342,377,
Marshall,U.S. Senate,Matt Silverstein,DEM,480304,2,11,116,129,
Marshall,U.S. Senate,Jim Inhofe,REP,480304,16,24,391,431,
Marshall,U.S. Senate,Aaron Delozier,IND,480304,0,0,5,5,
Marshall,U.S. Senate,Ray Woods,IND,480304,0,0,9,9,
Marshall,U.S. Senate,Joan Farr,IND,480304,0,0,8,8,
Marshall,U.S. Senate,Connie Johnson,DEM,480304,3,12,140,155,
Marshall,U.S. Senate,James Lankford,REP,480304,14,23,358,395,
Marshall,U.S. Senate,Mark Beard,IND,480304,1,0,31,32,
Marshall,U.S. House,Earl Everett,DEM,480304,2,11,115,128,02
Marshall,U.S. House,Markwayne Mullin,REP,480304,15,24,392,431,02
Marshall,U.S. House,Jon Douthitt,IND,480304,1,0,26,27,02
Marshall,State Senate,Joe Hill,DEM,480304,4,11,179,194,6
Marshall,State Senate,Josh Brecheen,REP,480304,12,24,337,373,6
Marshall,State Senate,Vicki Gaylor,IND,480304,2,0,19,21,6
Marshall,State House,Jessica Pfau,DEM,480304,2,11,143,156,49
Marshall,State House,Tommy Hardin,REP,480304,15,24,388,427,49
Mayes,Governor,Joe Dorman,DEM,490011,1,2,117,120,
Mayes,Governor,Mary Fallin,REP,490011,6,7,225,238,
Mayes,Governor,Kimberly Willis,IND,490011,0,0,2,2,
Mayes,Governor,Richard Prawdzienski,IND,490011,0,0,3,3,
Mayes,Lieutenant Governor,Cathy Cummings,DEM,490011,1,2,105,108,
Mayes,Lieutenant Governor,Todd Lamb,REP,490011,6,7,241,254,
Mayes,Superintendent of Public Instruction,John Cox,DEM,490011,4,6,172,182,
Mayes,Superintendent of Public Instruction,Joy Hofmeister,REP,490011,3,3,172,178,
Mayes,Commissioner of Labor,Mike Workman,DEM,490011,3,2,133,138,
Mayes,Commissioner of Labor,Mark Costello,REP,490011,4,7,210,221,
Mayes,U.S. Senate,Matt Silverstein,DEM,490011,2,2,90,94,
Mayes,U.S. Senate,Jim Inhofe,REP,490011,5,7,241,253,
Mayes,U.S. Senate,Aaron Delozier,IND,490011,0,0,7,7,
Mayes,U.S. Senate,Ray Woods,IND,490011,0,0,1,1,
Mayes,U.S. Senate,Joan Farr,IND,490011,0,0,5,5,
Mayes,U.S. Senate,Connie Johnson,DEM,490011,1,2,97,100,
Mayes,U.S. Senate,James Lankford,REP,490011,5,7,243,255,
Mayes,U.S. Senate,Mark Beard,IND,490011,1,0,8,9,
Mayes,U.S. House,Earl Everett,DEM,490011,1,2,71,74,02
Mayes,U.S. House,Markwayne Mullin,REP,490011,6,6,262,274,02
Mayes,U.S. House,Jon Douthitt,IND,490011,0,1,13,14,02
Mayes,State House,Chuck Hoskin,DEM,490011,2,3,182,187,6
Mayes,State House,Marshall Scott Mcguire,REP,490011,5,6,165,176,6
Mayes,Governor,Joe Dorman,DEM,490012,4,11,155,170,
Mayes,Governor,Mary Fallin,REP,490012,2,9,226,237,
Mayes,Governor,Kimberly Willis,IND,490012,0,0,5,5,
Mayes,Governor,Richard Prawdzienski,IND,490012,0,0,6,6,
Mayes,Lieutenant Governor,Cathy Cummings,DEM,490012,4,4,104,112,
Mayes,Lieutenant Governor,Todd Lamb,REP,490012,2,16,282,300,
Mayes,Superintendent of Public Instruction,John Cox,DEM,490012,6,15,237,258,
Mayes,Superintendent of Public Instruction,Joy Hofmeister,REP,490012,0,5,152,157,
Mayes,Commissioner of Labor,Mike Workman,DEM,490012,4,7,160,171,
Mayes,Commissioner of Labor,Mark Costello,REP,490012,2,13,220,235,
Mayes,U.S. Senate,Matt Silverstein,DEM,490012,4,4,91,99,
Mayes,U.S. Senate,Jim Inhofe,REP,490012,2,16,275,293,
Mayes,U.S. Senate,Aaron Delozier,IND,490012,0,0,20,20,
Mayes,U.S. Senate,Ray Woods,IND,490012,0,0,2,2,
Mayes,U.S. Senate,Joan Farr,IND,490012,0,0,2,2,
Mayes,U.S. Senate,Connie Johnson,DEM,490012,4,2,98,104,
Mayes,U.S. Senate,James Lankford,REP,490012,2,18,279,299,
Mayes,U.S. Senate,Mark Beard,IND,490012,0,0,10,10,
Mayes,U.S. House,Earl Everett,DEM,490012,4,2,62,68,02
Mayes,U.S. House,Markwayne Mullin,REP,490012,2,17,312,331,02
Mayes,U.S. House,Jon Douthitt,IND,490012,0,1,16,17,02
Mayes,State House,Chuck Hoskin,DEM,490012,5,16,258,279,6
Mayes,State House,Marshall Scott Mcguire,REP,490012,1,4,130,135,6
Mayes,Governor,Joe Dorman,DEM,490014,1,3,55,59,
Mayes,Governor,Mary Fallin,REP,490014,0,0,58,58,
Mayes,Governor,Kimberly Willis,IND,490014,0,0,3,3,
Mayes,Governor,Richard Prawdzienski,IND,490014,0,0,3,3,
Mayes,Lieutenant Governor,Cathy Cummings,DEM,490014,1,2,40,43,
Mayes,Lieutenant Governor,Todd Lamb,REP,490014,0,1,79,80,
Mayes,Superintendent of Public Instruction,John Cox,DEM,490014,1,3,63,67,
Mayes,Superintendent of Public Instruction,Joy Hofmeister,REP,490014,0,0,55,55,
Mayes,Commissioner of Labor,Mike Workman,DEM,490014,1,2,55,58,
Mayes,Commissioner of Labor,Mark Costello,REP,490014,0,1,62,63,
Mayes,U.S. Senate,Matt Silverstein,DEM,490014,1,2,40,43,
Mayes,U.S. Senate,Jim Inhofe,REP,490014,0,1,74,75,
Mayes,U.S. Senate,Aaron Delozier,IND,490014,0,0,0,0,
Mayes,U.S. Senate,Ray Woods,IND,490014,0,0,2,2,
Mayes,U.S. Senate,Joan Farr,IND,490014,0,0,3,3,
Mayes,U.S. Senate,Connie Johnson,DEM,490014,1,1,35,37,
Mayes,U.S. Senate,James Lankford,REP,490014,0,2,80,82,
Mayes,U.S. Senate,Mark Beard,IND,490014,0,0,4,4,
Mayes,U.S. House,Earl Everett,DEM,490014,1,0,26,27,02
Mayes,U.S. House,Markwayne Mullin,REP,490014,0,3,84,87,02
Mayes,U.S. House,Jon Douthitt,IND,490014,0,0,8,8,02
Mayes,Governor,Joe Dorman,DEM,490015,0,16,100,116,
Mayes,Governor,Mary Fallin,REP,490015,4,10,165,179,
Mayes,Governor,Kimberly Willis,IND,490015,0,1,5,6,
Mayes,Governor,Richard Prawdzienski,IND,490015,0,0,2,2,
Mayes,Lieutenant Governor,Cathy Cummings,DEM,490015,0,9,74,83,
Mayes,Lieutenant Governor,Todd Lamb,REP,490015,4,17,195,216,
Mayes,Superintendent of Public Instruction,John Cox,DEM,490015,4,20,152,176,
Mayes,Superintendent of Public Instruction,Joy Hofmeister,REP,490015,0,7,118,125,
Mayes,Commissioner of Labor,Mike Workman,DEM,490015,0,12,116,128,
Mayes,Commissioner of Labor,Mark Costello,REP,490015,4,12,148,164,
Mayes,U.S. Senate,Matt Silverstein,DEM,490015,1,12,77,90,
Mayes,U.S. Senate,Jim Inhofe,REP,490015,3,15,173,191,
Mayes,U.S. Senate,Aaron Delozier,IND,490015,0,0,12,12,
Mayes,U.S. Senate,Ray Woods,IND,490015,0,0,3,3,
Mayes,U.S. Senate,Joan Farr,IND,490015,0,0,1,1,
Mayes,U.S. Senate,Connie Johnson,DEM,490015,0,10,73,83,
Mayes,U.S. Senate,James Lankford,REP,490015,4,17,176,197,
Mayes,U.S. Senate,Mark Beard,IND,490015,0,0,20,20,
Mayes,U.S. House,Earl Everett,DEM,490015,0,9,59,68,02
Mayes,U.S. House,Markwayne Mullin,REP,490015,4,18,188,210,02
Mayes,U.S. House,Jon Douthitt,IND,490015,0,0,20,20,02
Mayes,Governor,Joe Dorman,DEM,490016,5,7,102,114,
Mayes,Governor,Mary Fallin,REP,490016,5,11,114,130,
Mayes,Governor,Kimberly Willis,IND,490016,0,2,7,9,
Mayes,Governor,Richard Prawdzienski,IND,490016,0,0,2,2,
Mayes,Lieutenant Governor,Cathy Cummings,DEM,490016,4,6,58,68,
Mayes,Lieutenant Governor,Todd Lamb,REP,490016,6,12,164,182,
Mayes,Superintendent of Public Instruction,John Cox,DEM,490016,6,13,130,149,
Mayes,Superintendent of Public Instruction,Joy Hofmeister,REP,490016,4,7,93,104,
Mayes,Commissioner of Labor,Mike Workman,DEM,490016,3,4,92,99,
Mayes,Commissioner of Labor,Mark Costello,REP,490016,7,14,126,147,
Mayes,U.S. Senate,Matt Silverstein,DEM,490016,2,3,57,62,
Mayes,U.S. Senate,Jim Inhofe,REP,490016,7,16,161,184,
Mayes,U.S. Senate,Aaron Delozier,IND,490016,1,0,4,5,
Mayes,U.S. Senate,Ray Woods,IND,490016,0,0,1,1,
Mayes,U.S. Senate,Joan Farr,IND,490016,0,0,1,1,
Mayes,U.S. Senate,Connie Johnson,DEM,490016,2,4,59,65,
Mayes,U.S. Senate,James Lankford,REP,490016,8,14,160,182,
Mayes,U.S. Senate,Mark Beard,IND,490016,0,2,4,6,
Mayes,U.S. House,Earl Everett,DEM,490016,2,4,41,47,02
Mayes,U.S. House,Markwayne Mullin,REP,490016,8,13,166,187,02
Mayes,U.S. House,Jon Douthitt,IND,490016,0,2,17,19,02
Mayes,State House,Chuck Hoskin,DEM,490016,5,8,126,139,6
Mayes,State House,Marshall Scott Mcguire,REP,490016,5,11,97,113,6
Mayes,Governor,Joe Dorman,DEM,490020,1,26,196,223,
Mayes,Governor,Mary Fallin,REP,490020,4,24,288,316,
Mayes,Governor,Kimberly Willis,IND,490020,0,1,11,12,
Mayes,Governor,Richard Prawdzienski,IND,490020,0,0,4,4,
Mayes,Lieutenant Governor,Cathy Cummings,DEM,490020,1,19,128,148,
Mayes,Lieutenant Governor,Todd Lamb,REP,490020,4,32,369,405,
Mayes,Superintendent of Public Instruction,John Cox,DEM,490020,2,31,282,315,
Mayes,Superintendent of Public Instruction,Joy Hofmeister,REP,490020,3,20,214,237,
Mayes,Commissioner of Labor,Mike Workman,DEM,490020,1,20,196,217,
Mayes,Commissioner of Labor,Mark Costello,REP,490020,4,28,294,326,
Mayes,U.S. Senate,Matt Silverstein,DEM,490020,1,19,121,141,
Mayes,U.S. Senate,Jim Inhofe,REP,490020,4,30,354,388,
Mayes,U.S. Senate,Aaron Delozier,IND,490020,0,1,11,12,
Mayes,U.S. Senate,Ray Woods,IND,490020,0,0,3,3,
Mayes,U.S. Senate,Joan Farr,IND,490020,0,0,6,6,
Mayes,U.S. Senate,Connie Johnson,DEM,490020,0,17,128,145,
Mayes,U.S. Senate,James Lankford,REP,490020,5,32,361,398,
Mayes,U.S. Senate,Mark Beard,IND,490020,0,1,9,10,
Mayes,U.S. House,Earl Everett,DEM,490020,0,12,85,97,02
Mayes,U.S. House,Markwayne Mullin,REP,490020,5,37,378,420,02
Mayes,U.S. House,Jon Douthitt,IND,490020,0,1,34,35,02
Mayes,Governor,Joe Dorman,DEM,490021,3,2,71,76,
Mayes,Governor,Mary Fallin,REP,490021,1,8,130,139,
Mayes,Governor,Kimberly Willis,IND,490021,0,0,4,4,
Mayes,Governor,Richard Prawdzienski,IND,490021,0,0,3,3,
Mayes,Lieutenant Governor,Cathy Cummings,DEM,490021,1,0,50,51,
Mayes,Lieutenant Governor,Todd Lamb,REP,490021,3,10,158,171,
Mayes,Superintendent of Public Instruction,John Cox,DEM,490021,3,5,110,118,
Mayes,Superintendent of Public Instruction,Joy Hofmeister,REP,490021,1,5,98,104,
Mayes,Commissioner of Labor,Mike Workman,DEM,490021,3,1,70,74,
Mayes,Commissioner of Labor,Mark Costello,REP,490021,1,9,134,144,
Mayes,U.S. Senate,Matt Silverstein,DEM,490021,3,0,48,51,
Mayes,U.S. Senate,Jim Inhofe,REP,490021,1,10,150,161,
Mayes,U.S. Senate,Aaron Delozier,IND,490021,0,0,3,3,
Mayes,U.S. Senate,Ray Woods,IND,490021,0,0,2,2,
Mayes,U.S. Senate,Joan Farr,IND,490021,0,0,4,4,
Mayes,U.S. Senate,Connie Johnson,DEM,490021,1,0,48,49,
Mayes,U.S. Senate,James Lankford,REP,490021,3,10,146,159,
Mayes,U.S. Senate,Mark Beard,IND,490021,0,0,11,11,
Mayes,U.S. House,Earl Everett,DEM,490021,2,0,43,45,02
Mayes,U.S. House,Markwayne Mullin,REP,490021,2,10,157,169,02
Mayes,U.S. House,Jon Douthitt,IND,490021,0,0,7,7,02
Mayes,Governor,Joe Dorman,DEM,490022,3,3,132,138,
Mayes,Governor,Mary Fallin,REP,490022,1,5,186,192,
Mayes,Governor,Kimberly Willis,IND,490022,0,0,13,13,
Mayes,Governor,Richard Prawdzienski,IND,490022,0,1,2,3,
Mayes,Lieutenant Governor,Cathy Cummings,DEM,490022,2,0,83,85,
Mayes,Lieutenant Governor,Todd Lamb,REP,490022,2,9,245,256,
Mayes,Superintendent of Public Instruction,John Cox,DEM,490022,4,5,191,200,
Mayes,Superintendent of Public Instruction,Joy Hofmeister,REP,490022,0,4,143,147,
Mayes,Commissioner of Labor,Mike Workman,DEM,490022,3,1,116,120,
Mayes,Commissioner of Labor,Mark Costello,REP,490022,0,8,211,219,
Mayes,U.S. Senate,Matt Silverstein,DEM,490022,2,1,75,78,
Mayes,U.S. Senate,Jim Inhofe,REP,490022,2,8,236,246,
Mayes,U.S. Senate,Aaron Delozier,IND,490022,0,0,14,14,
Mayes,U.S. Senate,Ray Woods,IND,490022,0,0,2,2,
Mayes,U.S. Senate,Joan Farr,IND,490022,0,0,7,7,
Mayes,U.S. Senate,Connie Johnson,DEM,490022,2,0,71,73,
Mayes,U.S. Senate,James Lankford,REP,490022,2,9,245,256,
Mayes,U.S. Senate,Mark Beard,IND,490022,0,0,13,13,
Mayes,U.S. House,Earl Everett,DEM,490022,2,0,58,60,02
Mayes,U.S. House,Markwayne Mullin,REP,490022,2,9,256,267,02
Mayes,U.S. House,Jon Douthitt,IND,490022,0,0,14,14,02
Mayes,Governor,Joe Dorman,DEM,490023,0,9,167,176,
Mayes,Governor,Mary Fallin,REP,490023,2,9,274,285,
Mayes,Governor,Kimberly Willis,IND,490023,0,0,11,11,
Mayes,Governor,Richard Prawdzienski,IND,490023,0,0,5,5,
Mayes,Lieutenant Governor,Cathy Cummings,DEM,490023,0,5,117,122,
Mayes,Lieutenant Governor,Todd Lamb,REP,490023,2,13,336,351,
Mayes,Superintendent of Public Instruction,John Cox,DEM,490023,1,9,249,259,
Mayes,Superintendent of Public Instruction,Joy Hofmeister,REP,490023,2,9,208,219,
Mayes,Commissioner of Labor,Mike Workman,DEM,490023,1,6,151,158,
Mayes,Commissioner of Labor,Mark Costello,REP,490023,2,11,298,311,
Mayes,U.S. Senate,Matt Silverstein,DEM,490023,1,4,118,123,
Mayes,U.S. Senate,Jim Inhofe,REP,490023,2,13,318,333,
Mayes,U.S. Senate,Aaron Delozier,IND,490023,0,1,15,16,
Mayes,U.S. Senate,Ray Woods,IND,490023,0,0,1,1,
Mayes,U.S. Senate,Joan Farr,IND,490023,0,0,3,3,
Mayes,U.S. Senate,Connie Johnson,DEM,490023,1,5,117,123,
Mayes,U.S. Senate,James Lankford,REP,490023,2,13,327,342,
Mayes,U.S. Senate,Mark Beard,IND,490023,0,0,11,11,
Mayes,U.S. House,Earl Everett,DEM,490023,1,2,91,94,02
Mayes,U.S. House,Markwayne Mullin,REP,490023,2,16,352,370,02
Mayes,U.S. House,Jon Douthitt,IND,490023,0,0,14,14,02
Mayes,Governor,Joe Dorman,DEM,490024,3,5,71,79,
Mayes,Governor,Mary Fallin,REP,490024,2,8,174,184,
Mayes,Governor,Kimberly Willis,IND,490024,0,1,6,7,
Mayes,Governor,Richard Prawdzienski,IND,490024,0,0,5,5,
Mayes,Lieutenant Governor,Cathy Cummings,DEM,490024,3,5,58,66,
Mayes,Lieutenant Governor,Todd Lamb,REP,490024,2,9,197,208,
Mayes,Superintendent of Public Instruction,John Cox,DEM,490024,2,7,108,117,
Mayes,Superintendent of Public Instruction,Joy Hofmeister,REP,490024,3,7,146,156,
Mayes,Commissioner of Labor,Mike Workman,DEM,490024,3,5,80,88,
Mayes,Commissioner of Labor,Mark Costello,REP,490024,2,8,170,180,
Mayes,U.S. Senate,Matt Silverstein,DEM,490024,3,4,53,60,
Mayes,U.S. Senate,Jim Inhofe,REP,490024,2,9,195,206,
Mayes,U.S. Senate,Aaron Delozier,IND,490024,0,0,3,3,
Mayes,U.S. Senate,Ray Woods,IND,490024,0,1,5,6,
Mayes,U.S. Senate,Joan Farr,IND,490024,0,0,0,0,
Mayes,U.S. Senate,Connie Johnson,DEM,490024,3,4,59,66,
Mayes,U.S. Senate,James Lankford,REP,490024,2,8,186,196,
Mayes,U.S. Senate,Mark Beard,IND,490024,0,1,10,11,
Mayes,U.S. House,Earl Everett,DEM,490024,3,4,40,47,02
Mayes,U.S. House,Markwayne Mullin,REP,490024,2,8,202,212,02
Mayes,U.S. House,Jon Douthitt,IND,490024,0,1,13,14,02
Mayes,Governor,Joe Dorman,DEM,490025,2,1,88,91,
Mayes,Governor,Mary Fallin,REP,490025,0,8,134,142,
Mayes,Governor,Kimberly Willis,IND,490025,0,0,6,6,
Mayes,Governor,Richard Prawdzienski,IND,490025,0,0,6,6,
Mayes,Lieutenant Governor,Cathy Cummings,DEM,490025,2,1,72,75,
Mayes,Lieutenant Governor,Todd Lamb,REP,490025,0,8,159,167,
Mayes,Superintendent of Public Instruction,John Cox,DEM,490025,2,1,130,133,
Mayes,Superintendent of Public Instruction,Joy Hofmeister,REP,490025,0,8,104,112,
Mayes,Commissioner of Labor,Mike Workman,DEM,490025,2,3,93,98,
Mayes,Commissioner of Labor,Mark Costello,REP,490025,0,6,135,141,
Mayes,U.S. Senate,Matt Silverstein,DEM,490025,2,1,59,62,
Mayes,U.S. Senate,Jim Inhofe,REP,490025,0,7,162,169,
Mayes,U.S. Senate,Aaron Delozier,IND,490025,0,0,5,5,
Mayes,U.S. Senate,Ray Woods,IND,490025,0,1,2,3,
Mayes,U.S. Senate,Joan Farr,IND,490025,0,0,4,4,
Mayes,U.S. Senate,Connie Johnson,DEM,490025,0,1,64,65,
Mayes,U.S. Senate,James Lankford,REP,490025,0,8,158,166,
Mayes,U.S. Senate,Mark Beard,IND,490025,2,0,11,13,
Mayes,U.S. House,Earl Everett,DEM,490025,0,0,53,53,02
Mayes,U.S. House,Markwayne Mullin,REP,490025,0,9,172,181,02
Mayes,U.S. House,Jon Douthitt,IND,490025,2,0,8,10,02
Mayes,State Senate,Charles Arnall,DEM,490025,2,1,79,82,18
Mayes,State Senate,Kim David,REP,490025,0,8,151,159,18
Mayes,Governor,Joe Dorman,DEM,490026,0,0,7,7,
Mayes,Governor,Mary Fallin,REP,490026,1,0,27,28,
Mayes,Governor,Kimberly Willis,IND,490026,0,0,1,1,
Mayes,Governor,Richard Prawdzienski,IND,490026,0,0,1,1,
Mayes,Lieutenant Governor,Cathy Cummings,DEM,490026,0,0,7,7,
Mayes,Lieutenant Governor,Todd Lamb,REP,490026,1,0,29,30,
Mayes,Superintendent of Public Instruction,John Cox,DEM,490026,0,0,13,13,
Mayes,Superintendent of Public Instruction,Joy Hofmeister,REP,490026,1,0,22,23,
Mayes,Commissioner of Labor,Mike Workman,DEM,490026,1,0,9,10,
Mayes,Commissioner of Labor,Mark Costello,REP,490026,0,0,24,24,
Mayes,U.S. Senate,Matt Silverstein,DEM,490026,0,0,3,3,
Mayes,U.S. Senate,Jim Inhofe,REP,490026,1,0,31,32,
Mayes,U.S. Senate,Aaron Delozier,IND,490026,0,0,1,1,
Mayes,U.S. Senate,Ray Woods,IND,490026,0,0,0,0,
Mayes,U.S. Senate,Joan Farr,IND,490026,0,0,0,0,
Mayes,U.S. Senate,Connie Johnson,DEM,490026,1,0,6,7,
Mayes,U.S. Senate,James Lankford,REP,490026,0,0,28,28,
Mayes,U.S. Senate,Mark Beard,IND,490026,0,0,1,1,
Mayes,U.S. House,Earl Everett,DEM,490026,0,0,4,4,02
Mayes,U.S. House,Markwayne Mullin,REP,490026,1,0,32,33,02
Mayes,U.S. House,Jon Douthitt,IND,490026,0,0,0,0,02
Mayes,Governor,Joe Dorman,DEM,490027,0,0,14,14,
Mayes,Governor,Mary Fallin,REP,490027,0,1,31,32,
Mayes,Governor,Kimberly Willis,IND,490027,0,0,1,1,
Mayes,Governor,Richard Prawdzienski,IND,490027,0,0,3,3,
Mayes,Lieutenant Governor,Cathy Cummings,DEM,490027,0,0,13,13,
Mayes,Lieutenant Governor,Todd Lamb,REP,490027,0,1,36,37,
Mayes,Superintendent of Public Instruction,John Cox,DEM,490027,0,0,20,20,
Mayes,Superintendent of Public Instruction,Joy Hofmeister,REP,490027,0,1,29,30,
Mayes,Commissioner of Labor,Mike Workman,DEM,490027,0,0,15,15,
Mayes,Commissioner of Labor,Mark Costello,REP,490027,0,1,34,35,
Mayes,U.S. Senate,Matt Silverstein,DEM,490027,0,0,11,11,
Mayes,U.S. Senate,Jim Inhofe,REP,490027,0,1,33,34,
Mayes,U.S. Senate,Aaron Delozier,IND,490027,0,0,0,0,
Mayes,U.S. Senate,Ray Woods,IND,490027,0,0,1,1,
Mayes,U.S. Senate,Joan Farr,IND,490027,0,0,1,1,
Mayes,U.S. Senate,Connie Johnson,DEM,490027,0,0,11,11,
Mayes,U.S. Senate,James Lankford,REP,490027,0,1,33,34,
Mayes,U.S. Senate,Mark Beard,IND,490027,0,0,5,5,
Mayes,U.S. House,Earl Everett,DEM,490027,0,0,8,8,02
Mayes,U.S. House,Markwayne Mullin,REP,490027,0,0,35,35,02
Mayes,U.S. House,Jon Douthitt,IND,490027,0,0,6,6,02
Mayes,State Senate,Charles Arnall,DEM,490027,0,0,16,16,18
Mayes,State Senate,Kim David,REP,490027,0,0,33,33,18
Mayes,Governor,Joe Dorman,DEM,490031,1,2,166,169,
Mayes,Governor,Mary Fallin,REP,490031,6,6,280,292,
Mayes,Governor,Kimberly Willis,IND,490031,0,0,13,13,
Mayes,Governor,Richard Prawdzienski,IND,490031,0,0,4,4,
Mayes,Lieutenant Governor,Cathy Cummings,DEM,490031,1,2,126,129,
Mayes,Lieutenant Governor,Todd Lamb,REP,490031,6,6,333,345,
Mayes,Superintendent of Public Instruction,John Cox,DEM,490031,1,2,233,236,
Mayes,Superintendent of Public Instruction,Joy Hofmeister,REP,490031,6,6,228,240,
Mayes,Commissioner of Labor,Mike Workman,DEM,490031,1,2,181,184,
Mayes,Commissioner of Labor,Mark Costello,REP,490031,6,6,272,284,
Mayes,U.S. Senate,Matt Silverstein,DEM,490031,1,2,124,127,
Mayes,U.S. Senate,Jim Inhofe,REP,490031,5,6,327,338,
Mayes,U.S. Senate,Aaron Delozier,IND,490031,1,0,4,5,
Mayes,U.S. Senate,Ray Woods,IND,490031,0,0,4,4,
Mayes,U.S. Senate,Joan Farr,IND,490031,0,0,5,5,
Mayes,U.S. Senate,Connie Johnson,DEM,490031,1,2,129,132,
Mayes,U.S. Senate,James Lankford,REP,490031,6,6,318,330,
Mayes,U.S. Senate,Mark Beard,IND,490031,0,0,15,15,
Mayes,U.S. House,Earl Everett,DEM,490031,1,0,93,94,02
Mayes,U.S. House,Markwayne Mullin,REP,490031,6,8,340,354,02
Mayes,U.S. House,Jon Douthitt,IND,490031,0,0,28,28,02
Mayes,Governor,Joe Dorman,DEM,490034,7,3,122,132,
Mayes,Governor,Mary Fallin,REP,490034,5,9,115,129,
Mayes,Governor,Kimberly Willis,IND,490034,0,1,10,11,
Mayes,Governor,Richard Prawdzienski,IND,490034,0,1,8,9,
Mayes,Lieutenant Governor,Cathy Cummings,DEM,490034,7,2,97,106,
Mayes,Lieutenant Governor,Todd Lamb,REP,490034,4,12,155,171,
Mayes,Superintendent of Public Instruction,John Cox,DEM,490034,8,7,172,187,
Mayes,Superintendent of Public Instruction,Joy Hofmeister,REP,490034,5,6,84,95,
Mayes,Commissioner of Labor,Mike Workman,DEM,490034,9,5,133,147,
Mayes,Commissioner of Labor,Mark Costello,REP,490034,3,8,119,130,
Mayes,U.S. Senate,Matt Silverstein,DEM,490034,6,1,91,98,
Mayes,U.S. Senate,Jim Inhofe,REP,490034,4,13,152,169,
Mayes,U.S. Senate,Aaron Delozier,IND,490034,0,0,6,6,
Mayes,U.S. Senate,Ray Woods,IND,490034,0,0,4,4,
Mayes,U.S. Senate,Joan Farr,IND,490034,0,0,4,4,
Mayes,U.S. Senate,Connie Johnson,DEM,490034,6,1,97,104,
Mayes,U.S. Senate,James Lankford,REP,490034,5,13,143,161,
Mayes,U.S. Senate,Mark Beard,IND,490034,0,0,11,11,
Mayes,U.S. House,Earl Everett,DEM,490034,2,2,74,78,02
Mayes,U.S. House,Markwayne Mullin,REP,490034,9,10,163,182,02
Mayes,U.S. House,Jon Douthitt,IND,490034,1,2,17,20,02
Mayes,Governor,Joe Dorman,DEM,490036,6,6,421,433,
Mayes,Governor,Mary Fallin,REP,490036,9,7,384,400,
Mayes,Governor,Kimberly Willis,IND,490036,0,1,28,29,
Mayes,Governor,Richard Prawdzienski,IND,490036,2,1,9,12,
Mayes,Lieutenant Governor,Cathy Cummings,DEM,490036,3,4,322,329,
Mayes,Lieutenant Governor,Todd Lamb,REP,490036,13,11,510,534,
Mayes,Superintendent of Public Instruction,John Cox,DEM,490036,13,11,603,627,
Mayes,Superintendent of Public Instruction,Joy Hofmeister,REP,490036,3,4,237,244,
Mayes,Commissioner of Labor,Mike Workman,DEM,490036,5,4,420,429,
Mayes,Commissioner of Labor,Mark Costello,REP,490036,10,11,405,426,
Mayes,U.S. Senate,Matt Silverstein,DEM,490036,4,4,288,296,
Mayes,U.S. Senate,Jim Inhofe,REP,490036,11,11,525,547,
Mayes,U.S. Senate,Aaron Delozier,IND,490036,1,0,9,10,
Mayes,U.S. Senate,Ray Woods,IND,490036,0,0,6,6,
Mayes,U.S. Senate,Joan Farr,IND,490036,0,0,6,6,
Mayes,U.S. Senate,Connie Johnson,DEM,490036,5,4,288,297,
Mayes,U.S. Senate,James Lankford,REP,490036,10,11,508,529,
Mayes,U.S. Senate,Mark Beard,IND,490036,1,0,32,33,
Mayes,U.S. House,Earl Everett,DEM,490036,4,4,223,231,02
Mayes,U.S. House,Markwayne Mullin,REP,490036,12,11,578,601,02
Mayes,U.S. House,Jon Douthitt,IND,490036,0,0,35,35,02
Mayes,Governor,Joe Dorman,DEM,490037,1,4,187,192,
Mayes,Governor,Mary Fallin,REP,490037,12,8,272,292,
Mayes,Governor,Kimberly Willis,IND,490037,0,2,15,17,
Mayes,Governor,Richard Prawdzienski,IND,490037,0,0,6,6,
Mayes,Lieutenant Governor,Cathy Cummings,DEM,490037,1,3,139,143,
Mayes,Lieutenant Governor,Todd Lamb,REP,490037,12,11,339,362,
Mayes,Superintendent of Public Instruction,John Cox,DEM,490037,3,10,313,326,
Mayes,Superintendent of Public Instruction,Joy Hofmeister,REP,490037,10,4,169,183,
Mayes,Commissioner of Labor,Mike Workman,DEM,490037,2,4,194,200,
Mayes,Commissioner of Labor,Mark Costello,REP,490037,11,9,279,299,
Mayes,U.S. Senate,Matt Silverstein,DEM,490037,1,2,125,128,
Mayes,U.S. Senate,Jim Inhofe,REP,490037,12,10,330,352,
Mayes,U.S. Senate,Aaron Delozier,IND,490037,0,2,11,13,
Mayes,U.S. Senate,Ray Woods,IND,490037,0,0,10,10,
Mayes,U.S. Senate,Joan Farr,IND,490037,0,0,3,3,
Mayes,U.S. Senate,Connie Johnson,DEM,490037,1,3,136,140,
Mayes,U.S. Senate,James Lankford,REP,490037,12,11,313,336,
Mayes,U.S. Senate,Mark Beard,IND,490037,0,0,25,25,
Mayes,U.S. House,Earl Everett,DEM,490037,1,2,101,104,02
Mayes,U.S. House,Markwayne Mullin,REP,490037,12,11,355,378,02
Mayes,U.S. House,Jon Douthitt,IND,490037,0,1,23,24,02
Mayes,Governor,Joe Dorman,DEM,490038,2,6,83,91,
Mayes,Governor,Mary Fallin,REP,490038,4,6,85,95,
Mayes,Governor,Kimberly Willis,IND,490038,0,0,1,1,
Mayes,Governor,Richard Prawdzienski,IND,490038,0,0,1,1,
Mayes,Lieutenant Governor,Cathy Cummings,DEM,490038,0,3,65,68,
Mayes,Lieutenant Governor,Todd Lamb,REP,490038,6,9,102,117,
Mayes,Superintendent of Public Instruction,John Cox,DEM,490038,5,9,120,134,
Mayes,Superintendent of Public Instruction,Joy Hofmeister,REP,490038,1,3,49,53,
Mayes,Commissioner of Labor,Mike Workman,DEM,490038,0,4,82,86,
Mayes,Commissioner of Labor,Mark Costello,REP,490038,4,6,82,92,
Mayes,U.S. Senate,Matt Silverstein,DEM,490038,2,3,72,77,
Mayes,U.S. Senate,Jim Inhofe,REP,490038,4,9,94,107,
Mayes,U.S. Senate,Aaron Delozier,IND,490038,0,0,0,0,
Mayes,U.S. Senate,Ray Woods,IND,490038,0,0,1,1,
Mayes,U.S. Senate,Joan Farr,IND,490038,0,0,1,1,
Mayes,U.S. Senate,Connie Johnson,DEM,490038,0,3,62,65,
Mayes,U.S. Senate,James Lankford,REP,490038,6,9,99,114,
Mayes,U.S. Senate,Mark Beard,IND,490038,0,0,5,5,
Mayes,U.S. House,Earl Everett,DEM,490038,0,3,47,50,02
Mayes,U.S. House,Markwayne Mullin,REP,490038,6,9,110,125,02
Mayes,U.S. House,Jon Douthitt,IND,490038,0,0,8,8,02
Mayes,Governor,Joe Dorman,DEM,490039,1,5,268,274,
Mayes,Governor,Mary Fallin,REP,490039,2,10,224,236,
Mayes,Governor,Kimberly Willis,IND,490039,0,0,13,13,
Mayes,Governor,Richard Prawdzienski,IND,490039,0,0,4,4,
Mayes,Lieutenant Governor,Cathy Cummings,DEM,490039,0,3,204,207,
Mayes,Lieutenant Governor,Todd Lamb,REP,490039,3,11,300,314,
Mayes,Superintendent of Public Instruction,John Cox,DEM,490039,1,10,371,382,
Mayes,Superintendent of Public Instruction,Joy Hofmeister,REP,490039,2,5,140,147,
Mayes,Commissioner of Labor,Mike Workman,DEM,490039,1,6,269,276,
Mayes,Commissioner of Labor,Mark Costello,REP,490039,2,8,227,237,
Mayes,U.S. Senate,Matt Silverstein,DEM,490039,0,1,193,194,
Mayes,U.S. Senate,Jim Inhofe,REP,490039,3,11,292,306,
Mayes,U.S. Senate,Aaron Delozier,IND,490039,0,0,12,12,
Mayes,U.S. Senate,Ray Woods,IND,490039,0,2,6,8,
Mayes,U.S. Senate,Joan Farr,IND,490039,0,0,5,5,
Mayes,U.S. Senate,Connie Johnson,DEM,490039,0,3,192,195,
Mayes,U.S. Senate,James Lankford,REP,490039,3,8,289,300,
Mayes,U.S. Senate,Mark Beard,IND,490039,0,3,20,23,
Mayes,U.S. House,Earl Everett,DEM,490039,1,1,157,159,02
Mayes,U.S. House,Markwayne Mullin,REP,490039,2,12,327,341,02
Mayes,U.S. House,Jon Douthitt,IND,490039,0,1,22,23,02
Mayes,Governor,Joe Dorman,DEM,490101,2,14,110,126,
Mayes,Governor,Mary Fallin,REP,490101,4,4,117,125,
Mayes,Governor,Kimberly Willis,IND,490101,1,1,5,7,
Mayes,Governor,Richard Prawdzienski,IND,490101,0,0,2,2,
Mayes,Lieutenant Governor,Cathy Cummings,DEM,490101,2,7,88,97,
Mayes,Lieutenant Governor,Todd Lamb,REP,490101,5,11,146,162,
Mayes,Superintendent of Public Instruction,John Cox,DEM,490101,3,16,151,170,
Mayes,Superintendent of Public Instruction,Joy Hofmeister,REP,490101,4,3,81,88,
Mayes,Commissioner of Labor,Mike Workman,DEM,490101,2,10,114,126,
Mayes,Commissioner of Labor,Mark Costello,REP,490101,5,8,113,126,
Mayes,U.S. Senate,Matt Silverstein,DEM,490101,2,10,89,101,
Mayes,U.S. Senate,Jim Inhofe,REP,490101,4,9,137,150,
Mayes,U.S. Senate,Aaron Delozier,IND,490101,1,0,6,7,
Mayes,U.S. Senate,Ray Woods,IND,490101,0,0,1,1,
Mayes,U.S. Senate,Joan Farr,IND,490101,0,0,1,1,
Mayes,U.S. Senate,Connie Johnson,DEM,490101,2,9,79,90,
Mayes,U.S. Senate,James Lankford,REP,490101,4,10,148,162,
Mayes,U.S. Senate,Mark Beard,IND,490101,1,0,5,6,
Mayes,U.S. House,Earl Everett,DEM,490101,3,8,61,72,02
Mayes,U.S. House,Markwayne Mullin,REP,490101,4,11,155,170,02
Mayes,U.S. House,Jon Douthitt,IND,490101,0,0,17,17,02
Mayes,Governor,Joe Dorman,DEM,490121,3,16,183,202,
Mayes,Governor,Mary Fallin,REP,490121,8,18,231,257,
Mayes,Governor,Kimberly Willis,IND,490121,1,0,9,10,
Mayes,Governor,Richard Prawdzienski,IND,490121,0,0,6,6,
Mayes,Lieutenant Governor,Cathy Cummings,DEM,490121,3,10,125,138,
Mayes,Lieutenant Governor,Todd Lamb,REP,490121,9,24,299,332,
Mayes,Superintendent of Public Instruction,John Cox,DEM,490121,4,24,262,290,
Mayes,Superintendent of Public Instruction,Joy Hofmeister,REP,490121,6,10,167,183,
Mayes,Commissioner of Labor,Mike Workman,DEM,490121,4,15,182,201,
Mayes,Commissioner of Labor,Mark Costello,REP,490121,7,18,240,265,
Mayes,U.S. Senate,Matt Silverstein,DEM,490121,3,10,112,125,
Mayes,U.S. Senate,Jim Inhofe,REP,490121,9,22,298,329,
Mayes,U.S. Senate,Aaron Delozier,IND,490121,0,0,11,11,
Mayes,U.S. Senate,Ray Woods,IND,490121,0,1,1,2,
Mayes,U.S. Senate,Joan Farr,IND,490121,0,1,4,5,
Mayes,U.S. Senate,Connie Johnson,DEM,490121,3,12,116,131,
Mayes,U.S. Senate,James Lankford,REP,490121,9,22,296,327,
Mayes,U.S. Senate,Mark Beard,IND,490121,0,0,15,15,
Mayes,U.S. House,Earl Everett,DEM,490121,3,9,87,99,02
Mayes,U.S. House,Markwayne Mullin,REP,490121,9,24,317,350,02
Mayes,U.S. House,Jon Douthitt,IND,490121,0,1,24,25,02
Mayes,Governor,Joe Dorman,DEM,490122,1,2,25,28,
Mayes,Governor,Mary Fallin,REP,490122,2,2,38,42,
Mayes,Governor,Kimberly Willis,IND,490122,0,0,0,0,
Mayes,Governor,Richard Prawdzienski,IND,490122,0,0,1,1,
Mayes,Lieutenant Governor,Cathy Cummings,DEM,490122,1,1,17,19,
Mayes,Lieutenant Governor,Todd Lamb,REP,490122,2,3,47,52,
Mayes,Superintendent of Public Instruction,John Cox,DEM,490122,1,2,35,38,
Mayes,Superintendent of Public Instruction,Joy Hofmeister,REP,490122,2,2,29,33,
Mayes,Commissioner of Labor,Mike Workman,DEM,490122,1,2,25,28,
Mayes,Commissioner of Labor,Mark Costello,REP,490122,2,2,39,43,
Mayes,U.S. Senate,Matt Silverstein,DEM,490122,1,1,17,19,
Mayes,U.S. Senate,Jim Inhofe,REP,490122,2,3,46,51,
Mayes,U.S. Senate,Aaron Delozier,IND,490122,0,0,1,1,
Mayes,U.S. Senate,Ray Woods,IND,490122,0,0,0,0,
Mayes,U.S. Senate,Joan Farr,IND,490122,0,0,0,0,
Mayes,U.S. Senate,Connie Johnson,DEM,490122,1,0,12,13,
Mayes,U.S. Senate,James Lankford,REP,490122,2,4,49,55,
Mayes,U.S. Senate,Mark Beard,IND,490122,0,0,3,3,
Mayes,U.S. House,Earl Everett,DEM,490122,1,0,6,7,02
Mayes,U.S. House,Markwayne Mullin,REP,490122,2,4,56,62,02
Mayes,U.S. House,Jon Douthitt,IND,490122,0,0,2,2,02
Mayes,Governor,Joe Dorman,DEM,490130,3,12,123,138,
Mayes,Governor,Mary Fallin,REP,490130,2,11,182,195,
Mayes,Governor,Kimberly Willis,IND,490130,0,0,10,10,
Mayes,Governor,Richard Prawdzienski,IND,490130,0,0,2,2,
Mayes,Lieutenant Governor,Cathy Cummings,DEM,490130,2,10,94,106,
Mayes,Lieutenant Governor,Todd Lamb,REP,490130,3,13,224,240,
Mayes,Superintendent of Public Instruction,John Cox,DEM,490130,3,18,171,192,
Mayes,Superintendent of Public Instruction,Joy Hofmeister,REP,490130,2,5,147,154,
Mayes,Commissioner of Labor,Mike Workman,DEM,490130,4,13,134,151,
Mayes,Commissioner of Labor,Mark Costello,REP,490130,1,9,177,187,
Mayes,U.S. Senate,Matt Silverstein,DEM,490130,3,6,87,96,
Mayes,U.S. Senate,Jim Inhofe,REP,490130,2,16,207,225,
Mayes,U.S. Senate,Aaron Delozier,IND,490130,0,1,14,15,
Mayes,U.S. Senate,Ray Woods,IND,490130,0,0,3,3,
Mayes,U.S. Senate,Joan Farr,IND,490130,0,0,5,5,
Mayes,U.S. Senate,Connie Johnson,DEM,490130,2,7,88,97,
Mayes,U.S. Senate,James Lankford,REP,490130,3,15,220,238,
Mayes,U.S. Senate,Mark Beard,IND,490130,0,1,9,10,
Mayes,U.S. House,Earl Everett,DEM,490130,2,5,64,71,02
Mayes,U.S. House,Markwayne Mullin,REP,490130,2,17,237,256,02
Mayes,U.S. House,Jon Douthitt,IND,490130,0,1,17,18,02
Mayes,Governor,Joe Dorman,DEM,490132,4,15,171,190,
Mayes,Governor,Mary Fallin,REP,490132,4,22,155,181,
Mayes,Governor,Kimberly Willis,IND,490132,0,0,10,10,
Mayes,Governor,Richard Prawdzienski,IND,490132,0,0,2,2,
Mayes,Lieutenant Governor,Cathy Cummings,DEM,490132,4,9,132,145,
Mayes,Lieutenant Governor,Todd Lamb,REP,490132,4,28,201,233,
Mayes,Superintendent of Public Instruction,John Cox,DEM,490132,4,24,220,248,
Mayes,Superintendent of Public Instruction,Joy Hofmeister,REP,490132,4,13,117,134,
Mayes,Commissioner of Labor,Mike Workman,DEM,490132,4,13,176,193,
Mayes,Commissioner of Labor,Mark Costello,REP,490132,4,23,149,176,
Mayes,U.S. Senate,Matt Silverstein,DEM,490132,4,10,115,129,
Mayes,U.S. Senate,Jim Inhofe,REP,490132,4,26,211,241,
Mayes,U.S. Senate,Aaron Delozier,IND,490132,0,0,3,3,
Mayes,U.S. Senate,Ray Woods,IND,490132,0,0,6,6,
Mayes,U.S. Senate,Joan Farr,IND,490132,0,0,2,2,
Mayes,U.S. Senate,Connie Johnson,DEM,490132,4,3,117,124,
Mayes,U.S. Senate,James Lankford,REP,490132,4,32,204,240,
Mayes,U.S. Senate,Mark Beard,IND,490132,0,1,10,11,
Mayes,U.S. House,Earl Everett,DEM,490132,4,7,94,105,02
Mayes,U.S. House,Markwayne Mullin,REP,490132,4,30,222,256,02
Mayes,U.S. House,Jon Douthitt,IND,490132,0,0,17,17,02
Mayes,Governor,Joe Dorman,DEM,490241,5,40,316,361,
Mayes,Governor,Mary Fallin,REP,490241,6,48,376,430,
Mayes,Governor,Kimberly Willis,IND,490241,0,1,14,15,
Mayes,Governor,Richard Prawdzienski,IND,490241,0,0,5,5,
Mayes,Lieutenant Governor,Cathy Cummings,DEM,490241,5,21,195,221,
Mayes,Lieutenant Governor,Todd Lamb,REP,490241,6,68,513,587,
Mayes,Superintendent of Public Instruction,John Cox,DEM,490241,10,53,454,517,
Mayes,Superintendent of Public Instruction,Joy Hofmeister,REP,490241,1,36,258,295,
Mayes,Commissioner of Labor,Mike Workman,DEM,490241,5,33,281,319,
Mayes,Commissioner of Labor,Mark Costello,REP,490241,6,52,420,478,
Mayes,U.S. Senate,Matt Silverstein,DEM,490241,6,24,197,227,
Mayes,U.S. Senate,Jim Inhofe,REP,490241,4,64,490,558,
Mayes,U.S. Senate,Aaron Delozier,IND,490241,1,1,9,11,
Mayes,U.S. Senate,Ray Woods,IND,490241,0,0,8,8,
Mayes,U.S. Senate,Joan Farr,IND,490241,0,0,4,4,
Mayes,U.S. Senate,Connie Johnson,DEM,490241,5,22,180,207,
Mayes,U.S. Senate,James Lankford,REP,490241,6,66,507,579,
Mayes,U.S. Senate,Mark Beard,IND,490241,0,1,23,24,
Mayes,U.S. House,Earl Everett,DEM,490241,4,17,135,156,02
Mayes,U.S. House,Markwayne Mullin,REP,490241,6,68,545,619,02
Mayes,U.S. House,Jon Douthitt,IND,490241,1,4,28,33,02
Mayes,Governor,Joe Dorman,DEM,490242,1,12,172,185,
Mayes,Governor,Mary Fallin,REP,490242,2,13,184,199,
Mayes,Governor,Kimberly Willis,IND,490242,0,0,6,6,
Mayes,Governor,Richard Prawdzienski,IND,490242,1,0,5,6,
Mayes,Lieutenant Governor,Cathy Cummings,DEM,490242,2,7,105,114,
Mayes,Lieutenant Governor,Todd Lamb,REP,490242,1,18,265,284,
Mayes,Superintendent of Public Instruction,John Cox,DEM,490242,3,19,249,271,
Mayes,Superintendent of Public Instruction,Joy Hofmeister,REP,490242,1,6,119,126,
Mayes,Commissioner of Labor,Mike Workman,DEM,490242,1,12,153,166,
Mayes,Commissioner of Labor,Mark Costello,REP,490242,0,12,210,222,
Mayes,U.S. Senate,Matt Silverstein,DEM,490242,1,9,112,122,
Mayes,U.S. Senate,Jim Inhofe,REP,490242,2,14,244,260,
Mayes,U.S. Senate,Aaron Delozier,IND,490242,0,0,12,12,
Mayes,U.S. Senate,Ray Woods,IND,490242,0,0,0,0,
Mayes,U.S. Senate,Joan Farr,IND,490242,1,1,2,4,
Mayes,U.S. Senate,Connie Johnson,DEM,490242,1,6,101,108,
Mayes,U.S. Senate,James Lankford,REP,490242,2,19,258,279,
Mayes,U.S. Senate,Mark Beard,IND,490242,1,0,8,9,
Mayes,U.S. House,Earl Everett,DEM,490242,1,7,71,79,02
Mayes,U.S. House,Markwayne Mullin,REP,490242,2,18,280,300,02
Mayes,U.S. House,Jon Douthitt,IND,490242,1,0,17,18,02
Mayes,Governor,Joe Dorman,DEM,490311,0,1,111,112,
Mayes,Governor,Mary Fallin,REP,490311,0,2,123,125,
Mayes,Governor,Kimberly Willis,IND,490311,0,0,5,5,
Mayes,Governor,Richard Prawdzienski,IND,490311,0,0,4,4,
Mayes,Lieutenant Governor,Cathy Cummings,DEM,490311,0,1,87,88,
Mayes,Lieutenant Governor,Todd Lamb,REP,490311,0,2,149,151,
Mayes,Superintendent of Public Instruction,John Cox,DEM,490311,0,1,179,180,
Mayes,Superintendent of Public Instruction,Joy Hofmeister,REP,490311,0,2,62,64,
Mayes,Commissioner of Labor,Mike Workman,DEM,490311,0,1,117,118,
Mayes,Commissioner of Labor,Mark Costello,REP,490311,0,2,116,118,
Mayes,U.S. Senate,Matt Silverstein,DEM,490311,0,1,78,79,
Mayes,U.S. Senate,Jim Inhofe,REP,490311,0,2,156,158,
Mayes,U.S. Senate,Aaron Delozier,IND,490311,0,0,7,7,
Mayes,U.S. Senate,Ray Woods,IND,490311,0,0,1,1,
Mayes,U.S. Senate,Joan Farr,IND,490311,0,0,1,1,
Mayes,U.S. Senate,Connie Johnson,DEM,490311,0,0,84,84,
Mayes,U.S. Senate,James Lankford,REP,490311,0,3,143,146,
Mayes,U.S. Senate,Mark Beard,IND,490311,0,0,14,14,
Mayes,U.S. House,Earl Everett,DEM,490311,0,1,66,67,02
Mayes,U.S. House,Markwayne Mullin,REP,490311,0,2,164,166,02
Mayes,U.S. House,Jon Douthitt,IND,490311,0,0,11,11,02
Mayes,State Senate,Charles Arnall,DEM,490311,0,1,95,96,18
Mayes,State Senate,Kim David,REP,490311,0,2,139,141,18
Murray,Governor,Joe Dorman,DEM,500004,3,9,151,163,
Murray,Governor,Mary Fallin,REP,500004,3,27,229,259,
Murray,Governor,Kimberly Willis,IND,500004,0,0,9,9,
Murray,Governor,Richard Prawdzienski,IND,500004,0,0,4,4,
Murray,Lieutenant Governor,Cathy Cummings,DEM,500004,4,7,109,120,
Murray,Lieutenant Governor,Todd Lamb,REP,500004,2,29,281,312,
Murray,Superintendent of Public Instruction,John Cox,DEM,500004,4,11,171,186,
Murray,Superintendent of Public Instruction,Joy Hofmeister,REP,500004,2,25,214,241,
Murray,Commissioner of Labor,Mike Workman,DEM,500004,4,10,145,159,
Murray,Commissioner of Labor,Mark Costello,REP,500004,2,26,231,259,
Murray,U.S. Senate,Matt Silverstein,DEM,500004,3,3,78,84,
Murray,U.S. Senate,Jim Inhofe,REP,500004,3,33,293,329,
Murray,U.S. Senate,Aaron Delozier,IND,500004,0,0,5,5,
Murray,U.S. Senate,Ray Woods,IND,500004,0,0,7,7,
Murray,U.S. Senate,Joan Farr,IND,500004,0,0,7,7,
Murray,U.S. Senate,Connie Johnson,DEM,500004,3,7,84,94,
Murray,U.S. Senate,James Lankford,REP,500004,3,28,291,322,
Murray,U.S. Senate,Mark Beard,IND,500004,0,1,12,13,
Murray,U.S. House,Bert Smith,DEM,500004,2,4,75,81,04
Murray,U.S. House,Tom Cole,REP,500004,4,30,303,337,04
Murray,U.S. House,Dennis Johnson,IND,500004,0,2,10,12,04
Murray,State Senate,Chequita Williams,DEM,500004,3,5,86,94,14
Murray,State Senate,Frank Simpson,REP,500004,3,31,299,333,14
Murray,Governor,Joe Dorman,DEM,500005,1,4,270,275,
Murray,Governor,Mary Fallin,REP,500005,3,13,277,293,
Murray,Governor,Kimberly Willis,IND,500005,0,1,15,16,
Murray,Governor,Richard Prawdzienski,IND,500005,0,1,9,10,
Murray,Lieutenant Governor,Cathy Cummings,DEM,500005,1,3,197,201,
Murray,Lieutenant Governor,Todd Lamb,REP,500005,3,15,372,390,
Murray,Superintendent of Public Instruction,John Cox,DEM,500005,1,8,288,297,
Murray,Superintendent of Public Instruction,Joy Hofmeister,REP,500005,3,12,283,298,
Murray,Commissioner of Labor,Mike Workman,DEM,500005,1,4,243,248,
Murray,Commissioner of Labor,Mark Costello,REP,500005,3,14,314,331,
Murray,U.S. Senate,Matt Silverstein,DEM,500005,1,2,152,155,
Murray,U.S. Senate,Jim Inhofe,REP,500005,3,17,387,407,
Murray,U.S. Senate,Aaron Delozier,IND,500005,0,0,9,9,
Murray,U.S. Senate,Ray Woods,IND,500005,0,0,8,8,
Murray,U.S. Senate,Joan Farr,IND,500005,0,1,14,15,
Murray,U.S. Senate,Connie Johnson,DEM,500005,1,3,150,154,
Murray,U.S. Senate,James Lankford,REP,500005,3,14,405,422,
Murray,U.S. Senate,Mark Beard,IND,500005,0,1,17,18,
Murray,U.S. House,Bert Smith,DEM,500005,1,2,132,135,04
Murray,U.S. House,Tom Cole,REP,500005,3,16,413,432,04
Murray,U.S. House,Dennis Johnson,IND,500005,0,1,25,26,04
Murray,State Senate,Chequita Williams,DEM,500005,1,4,150,155,14
Murray,State Senate,Frank Simpson,REP,500005,3,14,416,433,14
Murray,Governor,Joe Dorman,DEM,500007,0,3,79,82,
Murray,Governor,Mary Fallin,REP,500007,4,1,92,97,
Murray,Governor,Kimberly Willis,IND,500007,0,0,5,5,
Murray,Governor,Richard Prawdzienski,IND,500007,0,0,0,0,
Murray,Lieutenant Governor,Cathy Cummings,DEM,500007,0,3,48,51,
Murray,Lieutenant Governor,Todd Lamb,REP,500007,4,1,127,132,
Murray,Superintendent of Public Instruction,John Cox,DEM,500007,2,3,89,94,
Murray,Superintendent of Public Instruction,Joy Hofmeister,REP,500007,2,1,85,88,
Murray,Commissioner of Labor,Mike Workman,DEM,500007,0,3,77,80,
Murray,Commissioner of Labor,Mark Costello,REP,500007,4,1,97,102,
Murray,U.S. Senate,Matt Silverstein,DEM,500007,0,3,44,47,
Murray,U.S. Senate,Jim Inhofe,REP,500007,4,1,127,132,
Murray,U.S. Senate,Aaron Delozier,IND,500007,0,0,1,1,
Murray,U.S. Senate,Ray Woods,IND,500007,0,0,2,2,
Murray,U.S. Senate,Joan Farr,IND,500007,0,0,3,3,
Murray,U.S. Senate,Connie Johnson,DEM,500007,0,2,45,47,
Murray,U.S. Senate,James Lankford,REP,500007,4,2,126,132,
Murray,U.S. Senate,Mark Beard,IND,500007,0,0,4,4,
Murray,U.S. House,Bert Smith,DEM,500007,0,2,37,39,04
Murray,U.S. House,Tom Cole,REP,500007,4,2,133,139,04
Murray,U.S. House,Dennis Johnson,IND,500007,0,0,7,7,04
Murray,State Senate,Chequita Williams,DEM,500007,0,3,47,50,14
Murray,State Senate,Frank Simpson,REP,500007,4,1,129,134,14
Murray,Governor,Joe Dorman,DEM,500009,2,6,80,88,
Murray,Governor,Mary Fallin,REP,500009,1,9,101,111,
Murray,Governor,Kimberly Willis,IND,500009,0,1,4,5,
Murray,Governor,Richard Prawdzienski,IND,500009,0,0,4,4,
Murray,Lieutenant Governor,Cathy Cummings,DEM,500009,2,4,50,56,
Murray,Lieutenant Governor,Todd Lamb,REP,500009,1,12,138,151,
Murray,Superintendent of Public Instruction,John Cox,DEM,500009,2,8,83,93,
Murray,Superintendent of Public Instruction,Joy Hofmeister,REP,500009,1,8,105,114,
Murray,Commissioner of Labor,Mike Workman,DEM,500009,1,7,79,87,
Murray,Commissioner of Labor,Mark Costello,REP,500009,1,8,103,112,
Murray,U.S. Senate,Matt Silverstein,DEM,500009,2,2,47,51,
Murray,U.S. Senate,Jim Inhofe,REP,500009,1,13,140,154,
Murray,U.S. Senate,Aaron Delozier,IND,500009,0,0,0,0,
Murray,U.S. Senate,Ray Woods,IND,500009,0,1,1,2,
Murray,U.S. Senate,Joan Farr,IND,500009,0,0,0,0,
Murray,U.S. Senate,Connie Johnson,DEM,500009,2,2,45,49,
Murray,U.S. Senate,James Lankford,REP,500009,1,14,142,157,
Murray,U.S. Senate,Mark Beard,IND,500009,0,0,1,1,
Murray,U.S. House,Bert Smith,DEM,500009,2,3,40,45,04
Murray,U.S. House,Tom Cole,REP,500009,1,12,143,156,04
Murray,U.S. House,Dennis Johnson,IND,500009,0,1,4,5,04
Murray,State Senate,Chequita Williams,DEM,500009,1,4,54,59,14
Murray,State Senate,Frank Simpson,REP,500009,2,12,133,147,14
Murray,Governor,Joe Dorman,DEM,500012,2,0,65,67,
Murray,Governor,Mary Fallin,REP,500012,4,2,103,109,
Murray,Governor,Kimberly Willis,IND,500012,0,1,4,5,
Murray,Governor,Richard Prawdzienski,IND,500012,0,0,5,5,
Murray,Lieutenant Governor,Cathy Cummings,DEM,500012,2,0,47,49,
Murray,Lieutenant Governor,Todd Lamb,REP,500012,4,3,130,137,
Murray,Superintendent of Public Instruction,John Cox,DEM,500012,2,0,78,80,
Murray,Superintendent of Public Instruction,Joy Hofmeister,REP,500012,4,3,98,105,
Murray,Commissioner of Labor,Mike Workman,DEM,500012,2,1,69,72,
Murray,Commissioner of Labor,Mark Costello,REP,500012,4,2,105,111,
Murray,U.S. Senate,Matt Silverstein,DEM,500012,0,0,42,42,
Murray,U.S. Senate,Jim Inhofe,REP,500012,6,3,128,137,
Murray,U.S. Senate,Aaron Delozier,IND,500012,0,0,1,1,
Murray,U.S. Senate,Ray Woods,IND,500012,0,0,4,4,
Murray,U.S. Senate,Joan Farr,IND,500012,0,0,0,0,
Murray,U.S. Senate,Connie Johnson,DEM,500012,0,0,40,40,
Murray,U.S. Senate,James Lankford,REP,500012,6,3,128,137,
Murray,U.S. Senate,Mark Beard,IND,500012,0,0,8,8,
Murray,U.S. House,Bert Smith,DEM,500012,0,0,38,38,04
Murray,U.S. House,Tom Cole,REP,500012,6,3,130,139,04
Murray,U.S. House,Dennis Johnson,IND,500012,0,0,8,8,04
Murray,State Senate,Chequita Williams,DEM,500012,0,1,42,43,14
Murray,State Senate,Frank Simpson,REP,500012,6,2,133,141,14
Murray,Governor,Joe Dorman,DEM,500014,1,4,49,54,
Murray,Governor,Mary Fallin,REP,500014,4,0,41,45,
Murray,Governor,Kimberly Willis,IND,500014,0,0,0,0,
Murray,Governor,Richard Prawdzienski,IND,500014,0,0,2,2,
Murray,Lieutenant Governor,Cathy Cummings,DEM,500014,1,1,34,36,
Murray,Lieutenant Governor,Todd Lamb,REP,500014,4,2,56,62,
Murray,Superintendent of Public Instruction,John Cox,DEM,500014,1,2,51,54,
Murray,Superintendent of Public Instruction,Joy Hofmeister,REP,500014,4,2,39,45,
Murray,Commissioner of Labor,Mike Workman,DEM,500014,1,2,50,53,
Murray,Commissioner of Labor,Mark Costello,REP,500014,4,1,40,45,
Murray,U.S. Senate,Matt Silverstein,DEM,500014,1,1,25,27,
Murray,U.S. Senate,Jim Inhofe,REP,500014,4,2,63,69,
Murray,U.S. Senate,Aaron Delozier,IND,500014,0,0,0,0,
Murray,U.S. Senate,Ray Woods,IND,500014,0,0,1,1,
Murray,U.S. Senate,Joan Farr,IND,500014,0,0,2,2,
Murray,U.S. Senate,Connie Johnson,DEM,500014,1,1,31,33,
Murray,U.S. Senate,James Lankford,REP,500014,4,2,59,65,
Murray,U.S. Senate,Mark Beard,IND,500014,0,0,0,0,
Murray,U.S. House,Bert Smith,DEM,500014,1,1,25,27,04
Murray,U.S. House,Tom Cole,REP,500014,4,2,65,71,04
Murray,U.S. House,Dennis Johnson,IND,500014,0,0,1,1,04
Murray,State Senate,Chequita Williams,DEM,500014,1,1,37,39,14
Murray,State Senate,Frank Simpson,REP,500014,4,3,55,62,14
Murray,Governor,Joe Dorman,DEM,500015,6,23,163,192,
Murray,Governor,Mary Fallin,REP,500015,9,42,238,289,
Murray,Governor,Kimberly Willis,IND,500015,0,0,9,9,
Murray,Governor,Richard Prawdzienski,IND,500015,1,0,3,4,
Murray,Lieutenant Governor,Cathy Cummings,DEM,500015,5,18,120,143,
Murray,Lieutenant Governor,Todd Lamb,REP,500015,11,47,292,350,
Murray,Superintendent of Public Instruction,John Cox,DEM,500015,10,29,191,230,
Murray,Superintendent of Public Instruction,Joy Hofmeister,REP,500015,6,36,216,258,
Murray,Commissioner of Labor,Mike Workman,DEM,500015,8,20,176,204,
Murray,Commissioner of Labor,Mark Costello,REP,500015,8,44,220,272,
Murray,U.S. Senate,Matt Silverstein,DEM,500015,6,14,117,137,
Murray,U.S. Senate,Jim Inhofe,REP,500015,10,49,279,338,
Murray,U.S. Senate,Aaron Delozier,IND,500015,0,1,4,5,
Murray,U.S. Senate,Ray Woods,IND,500015,0,0,2,2,
Murray,U.S. Senate,Joan Farr,IND,500015,0,0,7,7,
Murray,U.S. Senate,Connie Johnson,DEM,500015,5,19,112,136,
Murray,U.S. Senate,James Lankford,REP,500015,9,44,289,342,
Murray,U.S. Senate,Mark Beard,IND,500015,1,2,5,8,
Murray,U.S. House,Bert Smith,DEM,500015,6,11,86,103,04
Murray,U.S. House,Tom Cole,REP,500015,8,50,311,369,04
Murray,U.S. House,Dennis Johnson,IND,500015,1,2,13,16,04
Murray,State Senate,Chequita Williams,DEM,500015,5,12,112,129,14
Murray,State Senate,Frank Simpson,REP,500015,11,53,289,353,14
Murray,Governor,Joe Dorman,DEM,500017,0,1,21,22,
Murray,Governor,Mary Fallin,REP,500017,0,2,29,31,
Murray,Governor,Kimberly Willis,IND,500017,0,0,2,2,
Murray,Governor,Richard Prawdzienski,IND,500017,0,0,1,1,
Murray,Lieutenant Governor,Cathy Cummings,DEM,500017,0,0,18,18,
Murray,Lieutenant Governor,Todd Lamb,REP,500017,0,3,35,38,
Murray,Superintendent of Public Instruction,John Cox,DEM,500017,0,0,33,33,
Murray,Superintendent of Public Instruction,Joy Hofmeister,REP,500017,0,3,19,22,
Murray,Commissioner of Labor,Mike Workman,DEM,500017,0,0,22,22,
Murray,Commissioner of Labor,Mark Costello,REP,500017,0,3,29,32,
Murray,U.S. Senate,Matt Silverstein,DEM,500017,0,0,10,10,
Murray,U.S. Senate,Jim Inhofe,REP,500017,0,3,41,44,
Murray,U.S. Senate,Aaron Delozier,IND,500017,0,0,0,0,
Murray,U.S. Senate,Ray Woods,IND,500017,0,0,1,1,
Murray,U.S. Senate,Joan Farr,IND,500017,0,0,1,1,
Murray,U.S. Senate,Connie Johnson,DEM,500017,0,0,9,9,
Murray,U.S. Senate,James Lankford,REP,500017,0,3,41,44,
Murray,U.S. Senate,Mark Beard,IND,500017,0,0,3,3,
Murray,U.S. House,Bert Smith,DEM,500017,0,0,7,7,04
Murray,U.S. House,Tom Cole,REP,500017,0,3,42,45,04
Murray,U.S. House,Dennis Johnson,IND,500017,0,0,4,4,04
Murray,State Senate,Chequita Williams,DEM,500017,0,0,10,10,14
Murray,State Senate,Frank Simpson,REP,500017,0,3,43,46,14
Murray,Governor,Joe Dorman,DEM,500018,1,7,100,108,
Murray,Governor,Mary Fallin,REP,500018,3,8,134,145,
Murray,Governor,Kimberly Willis,IND,500018,0,0,3,3,
Murray,Governor,Richard Prawdzienski,IND,500018,0,0,1,1,
Murray,Lieutenant Governor,Cathy Cummings,DEM,500018,1,3,68,72,
Murray,Lieutenant Governor,Todd Lamb,REP,500018,3,11,168,182,
Murray,Superintendent of Public Instruction,John Cox,DEM,500018,1,9,108,118,
Murray,Superintendent of Public Instruction,Joy Hofmeister,REP,500018,3,6,126,135,
Murray,Commissioner of Labor,Mike Workman,DEM,500018,1,4,86,91,
Murray,Commissioner of Labor,Mark Costello,REP,500018,3,9,139,151,
Murray,U.S. Senate,Matt Silverstein,DEM,500018,0,2,52,54,
Murray,U.S. Senate,Jim Inhofe,REP,500018,4,13,178,195,
Murray,U.S. Senate,Aaron Delozier,IND,500018,0,0,2,2,
Murray,U.S. Senate,Ray Woods,IND,500018,0,0,4,4,
Murray,U.S. Senate,Joan Farr,IND,500018,0,0,0,0,
Murray,U.S. Senate,Connie Johnson,DEM,500018,0,1,52,53,
Murray,U.S. Senate,James Lankford,REP,500018,4,14,173,191,
Murray,U.S. Senate,Mark Beard,IND,500018,0,0,8,8,
Murray,U.S. House,Bert Smith,DEM,500018,0,3,48,51,04
Murray,U.S. House,Tom Cole,REP,500018,4,12,182,198,04
Murray,U.S. House,Dennis Johnson,IND,500018,0,0,4,4,04
Murray,State Senate,Chequita Williams,DEM,500018,0,1,56,57,14
Murray,State Senate,Frank Simpson,REP,500018,4,13,172,189,14
Murray,Governor,Joe Dorman,DEM,500020,7,26,167,200,
Murray,Governor,Mary Fallin,REP,500020,6,22,199,227,
Murray,Governor,Kimberly Willis,IND,500020,0,0,6,6,
Murray,Governor,Richard Prawdzienski,IND,500020,0,0,4,4,
Murray,Lieutenant Governor,Cathy Cummings,DEM,500020,5,17,101,123,
Murray,Lieutenant Governor,Todd Lamb,REP,500020,8,32,272,312,
Murray,Superintendent of Public Instruction,John Cox,DEM,500020,7,26,182,215,
Murray,Superintendent of Public Instruction,Joy Hofmeister,REP,500020,6,22,187,215,
Murray,Commissioner of Labor,Mike Workman,DEM,500020,6,20,140,166,
Murray,Commissioner of Labor,Mark Costello,REP,500020,7,27,224,258,
Murray,U.S. Senate,Matt Silverstein,DEM,500020,4,18,88,110,
Murray,U.S. Senate,Jim Inhofe,REP,500020,8,29,267,304,
Murray,U.S. Senate,Aaron Delozier,IND,500020,0,1,2,3,
Murray,U.S. Senate,Ray Woods,IND,500020,1,0,6,7,
Murray,U.S. Senate,Joan Farr,IND,500020,0,1,5,6,
Murray,U.S. Senate,Connie Johnson,DEM,500020,5,20,77,102,
Murray,U.S. Senate,James Lankford,REP,500020,7,29,282,318,
Murray,U.S. Senate,Mark Beard,IND,500020,1,0,14,15,
Murray,U.S. House,Bert Smith,DEM,500020,4,14,75,93,04
Murray,U.S. House,Tom Cole,REP,500020,9,33,285,327,04
Murray,U.S. House,Dennis Johnson,IND,500020,0,2,12,14,04
Murray,State Senate,Chequita Williams,DEM,500020,6,17,83,106,14
Murray,State Senate,Frank Simpson,REP,500020,7,32,290,329,14
Muskogee,Governor,Joe Dorman,DEM,510005,9,28,316,353,
Muskogee,Governor,Mary Fallin,REP,510005,3,15,247,265,
Muskogee,Governor,Kimberly Willis,IND,510005,2,0,16,18,
Muskogee,Governor,Richard Prawdzienski,IND,510005,0,1,11,12,
Muskogee,Lieutenant Governor,Cathy Cummings,DEM,510005,9,24,280,313,
Muskogee,Lieutenant Governor,Todd Lamb,REP,510005,5,20,310,335,
Muskogee,Superintendent of Public Instruction,John Cox,DEM,510005,9,28,345,382,
Muskogee,Superintendent of Public Instruction,Joy Hofmeister,REP,510005,4,16,241,261,
Muskogee,Commissioner of Labor,Mike Workman,DEM,510005,8,31,319,358,
Muskogee,Commissioner of Labor,Mark Costello,REP,510005,6,13,266,285,
Muskogee,U.S. Senate,Matt Silverstein,DEM,510005,8,21,235,264,
Muskogee,U.S. Senate,Jim Inhofe,REP,510005,4,23,327,354,
Muskogee,U.S. Senate,Aaron Delozier,IND,510005,1,0,12,13,
Muskogee,U.S. Senate,Ray Woods,IND,510005,0,0,6,6,
Muskogee,U.S. Senate,Joan Farr,IND,510005,1,0,9,10,
Muskogee,U.S. Senate,Connie Johnson,DEM,510005,6,21,251,278,
Muskogee,U.S. Senate,James Lankford,REP,510005,7,22,308,337,
Muskogee,U.S. Senate,Mark Beard,IND,510005,1,1,30,32,
Muskogee,U.S. House,Earl Everett,DEM,510005,10,22,174,206,02
Muskogee,U.S. House,Markwayne Mullin,REP,510005,3,22,351,376,02
Muskogee,U.S. House,Jon Douthitt,IND,510005,1,0,62,63,02
Muskogee,State House,Jack Reavis,DEM,510005,10,26,310,346,14
Muskogee,State House,George Faught,REP,510005,4,18,281,303,14
Muskogee,Governor,Joe Dorman,DEM,510007,17,47,411,475,
Muskogee,Governor,Mary Fallin,REP,510007,10,35,442,487,
Muskogee,Governor,Kimberly Willis,IND,510007,1,2,24,27,
Muskogee,Governor,Richard Prawdzienski,IND,510007,0,1,4,5,
Muskogee,Lieutenant Governor,Cathy Cummings,DEM,510007,16,40,310,366,
Muskogee,Lieutenant Governor,Todd Lamb,REP,510007,11,46,569,626,
Muskogee,Superintendent of Public Instruction,John Cox,DEM,510007,18,54,451,523,
Muskogee,Superintendent of Public Instruction,Joy Hofmeister,REP,510007,10,31,430,471,
Muskogee,Commissioner of Labor,Mike Workman,DEM,510007,18,47,409,474,
Muskogee,Commissioner of Labor,Mark Costello,REP,510007,10,37,451,498,
Muskogee,U.S. Senate,Matt Silverstein,DEM,510007,14,36,290,340,
Muskogee,U.S. Senate,Jim Inhofe,REP,510007,14,45,568,627,
Muskogee,U.S. Senate,Aaron Delozier,IND,510007,0,1,7,8,
Muskogee,U.S. Senate,Ray Woods,IND,510007,0,2,7,9,
Muskogee,U.S. Senate,Joan Farr,IND,510007,0,0,9,9,
Muskogee,U.S. Senate,Connie Johnson,DEM,510007,13,32,295,340,
Muskogee,U.S. Senate,James Lankford,REP,510007,13,49,557,619,
Muskogee,U.S. Senate,Mark Beard,IND,510007,2,5,27,34,
Muskogee,U.S. House,Earl Everett,DEM,510007,13,28,208,249,02
Muskogee,U.S. House,Markwayne Mullin,REP,510007,12,56,591,659,02
Muskogee,U.S. House,Jon Douthitt,IND,510007,3,3,76,82,02
Muskogee,State House,Jack Reavis,DEM,510007,16,46,401,463,14
Muskogee,State House,George Faught,REP,510007,13,41,484,538,14
Muskogee,Governor,Joe Dorman,DEM,510009,10,35,402,447,
Muskogee,Governor,Mary Fallin,REP,510009,4,50,498,552,
Muskogee,Governor,Kimberly Willis,IND,510009,0,0,19,19,
Muskogee,Governor,Richard Prawdzienski,IND,510009,0,1,9,10,
Muskogee,Lieutenant Governor,Cathy Cummings,DEM,510009,9,27,306,342,
Muskogee,Lieutenant Governor,Todd Lamb,REP,510009,4,59,619,682,
Muskogee,Superintendent of Public Instruction,John Cox,DEM,510009,10,41,466,517,
Muskogee,Superintendent of Public Instruction,Joy Hofmeister,REP,510009,4,45,460,509,
Muskogee,Commissioner of Labor,Mike Workman,DEM,510009,8,29,393,430,
Muskogee,Commissioner of Labor,Mark Costello,REP,510009,5,56,508,569,
Muskogee,U.S. Senate,Matt Silverstein,DEM,510009,10,29,274,313,
Muskogee,U.S. Senate,Jim Inhofe,REP,510009,4,56,607,667,
Muskogee,U.S. Senate,Aaron Delozier,IND,510009,0,0,15,15,
Muskogee,U.S. Senate,Ray Woods,IND,510009,0,1,15,16,
Muskogee,U.S. Senate,Joan Farr,IND,510009,0,0,14,14,
Muskogee,U.S. Senate,Connie Johnson,DEM,510009,8,24,275,307,
Muskogee,U.S. Senate,James Lankford,REP,510009,5,62,618,685,
Muskogee,U.S. Senate,Mark Beard,IND,510009,0,0,30,30,
Muskogee,U.S. House,Earl Everett,DEM,510009,7,22,206,235,02
Muskogee,U.S. House,Markwayne Mullin,REP,510009,7,62,652,721,02
Muskogee,U.S. House,Jon Douthitt,IND,510009,0,1,65,66,02
Muskogee,State House,Jack Reavis,DEM,510009,9,34,366,409,14
Muskogee,State House,George Faught,REP,510009,5,52,566,623,14
Muskogee,Governor,Joe Dorman,DEM,510011,0,8,125,133,
Muskogee,Governor,Mary Fallin,REP,510011,0,8,130,138,
Muskogee,Governor,Kimberly Willis,IND,510011,1,1,9,11,
Muskogee,Governor,Richard Prawdzienski,IND,510011,0,0,10,10,
Muskogee,Lieutenant Governor,Cathy Cummings,DEM,510011,1,9,118,128,
Muskogee,Lieutenant Governor,Todd Lamb,REP,510011,0,8,155,163,
Muskogee,Superintendent of Public Instruction,John Cox,DEM,510011,1,10,146,157,
Muskogee,Superintendent of Public Instruction,Joy Hofmeister,REP,510011,0,7,122,129,
Muskogee,Commissioner of Labor,Mike Workman,DEM,510011,1,10,146,157,
Muskogee,Commissioner of Labor,Mark Costello,REP,510011,0,7,124,131,
Muskogee,U.S. Senate,Matt Silverstein,DEM,510011,1,8,94,103,
Muskogee,U.S. Senate,Jim Inhofe,REP,510011,0,8,160,168,
Muskogee,U.S. Senate,Aaron Delozier,IND,510011,0,0,6,6,
Muskogee,U.S. Senate,Ray Woods,IND,510011,0,0,6,6,
Muskogee,U.S. Senate,Joan Farr,IND,510011,0,1,9,10,
Muskogee,U.S. Senate,Connie Johnson,DEM,510011,0,8,105,113,
Muskogee,U.S. Senate,James Lankford,REP,510011,0,8,150,158,
Muskogee,U.S. Senate,Mark Beard,IND,510011,1,1,17,19,
Muskogee,U.S. House,Earl Everett,DEM,510011,0,8,78,86,02
Muskogee,U.S. House,Markwayne Mullin,REP,510011,0,8,167,175,02
Muskogee,U.S. House,Jon Douthitt,IND,510011,1,1,29,31,02
Muskogee,State House,Jack Reavis,DEM,510011,1,10,134,145,14
Muskogee,State House,George Faught,REP,510011,0,7,139,146,14
Muskogee,Governor,Joe Dorman,DEM,510013,4,18,255,277,
Muskogee,Governor,Mary Fallin,REP,510013,6,21,219,246,
Muskogee,Governor,Kimberly Willis,IND,510013,2,1,12,15,
Muskogee,Governor,Richard Prawdzienski,IND,510013,0,2,3,5,
Muskogee,Lieutenant Governor,Cathy Cummings,DEM,510013,5,15,211,231,
Muskogee,Lieutenant Governor,Todd Lamb,REP,510013,7,27,275,309,
Muskogee,Superintendent of Public Instruction,John Cox,DEM,510013,7,22,272,301,
Muskogee,Superintendent of Public Instruction,Joy Hofmeister,REP,510013,5,20,208,233,
Muskogee,Commissioner of Labor,Mike Workman,DEM,510013,6,18,254,278,
Muskogee,Commissioner of Labor,Mark Costello,REP,510013,6,24,221,251,
Muskogee,U.S. Senate,Matt Silverstein,DEM,510013,4,13,187,204,
Muskogee,U.S. Senate,Jim Inhofe,REP,510013,7,28,280,315,
Muskogee,U.S. Senate,Aaron Delozier,IND,510013,0,0,9,9,
Muskogee,U.S. Senate,Ray Woods,IND,510013,0,0,5,5,
Muskogee,U.S. Senate,Joan Farr,IND,510013,1,1,8,10,
Muskogee,U.S. Senate,Connie Johnson,DEM,510013,3,12,201,216,
Muskogee,U.S. Senate,James Lankford,REP,510013,6,27,267,300,
Muskogee,U.S. Senate,Mark Beard,IND,510013,3,3,18,24,
Muskogee,U.S. House,Earl Everett,DEM,510013,4,10,143,157,02
Muskogee,U.S. House,Markwayne Mullin,REP,510013,6,31,296,333,02
Muskogee,U.S. House,Jon Douthitt,IND,510013,2,1,48,51,02
Muskogee,State House,Jack Reavis,DEM,510013,5,12,238,255,14
Muskogee,State House,George Faught,REP,510013,7,30,252,289,14
Muskogee,Governor,Joe Dorman,DEM,510017,0,12,132,144,
Muskogee,Governor,Mary Fallin,REP,510017,2,4,36,42,
Muskogee,Governor,Kimberly Willis,IND,510017,0,0,9,9,
Muskogee,Governor,Richard Prawdzienski,IND,510017,0,0,2,2,
Muskogee,Lieutenant Governor,Cathy Cummings,DEM,510017,0,12,134,146,
Muskogee,Lieutenant Governor,Todd Lamb,REP,510017,2,4,44,50,
Muskogee,Superintendent of Public Instruction,John Cox,DEM,510017,0,12,131,143,
Muskogee,Superintendent of Public Instruction,Joy Hofmeister,REP,510017,2,4,46,52,
Muskogee,Commissioner of Labor,Mike Workman,DEM,510017,0,12,138,150,
Muskogee,Commissioner of Labor,Mark Costello,REP,510017,2,4,38,44,
Muskogee,U.S. Senate,Matt Silverstein,DEM,510017,0,11,132,143,
Muskogee,U.S. Senate,Jim Inhofe,REP,510017,2,4,41,47,
Muskogee,U.S. Senate,Aaron Delozier,IND,510017,0,0,0,0,
Muskogee,U.S. Senate,Ray Woods,IND,510017,0,0,1,1,
Muskogee,U.S. Senate,Joan Farr,IND,510017,0,1,3,4,
Muskogee,U.S. Senate,Connie Johnson,DEM,510017,0,12,132,144,
Muskogee,U.S. Senate,James Lankford,REP,510017,2,4,42,48,
Muskogee,U.S. Senate,Mark Beard,IND,510017,0,0,4,4,
Muskogee,U.S. House,Earl Everett,DEM,510017,0,10,111,121,02
Muskogee,U.S. House,Markwayne Mullin,REP,510017,2,5,52,59,02
Muskogee,U.S. House,Jon Douthitt,IND,510017,0,1,15,16,02
Muskogee,Governor,Joe Dorman,DEM,510021,1,22,270,293,
Muskogee,Governor,Mary Fallin,REP,510021,2,15,107,124,
Muskogee,Governor,Kimberly Willis,IND,510021,0,0,6,6,
Muskogee,Governor,Richard Prawdzienski,IND,510021,0,0,5,5,
Muskogee,Lieutenant Governor,Cathy Cummings,DEM,510021,1,22,238,261,
Muskogee,Lieutenant Governor,Todd Lamb,REP,510021,2,14,149,165,
Muskogee,Superintendent of Public Instruction,John Cox,DEM,510021,1,28,271,300,
Muskogee,Superintendent of Public Instruction,Joy Hofmeister,REP,510021,2,9,116,127,
Muskogee,Commissioner of Labor,Mike Workman,DEM,510021,1,24,266,291,
Muskogee,Commissioner of Labor,Mark Costello,REP,510021,2,12,118,132,
Muskogee,U.S. Senate,Matt Silverstein,DEM,510021,1,20,223,244,
Muskogee,U.S. Senate,Jim Inhofe,REP,510021,2,16,142,160,
Muskogee,U.S. Senate,Aaron Delozier,IND,510021,0,1,4,5,
Muskogee,U.S. Senate,Ray Woods,IND,510021,0,0,6,6,
Muskogee,U.S. Senate,Joan Farr,IND,510021,0,0,8,8,
Muskogee,U.S. Senate,Connie Johnson,DEM,510021,1,21,205,227,
Muskogee,U.S. Senate,James Lankford,REP,510021,2,14,118,134,
Muskogee,U.S. Senate,Mark Beard,IND,510021,0,2,14,16,
Muskogee,U.S. House,Earl Everett,DEM,510021,1,17,178,196,02
Muskogee,U.S. House,Markwayne Mullin,REP,510021,2,18,129,149,02
Muskogee,U.S. House,Jon Douthitt,IND,510021,0,2,31,33,02
Muskogee,Governor,Joe Dorman,DEM,510022,7,28,278,313,
Muskogee,Governor,Mary Fallin,REP,510022,11,31,270,312,
Muskogee,Governor,Kimberly Willis,IND,510022,0,0,12,12,
Muskogee,Governor,Richard Prawdzienski,IND,510022,0,1,3,4,
Muskogee,Lieutenant Governor,Cathy Cummings,DEM,510022,5,21,228,254,
Muskogee,Lieutenant Governor,Todd Lamb,REP,510022,13,39,331,383,
Muskogee,Superintendent of Public Instruction,John Cox,DEM,510022,8,30,298,336,
Muskogee,Superintendent of Public Instruction,Joy Hofmeister,REP,510022,10,30,264,304,
Muskogee,Commissioner of Labor,Mike Workman,DEM,510022,6,23,281,310,
Muskogee,Commissioner of Labor,Mark Costello,REP,510022,12,36,271,319,
Muskogee,U.S. Senate,Matt Silverstein,DEM,510022,6,25,226,257,
Muskogee,U.S. Senate,Jim Inhofe,REP,510022,11,35,310,356,
Muskogee,U.S. Senate,Aaron Delozier,IND,510022,0,0,7,7,
Muskogee,U.S. Senate,Ray Woods,IND,510022,0,0,7,7,
Muskogee,U.S. Senate,Joan Farr,IND,510022,1,0,10,11,
Muskogee,U.S. Senate,Connie Johnson,DEM,510022,7,25,220,252,
Muskogee,U.S. Senate,James Lankford,REP,510022,11,34,318,363,
Muskogee,U.S. Senate,Mark Beard,IND,510022,0,1,23,24,
Muskogee,U.S. House,Earl Everett,DEM,510022,4,20,166,190,02
Muskogee,U.S. House,Markwayne Mullin,REP,510022,13,35,346,394,02
Muskogee,U.S. House,Jon Douthitt,IND,510022,1,4,47,52,02
Muskogee,Governor,Joe Dorman,DEM,510023,5,38,312,355,
Muskogee,Governor,Mary Fallin,REP,510023,1,10,79,90,
Muskogee,Governor,Kimberly Willis,IND,510023,1,1,2,4,
Muskogee,Governor,Richard Prawdzienski,IND,510023,0,0,7,7,
Muskogee,Lieutenant Governor,Cathy Cummings,DEM,510023,5,37,297,339,
Muskogee,Lieutenant Governor,Todd Lamb,REP,510023,2,12,101,115,
Muskogee,Superintendent of Public Instruction,John Cox,DEM,510023,7,39,311,357,
Muskogee,Superintendent of Public Instruction,Joy Hofmeister,REP,510023,0,10,86,96,
Muskogee,Commissioner of Labor,Mike Workman,DEM,510023,6,41,316,363,
Muskogee,Commissioner of Labor,Mark Costello,REP,510023,1,8,78,87,
Muskogee,U.S. Senate,Matt Silverstein,DEM,510023,6,33,278,317,
Muskogee,U.S. Senate,Jim Inhofe,REP,510023,1,13,102,116,
Muskogee,U.S. Senate,Aaron Delozier,IND,510023,0,0,6,6,
Muskogee,U.S. Senate,Ray Woods,IND,510023,0,0,2,2,
Muskogee,U.S. Senate,Joan Farr,IND,510023,0,2,9,11,
Muskogee,U.S. Senate,Connie Johnson,DEM,510023,6,37,301,344,
Muskogee,U.S. Senate,James Lankford,REP,510023,1,11,84,96,
Muskogee,U.S. Senate,Mark Beard,IND,510023,0,1,13,14,
Muskogee,U.S. House,Earl Everett,DEM,510023,6,33,266,305,02
Muskogee,U.S. House,Markwayne Mullin,REP,510023,1,14,100,115,02
Muskogee,U.S. House,Jon Douthitt,IND,510023,0,2,32,34,02
Muskogee,Governor,Joe Dorman,DEM,510028,1,2,146,149,
Muskogee,Governor,Mary Fallin,REP,510028,4,7,108,119,
Muskogee,Governor,Kimberly Willis,IND,510028,0,0,5,5,
Muskogee,Governor,Richard Prawdzienski,IND,510028,0,0,0,0,
Muskogee,Lieutenant Governor,Cathy Cummings,DEM,510028,2,2,144,148,
Muskogee,Lieutenant Governor,Todd Lamb,REP,510028,3,7,115,125,
Muskogee,Superintendent of Public Instruction,John Cox,DEM,510028,2,3,152,157,
Muskogee,Superintendent of Public Instruction,Joy Hofmeister,REP,510028,3,6,105,114,
Muskogee,Commissioner of Labor,Mike Workman,DEM,510028,2,3,140,145,
Muskogee,Commissioner of Labor,Mark Costello,REP,510028,3,6,112,121,
Muskogee,U.S. Senate,Matt Silverstein,DEM,510028,1,3,127,131,
Muskogee,U.S. Senate,Jim Inhofe,REP,510028,4,6,122,132,
Muskogee,U.S. Senate,Aaron Delozier,IND,510028,0,0,1,1,
Muskogee,U.S. Senate,Ray Woods,IND,510028,0,0,3,3,
Muskogee,U.S. Senate,Joan Farr,IND,510028,0,0,3,3,
Muskogee,U.S. Senate,Connie Johnson,DEM,510028,2,1,133,136,
Muskogee,U.S. Senate,James Lankford,REP,510028,3,7,120,130,
Muskogee,U.S. Senate,Mark Beard,IND,510028,0,0,6,6,
Muskogee,U.S. House,Earl Everett,DEM,510028,2,2,113,117,02
Muskogee,U.S. House,Markwayne Mullin,REP,510028,3,7,130,140,02
Muskogee,U.S. House,Jon Douthitt,IND,510028,0,0,17,17,02
Muskogee,Governor,Joe Dorman,DEM,510033,3,6,278,287,
Muskogee,Governor,Mary Fallin,REP,510033,4,3,336,343,
Muskogee,Governor,Kimberly Willis,IND,510033,0,0,15,15,
Muskogee,Governor,Richard Prawdzienski,IND,510033,0,0,4,4,
Muskogee,Lieutenant Governor,Cathy Cummings,DEM,510033,2,6,185,193,
Muskogee,Lieutenant Governor,Todd Lamb,REP,510033,5,3,446,454,
Muskogee,Superintendent of Public Instruction,John Cox,DEM,510033,3,7,330,340,
Muskogee,Superintendent of Public Instruction,Joy Hofmeister,REP,510033,3,2,299,304,
Muskogee,Commissioner of Labor,Mike Workman,DEM,510033,3,5,249,257,
Muskogee,Commissioner of Labor,Mark Costello,REP,510033,3,4,363,370,
Muskogee,U.S. Senate,Matt Silverstein,DEM,510033,3,5,183,191,
Muskogee,U.S. Senate,Jim Inhofe,REP,510033,4,3,429,436,
Muskogee,U.S. Senate,Aaron Delozier,IND,510033,0,0,2,2,
Muskogee,U.S. Senate,Ray Woods,IND,510033,0,0,7,7,
Muskogee,U.S. Senate,Joan Farr,IND,510033,0,1,12,13,
Muskogee,U.S. Senate,Connie Johnson,DEM,510033,2,4,178,184,
Muskogee,U.S. Senate,James Lankford,REP,510033,4,5,425,434,
Muskogee,U.S. Senate,Mark Beard,IND,510033,0,0,25,25,
Muskogee,U.S. House,Earl Everett,DEM,510033,2,2,145,149,02
Muskogee,U.S. House,Markwayne Mullin,REP,510033,4,7,461,472,02
Muskogee,U.S. House,Jon Douthitt,IND,510033,0,0,24,24,02
Muskogee,State Senate,Charles Arnall,DEM,510033,2,5,226,233,18
Muskogee,State Senate,Kim David,REP,510033,5,4,391,400,18
Muskogee,State House,Jerry Shoemake,DEM,510033,4,7,386,397,16
Muskogee,State House,James Bo Delso,REP,510033,2,1,242,245,16
Muskogee,Governor,Joe Dorman,DEM,510036,0,4,90,94,
Muskogee,Governor,Mary Fallin,REP,510036,2,2,18,22,
Muskogee,Governor,Kimberly Willis,IND,510036,0,0,2,2,
Muskogee,Governor,Richard Prawdzienski,IND,510036,0,0,3,3,
Muskogee,Lieutenant Governor,Cathy Cummings,DEM,510036,0,3,77,80,
Muskogee,Lieutenant Governor,Todd Lamb,REP,510036,2,3,35,40,
Muskogee,Superintendent of Public Instruction,John Cox,DEM,510036,1,3,90,94,
Muskogee,Superintendent of Public Instruction,Joy Hofmeister,REP,510036,1,3,21,25,
Muskogee,Commissioner of Labor,Mike Workman,DEM,510036,1,3,85,89,
Muskogee,Commissioner of Labor,Mark Costello,REP,510036,1,3,26,30,
Muskogee,U.S. Senate,Matt Silverstein,DEM,510036,0,3,76,79,
Muskogee,U.S. Senate,Jim Inhofe,REP,510036,2,3,34,39,
Muskogee,U.S. Senate,Aaron Delozier,IND,510036,0,0,1,1,
Muskogee,U.S. Senate,Ray Woods,IND,510036,0,0,2,2,
Muskogee,U.S. Senate,Joan Farr,IND,510036,0,0,0,0,
Muskogee,U.S. Senate,Connie Johnson,DEM,510036,0,3,80,83,
Muskogee,U.S. Senate,James Lankford,REP,510036,2,3,28,33,
Muskogee,U.S. Senate,Mark Beard,IND,510036,0,0,4,4,
Muskogee,U.S. House,Earl Everett,DEM,510036,0,3,72,75,02
Muskogee,U.S. House,Markwayne Mullin,REP,510036,2,3,34,39,02
Muskogee,U.S. House,Jon Douthitt,IND,510036,0,0,5,5,02
Muskogee,Governor,Joe Dorman,DEM,510037,0,16,198,214,
Muskogee,Governor,Mary Fallin,REP,510037,1,12,230,243,
Muskogee,Governor,Kimberly Willis,IND,510037,0,0,10,10,
Muskogee,Governor,Richard Prawdzienski,IND,510037,0,0,8,8,
Muskogee,Lieutenant Governor,Cathy Cummings,DEM,510037,0,14,160,174,
Muskogee,Lieutenant Governor,Todd Lamb,REP,510037,1,14,285,300,
Muskogee,Superintendent of Public Instruction,John Cox,DEM,510037,0,20,226,246,
Muskogee,Superintendent of Public Instruction,Joy Hofmeister,REP,510037,1,8,216,225,
Muskogee,Commissioner of Labor,Mike Workman,DEM,510037,0,19,207,226,
Muskogee,Commissioner of Labor,Mark Costello,REP,510037,1,9,225,235,
Muskogee,U.S. Senate,Matt Silverstein,DEM,510037,0,13,141,154,
Muskogee,U.S. Senate,Jim Inhofe,REP,510037,1,15,285,301,
Muskogee,U.S. Senate,Aaron Delozier,IND,510037,0,0,2,2,
Muskogee,U.S. Senate,Ray Woods,IND,510037,0,0,6,6,
Muskogee,U.S. Senate,Joan Farr,IND,510037,0,0,11,11,
Muskogee,U.S. Senate,Connie Johnson,DEM,510037,0,13,136,149,
Muskogee,U.S. Senate,James Lankford,REP,510037,1,14,296,311,
Muskogee,U.S. Senate,Mark Beard,IND,510037,0,1,14,15,
Muskogee,U.S. House,Earl Everett,DEM,510037,0,11,98,109,02
Muskogee,U.S. House,Markwayne Mullin,REP,510037,1,13,309,323,02
Muskogee,U.S. House,Jon Douthitt,IND,510037,0,3,39,42,02
Muskogee,Governor,Joe Dorman,DEM,510038,5,39,268,312,
Muskogee,Governor,Mary Fallin,REP,510038,13,41,350,404,
Muskogee,Governor,Kimberly Willis,IND,510038,0,0,4,4,
Muskogee,Governor,Richard Prawdzienski,IND,510038,1,0,3,4,
Muskogee,Lieutenant Governor,Cathy Cummings,DEM,510038,2,32,212,246,
Muskogee,Lieutenant Governor,Todd Lamb,REP,510038,17,48,412,477,
Muskogee,Superintendent of Public Instruction,John Cox,DEM,510038,5,49,289,343,
Muskogee,Superintendent of Public Instruction,Joy Hofmeister,REP,510038,13,29,335,377,
Muskogee,Commissioner of Labor,Mike Workman,DEM,510038,4,39,235,278,
Muskogee,Commissioner of Labor,Mark Costello,REP,510038,13,35,375,423,
Muskogee,U.S. Senate,Matt Silverstein,DEM,510038,3,35,209,247,
Muskogee,U.S. Senate,Jim Inhofe,REP,510038,15,46,405,466,
Muskogee,U.S. Senate,Aaron Delozier,IND,510038,0,0,3,3,
Muskogee,U.S. Senate,Ray Woods,IND,510038,1,0,5,6,
Muskogee,U.S. Senate,Joan Farr,IND,510038,0,0,2,2,
Muskogee,U.S. Senate,Connie Johnson,DEM,510038,3,31,192,226,
Muskogee,U.S. Senate,James Lankford,REP,510038,15,49,417,481,
Muskogee,U.S. Senate,Mark Beard,IND,510038,1,1,13,15,
Muskogee,U.S. House,Earl Everett,DEM,510038,3,25,145,173,02
Muskogee,U.S. House,Markwayne Mullin,REP,510038,15,56,427,498,02
Muskogee,U.S. House,Jon Douthitt,IND,510038,1,1,46,48,02
Muskogee,State House,Jack Reavis,DEM,510038,4,43,267,314,14
Muskogee,State House,George Faught,REP,510038,15,38,358,411,14
Muskogee,Governor,Joe Dorman,DEM,510040,4,6,72,82,
Muskogee,Governor,Mary Fallin,REP,510040,8,1,131,140,
Muskogee,Governor,Kimberly Willis,IND,510040,0,0,2,2,
Muskogee,Governor,Richard Prawdzienski,IND,510040,0,0,1,1,
Muskogee,Lieutenant Governor,Cathy Cummings,DEM,510040,3,5,47,55,
Muskogee,Lieutenant Governor,Todd Lamb,REP,510040,9,2,161,172,
Muskogee,Superintendent of Public Instruction,John Cox,DEM,510040,3,6,89,98,
Muskogee,Superintendent of Public Instruction,Joy Hofmeister,REP,510040,9,1,118,128,
Muskogee,Commissioner of Labor,Mike Workman,DEM,510040,3,4,64,71,
Muskogee,Commissioner of Labor,Mark Costello,REP,510040,9,3,139,151,
Muskogee,U.S. Senate,Matt Silverstein,DEM,510040,2,4,54,60,
Muskogee,U.S. Senate,Jim Inhofe,REP,510040,10,2,152,164,
Muskogee,U.S. Senate,Aaron Delozier,IND,510040,0,0,0,0,
Muskogee,U.S. Senate,Ray Woods,IND,510040,0,0,1,1,
Muskogee,U.S. Senate,Joan Farr,IND,510040,0,0,1,1,
Muskogee,U.S. Senate,Connie Johnson,DEM,510040,3,4,48,55,
Muskogee,U.S. Senate,James Lankford,REP,510040,9,3,157,169,
Muskogee,U.S. Senate,Mark Beard,IND,510040,0,0,3,3,
Muskogee,U.S. House,Earl Everett,DEM,510040,3,3,36,42,02
Muskogee,U.S. House,Markwayne Mullin,REP,510040,9,4,162,175,02
Muskogee,U.S. House,Jon Douthitt,IND,510040,0,0,10,10,02
Muskogee,State House,Jack Reavis,DEM,510040,3,6,63,72,14
Muskogee,State House,George Faught,REP,510040,9,1,144,154,14
Muskogee,Governor,Joe Dorman,DEM,510041,14,30,562,606,
Muskogee,Governor,Mary Fallin,REP,510041,16,25,632,673,
Muskogee,Governor,Kimberly Willis,IND,510041,0,2,29,31,
Muskogee,Governor,Richard Prawdzienski,IND,510041,0,0,8,8,
Muskogee,Lieutenant Governor,Cathy Cummings,DEM,510041,10,20,395,425,
Muskogee,Lieutenant Governor,Todd Lamb,REP,510041,20,37,829,886,
Muskogee,Superintendent of Public Instruction,John Cox,DEM,510041,16,32,660,708,
Muskogee,Superintendent of Public Instruction,Joy Hofmeister,REP,510041,14,25,562,601,
Muskogee,Commissioner of Labor,Mike Workman,DEM,510041,14,32,517,563,
Muskogee,Commissioner of Labor,Mark Costello,REP,510041,16,25,680,721,
Muskogee,U.S. Senate,Matt Silverstein,DEM,510041,13,24,350,387,
Muskogee,U.S. Senate,Jim Inhofe,REP,510041,16,29,838,883,
Muskogee,U.S. Senate,Aaron Delozier,IND,510041,0,1,13,14,
Muskogee,U.S. Senate,Ray Woods,IND,510041,1,0,11,12,
Muskogee,U.S. Senate,Joan Farr,IND,510041,0,1,13,14,
Muskogee,U.S. Senate,Connie Johnson,DEM,510041,9,21,346,376,
Muskogee,U.S. Senate,James Lankford,REP,510041,20,35,828,883,
Muskogee,U.S. Senate,Mark Beard,IND,510041,1,0,43,44,
Muskogee,U.S. House,Earl Everett,DEM,510041,9,20,228,257,02
Muskogee,U.S. House,Markwayne Mullin,REP,510041,20,34,890,944,02
Muskogee,U.S. House,Jon Douthitt,IND,510041,1,1,106,108,02
Muskogee,State Senate,Charles Arnall,DEM,510041,11,22,416,449,18
Muskogee,State Senate,Kim David,REP,510041,19,35,799,853,18
Muskogee,State House,Jack Reavis,DEM,510041,11,30,470,511,14
Muskogee,State House,George Faught,REP,510041,19,27,751,797,14
Muskogee,Governor,Joe Dorman,DEM,510044,2,3,139,144,
Muskogee,Governor,Mary Fallin,REP,510044,0,1,163,164,
Muskogee,Governor,Kimberly Willis,IND,510044,0,0,7,7,
Muskogee,Governor,Richard Prawdzienski,IND,510044,0,0,3,3,
Muskogee,Lieutenant Governor,Cathy Cummings,DEM,510044,2,3,104,109,
Muskogee,Lieutenant Governor,Todd Lamb,REP,510044,0,1,206,207,
Muskogee,Superintendent of Public Instruction,John Cox,DEM,510044,2,3,162,167,
Muskogee,Superintendent of Public Instruction,Joy Hofmeister,REP,510044,0,1,149,150,
Muskogee,Commissioner of Labor,Mike Workman,DEM,510044,2,3,151,156,
Muskogee,Commissioner of Labor,Mark Costello,REP,510044,0,1,156,157,
Muskogee,U.S. Senate,Matt Silverstein,DEM,510044,2,3,93,98,
Muskogee,U.S. Senate,Jim Inhofe,REP,510044,0,1,196,197,
Muskogee,U.S. Senate,Aaron Delozier,IND,510044,0,0,9,9,
Muskogee,U.S. Senate,Ray Woods,IND,510044,0,0,3,3,
Muskogee,U.S. Senate,Joan Farr,IND,510044,0,0,8,8,
Muskogee,U.S. Senate,Connie Johnson,DEM,510044,2,3,92,97,
Muskogee,U.S. Senate,James Lankford,REP,510044,0,1,200,201,
Muskogee,U.S. Senate,Mark Beard,IND,510044,0,0,19,19,
Muskogee,U.S. House,Earl Everett,DEM,510044,1,3,80,84,02
Muskogee,U.S. House,Markwayne Mullin,REP,510044,1,1,205,207,02
Muskogee,U.S. House,Jon Douthitt,IND,510044,0,0,23,23,02
Muskogee,State House,Jack Reavis,DEM,510044,2,3,137,142,14
Muskogee,State House,George Faught,REP,510044,0,1,173,174,14
Muskogee,Governor,Joe Dorman,DEM,510045,3,8,160,171,
Muskogee,Governor,Mary Fallin,REP,510045,6,5,183,194,
Muskogee,Governor,Kimberly Willis,IND,510045,0,2,3,5,
Muskogee,Governor,Richard Prawdzienski,IND,510045,0,1,2,3,
Muskogee,Lieutenant Governor,Cathy Cummings,DEM,510045,3,8,135,146,
Muskogee,Lieutenant Governor,Todd Lamb,REP,510045,6,7,212,225,
Muskogee,Superintendent of Public Instruction,John Cox,DEM,510045,3,9,168,180,
Muskogee,Superintendent of Public Instruction,Joy Hofmeister,REP,510045,6,6,178,190,
Muskogee,Commissioner of Labor,Mike Workman,DEM,510045,2,11,169,182,
Muskogee,Commissioner of Labor,Mark Costello,REP,510045,7,5,168,180,
Muskogee,U.S. Senate,Matt Silverstein,DEM,510045,3,8,130,141,
Muskogee,U.S. Senate,Jim Inhofe,REP,510045,6,7,207,220,
Muskogee,U.S. Senate,Aaron Delozier,IND,510045,0,0,4,4,
Muskogee,U.S. Senate,Ray Woods,IND,510045,0,1,3,4,
Muskogee,U.S. Senate,Joan Farr,IND,510045,0,0,3,3,
Muskogee,U.S. Senate,Connie Johnson,DEM,510045,3,9,106,118,
Muskogee,U.S. Senate,James Lankford,REP,510045,6,7,225,238,
Muskogee,U.S. Senate,Mark Beard,IND,510045,0,0,14,14,
Muskogee,U.S. House,Earl Everett,DEM,510045,2,8,89,99,02
Muskogee,U.S. House,Markwayne Mullin,REP,510045,6,6,224,236,02
Muskogee,U.S. House,Jon Douthitt,IND,510045,1,2,31,34,02
Muskogee,State House,Jack Reavis,DEM,510045,3,10,150,163,14
Muskogee,State House,George Faught,REP,510045,6,6,196,208,14
Muskogee,Governor,Joe Dorman,DEM,510046,3,23,238,264,
Muskogee,Governor,Mary Fallin,REP,510046,6,16,312,334,
Muskogee,Governor,Kimberly Willis,IND,510046,2,1,13,16,
Muskogee,Governor,Richard Prawdzienski,IND,510046,0,0,8,8,
Muskogee,Lieutenant Governor,Cathy Cummings,DEM,510046,4,17,180,201,
Muskogee,Lieutenant Governor,Todd Lamb,REP,510046,7,23,387,417,
Muskogee,Superintendent of Public Instruction,John Cox,DEM,510046,6,24,284,314,
Muskogee,Superintendent of Public Instruction,Joy Hofmeister,REP,510046,5,16,280,301,
Muskogee,Commissioner of Labor,Mike Workman,DEM,510046,6,23,205,234,
Muskogee,Commissioner of Labor,Mark Costello,REP,510046,5,16,352,373,
Muskogee,U.S. Senate,Matt Silverstein,DEM,510046,3,16,140,159,
Muskogee,U.S. Senate,Jim Inhofe,REP,510046,7,22,405,434,
Muskogee,U.S. Senate,Aaron Delozier,IND,510046,0,0,11,11,
Muskogee,U.S. Senate,Ray Woods,IND,510046,0,1,3,4,
Muskogee,U.S. Senate,Joan Farr,IND,510046,1,1,6,8,
Muskogee,U.S. Senate,Connie Johnson,DEM,510046,3,17,145,165,
Muskogee,U.S. Senate,James Lankford,REP,510046,7,21,399,427,
Muskogee,U.S. Senate,Mark Beard,IND,510046,1,2,22,25,
Muskogee,U.S. House,Earl Everett,DEM,510046,3,14,113,130,02
Muskogee,U.S. House,Markwayne Mullin,REP,510046,8,24,399,431,02
Muskogee,U.S. House,Jon Douthitt,IND,510046,0,2,51,53,02
Muskogee,Governor,Joe Dorman,DEM,510047,4,10,200,214,
Muskogee,Governor,Mary Fallin,REP,510047,1,5,169,175,
Muskogee,Governor,Kimberly Willis,IND,510047,0,0,6,6,
Muskogee,Governor,Richard Prawdzienski,IND,510047,0,0,1,1,
Muskogee,Lieutenant Governor,Cathy Cummings,DEM,510047,1,10,156,167,
Muskogee,Lieutenant Governor,Todd Lamb,REP,510047,4,5,219,228,
Muskogee,Superintendent of Public Instruction,John Cox,DEM,510047,4,11,219,234,
Muskogee,Superintendent of Public Instruction,Joy Hofmeister,REP,510047,1,4,156,161,
Muskogee,Commissioner of Labor,Mike Workman,DEM,510047,3,11,197,211,
Muskogee,Commissioner of Labor,Mark Costello,REP,510047,2,4,176,182,
Muskogee,U.S. Senate,Matt Silverstein,DEM,510047,1,10,155,166,
Muskogee,U.S. Senate,Jim Inhofe,REP,510047,4,5,215,224,
Muskogee,U.S. Senate,Aaron Delozier,IND,510047,0,0,1,1,
Muskogee,U.S. Senate,Ray Woods,IND,510047,0,0,1,1,
Muskogee,U.S. Senate,Joan Farr,IND,510047,0,0,3,3,
Muskogee,U.S. Senate,Connie Johnson,DEM,510047,1,10,155,166,
Muskogee,U.S. Senate,James Lankford,REP,510047,4,5,208,217,
Muskogee,U.S. Senate,Mark Beard,IND,510047,0,0,12,12,
Muskogee,U.S. House,Earl Everett,DEM,510047,1,9,122,132,02
Muskogee,U.S. House,Markwayne Mullin,REP,510047,4,6,226,236,02
Muskogee,U.S. House,Jon Douthitt,IND,510047,0,0,27,27,02
Muskogee,Governor,Joe Dorman,DEM,510049,1,10,65,76,
Muskogee,Governor,Mary Fallin,REP,510049,2,9,76,87,
Muskogee,Governor,Kimberly Willis,IND,510049,0,0,2,2,
Muskogee,Governor,Richard Prawdzienski,IND,510049,0,0,2,2,
Muskogee,Lieutenant Governor,Cathy Cummings,DEM,510049,1,9,52,62,
Muskogee,Lieutenant Governor,Todd Lamb,REP,510049,2,10,90,102,
Muskogee,Superintendent of Public Instruction,John Cox,DEM,510049,2,12,83,97,
Muskogee,Superintendent of Public Instruction,Joy Hofmeister,REP,510049,1,7,61,69,
Muskogee,Commissioner of Labor,Mike Workman,DEM,510049,1,9,79,89,
Muskogee,Commissioner of Labor,Mark Costello,REP,510049,1,10,62,73,
Muskogee,U.S. Senate,Matt Silverstein,DEM,510049,1,8,54,63,
Muskogee,U.S. Senate,Jim Inhofe,REP,510049,2,11,84,97,
Muskogee,U.S. Senate,Aaron Delozier,IND,510049,0,0,2,2,
Muskogee,U.S. Senate,Ray Woods,IND,510049,0,0,0,0,
Muskogee,U.S. Senate,Joan Farr,IND,510049,0,0,5,5,
Muskogee,U.S. Senate,Connie Johnson,DEM,510049,1,7,50,58,
Muskogee,U.S. Senate,James Lankford,REP,510049,2,12,88,102,
Muskogee,U.S. Senate,Mark Beard,IND,510049,0,0,7,7,
Muskogee,U.S. House,Earl Everett,DEM,510049,0,8,35,43,02
Muskogee,U.S. House,Markwayne Mullin,REP,510049,2,11,91,104,02
Muskogee,U.S. House,Jon Douthitt,IND,510049,1,0,15,16,02
Muskogee,State House,Jack Reavis,DEM,510049,1,10,63,74,14
Muskogee,State House,George Faught,REP,510049,2,9,81,92,14
Muskogee,Governor,Joe Dorman,DEM,510050,0,1,89,90,
Muskogee,Governor,Mary Fallin,REP,510050,2,4,53,59,
Muskogee,Governor,Kimberly Willis,IND,510050,0,0,2,2,
Muskogee,Governor,Richard Prawdzienski,IND,510050,0,0,0,0,
Muskogee,Lieutenant Governor,Cathy Cummings,DEM,510050,0,1,80,81,
Muskogee,Lieutenant Governor,Todd Lamb,REP,510050,2,4,63,69,
Muskogee,Superintendent of Public Instruction,John Cox,DEM,510050,0,1,104,105,
Muskogee,Superintendent of Public Instruction,Joy Hofmeister,REP,510050,2,4,39,45,
Muskogee,Commissioner of Labor,Mike Workman,DEM,510050,0,1,86,87,
Muskogee,Commissioner of Labor,Mark Costello,REP,510050,2,3,57,62,
Muskogee,U.S. Senate,Matt Silverstein,DEM,510050,0,1,78,79,
Muskogee,U.S. Senate,Jim Inhofe,REP,510050,2,3,61,66,
Muskogee,U.S. Senate,Aaron Delozier,IND,510050,0,0,3,3,
Muskogee,U.S. Senate,Ray Woods,IND,510050,0,0,1,1,
Muskogee,U.S. Senate,Joan Farr,IND,510050,0,0,1,1,
Muskogee,U.S. Senate,Connie Johnson,DEM,510050,0,0,81,81,
Muskogee,U.S. Senate,James Lankford,REP,510050,2,5,59,66,
Muskogee,U.S. Senate,Mark Beard,IND,510050,0,0,4,4,
Muskogee,U.S. House,Earl Everett,DEM,510050,0,1,74,75,02
Muskogee,U.S. House,Markwayne Mullin,REP,510050,2,4,64,70,02
Muskogee,U.S. House,Jon Douthitt,IND,510050,0,0,6,6,02
Muskogee,State Senate,Charles Arnall,DEM,510050,0,1,85,86,18
Muskogee,State Senate,Kim David,REP,510050,2,4,57,63,18
Muskogee,State House,Jerry Shoemake,DEM,510050,0,3,118,121,16
Muskogee,State House,James Bo Delso,REP,510050,2,2,26,30,16
Muskogee,Governor,Joe Dorman,DEM,510051,0,1,43,44,
Muskogee,Governor,Mary Fallin,REP,510051,0,0,34,34,
Muskogee,Governor,Kimberly Willis,IND,510051,0,0,3,3,
Muskogee,Governor,Richard Prawdzienski,IND,510051,0,0,0,0,
Muskogee,Lieutenant Governor,Cathy Cummings,DEM,510051,0,1,37,38,
Muskogee,Lieutenant Governor,Todd Lamb,REP,510051,0,0,42,42,
Muskogee,Superintendent of Public Instruction,John Cox,DEM,510051,0,1,56,57,
Muskogee,Superintendent of Public Instruction,Joy Hofmeister,REP,510051,0,0,23,23,
Muskogee,Commissioner of Labor,Mike Workman,DEM,510051,0,1,46,47,
Muskogee,Commissioner of Labor,Mark Costello,REP,510051,0,0,33,33,
Muskogee,U.S. Senate,Matt Silverstein,DEM,510051,0,1,27,28,
Muskogee,U.S. Senate,Jim Inhofe,REP,510051,0,0,51,51,
Muskogee,U.S. Senate,Aaron Delozier,IND,510051,0,0,0,0,
Muskogee,U.S. Senate,Ray Woods,IND,510051,0,0,2,2,
Muskogee,U.S. Senate,Joan Farr,IND,510051,0,0,0,0,
Muskogee,U.S. Senate,Connie Johnson,DEM,510051,0,1,26,27,
Muskogee,U.S. Senate,James Lankford,REP,510051,0,0,52,52,
Muskogee,U.S. Senate,Mark Beard,IND,510051,0,0,1,1,
Muskogee,U.S. House,Earl Everett,DEM,510051,0,1,25,26,02
Muskogee,U.S. House,Markwayne Mullin,REP,510051,0,0,52,52,02
Muskogee,U.S. House,Jon Douthitt,IND,510051,0,0,3,3,02
Muskogee,State Senate,Charles Arnall,DEM,510051,0,1,37,38,18
Muskogee,State Senate,Kim David,REP,510051,0,0,42,42,18
Muskogee,State House,Jerry Shoemake,DEM,510051,0,1,57,58,16
Muskogee,State House,James Bo Delso,REP,510051,0,0,21,21,16
Muskogee,Governor,Joe Dorman,DEM,510052,2,3,68,73,
Muskogee,Governor,Mary Fallin,REP,510052,3,12,73,88,
Muskogee,Governor,Kimberly Willis,IND,510052,0,0,4,4,
Muskogee,Governor,Richard Prawdzienski,IND,510052,0,0,1,1,
Muskogee,Lieutenant Governor,Cathy Cummings,DEM,510052,3,1,57,61,
Muskogee,Lieutenant Governor,Todd Lamb,REP,510052,2,14,87,103,
Muskogee,Superintendent of Public Instruction,John Cox,DEM,510052,3,4,91,98,
Muskogee,Superintendent of Public Instruction,Joy Hofmeister,REP,510052,2,11,51,64,
Muskogee,Commissioner of Labor,Mike Workman,DEM,510052,3,3,70,76,
Muskogee,Commissioner of Labor,Mark Costello,REP,510052,2,11,66,79,
Muskogee,U.S. Senate,Matt Silverstein,DEM,510052,2,2,46,50,
Muskogee,U.S. Senate,Jim Inhofe,REP,510052,3,12,95,110,
Muskogee,U.S. Senate,Aaron Delozier,IND,510052,0,0,0,0,
Muskogee,U.S. Senate,Ray Woods,IND,510052,0,1,1,2,
Muskogee,U.S. Senate,Joan Farr,IND,510052,0,0,4,4,
Muskogee,U.S. Senate,Connie Johnson,DEM,510052,2,2,52,56,
Muskogee,U.S. Senate,James Lankford,REP,510052,3,11,85,99,
Muskogee,U.S. Senate,Mark Beard,IND,510052,0,1,4,5,
Muskogee,U.S. House,Earl Everett,DEM,510052,2,1,36,39,02
Muskogee,U.S. House,Markwayne Mullin,REP,510052,3,13,97,113,02
Muskogee,U.S. House,Jon Douthitt,IND,510052,0,1,10,11,02
Muskogee,State Senate,Charles Arnall,DEM,510052,3,2,64,69,18
Muskogee,State Senate,Kim David,REP,510052,2,13,75,90,18
Muskogee,Governor,Joe Dorman,DEM,510053,0,6,156,162,
Muskogee,Governor,Mary Fallin,REP,510053,1,7,157,165,
Muskogee,Governor,Kimberly Willis,IND,510053,0,0,14,14,
Muskogee,Governor,Richard Prawdzienski,IND,510053,0,0,4,4,
Muskogee,Lieutenant Governor,Cathy Cummings,DEM,510053,0,5,115,120,
Muskogee,Lieutenant Governor,Todd Lamb,REP,510053,1,8,218,227,
Muskogee,Superintendent of Public Instruction,John Cox,DEM,510053,0,7,170,177,
Muskogee,Superintendent of Public Instruction,Joy Hofmeister,REP,510053,1,6,162,169,
Muskogee,Commissioner of Labor,Mike Workman,DEM,510053,0,6,173,179,
Muskogee,Commissioner of Labor,Mark Costello,REP,510053,1,6,150,157,
Muskogee,U.S. Senate,Matt Silverstein,DEM,510053,0,3,95,98,
Muskogee,U.S. Senate,Jim Inhofe,REP,510053,1,10,218,229,
Muskogee,U.S. Senate,Aaron Delozier,IND,510053,0,0,3,3,
Muskogee,U.S. Senate,Ray Woods,IND,510053,0,0,6,6,
Muskogee,U.S. Senate,Joan Farr,IND,510053,0,0,11,11,
Muskogee,U.S. Senate,Connie Johnson,DEM,510053,0,6,98,104,
Muskogee,U.S. Senate,James Lankford,REP,510053,1,7,214,222,
Muskogee,U.S. Senate,Mark Beard,IND,510053,1,0,18,19,
Muskogee,U.S. House,Earl Everett,DEM,510053,0,3,70,73,02
Muskogee,U.S. House,Markwayne Mullin,REP,510053,2,9,234,245,02
Muskogee,U.S. House,Jon Douthitt,IND,510053,0,1,26,27,02
Muskogee,Governor,Joe Dorman,DEM,510055,5,35,429,469,
Muskogee,Governor,Mary Fallin,REP,510055,7,46,516,569,
Muskogee,Governor,Kimberly Willis,IND,510055,0,3,25,28,
Muskogee,Governor,Richard Prawdzienski,IND,510055,1,2,13,16,
Muskogee,Lieutenant Governor,Cathy Cummings,DEM,510055,4,31,307,342,
Muskogee,Lieutenant Governor,Todd Lamb,REP,510055,8,54,669,731,
Muskogee,Superintendent of Public Instruction,John Cox,DEM,510055,5,37,505,547,
Muskogee,Superintendent of Public Instruction,Joy Hofmeister,REP,510055,8,46,475,529,
Muskogee,Commissioner of Labor,Mike Workman,DEM,510055,4,40,423,467,
Muskogee,Commissioner of Labor,Mark Costello,REP,510055,8,44,539,591,
Muskogee,U.S. Senate,Matt Silverstein,DEM,510055,3,26,267,296,
Muskogee,U.S. Senate,Jim Inhofe,REP,510055,9,57,678,744,
Muskogee,U.S. Senate,Aaron Delozier,IND,510055,0,1,7,8,
Muskogee,U.S. Senate,Ray Woods,IND,510055,1,1,10,12,
Muskogee,U.S. Senate,Joan Farr,IND,510055,0,0,18,18,
Muskogee,U.S. Senate,Connie Johnson,DEM,510055,1,28,264,293,
Muskogee,U.S. Senate,James Lankford,REP,510055,11,55,675,741,
Muskogee,U.S. Senate,Mark Beard,IND,510055,1,2,35,38,
Muskogee,U.S. House,Earl Everett,DEM,510055,0,22,190,212,02
Muskogee,U.S. House,Markwayne Mullin,REP,510055,11,62,727,800,02
Muskogee,U.S. House,Jon Douthitt,IND,510055,2,2,59,63,02
Muskogee,Governor,Joe Dorman,DEM,510056,0,1,32,33,
Muskogee,Governor,Mary Fallin,REP,510056,1,2,63,66,
Muskogee,Governor,Kimberly Willis,IND,510056,0,0,2,2,
Muskogee,Governor,Richard Prawdzienski,IND,510056,0,0,1,1,
Muskogee,Lieutenant Governor,Cathy Cummings,DEM,510056,0,1,30,31,
Muskogee,Lieutenant Governor,Todd Lamb,REP,510056,1,2,68,71,
Muskogee,Superintendent of Public Instruction,John Cox,DEM,510056,0,1,49,50,
Muskogee,Superintendent of Public Instruction,Joy Hofmeister,REP,510056,1,2,49,52,
Muskogee,Commissioner of Labor,Mike Workman,DEM,510056,0,1,45,46,
Muskogee,Commissioner of Labor,Mark Costello,REP,510056,1,2,52,55,
Muskogee,U.S. Senate,Matt Silverstein,DEM,510056,0,1,25,26,
Muskogee,U.S. Senate,Jim Inhofe,REP,510056,1,2,68,71,
Muskogee,U.S. Senate,Aaron Delozier,IND,510056,0,0,1,1,
Muskogee,U.S. Senate,Ray Woods,IND,510056,0,0,1,1,
Muskogee,U.S. Senate,Joan Farr,IND,510056,0,0,1,1,
Muskogee,U.S. Senate,Connie Johnson,DEM,510056,0,1,29,30,
Muskogee,U.S. Senate,James Lankford,REP,510056,1,2,67,70,
Muskogee,U.S. Senate,Mark Beard,IND,510056,0,0,3,3,
Muskogee,U.S. House,Earl Everett,DEM,510056,0,1,25,26,02
Muskogee,U.S. House,Markwayne Mullin,REP,510056,1,2,71,74,02
Muskogee,U.S. House,Jon Douthitt,IND,510056,0,0,3,3,02
Muskogee,Governor,Joe Dorman,DEM,510057,0,0,5,5,
Muskogee,Governor,Mary Fallin,REP,510057,1,3,10,14,
Muskogee,Governor,Kimberly Willis,IND,510057,0,0,2,2,
Muskogee,Governor,Richard Prawdzienski,IND,510057,0,0,0,0,
Muskogee,Lieutenant Governor,Cathy Cummings,DEM,510057,0,0,4,4,
Muskogee,Lieutenant Governor,Todd Lamb,REP,510057,1,3,13,17,
Muskogee,Superintendent of Public Instruction,John Cox,DEM,510057,0,0,6,6,
Muskogee,Superintendent of Public Instruction,Joy Hofmeister,REP,510057,1,3,11,15,
Muskogee,Commissioner of Labor,Mike Workman,DEM,510057,0,0,5,5,
Muskogee,Commissioner of Labor,Mark Costello,REP,510057,1,3,12,16,
Muskogee,U.S. Senate,Matt Silverstein,DEM,510057,0,0,3,3,
Muskogee,U.S. Senate,Jim Inhofe,REP,510057,1,3,12,16,
Muskogee,U.S. Senate,Aaron Delozier,IND,510057,0,0,1,1,
Muskogee,U.S. Senate,Ray Woods,IND,510057,0,0,0,0,
Muskogee,U.S. Senate,Joan Farr,IND,510057,0,0,1,1,
Muskogee,U.S. Senate,Connie Johnson,DEM,510057,0,0,4,4,
Muskogee,U.S. Senate,James Lankford,REP,510057,1,3,12,16,
Muskogee,U.S. Senate,Mark Beard,IND,510057,0,0,1,1,
Muskogee,U.S. House,Earl Everett,DEM,510057,0,0,3,3,02
Muskogee,U.S. House,Markwayne Mullin,REP,510057,1,3,12,16,02
Muskogee,U.S. House,Jon Douthitt,IND,510057,0,0,2,2,02
Muskogee,State House,Jack Reavis,DEM,510057,0,0,4,4,14
Muskogee,State House,George Faught,REP,510057,1,3,13,17,14
Muskogee,Governor,Joe Dorman,DEM,510058,0,3,127,130,
Muskogee,Governor,Mary Fallin,REP,510058,7,2,153,162,
Muskogee,Governor,Kimberly Willis,IND,510058,0,0,4,4,
Muskogee,Governor,Richard Prawdzienski,IND,510058,0,0,1,1,
Muskogee,Lieutenant Governor,Cathy Cummings,DEM,510058,0,2,93,95,
Muskogee,Lieutenant Governor,Todd Lamb,REP,510058,7,4,190,201,
Muskogee,Superintendent of Public Instruction,John Cox,DEM,510058,5,5,156,166,
Muskogee,Superintendent of Public Instruction,Joy Hofmeister,REP,510058,2,1,128,131,
Muskogee,Commissioner of Labor,Mike Workman,DEM,510058,0,4,120,124,
Muskogee,Commissioner of Labor,Mark Costello,REP,510058,6,2,157,165,
Muskogee,U.S. Senate,Matt Silverstein,DEM,510058,0,2,88,90,
Muskogee,U.S. Senate,Jim Inhofe,REP,510058,7,4,187,198,
Muskogee,U.S. Senate,Aaron Delozier,IND,510058,0,0,2,2,
Muskogee,U.S. Senate,Ray Woods,IND,510058,0,0,4,4,
Muskogee,U.S. Senate,Joan Farr,IND,510058,0,0,2,2,
Muskogee,U.S. Senate,Connie Johnson,DEM,510058,0,2,96,98,
Muskogee,U.S. Senate,James Lankford,REP,510058,7,2,177,186,
Muskogee,U.S. Senate,Mark Beard,IND,510058,0,1,10,11,
Muskogee,U.S. House,Earl Everett,DEM,510058,0,3,71,74,02
Muskogee,U.S. House,Markwayne Mullin,REP,510058,7,2,202,211,02
Muskogee,U.S. House,Jon Douthitt,IND,510058,0,1,11,12,02
Muskogee,State Senate,Selina Jayne-Dornan,DEM,510058,1,2,110,113,8
Muskogee,State Senate,Roger Thompson,REP,510058,6,4,172,182,8
Muskogee,State House,Jack Reavis,DEM,510058,0,4,103,107,14
Muskogee,State House,George Faught,REP,510058,7,2,180,189,14
Muskogee,Governor,Joe Dorman,DEM,510059,2,12,199,213,
Muskogee,Governor,Mary Fallin,REP,510059,1,5,169,175,
Muskogee,Governor,Kimberly Willis,IND,510059,0,0,14,14,
Muskogee,Governor,Richard Prawdzienski,IND,510059,0,0,8,8,
Muskogee,Lieutenant Governor,Cathy Cummings,DEM,510059,1,10,136,147,
Muskogee,Lieutenant Governor,Todd Lamb,REP,510059,2,7,249,258,
Muskogee,Superintendent of Public Instruction,John Cox,DEM,510059,1,12,245,258,
Muskogee,Superintendent of Public Instruction,Joy Hofmeister,REP,510059,2,6,139,147,
Muskogee,Commissioner of Labor,Mike Workman,DEM,510059,2,10,203,215,
Muskogee,Commissioner of Labor,Mark Costello,REP,510059,1,7,175,183,
Muskogee,U.S. Senate,Matt Silverstein,DEM,510059,2,9,131,142,
Muskogee,U.S. Senate,Jim Inhofe,REP,510059,1,8,241,250,
Muskogee,U.S. Senate,Aaron Delozier,IND,510059,0,0,6,6,
Muskogee,U.S. Senate,Ray Woods,IND,510059,0,0,3,3,
Muskogee,U.S. Senate,Joan Farr,IND,510059,0,1,5,6,
Muskogee,U.S. Senate,Connie Johnson,DEM,510059,2,11,141,154,
Muskogee,U.S. Senate,James Lankford,REP,510059,1,7,226,234,
Muskogee,U.S. Senate,Mark Beard,IND,510059,0,0,18,18,
Muskogee,U.S. House,Earl Everett,DEM,510059,1,8,92,101,02
Muskogee,U.S. House,Markwayne Mullin,REP,510059,2,9,260,271,02
Muskogee,U.S. House,Jon Douthitt,IND,510059,0,1,33,34,02
Muskogee,State Senate,Selina Jayne-Dornan,DEM,510059,2,13,178,193,8
Muskogee,State Senate,Roger Thompson,REP,510059,1,5,208,214,8
Muskogee,Governor,Joe Dorman,DEM,510060,1,1,55,57,
Muskogee,Governor,Mary Fallin,REP,510060,1,0,50,51,
Muskogee,Governor,Kimberly Willis,IND,510060,0,0,2,2,
Muskogee,Governor,Richard Prawdzienski,IND,510060,0,1,1,2,
Muskogee,Lieutenant Governor,Cathy Cummings,DEM,510060,1,0,35,36,
Muskogee,Lieutenant Governor,Todd Lamb,REP,510060,1,2,72,75,
Muskogee,Superintendent of Public Instruction,John Cox,DEM,510060,1,2,68,71,
Muskogee,Superintendent of Public Instruction,Joy Hofmeister,REP,510060,1,0,40,41,
Muskogee,Commissioner of Labor,Mike Workman,DEM,510060,1,0,53,54,
Muskogee,Commissioner of Labor,Mark Costello,REP,510060,1,2,52,55,
Muskogee,U.S. Senate,Matt Silverstein,DEM,510060,1,0,30,31,
Muskogee,U.S. Senate,Jim Inhofe,REP,510060,1,2,77,80,
Muskogee,U.S. Senate,Aaron Delozier,IND,510060,0,0,0,0,
Muskogee,U.S. Senate,Ray Woods,IND,510060,0,0,1,1,
Muskogee,U.S. Senate,Joan Farr,IND,510060,0,0,0,0,
Muskogee,U.S. Senate,Connie Johnson,DEM,510060,1,1,39,41,
Muskogee,U.S. Senate,James Lankford,REP,510060,1,1,66,68,
Muskogee,U.S. Senate,Mark Beard,IND,510060,0,0,1,1,
Muskogee,U.S. House,Earl Everett,DEM,510060,0,0,26,26,02
Muskogee,U.S. House,Markwayne Mullin,REP,510060,2,2,77,81,02
Muskogee,U.S. House,Jon Douthitt,IND,510060,0,0,5,5,02
Muskogee,State Senate,Selina Jayne-Dornan,DEM,510060,1,2,48,51,8
Muskogee,State Senate,Roger Thompson,REP,510060,1,0,59,60,8
Muskogee,Governor,Joe Dorman,DEM,510061,1,4,132,137,
Muskogee,Governor,Mary Fallin,REP,510061,1,4,103,108,
Muskogee,Governor,Kimberly Willis,IND,510061,0,0,4,4,
Muskogee,Governor,Richard Prawdzienski,IND,510061,0,0,4,4,
Muskogee,Lieutenant Governor,Cathy Cummings,DEM,510061,1,4,102,107,
Muskogee,Lieutenant Governor,Todd Lamb,REP,510061,1,4,141,146,
Muskogee,Superintendent of Public Instruction,John Cox,DEM,510061,2,4,153,159,
Muskogee,Superintendent of Public Instruction,Joy Hofmeister,REP,510061,0,4,89,93,
Muskogee,Commissioner of Labor,Mike Workman,DEM,510061,1,4,130,135,
Muskogee,Commissioner of Labor,Mark Costello,REP,510061,1,3,110,114,
Muskogee,U.S. Senate,Matt Silverstein,DEM,510061,1,3,100,104,
Muskogee,U.S. Senate,Jim Inhofe,REP,510061,0,4,137,141,
Muskogee,U.S. Senate,Aaron Delozier,IND,510061,0,0,2,2,
Muskogee,U.S. Senate,Ray Woods,IND,510061,0,1,1,2,
Muskogee,U.S. Senate,Joan Farr,IND,510061,1,0,3,4,
Muskogee,U.S. Senate,Connie Johnson,DEM,510061,2,5,98,105,
Muskogee,U.S. Senate,James Lankford,REP,510061,0,3,137,140,
Muskogee,U.S. Senate,Mark Beard,IND,510061,0,0,8,8,
Muskogee,U.S. House,Earl Everett,DEM,510061,1,4,83,88,02
Muskogee,U.S. House,Markwayne Mullin,REP,510061,1,4,147,152,02
Muskogee,U.S. House,Jon Douthitt,IND,510061,0,0,13,13,02
Muskogee,Governor,Joe Dorman,DEM,510064,4,6,213,223,
Muskogee,Governor,Mary Fallin,REP,510064,1,5,171,177,
Muskogee,Governor,Kimberly Willis,IND,510064,1,0,16,17,
Muskogee,Governor,Richard Prawdzienski,IND,510064,0,0,5,5,
Muskogee,Lieutenant Governor,Cathy Cummings,DEM,510064,5,6,171,182,
Muskogee,Lieutenant Governor,Todd Lamb,REP,510064,1,5,232,238,
Muskogee,Superintendent of Public Instruction,John Cox,DEM,510064,5,9,273,287,
Muskogee,Superintendent of Public Instruction,Joy Hofmeister,REP,510064,1,2,131,134,
Muskogee,Commissioner of Labor,Mike Workman,DEM,510064,5,6,231,242,
Muskogee,Commissioner of Labor,Mark Costello,REP,510064,1,5,167,173,
Muskogee,U.S. Senate,Matt Silverstein,DEM,510064,4,6,130,140,
Muskogee,U.S. Senate,Jim Inhofe,REP,510064,1,5,251,257,
Muskogee,U.S. Senate,Aaron Delozier,IND,510064,0,0,7,7,
Muskogee,U.S. Senate,Ray Woods,IND,510064,0,0,10,10,
Muskogee,U.S. Senate,Joan Farr,IND,510064,1,0,5,6,
Muskogee,U.S. Senate,Connie Johnson,DEM,510064,4,5,147,156,
Muskogee,U.S. Senate,James Lankford,REP,510064,1,6,236,243,
Muskogee,U.S. Senate,Mark Beard,IND,510064,1,0,18,19,
Muskogee,U.S. House,Earl Everett,DEM,510064,4,7,113,124,02
Muskogee,U.S. House,Markwayne Mullin,REP,510064,1,4,270,275,02
Muskogee,U.S. House,Jon Douthitt,IND,510064,1,0,23,24,02
Muskogee,State Senate,Selina Jayne-Dornan,DEM,510064,5,6,200,211,8
Muskogee,State Senate,Roger Thompson,REP,510064,1,5,203,209,8
Noble,Governor,Joe Dorman,DEM,520101,1,13,106,120,
Noble,Governor,Mary Fallin,REP,520101,8,36,250,294,
Noble,Governor,Kimberly Willis,IND,520101,0,0,4,4,
Noble,Governor,Richard Prawdzienski,IND,520101,0,1,3,4,
Noble,Lieutenant Governor,Cathy Cummings,DEM,520101,1,3,60,64,
Noble,Lieutenant Governor,Todd Lamb,REP,520101,8,47,303,358,
Noble,Superintendent of Public Instruction,John Cox,DEM,520101,0,16,123,139,
Noble,Superintendent of Public Instruction,Joy Hofmeister,REP,520101,9,34,234,277,
Noble,Commissioner of Labor,Mike Workman,DEM,520101,2,12,90,104,
Noble,Commissioner of Labor,Mark Costello,REP,520101,7,37,262,306,
Noble,U.S. Senate,Matt Silverstein,DEM,520101,1,6,56,63,
Noble,U.S. Senate,Jim Inhofe,REP,520101,8,43,300,351,
Noble,U.S. Senate,Aaron Delozier,IND,520101,0,0,2,2,
Noble,U.S. Senate,Ray Woods,IND,520101,0,0,3,3,
Noble,U.S. Senate,Joan Farr,IND,520101,0,1,1,2,
Noble,U.S. Senate,Connie Johnson,DEM,520101,1,4,45,50,
Noble,U.S. Senate,James Lankford,REP,520101,8,46,307,361,
Noble,U.S. Senate,Mark Beard,IND,520101,0,0,9,9,
Noble,U.S. House,Frankie Robbins,DEM,520101,1,2,44,47,03
Noble,U.S. House,Frank Lucas,REP,520101,8,48,315,371,03
Noble,State House,Wannetta Cloyd,DEM,520101,0,2,37,39,35
Noble,State House,Dennis Casey,REP,520101,9,48,324,381,35
Noble,Governor,Joe Dorman,DEM,520102,0,6,26,32,
Noble,Governor,Mary Fallin,REP,520102,5,9,74,88,
Noble,Governor,Kimberly Willis,IND,520102,0,1,2,3,
Noble,Governor,Richard Prawdzienski,IND,520102,0,0,0,0,
Noble,Lieutenant Governor,Cathy Cummings,DEM,520102,1,5,16,22,
Noble,Lieutenant Governor,Todd Lamb,REP,520102,2,11,86,99,
Noble,Superintendent of Public Instruction,John Cox,DEM,520102,1,11,41,53,
Noble,Superintendent of Public Instruction,Joy Hofmeister,REP,520102,2,5,60,67,
Noble,Commissioner of Labor,Mike Workman,DEM,520102,0,5,31,36,
Noble,Commissioner of Labor,Mark Costello,REP,520102,3,11,68,82,
Noble,U.S. Senate,Matt Silverstein,DEM,520102,0,5,12,17,
Noble,U.S. Senate,Jim Inhofe,REP,520102,3,11,89,103,
Noble,U.S. Senate,Aaron Delozier,IND,520102,0,0,1,1,
Noble,U.S. Senate,Ray Woods,IND,520102,0,0,0,0,
Noble,U.S. Senate,Joan Farr,IND,520102,0,0,0,0,
Noble,U.S. Senate,Connie Johnson,DEM,520102,0,4,16,20,
Noble,U.S. Senate,James Lankford,REP,520102,3,12,84,99,
Noble,U.S. Senate,Mark Beard,IND,520102,0,0,1,1,
Noble,U.S. House,Frankie Robbins,DEM,520102,0,4,12,16,03
Noble,U.S. House,Frank Lucas,REP,520102,3,12,90,105,03
Noble,Governor,Joe Dorman,DEM,520103,5,1,48,54,
Noble,Governor,Mary Fallin,REP,520103,9,2,66,77,
Noble,Governor,Kimberly Willis,IND,520103,0,0,6,6,
Noble,Governor,Richard Prawdzienski,IND,520103,1,0,2,3,
Noble,Lieutenant Governor,Cathy Cummings,DEM,520103,7,1,23,31,
Noble,Lieutenant Governor,Todd Lamb,REP,520103,8,2,99,109,
Noble,Superintendent of Public Instruction,John Cox,DEM,520103,10,3,61,74,
Noble,Superintendent of Public Instruction,Joy Hofmeister,REP,520103,5,0,60,65,
Noble,Commissioner of Labor,Mike Workman,DEM,520103,9,1,45,55,
Noble,Commissioner of Labor,Mark Costello,REP,520103,6,2,74,82,
Noble,U.S. Senate,Matt Silverstein,DEM,520103,4,0,25,29,
Noble,U.S. Senate,Jim Inhofe,REP,520103,10,3,94,107,
Noble,U.S. Senate,Aaron Delozier,IND,520103,0,0,1,1,
Noble,U.S. Senate,Ray Woods,IND,520103,1,0,2,3,
Noble,U.S. Senate,Joan Farr,IND,520103,0,0,0,0,
Noble,U.S. Senate,Connie Johnson,DEM,520103,5,0,25,30,
Noble,U.S. Senate,James Lankford,REP,520103,7,3,93,103,
Noble,U.S. Senate,Mark Beard,IND,520103,3,0,3,6,
Noble,U.S. House,Frankie Robbins,DEM,520103,7,0,18,25,03
Noble,U.S. House,Frank Lucas,REP,520103,8,3,104,115,03
Noble,Governor,Joe Dorman,DEM,520104,1,2,54,57,
Noble,Governor,Mary Fallin,REP,520104,4,7,91,102,
Noble,Governor,Kimberly Willis,IND,520104,0,0,3,3,
Noble,Governor,Richard Prawdzienski,IND,520104,0,0,4,4,
Noble,Lieutenant Governor,Cathy Cummings,DEM,520104,0,0,43,43,
Noble,Lieutenant Governor,Todd Lamb,REP,520104,5,9,108,122,
Noble,Superintendent of Public Instruction,John Cox,DEM,520104,1,5,66,72,
Noble,Superintendent of Public Instruction,Joy Hofmeister,REP,520104,4,4,84,92,
Noble,Commissioner of Labor,Mike Workman,DEM,520104,1,1,55,57,
Noble,Commissioner of Labor,Mark Costello,REP,520104,4,7,96,107,
Noble,U.S. Senate,Matt Silverstein,DEM,520104,0,0,35,35,
Noble,U.S. Senate,Jim Inhofe,REP,520104,5,9,109,123,
Noble,U.S. Senate,Aaron Delozier,IND,520104,0,0,0,0,
Noble,U.S. Senate,Ray Woods,IND,520104,0,0,4,4,
Noble,U.S. Senate,Joan Farr,IND,520104,0,0,2,2,
Noble,U.S. Senate,Connie Johnson,DEM,520104,0,1,39,40,
Noble,U.S. Senate,James Lankford,REP,520104,4,8,105,117,
Noble,U.S. Senate,Mark Beard,IND,520104,1,0,8,9,
Noble,U.S. House,Frankie Robbins,DEM,520104,0,0,38,38,03
Noble,U.S. House,Frank Lucas,REP,520104,5,9,112,126,03
Noble,Governor,Joe Dorman,DEM,520105,0,1,60,61,
Noble,Governor,Mary Fallin,REP,520105,1,1,65,67,
Noble,Governor,Kimberly Willis,IND,520105,0,0,2,2,
Noble,Governor,Richard Prawdzienski,IND,520105,0,0,2,2,
Noble,Lieutenant Governor,Cathy Cummings,DEM,520105,0,0,44,44,
Noble,Lieutenant Governor,Todd Lamb,REP,520105,1,2,84,87,
Noble,Superintendent of Public Instruction,John Cox,DEM,520105,0,2,64,66,
Noble,Superintendent of Public Instruction,Joy Hofmeister,REP,520105,1,0,64,65,
Noble,Commissioner of Labor,Mike Workman,DEM,520105,0,1,60,61,
Noble,Commissioner of Labor,Mark Costello,REP,520105,1,1,64,66,
Noble,U.S. Senate,Matt Silverstein,DEM,520105,0,0,42,42,
Noble,U.S. Senate,Jim Inhofe,REP,520105,1,2,82,85,
Noble,U.S. Senate,Aaron Delozier,IND,520105,0,0,1,1,
Noble,U.S. Senate,Ray Woods,IND,520105,0,0,1,1,
Noble,U.S. Senate,Joan Farr,IND,520105,0,0,3,3,
Noble,U.S. Senate,Connie Johnson,DEM,520105,0,1,39,40,
Noble,U.S. Senate,James Lankford,REP,520105,1,1,84,86,
Noble,U.S. Senate,Mark Beard,IND,520105,0,0,5,5,
Noble,U.S. House,Frankie Robbins,DEM,520105,0,0,44,44,03
Noble,U.S. House,Frank Lucas,REP,520105,1,2,82,85,03
Noble,Governor,Joe Dorman,DEM,520106,0,0,17,17,
Noble,Governor,Mary Fallin,REP,520106,0,3,50,53,
Noble,Governor,Kimberly Willis,IND,520106,0,0,1,1,
Noble,Governor,Richard Prawdzienski,IND,520106,0,0,1,1,
Noble,Lieutenant Governor,Cathy Cummings,DEM,520106,0,0,8,8,
Noble,Lieutenant Governor,Todd Lamb,REP,520106,0,3,60,63,
Noble,Superintendent of Public Instruction,John Cox,DEM,520106,0,0,29,29,
Noble,Superintendent of Public Instruction,Joy Hofmeister,REP,520106,0,3,40,43,
Noble,Commissioner of Labor,Mike Workman,DEM,520106,0,0,17,17,
Noble,Commissioner of Labor,Mark Costello,REP,520106,0,3,51,54,
Noble,U.S. Senate,Matt Silverstein,DEM,520106,0,0,12,12,
Noble,U.S. Senate,Jim Inhofe,REP,520106,0,3,56,59,
Noble,U.S. Senate,Aaron Delozier,IND,520106,0,0,0,0,
Noble,U.S. Senate,Ray Woods,IND,520106,0,0,1,1,
Noble,U.S. Senate,Joan Farr,IND,520106,0,0,0,0,
Noble,U.S. Senate,Connie Johnson,DEM,520106,0,0,11,11,
Noble,U.S. Senate,James Lankford,REP,520106,0,3,56,59,
Noble,U.S. Senate,Mark Beard,IND,520106,0,0,2,2,
Noble,U.S. House,Frankie Robbins,DEM,520106,0,0,16,16,03
Noble,U.S. House,Frank Lucas,REP,520106,0,3,53,56,03
Noble,Governor,Joe Dorman,DEM,520201,0,31,79,110,
Noble,Governor,Mary Fallin,REP,520201,4,46,181,231,
Noble,Governor,Kimberly Willis,IND,520201,0,1,4,5,
Noble,Governor,Richard Prawdzienski,IND,520201,0,0,4,4,
Noble,Lieutenant Governor,Cathy Cummings,DEM,520201,0,23,44,67,
Noble,Lieutenant Governor,Todd Lamb,REP,520201,4,55,226,285,
Noble,Superintendent of Public Instruction,John Cox,DEM,520201,0,37,91,128,
Noble,Superintendent of Public Instruction,Joy Hofmeister,REP,520201,4,40,177,221,
Noble,Commissioner of Labor,Mike Workman,DEM,520201,0,36,75,111,
Noble,Commissioner of Labor,Mark Costello,REP,520201,4,42,189,235,
Noble,U.S. Senate,Matt Silverstein,DEM,520201,0,25,39,64,
Noble,U.S. Senate,Jim Inhofe,REP,520201,4,52,224,280,
Noble,U.S. Senate,Aaron Delozier,IND,520201,0,1,3,4,
Noble,U.S. Senate,Ray Woods,IND,520201,0,0,2,2,
Noble,U.S. Senate,Joan Farr,IND,520201,0,0,0,0,
Noble,U.S. Senate,Connie Johnson,DEM,520201,0,21,40,61,
Noble,U.S. Senate,James Lankford,REP,520201,4,57,225,286,
Noble,U.S. Senate,Mark Beard,IND,520201,0,0,4,4,
Noble,U.S. House,Frankie Robbins,DEM,520201,0,19,38,57,03
Noble,U.S. House,Frank Lucas,REP,520201,4,59,232,295,03
Noble,State House,Wannetta Cloyd,DEM,520201,0,16,34,50,35
Noble,State House,Dennis Casey,REP,520201,4,62,233,299,35
Noble,Governor,Joe Dorman,DEM,520202,1,6,43,50,
Noble,Governor,Mary Fallin,REP,520202,4,19,125,148,
Noble,Governor,Kimberly Willis,IND,520202,0,0,3,3,
Noble,Governor,Richard Prawdzienski,IND,520202,0,0,2,2,
Noble,Lieutenant Governor,Cathy Cummings,DEM,520202,0,5,31,36,
Noble,Lieutenant Governor,Todd Lamb,REP,520202,4,20,142,166,
Noble,Superintendent of Public Instruction,John Cox,DEM,520202,2,7,61,70,
Noble,Superintendent of Public Instruction,Joy Hofmeister,REP,520202,2,17,110,129,
Noble,Commissioner of Labor,Mike Workman,DEM,520202,1,9,51,61,
Noble,Commissioner of Labor,Mark Costello,REP,520202,2,15,120,137,
Noble,U.S. Senate,Matt Silverstein,DEM,520202,1,5,29,35,
Noble,U.S. Senate,Jim Inhofe,REP,520202,3,20,139,162,
Noble,U.S. Senate,Aaron Delozier,IND,520202,0,0,0,0,
Noble,U.S. Senate,Ray Woods,IND,520202,0,0,2,2,
Noble,U.S. Senate,Joan Farr,IND,520202,0,0,3,3,
Noble,U.S. Senate,Connie Johnson,DEM,520202,1,4,34,39,
Noble,U.S. Senate,James Lankford,REP,520202,3,21,134,158,
Noble,U.S. Senate,Mark Beard,IND,520202,0,0,5,5,
Noble,U.S. House,Frankie Robbins,DEM,520202,1,5,30,36,03
Noble,U.S. House,Frank Lucas,REP,520202,3,20,143,166,03
Noble,Governor,Joe Dorman,DEM,520203,1,8,44,53,
Noble,Governor,Mary Fallin,REP,520203,2,10,112,124,
Noble,Governor,Kimberly Willis,IND,520203,0,0,6,6,
Noble,Governor,Richard Prawdzienski,IND,520203,0,1,4,5,
Noble,Lieutenant Governor,Cathy Cummings,DEM,520203,1,5,29,35,
Noble,Lieutenant Governor,Todd Lamb,REP,520203,2,14,136,152,
Noble,Superintendent of Public Instruction,John Cox,DEM,520203,1,8,56,65,
Noble,Superintendent of Public Instruction,Joy Hofmeister,REP,520203,2,10,108,120,
Noble,Commissioner of Labor,Mike Workman,DEM,520203,1,12,60,73,
Noble,Commissioner of Labor,Mark Costello,REP,520203,1,6,105,112,
Noble,U.S. Senate,Matt Silverstein,DEM,520203,1,5,26,32,
Noble,U.S. Senate,Jim Inhofe,REP,520203,2,13,132,147,
Noble,U.S. Senate,Aaron Delozier,IND,520203,0,1,3,4,
Noble,U.S. Senate,Ray Woods,IND,520203,0,0,3,3,
Noble,U.S. Senate,Joan Farr,IND,520203,0,0,2,2,
Noble,U.S. Senate,Connie Johnson,DEM,520203,1,5,30,36,
Noble,U.S. Senate,James Lankford,REP,520203,2,12,127,141,
Noble,U.S. Senate,Mark Beard,IND,520203,0,2,9,11,
Noble,U.S. House,Frankie Robbins,DEM,520203,2,6,30,38,03
Noble,U.S. House,Frank Lucas,REP,520203,1,13,136,150,03
Noble,State House,Wannetta Cloyd,DEM,520203,1,6,33,40,35
Noble,State House,Dennis Casey,REP,520203,2,13,131,146,35
Noble,Governor,Joe Dorman,DEM,520301,4,21,57,82,
Noble,Governor,Mary Fallin,REP,520301,5,34,142,181,
Noble,Governor,Kimberly Willis,IND,520301,0,0,2,2,
Noble,Governor,Richard Prawdzienski,IND,520301,0,0,2,2,
Noble,Lieutenant Governor,Cathy Cummings,DEM,520301,4,12,27,43,
Noble,Lieutenant Governor,Todd Lamb,REP,520301,5,43,176,224,
Noble,Superintendent of Public Instruction,John Cox,DEM,520301,6,24,74,104,
Noble,Superintendent of Public Instruction,Joy Hofmeister,REP,520301,3,31,129,163,
Noble,Commissioner of Labor,Mike Workman,DEM,520301,4,14,57,75,
Noble,Commissioner of Labor,Mark Costello,REP,520301,5,41,142,188,
Noble,U.S. Senate,Matt Silverstein,DEM,520301,4,10,27,41,
Noble,U.S. Senate,Jim Inhofe,REP,520301,5,45,172,222,
Noble,U.S. Senate,Aaron Delozier,IND,520301,0,0,0,0,
Noble,U.S. Senate,Ray Woods,IND,520301,0,0,1,1,
Noble,U.S. Senate,Joan Farr,IND,520301,0,0,3,3,
Noble,U.S. Senate,Connie Johnson,DEM,520301,4,12,19,35,
Noble,U.S. Senate,James Lankford,REP,520301,5,42,178,225,
Noble,U.S. Senate,Mark Beard,IND,520301,0,1,5,6,
Noble,U.S. House,Frankie Robbins,DEM,520301,4,7,22,33,03
Noble,U.S. House,Frank Lucas,REP,520301,5,48,180,233,03
Noble,Governor,Joe Dorman,DEM,520305,5,2,160,167,
Noble,Governor,Mary Fallin,REP,520305,2,20,257,279,
Noble,Governor,Kimberly Willis,IND,520305,1,1,17,19,
Noble,Governor,Richard Prawdzienski,IND,520305,0,0,4,4,
Noble,Lieutenant Governor,Cathy Cummings,DEM,520305,4,2,82,88,
Noble,Lieutenant Governor,Todd Lamb,REP,520305,4,21,355,380,
Noble,Superintendent of Public Instruction,John Cox,DEM,520305,6,4,163,173,
Noble,Superintendent of Public Instruction,Joy Hofmeister,REP,520305,2,19,274,295,
Noble,Commissioner of Labor,Mike Workman,DEM,520305,3,3,135,141,
Noble,Commissioner of Labor,Mark Costello,REP,520305,4,19,295,318,
Noble,U.S. Senate,Matt Silverstein,DEM,520305,3,1,71,75,
Noble,U.S. Senate,Jim Inhofe,REP,520305,5,21,352,378,
Noble,U.S. Senate,Aaron Delozier,IND,520305,0,0,4,4,
Noble,U.S. Senate,Ray Woods,IND,520305,0,1,3,4,
Noble,U.S. Senate,Joan Farr,IND,520305,0,0,6,6,
Noble,U.S. Senate,Connie Johnson,DEM,520305,3,1,66,70,
Noble,U.S. Senate,James Lankford,REP,520305,4,21,351,376,
Noble,U.S. Senate,Mark Beard,IND,520305,1,1,20,22,
Noble,U.S. House,Frankie Robbins,DEM,520305,3,1,75,79,03
Noble,U.S. House,Frank Lucas,REP,520305,5,22,361,388,03
Noble,State House,Wannetta Cloyd,DEM,520305,2,1,38,41,35
Noble,State House,Dennis Casey,REP,520305,6,22,398,426,35
Noble,Governor,Joe Dorman,DEM,520307,5,26,93,124,
Noble,Governor,Mary Fallin,REP,520307,7,61,189,257,
Noble,Governor,Kimberly Willis,IND,520307,0,2,2,4,
Noble,Governor,Richard Prawdzienski,IND,520307,0,0,1,1,
Noble,Lieutenant Governor,Cathy Cummings,DEM,520307,4,15,46,65,
Noble,Lieutenant Governor,Todd Lamb,REP,520307,8,74,237,319,
Noble,Superintendent of Public Instruction,John Cox,DEM,520307,2,31,89,122,
Noble,Superintendent of Public Instruction,Joy Hofmeister,REP,520307,10,57,194,261,
Noble,Commissioner of Labor,Mike Workman,DEM,520307,5,29,74,108,
Noble,Commissioner of Labor,Mark Costello,REP,520307,7,60,206,273,
Noble,U.S. Senate,Matt Silverstein,DEM,520307,5,16,50,71,
Noble,U.S. Senate,Jim Inhofe,REP,520307,7,70,222,299,
Noble,U.S. Senate,Aaron Delozier,IND,520307,0,1,4,5,
Noble,U.S. Senate,Ray Woods,IND,520307,0,1,5,6,
Noble,U.S. Senate,Joan Farr,IND,520307,0,1,1,2,
Noble,U.S. Senate,Connie Johnson,DEM,520307,3,16,42,61,
Noble,U.S. Senate,James Lankford,REP,520307,9,71,236,316,
Noble,U.S. Senate,Mark Beard,IND,520307,0,1,4,5,
Noble,U.S. House,Frankie Robbins,DEM,520307,3,15,41,59,03
Noble,U.S. House,Frank Lucas,REP,520307,9,74,242,325,03
Noble,State House,Wannetta Cloyd,DEM,520307,3,15,38,56,35
Noble,State House,Dennis Casey,REP,520307,9,74,243,326,35
Nowata,Governor,Joe Dorman,DEM,530101,1,8,109,118,
Nowata,Governor,Mary Fallin,REP,530101,7,19,169,195,
Nowata,Governor,Kimberly Willis,IND,530101,0,0,5,5,
Nowata,Governor,Richard Prawdzienski,IND,530101,0,0,7,7,
Nowata,Lieutenant Governor,Cathy Cummings,DEM,530101,2,4,68,74,
Nowata,Lieutenant Governor,Todd Lamb,REP,530101,7,23,214,244,
Nowata,Superintendent of Public Instruction,John Cox,DEM,530101,1,17,155,173,
Nowata,Superintendent of Public Instruction,Joy Hofmeister,REP,530101,7,10,131,148,
Nowata,Commissioner of Labor,Mike Workman,DEM,530101,2,13,124,139,
Nowata,Commissioner of Labor,Mark Costello,REP,530101,6,12,160,178,
Nowata,U.S. Senate,Matt Silverstein,DEM,530101,1,7,73,81,
Nowata,U.S. Senate,Jim Inhofe,REP,530101,8,17,204,229,
Nowata,U.S. Senate,Aaron Delozier,IND,530101,0,1,2,3,
Nowata,U.S. Senate,Ray Woods,IND,530101,0,0,6,6,
Nowata,U.S. Senate,Joan Farr,IND,530101,0,1,3,4,
Nowata,U.S. Senate,Connie Johnson,DEM,530101,1,5,81,87,
Nowata,U.S. Senate,James Lankford,REP,530101,7,20,188,215,
Nowata,U.S. Senate,Mark Beard,IND,530101,0,2,18,20,
Nowata,U.S. House,Earl Everett,DEM,530101,1,3,53,57,02
Nowata,U.S. House,Markwayne Mullin,REP,530101,8,24,225,257,02
Nowata,U.S. House,Jon Douthitt,IND,530101,0,0,12,12,02
Nowata,State House,Anthony Tucker,DEM,530101,2,8,90,100,10
Nowata,State House,Travis Dunlap,REP,530101,6,19,196,221,10
Nowata,Governor,Joe Dorman,DEM,530102,4,9,147,160,
Nowata,Governor,Mary Fallin,REP,530102,7,23,219,249,
Nowata,Governor,Kimberly Willis,IND,530102,0,1,10,11,
Nowata,Governor,Richard Prawdzienski,IND,530102,0,0,7,7,
Nowata,Lieutenant Governor,Cathy Cummings,DEM,530102,2,4,85,91,
Nowata,Lieutenant Governor,Todd Lamb,REP,530102,9,29,293,331,
Nowata,Superintendent of Public Instruction,John Cox,DEM,530102,5,17,203,225,
Nowata,Superintendent of Public Instruction,Joy Hofmeister,REP,530102,6,14,176,196,
Nowata,Commissioner of Labor,Mike Workman,DEM,530102,5,14,161,180,
Nowata,Commissioner of Labor,Mark Costello,REP,530102,6,18,208,232,
Nowata,U.S. Senate,Matt Silverstein,DEM,530102,3,5,98,106,
Nowata,U.S. Senate,Jim Inhofe,REP,530102,8,27,264,299,
Nowata,U.S. Senate,Aaron Delozier,IND,530102,0,0,9,9,
Nowata,U.S. Senate,Ray Woods,IND,530102,0,0,5,5,
Nowata,U.S. Senate,Joan Farr,IND,530102,0,0,5,5,
Nowata,U.S. Senate,Connie Johnson,DEM,530102,2,3,96,101,
Nowata,U.S. Senate,James Lankford,REP,530102,9,26,261,296,
Nowata,U.S. Senate,Mark Beard,IND,530102,0,2,21,23,
Nowata,U.S. House,Earl Everett,DEM,530102,3,4,65,72,02
Nowata,U.S. House,Markwayne Mullin,REP,530102,8,28,299,335,02
Nowata,U.S. House,Jon Douthitt,IND,530102,0,0,17,17,02
Nowata,State House,Anthony Tucker,DEM,530102,3,9,110,122,10
Nowata,State House,Travis Dunlap,REP,530102,8,24,264,296,10
Nowata,Governor,Joe Dorman,DEM,530103,0,1,62,63,
Nowata,Governor,Mary Fallin,REP,530103,0,7,98,105,
Nowata,Governor,Kimberly Willis,IND,530103,0,0,4,4,
Nowata,Governor,Richard Prawdzienski,IND,530103,0,0,2,2,
Nowata,Lieutenant Governor,Cathy Cummings,DEM,530103,0,1,44,45,
Nowata,Lieutenant Governor,Todd Lamb,REP,530103,0,7,122,129,
Nowata,Superintendent of Public Instruction,John Cox,DEM,530103,0,0,99,99,
Nowata,Superintendent of Public Instruction,Joy Hofmeister,REP,530103,0,8,68,76,
Nowata,Commissioner of Labor,Mike Workman,DEM,530103,0,2,68,70,
Nowata,Commissioner of Labor,Mark Costello,REP,530103,0,6,98,104,
Nowata,U.S. Senate,Matt Silverstein,DEM,530103,0,1,39,40,
Nowata,U.S. Senate,Jim Inhofe,REP,530103,0,7,123,130,
Nowata,U.S. Senate,Aaron Delozier,IND,530103,0,0,3,3,
Nowata,U.S. Senate,Ray Woods,IND,530103,0,0,0,0,
Nowata,U.S. Senate,Joan Farr,IND,530103,0,0,1,1,
Nowata,U.S. Senate,Connie Johnson,DEM,530103,0,1,45,46,
Nowata,U.S. Senate,James Lankford,REP,530103,0,7,117,124,
Nowata,U.S. Senate,Mark Beard,IND,530103,0,0,4,4,
Nowata,U.S. House,Earl Everett,DEM,530103,0,1,37,38,02
Nowata,U.S. House,Markwayne Mullin,REP,530103,0,7,123,130,02
Nowata,U.S. House,Jon Douthitt,IND,530103,0,0,6,6,02
Nowata,State House,Anthony Tucker,DEM,530103,0,2,57,59,10
Nowata,State House,Travis Dunlap,REP,530103,0,6,107,113,10
Nowata,Governor,Joe Dorman,DEM,530201,2,2,54,58,
Nowata,Governor,Mary Fallin,REP,530201,6,1,127,134,
Nowata,Governor,Kimberly Willis,IND,530201,0,0,1,1,
Nowata,Governor,Richard Prawdzienski,IND,530201,0,0,2,2,
Nowata,Lieutenant Governor,Cathy Cummings,DEM,530201,2,0,43,45,
Nowata,Lieutenant Governor,Todd Lamb,REP,530201,6,3,140,149,
Nowata,Superintendent of Public Instruction,John Cox,DEM,530201,2,3,73,78,
Nowata,Superintendent of Public Instruction,Joy Hofmeister,REP,530201,6,0,107,113,
Nowata,Commissioner of Labor,Mike Workman,DEM,530201,2,0,78,80,
Nowata,Commissioner of Labor,Mark Costello,REP,530201,6,3,103,112,
Nowata,U.S. Senate,Matt Silverstein,DEM,530201,2,0,35,37,
Nowata,U.S. Senate,Jim Inhofe,REP,530201,6,3,142,151,
Nowata,U.S. Senate,Aaron Delozier,IND,530201,0,0,4,4,
Nowata,U.S. Senate,Ray Woods,IND,530201,0,0,0,0,
Nowata,U.S. Senate,Joan Farr,IND,530201,0,0,2,2,
Nowata,U.S. Senate,Connie Johnson,DEM,530201,2,0,42,44,
Nowata,U.S. Senate,James Lankford,REP,530201,6,3,132,141,
Nowata,U.S. Senate,Mark Beard,IND,530201,0,0,9,9,
Nowata,U.S. House,Earl Everett,DEM,530201,2,0,31,33,02
Nowata,U.S. House,Markwayne Mullin,REP,530201,6,3,146,155,02
Nowata,U.S. House,Jon Douthitt,IND,530201,0,0,6,6,02
Nowata,State House,Anthony Tucker,DEM,530201,2,1,47,50,10
Nowata,State House,Travis Dunlap,REP,530201,6,2,134,142,10
Nowata,Governor,Joe Dorman,DEM,530202,4,5,48,57,
Nowata,Governor,Mary Fallin,REP,530202,3,22,130,155,
Nowata,Governor,Kimberly Willis,IND,530202,0,0,4,4,
Nowata,Governor,Richard Prawdzienski,IND,530202,0,0,1,1,
Nowata,Lieutenant Governor,Cathy Cummings,DEM,530202,4,1,25,30,
Nowata,Lieutenant Governor,Todd Lamb,REP,530202,3,26,157,186,
Nowata,Superintendent of Public Instruction,John Cox,DEM,530202,4,14,75,93,
Nowata,Superintendent of Public Instruction,Joy Hofmeister,REP,530202,3,13,108,124,
Nowata,Commissioner of Labor,Mike Workman,DEM,530202,4,11,53,68,
Nowata,Commissioner of Labor,Mark Costello,REP,530202,3,16,127,146,
Nowata,U.S. Senate,Matt Silverstein,DEM,530202,3,4,25,32,
Nowata,U.S. Senate,Jim Inhofe,REP,530202,4,22,155,181,
Nowata,U.S. Senate,Aaron Delozier,IND,530202,0,1,1,2,
Nowata,U.S. Senate,Ray Woods,IND,530202,0,0,0,0,
Nowata,U.S. Senate,Joan Farr,IND,530202,0,0,3,3,
Nowata,U.S. Senate,Connie Johnson,DEM,530202,4,0,32,36,
Nowata,U.S. Senate,James Lankford,REP,530202,3,26,147,176,
Nowata,U.S. Senate,Mark Beard,IND,530202,0,1,6,7,
Nowata,U.S. House,Earl Everett,DEM,530202,2,1,20,23,02
Nowata,U.S. House,Markwayne Mullin,REP,530202,4,26,157,187,02
Nowata,U.S. House,Jon Douthitt,IND,530202,1,0,5,6,02
Nowata,State House,Anthony Tucker,DEM,530202,5,6,25,36,10
Nowata,State House,Travis Dunlap,REP,530202,2,21,155,178,10
Nowata,Governor,Joe Dorman,DEM,530203,3,21,115,139,
Nowata,Governor,Mary Fallin,REP,530203,3,25,206,234,
Nowata,Governor,Kimberly Willis,IND,530203,0,2,7,9,
Nowata,Governor,Richard Prawdzienski,IND,530203,0,2,3,5,
Nowata,Lieutenant Governor,Cathy Cummings,DEM,530203,2,20,87,109,
Nowata,Lieutenant Governor,Todd Lamb,REP,530203,4,30,245,279,
Nowata,Superintendent of Public Instruction,John Cox,DEM,530203,6,33,176,215,
Nowata,Superintendent of Public Instruction,Joy Hofmeister,REP,530203,0,16,155,171,
Nowata,Commissioner of Labor,Mike Workman,DEM,530203,4,24,126,154,
Nowata,Commissioner of Labor,Mark Costello,REP,530203,2,25,200,227,
Nowata,U.S. Senate,Matt Silverstein,DEM,530203,2,16,78,96,
Nowata,U.S. Senate,Jim Inhofe,REP,530203,4,28,237,269,
Nowata,U.S. Senate,Aaron Delozier,IND,530203,0,5,9,14,
Nowata,U.S. Senate,Ray Woods,IND,530203,0,1,2,3,
Nowata,U.S. Senate,Joan Farr,IND,530203,0,0,5,5,
Nowata,U.S. Senate,Connie Johnson,DEM,530203,3,16,85,104,
Nowata,U.S. Senate,James Lankford,REP,530203,3,29,233,265,
Nowata,U.S. Senate,Mark Beard,IND,530203,0,5,11,16,
Nowata,U.S. House,Earl Everett,DEM,530203,2,15,62,79,02
Nowata,U.S. House,Markwayne Mullin,REP,530203,4,33,254,291,02
Nowata,U.S. House,Jon Douthitt,IND,530203,0,2,13,15,02
Nowata,State House,Anthony Tucker,DEM,530203,3,24,100,127,10
Nowata,State House,Travis Dunlap,REP,530203,3,25,229,257,10
Nowata,Governor,Joe Dorman,DEM,530204,0,1,43,44,
Nowata,Governor,Mary Fallin,REP,530204,1,0,93,94,
Nowata,Governor,Kimberly Willis,IND,530204,0,0,3,3,
Nowata,Governor,Richard Prawdzienski,IND,530204,0,0,3,3,
Nowata,Lieutenant Governor,Cathy Cummings,DEM,530204,0,1,28,29,
Nowata,Lieutenant Governor,Todd Lamb,REP,530204,1,1,114,116,
Nowata,Superintendent of Public Instruction,John Cox,DEM,530204,0,2,68,70,
Nowata,Superintendent of Public Instruction,Joy Hofmeister,REP,530204,1,0,75,76,
Nowata,Commissioner of Labor,Mike Workman,DEM,530204,0,1,47,48,
Nowata,Commissioner of Labor,Mark Costello,REP,530204,1,0,95,96,
Nowata,U.S. Senate,Matt Silverstein,DEM,530204,0,1,28,29,
Nowata,U.S. Senate,Jim Inhofe,REP,530204,1,1,108,110,
Nowata,U.S. Senate,Aaron Delozier,IND,530204,0,0,5,5,
Nowata,U.S. Senate,Ray Woods,IND,530204,0,0,0,0,
Nowata,U.S. Senate,Joan Farr,IND,530204,0,0,1,1,
Nowata,U.S. Senate,Connie Johnson,DEM,530204,0,0,29,29,
Nowata,U.S. Senate,James Lankford,REP,530204,1,2,108,111,
Nowata,U.S. Senate,Mark Beard,IND,530204,0,0,4,4,
Nowata,U.S. House,Earl Everett,DEM,530204,0,0,23,23,02
Nowata,U.S. House,Markwayne Mullin,REP,530204,1,2,114,117,02
Nowata,U.S. House,Jon Douthitt,IND,530204,0,0,5,5,02
Nowata,State House,Anthony Tucker,DEM,530204,0,1,44,45,10
Nowata,State House,Travis Dunlap,REP,530204,1,0,97,98,10
Nowata,Governor,Joe Dorman,DEM,530301,0,0,131,131,
Nowata,Governor,Mary Fallin,REP,530301,8,4,200,212,
Nowata,Governor,Kimberly Willis,IND,530301,0,0,10,10,
Nowata,Governor,Richard Prawdzienski,IND,530301,0,0,5,5,
Nowata,Lieutenant Governor,Cathy Cummings,DEM,530301,0,0,111,111,
Nowata,Lieutenant Governor,Todd Lamb,REP,530301,8,4,234,246,
Nowata,Superintendent of Public Instruction,John Cox,DEM,530301,4,1,173,178,
Nowata,Superintendent of Public Instruction,Joy Hofmeister,REP,530301,4,3,173,180,
Nowata,Commissioner of Labor,Mike Workman,DEM,530301,5,1,140,146,
Nowata,Commissioner of Labor,Mark Costello,REP,530301,3,3,205,211,
Nowata,U.S. Senate,Matt Silverstein,DEM,530301,0,0,97,97,
Nowata,U.S. Senate,Jim Inhofe,REP,530301,7,4,242,253,
Nowata,U.S. Senate,Aaron Delozier,IND,530301,0,0,5,5,
Nowata,U.S. Senate,Ray Woods,IND,530301,1,0,4,5,
Nowata,U.S. Senate,Joan Farr,IND,530301,0,0,0,0,
Nowata,U.S. Senate,Connie Johnson,DEM,530301,4,0,97,101,
Nowata,U.S. Senate,James Lankford,REP,530301,3,3,230,236,
Nowata,U.S. Senate,Mark Beard,IND,530301,0,1,18,19,
Nowata,U.S. House,Earl Everett,DEM,530301,0,0,81,81,02
Nowata,U.S. House,Markwayne Mullin,REP,530301,8,4,255,267,02
Nowata,U.S. House,Jon Douthitt,IND,530301,0,0,10,10,02
Nowata,State House,Anthony Tucker,DEM,530301,5,0,133,138,10
Nowata,State House,Travis Dunlap,REP,530301,3,4,212,219,10
Nowata,Governor,Joe Dorman,DEM,530302,1,11,74,86,
Nowata,Governor,Mary Fallin,REP,530302,1,23,111,135,
Nowata,Governor,Kimberly Willis,IND,530302,0,0,6,6,
Nowata,Governor,Richard Prawdzienski,IND,530302,0,0,1,1,
Nowata,Lieutenant Governor,Cathy Cummings,DEM,530302,1,7,54,62,
Nowata,Lieutenant Governor,Todd Lamb,REP,530302,1,27,137,165,
Nowata,Superintendent of Public Instruction,John Cox,DEM,530302,1,17,108,126,
Nowata,Superintendent of Public Instruction,Joy Hofmeister,REP,530302,1,17,83,101,
Nowata,Commissioner of Labor,Mike Workman,DEM,530302,2,13,89,104,
Nowata,Commissioner of Labor,Mark Costello,REP,530302,0,21,101,122,
Nowata,U.S. Senate,Matt Silverstein,DEM,530302,1,8,53,62,
Nowata,U.S. Senate,Jim Inhofe,REP,530302,1,26,131,158,
Nowata,U.S. Senate,Aaron Delozier,IND,530302,0,0,3,3,
Nowata,U.S. Senate,Ray Woods,IND,530302,0,0,2,2,
Nowata,U.S. Senate,Joan Farr,IND,530302,0,0,1,1,
Nowata,U.S. Senate,Connie Johnson,DEM,530302,1,9,58,68,
Nowata,U.S. Senate,James Lankford,REP,530302,1,25,123,149,
Nowata,U.S. Senate,Mark Beard,IND,530302,0,0,10,10,
Nowata,U.S. House,Earl Everett,DEM,530302,1,7,47,55,02
Nowata,U.S. House,Markwayne Mullin,REP,530302,1,27,139,167,02
Nowata,U.S. House,Jon Douthitt,IND,530302,0,0,5,5,02
Nowata,State House,Anthony Tucker,DEM,530302,2,12,79,93,10
Nowata,State House,Travis Dunlap,REP,530302,0,22,113,135,10
Nowata,Governor,Joe Dorman,DEM,530303,1,0,62,63,
Nowata,Governor,Mary Fallin,REP,530303,0,5,82,87,
Nowata,Governor,Kimberly Willis,IND,530303,0,0,6,6,
Nowata,Governor,Richard Prawdzienski,IND,530303,0,0,1,1,
Nowata,Lieutenant Governor,Cathy Cummings,DEM,530303,1,0,43,44,
Nowata,Lieutenant Governor,Todd Lamb,REP,530303,0,5,109,114,
Nowata,Superintendent of Public Instruction,John Cox,DEM,530303,1,2,87,90,
Nowata,Superintendent of Public Instruction,Joy Hofmeister,REP,530303,0,3,64,67,
Nowata,Commissioner of Labor,Mike Workman,DEM,530303,1,2,75,78,
Nowata,Commissioner of Labor,Mark Costello,REP,530303,0,3,76,79,
Nowata,U.S. Senate,Matt Silverstein,DEM,530303,1,0,41,42,
Nowata,U.S. Senate,Jim Inhofe,REP,530303,0,5,105,110,
Nowata,U.S. Senate,Aaron Delozier,IND,530303,0,0,2,2,
Nowata,U.S. Senate,Ray Woods,IND,530303,0,0,2,2,
Nowata,U.S. Senate,Joan Farr,IND,530303,0,0,1,1,
Nowata,U.S. Senate,Connie Johnson,DEM,530303,1,1,44,46,
Nowata,U.S. Senate,James Lankford,REP,530303,0,4,93,97,
Nowata,U.S. Senate,Mark Beard,IND,530303,0,0,13,13,
Nowata,U.S. House,Earl Everett,DEM,530303,1,0,26,27,02
Nowata,U.S. House,Markwayne Mullin,REP,530303,0,5,117,122,02
Nowata,U.S. House,Jon Douthitt,IND,530303,0,0,6,6,02
Nowata,State House,Anthony Tucker,DEM,530303,1,2,70,73,10
Nowata,State House,Travis Dunlap,REP,530303,0,3,80,83,10
Nowata,Governor,Joe Dorman,DEM,530304,4,4,26,34,
Nowata,Governor,Mary Fallin,REP,530304,4,2,50,56,
Nowata,Governor,Kimberly Willis,IND,530304,0,0,1,1,
Nowata,Governor,Richard Prawdzienski,IND,530304,0,0,2,2,
Nowata,Lieutenant Governor,Cathy Cummings,DEM,530304,3,4,13,20,
Nowata,Lieutenant Governor,Todd Lamb,REP,530304,5,2,66,73,
Nowata,Superintendent of Public Instruction,John Cox,DEM,530304,5,4,44,53,
Nowata,Superintendent of Public Instruction,Joy Hofmeister,REP,530304,3,2,34,39,
Nowata,Commissioner of Labor,Mike Workman,DEM,530304,4,3,35,42,
Nowata,Commissioner of Labor,Mark Costello,REP,530304,3,3,39,45,
Nowata,U.S. Senate,Matt Silverstein,DEM,530304,3,3,14,20,
Nowata,U.S. Senate,Jim Inhofe,REP,530304,5,3,63,71,
Nowata,U.S. Senate,Aaron Delozier,IND,530304,0,0,1,1,
Nowata,U.S. Senate,Ray Woods,IND,530304,0,0,0,0,
Nowata,U.S. Senate,Joan Farr,IND,530304,0,0,0,0,
Nowata,U.S. Senate,Connie Johnson,DEM,530304,3,2,17,22,
Nowata,U.S. Senate,James Lankford,REP,530304,5,3,59,67,
Nowata,U.S. Senate,Mark Beard,IND,530304,0,0,1,1,
Nowata,U.S. House,Earl Everett,DEM,530304,3,2,13,18,02
Nowata,U.S. House,Markwayne Mullin,REP,530304,5,3,64,72,02
Nowata,U.S. House,Jon Douthitt,IND,530304,0,0,1,1,02
Nowata,State House,Anthony Tucker,DEM,530304,2,2,23,27,10
Nowata,State House,Travis Dunlap,REP,530304,6,3,54,63,10
Okfuskee,Governor,Joe Dorman,DEM,540101,0,2,174,176,
Okfuskee,Governor,Mary Fallin,REP,540101,1,2,317,320,
Okfuskee,Governor,Kimberly Willis,IND,540101,0,0,20,20,
Okfuskee,Governor,Richard Prawdzienski,IND,540101,0,0,9,9,
Okfuskee,Lieutenant Governor,Cathy Cummings,DEM,540101,0,3,121,124,
Okfuskee,Lieutenant Governor,Todd Lamb,REP,540101,1,2,400,403,
Okfuskee,Superintendent of Public Instruction,John Cox,DEM,540101,0,4,246,250,
Okfuskee,Superintendent of Public Instruction,Joy Hofmeister,REP,540101,1,1,270,272,
Okfuskee,Commissioner of Labor,Mike Workman,DEM,540101,1,3,177,181,
Okfuskee,Commissioner of Labor,Mark Costello,REP,540101,0,1,323,324,
Okfuskee,U.S. Senate,Matt Silverstein,DEM,540101,0,3,85,88,
Okfuskee,U.S. Senate,Jim Inhofe,REP,540101,1,1,411,413,
Okfuskee,U.S. Senate,Aaron Delozier,IND,540101,0,0,8,8,
Okfuskee,U.S. Senate,Ray Woods,IND,540101,0,0,8,8,
Okfuskee,U.S. Senate,Joan Farr,IND,540101,0,0,6,6,
Okfuskee,U.S. Senate,Connie Johnson,DEM,540101,0,3,91,94,
Okfuskee,U.S. Senate,James Lankford,REP,540101,1,2,404,407,
Okfuskee,U.S. Senate,Mark Beard,IND,540101,0,0,17,17,
Okfuskee,U.S. House,Earl Everett,DEM,540101,0,3,125,128,02
Okfuskee,U.S. House,Markwayne Mullin,REP,540101,1,2,353,356,02
Okfuskee,U.S. House,Jon Douthitt,IND,540101,0,0,27,27,02
Okfuskee,State Senate,Selina Jayne-Dornan,DEM,540101,0,3,154,157,8
Okfuskee,State Senate,Roger Thompson,REP,540101,1,2,352,355,8
Okfuskee,Governor,Joe Dorman,DEM,540102,8,4,95,107,
Okfuskee,Governor,Mary Fallin,REP,540102,3,0,8,11,
Okfuskee,Governor,Kimberly Willis,IND,540102,0,0,0,0,
Okfuskee,Governor,Richard Prawdzienski,IND,540102,0,0,0,0,
Okfuskee,Lieutenant Governor,Cathy Cummings,DEM,540102,7,2,94,103,
Okfuskee,Lieutenant Governor,Todd Lamb,REP,540102,4,2,8,14,
Okfuskee,Superintendent of Public Instruction,John Cox,DEM,540102,8,4,98,110,
Okfuskee,Superintendent of Public Instruction,Joy Hofmeister,REP,540102,3,0,5,8,
Okfuskee,Commissioner of Labor,Mike Workman,DEM,540102,7,4,96,107,
Okfuskee,Commissioner of Labor,Mark Costello,REP,540102,4,0,7,11,
Okfuskee,U.S. Senate,Matt Silverstein,DEM,540102,7,2,93,102,
Okfuskee,U.S. Senate,Jim Inhofe,REP,540102,4,2,9,15,
Okfuskee,U.S. Senate,Aaron Delozier,IND,540102,0,0,0,0,
Okfuskee,U.S. Senate,Ray Woods,IND,540102,0,0,0,0,
Okfuskee,U.S. Senate,Joan Farr,IND,540102,0,0,1,1,
Okfuskee,U.S. Senate,Connie Johnson,DEM,540102,7,4,97,108,
Okfuskee,U.S. Senate,James Lankford,REP,540102,4,0,6,10,
Okfuskee,U.S. Senate,Mark Beard,IND,540102,0,0,0,0,
Okfuskee,U.S. House,Earl Everett,DEM,540102,7,3,96,106,02
Okfuskee,U.S. House,Markwayne Mullin,REP,540102,4,1,7,12,02
Okfuskee,U.S. House,Jon Douthitt,IND,540102,0,0,0,0,02
Okfuskee,State Senate,Selina Jayne-Dornan,DEM,540102,7,2,94,103,8
Okfuskee,State Senate,Roger Thompson,REP,540102,1,2,9,12,8
Okfuskee,Governor,Joe Dorman,DEM,540103,2,0,45,47,
Okfuskee,Governor,Mary Fallin,REP,540103,2,2,51,55,
Okfuskee,Governor,Kimberly Willis,IND,540103,0,1,4,5,
Okfuskee,Governor,Richard Prawdzienski,IND,540103,0,0,1,1,
Okfuskee,Lieutenant Governor,Cathy Cummings,DEM,540103,1,1,32,34,
Okfuskee,Lieutenant Governor,Todd Lamb,REP,540103,3,2,66,71,
Okfuskee,Superintendent of Public Instruction,John Cox,DEM,540103,3,1,56,60,
Okfuskee,Superintendent of Public Instruction,Joy Hofmeister,REP,540103,1,2,39,42,
Okfuskee,Commissioner of Labor,Mike Workman,DEM,540103,3,0,57,60,
Okfuskee,Commissioner of Labor,Mark Costello,REP,540103,0,3,39,42,
Okfuskee,U.S. Senate,Matt Silverstein,DEM,540103,2,0,29,31,
Okfuskee,U.S. Senate,Jim Inhofe,REP,540103,2,3,69,74,
Okfuskee,U.S. Senate,Aaron Delozier,IND,540103,0,0,0,0,
Okfuskee,U.S. Senate,Ray Woods,IND,540103,0,0,1,1,
Okfuskee,U.S. Senate,Joan Farr,IND,540103,0,0,1,1,
Okfuskee,U.S. Senate,Connie Johnson,DEM,540103,2,1,35,38,
Okfuskee,U.S. Senate,James Lankford,REP,540103,2,2,57,61,
Okfuskee,U.S. Senate,Mark Beard,IND,540103,0,0,4,4,
Okfuskee,U.S. House,Earl Everett,DEM,540103,2,0,31,33,02
Okfuskee,U.S. House,Markwayne Mullin,REP,540103,2,3,63,68,02
Okfuskee,U.S. House,Jon Douthitt,IND,540103,0,0,4,4,02
Okfuskee,State Senate,Selina Jayne-Dornan,DEM,540103,2,1,45,48,8
Okfuskee,State Senate,Roger Thompson,REP,540103,2,2,56,60,8
Okfuskee,Governor,Joe Dorman,DEM,540105,1,11,68,80,
Okfuskee,Governor,Mary Fallin,REP,540105,0,4,55,59,
Okfuskee,Governor,Kimberly Willis,IND,540105,0,0,0,0,
Okfuskee,Governor,Richard Prawdzienski,IND,540105,0,1,1,2,
Okfuskee,Lieutenant Governor,Cathy Cummings,DEM,540105,1,7,52,60,
Okfuskee,Lieutenant Governor,Todd Lamb,REP,540105,0,9,71,80,
Okfuskee,Superintendent of Public Instruction,John Cox,DEM,540105,1,11,83,95,
Okfuskee,Superintendent of Public Instruction,Joy Hofmeister,REP,540105,0,5,40,45,
Okfuskee,Commissioner of Labor,Mike Workman,DEM,540105,1,9,74,84,
Okfuskee,Commissioner of Labor,Mark Costello,REP,540105,0,7,47,54,
Okfuskee,U.S. Senate,Matt Silverstein,DEM,540105,1,5,51,57,
Okfuskee,U.S. Senate,Jim Inhofe,REP,540105,0,11,66,77,
Okfuskee,U.S. Senate,Aaron Delozier,IND,540105,0,0,2,2,
Okfuskee,U.S. Senate,Ray Woods,IND,540105,0,0,3,3,
Okfuskee,U.S. Senate,Joan Farr,IND,540105,0,0,1,1,
Okfuskee,U.S. Senate,Connie Johnson,DEM,540105,1,5,49,55,
Okfuskee,U.S. Senate,James Lankford,REP,540105,0,11,69,80,
Okfuskee,U.S. Senate,Mark Beard,IND,540105,0,0,4,4,
Okfuskee,U.S. House,Earl Everett,DEM,540105,1,7,45,53,02
Okfuskee,U.S. House,Markwayne Mullin,REP,540105,0,8,75,83,02
Okfuskee,U.S. House,Jon Douthitt,IND,540105,0,1,2,3,02
Okfuskee,State Senate,Selina Jayne-Dornan,DEM,540105,1,9,71,81,8
Okfuskee,State Senate,Roger Thompson,REP,540105,0,7,52,59,8
Okfuskee,Governor,Joe Dorman,DEM,540206,6,4,95,105,
Okfuskee,Governor,Mary Fallin,REP,540206,6,15,127,148,
Okfuskee,Governor,Kimberly Willis,IND,540206,0,1,4,5,
Okfuskee,Governor,Richard Prawdzienski,IND,540206,0,0,3,3,
Okfuskee,Lieutenant Governor,Cathy Cummings,DEM,540206,4,3,67,74,
Okfuskee,Lieutenant Governor,Todd Lamb,REP,540206,8,16,160,184,
Okfuskee,Superintendent of Public Instruction,John Cox,DEM,540206,7,7,161,175,
Okfuskee,Superintendent of Public Instruction,Joy Hofmeister,REP,540206,5,13,69,87,
Okfuskee,Commissioner of Labor,Mike Workman,DEM,540206,5,3,99,107,
Okfuskee,Commissioner of Labor,Mark Costello,REP,540206,7,15,119,141,
Okfuskee,U.S. Senate,Matt Silverstein,DEM,540206,4,3,56,63,
Okfuskee,U.S. Senate,Jim Inhofe,REP,540206,8,15,170,193,
Okfuskee,U.S. Senate,Aaron Delozier,IND,540206,0,0,1,1,
Okfuskee,U.S. Senate,Ray Woods,IND,540206,0,0,1,1,
Okfuskee,U.S. Senate,Joan Farr,IND,540206,0,0,0,0,
Okfuskee,U.S. Senate,Connie Johnson,DEM,540206,4,2,54,60,
Okfuskee,U.S. Senate,James Lankford,REP,540206,8,15,171,194,
Okfuskee,U.S. Senate,Mark Beard,IND,540206,0,2,4,6,
Okfuskee,U.S. House,Earl Everett,DEM,540206,3,1,45,49,02
Okfuskee,U.S. House,Markwayne Mullin,REP,540206,8,18,176,202,02
Okfuskee,U.S. House,Jon Douthitt,IND,540206,1,0,8,9,02
Okfuskee,State Senate,Selina Jayne-Dornan,DEM,540206,7,6,99,112,8
Okfuskee,State Senate,Roger Thompson,REP,540206,5,14,129,148,8
Okfuskee,Governor,Joe Dorman,DEM,540207,1,4,32,37,
Okfuskee,Governor,Mary Fallin,REP,540207,2,6,42,50,
Okfuskee,Governor,Kimberly Willis,IND,540207,0,0,3,3,
Okfuskee,Governor,Richard Prawdzienski,IND,540207,0,0,0,0,
Okfuskee,Lieutenant Governor,Cathy Cummings,DEM,540207,1,3,21,25,
Okfuskee,Lieutenant Governor,Todd Lamb,REP,540207,1,7,55,63,
Okfuskee,Superintendent of Public Instruction,John Cox,DEM,540207,2,6,38,46,
Okfuskee,Superintendent of Public Instruction,Joy Hofmeister,REP,540207,1,4,38,43,
Okfuskee,Commissioner of Labor,Mike Workman,DEM,540207,1,5,28,34,
Okfuskee,Commissioner of Labor,Mark Costello,REP,540207,2,5,47,54,
Okfuskee,U.S. Senate,Matt Silverstein,DEM,540207,1,3,19,23,
Okfuskee,U.S. Senate,Jim Inhofe,REP,540207,2,6,55,63,
Okfuskee,U.S. Senate,Aaron Delozier,IND,540207,0,0,0,0,
Okfuskee,U.S. Senate,Ray Woods,IND,540207,0,0,1,1,
Okfuskee,U.S. Senate,Joan Farr,IND,540207,0,0,0,0,
Okfuskee,U.S. Senate,Connie Johnson,DEM,540207,1,4,22,27,
Okfuskee,U.S. Senate,James Lankford,REP,540207,2,6,55,63,
Okfuskee,U.S. Senate,Mark Beard,IND,540207,0,0,0,0,
Okfuskee,U.S. House,Earl Everett,DEM,540207,1,4,17,22,02
Okfuskee,U.S. House,Markwayne Mullin,REP,540207,2,5,57,64,02
Okfuskee,U.S. House,Jon Douthitt,IND,540207,0,1,2,3,02
Okfuskee,State Senate,Selina Jayne-Dornan,DEM,540207,1,3,30,34,8
Okfuskee,State Senate,Roger Thompson,REP,540207,2,7,46,55,8
Okfuskee,Governor,Joe Dorman,DEM,540208,3,14,70,87,
Okfuskee,Governor,Mary Fallin,REP,540208,6,17,81,104,
Okfuskee,Governor,Kimberly Willis,IND,540208,0,0,3,3,
Okfuskee,Governor,Richard Prawdzienski,IND,540208,1,0,2,3,
Okfuskee,Lieutenant Governor,Cathy Cummings,DEM,540208,5,5,40,50,
Okfuskee,Lieutenant Governor,Todd Lamb,REP,540208,5,25,114,144,
Okfuskee,Superintendent of Public Instruction,John Cox,DEM,540208,3,17,102,122,
Okfuskee,Superintendent of Public Instruction,Joy Hofmeister,REP,540208,7,14,52,73,
Okfuskee,Commissioner of Labor,Mike Workman,DEM,540208,3,12,65,80,
Okfuskee,Commissioner of Labor,Mark Costello,REP,540208,6,17,83,106,
Okfuskee,U.S. Senate,Matt Silverstein,DEM,540208,3,8,36,47,
Okfuskee,U.S. Senate,Jim Inhofe,REP,540208,7,22,111,140,
Okfuskee,U.S. Senate,Aaron Delozier,IND,540208,0,0,4,4,
Okfuskee,U.S. Senate,Ray Woods,IND,540208,0,0,2,2,
Okfuskee,U.S. Senate,Joan Farr,IND,540208,0,0,1,1,
Okfuskee,U.S. Senate,Connie Johnson,DEM,540208,3,5,43,51,
Okfuskee,U.S. Senate,James Lankford,REP,540208,7,25,105,137,
Okfuskee,U.S. Senate,Mark Beard,IND,540208,0,0,7,7,
Okfuskee,U.S. House,Earl Everett,DEM,540208,3,5,27,35,02
Okfuskee,U.S. House,Markwayne Mullin,REP,540208,7,25,117,149,02
Okfuskee,U.S. House,Jon Douthitt,IND,540208,0,0,9,9,02
Okfuskee,State Senate,Selina Jayne-Dornan,DEM,540208,3,11,71,85,8
Okfuskee,State Senate,Roger Thompson,REP,540208,7,20,85,112,8
Okfuskee,Governor,Joe Dorman,DEM,540209,7,15,162,184,
Okfuskee,Governor,Mary Fallin,REP,540209,14,21,167,202,
Okfuskee,Governor,Kimberly Willis,IND,540209,0,1,7,8,
Okfuskee,Governor,Richard Prawdzienski,IND,540209,0,1,2,3,
Okfuskee,Lieutenant Governor,Cathy Cummings,DEM,540209,8,6,125,139,
Okfuskee,Lieutenant Governor,Todd Lamb,REP,540209,13,30,208,251,
Okfuskee,Superintendent of Public Instruction,John Cox,DEM,540209,11,16,210,237,
Okfuskee,Superintendent of Public Instruction,Joy Hofmeister,REP,540209,10,21,126,157,
Okfuskee,Commissioner of Labor,Mike Workman,DEM,540209,8,13,154,175,
Okfuskee,Commissioner of Labor,Mark Costello,REP,540209,11,22,170,203,
Okfuskee,U.S. Senate,Matt Silverstein,DEM,540209,4,7,103,114,
Okfuskee,U.S. Senate,Jim Inhofe,REP,540209,16,28,221,265,
Okfuskee,U.S. Senate,Aaron Delozier,IND,540209,0,0,3,3,
Okfuskee,U.S. Senate,Ray Woods,IND,540209,0,0,4,4,
Okfuskee,U.S. Senate,Joan Farr,IND,540209,1,2,3,6,
Okfuskee,U.S. Senate,Connie Johnson,DEM,540209,5,5,98,108,
Okfuskee,U.S. Senate,James Lankford,REP,540209,15,32,225,272,
Okfuskee,U.S. Senate,Mark Beard,IND,540209,1,0,11,12,
Okfuskee,U.S. House,Earl Everett,DEM,540209,2,6,91,99,02
Okfuskee,U.S. House,Markwayne Mullin,REP,540209,19,28,219,266,02
Okfuskee,U.S. House,Jon Douthitt,IND,540209,0,1,20,21,02
Okfuskee,State Senate,Selina Jayne-Dornan,DEM,540209,8,13,158,179,8
Okfuskee,State Senate,Roger Thompson,REP,540209,13,25,180,218,8
Okfuskee,Governor,Joe Dorman,DEM,540210,1,12,55,68,
Okfuskee,Governor,Mary Fallin,REP,540210,3,12,42,57,
Okfuskee,Governor,Kimberly Willis,IND,540210,0,1,4,5,
Okfuskee,Governor,Richard Prawdzienski,IND,540210,0,0,2,2,
Okfuskee,Lieutenant Governor,Cathy Cummings,DEM,540210,2,5,30,37,
Okfuskee,Lieutenant Governor,Todd Lamb,REP,540210,2,20,71,93,
Okfuskee,Superintendent of Public Instruction,John Cox,DEM,540210,3,14,73,90,
Okfuskee,Superintendent of Public Instruction,Joy Hofmeister,REP,540210,1,10,30,41,
Okfuskee,Commissioner of Labor,Mike Workman,DEM,540210,2,11,50,63,
Okfuskee,Commissioner of Labor,Mark Costello,REP,540210,1,14,50,65,
Okfuskee,U.S. Senate,Matt Silverstein,DEM,540210,2,4,27,33,
Okfuskee,U.S. Senate,Jim Inhofe,REP,540210,2,21,72,95,
Okfuskee,U.S. Senate,Aaron Delozier,IND,540210,0,0,1,1,
Okfuskee,U.S. Senate,Ray Woods,IND,540210,0,0,3,3,
Okfuskee,U.S. Senate,Joan Farr,IND,540210,0,0,0,0,
Okfuskee,U.S. Senate,Connie Johnson,DEM,540210,2,3,28,33,
Okfuskee,U.S. Senate,James Lankford,REP,540210,2,21,73,96,
Okfuskee,U.S. Senate,Mark Beard,IND,540210,0,1,1,2,
Okfuskee,U.S. House,Earl Everett,DEM,540210,2,7,30,39,02
Okfuskee,U.S. House,Markwayne Mullin,REP,540210,2,18,69,89,02
Okfuskee,U.S. House,Jon Douthitt,IND,540210,0,0,3,3,02
Okfuskee,Governor,Joe Dorman,DEM,540311,4,6,75,85,
Okfuskee,Governor,Mary Fallin,REP,540311,9,8,73,90,
Okfuskee,Governor,Kimberly Willis,IND,540311,0,0,5,5,
Okfuskee,Governor,Richard Prawdzienski,IND,540311,0,0,2,2,
Okfuskee,Lieutenant Governor,Cathy Cummings,DEM,540311,4,3,59,66,
Okfuskee,Lieutenant Governor,Todd Lamb,REP,540311,9,11,95,115,
Okfuskee,Superintendent of Public Instruction,John Cox,DEM,540311,5,10,91,106,
Okfuskee,Superintendent of Public Instruction,Joy Hofmeister,REP,540311,8,4,63,75,
Okfuskee,Commissioner of Labor,Mike Workman,DEM,540311,5,9,83,97,
Okfuskee,Commissioner of Labor,Mark Costello,REP,540311,7,5,71,83,
Okfuskee,U.S. Senate,Matt Silverstein,DEM,540311,4,3,57,64,
Okfuskee,U.S. Senate,Jim Inhofe,REP,540311,9,10,93,112,
Okfuskee,U.S. Senate,Aaron Delozier,IND,540311,0,0,0,0,
Okfuskee,U.S. Senate,Ray Woods,IND,540311,0,1,2,3,
Okfuskee,U.S. Senate,Joan Farr,IND,540311,0,0,1,1,
Okfuskee,U.S. Senate,Connie Johnson,DEM,540311,4,4,60,68,
Okfuskee,U.S. Senate,James Lankford,REP,540311,9,10,91,110,
Okfuskee,U.S. Senate,Mark Beard,IND,540311,0,0,3,3,
Okfuskee,U.S. House,Earl Everett,DEM,540311,4,4,55,63,02
Okfuskee,U.S. House,Markwayne Mullin,REP,540311,9,10,94,113,02
Okfuskee,U.S. House,Jon Douthitt,IND,540311,0,0,6,6,02
Okfuskee,State Senate,Selina Jayne-Dornan,DEM,540311,5,6,79,90,8
Okfuskee,State Senate,Roger Thompson,REP,540311,7,8,76,91,8
Okfuskee,Governor,Joe Dorman,DEM,540312,11,3,127,141,
Okfuskee,Governor,Mary Fallin,REP,540312,6,9,86,101,
Okfuskee,Governor,Kimberly Willis,IND,540312,0,0,4,4,
Okfuskee,Governor,Richard Prawdzienski,IND,540312,0,0,3,3,
Okfuskee,Lieutenant Governor,Cathy Cummings,DEM,540312,11,5,92,108,
Okfuskee,Lieutenant Governor,Todd Lamb,REP,540312,6,7,130,143,
Okfuskee,Superintendent of Public Instruction,John Cox,DEM,540312,14,7,140,161,
Okfuskee,Superintendent of Public Instruction,Joy Hofmeister,REP,540312,3,6,83,92,
Okfuskee,Commissioner of Labor,Mike Workman,DEM,540312,8,5,118,131,
Okfuskee,Commissioner of Labor,Mark Costello,REP,540312,9,6,101,116,
Okfuskee,U.S. Senate,Matt Silverstein,DEM,540312,7,3,74,84,
Okfuskee,U.S. Senate,Jim Inhofe,REP,540312,9,9,136,154,
Okfuskee,U.S. Senate,Aaron Delozier,IND,540312,0,0,2,2,
Okfuskee,U.S. Senate,Ray Woods,IND,540312,1,0,5,6,
Okfuskee,U.S. Senate,Joan Farr,IND,540312,0,0,3,3,
Okfuskee,U.S. Senate,Connie Johnson,DEM,540312,6,4,76,86,
Okfuskee,U.S. Senate,James Lankford,REP,540312,9,8,137,154,
Okfuskee,U.S. Senate,Mark Beard,IND,540312,2,0,9,11,
Okfuskee,U.S. House,Earl Everett,DEM,540312,8,2,73,83,02
Okfuskee,U.S. House,Markwayne Mullin,REP,540312,8,9,140,157,02
Okfuskee,U.S. House,Jon Douthitt,IND,540312,1,1,7,9,02
Okfuskee,Governor,Joe Dorman,DEM,540313,1,0,35,36,
Okfuskee,Governor,Mary Fallin,REP,540313,0,1,18,19,
Okfuskee,Governor,Kimberly Willis,IND,540313,0,0,0,0,
Okfuskee,Governor,Richard Prawdzienski,IND,540313,0,0,1,1,
Okfuskee,Lieutenant Governor,Cathy Cummings,DEM,540313,0,0,24,24,
Okfuskee,Lieutenant Governor,Todd Lamb,REP,540313,1,1,29,31,
Okfuskee,Superintendent of Public Instruction,John Cox,DEM,540313,1,0,40,41,
Okfuskee,Superintendent of Public Instruction,Joy Hofmeister,REP,540313,0,1,14,15,
Okfuskee,Commissioner of Labor,Mike Workman,DEM,540313,1,0,39,40,
Okfuskee,Commissioner of Labor,Mark Costello,REP,540313,0,1,15,16,
Okfuskee,U.S. Senate,Matt Silverstein,DEM,540313,0,0,24,24,
Okfuskee,U.S. Senate,Jim Inhofe,REP,540313,1,1,29,31,
Okfuskee,U.S. Senate,Aaron Delozier,IND,540313,0,0,0,0,
Okfuskee,U.S. Senate,Ray Woods,IND,540313,0,0,0,0,
Okfuskee,U.S. Senate,Joan Farr,IND,540313,0,0,0,0,
Okfuskee,U.S. Senate,Connie Johnson,DEM,540313,0,0,24,24,
Okfuskee,U.S. Senate,James Lankford,REP,540313,1,1,25,27,
Okfuskee,U.S. Senate,Mark Beard,IND,540313,0,0,2,2,
Okfuskee,U.S. House,Earl Everett,DEM,540313,0,0,22,22,02
Okfuskee,U.S. House,Markwayne Mullin,REP,540313,1,1,31,33,02
Okfuskee,U.S. House,Jon Douthitt,IND,540313,0,0,1,1,02
Okfuskee,State Senate,Selina Jayne-Dornan,DEM,540313,1,0,30,31,8
Okfuskee,State Senate,Roger Thompson,REP,540313,0,1,24,25,8
Okfuskee,Governor,Joe Dorman,DEM,540314,4,14,83,101,
Okfuskee,Governor,Mary Fallin,REP,540314,3,15,56,74,
Okfuskee,Governor,Kimberly Willis,IND,540314,0,0,4,4,
Okfuskee,Governor,Richard Prawdzienski,IND,540314,0,0,0,0,
Okfuskee,Lieutenant Governor,Cathy Cummings,DEM,540314,5,8,62,75,
Okfuskee,Lieutenant Governor,Todd Lamb,REP,540314,2,20,82,104,
Okfuskee,Superintendent of Public Instruction,John Cox,DEM,540314,6,15,88,109,
Okfuskee,Superintendent of Public Instruction,Joy Hofmeister,REP,540314,1,14,53,68,
Okfuskee,Commissioner of Labor,Mike Workman,DEM,540314,5,10,77,92,
Okfuskee,Commissioner of Labor,Mark Costello,REP,540314,2,15,65,82,
Okfuskee,U.S. Senate,Matt Silverstein,DEM,540314,4,5,58,67,
Okfuskee,U.S. Senate,Jim Inhofe,REP,540314,3,20,79,102,
Okfuskee,U.S. Senate,Aaron Delozier,IND,540314,0,0,1,1,
Okfuskee,U.S. Senate,Ray Woods,IND,540314,0,0,2,2,
Okfuskee,U.S. Senate,Joan Farr,IND,540314,0,1,4,5,
Okfuskee,U.S. Senate,Connie Johnson,DEM,540314,3,7,55,65,
Okfuskee,U.S. Senate,James Lankford,REP,540314,3,19,81,103,
Okfuskee,U.S. Senate,Mark Beard,IND,540314,0,1,8,9,
Okfuskee,U.S. House,Earl Everett,DEM,540314,4,9,49,62,02
Okfuskee,U.S. House,Markwayne Mullin,REP,540314,3,19,85,107,02
Okfuskee,U.S. House,Jon Douthitt,IND,540314,0,0,9,9,02
Okfuskee,State Senate,Selina Jayne-Dornan,DEM,540314,6,9,80,95,8
Okfuskee,State Senate,Roger Thompson,REP,540314,1,20,63,84,8
Oklahoma,Governor,Joe Dorman,DEM,550001,0,0,181,181,
Oklahoma,Governor,Mary Fallin,REP,550001,0,0,232,232,
Oklahoma,Governor,Kimberly Willis,IND,550001,0,0,8,8,
Oklahoma,Governor,Richard Prawdzienski,IND,550001,0,0,4,4,
Oklahoma,Lieutenant Governor,Cathy Cummings,DEM,550001,0,0,152,152,
Oklahoma,Lieutenant Governor,Todd Lamb,REP,550001,0,0,271,271,
Oklahoma,Superintendent of Public Instruction,John Cox,DEM,550001,0,0,191,191,
Oklahoma,Superintendent of Public Instruction,Joy Hofmeister,REP,550001,0,0,231,231,
Oklahoma,Commissioner of Labor,Mike Workman,DEM,550001,0,0,170,170,
Oklahoma,Commissioner of Labor,Mark Costello,REP,550001,0,0,246,246,
Oklahoma,U.S. Senate,Matt Silverstein,DEM,550001,0,0,136,136,
Oklahoma,U.S. Senate,Jim Inhofe,REP,550001,0,0,267,267,
Oklahoma,U.S. Senate,Aaron Delozier,IND,550001,0,0,8,8,
Oklahoma,U.S. Senate,Ray Woods,IND,550001,0,0,6,6,
Oklahoma,U.S. Senate,Joan Farr,IND,550001,0,0,6,6,
Oklahoma,U.S. Senate,Connie Johnson,DEM,550001,0,0,154,154,
Oklahoma,U.S. Senate,James Lankford,REP,550001,0,0,261,261,
Oklahoma,U.S. Senate,Mark Beard,IND,550001,0,0,8,8,
Oklahoma,U.S. House,Al Mcaffrey,DEM,550001,0,0,139,139,05
Oklahoma,U.S. House,Steve Russell,REP,550001,0,0,265,265,05
Oklahoma,U.S. House,Buddy Ray,IND,550001,0,0,0,0,05
Oklahoma,U.S. House,Tom Boggs,IND,550001,0,0,9,9,05
Oklahoma,U.S. House,Robert Murphy,IND,550001,0,0,9,9,05
Oklahoma,Governor,Joe Dorman,DEM,550002,0,0,132,132,
Oklahoma,Governor,Mary Fallin,REP,550002,0,0,283,283,
Oklahoma,Governor,Kimberly Willis,IND,550002,0,0,12,12,
Oklahoma,Governor,Richard Prawdzienski,IND,550002,0,0,3,3,
Oklahoma,Lieutenant Governor,Cathy Cummings,DEM,550002,0,0,111,111,
Oklahoma,Lieutenant Governor,Todd Lamb,REP,550002,0,0,318,318,
Oklahoma,Superintendent of Public Instruction,John Cox,DEM,550002,0,0,140,140,
Oklahoma,Superintendent of Public Instruction,Joy Hofmeister,REP,550002,0,0,285,285,
Oklahoma,Commissioner of Labor,Mike Workman,DEM,550002,0,0,110,110,
Oklahoma,Commissioner of Labor,Mark Costello,REP,550002,0,0,310,310,
Oklahoma,U.S. Senate,Matt Silverstein,DEM,550002,0,0,101,101,
Oklahoma,U.S. Senate,Jim Inhofe,REP,550002,0,0,318,318,
Oklahoma,U.S. Senate,Aaron Delozier,IND,550002,0,0,3,3,
Oklahoma,U.S. Senate,Ray Woods,IND,550002,0,0,4,4,
Oklahoma,U.S. Senate,Joan Farr,IND,550002,0,0,4,4,
Oklahoma,U.S. Senate,Connie Johnson,DEM,550002,0,0,98,98,
Oklahoma,U.S. Senate,James Lankford,REP,550002,0,0,323,323,
Oklahoma,U.S. Senate,Mark Beard,IND,550002,0,0,10,10,
Oklahoma,U.S. House,Al Mcaffrey,DEM,550002,0,0,100,100,05
Oklahoma,U.S. House,Steve Russell,REP,550002,0,0,314,314,05
Oklahoma,U.S. House,Buddy Ray,IND,550002,0,0,4,4,05
Oklahoma,U.S. House,Tom Boggs,IND,550002,0,0,4,4,05
Oklahoma,U.S. House,Robert Murphy,IND,550002,0,0,8,8,05
Oklahoma,Governor,Joe Dorman,DEM,550003,0,0,211,211,
Oklahoma,Governor,Mary Fallin,REP,550003,0,0,380,380,
Oklahoma,Governor,Kimberly Willis,IND,550003,0,0,15,15,
Oklahoma,Governor,Richard Prawdzienski,IND,550003,0,0,6,6,
Oklahoma,Lieutenant Governor,Cathy Cummings,DEM,550003,0,0,151,151,
Oklahoma,Lieutenant Governor,Todd Lamb,REP,550003,0,0,461,461,
Oklahoma,Superintendent of Public Instruction,John Cox,DEM,550003,0,0,227,227,
Oklahoma,Superintendent of Public Instruction,Joy Hofmeister,REP,550003,0,0,382,382,
Oklahoma,Commissioner of Labor,Mike Workman,DEM,550003,0,0,168,168,
Oklahoma,Commissioner of Labor,Mark Costello,REP,550003,0,0,431,431,
Oklahoma,U.S. Senate,Matt Silverstein,DEM,550003,0,0,137,137,
Oklahoma,U.S. Senate,Jim Inhofe,REP,550003,0,0,447,447,
Oklahoma,U.S. Senate,Aaron Delozier,IND,550003,0,0,4,4,
Oklahoma,U.S. Senate,Ray Woods,IND,550003,0,0,9,9,
Oklahoma,U.S. Senate,Joan Farr,IND,550003,0,0,11,11,
Oklahoma,U.S. Senate,Connie Johnson,DEM,550003,0,0,132,132,
Oklahoma,U.S. Senate,James Lankford,REP,550003,0,0,461,461,
Oklahoma,U.S. Senate,Mark Beard,IND,550003,0,0,20,20,
Oklahoma,U.S. House,Al Mcaffrey,DEM,550003,0,0,139,139,05
Oklahoma,U.S. House,Steve Russell,REP,550003,0,0,441,441,05
Oklahoma,U.S. House,Buddy Ray,IND,550003,0,0,3,3,05
Oklahoma,U.S. House,Tom Boggs,IND,550003,0,0,20,20,05
Oklahoma,U.S. House,Robert Murphy,IND,550003,0,0,9,9,05
Oklahoma,Governor,Joe Dorman,DEM,550004,0,0,229,229,
Oklahoma,Governor,Mary Fallin,REP,550004,0,0,480,480,
Oklahoma,Governor,Kimberly Willis,IND,550004,0,0,13,13,
Oklahoma,Governor,Richard Prawdzienski,IND,550004,0,0,12,12,
Oklahoma,Lieutenant Governor,Cathy Cummings,DEM,550004,0,0,162,162,
Oklahoma,Lieutenant Governor,Todd Lamb,REP,550004,0,0,570,570,
Oklahoma,Superintendent of Public Instruction,John Cox,DEM,550004,0,0,225,225,
Oklahoma,Superintendent of Public Instruction,Joy Hofmeister,REP,550004,0,0,501,501,
Oklahoma,Commissioner of Labor,Mike Workman,DEM,550004,0,0,183,183,
Oklahoma,Commissioner of Labor,Mark Costello,REP,550004,0,0,519,519,
Oklahoma,U.S. Senate,Matt Silverstein,DEM,550004,0,0,126,126,
Oklahoma,U.S. Senate,Jim Inhofe,REP,550004,0,0,582,582,
Oklahoma,U.S. Senate,Aaron Delozier,IND,550004,0,0,6,6,
Oklahoma,U.S. Senate,Ray Woods,IND,550004,0,0,8,8,
Oklahoma,U.S. Senate,Joan Farr,IND,550004,0,0,7,7,
Oklahoma,U.S. Senate,Connie Johnson,DEM,550004,0,0,139,139,
Oklahoma,U.S. Senate,James Lankford,REP,550004,0,0,571,571,
Oklahoma,U.S. Senate,Mark Beard,IND,550004,0,0,22,22,
Oklahoma,U.S. House,Al Mcaffrey,DEM,550004,0,0,136,136,05
Oklahoma,U.S. House,Steve Russell,REP,550004,0,0,545,545,05
Oklahoma,U.S. House,Buddy Ray,IND,550004,0,0,9,9,05
Oklahoma,U.S. House,Tom Boggs,IND,550004,0,0,19,19,05
Oklahoma,U.S. House,Robert Murphy,IND,550004,0,0,7,7,05
Oklahoma,Governor,Joe Dorman,DEM,550005,0,0,185,185,
Oklahoma,Governor,Mary Fallin,REP,550005,0,0,339,339,
Oklahoma,Governor,Kimberly Willis,IND,550005,0,0,9,9,
Oklahoma,Governor,Richard Prawdzienski,IND,550005,0,0,7,7,
Oklahoma,Lieutenant Governor,Cathy Cummings,DEM,550005,0,0,147,147,
Oklahoma,Lieutenant Governor,Todd Lamb,REP,550005,0,0,392,392,
Oklahoma,Superintendent of Public Instruction,John Cox,DEM,550005,0,0,197,197,
Oklahoma,Superintendent of Public Instruction,Joy Hofmeister,REP,550005,0,0,339,339,
Oklahoma,Commissioner of Labor,Mike Workman,DEM,550005,0,0,163,163,
Oklahoma,Commissioner of Labor,Mark Costello,REP,550005,0,0,368,368,
Oklahoma,U.S. Senate,Matt Silverstein,DEM,550005,0,0,126,126,
Oklahoma,U.S. Senate,Jim Inhofe,REP,550005,0,0,391,391,
Oklahoma,U.S. Senate,Aaron Delozier,IND,550005,0,0,3,3,
Oklahoma,U.S. Senate,Ray Woods,IND,550005,0,0,12,12,
Oklahoma,U.S. Senate,Joan Farr,IND,550005,0,0,8,8,
Oklahoma,U.S. Senate,Connie Johnson,DEM,550005,0,0,135,135,
Oklahoma,U.S. Senate,James Lankford,REP,550005,0,0,392,392,
Oklahoma,U.S. Senate,Mark Beard,IND,550005,0,0,15,15,
Oklahoma,U.S. House,Al Mcaffrey,DEM,550005,0,0,131,131,05
Oklahoma,U.S. House,Steve Russell,REP,550005,0,0,382,382,05
Oklahoma,U.S. House,Buddy Ray,IND,550005,0,0,10,10,05
Oklahoma,U.S. House,Tom Boggs,IND,550005,0,0,12,12,05
Oklahoma,U.S. House,Robert Murphy,IND,550005,0,0,4,4,05
Oklahoma,State Senate,John Handy Edwards,DEM,550005,0,0,176,176,40
Oklahoma,State Senate,Ervin Yen,REP,550005,0,0,360,360,40
Oklahoma,Governor,Joe Dorman,DEM,550006,0,0,150,150,
Oklahoma,Governor,Mary Fallin,REP,550006,0,0,252,252,
Oklahoma,Governor,Kimberly Willis,IND,550006,0,0,13,13,
Oklahoma,Governor,Richard Prawdzienski,IND,550006,0,0,5,5,
Oklahoma,Lieutenant Governor,Cathy Cummings,DEM,550006,0,0,113,113,
Oklahoma,Lieutenant Governor,Todd Lamb,REP,550006,0,0,309,309,
Oklahoma,Superintendent of Public Instruction,John Cox,DEM,550006,0,0,166,166,
Oklahoma,Superintendent of Public Instruction,Joy Hofmeister,REP,550006,0,0,246,246,
Oklahoma,Commissioner of Labor,Mike Workman,DEM,550006,0,0,140,140,
Oklahoma,Commissioner of Labor,Mark Costello,REP,550006,0,0,268,268,
Oklahoma,U.S. Senate,Matt Silverstein,DEM,550006,0,0,105,105,
Oklahoma,U.S. Senate,Jim Inhofe,REP,550006,0,0,294,294,
Oklahoma,U.S. Senate,Aaron Delozier,IND,550006,0,0,3,3,
Oklahoma,U.S. Senate,Ray Woods,IND,550006,0,0,11,11,
Oklahoma,U.S. Senate,Joan Farr,IND,550006,0,0,4,4,
Oklahoma,U.S. Senate,Connie Johnson,DEM,550006,0,0,108,108,
Oklahoma,U.S. Senate,James Lankford,REP,550006,0,0,302,302,
Oklahoma,U.S. Senate,Mark Beard,IND,550006,0,0,10,10,
Oklahoma,U.S. House,Al Mcaffrey,DEM,550006,0,0,104,104,05
Oklahoma,U.S. House,Steve Russell,REP,550006,0,0,292,292,05
Oklahoma,U.S. House,Buddy Ray,IND,550006,0,0,4,4,05
Oklahoma,U.S. House,Tom Boggs,IND,550006,0,0,10,10,05
Oklahoma,U.S. House,Robert Murphy,IND,550006,0,0,4,4,05
Oklahoma,Governor,Joe Dorman,DEM,550007,0,0,176,176,
Oklahoma,Governor,Mary Fallin,REP,550007,0,0,436,436,
Oklahoma,Governor,Kimberly Willis,IND,550007,0,0,9,9,
Oklahoma,Governor,Richard Prawdzienski,IND,550007,0,0,10,10,
Oklahoma,Lieutenant Governor,Cathy Cummings,DEM,550007,0,0,123,123,
Oklahoma,Lieutenant Governor,Todd Lamb,REP,550007,0,0,505,505,
Oklahoma,Superintendent of Public Instruction,John Cox,DEM,550007,0,0,202,202,
Oklahoma,Superintendent of Public Instruction,Joy Hofmeister,REP,550007,0,0,423,423,
Oklahoma,Commissioner of Labor,Mike Workman,DEM,550007,0,0,130,130,
Oklahoma,Commissioner of Labor,Mark Costello,REP,550007,0,0,480,480,
Oklahoma,U.S. Senate,Matt Silverstein,DEM,550007,0,0,107,107,
Oklahoma,U.S. Senate,Jim Inhofe,REP,550007,0,0,499,499,
Oklahoma,U.S. Senate,Aaron Delozier,IND,550007,0,0,4,4,
Oklahoma,U.S. Senate,Ray Woods,IND,550007,0,0,4,4,
Oklahoma,U.S. Senate,Joan Farr,IND,550007,0,0,13,13,
Oklahoma,U.S. Senate,Connie Johnson,DEM,550007,0,0,110,110,
Oklahoma,U.S. Senate,James Lankford,REP,550007,0,0,502,502,
Oklahoma,U.S. Senate,Mark Beard,IND,550007,0,0,19,19,
Oklahoma,U.S. House,Al Mcaffrey,DEM,550007,0,0,103,103,05
Oklahoma,U.S. House,Steve Russell,REP,550007,0,0,495,495,05
Oklahoma,U.S. House,Buddy Ray,IND,550007,0,0,5,5,05
Oklahoma,U.S. House,Tom Boggs,IND,550007,0,0,6,6,05
Oklahoma,U.S. House,Robert Murphy,IND,550007,0,0,11,11,05
Oklahoma,Governor,Joe Dorman,DEM,550008,0,0,72,72,
Oklahoma,Governor,Mary Fallin,REP,550008,0,0,252,252,
Oklahoma,Governor,Kimberly Willis,IND,550008,0,0,4,4,
Oklahoma,Governor,Richard Prawdzienski,IND,550008,0,0,3,3,
Oklahoma,Lieutenant Governor,Cathy Cummings,DEM,550008,0,0,58,58,
Oklahoma,Lieutenant Governor,Todd Lamb,REP,550008,0,0,267,267,
Oklahoma,Superintendent of Public Instruction,John Cox,DEM,550008,0,0,81,81,
Oklahoma,Superintendent of Public Instruction,Joy Hofmeister,REP,550008,0,0,241,241,
Oklahoma,Commissioner of Labor,Mike Workman,DEM,550008,0,0,67,67,
Oklahoma,Commissioner of Labor,Mark Costello,REP,550008,0,0,243,243,
Oklahoma,U.S. Senate,Matt Silverstein,DEM,550008,0,0,44,44,
Oklahoma,U.S. Senate,Jim Inhofe,REP,550008,0,0,271,271,
Oklahoma,U.S. Senate,Aaron Delozier,IND,550008,0,0,4,4,
Oklahoma,U.S. Senate,Ray Woods,IND,550008,0,0,5,5,
Oklahoma,U.S. Senate,Joan Farr,IND,550008,0,0,1,1,
Oklahoma,U.S. Senate,Connie Johnson,DEM,550008,0,0,48,48,
Oklahoma,U.S. Senate,James Lankford,REP,550008,0,0,266,266,
Oklahoma,U.S. Senate,Mark Beard,IND,550008,0,0,13,13,
Oklahoma,U.S. House,Al Mcaffrey,DEM,550008,0,0,43,43,05
Oklahoma,U.S. House,Steve Russell,REP,550008,0,0,269,269,05
Oklahoma,U.S. House,Buddy Ray,IND,550008,0,0,6,6,05
Oklahoma,U.S. House,Tom Boggs,IND,550008,0,0,4,4,05
Oklahoma,U.S. House,Robert Murphy,IND,550008,0,0,0,0,05
Oklahoma,Governor,Joe Dorman,DEM,550009,0,0,129,129,
Oklahoma,Governor,Mary Fallin,REP,550009,0,0,226,226,
Oklahoma,Governor,Kimberly Willis,IND,550009,0,0,13,13,
Oklahoma,Governor,Richard Prawdzienski,IND,550009,0,0,4,4,
Oklahoma,Lieutenant Governor,Cathy Cummings,DEM,550009,0,0,94,94,
Oklahoma,Lieutenant Governor,Todd Lamb,REP,550009,0,0,277,277,
Oklahoma,Superintendent of Public Instruction,John Cox,DEM,550009,0,0,135,135,
Oklahoma,Superintendent of Public Instruction,Joy Hofmeister,REP,550009,0,0,234,234,
Oklahoma,Commissioner of Labor,Mike Workman,DEM,550009,0,0,104,104,
Oklahoma,Commissioner of Labor,Mark Costello,REP,550009,0,0,257,257,
Oklahoma,U.S. Senate,Matt Silverstein,DEM,550009,0,0,80,80,
Oklahoma,U.S. Senate,Jim Inhofe,REP,550009,0,0,266,266,
Oklahoma,U.S. Senate,Aaron Delozier,IND,550009,0,0,5,5,
Oklahoma,U.S. Senate,Ray Woods,IND,550009,0,0,7,7,
Oklahoma,U.S. Senate,Joan Farr,IND,550009,0,0,7,7,
Oklahoma,U.S. Senate,Connie Johnson,DEM,550009,0,0,73,73,
Oklahoma,U.S. Senate,James Lankford,REP,550009,0,0,285,285,
Oklahoma,U.S. Senate,Mark Beard,IND,550009,0,0,14,14,
Oklahoma,U.S. House,Al Mcaffrey,DEM,550009,0,0,79,79,05
Oklahoma,U.S. House,Steve Russell,REP,550009,0,0,261,261,05
Oklahoma,U.S. House,Buddy Ray,IND,550009,0,0,10,10,05
Oklahoma,U.S. House,Tom Boggs,IND,550009,0,0,8,8,05
Oklahoma,U.S. House,Robert Murphy,IND,550009,0,0,11,11,05
Oklahoma,State House,Donald Smith,DEM,550009,0,0,92,92,10
Oklahoma,State House,Elise Hall,REP,550009,0,0,274,274,10
Oklahoma,Governor,Joe Dorman,DEM,550010,0,0,98,98,
Oklahoma,Governor,Mary Fallin,REP,550010,0,0,176,176,
Oklahoma,Governor,Kimberly Willis,IND,550010,0,0,12,12,
Oklahoma,Governor,Richard Prawdzienski,IND,550010,0,0,4,4,
Oklahoma,Lieutenant Governor,Cathy Cummings,DEM,550010,0,0,77,77,
Oklahoma,Lieutenant Governor,Todd Lamb,REP,550010,0,0,212,212,
Oklahoma,Superintendent of Public Instruction,John Cox,DEM,550010,0,0,106,106,
Oklahoma,Superintendent of Public Instruction,Joy Hofmeister,REP,550010,0,0,184,184,
Oklahoma,Commissioner of Labor,Mike Workman,DEM,550010,0,0,88,88,
Oklahoma,Commissioner of Labor,Mark Costello,REP,550010,0,0,193,193,
Oklahoma,U.S. Senate,Matt Silverstein,DEM,550010,0,0,66,66,
Oklahoma,U.S. Senate,Jim Inhofe,REP,550010,0,0,206,206,
Oklahoma,U.S. Senate,Aaron Delozier,IND,550010,0,0,5,5,
Oklahoma,U.S. Senate,Ray Woods,IND,550010,0,0,5,5,
Oklahoma,U.S. Senate,Joan Farr,IND,550010,0,0,2,2,
Oklahoma,U.S. Senate,Connie Johnson,DEM,550010,0,0,62,62,
Oklahoma,U.S. Senate,James Lankford,REP,550010,0,0,220,220,
Oklahoma,U.S. Senate,Mark Beard,IND,550010,0,0,9,9,
Oklahoma,U.S. House,Al Mcaffrey,DEM,550010,0,0,63,63,05
Oklahoma,U.S. House,Steve Russell,REP,550010,0,0,206,206,05
Oklahoma,U.S. House,Buddy Ray,IND,550010,0,0,3,3,05
Oklahoma,U.S. House,Tom Boggs,IND,550010,0,0,9,9,05
Oklahoma,U.S. House,Robert Murphy,IND,550010,0,0,3,3,05
Oklahoma,Governor,Joe Dorman,DEM,550011,0,0,180,180,
Oklahoma,Governor,Mary Fallin,REP,550011,0,0,280,280,
Oklahoma,Governor,Kimberly Willis,IND,550011,0,0,11,11,
Oklahoma,Governor,Richard Prawdzienski,IND,550011,0,0,10,10,
Oklahoma,Lieutenant Governor,Cathy Cummings,DEM,550011,0,0,160,160,
Oklahoma,Lieutenant Governor,Todd Lamb,REP,550011,0,0,317,317,
Oklahoma,Superintendent of Public Instruction,John Cox,DEM,550011,0,0,197,197,
Oklahoma,Superintendent of Public Instruction,Joy Hofmeister,REP,550011,0,0,278,278,
Oklahoma,Commissioner of Labor,Mike Workman,DEM,550011,0,0,158,158,
Oklahoma,Commissioner of Labor,Mark Costello,REP,550011,0,0,307,307,
Oklahoma,U.S. Senate,Matt Silverstein,DEM,550011,0,0,133,133,
Oklahoma,U.S. Senate,Jim Inhofe,REP,550011,0,0,318,318,
Oklahoma,U.S. Senate,Aaron Delozier,IND,550011,0,0,5,5,
Oklahoma,U.S. Senate,Ray Woods,IND,550011,0,0,11,11,
Oklahoma,U.S. Senate,Joan Farr,IND,550011,0,0,6,6,
Oklahoma,U.S. Senate,Connie Johnson,DEM,550011,0,0,142,142,
Oklahoma,U.S. Senate,James Lankford,REP,550011,0,0,324,324,
Oklahoma,U.S. Senate,Mark Beard,IND,550011,0,0,16,16,
Oklahoma,U.S. House,Al Mcaffrey,DEM,550011,0,0,144,144,05
Oklahoma,U.S. House,Steve Russell,REP,550011,0,0,306,306,05
Oklahoma,U.S. House,Buddy Ray,IND,550011,0,0,3,3,05
Oklahoma,U.S. House,Tom Boggs,IND,550011,0,0,12,12,05
Oklahoma,U.S. House,Robert Murphy,IND,550011,0,0,11,11,05
Oklahoma,State Senate,John Handy Edwards,DEM,550011,0,0,186,186,40
Oklahoma,State Senate,Ervin Yen,REP,550011,0,0,292,292,40
Oklahoma,Governor,Joe Dorman,DEM,550012,0,0,370,370,
Oklahoma,Governor,Mary Fallin,REP,550012,0,0,475,475,
Oklahoma,Governor,Kimberly Willis,IND,550012,0,0,22,22,
Oklahoma,Governor,Richard Prawdzienski,IND,550012,0,0,12,12,
Oklahoma,Lieutenant Governor,Cathy Cummings,DEM,550012,0,0,302,302,
Oklahoma,Lieutenant Governor,Todd Lamb,REP,550012,0,0,570,570,
Oklahoma,Superintendent of Public Instruction,John Cox,DEM,550012,0,0,391,391,
Oklahoma,Superintendent of Public Instruction,Joy Hofmeister,REP,550012,0,0,474,474,
Oklahoma,Commissioner of Labor,Mike Workman,DEM,550012,0,0,321,321,
Oklahoma,Commissioner of Labor,Mark Costello,REP,550012,0,0,521,521,
Oklahoma,U.S. Senate,Matt Silverstein,DEM,550012,0,0,280,280,
Oklahoma,U.S. Senate,Jim Inhofe,REP,550012,0,0,561,561,
Oklahoma,U.S. Senate,Aaron Delozier,IND,550012,0,0,9,9,
Oklahoma,U.S. Senate,Ray Woods,IND,550012,0,0,10,10,
Oklahoma,U.S. Senate,Joan Farr,IND,550012,0,0,10,10,
Oklahoma,U.S. Senate,Connie Johnson,DEM,550012,0,0,287,287,
Oklahoma,U.S. Senate,James Lankford,REP,550012,0,0,567,567,
Oklahoma,U.S. Senate,Mark Beard,IND,550012,0,0,22,22,
Oklahoma,U.S. House,Al Mcaffrey,DEM,550012,0,0,280,280,05
Oklahoma,U.S. House,Steve Russell,REP,550012,0,0,550,550,05
Oklahoma,U.S. House,Buddy Ray,IND,550012,0,0,9,9,05
Oklahoma,U.S. House,Tom Boggs,IND,550012,0,0,13,13,05
Oklahoma,U.S. House,Robert Murphy,IND,550012,0,0,15,15,05
Oklahoma,State Senate,John Handy Edwards,DEM,550012,0,0,326,326,40
Oklahoma,State Senate,Ervin Yen,REP,550012,0,0,541,541,40
Oklahoma,State House,Collin Walke,DEM,550012,0,0,331,331,87
Oklahoma,State House,Jason Nelson,REP,550012,0,0,530,530,87
Oklahoma,Governor,Joe Dorman,DEM,550013,0,0,206,206,
Oklahoma,Governor,Mary Fallin,REP,550013,0,0,265,265,
Oklahoma,Governor,Kimberly Willis,IND,550013,0,0,17,17,
Oklahoma,Governor,Richard Prawdzienski,IND,550013,0,0,10,10,
Oklahoma,Lieutenant Governor,Cathy Cummings,DEM,550013,0,0,164,164,
Oklahoma,Lieutenant Governor,Todd Lamb,REP,550013,0,0,332,332,
Oklahoma,Superintendent of Public Instruction,John Cox,DEM,550013,0,0,201,201,
Oklahoma,Superintendent of Public Instruction,Joy Hofmeister,REP,550013,0,0,293,293,
Oklahoma,Commissioner of Labor,Mike Workman,DEM,550013,0,0,172,172,
Oklahoma,Commissioner of Labor,Mark Costello,REP,550013,0,0,310,310,
Oklahoma,U.S. Senate,Matt Silverstein,DEM,550013,0,0,144,144,
Oklahoma,U.S. Senate,Jim Inhofe,REP,550013,0,0,319,319,
Oklahoma,U.S. Senate,Aaron Delozier,IND,550013,0,0,11,11,
Oklahoma,U.S. Senate,Ray Woods,IND,550013,0,0,9,9,
Oklahoma,U.S. Senate,Joan Farr,IND,550013,0,0,13,13,
Oklahoma,U.S. Senate,Connie Johnson,DEM,550013,0,0,146,146,
Oklahoma,U.S. Senate,James Lankford,REP,550013,0,0,328,328,
Oklahoma,U.S. Senate,Mark Beard,IND,550013,0,0,24,24,
Oklahoma,U.S. House,Al Mcaffrey,DEM,550013,0,0,144,144,05
Oklahoma,U.S. House,Steve Russell,REP,550013,0,0,325,325,05
Oklahoma,U.S. House,Buddy Ray,IND,550013,0,0,7,7,05
Oklahoma,U.S. House,Tom Boggs,IND,550013,0,0,6,6,05
Oklahoma,U.S. House,Robert Murphy,IND,550013,0,0,13,13,05
Oklahoma,State House,Donald Smith,DEM,550013,0,0,157,157,10
Oklahoma,State House,Elise Hall,REP,550013,0,0,334,334,10
Oklahoma,Governor,Joe Dorman,DEM,550014,0,0,226,226,
Oklahoma,Governor,Mary Fallin,REP,550014,0,0,314,314,
Oklahoma,Governor,Kimberly Willis,IND,550014,0,0,4,4,
Oklahoma,Governor,Richard Prawdzienski,IND,550014,0,0,4,4,
Oklahoma,Lieutenant Governor,Cathy Cummings,DEM,550014,0,0,182,182,
Oklahoma,Lieutenant Governor,Todd Lamb,REP,550014,0,0,360,360,
Oklahoma,Superintendent of Public Instruction,John Cox,DEM,550014,0,0,228,228,
Oklahoma,Superintendent of Public Instruction,Joy Hofmeister,REP,550014,0,0,311,311,
Oklahoma,Commissioner of Labor,Mike Workman,DEM,550014,0,0,195,195,
Oklahoma,Commissioner of Labor,Mark Costello,REP,550014,0,0,336,336,
Oklahoma,U.S. Senate,Matt Silverstein,DEM,550014,0,0,169,169,
Oklahoma,U.S. Senate,Jim Inhofe,REP,550014,0,0,352,352,
Oklahoma,U.S. Senate,Aaron Delozier,IND,550014,0,0,6,6,
Oklahoma,U.S. Senate,Ray Woods,IND,550014,0,0,3,3,
Oklahoma,U.S. Senate,Joan Farr,IND,550014,0,0,13,13,
Oklahoma,U.S. Senate,Connie Johnson,DEM,550014,0,0,176,176,
Oklahoma,U.S. Senate,James Lankford,REP,550014,0,0,347,347,
Oklahoma,U.S. Senate,Mark Beard,IND,550014,0,0,19,19,
Oklahoma,U.S. House,Al Mcaffrey,DEM,550014,0,0,169,169,05
Oklahoma,U.S. House,Steve Russell,REP,550014,0,0,347,347,05
Oklahoma,U.S. House,Buddy Ray,IND,550014,0,0,5,5,05
Oklahoma,U.S. House,Tom Boggs,IND,550014,0,0,7,7,05
Oklahoma,U.S. House,Robert Murphy,IND,550014,0,0,9,9,05
Oklahoma,State House,Collin Walke,DEM,550014,0,0,210,210,87
Oklahoma,State House,Jason Nelson,REP,550014,0,0,323,323,87
Oklahoma,Governor,Joe Dorman,DEM,550015,0,0,264,264,
Oklahoma,Governor,Mary Fallin,REP,550015,0,0,362,362,
Oklahoma,Governor,Kimberly Willis,IND,550015,0,0,9,9,
Oklahoma,Governor,Richard Prawdzienski,IND,550015,0,0,7,7,
Oklahoma,Lieutenant Governor,Cathy Cummings,DEM,550015,0,0,219,219,
Oklahoma,Lieutenant Governor,Todd Lamb,REP,550015,0,0,422,422,
Oklahoma,Superintendent of Public Instruction,John Cox,DEM,550015,0,0,270,270,
Oklahoma,Superintendent of Public Instruction,Joy Hofmeister,REP,550015,0,0,365,365,
Oklahoma,Commissioner of Labor,Mike Workman,DEM,550015,0,0,230,230,
Oklahoma,Commissioner of Labor,Mark Costello,REP,550015,0,0,394,394,
Oklahoma,U.S. Senate,Matt Silverstein,DEM,550015,0,0,200,200,
Oklahoma,U.S. Senate,Jim Inhofe,REP,550015,0,0,419,419,
Oklahoma,U.S. Senate,Aaron Delozier,IND,550015,0,0,5,5,
Oklahoma,U.S. Senate,Ray Woods,IND,550015,0,0,4,4,
Oklahoma,U.S. Senate,Joan Farr,IND,550015,0,0,7,7,
Oklahoma,U.S. Senate,Connie Johnson,DEM,550015,0,0,191,191,
Oklahoma,U.S. Senate,James Lankford,REP,550015,0,0,428,428,
Oklahoma,U.S. Senate,Mark Beard,IND,550015,0,0,19,19,
Oklahoma,U.S. House,Al Mcaffrey,DEM,550015,0,0,193,193,05
Oklahoma,U.S. House,Steve Russell,REP,550015,0,0,419,419,05
Oklahoma,U.S. House,Buddy Ray,IND,550015,0,0,8,8,05
Oklahoma,U.S. House,Tom Boggs,IND,550015,0,0,9,9,05
Oklahoma,U.S. House,Robert Murphy,IND,550015,0,0,3,3,05
Oklahoma,State Senate,John Handy Edwards,DEM,550015,0,0,242,242,40
Oklahoma,State Senate,Ervin Yen,REP,550015,0,0,388,388,40
Oklahoma,State House,Collin Walke,DEM,550015,0,0,237,237,87
Oklahoma,State House,Jason Nelson,REP,550015,0,0,397,397,87
Oklahoma,Governor,Joe Dorman,DEM,550016,0,0,50,50,
Oklahoma,Governor,Mary Fallin,REP,550016,0,0,101,101,
Oklahoma,Governor,Kimberly Willis,IND,550016,0,0,1,1,
Oklahoma,Governor,Richard Prawdzienski,IND,550016,0,0,1,1,
Oklahoma,Lieutenant Governor,Cathy Cummings,DEM,550016,0,0,35,35,
Oklahoma,Lieutenant Governor,Todd Lamb,REP,550016,0,0,121,121,
Oklahoma,Superintendent of Public Instruction,John Cox,DEM,550016,0,0,48,48,
Oklahoma,Superintendent of Public Instruction,Joy Hofmeister,REP,550016,0,0,107,107,
Oklahoma,Commissioner of Labor,Mike Workman,DEM,550016,0,0,39,39,
Oklahoma,Commissioner of Labor,Mark Costello,REP,550016,0,0,115,115,
Oklahoma,U.S. Senate,Matt Silverstein,DEM,550016,0,0,32,32,
Oklahoma,U.S. Senate,Jim Inhofe,REP,550016,0,0,122,122,
Oklahoma,U.S. Senate,Aaron Delozier,IND,550016,0,0,2,2,
Oklahoma,U.S. Senate,Ray Woods,IND,550016,0,0,0,0,
Oklahoma,U.S. Senate,Joan Farr,IND,550016,0,0,0,0,
Oklahoma,U.S. Senate,Connie Johnson,DEM,550016,0,0,31,31,
Oklahoma,U.S. Senate,James Lankford,REP,550016,0,0,125,125,
Oklahoma,U.S. Senate,Mark Beard,IND,550016,0,0,0,0,
Oklahoma,U.S. House,Al Mcaffrey,DEM,550016,0,0,32,32,05
Oklahoma,U.S. House,Steve Russell,REP,550016,0,0,120,120,05
Oklahoma,U.S. House,Buddy Ray,IND,550016,0,0,1,1,05
Oklahoma,U.S. House,Tom Boggs,IND,550016,0,0,1,1,05
Oklahoma,U.S. House,Robert Murphy,IND,550016,0,0,1,1,05
Oklahoma,State Senate,John Handy Edwards,DEM,550016,0,0,40,40,40
Oklahoma,State Senate,Ervin Yen,REP,550016,0,0,115,115,40
Oklahoma,State House,Cyndi Munson,DEM,550016,0,0,48,48,85
Oklahoma,State House,David Dank,REP,550016,0,0,108,108,85
Oklahoma,Governor,Joe Dorman,DEM,550017,0,0,0,0,
Oklahoma,Governor,Mary Fallin,REP,550017,0,0,0,0,
Oklahoma,Governor,Kimberly Willis,IND,550017,0,0,0,0,
Oklahoma,Governor,Richard Prawdzienski,IND,550017,0,0,0,0,
Oklahoma,Lieutenant Governor,Cathy Cummings,DEM,550017,0,0,0,0,
Oklahoma,Lieutenant Governor,Todd Lamb,REP,550017,0,0,0,0,
Oklahoma,Superintendent of Public Instruction,John Cox,DEM,550017,0,0,0,0,
Oklahoma,Superintendent of Public Instruction,Joy Hofmeister,REP,550017,0,0,0,0,
Oklahoma,Commissioner of Labor,Mike Workman,DEM,550017,0,0,0,0,
Oklahoma,Commissioner of Labor,Mark Costello,REP,550017,0,0,0,0,
Oklahoma,U.S. Senate,Matt Silverstein,DEM,550017,0,0,0,0,
Oklahoma,U.S. Senate,Jim Inhofe,REP,550017,0,0,0,0,
Oklahoma,U.S. Senate,Aaron Delozier,IND,550017,0,0,0,0,
Oklahoma,U.S. Senate,Ray Woods,IND,550017,0,0,0,0,
Oklahoma,U.S. Senate,Joan Farr,IND,550017,0,0,0,0,
Oklahoma,U.S. Senate,Connie Johnson,DEM,550017,0,0,0,0,
Oklahoma,U.S. Senate,James Lankford,REP,550017,0,0,0,0,
Oklahoma,U.S. Senate,Mark Beard,IND,550017,0,0,0,0,
Oklahoma,U.S. House,Al Mcaffrey,DEM,550017,0,0,0,0,05
Oklahoma,U.S. House,Steve Russell,REP,550017,0,0,0,0,05
Oklahoma,U.S. House,Buddy Ray,IND,550017,0,0,0,0,05
Oklahoma,U.S. House,Tom Boggs,IND,550017,0,0,0,0,05
Oklahoma,U.S. House,Robert Murphy,IND,550017,0,0,0,0,05
Oklahoma,State House,Cyndi Munson,DEM,550017,0,0,0,0,85
Oklahoma,State House,David Dank,REP,550017,0,0,0,0,85
Oklahoma,Governor,Joe Dorman,DEM,550018,0,0,63,63,
Oklahoma,Governor,Mary Fallin,REP,550018,0,0,120,120,
Oklahoma,Governor,Kimberly Willis,IND,550018,0,0,4,4,
Oklahoma,Governor,Richard Prawdzienski,IND,550018,0,0,2,2,
Oklahoma,Lieutenant Governor,Cathy Cummings,DEM,550018,0,0,44,44,
Oklahoma,Lieutenant Governor,Todd Lamb,REP,550018,0,0,143,143,
Oklahoma,Superintendent of Public Instruction,John Cox,DEM,550018,0,0,71,71,
Oklahoma,Superintendent of Public Instruction,Joy Hofmeister,REP,550018,0,0,116,116,
Oklahoma,Commissioner of Labor,Mike Workman,DEM,550018,0,0,47,47,
Oklahoma,Commissioner of Labor,Mark Costello,REP,550018,0,0,133,133,
Oklahoma,U.S. Senate,Matt Silverstein,DEM,550018,0,0,33,33,
Oklahoma,U.S. Senate,Jim Inhofe,REP,550018,0,0,144,144,
Oklahoma,U.S. Senate,Aaron Delozier,IND,550018,0,0,2,2,
Oklahoma,U.S. Senate,Ray Woods,IND,550018,0,0,5,5,
Oklahoma,U.S. Senate,Joan Farr,IND,550018,0,0,2,2,
Oklahoma,U.S. Senate,Connie Johnson,DEM,550018,0,0,35,35,
Oklahoma,U.S. Senate,James Lankford,REP,550018,0,0,149,149,
Oklahoma,U.S. Senate,Mark Beard,IND,550018,0,0,5,5,
Oklahoma,U.S. House,Al Mcaffrey,DEM,550018,0,0,32,32,05
Oklahoma,U.S. House,Steve Russell,REP,550018,0,0,145,145,05
Oklahoma,U.S. House,Buddy Ray,IND,550018,0,0,1,1,05
Oklahoma,U.S. House,Tom Boggs,IND,550018,0,0,3,3,05
Oklahoma,U.S. House,Robert Murphy,IND,550018,0,0,2,2,05
Oklahoma,State House,Cecilia Taft,DEM,550018,0,0,45,45,96
Oklahoma,State House,Lewis Moore,REP,550018,0,0,138,138,96
Oklahoma,Governor,Joe Dorman,DEM,550019,0,0,191,191,
Oklahoma,Governor,Mary Fallin,REP,550019,0,0,382,382,
Oklahoma,Governor,Kimberly Willis,IND,550019,0,0,15,15,
Oklahoma,Governor,Richard Prawdzienski,IND,550019,0,0,11,11,
Oklahoma,Lieutenant Governor,Cathy Cummings,DEM,550019,0,0,127,127,
Oklahoma,Lieutenant Governor,Todd Lamb,REP,550019,0,0,473,473,
Oklahoma,Superintendent of Public Instruction,John Cox,DEM,550019,0,0,213,213,
Oklahoma,Superintendent of Public Instruction,Joy Hofmeister,REP,550019,0,0,382,382,
Oklahoma,Commissioner of Labor,Mike Workman,DEM,550019,0,0,155,155,
Oklahoma,Commissioner of Labor,Mark Costello,REP,550019,0,0,431,431,
Oklahoma,U.S. Senate,Matt Silverstein,DEM,550019,0,0,102,102,
Oklahoma,U.S. Senate,Jim Inhofe,REP,550019,0,0,468,468,
Oklahoma,U.S. Senate,Aaron Delozier,IND,550019,0,0,6,6,
Oklahoma,U.S. Senate,Ray Woods,IND,550019,0,0,8,8,
Oklahoma,U.S. Senate,Joan Farr,IND,550019,0,0,9,9,
Oklahoma,U.S. Senate,Connie Johnson,DEM,550019,0,0,102,102,
Oklahoma,U.S. Senate,James Lankford,REP,550019,0,0,473,473,
Oklahoma,U.S. Senate,Mark Beard,IND,550019,0,0,23,23,
Oklahoma,U.S. House,Al Mcaffrey,DEM,550019,0,0,116,116,05
Oklahoma,U.S. House,Steve Russell,REP,550019,0,0,464,464,05
Oklahoma,U.S. House,Buddy Ray,IND,550019,0,0,5,5,05
Oklahoma,U.S. House,Tom Boggs,IND,550019,0,0,6,6,05
Oklahoma,U.S. House,Robert Murphy,IND,550019,0,0,3,3,05
Oklahoma,State House,Cecilia Taft,DEM,550019,0,0,148,148,96
Oklahoma,State House,Lewis Moore,REP,550019,0,0,443,443,96
Oklahoma,Governor,Joe Dorman,DEM,550020,0,0,257,257,
Oklahoma,Governor,Mary Fallin,REP,550020,0,0,584,584,
Oklahoma,Governor,Kimberly Willis,IND,550020,0,0,11,11,
Oklahoma,Governor,Richard Prawdzienski,IND,550020,0,0,5,5,
Oklahoma,Lieutenant Governor,Cathy Cummings,DEM,550020,0,0,180,180,
Oklahoma,Lieutenant Governor,Todd Lamb,REP,550020,0,0,672,672,
Oklahoma,Superintendent of Public Instruction,John Cox,DEM,550020,0,0,283,283,
Oklahoma,Superintendent of Public Instruction,Joy Hofmeister,REP,550020,0,0,565,565,
Oklahoma,Commissioner of Labor,Mike Workman,DEM,550020,0,0,218,218,
Oklahoma,Commissioner of Labor,Mark Costello,REP,550020,0,0,618,618,
Oklahoma,U.S. Senate,Matt Silverstein,DEM,550020,0,0,162,162,
Oklahoma,U.S. Senate,Jim Inhofe,REP,550020,0,0,665,665,
Oklahoma,U.S. Senate,Aaron Delozier,IND,550020,0,0,5,5,
Oklahoma,U.S. Senate,Ray Woods,IND,550020,0,0,8,8,
Oklahoma,U.S. Senate,Joan Farr,IND,550020,0,0,6,6,
Oklahoma,U.S. Senate,Connie Johnson,DEM,550020,0,0,155,155,
Oklahoma,U.S. Senate,James Lankford,REP,550020,0,0,679,679,
Oklahoma,U.S. Senate,Mark Beard,IND,550020,0,0,21,21,
Oklahoma,U.S. House,Al Mcaffrey,DEM,550020,0,0,164,164,05
Oklahoma,U.S. House,Steve Russell,REP,550020,0,0,651,651,05
Oklahoma,U.S. House,Buddy Ray,IND,550020,0,0,10,10,05
Oklahoma,U.S. House,Tom Boggs,IND,550020,0,0,10,10,05
Oklahoma,U.S. House,Robert Murphy,IND,550020,0,0,11,11,05
Oklahoma,State House,Cecilia Taft,DEM,550020,0,0,191,191,96
Oklahoma,State House,Lewis Moore,REP,550020,0,0,641,641,96
Oklahoma,Governor,Joe Dorman,DEM,550021,0,0,283,283,
Oklahoma,Governor,Mary Fallin,REP,550021,0,0,584,584,
Oklahoma,Governor,Kimberly Willis,IND,550021,0,0,11,11,
Oklahoma,Governor,Richard Prawdzienski,IND,550021,0,0,10,10,
Oklahoma,Lieutenant Governor,Cathy Cummings,DEM,550021,0,0,203,203,
Oklahoma,Lieutenant Governor,Todd Lamb,REP,550021,0,0,680,680,
Oklahoma,Superintendent of Public Instruction,John Cox,DEM,550021,0,0,318,318,
Oklahoma,Superintendent of Public Instruction,Joy Hofmeister,REP,550021,0,0,568,568,
Oklahoma,Commissioner of Labor,Mike Workman,DEM,550021,0,0,231,231,
Oklahoma,Commissioner of Labor,Mark Costello,REP,550021,0,0,629,629,
Oklahoma,U.S. Senate,Matt Silverstein,DEM,550021,0,0,177,177,
Oklahoma,U.S. Senate,Jim Inhofe,REP,550021,0,0,673,673,
Oklahoma,U.S. Senate,Aaron Delozier,IND,550021,0,0,6,6,
Oklahoma,U.S. Senate,Ray Woods,IND,550021,0,0,10,10,
Oklahoma,U.S. Senate,Joan Farr,IND,550021,0,0,11,11,
Oklahoma,U.S. Senate,Connie Johnson,DEM,550021,0,0,171,171,
Oklahoma,U.S. Senate,James Lankford,REP,550021,0,0,688,688,
Oklahoma,U.S. Senate,Mark Beard,IND,550021,0,0,23,23,
Oklahoma,U.S. House,Al Mcaffrey,DEM,550021,0,0,184,184,05
Oklahoma,U.S. House,Steve Russell,REP,550021,0,0,661,661,05
Oklahoma,U.S. House,Buddy Ray,IND,550021,0,0,6,6,05
Oklahoma,U.S. House,Tom Boggs,IND,550021,0,0,13,13,05
Oklahoma,U.S. House,Robert Murphy,IND,550021,0,0,14,14,05
Oklahoma,Governor,Joe Dorman,DEM,550022,0,0,145,145,
Oklahoma,Governor,Mary Fallin,REP,550022,0,0,334,334,
Oklahoma,Governor,Kimberly Willis,IND,550022,0,0,6,6,
Oklahoma,Governor,Richard Prawdzienski,IND,550022,0,0,4,4,
Oklahoma,Lieutenant Governor,Cathy Cummings,DEM,550022,0,0,106,106,
Oklahoma,Lieutenant Governor,Todd Lamb,REP,550022,0,0,384,384,
Oklahoma,Superintendent of Public Instruction,John Cox,DEM,550022,0,0,169,169,
Oklahoma,Superintendent of Public Instruction,Joy Hofmeister,REP,550022,0,0,317,317,
Oklahoma,Commissioner of Labor,Mike Workman,DEM,550022,0,0,125,125,
Oklahoma,Commissioner of Labor,Mark Costello,REP,550022,0,0,355,355,
Oklahoma,U.S. Senate,Matt Silverstein,DEM,550022,0,0,93,93,
Oklahoma,U.S. Senate,Jim Inhofe,REP,550022,0,0,378,378,
Oklahoma,U.S. Senate,Aaron Delozier,IND,550022,0,0,5,5,
Oklahoma,U.S. Senate,Ray Woods,IND,550022,0,0,6,6,
Oklahoma,U.S. Senate,Joan Farr,IND,550022,0,0,4,4,
Oklahoma,U.S. Senate,Connie Johnson,DEM,550022,0,0,90,90,
Oklahoma,U.S. Senate,James Lankford,REP,550022,0,0,382,382,
Oklahoma,U.S. Senate,Mark Beard,IND,550022,0,0,18,18,
Oklahoma,U.S. House,Bert Smith,DEM,550022,0,0,83,83,04
Oklahoma,U.S. House,Tom Cole,REP,550022,0,0,381,381,04
Oklahoma,U.S. House,Dennis Johnson,IND,550022,0,0,24,24,04
Oklahoma,State Senate,Hiawatha Jr.,DEM,550022,0,0,88,88,42
Oklahoma,State Senate,Jack Fry,REP,550022,0,0,368,368,42
Oklahoma,State Senate,Charles Thompson,IND,550022,0,0,24,24,42
Oklahoma,Governor,Joe Dorman,DEM,550023,0,0,243,243,
Oklahoma,Governor,Mary Fallin,REP,550023,0,0,401,401,
Oklahoma,Governor,Kimberly Willis,IND,550023,0,0,21,21,
Oklahoma,Governor,Richard Prawdzienski,IND,550023,0,0,4,4,
Oklahoma,Lieutenant Governor,Cathy Cummings,DEM,550023,0,0,167,167,
Oklahoma,Lieutenant Governor,Todd Lamb,REP,550023,0,0,495,495,
Oklahoma,Superintendent of Public Instruction,John Cox,DEM,550023,0,0,268,268,
Oklahoma,Superintendent of Public Instruction,Joy Hofmeister,REP,550023,0,0,397,397,
Oklahoma,Commissioner of Labor,Mike Workman,DEM,550023,0,0,176,176,
Oklahoma,Commissioner of Labor,Mark Costello,REP,550023,0,0,476,476,
Oklahoma,U.S. Senate,Matt Silverstein,DEM,550023,0,0,129,129,
Oklahoma,U.S. Senate,Jim Inhofe,REP,550023,0,0,503,503,
Oklahoma,U.S. Senate,Aaron Delozier,IND,550023,0,0,5,5,
Oklahoma,U.S. Senate,Ray Woods,IND,550023,0,0,11,11,
Oklahoma,U.S. Senate,Joan Farr,IND,550023,0,0,13,13,
Oklahoma,U.S. Senate,Connie Johnson,DEM,550023,0,0,137,137,
Oklahoma,U.S. Senate,James Lankford,REP,550023,0,0,510,510,
Oklahoma,U.S. Senate,Mark Beard,IND,550023,0,0,21,21,
Oklahoma,U.S. House,Bert Smith,DEM,550023,0,0,119,119,04
Oklahoma,U.S. House,Tom Cole,REP,550023,0,0,512,512,04
Oklahoma,U.S. House,Dennis Johnson,IND,550023,0,0,33,33,04
Oklahoma,Governor,Joe Dorman,DEM,550024,0,0,19,19,
Oklahoma,Governor,Mary Fallin,REP,550024,0,0,28,28,
Oklahoma,Governor,Kimberly Willis,IND,550024,0,0,1,1,
Oklahoma,Governor,Richard Prawdzienski,IND,550024,0,0,0,0,
Oklahoma,Lieutenant Governor,Cathy Cummings,DEM,550024,0,0,13,13,
Oklahoma,Lieutenant Governor,Todd Lamb,REP,550024,0,0,35,35,
Oklahoma,Superintendent of Public Instruction,John Cox,DEM,550024,0,0,22,22,
Oklahoma,Superintendent of Public Instruction,Joy Hofmeister,REP,550024,0,0,26,26,
Oklahoma,Commissioner of Labor,Mike Workman,DEM,550024,0,0,18,18,
Oklahoma,Commissioner of Labor,Mark Costello,REP,550024,0,0,27,27,
Oklahoma,U.S. Senate,Matt Silverstein,DEM,550024,0,0,8,8,
Oklahoma,U.S. Senate,Jim Inhofe,REP,550024,0,0,39,39,
Oklahoma,U.S. Senate,Aaron Delozier,IND,550024,0,0,0,0,
Oklahoma,U.S. Senate,Ray Woods,IND,550024,0,0,1,1,
Oklahoma,U.S. Senate,Joan Farr,IND,550024,0,0,0,0,
Oklahoma,U.S. Senate,Connie Johnson,DEM,550024,0,0,8,8,
Oklahoma,U.S. Senate,James Lankford,REP,550024,0,0,37,37,
Oklahoma,U.S. Senate,Mark Beard,IND,550024,0,0,2,2,
Oklahoma,U.S. House,Al Mcaffrey,DEM,550024,0,0,12,12,05
Oklahoma,U.S. House,Steve Russell,REP,550024,0,0,34,34,05
Oklahoma,U.S. House,Buddy Ray,IND,550024,0,0,0,0,05
Oklahoma,U.S. House,Tom Boggs,IND,550024,0,0,2,2,05
Oklahoma,U.S. House,Robert Murphy,IND,550024,0,0,0,0,05
Oklahoma,State Senate,Anastasia Pittman,DEM,550024,0,0,19,19,48
Oklahoma,State Senate,Duane Crumbacher,REP,550024,0,0,26,26,48
Oklahoma,State House,Cecilia Taft,DEM,550024,0,0,9,9,96
Oklahoma,State House,Lewis Moore,REP,550024,0,0,35,35,96
Oklahoma,Governor,Joe Dorman,DEM,550025,0,0,112,112,
Oklahoma,Governor,Mary Fallin,REP,550025,0,0,121,121,
Oklahoma,Governor,Kimberly Willis,IND,550025,0,0,3,3,
Oklahoma,Governor,Richard Prawdzienski,IND,550025,0,0,2,2,
Oklahoma,Lieutenant Governor,Cathy Cummings,DEM,550025,0,0,103,103,
Oklahoma,Lieutenant Governor,Todd Lamb,REP,550025,0,0,135,135,
Oklahoma,Superintendent of Public Instruction,John Cox,DEM,550025,0,0,118,118,
Oklahoma,Superintendent of Public Instruction,Joy Hofmeister,REP,550025,0,0,120,120,
Oklahoma,Commissioner of Labor,Mike Workman,DEM,550025,0,0,103,103,
Oklahoma,Commissioner of Labor,Mark Costello,REP,550025,0,0,131,131,
Oklahoma,U.S. Senate,Matt Silverstein,DEM,550025,0,0,92,92,
Oklahoma,U.S. Senate,Jim Inhofe,REP,550025,0,0,135,135,
Oklahoma,U.S. Senate,Aaron Delozier,IND,550025,0,0,3,3,
Oklahoma,U.S. Senate,Ray Woods,IND,550025,0,0,5,5,
Oklahoma,U.S. Senate,Joan Farr,IND,550025,0,0,2,2,
Oklahoma,U.S. Senate,Connie Johnson,DEM,550025,0,0,100,100,
Oklahoma,U.S. Senate,James Lankford,REP,550025,0,0,130,130,
Oklahoma,U.S. Senate,Mark Beard,IND,550025,0,0,8,8,
Oklahoma,U.S. House,Al Mcaffrey,DEM,550025,0,0,89,89,05
Oklahoma,U.S. House,Steve Russell,REP,550025,0,0,137,137,05
Oklahoma,U.S. House,Buddy Ray,IND,550025,0,0,4,4,05
Oklahoma,U.S. House,Tom Boggs,IND,550025,0,0,6,6,05
Oklahoma,U.S. House,Robert Murphy,IND,550025,0,0,1,1,05
Oklahoma,State Senate,Anastasia Pittman,DEM,550025,0,0,117,117,48
Oklahoma,State Senate,Duane Crumbacher,REP,550025,0,0,119,119,48
Oklahoma,State House,Mike Shelton,DEM,550025,0,0,128,128,97
Oklahoma,State House,Tonni Canaday,REP,550025,0,0,106,106,97
Oklahoma,Governor,Joe Dorman,DEM,550026,0,0,145,145,
Oklahoma,Governor,Mary Fallin,REP,550026,0,0,305,305,
Oklahoma,Governor,Kimberly Willis,IND,550026,0,0,13,13,
Oklahoma,Governor,Richard Prawdzienski,IND,550026,0,0,9,9,
Oklahoma,Lieutenant Governor,Cathy Cummings,DEM,550026,0,0,110,110,
Oklahoma,Lieutenant Governor,Todd Lamb,REP,550026,0,0,362,362,
Oklahoma,Superintendent of Public Instruction,John Cox,DEM,550026,0,0,165,165,
Oklahoma,Superintendent of Public Instruction,Joy Hofmeister,REP,550026,0,0,306,306,
Oklahoma,Commissioner of Labor,Mike Workman,DEM,550026,0,0,126,126,
Oklahoma,Commissioner of Labor,Mark Costello,REP,550026,0,0,332,332,
Oklahoma,U.S. Senate,Matt Silverstein,DEM,550026,0,0,86,86,
Oklahoma,U.S. Senate,Jim Inhofe,REP,550026,0,0,359,359,
Oklahoma,U.S. Senate,Aaron Delozier,IND,550026,0,0,3,3,
Oklahoma,U.S. Senate,Ray Woods,IND,550026,0,0,11,11,
Oklahoma,U.S. Senate,Joan Farr,IND,550026,0,0,6,6,
Oklahoma,U.S. Senate,Connie Johnson,DEM,550026,0,0,86,86,
Oklahoma,U.S. Senate,James Lankford,REP,550026,0,0,359,359,
Oklahoma,U.S. Senate,Mark Beard,IND,550026,0,0,26,26,
Oklahoma,U.S. House,Bert Smith,DEM,550026,0,0,80,80,04
Oklahoma,U.S. House,Tom Cole,REP,550026,0,0,358,358,04
Oklahoma,U.S. House,Dennis Johnson,IND,550026,0,0,32,32,04
Oklahoma,Governor,Joe Dorman,DEM,550027,0,0,30,30,
Oklahoma,Governor,Mary Fallin,REP,550027,0,0,70,70,
Oklahoma,Governor,Kimberly Willis,IND,550027,0,0,1,1,
Oklahoma,Governor,Richard Prawdzienski,IND,550027,0,0,3,3,
Oklahoma,Lieutenant Governor,Cathy Cummings,DEM,550027,0,0,23,23,
Oklahoma,Lieutenant Governor,Todd Lamb,REP,550027,0,0,80,80,
Oklahoma,Superintendent of Public Instruction,John Cox,DEM,550027,0,0,35,35,
Oklahoma,Superintendent of Public Instruction,Joy Hofmeister,REP,550027,0,0,67,67,
Oklahoma,Commissioner of Labor,Mike Workman,DEM,550027,0,0,32,32,
Oklahoma,Commissioner of Labor,Mark Costello,REP,550027,0,0,68,68,
Oklahoma,U.S. Senate,Matt Silverstein,DEM,550027,0,0,24,24,
Oklahoma,U.S. Senate,Jim Inhofe,REP,550027,0,0,76,76,
Oklahoma,U.S. Senate,Aaron Delozier,IND,550027,0,0,1,1,
Oklahoma,U.S. Senate,Ray Woods,IND,550027,0,0,2,2,
Oklahoma,U.S. Senate,Joan Farr,IND,550027,0,0,0,0,
Oklahoma,U.S. Senate,Connie Johnson,DEM,550027,0,0,22,22,
Oklahoma,U.S. Senate,James Lankford,REP,550027,0,0,78,78,
Oklahoma,U.S. Senate,Mark Beard,IND,550027,0,0,3,3,
Oklahoma,U.S. House,Bert Smith,DEM,550027,0,0,21,21,04
Oklahoma,U.S. House,Tom Cole,REP,550027,0,0,75,75,04
Oklahoma,U.S. House,Dennis Johnson,IND,550027,0,0,7,7,04
Oklahoma,State Senate,Anastasia Pittman,DEM,550027,0,0,35,35,48
Oklahoma,State Senate,Duane Crumbacher,REP,550027,0,0,64,64,48
Oklahoma,Governor,Joe Dorman,DEM,550028,0,0,314,314,
Oklahoma,Governor,Mary Fallin,REP,550028,0,0,224,224,
Oklahoma,Governor,Kimberly Willis,IND,550028,0,0,11,11,
Oklahoma,Governor,Richard Prawdzienski,IND,550028,0,0,12,12,
Oklahoma,Lieutenant Governor,Cathy Cummings,DEM,550028,0,0,283,283,
Oklahoma,Lieutenant Governor,Todd Lamb,REP,550028,0,0,276,276,
Oklahoma,Superintendent of Public Instruction,John Cox,DEM,550028,0,0,347,347,
Oklahoma,Superintendent of Public Instruction,Joy Hofmeister,REP,550028,0,0,212,212,
Oklahoma,Commissioner of Labor,Mike Workman,DEM,550028,0,0,333,333,
Oklahoma,Commissioner of Labor,Mark Costello,REP,550028,0,0,216,216,
Oklahoma,U.S. Senate,Matt Silverstein,DEM,550028,0,0,263,263,
Oklahoma,U.S. Senate,Jim Inhofe,REP,550028,0,0,274,274,
Oklahoma,U.S. Senate,Aaron Delozier,IND,550028,0,0,6,6,
Oklahoma,U.S. Senate,Ray Woods,IND,550028,0,0,7,7,
Oklahoma,U.S. Senate,Joan Farr,IND,550028,0,0,9,9,
Oklahoma,U.S. Senate,Connie Johnson,DEM,550028,0,0,281,281,
Oklahoma,U.S. Senate,James Lankford,REP,550028,0,0,262,262,
Oklahoma,U.S. Senate,Mark Beard,IND,550028,0,0,16,16,
Oklahoma,U.S. House,Al Mcaffrey,DEM,550028,0,0,271,271,05
Oklahoma,U.S. House,Steve Russell,REP,550028,0,0,264,264,05
Oklahoma,U.S. House,Buddy Ray,IND,550028,0,0,7,7,05
Oklahoma,U.S. House,Tom Boggs,IND,550028,0,0,6,6,05
Oklahoma,U.S. House,Robert Murphy,IND,550028,0,0,8,8,05
Oklahoma,State Senate,Hiawatha Jr.,DEM,550028,0,0,278,278,42
Oklahoma,State Senate,Jack Fry,REP,550028,0,0,237,237,42
Oklahoma,State Senate,Charles Thompson,IND,550028,0,0,38,38,42
Oklahoma,Governor,Joe Dorman,DEM,550029,0,0,291,291,
Oklahoma,Governor,Mary Fallin,REP,550029,0,0,351,351,
Oklahoma,Governor,Kimberly Willis,IND,550029,0,0,17,17,
Oklahoma,Governor,Richard Prawdzienski,IND,550029,0,0,13,13,
Oklahoma,Lieutenant Governor,Cathy Cummings,DEM,550029,0,0,256,256,
Oklahoma,Lieutenant Governor,Todd Lamb,REP,550029,0,0,415,415,
Oklahoma,Superintendent of Public Instruction,John Cox,DEM,550029,0,0,311,311,
Oklahoma,Superintendent of Public Instruction,Joy Hofmeister,REP,550029,0,0,356,356,
Oklahoma,Commissioner of Labor,Mike Workman,DEM,550029,0,0,274,274,
Oklahoma,Commissioner of Labor,Mark Costello,REP,550029,0,0,384,384,
Oklahoma,U.S. Senate,Matt Silverstein,DEM,550029,0,0,223,223,
Oklahoma,U.S. Senate,Jim Inhofe,REP,550029,0,0,416,416,
Oklahoma,U.S. Senate,Aaron Delozier,IND,550029,0,0,5,5,
Oklahoma,U.S. Senate,Ray Woods,IND,550029,0,0,15,15,
Oklahoma,U.S. Senate,Joan Farr,IND,550029,0,0,12,12,
Oklahoma,U.S. Senate,Connie Johnson,DEM,550029,0,0,238,238,
Oklahoma,U.S. Senate,James Lankford,REP,550029,0,0,403,403,
Oklahoma,U.S. Senate,Mark Beard,IND,550029,0,0,31,31,
Oklahoma,U.S. House,Al Mcaffrey,DEM,550029,0,0,221,221,05
Oklahoma,U.S. House,Steve Russell,REP,550029,0,0,412,412,05
Oklahoma,U.S. House,Buddy Ray,IND,550029,0,0,14,14,05
Oklahoma,U.S. House,Tom Boggs,IND,550029,0,0,7,7,05
Oklahoma,U.S. House,Robert Murphy,IND,550029,0,0,18,18,05
Oklahoma,State Senate,Hiawatha Jr.,DEM,550029,0,0,239,239,42
Oklahoma,State Senate,Jack Fry,REP,550029,0,0,369,369,42
Oklahoma,State Senate,Charles Thompson,IND,550029,0,0,60,60,42
Oklahoma,Governor,Joe Dorman,DEM,550030,0,0,254,254,
Oklahoma,Governor,Mary Fallin,REP,550030,0,0,263,263,
Oklahoma,Governor,Kimberly Willis,IND,550030,0,0,10,10,
Oklahoma,Governor,Richard Prawdzienski,IND,550030,0,0,11,11,
Oklahoma,Lieutenant Governor,Cathy Cummings,DEM,550030,0,0,240,240,
Oklahoma,Lieutenant Governor,Todd Lamb,REP,550030,0,0,295,295,
Oklahoma,Superintendent of Public Instruction,John Cox,DEM,550030,0,0,281,281,
Oklahoma,Superintendent of Public Instruction,Joy Hofmeister,REP,550030,0,0,251,251,
Oklahoma,Commissioner of Labor,Mike Workman,DEM,550030,0,0,265,265,
Oklahoma,Commissioner of Labor,Mark Costello,REP,550030,0,0,258,258,
Oklahoma,U.S. Senate,Matt Silverstein,DEM,550030,0,0,216,216,
Oklahoma,U.S. Senate,Jim Inhofe,REP,550030,0,0,287,287,
Oklahoma,U.S. Senate,Aaron Delozier,IND,550030,0,0,9,9,
Oklahoma,U.S. Senate,Ray Woods,IND,550030,0,0,15,15,
Oklahoma,U.S. Senate,Joan Farr,IND,550030,0,0,7,7,
Oklahoma,U.S. Senate,Connie Johnson,DEM,550030,0,0,215,215,
Oklahoma,U.S. Senate,James Lankford,REP,550030,0,0,302,302,
Oklahoma,U.S. Senate,Mark Beard,IND,550030,0,0,19,19,
Oklahoma,U.S. House,Al Mcaffrey,DEM,550030,0,0,218,218,05
Oklahoma,U.S. House,Steve Russell,REP,550030,0,0,286,286,05
Oklahoma,U.S. House,Buddy Ray,IND,550030,0,0,8,8,05
Oklahoma,U.S. House,Tom Boggs,IND,550030,0,0,8,8,05
Oklahoma,U.S. House,Robert Murphy,IND,550030,0,0,14,14,05
Oklahoma,State Senate,Hiawatha Jr.,DEM,550030,0,0,213,213,42
Oklahoma,State Senate,Jack Fry,REP,550030,0,0,271,271,42
Oklahoma,State Senate,Charles Thompson,IND,550030,0,0,47,47,42
Oklahoma,Governor,Joe Dorman,DEM,550031,0,0,296,296,
Oklahoma,Governor,Mary Fallin,REP,550031,0,0,382,382,
Oklahoma,Governor,Kimberly Willis,IND,550031,0,0,15,15,
Oklahoma,Governor,Richard Prawdzienski,IND,550031,0,0,9,9,
Oklahoma,Lieutenant Governor,Cathy Cummings,DEM,550031,0,0,248,248,
Oklahoma,Lieutenant Governor,Todd Lamb,REP,550031,0,0,450,450,
Oklahoma,Superintendent of Public Instruction,John Cox,DEM,550031,0,0,339,339,
Oklahoma,Superintendent of Public Instruction,Joy Hofmeister,REP,550031,0,0,361,361,
Oklahoma,Commissioner of Labor,Mike Workman,DEM,550031,0,0,280,280,
Oklahoma,Commissioner of Labor,Mark Costello,REP,550031,0,0,405,405,
Oklahoma,U.S. Senate,Matt Silverstein,DEM,550031,0,0,200,200,
Oklahoma,U.S. Senate,Jim Inhofe,REP,550031,0,0,464,464,
Oklahoma,U.S. Senate,Aaron Delozier,IND,550031,0,0,9,9,
Oklahoma,U.S. Senate,Ray Woods,IND,550031,0,0,8,8,
Oklahoma,U.S. Senate,Joan Farr,IND,550031,0,0,13,13,
Oklahoma,U.S. Senate,Connie Johnson,DEM,550031,0,0,220,220,
Oklahoma,U.S. Senate,James Lankford,REP,550031,0,0,452,452,
Oklahoma,U.S. Senate,Mark Beard,IND,550031,0,0,28,28,
Oklahoma,U.S. House,Al Mcaffrey,DEM,550031,0,0,217,217,05
Oklahoma,U.S. House,Steve Russell,REP,550031,0,0,448,448,05
Oklahoma,U.S. House,Buddy Ray,IND,550031,0,0,7,7,05
Oklahoma,U.S. House,Tom Boggs,IND,550031,0,0,10,10,05
Oklahoma,U.S. House,Robert Murphy,IND,550031,0,0,12,12,05
Oklahoma,State Senate,Hiawatha Jr.,DEM,550031,0,0,217,217,42
Oklahoma,State Senate,Jack Fry,REP,550031,0,0,413,413,42
Oklahoma,State Senate,Charles Thompson,IND,550031,0,0,58,58,42
Oklahoma,Governor,Joe Dorman,DEM,550032,0,0,169,169,
Oklahoma,Governor,Mary Fallin,REP,550032,0,0,275,275,
Oklahoma,Governor,Kimberly Willis,IND,550032,0,0,9,9,
Oklahoma,Governor,Richard Prawdzienski,IND,550032,0,0,6,6,
Oklahoma,Lieutenant Governor,Cathy Cummings,DEM,550032,0,0,138,138,
Oklahoma,Lieutenant Governor,Todd Lamb,REP,550032,0,0,323,323,
Oklahoma,Superintendent of Public Instruction,John Cox,DEM,550032,0,0,190,190,
Oklahoma,Superintendent of Public Instruction,Joy Hofmeister,REP,550032,0,0,268,268,
Oklahoma,Commissioner of Labor,Mike Workman,DEM,550032,0,0,169,169,
Oklahoma,Commissioner of Labor,Mark Costello,REP,550032,0,0,286,286,
Oklahoma,U.S. Senate,Matt Silverstein,DEM,550032,0,0,122,122,
Oklahoma,U.S. Senate,Jim Inhofe,REP,550032,0,0,322,322,
Oklahoma,U.S. Senate,Aaron Delozier,IND,550032,0,0,6,6,
Oklahoma,U.S. Senate,Ray Woods,IND,550032,0,0,4,4,
Oklahoma,U.S. Senate,Joan Farr,IND,550032,0,0,5,5,
Oklahoma,U.S. Senate,Connie Johnson,DEM,550032,0,0,127,127,
Oklahoma,U.S. Senate,James Lankford,REP,550032,0,0,321,321,
Oklahoma,U.S. Senate,Mark Beard,IND,550032,0,0,15,15,
Oklahoma,U.S. House,Al Mcaffrey,DEM,550032,0,0,116,116,05
Oklahoma,U.S. House,Steve Russell,REP,550032,0,0,320,320,05
Oklahoma,U.S. House,Buddy Ray,IND,550032,0,0,5,5,05
Oklahoma,U.S. House,Tom Boggs,IND,550032,0,0,10,10,05
Oklahoma,U.S. House,Robert Murphy,IND,550032,0,0,9,9,05
Oklahoma,State Senate,Hiawatha Jr.,DEM,550032,0,0,124,124,42
Oklahoma,State Senate,Jack Fry,REP,550032,0,0,293,293,42
Oklahoma,State Senate,Charles Thompson,IND,550032,0,0,42,42,42
Oklahoma,Governor,Joe Dorman,DEM,550033,0,0,379,379,
Oklahoma,Governor,Mary Fallin,REP,550033,0,0,547,547,
Oklahoma,Governor,Kimberly Willis,IND,550033,0,0,22,22,
Oklahoma,Governor,Richard Prawdzienski,IND,550033,0,0,14,14,
Oklahoma,Lieutenant Governor,Cathy Cummings,DEM,550033,0,0,315,315,
Oklahoma,Lieutenant Governor,Todd Lamb,REP,550033,0,0,641,641,
Oklahoma,Superintendent of Public Instruction,John Cox,DEM,550033,0,0,425,425,
Oklahoma,Superintendent of Public Instruction,Joy Hofmeister,REP,550033,0,0,532,532,
Oklahoma,Commissioner of Labor,Mike Workman,DEM,550033,0,0,352,352,
Oklahoma,Commissioner of Labor,Mark Costello,REP,550033,0,0,586,586,
Oklahoma,U.S. Senate,Matt Silverstein,DEM,550033,0,0,279,279,
Oklahoma,U.S. Senate,Jim Inhofe,REP,550033,0,0,645,645,
Oklahoma,U.S. Senate,Aaron Delozier,IND,550033,0,0,8,8,
Oklahoma,U.S. Senate,Ray Woods,IND,550033,0,0,6,6,
Oklahoma,U.S. Senate,Joan Farr,IND,550033,0,0,14,14,
Oklahoma,U.S. Senate,Connie Johnson,DEM,550033,0,0,299,299,
Oklahoma,U.S. Senate,James Lankford,REP,550033,0,0,637,637,
Oklahoma,U.S. Senate,Mark Beard,IND,550033,0,0,24,24,
Oklahoma,U.S. House,Al Mcaffrey,DEM,550033,0,0,268,268,05
Oklahoma,U.S. House,Steve Russell,REP,550033,0,0,649,649,05
Oklahoma,U.S. House,Buddy Ray,IND,550033,0,0,8,8,05
Oklahoma,U.S. House,Tom Boggs,IND,550033,0,0,14,14,05
Oklahoma,U.S. House,Robert Murphy,IND,550033,0,0,14,14,05
Oklahoma,State Senate,Hiawatha Jr.,DEM,550033,0,0,275,275,42
Oklahoma,State Senate,Jack Fry,REP,550033,0,0,613,613,42
Oklahoma,State Senate,Charles Thompson,IND,550033,0,0,63,63,42
Oklahoma,Governor,Joe Dorman,DEM,550034,0,0,139,139,
Oklahoma,Governor,Mary Fallin,REP,550034,0,0,366,366,
Oklahoma,Governor,Kimberly Willis,IND,550034,0,0,12,12,
Oklahoma,Governor,Richard Prawdzienski,IND,550034,0,0,5,5,
Oklahoma,Lieutenant Governor,Cathy Cummings,DEM,550034,0,0,86,86,
Oklahoma,Lieutenant Governor,Todd Lamb,REP,550034,0,0,436,436,
Oklahoma,Superintendent of Public Instruction,John Cox,DEM,550034,0,0,125,125,
Oklahoma,Superintendent of Public Instruction,Joy Hofmeister,REP,550034,0,0,392,392,
Oklahoma,Commissioner of Labor,Mike Workman,DEM,550034,0,0,71,71,
Oklahoma,Commissioner of Labor,Mark Costello,REP,550034,0,0,428,428,
Oklahoma,U.S. Senate,Matt Silverstein,DEM,550034,0,0,70,70,
Oklahoma,U.S. Senate,Jim Inhofe,REP,550034,0,0,437,437,
Oklahoma,U.S. Senate,Aaron Delozier,IND,550034,0,0,2,2,
Oklahoma,U.S. Senate,Ray Woods,IND,550034,0,0,5,5,
Oklahoma,U.S. Senate,Joan Farr,IND,550034,0,0,5,5,
Oklahoma,U.S. Senate,Connie Johnson,DEM,550034,0,0,69,69,
Oklahoma,U.S. Senate,James Lankford,REP,550034,0,0,447,447,
Oklahoma,U.S. Senate,Mark Beard,IND,550034,0,0,7,7,
Oklahoma,U.S. House,Al Mcaffrey,DEM,550034,0,0,75,75,05
Oklahoma,U.S. House,Steve Russell,REP,550034,0,0,425,425,05
Oklahoma,U.S. House,Buddy Ray,IND,550034,0,0,4,4,05
Oklahoma,U.S. House,Tom Boggs,IND,550034,0,0,3,3,05
Oklahoma,U.S. House,Robert Murphy,IND,550034,0,0,5,5,05
Oklahoma,Governor,Joe Dorman,DEM,550035,0,0,354,354,
Oklahoma,Governor,Mary Fallin,REP,550035,0,0,588,588,
Oklahoma,Governor,Kimberly Willis,IND,550035,0,0,19,19,
Oklahoma,Governor,Richard Prawdzienski,IND,550035,0,0,13,13,
Oklahoma,Lieutenant Governor,Cathy Cummings,DEM,550035,0,0,249,249,
Oklahoma,Lieutenant Governor,Todd Lamb,REP,550035,0,0,719,719,
Oklahoma,Superintendent of Public Instruction,John Cox,DEM,550035,0,0,343,343,
Oklahoma,Superintendent of Public Instruction,Joy Hofmeister,REP,550035,0,0,625,625,
Oklahoma,Commissioner of Labor,Mike Workman,DEM,550035,0,0,234,234,
Oklahoma,Commissioner of Labor,Mark Costello,REP,550035,0,0,712,712,
Oklahoma,U.S. Senate,Matt Silverstein,DEM,550035,0,0,227,227,
Oklahoma,U.S. Senate,Jim Inhofe,REP,550035,0,0,713,713,
Oklahoma,U.S. Senate,Aaron Delozier,IND,550035,0,0,8,8,
Oklahoma,U.S. Senate,Ray Woods,IND,550035,0,0,3,3,
Oklahoma,U.S. Senate,Joan Farr,IND,550035,0,0,10,10,
Oklahoma,U.S. Senate,Connie Johnson,DEM,550035,0,0,212,212,
Oklahoma,U.S. Senate,James Lankford,REP,550035,0,0,740,740,
Oklahoma,U.S. Senate,Mark Beard,IND,550035,0,0,20,20,
Oklahoma,U.S. House,Al Mcaffrey,DEM,550035,0,0,235,235,05
Oklahoma,U.S. House,Steve Russell,REP,550035,0,0,702,702,05
Oklahoma,U.S. House,Buddy Ray,IND,550035,0,0,9,9,05
Oklahoma,U.S. House,Tom Boggs,IND,550035,0,0,2,2,05
Oklahoma,U.S. House,Robert Murphy,IND,550035,0,0,15,15,05
Oklahoma,Governor,Joe Dorman,DEM,550036,0,0,184,184,
Oklahoma,Governor,Mary Fallin,REP,550036,0,0,444,444,
Oklahoma,Governor,Kimberly Willis,IND,550036,0,0,7,7,
Oklahoma,Governor,Richard Prawdzienski,IND,550036,0,0,5,5,
Oklahoma,Lieutenant Governor,Cathy Cummings,DEM,550036,0,0,119,119,
Oklahoma,Lieutenant Governor,Todd Lamb,REP,550036,0,0,515,515,
Oklahoma,Superintendent of Public Instruction,John Cox,DEM,550036,0,0,184,184,
Oklahoma,Superintendent of Public Instruction,Joy Hofmeister,REP,550036,0,0,451,451,
Oklahoma,Commissioner of Labor,Mike Workman,DEM,550036,0,0,120,120,
Oklahoma,Commissioner of Labor,Mark Costello,REP,550036,0,0,503,503,
Oklahoma,U.S. Senate,Matt Silverstein,DEM,550036,0,0,112,112,
Oklahoma,U.S. Senate,Jim Inhofe,REP,550036,0,0,513,513,
Oklahoma,U.S. Senate,Aaron Delozier,IND,550036,0,0,1,1,
Oklahoma,U.S. Senate,Ray Woods,IND,550036,0,0,4,4,
Oklahoma,U.S. Senate,Joan Farr,IND,550036,0,0,4,4,
Oklahoma,U.S. Senate,Connie Johnson,DEM,550036,0,0,106,106,
Oklahoma,U.S. Senate,James Lankford,REP,550036,0,0,523,523,
Oklahoma,U.S. Senate,Mark Beard,IND,550036,0,0,11,11,
Oklahoma,U.S. House,Al Mcaffrey,DEM,550036,0,0,118,118,05
Oklahoma,U.S. House,Steve Russell,REP,550036,0,0,505,505,05
Oklahoma,U.S. House,Buddy Ray,IND,550036,0,0,2,2,05
Oklahoma,U.S. House,Tom Boggs,IND,550036,0,0,2,2,05
Oklahoma,U.S. House,Robert Murphy,IND,550036,0,0,3,3,05
Oklahoma,Governor,Joe Dorman,DEM,550037,0,0,261,261,
Oklahoma,Governor,Mary Fallin,REP,550037,0,0,426,426,
Oklahoma,Governor,Kimberly Willis,IND,550037,0,0,11,11,
Oklahoma,Governor,Richard Prawdzienski,IND,550037,0,0,10,10,
Oklahoma,Lieutenant Governor,Cathy Cummings,DEM,550037,0,0,189,189,
Oklahoma,Lieutenant Governor,Todd Lamb,REP,550037,0,0,523,523,
Oklahoma,Superintendent of Public Instruction,John Cox,DEM,550037,0,0,258,258,
Oklahoma,Superintendent of Public Instruction,Joy Hofmeister,REP,550037,0,0,448,448,
Oklahoma,Commissioner of Labor,Mike Workman,DEM,550037,0,0,172,172,
Oklahoma,Commissioner of Labor,Mark Costello,REP,550037,0,0,524,524,
Oklahoma,U.S. Senate,Matt Silverstein,DEM,550037,0,0,170,170,
Oklahoma,U.S. Senate,Jim Inhofe,REP,550037,0,0,518,518,
Oklahoma,U.S. Senate,Aaron Delozier,IND,550037,0,0,9,9,
Oklahoma,U.S. Senate,Ray Woods,IND,550037,0,0,5,5,
Oklahoma,U.S. Senate,Joan Farr,IND,550037,0,0,8,8,
Oklahoma,U.S. Senate,Connie Johnson,DEM,550037,0,0,162,162,
Oklahoma,U.S. Senate,James Lankford,REP,550037,0,0,534,534,
Oklahoma,U.S. Senate,Mark Beard,IND,550037,0,0,14,14,
Oklahoma,U.S. House,Al Mcaffrey,DEM,550037,0,0,171,171,05
Oklahoma,U.S. House,Steve Russell,REP,550037,0,0,508,508,05
Oklahoma,U.S. House,Buddy Ray,IND,550037,0,0,6,6,05
Oklahoma,U.S. House,Tom Boggs,IND,550037,0,0,11,11,05
Oklahoma,U.S. House,Robert Murphy,IND,550037,0,0,6,6,05
Oklahoma,Governor,Joe Dorman,DEM,550038,0,0,247,247,
Oklahoma,Governor,Mary Fallin,REP,550038,0,0,371,371,
Oklahoma,Governor,Kimberly Willis,IND,550038,0,0,10,10,
Oklahoma,Governor,Richard Prawdzienski,IND,550038,0,0,6,6,
Oklahoma,Lieutenant Governor,Cathy Cummings,DEM,550038,0,0,195,195,
Oklahoma,Lieutenant Governor,Todd Lamb,REP,550038,0,0,435,435,
Oklahoma,Superintendent of Public Instruction,John Cox,DEM,550038,0,0,263,263,
Oklahoma,Superintendent of Public Instruction,Joy Hofmeister,REP,550038,0,0,364,364,
Oklahoma,Commissioner of Labor,Mike Workman,DEM,550038,0,0,184,184,
Oklahoma,Commissioner of Labor,Mark Costello,REP,550038,0,0,429,429,
Oklahoma,U.S. Senate,Matt Silverstein,DEM,550038,0,0,183,183,
Oklahoma,U.S. Senate,Jim Inhofe,REP,550038,0,0,429,429,
Oklahoma,U.S. Senate,Aaron Delozier,IND,550038,0,0,3,3,
Oklahoma,U.S. Senate,Ray Woods,IND,550038,0,0,5,5,
Oklahoma,U.S. Senate,Joan Farr,IND,550038,0,0,9,9,
Oklahoma,U.S. Senate,Connie Johnson,DEM,550038,0,0,179,179,
Oklahoma,U.S. Senate,James Lankford,REP,550038,0,0,439,439,
Oklahoma,U.S. Senate,Mark Beard,IND,550038,0,0,13,13,
Oklahoma,U.S. House,Al Mcaffrey,DEM,550038,0,0,176,176,05
Oklahoma,U.S. House,Steve Russell,REP,550038,0,0,435,435,05
Oklahoma,U.S. House,Buddy Ray,IND,550038,0,0,5,5,05
Oklahoma,U.S. House,Tom Boggs,IND,550038,0,0,4,4,05
Oklahoma,U.S. House,Robert Murphy,IND,550038,0,0,8,8,05
Oklahoma,Governor,Joe Dorman,DEM,550039,0,0,282,282,
Oklahoma,Governor,Mary Fallin,REP,550039,0,0,398,398,
Oklahoma,Governor,Kimberly Willis,IND,550039,0,0,11,11,
Oklahoma,Governor,Richard Prawdzienski,IND,550039,0,0,5,5,
Oklahoma,Lieutenant Governor,Cathy Cummings,DEM,550039,0,0,189,189,
Oklahoma,Lieutenant Governor,Todd Lamb,REP,550039,0,0,500,500,
Oklahoma,Superintendent of Public Instruction,John Cox,DEM,550039,0,0,284,284,
Oklahoma,Superintendent of Public Instruction,Joy Hofmeister,REP,550039,0,0,404,404,
Oklahoma,Commissioner of Labor,Mike Workman,DEM,550039,0,0,196,196,
Oklahoma,Commissioner of Labor,Mark Costello,REP,550039,0,0,473,473,
Oklahoma,U.S. Senate,Matt Silverstein,DEM,550039,0,0,176,176,
Oklahoma,U.S. Senate,Jim Inhofe,REP,550039,0,0,492,492,
Oklahoma,U.S. Senate,Aaron Delozier,IND,550039,0,0,3,3,
Oklahoma,U.S. Senate,Ray Woods,IND,550039,0,0,9,9,
Oklahoma,U.S. Senate,Joan Farr,IND,550039,0,0,9,9,
Oklahoma,U.S. Senate,Connie Johnson,DEM,550039,0,0,177,177,
Oklahoma,U.S. Senate,James Lankford,REP,550039,0,0,502,502,
Oklahoma,U.S. Senate,Mark Beard,IND,550039,0,0,13,13,
Oklahoma,U.S. House,Al Mcaffrey,DEM,550039,0,0,178,178,05
Oklahoma,U.S. House,Steve Russell,REP,550039,0,0,486,486,05
Oklahoma,U.S. House,Buddy Ray,IND,550039,0,0,4,4,05
Oklahoma,U.S. House,Tom Boggs,IND,550039,0,0,10,10,05
Oklahoma,U.S. House,Robert Murphy,IND,550039,0,0,7,7,05
Oklahoma,State House,Ed Holzberger,DEM,550039,0,0,195,195,83
Oklahoma,State House,Randy Mcdaniel,REP,550039,0,0,481,481,83
Oklahoma,Governor,Joe Dorman,DEM,550040,0,0,392,392,
Oklahoma,Governor,Mary Fallin,REP,550040,0,0,518,518,
Oklahoma,Governor,Kimberly Willis,IND,550040,0,0,20,20,
Oklahoma,Governor,Richard Prawdzienski,IND,550040,0,0,16,16,
Oklahoma,Lieutenant Governor,Cathy Cummings,DEM,550040,0,0,285,285,
Oklahoma,Lieutenant Governor,Todd Lamb,REP,550040,0,0,660,660,
Oklahoma,Superintendent of Public Instruction,John Cox,DEM,550040,0,0,393,393,
Oklahoma,Superintendent of Public Instruction,Joy Hofmeister,REP,550040,0,0,551,551,
Oklahoma,Commissioner of Labor,Mike Workman,DEM,550040,0,0,282,282,
Oklahoma,Commissioner of Labor,Mark Costello,REP,550040,0,0,651,651,
Oklahoma,U.S. Senate,Matt Silverstein,DEM,550040,0,0,256,256,
Oklahoma,U.S. Senate,Jim Inhofe,REP,550040,0,0,652,652,
Oklahoma,U.S. Senate,Aaron Delozier,IND,550040,0,0,8,8,
Oklahoma,U.S. Senate,Ray Woods,IND,550040,0,0,14,14,
Oklahoma,U.S. Senate,Joan Farr,IND,550040,0,0,12,12,
Oklahoma,U.S. Senate,Connie Johnson,DEM,550040,0,0,263,263,
Oklahoma,U.S. Senate,James Lankford,REP,550040,0,0,655,655,
Oklahoma,U.S. Senate,Mark Beard,IND,550040,0,0,30,30,
Oklahoma,U.S. House,Al Mcaffrey,DEM,550040,0,0,256,256,05
Oklahoma,U.S. House,Steve Russell,REP,550040,0,0,644,644,05
Oklahoma,U.S. House,Buddy Ray,IND,550040,0,0,15,15,05
Oklahoma,U.S. House,Tom Boggs,IND,550040,0,0,12,12,05
Oklahoma,U.S. House,Robert Murphy,IND,550040,0,0,13,13,05
Oklahoma,Governor,Joe Dorman,DEM,550041,0,0,295,295,
Oklahoma,Governor,Mary Fallin,REP,550041,0,0,368,368,
Oklahoma,Governor,Kimberly Willis,IND,550041,0,0,16,16,
Oklahoma,Governor,Richard Prawdzienski,IND,550041,0,0,10,10,
Oklahoma,Lieutenant Governor,Cathy Cummings,DEM,550041,0,0,224,224,
Oklahoma,Lieutenant Governor,Todd Lamb,REP,550041,0,0,463,463,
Oklahoma,Superintendent of Public Instruction,John Cox,DEM,550041,0,0,310,310,
Oklahoma,Superintendent of Public Instruction,Joy Hofmeister,REP,550041,0,0,374,374,
Oklahoma,Commissioner of Labor,Mike Workman,DEM,550041,0,0,217,217,
Oklahoma,Commissioner of Labor,Mark Costello,REP,550041,0,0,452,452,
Oklahoma,U.S. Senate,Matt Silverstein,DEM,550041,0,0,215,215,
Oklahoma,U.S. Senate,Jim Inhofe,REP,550041,0,0,441,441,
Oklahoma,U.S. Senate,Aaron Delozier,IND,550041,0,0,9,9,
Oklahoma,U.S. Senate,Ray Woods,IND,550041,0,0,9,9,
Oklahoma,U.S. Senate,Joan Farr,IND,550041,0,0,9,9,
Oklahoma,U.S. Senate,Connie Johnson,DEM,550041,0,0,219,219,
Oklahoma,U.S. Senate,James Lankford,REP,550041,0,0,458,458,
Oklahoma,U.S. Senate,Mark Beard,IND,550041,0,0,8,8,
Oklahoma,U.S. House,Al Mcaffrey,DEM,550041,0,0,209,209,05
Oklahoma,U.S. House,Steve Russell,REP,550041,0,0,445,445,05
Oklahoma,U.S. House,Buddy Ray,IND,550041,0,0,8,8,05
Oklahoma,U.S. House,Tom Boggs,IND,550041,0,0,10,10,05
Oklahoma,U.S. House,Robert Murphy,IND,550041,0,0,5,5,05
Oklahoma,Governor,Joe Dorman,DEM,550042,0,0,322,322,
Oklahoma,Governor,Mary Fallin,REP,550042,0,0,534,534,
Oklahoma,Governor,Kimberly Willis,IND,550042,0,0,16,16,
Oklahoma,Governor,Richard Prawdzienski,IND,550042,0,0,7,7,
Oklahoma,Lieutenant Governor,Cathy Cummings,DEM,550042,0,0,221,221,
Oklahoma,Lieutenant Governor,Todd Lamb,REP,550042,0,0,657,657,
Oklahoma,Superintendent of Public Instruction,John Cox,DEM,550042,0,0,304,304,
Oklahoma,Superintendent of Public Instruction,Joy Hofmeister,REP,550042,0,0,561,561,
Oklahoma,Commissioner of Labor,Mike Workman,DEM,550042,0,0,220,220,
Oklahoma,Commissioner of Labor,Mark Costello,REP,550042,0,0,643,643,
Oklahoma,U.S. Senate,Matt Silverstein,DEM,550042,0,0,198,198,
Oklahoma,U.S. Senate,Jim Inhofe,REP,550042,0,0,643,643,
Oklahoma,U.S. Senate,Aaron Delozier,IND,550042,0,0,7,7,
Oklahoma,U.S. Senate,Ray Woods,IND,550042,0,0,11,11,
Oklahoma,U.S. Senate,Joan Farr,IND,550042,0,0,11,11,
Oklahoma,U.S. Senate,Connie Johnson,DEM,550042,0,0,201,201,
Oklahoma,U.S. Senate,James Lankford,REP,550042,0,0,651,651,
Oklahoma,U.S. Senate,Mark Beard,IND,550042,0,0,26,26,
Oklahoma,U.S. House,Al Mcaffrey,DEM,550042,0,0,203,203,05
Oklahoma,U.S. House,Steve Russell,REP,550042,0,0,634,634,05
Oklahoma,U.S. House,Buddy Ray,IND,550042,0,0,8,8,05
Oklahoma,U.S. House,Tom Boggs,IND,550042,0,0,13,13,05
Oklahoma,U.S. House,Robert Murphy,IND,550042,0,0,13,13,05
Oklahoma,Governor,Joe Dorman,DEM,550043,0,0,247,247,
Oklahoma,Governor,Mary Fallin,REP,550043,0,0,975,975,
Oklahoma,Governor,Kimberly Willis,IND,550043,0,0,12,12,
Oklahoma,Governor,Richard Prawdzienski,IND,550043,0,0,4,4,
Oklahoma,Lieutenant Governor,Cathy Cummings,DEM,550043,0,0,156,156,
Oklahoma,Lieutenant Governor,Todd Lamb,REP,550043,0,0,1077,1077,
Oklahoma,Superintendent of Public Instruction,John Cox,DEM,550043,0,0,280,280,
Oklahoma,Superintendent of Public Instruction,Joy Hofmeister,REP,550043,0,0,939,939,
Oklahoma,Commissioner of Labor,Mike Workman,DEM,550043,0,0,161,161,
Oklahoma,Commissioner of Labor,Mark Costello,REP,550043,0,0,1049,1049,
Oklahoma,U.S. Senate,Matt Silverstein,DEM,550043,0,0,147,147,
Oklahoma,U.S. Senate,Jim Inhofe,REP,550043,0,0,1056,1056,
Oklahoma,U.S. Senate,Aaron Delozier,IND,550043,0,0,8,8,
Oklahoma,U.S. Senate,Ray Woods,IND,550043,0,0,5,5,
Oklahoma,U.S. Senate,Joan Farr,IND,550043,0,0,12,12,
Oklahoma,U.S. Senate,Connie Johnson,DEM,550043,0,0,152,152,
Oklahoma,U.S. Senate,James Lankford,REP,550043,0,0,1067,1067,
Oklahoma,U.S. Senate,Mark Beard,IND,550043,0,0,17,17,
Oklahoma,U.S. House,Al Mcaffrey,DEM,550043,0,0,138,138,05
Oklahoma,U.S. House,Steve Russell,REP,550043,0,0,1059,1059,05
Oklahoma,U.S. House,Buddy Ray,IND,550043,0,0,6,6,05
Oklahoma,U.S. House,Tom Boggs,IND,550043,0,0,14,14,05
Oklahoma,U.S. House,Robert Murphy,IND,550043,0,0,7,7,05
Oklahoma,Governor,Joe Dorman,DEM,550044,0,0,420,420,
Oklahoma,Governor,Mary Fallin,REP,550044,0,0,666,666,
Oklahoma,Governor,Kimberly Willis,IND,550044,0,0,15,15,
Oklahoma,Governor,Richard Prawdzienski,IND,550044,0,0,17,17,
Oklahoma,Lieutenant Governor,Cathy Cummings,DEM,550044,0,0,291,291,
Oklahoma,Lieutenant Governor,Todd Lamb,REP,550044,0,0,824,824,
Oklahoma,Superintendent of Public Instruction,John Cox,DEM,550044,0,0,435,435,
Oklahoma,Superintendent of Public Instruction,Joy Hofmeister,REP,550044,0,0,674,674,
Oklahoma,Commissioner of Labor,Mike Workman,DEM,550044,0,0,277,277,
Oklahoma,Commissioner of Labor,Mark Costello,REP,550044,0,0,808,808,
Oklahoma,U.S. Senate,Matt Silverstein,DEM,550044,0,0,258,258,
Oklahoma,U.S. Senate,Jim Inhofe,REP,550044,0,0,817,817,
Oklahoma,U.S. Senate,Aaron Delozier,IND,550044,0,0,12,12,
Oklahoma,U.S. Senate,Ray Woods,IND,550044,0,0,8,8,
Oklahoma,U.S. Senate,Joan Farr,IND,550044,0,0,14,14,
Oklahoma,U.S. Senate,Connie Johnson,DEM,550044,0,0,271,271,
Oklahoma,U.S. Senate,James Lankford,REP,550044,0,0,821,821,
Oklahoma,U.S. Senate,Mark Beard,IND,550044,0,0,23,23,
Oklahoma,U.S. House,Al Mcaffrey,DEM,550044,0,0,276,276,05
Oklahoma,U.S. House,Steve Russell,REP,550044,0,0,795,795,05
Oklahoma,U.S. House,Buddy Ray,IND,550044,0,0,5,5,05
Oklahoma,U.S. House,Tom Boggs,IND,550044,0,0,10,10,05
Oklahoma,U.S. House,Robert Murphy,IND,550044,0,0,16,16,05
Oklahoma,Governor,Joe Dorman,DEM,550045,0,0,378,378,
Oklahoma,Governor,Mary Fallin,REP,550045,0,0,787,787,
Oklahoma,Governor,Kimberly Willis,IND,550045,0,0,15,15,
Oklahoma,Governor,Richard Prawdzienski,IND,550045,0,0,19,19,
Oklahoma,Lieutenant Governor,Cathy Cummings,DEM,550045,0,0,271,271,
Oklahoma,Lieutenant Governor,Todd Lamb,REP,550045,0,0,930,930,
Oklahoma,Superintendent of Public Instruction,John Cox,DEM,550045,0,0,391,391,
Oklahoma,Superintendent of Public Instruction,Joy Hofmeister,REP,550045,0,0,803,803,
Oklahoma,Commissioner of Labor,Mike Workman,DEM,550045,0,0,261,261,
Oklahoma,Commissioner of Labor,Mark Costello,REP,550045,0,0,924,924,
Oklahoma,U.S. Senate,Matt Silverstein,DEM,550045,0,0,257,257,
Oklahoma,U.S. Senate,Jim Inhofe,REP,550045,0,0,911,911,
Oklahoma,U.S. Senate,Aaron Delozier,IND,550045,0,0,9,9,
Oklahoma,U.S. Senate,Ray Woods,IND,550045,0,0,12,12,
Oklahoma,U.S. Senate,Joan Farr,IND,550045,0,0,9,9,
Oklahoma,U.S. Senate,Connie Johnson,DEM,550045,0,0,243,243,
Oklahoma,U.S. Senate,James Lankford,REP,550045,0,0,939,939,
Oklahoma,U.S. Senate,Mark Beard,IND,550045,0,0,23,23,
Oklahoma,U.S. House,Al Mcaffrey,DEM,550045,0,0,252,252,05
Oklahoma,U.S. House,Steve Russell,REP,550045,0,0,914,914,05
Oklahoma,U.S. House,Buddy Ray,IND,550045,0,0,4,4,05
Oklahoma,U.S. House,Tom Boggs,IND,550045,0,0,12,12,05
Oklahoma,U.S. House,Robert Murphy,IND,550045,0,0,8,8,05
Oklahoma,Governor,Joe Dorman,DEM,550046,0,0,176,176,
Oklahoma,Governor,Mary Fallin,REP,550046,0,0,195,195,
Oklahoma,Governor,Kimberly Willis,IND,550046,0,0,4,4,
Oklahoma,Governor,Richard Prawdzienski,IND,550046,0,0,4,4,
Oklahoma,Lieutenant Governor,Cathy Cummings,DEM,550046,0,0,148,148,
Oklahoma,Lieutenant Governor,Todd Lamb,REP,550046,0,0,229,229,
Oklahoma,Superintendent of Public Instruction,John Cox,DEM,550046,0,0,179,179,
Oklahoma,Superintendent of Public Instruction,Joy Hofmeister,REP,550046,0,0,198,198,
Oklahoma,Commissioner of Labor,Mike Workman,DEM,550046,0,0,140,140,
Oklahoma,Commissioner of Labor,Mark Costello,REP,550046,0,0,230,230,
Oklahoma,U.S. Senate,Matt Silverstein,DEM,550046,0,0,139,139,
Oklahoma,U.S. Senate,Jim Inhofe,REP,550046,0,0,224,224,
Oklahoma,U.S. Senate,Aaron Delozier,IND,550046,0,0,1,1,
Oklahoma,U.S. Senate,Ray Woods,IND,550046,0,0,7,7,
Oklahoma,U.S. Senate,Joan Farr,IND,550046,0,0,7,7,
Oklahoma,U.S. Senate,Connie Johnson,DEM,550046,0,0,146,146,
Oklahoma,U.S. Senate,James Lankford,REP,550046,0,0,216,216,
Oklahoma,U.S. Senate,Mark Beard,IND,550046,0,0,16,16,
Oklahoma,U.S. House,Al Mcaffrey,DEM,550046,0,0,139,139,05
Oklahoma,U.S. House,Steve Russell,REP,550046,0,0,217,217,05
Oklahoma,U.S. House,Buddy Ray,IND,550046,0,0,5,5,05
Oklahoma,U.S. House,Tom Boggs,IND,550046,0,0,7,7,05
Oklahoma,U.S. House,Robert Murphy,IND,550046,0,0,4,4,05
Oklahoma,Governor,Joe Dorman,DEM,550047,0,0,155,155,
Oklahoma,Governor,Mary Fallin,REP,550047,0,0,142,142,
Oklahoma,Governor,Kimberly Willis,IND,550047,0,0,10,10,
Oklahoma,Governor,Richard Prawdzienski,IND,550047,0,0,9,9,
Oklahoma,Lieutenant Governor,Cathy Cummings,DEM,550047,0,0,130,130,
Oklahoma,Lieutenant Governor,Todd Lamb,REP,550047,0,0,185,185,
Oklahoma,Superintendent of Public Instruction,John Cox,DEM,550047,0,0,161,161,
Oklahoma,Superintendent of Public Instruction,Joy Hofmeister,REP,550047,0,0,152,152,
Oklahoma,Commissioner of Labor,Mike Workman,DEM,550047,0,0,136,136,
Oklahoma,Commissioner of Labor,Mark Costello,REP,550047,0,0,169,169,
Oklahoma,U.S. Senate,Matt Silverstein,DEM,550047,0,0,119,119,
Oklahoma,U.S. Senate,Jim Inhofe,REP,550047,0,0,173,173,
Oklahoma,U.S. Senate,Aaron Delozier,IND,550047,0,0,6,6,
Oklahoma,U.S. Senate,Ray Woods,IND,550047,0,0,8,8,
Oklahoma,U.S. Senate,Joan Farr,IND,550047,0,0,9,9,
Oklahoma,U.S. Senate,Connie Johnson,DEM,550047,0,0,127,127,
Oklahoma,U.S. Senate,James Lankford,REP,550047,0,0,175,175,
Oklahoma,U.S. Senate,Mark Beard,IND,550047,0,0,17,17,
Oklahoma,U.S. House,Al Mcaffrey,DEM,550047,0,0,129,129,05
Oklahoma,U.S. House,Steve Russell,REP,550047,0,0,162,162,05
Oklahoma,U.S. House,Buddy Ray,IND,550047,0,0,7,7,05
Oklahoma,U.S. House,Tom Boggs,IND,550047,0,0,6,6,05
Oklahoma,U.S. House,Robert Murphy,IND,550047,0,0,5,5,05
Oklahoma,Governor,Joe Dorman,DEM,550048,0,0,208,208,
Oklahoma,Governor,Mary Fallin,REP,550048,0,0,266,266,
Oklahoma,Governor,Kimberly Willis,IND,550048,0,0,12,12,
Oklahoma,Governor,Richard Prawdzienski,IND,550048,0,0,12,12,
Oklahoma,Lieutenant Governor,Cathy Cummings,DEM,550048,0,0,154,154,
Oklahoma,Lieutenant Governor,Todd Lamb,REP,550048,0,0,340,340,
Oklahoma,Superintendent of Public Instruction,John Cox,DEM,550048,0,0,195,195,
Oklahoma,Superintendent of Public Instruction,Joy Hofmeister,REP,550048,0,0,295,295,
Oklahoma,Commissioner of Labor,Mike Workman,DEM,550048,0,0,157,157,
Oklahoma,Commissioner of Labor,Mark Costello,REP,550048,0,0,325,325,
Oklahoma,U.S. Senate,Matt Silverstein,DEM,550048,0,0,136,136,
Oklahoma,U.S. Senate,Jim Inhofe,REP,550048,0,0,329,329,
Oklahoma,U.S. Senate,Aaron Delozier,IND,550048,0,0,6,6,
Oklahoma,U.S. Senate,Ray Woods,IND,550048,0,0,11,11,
Oklahoma,U.S. Senate,Joan Farr,IND,550048,0,0,7,7,
Oklahoma,U.S. Senate,Connie Johnson,DEM,550048,0,0,148,148,
Oklahoma,U.S. Senate,James Lankford,REP,550048,0,0,332,332,
Oklahoma,U.S. Senate,Mark Beard,IND,550048,0,0,14,14,
Oklahoma,U.S. House,Al Mcaffrey,DEM,550048,0,0,138,138,05
Oklahoma,U.S. House,Steve Russell,REP,550048,0,0,326,326,05
Oklahoma,U.S. House,Buddy Ray,IND,550048,0,0,7,7,05
Oklahoma,U.S. House,Tom Boggs,IND,550048,0,0,7,7,05
Oklahoma,U.S. House,Robert Murphy,IND,550048,0,0,13,13,05
Oklahoma,Governor,Joe Dorman,DEM,550049,0,0,165,165,
Oklahoma,Governor,Mary Fallin,REP,550049,0,0,162,162,
Oklahoma,Governor,Kimberly Willis,IND,550049,0,0,14,14,
Oklahoma,Governor,Richard Prawdzienski,IND,550049,0,0,10,10,
Oklahoma,Lieutenant Governor,Cathy Cummings,DEM,550049,0,0,135,135,
Oklahoma,Lieutenant Governor,Todd Lamb,REP,550049,0,0,212,212,
Oklahoma,Superintendent of Public Instruction,John Cox,DEM,550049,0,0,165,165,
Oklahoma,Superintendent of Public Instruction,Joy Hofmeister,REP,550049,0,0,182,182,
Oklahoma,Commissioner of Labor,Mike Workman,DEM,550049,0,0,130,130,
Oklahoma,Commissioner of Labor,Mark Costello,REP,550049,0,0,211,211,
Oklahoma,U.S. Senate,Matt Silverstein,DEM,550049,0,0,117,117,
Oklahoma,U.S. Senate,Jim Inhofe,REP,550049,0,0,214,214,
Oklahoma,U.S. Senate,Aaron Delozier,IND,550049,0,0,7,7,
Oklahoma,U.S. Senate,Ray Woods,IND,550049,0,0,8,8,
Oklahoma,U.S. Senate,Joan Farr,IND,550049,0,0,4,4,
Oklahoma,U.S. Senate,Connie Johnson,DEM,550049,0,0,128,128,
Oklahoma,U.S. Senate,James Lankford,REP,550049,0,0,209,209,
Oklahoma,U.S. Senate,Mark Beard,IND,550049,0,0,14,14,
Oklahoma,U.S. House,Al Mcaffrey,DEM,550049,0,0,125,125,05
Oklahoma,U.S. House,Steve Russell,REP,550049,0,0,208,208,05
Oklahoma,U.S. House,Buddy Ray,IND,550049,0,0,7,7,05
Oklahoma,U.S. House,Tom Boggs,IND,550049,0,0,5,5,05
Oklahoma,U.S. House,Robert Murphy,IND,550049,0,0,5,5,05
Oklahoma,Governor,Joe Dorman,DEM,550050,0,0,12,12,
Oklahoma,Governor,Mary Fallin,REP,550050,0,0,5,5,
Oklahoma,Governor,Kimberly Willis,IND,550050,0,0,0,0,
Oklahoma,Governor,Richard Prawdzienski,IND,550050,0,0,0,0,
Oklahoma,Lieutenant Governor,Cathy Cummings,DEM,550050,0,0,10,10,
Oklahoma,Lieutenant Governor,Todd Lamb,REP,550050,0,0,7,7,
Oklahoma,Superintendent of Public Instruction,John Cox,DEM,550050,0,0,8,8,
Oklahoma,Superintendent of Public Instruction,Joy Hofmeister,REP,550050,0,0,8,8,
Oklahoma,Commissioner of Labor,Mike Workman,DEM,550050,0,0,7,7,
Oklahoma,Commissioner of Labor,Mark Costello,REP,550050,0,0,8,8,
Oklahoma,U.S. Senate,Matt Silverstein,DEM,550050,0,0,9,9,
Oklahoma,U.S. Senate,Jim Inhofe,REP,550050,0,0,8,8,
Oklahoma,U.S. Senate,Aaron Delozier,IND,550050,0,0,0,0,
Oklahoma,U.S. Senate,Ray Woods,IND,550050,0,0,0,0,
Oklahoma,U.S. Senate,Joan Farr,IND,550050,0,0,0,0,
Oklahoma,U.S. Senate,Connie Johnson,DEM,550050,0,0,8,8,
Oklahoma,U.S. Senate,James Lankford,REP,550050,0,0,7,7,
Oklahoma,U.S. Senate,Mark Beard,IND,550050,0,0,2,2,
Oklahoma,U.S. House,Al Mcaffrey,DEM,550050,0,0,10,10,05
Oklahoma,U.S. House,Steve Russell,REP,550050,0,0,6,6,05
Oklahoma,U.S. House,Buddy Ray,IND,550050,0,0,0,0,05
Oklahoma,U.S. House,Tom Boggs,IND,550050,0,0,1,1,05
Oklahoma,U.S. House,Robert Murphy,IND,550050,0,0,0,0,05
Oklahoma,State House,Ed Holzberger,DEM,550050,0,0,10,10,83
Oklahoma,State House,Randy Mcdaniel,REP,550050,0,0,7,7,83
Oklahoma,Governor,Joe Dorman,DEM,550051,0,0,220,220,
Oklahoma,Governor,Mary Fallin,REP,550051,0,0,282,282,
Oklahoma,Governor,Kimberly Willis,IND,550051,0,0,6,6,
Oklahoma,Governor,Richard Prawdzienski,IND,550051,0,0,6,6,
Oklahoma,Lieutenant Governor,Cathy Cummings,DEM,550051,0,0,176,176,
Oklahoma,Lieutenant Governor,Todd Lamb,REP,550051,0,0,334,334,
Oklahoma,Superintendent of Public Instruction,John Cox,DEM,550051,0,0,215,215,
Oklahoma,Superintendent of Public Instruction,Joy Hofmeister,REP,550051,0,0,297,297,
Oklahoma,Commissioner of Labor,Mike Workman,DEM,550051,0,0,181,181,
Oklahoma,Commissioner of Labor,Mark Costello,REP,550051,0,0,318,318,
Oklahoma,U.S. Senate,Matt Silverstein,DEM,550051,0,0,153,153,
Oklahoma,U.S. Senate,Jim Inhofe,REP,550051,0,0,332,332,
Oklahoma,U.S. Senate,Aaron Delozier,IND,550051,0,0,6,6,
Oklahoma,U.S. Senate,Ray Woods,IND,550051,0,0,6,6,
Oklahoma,U.S. Senate,Joan Farr,IND,550051,0,0,10,10,
Oklahoma,U.S. Senate,Connie Johnson,DEM,550051,0,0,156,156,
Oklahoma,U.S. Senate,James Lankford,REP,550051,0,0,337,337,
Oklahoma,U.S. Senate,Mark Beard,IND,550051,0,0,18,18,
Oklahoma,U.S. House,Al Mcaffrey,DEM,550051,0,0,151,151,05
Oklahoma,U.S. House,Steve Russell,REP,550051,0,0,333,333,05
Oklahoma,U.S. House,Buddy Ray,IND,550051,0,0,7,7,05
Oklahoma,U.S. House,Tom Boggs,IND,550051,0,0,6,6,05
Oklahoma,U.S. House,Robert Murphy,IND,550051,0,0,11,11,05
Oklahoma,Governor,Joe Dorman,DEM,550052,0,0,232,232,
Oklahoma,Governor,Mary Fallin,REP,550052,0,0,445,445,
Oklahoma,Governor,Kimberly Willis,IND,550052,0,0,9,9,
Oklahoma,Governor,Richard Prawdzienski,IND,550052,0,0,6,6,
Oklahoma,Lieutenant Governor,Cathy Cummings,DEM,550052,0,0,163,163,
Oklahoma,Lieutenant Governor,Todd Lamb,REP,550052,0,0,529,529,
Oklahoma,Superintendent of Public Instruction,John Cox,DEM,550052,0,0,244,244,
Oklahoma,Superintendent of Public Instruction,Joy Hofmeister,REP,550052,0,0,442,442,
Oklahoma,Commissioner of Labor,Mike Workman,DEM,550052,0,0,176,176,
Oklahoma,Commissioner of Labor,Mark Costello,REP,550052,0,0,502,502,
Oklahoma,U.S. Senate,Matt Silverstein,DEM,550052,0,0,153,153,
Oklahoma,U.S. Senate,Jim Inhofe,REP,550052,0,0,520,520,
Oklahoma,U.S. Senate,Aaron Delozier,IND,550052,0,0,7,7,
Oklahoma,U.S. Senate,Ray Woods,IND,550052,0,0,5,5,
Oklahoma,U.S. Senate,Joan Farr,IND,550052,0,0,3,3,
Oklahoma,U.S. Senate,Connie Johnson,DEM,550052,0,0,146,146,
Oklahoma,U.S. Senate,James Lankford,REP,550052,0,0,529,529,
Oklahoma,U.S. Senate,Mark Beard,IND,550052,0,0,19,19,
Oklahoma,U.S. House,Al Mcaffrey,DEM,550052,0,0,154,154,05
Oklahoma,U.S. House,Steve Russell,REP,550052,0,0,514,514,05
Oklahoma,U.S. House,Buddy Ray,IND,550052,0,0,2,2,05
Oklahoma,U.S. House,Tom Boggs,IND,550052,0,0,4,4,05
Oklahoma,U.S. House,Robert Murphy,IND,550052,0,0,10,10,05
Oklahoma,Governor,Joe Dorman,DEM,550053,0,0,257,257,
Oklahoma,Governor,Mary Fallin,REP,550053,0,0,385,385,
Oklahoma,Governor,Kimberly Willis,IND,550053,0,0,10,10,
Oklahoma,Governor,Richard Prawdzienski,IND,550053,0,0,11,11,
Oklahoma,Lieutenant Governor,Cathy Cummings,DEM,550053,0,0,189,189,
Oklahoma,Lieutenant Governor,Todd Lamb,REP,550053,0,0,471,471,
Oklahoma,Superintendent of Public Instruction,John Cox,DEM,550053,0,0,251,251,
Oklahoma,Superintendent of Public Instruction,Joy Hofmeister,REP,550053,0,0,407,407,
Oklahoma,Commissioner of Labor,Mike Workman,DEM,550053,0,0,197,197,
Oklahoma,Commissioner of Labor,Mark Costello,REP,550053,0,0,441,441,
Oklahoma,U.S. Senate,Matt Silverstein,DEM,550053,0,0,171,171,
Oklahoma,U.S. Senate,Jim Inhofe,REP,550053,0,0,466,466,
Oklahoma,U.S. Senate,Aaron Delozier,IND,550053,0,0,5,5,
Oklahoma,U.S. Senate,Ray Woods,IND,550053,0,0,8,8,
Oklahoma,U.S. Senate,Joan Farr,IND,550053,0,0,9,9,
Oklahoma,U.S. Senate,Connie Johnson,DEM,550053,0,0,190,190,
Oklahoma,U.S. Senate,James Lankford,REP,550053,0,0,457,457,
Oklahoma,U.S. Senate,Mark Beard,IND,550053,0,0,18,18,
Oklahoma,U.S. House,Al Mcaffrey,DEM,550053,0,0,174,174,05
Oklahoma,U.S. House,Steve Russell,REP,550053,0,0,456,456,05
Oklahoma,U.S. House,Buddy Ray,IND,550053,0,0,10,10,05
Oklahoma,U.S. House,Tom Boggs,IND,550053,0,0,6,6,05
Oklahoma,U.S. House,Robert Murphy,IND,550053,0,0,13,13,05
Oklahoma,Governor,Joe Dorman,DEM,550054,0,0,288,288,
Oklahoma,Governor,Mary Fallin,REP,550054,0,0,450,450,
Oklahoma,Governor,Kimberly Willis,IND,550054,0,0,18,18,
Oklahoma,Governor,Richard Prawdzienski,IND,550054,0,0,11,11,
Oklahoma,Lieutenant Governor,Cathy Cummings,DEM,550054,0,0,198,198,
Oklahoma,Lieutenant Governor,Todd Lamb,REP,550054,0,0,566,566,
Oklahoma,Superintendent of Public Instruction,John Cox,DEM,550054,0,0,289,289,
Oklahoma,Superintendent of Public Instruction,Joy Hofmeister,REP,550054,0,0,470,470,
Oklahoma,Commissioner of Labor,Mike Workman,DEM,550054,0,0,205,205,
Oklahoma,Commissioner of Labor,Mark Costello,REP,550054,0,0,544,544,
Oklahoma,U.S. Senate,Matt Silverstein,DEM,550054,0,0,187,187,
Oklahoma,U.S. Senate,Jim Inhofe,REP,550054,0,0,542,542,
Oklahoma,U.S. Senate,Aaron Delozier,IND,550054,0,0,6,6,
Oklahoma,U.S. Senate,Ray Woods,IND,550054,0,0,12,12,
Oklahoma,U.S. Senate,Joan Farr,IND,550054,0,0,10,10,
Oklahoma,U.S. Senate,Connie Johnson,DEM,550054,0,0,187,187,
Oklahoma,U.S. Senate,James Lankford,REP,550054,0,0,560,560,
Oklahoma,U.S. Senate,Mark Beard,IND,550054,0,0,19,19,
Oklahoma,U.S. House,Al Mcaffrey,DEM,550054,0,0,171,171,05
Oklahoma,U.S. House,Steve Russell,REP,550054,0,0,560,560,05
Oklahoma,U.S. House,Buddy Ray,IND,550054,0,0,7,7,05
Oklahoma,U.S. House,Tom Boggs,IND,550054,0,0,9,9,05
Oklahoma,U.S. House,Robert Murphy,IND,550054,0,0,9,9,05
Oklahoma,Governor,Joe Dorman,DEM,550055,0,0,283,283,
Oklahoma,Governor,Mary Fallin,REP,550055,0,0,423,423,
Oklahoma,Governor,Kimberly Willis,IND,550055,0,0,19,19,
Oklahoma,Governor,Richard Prawdzienski,IND,550055,0,0,8,8,
Oklahoma,Lieutenant Governor,Cathy Cummings,DEM,550055,0,0,246,246,
Oklahoma,Lieutenant Governor,Todd Lamb,REP,550055,0,0,482,482,
Oklahoma,Superintendent of Public Instruction,John Cox,DEM,550055,0,0,311,311,
Oklahoma,Superintendent of Public Instruction,Joy Hofmeister,REP,550055,0,0,415,415,
Oklahoma,Commissioner of Labor,Mike Workman,DEM,550055,0,0,242,242,
Oklahoma,Commissioner of Labor,Mark Costello,REP,550055,0,0,470,470,
Oklahoma,U.S. Senate,Matt Silverstein,DEM,550055,0,0,219,219,
Oklahoma,U.S. Senate,Jim Inhofe,REP,550055,0,0,482,482,
Oklahoma,U.S. Senate,Aaron Delozier,IND,550055,0,0,8,8,
Oklahoma,U.S. Senate,Ray Woods,IND,550055,0,0,6,6,
Oklahoma,U.S. Senate,Joan Farr,IND,550055,0,0,13,13,
Oklahoma,U.S. Senate,Connie Johnson,DEM,550055,0,0,218,218,
Oklahoma,U.S. Senate,James Lankford,REP,550055,0,0,498,498,
Oklahoma,U.S. Senate,Mark Beard,IND,550055,0,0,17,17,
Oklahoma,U.S. House,Al Mcaffrey,DEM,550055,0,0,208,208,05
Oklahoma,U.S. House,Steve Russell,REP,550055,0,0,496,496,05
Oklahoma,U.S. House,Buddy Ray,IND,550055,0,0,6,6,05
Oklahoma,U.S. House,Tom Boggs,IND,550055,0,0,11,11,05
Oklahoma,U.S. House,Robert Murphy,IND,550055,0,0,2,2,05
Oklahoma,Governor,Joe Dorman,DEM,550056,0,0,252,252,
Oklahoma,Governor,Mary Fallin,REP,550056,0,0,402,402,
Oklahoma,Governor,Kimberly Willis,IND,550056,0,0,10,10,
Oklahoma,Governor,Richard Prawdzienski,IND,550056,0,0,10,10,
Oklahoma,Lieutenant Governor,Cathy Cummings,DEM,550056,0,0,193,193,
Oklahoma,Lieutenant Governor,Todd Lamb,REP,550056,0,0,477,477,
Oklahoma,Superintendent of Public Instruction,John Cox,DEM,550056,0,0,256,256,
Oklahoma,Superintendent of Public Instruction,Joy Hofmeister,REP,550056,0,0,411,411,
Oklahoma,Commissioner of Labor,Mike Workman,DEM,550056,0,0,174,174,
Oklahoma,Commissioner of Labor,Mark Costello,REP,550056,0,0,481,481,
Oklahoma,U.S. Senate,Matt Silverstein,DEM,550056,0,0,175,175,
Oklahoma,U.S. Senate,Jim Inhofe,REP,550056,0,0,474,474,
Oklahoma,U.S. Senate,Aaron Delozier,IND,550056,0,0,8,8,
Oklahoma,U.S. Senate,Ray Woods,IND,550056,0,0,8,8,
Oklahoma,U.S. Senate,Joan Farr,IND,550056,0,0,6,6,
Oklahoma,U.S. Senate,Connie Johnson,DEM,550056,0,0,171,171,
Oklahoma,U.S. Senate,James Lankford,REP,550056,0,0,481,481,
Oklahoma,U.S. Senate,Mark Beard,IND,550056,0,0,20,20,
Oklahoma,U.S. House,Al Mcaffrey,DEM,550056,0,0,169,169,05
Oklahoma,U.S. House,Steve Russell,REP,550056,0,0,475,475,05
Oklahoma,U.S. House,Buddy Ray,IND,550056,0,0,5,5,05
Oklahoma,U.S. House,Tom Boggs,IND,550056,0,0,9,9,05
Oklahoma,U.S. House,Robert Murphy,IND,550056,0,0,8,8,05
Oklahoma,Governor,Joe Dorman,DEM,550057,0,0,183,183,
Oklahoma,Governor,Mary Fallin,REP,550057,0,0,362,362,
Oklahoma,Governor,Kimberly Willis,IND,550057,0,0,10,10,
Oklahoma,Governor,Richard Prawdzienski,IND,550057,0,0,10,10,
Oklahoma,Lieutenant Governor,Cathy Cummings,DEM,550057,0,0,161,161,
Oklahoma,Lieutenant Governor,Todd Lamb,REP,550057,0,0,408,408,
Oklahoma,Superintendent of Public Instruction,John Cox,DEM,550057,0,0,190,190,
Oklahoma,Superintendent of Public Instruction,Joy Hofmeister,REP,550057,0,0,375,375,
Oklahoma,Commissioner of Labor,Mike Workman,DEM,550057,0,0,154,154,
Oklahoma,Commissioner of Labor,Mark Costello,REP,550057,0,0,407,407,
Oklahoma,U.S. Senate,Matt Silverstein,DEM,550057,0,0,133,133,
Oklahoma,U.S. Senate,Jim Inhofe,REP,550057,0,0,400,400,
Oklahoma,U.S. Senate,Aaron Delozier,IND,550057,0,0,7,7,
Oklahoma,U.S. Senate,Ray Woods,IND,550057,0,0,12,12,
Oklahoma,U.S. Senate,Joan Farr,IND,550057,0,0,9,9,
Oklahoma,U.S. Senate,Connie Johnson,DEM,550057,0,0,147,147,
Oklahoma,U.S. Senate,James Lankford,REP,550057,0,0,405,405,
Oklahoma,U.S. Senate,Mark Beard,IND,550057,0,0,16,16,
Oklahoma,U.S. House,Al Mcaffrey,DEM,550057,0,0,139,139,05
Oklahoma,U.S. House,Steve Russell,REP,550057,0,0,407,407,05
Oklahoma,U.S. House,Buddy Ray,IND,550057,0,0,5,5,05
Oklahoma,U.S. House,Tom Boggs,IND,550057,0,0,6,6,05
Oklahoma,U.S. House,Robert Murphy,IND,550057,0,0,8,8,05
Oklahoma,Governor,Joe Dorman,DEM,550058,0,0,411,411,
Oklahoma,Governor,Mary Fallin,REP,550058,0,0,1074,1074,
Oklahoma,Governor,Kimberly Willis,IND,550058,0,0,13,13,
Oklahoma,Governor,Richard Prawdzienski,IND,550058,0,0,9,9,
Oklahoma,Lieutenant Governor,Cathy Cummings,DEM,550058,0,0,288,288,
Oklahoma,Lieutenant Governor,Todd Lamb,REP,550058,0,0,1224,1224,
Oklahoma,Superintendent of Public Instruction,John Cox,DEM,550058,0,0,447,447,
Oklahoma,Superintendent of Public Instruction,Joy Hofmeister,REP,550058,0,0,1048,1048,
Oklahoma,Commissioner of Labor,Mike Workman,DEM,550058,0,0,283,283,
Oklahoma,Commissioner of Labor,Mark Costello,REP,550058,0,0,1193,1193,
Oklahoma,U.S. Senate,Matt Silverstein,DEM,550058,0,0,284,284,
Oklahoma,U.S. Senate,Jim Inhofe,REP,550058,0,0,1186,1186,
Oklahoma,U.S. Senate,Aaron Delozier,IND,550058,0,0,9,9,
Oklahoma,U.S. Senate,Ray Woods,IND,550058,0,0,10,10,
Oklahoma,U.S. Senate,Joan Farr,IND,550058,0,0,8,8,
Oklahoma,U.S. Senate,Connie Johnson,DEM,550058,0,0,266,266,
Oklahoma,U.S. Senate,James Lankford,REP,550058,0,0,1224,1224,
Oklahoma,U.S. Senate,Mark Beard,IND,550058,0,0,25,25,
Oklahoma,U.S. House,Al Mcaffrey,DEM,550058,0,0,276,276,05
Oklahoma,U.S. House,Steve Russell,REP,550058,0,0,1193,1193,05
Oklahoma,U.S. House,Buddy Ray,IND,550058,0,0,9,9,05
Oklahoma,U.S. House,Tom Boggs,IND,550058,0,0,10,10,05
Oklahoma,U.S. House,Robert Murphy,IND,550058,0,0,9,9,05
Oklahoma,State House,Cecilia Taft,DEM,550058,0,0,317,317,96
Oklahoma,State House,Lewis Moore,REP,550058,0,0,1140,1140,96
Oklahoma,Governor,Joe Dorman,DEM,550059,0,0,196,196,
Oklahoma,Governor,Mary Fallin,REP,550059,0,0,680,680,
Oklahoma,Governor,Kimberly Willis,IND,550059,0,0,10,10,
Oklahoma,Governor,Richard Prawdzienski,IND,550059,0,0,9,9,
Oklahoma,Lieutenant Governor,Cathy Cummings,DEM,550059,0,0,130,130,
Oklahoma,Lieutenant Governor,Todd Lamb,REP,550059,0,0,765,765,
Oklahoma,Superintendent of Public Instruction,John Cox,DEM,550059,0,0,220,220,
Oklahoma,Superintendent of Public Instruction,Joy Hofmeister,REP,550059,0,0,673,673,
Oklahoma,Commissioner of Labor,Mike Workman,DEM,550059,0,0,139,139,
Oklahoma,Commissioner of Labor,Mark Costello,REP,550059,0,0,749,749,
Oklahoma,U.S. Senate,Matt Silverstein,DEM,550059,0,0,133,133,
Oklahoma,U.S. Senate,Jim Inhofe,REP,550059,0,0,751,751,
Oklahoma,U.S. Senate,Aaron Delozier,IND,550059,0,0,3,3,
Oklahoma,U.S. Senate,Ray Woods,IND,550059,0,0,7,7,
Oklahoma,U.S. Senate,Joan Farr,IND,550059,0,0,4,4,
Oklahoma,U.S. Senate,Connie Johnson,DEM,550059,0,0,126,126,
Oklahoma,U.S. Senate,James Lankford,REP,550059,0,0,756,756,
Oklahoma,U.S. Senate,Mark Beard,IND,550059,0,0,15,15,
Oklahoma,U.S. House,Al Mcaffrey,DEM,550059,0,0,118,118,05
Oklahoma,U.S. House,Steve Russell,REP,550059,0,0,753,753,05
Oklahoma,U.S. House,Buddy Ray,IND,550059,0,0,4,4,05
Oklahoma,U.S. House,Tom Boggs,IND,550059,0,0,7,7,05
Oklahoma,U.S. House,Robert Murphy,IND,550059,0,0,16,16,05
Oklahoma,Governor,Joe Dorman,DEM,550060,0,0,391,391,
Oklahoma,Governor,Mary Fallin,REP,550060,0,0,842,842,
Oklahoma,Governor,Kimberly Willis,IND,550060,0,0,24,24,
Oklahoma,Governor,Richard Prawdzienski,IND,550060,0,0,11,11,
Oklahoma,Lieutenant Governor,Cathy Cummings,DEM,550060,0,0,290,290,
Oklahoma,Lieutenant Governor,Todd Lamb,REP,550060,0,0,976,976,
Oklahoma,Superintendent of Public Instruction,John Cox,DEM,550060,0,0,407,407,
Oklahoma,Superintendent of Public Instruction,Joy Hofmeister,REP,550060,0,0,853,853,
Oklahoma,Commissioner of Labor,Mike Workman,DEM,550060,0,0,287,287,
Oklahoma,Commissioner of Labor,Mark Costello,REP,550060,0,0,952,952,
Oklahoma,U.S. Senate,Matt Silverstein,DEM,550060,0,0,276,276,
Oklahoma,U.S. Senate,Jim Inhofe,REP,550060,0,0,950,950,
Oklahoma,U.S. Senate,Aaron Delozier,IND,550060,0,0,7,7,
Oklahoma,U.S. Senate,Ray Woods,IND,550060,0,0,15,15,
Oklahoma,U.S. Senate,Joan Farr,IND,550060,0,0,16,16,
Oklahoma,U.S. Senate,Connie Johnson,DEM,550060,0,0,277,277,
Oklahoma,U.S. Senate,James Lankford,REP,550060,0,0,963,963,
Oklahoma,U.S. Senate,Mark Beard,IND,550060,0,0,29,29,
Oklahoma,U.S. House,Al Mcaffrey,DEM,550060,0,0,260,260,05
Oklahoma,U.S. House,Steve Russell,REP,550060,0,0,970,970,05
Oklahoma,U.S. House,Buddy Ray,IND,550060,0,0,10,10,05
Oklahoma,U.S. House,Tom Boggs,IND,550060,0,0,14,14,05
Oklahoma,U.S. House,Robert Murphy,IND,550060,0,0,10,10,05
Oklahoma,State House,Cecilia Taft,DEM,550060,0,0,317,317,96
Oklahoma,State House,Lewis Moore,REP,550060,0,0,921,921,96
Oklahoma,Governor,Joe Dorman,DEM,550061,0,0,333,333,
Oklahoma,Governor,Mary Fallin,REP,550061,0,0,798,798,
Oklahoma,Governor,Kimberly Willis,IND,550061,0,0,15,15,
Oklahoma,Governor,Richard Prawdzienski,IND,550061,0,0,7,7,
Oklahoma,Lieutenant Governor,Cathy Cummings,DEM,550061,0,0,234,234,
Oklahoma,Lieutenant Governor,Todd Lamb,REP,550061,0,0,916,916,
Oklahoma,Superintendent of Public Instruction,John Cox,DEM,550061,0,0,335,335,
Oklahoma,Superintendent of Public Instruction,Joy Hofmeister,REP,550061,0,0,805,805,
Oklahoma,Commissioner of Labor,Mike Workman,DEM,550061,0,0,239,239,
Oklahoma,Commissioner of Labor,Mark Costello,REP,550061,0,0,875,875,
Oklahoma,U.S. Senate,Matt Silverstein,DEM,550061,0,0,222,222,
Oklahoma,U.S. Senate,Jim Inhofe,REP,550061,0,0,901,901,
Oklahoma,U.S. Senate,Aaron Delozier,IND,550061,0,0,6,6,
Oklahoma,U.S. Senate,Ray Woods,IND,550061,0,0,10,10,
Oklahoma,U.S. Senate,Joan Farr,IND,550061,0,0,7,7,
Oklahoma,U.S. Senate,Connie Johnson,DEM,550061,0,0,217,217,
Oklahoma,U.S. Senate,James Lankford,REP,550061,0,0,916,916,
Oklahoma,U.S. Senate,Mark Beard,IND,550061,0,0,21,21,
Oklahoma,U.S. House,Al Mcaffrey,DEM,550061,0,0,215,215,05
Oklahoma,U.S. House,Steve Russell,REP,550061,0,0,905,905,05
Oklahoma,U.S. House,Buddy Ray,IND,550061,0,0,6,6,05
Oklahoma,U.S. House,Tom Boggs,IND,550061,0,0,11,11,05
Oklahoma,U.S. House,Robert Murphy,IND,550061,0,0,13,13,05
Oklahoma,Governor,Joe Dorman,DEM,550062,0,0,459,459,
Oklahoma,Governor,Mary Fallin,REP,550062,0,0,847,847,
Oklahoma,Governor,Kimberly Willis,IND,550062,0,0,20,20,
Oklahoma,Governor,Richard Prawdzienski,IND,550062,0,0,6,6,
Oklahoma,Lieutenant Governor,Cathy Cummings,DEM,550062,0,0,320,320,
Oklahoma,Lieutenant Governor,Todd Lamb,REP,550062,0,0,1013,1013,
Oklahoma,Superintendent of Public Instruction,John Cox,DEM,550062,0,0,488,488,
Oklahoma,Superintendent of Public Instruction,Joy Hofmeister,REP,550062,0,0,840,840,
Oklahoma,Commissioner of Labor,Mike Workman,DEM,550062,0,0,335,335,
Oklahoma,Commissioner of Labor,Mark Costello,REP,550062,0,0,965,965,
Oklahoma,U.S. Senate,Matt Silverstein,DEM,550062,0,0,327,327,
Oklahoma,U.S. Senate,Jim Inhofe,REP,550062,0,0,975,975,
Oklahoma,U.S. Senate,Aaron Delozier,IND,550062,0,0,5,5,
Oklahoma,U.S. Senate,Ray Woods,IND,550062,0,0,9,9,
Oklahoma,U.S. Senate,Joan Farr,IND,550062,0,0,11,11,
Oklahoma,U.S. Senate,Connie Johnson,DEM,550062,0,0,296,296,
Oklahoma,U.S. Senate,James Lankford,REP,550062,0,0,1015,1015,
Oklahoma,U.S. Senate,Mark Beard,IND,550062,0,0,24,24,
Oklahoma,U.S. House,Al Mcaffrey,DEM,550062,0,0,307,307,05
Oklahoma,U.S. House,Steve Russell,REP,550062,0,0,984,984,05
Oklahoma,U.S. House,Buddy Ray,IND,550062,0,0,10,10,05
Oklahoma,U.S. House,Tom Boggs,IND,550062,0,0,12,12,05
Oklahoma,U.S. House,Robert Murphy,IND,550062,0,0,9,9,05
Oklahoma,Governor,Joe Dorman,DEM,550063,0,0,116,116,
Oklahoma,Governor,Mary Fallin,REP,550063,0,0,319,319,
Oklahoma,Governor,Kimberly Willis,IND,550063,0,0,6,6,
Oklahoma,Governor,Richard Prawdzienski,IND,550063,0,0,2,2,
Oklahoma,Lieutenant Governor,Cathy Cummings,DEM,550063,0,0,90,90,
Oklahoma,Lieutenant Governor,Todd Lamb,REP,550063,0,0,351,351,
Oklahoma,Superintendent of Public Instruction,John Cox,DEM,550063,0,0,123,123,
Oklahoma,Superintendent of Public Instruction,Joy Hofmeister,REP,550063,0,0,316,316,
Oklahoma,Commissioner of Labor,Mike Workman,DEM,550063,0,0,91,91,
Oklahoma,Commissioner of Labor,Mark Costello,REP,550063,0,0,342,342,
Oklahoma,U.S. Senate,Matt Silverstein,DEM,550063,0,0,80,80,
Oklahoma,U.S. Senate,Jim Inhofe,REP,550063,0,0,349,349,
Oklahoma,U.S. Senate,Aaron Delozier,IND,550063,0,0,2,2,
Oklahoma,U.S. Senate,Ray Woods,IND,550063,0,0,4,4,
Oklahoma,U.S. Senate,Joan Farr,IND,550063,0,0,1,1,
Oklahoma,U.S. Senate,Connie Johnson,DEM,550063,0,0,80,80,
Oklahoma,U.S. Senate,James Lankford,REP,550063,0,0,354,354,
Oklahoma,U.S. Senate,Mark Beard,IND,550063,0,0,8,8,
Oklahoma,U.S. House,Al Mcaffrey,DEM,550063,0,0,86,86,05
Oklahoma,U.S. House,Steve Russell,REP,550063,0,0,346,346,05
Oklahoma,U.S. House,Buddy Ray,IND,550063,0,0,1,1,05
Oklahoma,U.S. House,Tom Boggs,IND,550063,0,0,5,5,05
Oklahoma,U.S. House,Robert Murphy,IND,550063,0,0,3,3,05
Oklahoma,State House,Cecilia Taft,DEM,550063,0,0,100,100,96
Oklahoma,State House,Lewis Moore,REP,550063,0,0,335,335,96
Oklahoma,Governor,Joe Dorman,DEM,550064,0,0,302,302,
Oklahoma,Governor,Mary Fallin,REP,550064,0,0,701,701,
Oklahoma,Governor,Kimberly Willis,IND,550064,0,0,10,10,
Oklahoma,Governor,Richard Prawdzienski,IND,550064,0,0,5,5,
Oklahoma,Lieutenant Governor,Cathy Cummings,DEM,550064,0,0,216,216,
Oklahoma,Lieutenant Governor,Todd Lamb,REP,550064,0,0,801,801,
Oklahoma,Superintendent of Public Instruction,John Cox,DEM,550064,0,0,327,327,
Oklahoma,Superintendent of Public Instruction,Joy Hofmeister,REP,550064,0,0,672,672,
Oklahoma,Commissioner of Labor,Mike Workman,DEM,550064,0,0,215,215,
Oklahoma,Commissioner of Labor,Mark Costello,REP,550064,0,0,776,776,
Oklahoma,U.S. Senate,Matt Silverstein,DEM,550064,0,0,202,202,
Oklahoma,U.S. Senate,Jim Inhofe,REP,550064,0,0,779,779,
Oklahoma,U.S. Senate,Aaron Delozier,IND,550064,0,0,11,11,
Oklahoma,U.S. Senate,Ray Woods,IND,550064,0,0,8,8,
Oklahoma,U.S. Senate,Joan Farr,IND,550064,0,0,10,10,
Oklahoma,U.S. Senate,Connie Johnson,DEM,550064,0,0,205,205,
Oklahoma,U.S. Senate,James Lankford,REP,550064,0,0,794,794,
Oklahoma,U.S. Senate,Mark Beard,IND,550064,0,0,18,18,
Oklahoma,U.S. House,Al Mcaffrey,DEM,550064,0,0,198,198,05
Oklahoma,U.S. House,Steve Russell,REP,550064,0,0,792,792,05
Oklahoma,U.S. House,Buddy Ray,IND,550064,0,0,7,7,05
Oklahoma,U.S. House,Tom Boggs,IND,550064,0,0,8,8,05
Oklahoma,U.S. House,Robert Murphy,IND,550064,0,0,13,13,05
Oklahoma,State House,Cecilia Taft,DEM,550064,0,0,226,226,96
Oklahoma,State House,Lewis Moore,REP,550064,0,0,770,770,96
Oklahoma,Governor,Joe Dorman,DEM,550065,0,0,228,228,
Oklahoma,Governor,Mary Fallin,REP,550065,0,0,357,357,
Oklahoma,Governor,Kimberly Willis,IND,550065,0,0,10,10,
Oklahoma,Governor,Richard Prawdzienski,IND,550065,0,0,3,3,
Oklahoma,Lieutenant Governor,Cathy Cummings,DEM,550065,0,0,179,179,
Oklahoma,Lieutenant Governor,Todd Lamb,REP,550065,0,0,416,416,
Oklahoma,Superintendent of Public Instruction,John Cox,DEM,550065,0,0,232,232,
Oklahoma,Superintendent of Public Instruction,Joy Hofmeister,REP,550065,0,0,359,359,
Oklahoma,Commissioner of Labor,Mike Workman,DEM,550065,0,0,176,176,
Oklahoma,Commissioner of Labor,Mark Costello,REP,550065,0,0,404,404,
Oklahoma,U.S. Senate,Matt Silverstein,DEM,550065,0,0,162,162,
Oklahoma,U.S. Senate,Jim Inhofe,REP,550065,0,0,415,415,
Oklahoma,U.S. Senate,Aaron Delozier,IND,550065,0,0,4,4,
Oklahoma,U.S. Senate,Ray Woods,IND,550065,0,0,6,6,
Oklahoma,U.S. Senate,Joan Farr,IND,550065,0,0,8,8,
Oklahoma,U.S. Senate,Connie Johnson,DEM,550065,0,0,170,170,
Oklahoma,U.S. Senate,James Lankford,REP,550065,0,0,413,413,
Oklahoma,U.S. Senate,Mark Beard,IND,550065,0,0,11,11,
Oklahoma,U.S. House,Al Mcaffrey,DEM,550065,0,0,156,156,05
Oklahoma,U.S. House,Steve Russell,REP,550065,0,0,418,418,05
Oklahoma,U.S. House,Buddy Ray,IND,550065,0,0,3,3,05
Oklahoma,U.S. House,Tom Boggs,IND,550065,0,0,5,5,05
Oklahoma,U.S. House,Robert Murphy,IND,550065,0,0,6,6,05
Oklahoma,State House,Cecilia Taft,DEM,550065,0,0,174,174,96
Oklahoma,State House,Lewis Moore,REP,550065,0,0,407,407,96
Oklahoma,Governor,Joe Dorman,DEM,550066,0,0,627,627,
Oklahoma,Governor,Mary Fallin,REP,550066,0,0,129,129,
Oklahoma,Governor,Kimberly Willis,IND,550066,0,0,9,9,
Oklahoma,Governor,Richard Prawdzienski,IND,550066,0,0,2,2,
Oklahoma,Lieutenant Governor,Cathy Cummings,DEM,550066,0,0,596,596,
Oklahoma,Lieutenant Governor,Todd Lamb,REP,550066,0,0,166,166,
Oklahoma,Superintendent of Public Instruction,John Cox,DEM,550066,0,0,633,633,
Oklahoma,Superintendent of Public Instruction,Joy Hofmeister,REP,550066,0,0,128,128,
Oklahoma,Commissioner of Labor,Mike Workman,DEM,550066,0,0,613,613,
Oklahoma,Commissioner of Labor,Mark Costello,REP,550066,0,0,140,140,
Oklahoma,U.S. Senate,Matt Silverstein,DEM,550066,0,0,561,561,
Oklahoma,U.S. Senate,Jim Inhofe,REP,550066,0,0,167,167,
Oklahoma,U.S. Senate,Aaron Delozier,IND,550066,0,0,4,4,
Oklahoma,U.S. Senate,Ray Woods,IND,550066,0,0,12,12,
Oklahoma,U.S. Senate,Joan Farr,IND,550066,0,0,14,14,
Oklahoma,U.S. Senate,Connie Johnson,DEM,550066,0,0,617,617,
Oklahoma,U.S. Senate,James Lankford,REP,550066,0,0,145,145,
Oklahoma,U.S. Senate,Mark Beard,IND,550066,0,0,8,8,
Oklahoma,U.S. House,Al Mcaffrey,DEM,550066,0,0,593,593,05
Oklahoma,U.S. House,Steve Russell,REP,550066,0,0,152,152,05
Oklahoma,U.S. House,Buddy Ray,IND,550066,0,0,5,5,05
Oklahoma,U.S. House,Tom Boggs,IND,550066,0,0,7,7,05
Oklahoma,U.S. House,Robert Murphy,IND,550066,0,0,10,10,05
Oklahoma,State Senate,Anastasia Pittman,DEM,550066,0,0,637,637,48
Oklahoma,State Senate,Duane Crumbacher,REP,550066,0,0,127,127,48
Oklahoma,State House,Mike Shelton,DEM,550066,0,0,652,652,97
Oklahoma,State House,Tonni Canaday,REP,550066,0,0,115,115,97
Oklahoma,Governor,Joe Dorman,DEM,550067,0,0,229,229,
Oklahoma,Governor,Mary Fallin,REP,550067,0,0,454,454,
Oklahoma,Governor,Kimberly Willis,IND,550067,0,0,15,15,
Oklahoma,Governor,Richard Prawdzienski,IND,550067,0,0,7,7,
Oklahoma,Lieutenant Governor,Cathy Cummings,DEM,550067,0,0,174,174,
Oklahoma,Lieutenant Governor,Todd Lamb,REP,550067,0,0,527,527,
Oklahoma,Superintendent of Public Instruction,John Cox,DEM,550067,0,0,252,252,
Oklahoma,Superintendent of Public Instruction,Joy Hofmeister,REP,550067,0,0,448,448,
Oklahoma,Commissioner of Labor,Mike Workman,DEM,550067,0,0,200,200,
Oklahoma,Commissioner of Labor,Mark Costello,REP,550067,0,0,481,481,
Oklahoma,U.S. Senate,Matt Silverstein,DEM,550067,0,0,134,134,
Oklahoma,U.S. Senate,Jim Inhofe,REP,550067,0,0,536,536,
Oklahoma,U.S. Senate,Aaron Delozier,IND,550067,0,0,6,6,
Oklahoma,U.S. Senate,Ray Woods,IND,550067,0,0,13,13,
Oklahoma,U.S. Senate,Joan Farr,IND,550067,0,0,8,8,
Oklahoma,U.S. Senate,Connie Johnson,DEM,550067,0,0,138,138,
Oklahoma,U.S. Senate,James Lankford,REP,550067,0,0,552,552,
Oklahoma,U.S. Senate,Mark Beard,IND,550067,0,0,15,15,
Oklahoma,U.S. House,Al Mcaffrey,DEM,550067,0,0,131,131,05
Oklahoma,U.S. House,Steve Russell,REP,550067,0,0,542,542,05
Oklahoma,U.S. House,Buddy Ray,IND,550067,0,0,4,4,05
Oklahoma,U.S. House,Tom Boggs,IND,550067,0,0,12,12,05
Oklahoma,U.S. House,Robert Murphy,IND,550067,0,0,9,9,05
Oklahoma,Governor,Joe Dorman,DEM,550068,0,0,126,126,
Oklahoma,Governor,Mary Fallin,REP,550068,0,0,332,332,
Oklahoma,Governor,Kimberly Willis,IND,550068,0,0,6,6,
Oklahoma,Governor,Richard Prawdzienski,IND,550068,0,0,10,10,
Oklahoma,Lieutenant Governor,Cathy Cummings,DEM,550068,0,0,86,86,
Oklahoma,Lieutenant Governor,Todd Lamb,REP,550068,0,0,386,386,
Oklahoma,Superintendent of Public Instruction,John Cox,DEM,550068,0,0,154,154,
Oklahoma,Superintendent of Public Instruction,Joy Hofmeister,REP,550068,0,0,321,321,
Oklahoma,Commissioner of Labor,Mike Workman,DEM,550068,0,0,108,108,
Oklahoma,Commissioner of Labor,Mark Costello,REP,550068,0,0,348,348,
Oklahoma,U.S. Senate,Matt Silverstein,DEM,550068,0,0,78,78,
Oklahoma,U.S. Senate,Jim Inhofe,REP,550068,0,0,383,383,
Oklahoma,U.S. Senate,Aaron Delozier,IND,550068,0,0,4,4,
Oklahoma,U.S. Senate,Ray Woods,IND,550068,0,0,2,2,
Oklahoma,U.S. Senate,Joan Farr,IND,550068,0,0,4,4,
Oklahoma,U.S. Senate,Connie Johnson,DEM,550068,0,0,74,74,
Oklahoma,U.S. Senate,James Lankford,REP,550068,0,0,390,390,
Oklahoma,U.S. Senate,Mark Beard,IND,550068,0,0,8,8,
Oklahoma,U.S. House,Al Mcaffrey,DEM,550068,0,0,78,78,05
Oklahoma,U.S. House,Steve Russell,REP,550068,0,0,374,374,05
Oklahoma,U.S. House,Buddy Ray,IND,550068,0,0,5,5,05
Oklahoma,U.S. House,Tom Boggs,IND,550068,0,0,5,5,05
Oklahoma,U.S. House,Robert Murphy,IND,550068,0,0,7,7,05
Oklahoma,State House,Cecilia Taft,DEM,550068,0,0,102,102,96
Oklahoma,State House,Lewis Moore,REP,550068,0,0,360,360,96
Oklahoma,Governor,Joe Dorman,DEM,550069,0,0,176,176,
Oklahoma,Governor,Mary Fallin,REP,550069,0,0,368,368,
Oklahoma,Governor,Kimberly Willis,IND,550069,0,0,17,17,
Oklahoma,Governor,Richard Prawdzienski,IND,550069,0,0,9,9,
Oklahoma,Lieutenant Governor,Cathy Cummings,DEM,550069,0,0,126,126,
Oklahoma,Lieutenant Governor,Todd Lamb,REP,550069,0,0,445,445,
Oklahoma,Superintendent of Public Instruction,John Cox,DEM,550069,0,0,224,224,
Oklahoma,Superintendent of Public Instruction,Joy Hofmeister,REP,550069,0,0,343,343,
Oklahoma,Commissioner of Labor,Mike Workman,DEM,550069,0,0,147,147,
Oklahoma,Commissioner of Labor,Mark Costello,REP,550069,0,0,417,417,
Oklahoma,U.S. Senate,Matt Silverstein,DEM,550069,0,0,107,107,
Oklahoma,U.S. Senate,Jim Inhofe,REP,550069,0,0,439,439,
Oklahoma,U.S. Senate,Aaron Delozier,IND,550069,0,0,5,5,
Oklahoma,U.S. Senate,Ray Woods,IND,550069,0,0,7,7,
Oklahoma,U.S. Senate,Joan Farr,IND,550069,0,0,11,11,
Oklahoma,U.S. Senate,Connie Johnson,DEM,550069,0,0,105,105,
Oklahoma,U.S. Senate,James Lankford,REP,550069,0,0,454,454,
Oklahoma,U.S. Senate,Mark Beard,IND,550069,0,0,12,12,
Oklahoma,U.S. House,Al Mcaffrey,DEM,550069,0,0,101,101,05
Oklahoma,U.S. House,Steve Russell,REP,550069,0,0,444,444,05
Oklahoma,U.S. House,Buddy Ray,IND,550069,0,0,6,6,05
Oklahoma,U.S. House,Tom Boggs,IND,550069,0,0,10,10,05
Oklahoma,U.S. House,Robert Murphy,IND,550069,0,0,6,6,05
Oklahoma,State House,Cecilia Taft,DEM,550069,0,0,135,135,96
Oklahoma,State House,Lewis Moore,REP,550069,0,0,426,426,96
Oklahoma,Governor,Joe Dorman,DEM,550070,0,0,162,162,
Oklahoma,Governor,Mary Fallin,REP,550070,0,0,352,352,
Oklahoma,Governor,Kimberly Willis,IND,550070,0,0,6,6,
Oklahoma,Governor,Richard Prawdzienski,IND,550070,0,0,3,3,
Oklahoma,Lieutenant Governor,Cathy Cummings,DEM,550070,0,0,119,119,
Oklahoma,Lieutenant Governor,Todd Lamb,REP,550070,0,0,404,404,
Oklahoma,Superintendent of Public Instruction,John Cox,DEM,550070,0,0,202,202,
Oklahoma,Superintendent of Public Instruction,Joy Hofmeister,REP,550070,0,0,320,320,
Oklahoma,Commissioner of Labor,Mike Workman,DEM,550070,0,0,144,144,
Oklahoma,Commissioner of Labor,Mark Costello,REP,550070,0,0,365,365,
Oklahoma,U.S. Senate,Matt Silverstein,DEM,550070,0,0,107,107,
Oklahoma,U.S. Senate,Jim Inhofe,REP,550070,0,0,402,402,
Oklahoma,U.S. Senate,Aaron Delozier,IND,550070,0,0,3,3,
Oklahoma,U.S. Senate,Ray Woods,IND,550070,0,0,4,4,
Oklahoma,U.S. Senate,Joan Farr,IND,550070,0,0,3,3,
Oklahoma,U.S. Senate,Connie Johnson,DEM,550070,0,0,103,103,
Oklahoma,U.S. Senate,James Lankford,REP,550070,0,0,410,410,
Oklahoma,U.S. Senate,Mark Beard,IND,550070,0,0,12,12,
Oklahoma,U.S. House,Al Mcaffrey,DEM,550070,0,0,111,111,05
Oklahoma,U.S. House,Steve Russell,REP,550070,0,0,391,391,05
Oklahoma,U.S. House,Buddy Ray,IND,550070,0,0,3,3,05
Oklahoma,U.S. House,Tom Boggs,IND,550070,0,0,5,5,05
Oklahoma,U.S. House,Robert Murphy,IND,550070,0,0,8,8,05
Oklahoma,State House,Cecilia Taft,DEM,550070,0,0,138,138,96
Oklahoma,State House,Lewis Moore,REP,550070,0,0,373,373,96
Oklahoma,Governor,Joe Dorman,DEM,550071,0,0,214,214,
Oklahoma,Governor,Mary Fallin,REP,550071,0,0,463,463,
Oklahoma,Governor,Kimberly Willis,IND,550071,0,0,22,22,
Oklahoma,Governor,Richard Prawdzienski,IND,550071,0,0,10,10,
Oklahoma,Lieutenant Governor,Cathy Cummings,DEM,550071,0,0,169,169,
Oklahoma,Lieutenant Governor,Todd Lamb,REP,550071,0,0,540,540,
Oklahoma,Superintendent of Public Instruction,John Cox,DEM,550071,0,0,255,255,
Oklahoma,Superintendent of Public Instruction,Joy Hofmeister,REP,550071,0,0,446,446,
Oklahoma,Commissioner of Labor,Mike Workman,DEM,550071,0,0,199,199,
Oklahoma,Commissioner of Labor,Mark Costello,REP,550071,0,0,492,492,
Oklahoma,U.S. Senate,Matt Silverstein,DEM,550071,0,0,129,129,
Oklahoma,U.S. Senate,Jim Inhofe,REP,550071,0,0,542,542,
Oklahoma,U.S. Senate,Aaron Delozier,IND,550071,0,0,6,6,
Oklahoma,U.S. Senate,Ray Woods,IND,550071,0,0,10,10,
Oklahoma,U.S. Senate,Joan Farr,IND,550071,0,0,17,17,
Oklahoma,U.S. Senate,Connie Johnson,DEM,550071,0,0,127,127,
Oklahoma,U.S. Senate,James Lankford,REP,550071,0,0,561,561,
Oklahoma,U.S. Senate,Mark Beard,IND,550071,0,0,19,19,
Oklahoma,U.S. House,Al Mcaffrey,DEM,550071,0,0,120,120,05
Oklahoma,U.S. House,Steve Russell,REP,550071,0,0,552,552,05
Oklahoma,U.S. House,Buddy Ray,IND,550071,0,0,8,8,05
Oklahoma,U.S. House,Tom Boggs,IND,550071,0,0,15,15,05
Oklahoma,U.S. House,Robert Murphy,IND,550071,0,0,8,8,05
Oklahoma,State House,Cecilia Taft,DEM,550071,0,0,193,193,96
Oklahoma,State House,Lewis Moore,REP,550071,0,0,495,495,96
Oklahoma,Governor,Joe Dorman,DEM,550072,0,0,160,160,
Oklahoma,Governor,Mary Fallin,REP,550072,0,0,279,279,
Oklahoma,Governor,Kimberly Willis,IND,550072,0,0,14,14,
Oklahoma,Governor,Richard Prawdzienski,IND,550072,0,0,11,11,
Oklahoma,Lieutenant Governor,Cathy Cummings,DEM,550072,0,0,107,107,
Oklahoma,Lieutenant Governor,Todd Lamb,REP,550072,0,0,350,350,
Oklahoma,Superintendent of Public Instruction,John Cox,DEM,550072,0,0,180,180,
Oklahoma,Superintendent of Public Instruction,Joy Hofmeister,REP,550072,0,0,280,280,
Oklahoma,Commissioner of Labor,Mike Workman,DEM,550072,0,0,135,135,
Oklahoma,Commissioner of Labor,Mark Costello,REP,550072,0,0,310,310,
Oklahoma,U.S. Senate,Matt Silverstein,DEM,550072,0,0,92,92,
Oklahoma,U.S. Senate,Jim Inhofe,REP,550072,0,0,345,345,
Oklahoma,U.S. Senate,Aaron Delozier,IND,550072,0,0,6,6,
Oklahoma,U.S. Senate,Ray Woods,IND,550072,0,0,8,8,
Oklahoma,U.S. Senate,Joan Farr,IND,550072,0,0,6,6,
Oklahoma,U.S. Senate,Connie Johnson,DEM,550072,0,0,100,100,
Oklahoma,U.S. Senate,James Lankford,REP,550072,0,0,349,349,
Oklahoma,U.S. Senate,Mark Beard,IND,550072,0,0,11,11,
Oklahoma,U.S. House,Al Mcaffrey,DEM,550072,0,0,102,102,05
Oklahoma,U.S. House,Steve Russell,REP,550072,0,0,329,329,05
Oklahoma,U.S. House,Buddy Ray,IND,550072,0,0,6,6,05
Oklahoma,U.S. House,Tom Boggs,IND,550072,0,0,11,11,05
Oklahoma,U.S. House,Robert Murphy,IND,550072,0,0,6,6,05
Oklahoma,State House,Cecilia Taft,DEM,550072,0,0,132,132,96
Oklahoma,State House,Lewis Moore,REP,550072,0,0,308,308,96
Oklahoma,Governor,Joe Dorman,DEM,550073,0,0,45,45,
Oklahoma,Governor,Mary Fallin,REP,550073,0,0,95,95,
Oklahoma,Governor,Kimberly Willis,IND,550073,0,0,6,6,
Oklahoma,Governor,Richard Prawdzienski,IND,550073,0,0,2,2,
Oklahoma,Lieutenant Governor,Cathy Cummings,DEM,550073,0,0,26,26,
Oklahoma,Lieutenant Governor,Todd Lamb,REP,550073,0,0,124,124,
Oklahoma,Superintendent of Public Instruction,John Cox,DEM,550073,0,0,53,53,
Oklahoma,Superintendent of Public Instruction,Joy Hofmeister,REP,550073,0,0,97,97,
Oklahoma,Commissioner of Labor,Mike Workman,DEM,550073,0,0,39,39,
Oklahoma,Commissioner of Labor,Mark Costello,REP,550073,0,0,109,109,
Oklahoma,U.S. Senate,Matt Silverstein,DEM,550073,0,0,19,19,
Oklahoma,U.S. Senate,Jim Inhofe,REP,550073,0,0,121,121,
Oklahoma,U.S. Senate,Aaron Delozier,IND,550073,0,0,3,3,
Oklahoma,U.S. Senate,Ray Woods,IND,550073,0,0,2,2,
Oklahoma,U.S. Senate,Joan Farr,IND,550073,0,0,2,2,
Oklahoma,U.S. Senate,Connie Johnson,DEM,550073,0,0,22,22,
Oklahoma,U.S. Senate,James Lankford,REP,550073,0,0,123,123,
Oklahoma,U.S. Senate,Mark Beard,IND,550073,0,0,5,5,
Oklahoma,U.S. House,Al Mcaffrey,DEM,550073,0,0,20,20,05
Oklahoma,U.S. House,Steve Russell,REP,550073,0,0,119,119,05
Oklahoma,U.S. House,Buddy Ray,IND,550073,0,0,2,2,05
Oklahoma,U.S. House,Tom Boggs,IND,550073,0,0,6,6,05
Oklahoma,U.S. House,Robert Murphy,IND,550073,0,0,3,3,05
Oklahoma,State House,Mike Shelton,DEM,550073,0,0,51,51,97
Oklahoma,State House,Tonni Canaday,REP,550073,0,0,95,95,97
Oklahoma,Governor,Joe Dorman,DEM,550074,0,0,158,158,
Oklahoma,Governor,Mary Fallin,REP,550074,0,0,24,24,
Oklahoma,Governor,Kimberly Willis,IND,550074,0,0,6,6,
Oklahoma,Governor,Richard Prawdzienski,IND,550074,0,0,1,1,
Oklahoma,Lieutenant Governor,Cathy Cummings,DEM,550074,0,0,156,156,
Oklahoma,Lieutenant Governor,Todd Lamb,REP,550074,0,0,33,33,
Oklahoma,Superintendent of Public Instruction,John Cox,DEM,550074,0,0,159,159,
Oklahoma,Superintendent of Public Instruction,Joy Hofmeister,REP,550074,0,0,30,30,
Oklahoma,Commissioner of Labor,Mike Workman,DEM,550074,0,0,156,156,
Oklahoma,Commissioner of Labor,Mark Costello,REP,550074,0,0,29,29,
Oklahoma,U.S. Senate,Matt Silverstein,DEM,550074,0,0,149,149,
Oklahoma,U.S. Senate,Jim Inhofe,REP,550074,0,0,35,35,
Oklahoma,U.S. Senate,Aaron Delozier,IND,550074,0,0,2,2,
Oklahoma,U.S. Senate,Ray Woods,IND,550074,0,0,2,2,
Oklahoma,U.S. Senate,Joan Farr,IND,550074,0,0,0,0,
Oklahoma,U.S. Senate,Connie Johnson,DEM,550074,0,0,153,153,
Oklahoma,U.S. Senate,James Lankford,REP,550074,0,0,31,31,
Oklahoma,U.S. Senate,Mark Beard,IND,550074,0,0,5,5,
Oklahoma,U.S. House,Al Mcaffrey,DEM,550074,0,0,150,150,05
Oklahoma,U.S. House,Steve Russell,REP,550074,0,0,32,32,05
Oklahoma,U.S. House,Buddy Ray,IND,550074,0,0,2,2,05
Oklahoma,U.S. House,Tom Boggs,IND,550074,0,0,1,1,05
Oklahoma,U.S. House,Robert Murphy,IND,550074,0,0,2,2,05
Oklahoma,State Senate,Anastasia Pittman,DEM,550074,0,0,163,163,48
Oklahoma,State Senate,Duane Crumbacher,REP,550074,0,0,25,25,48
Oklahoma,State House,Mike Shelton,DEM,550074,0,0,160,160,97
Oklahoma,State House,Tonni Canaday,REP,550074,0,0,28,28,97
Oklahoma,Governor,Joe Dorman,DEM,550075,0,0,516,516,
Oklahoma,Governor,Mary Fallin,REP,550075,0,0,88,88,
Oklahoma,Governor,Kimberly Willis,IND,550075,0,0,11,11,
Oklahoma,Governor,Richard Prawdzienski,IND,550075,0,0,4,4,
Oklahoma,Lieutenant Governor,Cathy Cummings,DEM,550075,0,0,483,483,
Oklahoma,Lieutenant Governor,Todd Lamb,REP,550075,0,0,133,133,
Oklahoma,Superintendent of Public Instruction,John Cox,DEM,550075,0,0,511,511,
Oklahoma,Superintendent of Public Instruction,Joy Hofmeister,REP,550075,0,0,105,105,
Oklahoma,Commissioner of Labor,Mike Workman,DEM,550075,0,0,502,502,
Oklahoma,Commissioner of Labor,Mark Costello,REP,550075,0,0,112,112,
Oklahoma,U.S. Senate,Matt Silverstein,DEM,550075,0,0,467,467,
Oklahoma,U.S. Senate,Jim Inhofe,REP,550075,0,0,135,135,
Oklahoma,U.S. Senate,Aaron Delozier,IND,550075,0,0,4,4,
Oklahoma,U.S. Senate,Ray Woods,IND,550075,0,0,7,7,
Oklahoma,U.S. Senate,Joan Farr,IND,550075,0,0,5,5,
Oklahoma,U.S. Senate,Connie Johnson,DEM,550075,0,0,486,486,
Oklahoma,U.S. Senate,James Lankford,REP,550075,0,0,127,127,
Oklahoma,U.S. Senate,Mark Beard,IND,550075,0,0,3,3,
Oklahoma,U.S. House,Al Mcaffrey,DEM,550075,0,0,482,482,05
Oklahoma,U.S. House,Steve Russell,REP,550075,0,0,108,108,05
Oklahoma,U.S. House,Buddy Ray,IND,550075,0,0,4,4,05
Oklahoma,U.S. House,Tom Boggs,IND,550075,0,0,12,12,05
Oklahoma,U.S. House,Robert Murphy,IND,550075,0,0,5,5,05
Oklahoma,State Senate,Anastasia Pittman,DEM,550075,0,0,515,515,48
Oklahoma,State Senate,Duane Crumbacher,REP,550075,0,0,98,98,48
Oklahoma,State House,Mike Shelton,DEM,550075,0,0,520,520,97
Oklahoma,State House,Tonni Canaday,REP,550075,0,0,91,91,97
Oklahoma,Governor,Joe Dorman,DEM,550076,0,0,211,211,
Oklahoma,Governor,Mary Fallin,REP,550076,0,0,282,282,
Oklahoma,Governor,Kimberly Willis,IND,550076,0,0,15,15,
Oklahoma,Governor,Richard Prawdzienski,IND,550076,0,0,8,8,
Oklahoma,Lieutenant Governor,Cathy Cummings,DEM,550076,0,0,165,165,
Oklahoma,Lieutenant Governor,Todd Lamb,REP,550076,0,0,352,352,
Oklahoma,Superintendent of Public Instruction,John Cox,DEM,550076,0,0,223,223,
Oklahoma,Superintendent of Public Instruction,Joy Hofmeister,REP,550076,0,0,293,293,
Oklahoma,Commissioner of Labor,Mike Workman,DEM,550076,0,0,182,182,
Oklahoma,Commissioner of Labor,Mark Costello,REP,550076,0,0,323,323,
Oklahoma,U.S. Senate,Matt Silverstein,DEM,550076,0,0,144,144,
Oklahoma,U.S. Senate,Jim Inhofe,REP,550076,0,0,347,347,
Oklahoma,U.S. Senate,Aaron Delozier,IND,550076,0,0,9,9,
Oklahoma,U.S. Senate,Ray Woods,IND,550076,0,0,10,10,
Oklahoma,U.S. Senate,Joan Farr,IND,550076,0,0,6,6,
Oklahoma,U.S. Senate,Connie Johnson,DEM,550076,0,0,153,153,
Oklahoma,U.S. Senate,James Lankford,REP,550076,0,0,350,350,
Oklahoma,U.S. Senate,Mark Beard,IND,550076,0,0,14,14,
Oklahoma,U.S. House,Al Mcaffrey,DEM,550076,0,0,139,139,05
Oklahoma,U.S. House,Steve Russell,REP,550076,0,0,350,350,05
Oklahoma,U.S. House,Buddy Ray,IND,550076,0,0,7,7,05
Oklahoma,U.S. House,Tom Boggs,IND,550076,0,0,15,15,05
Oklahoma,U.S. House,Robert Murphy,IND,550076,0,0,6,6,05
Oklahoma,State House,Cecilia Taft,DEM,550076,0,0,181,181,96
Oklahoma,State House,Lewis Moore,REP,550076,0,0,329,329,96
Oklahoma,Governor,Joe Dorman,DEM,550077,0,0,513,513,
Oklahoma,Governor,Mary Fallin,REP,550077,0,0,158,158,
Oklahoma,Governor,Kimberly Willis,IND,550077,0,0,16,16,
Oklahoma,Governor,Richard Prawdzienski,IND,550077,0,0,5,5,
Oklahoma,Lieutenant Governor,Cathy Cummings,DEM,550077,0,0,490,490,
Oklahoma,Lieutenant Governor,Todd Lamb,REP,550077,0,0,197,197,
Oklahoma,Superintendent of Public Instruction,John Cox,DEM,550077,0,0,520,520,
Oklahoma,Superintendent of Public Instruction,Joy Hofmeister,REP,550077,0,0,171,171,
Oklahoma,Commissioner of Labor,Mike Workman,DEM,550077,0,0,516,516,
Oklahoma,Commissioner of Labor,Mark Costello,REP,550077,0,0,166,166,
Oklahoma,U.S. Senate,Matt Silverstein,DEM,550077,0,0,461,461,
Oklahoma,U.S. Senate,Jim Inhofe,REP,550077,0,0,194,194,
Oklahoma,U.S. Senate,Aaron Delozier,IND,550077,0,0,10,10,
Oklahoma,U.S. Senate,Ray Woods,IND,550077,0,0,11,11,
Oklahoma,U.S. Senate,Joan Farr,IND,550077,0,0,14,14,
Oklahoma,U.S. Senate,Connie Johnson,DEM,550077,0,0,491,491,
Oklahoma,U.S. Senate,James Lankford,REP,550077,0,0,184,184,
Oklahoma,U.S. Senate,Mark Beard,IND,550077,0,0,16,16,
Oklahoma,U.S. House,Al Mcaffrey,DEM,550077,0,0,475,475,05
Oklahoma,U.S. House,Steve Russell,REP,550077,0,0,177,177,05
Oklahoma,U.S. House,Buddy Ray,IND,550077,0,0,12,12,05
Oklahoma,U.S. House,Tom Boggs,IND,550077,0,0,13,13,05
Oklahoma,U.S. House,Robert Murphy,IND,550077,0,0,9,9,05
Oklahoma,State Senate,Anastasia Pittman,DEM,550077,0,0,522,522,48
Oklahoma,State Senate,Duane Crumbacher,REP,550077,0,0,157,157,48
Oklahoma,State House,Mike Shelton,DEM,550077,0,0,514,514,97
Oklahoma,State House,Tonni Canaday,REP,550077,0,0,172,172,97
Oklahoma,Governor,Joe Dorman,DEM,550078,0,0,363,363,
Oklahoma,Governor,Mary Fallin,REP,550078,0,0,83,83,
Oklahoma,Governor,Kimberly Willis,IND,550078,0,0,13,13,
Oklahoma,Governor,Richard Prawdzienski,IND,550078,0,0,6,6,
Oklahoma,Lieutenant Governor,Cathy Cummings,DEM,550078,0,0,351,351,
Oklahoma,Lieutenant Governor,Todd Lamb,REP,550078,0,0,111,111,
Oklahoma,Superintendent of Public Instruction,John Cox,DEM,550078,0,0,369,369,
Oklahoma,Superintendent of Public Instruction,Joy Hofmeister,REP,550078,0,0,93,93,
Oklahoma,Commissioner of Labor,Mike Workman,DEM,550078,0,0,366,366,
Oklahoma,Commissioner of Labor,Mark Costello,REP,550078,0,0,94,94,
Oklahoma,U.S. Senate,Matt Silverstein,DEM,550078,0,0,330,330,
Oklahoma,U.S. Senate,Jim Inhofe,REP,550078,0,0,115,115,
Oklahoma,U.S. Senate,Aaron Delozier,IND,550078,0,0,6,6,
Oklahoma,U.S. Senate,Ray Woods,IND,550078,0,0,7,7,
Oklahoma,U.S. Senate,Joan Farr,IND,550078,0,0,5,5,
Oklahoma,U.S. Senate,Connie Johnson,DEM,550078,0,0,360,360,
Oklahoma,U.S. Senate,James Lankford,REP,550078,0,0,98,98,
Oklahoma,U.S. Senate,Mark Beard,IND,550078,0,0,7,7,
Oklahoma,U.S. House,Al Mcaffrey,DEM,550078,0,0,346,346,05
Oklahoma,U.S. House,Steve Russell,REP,550078,0,0,101,101,05
Oklahoma,U.S. House,Buddy Ray,IND,550078,0,0,4,4,05
Oklahoma,U.S. House,Tom Boggs,IND,550078,0,0,5,5,05
Oklahoma,U.S. House,Robert Murphy,IND,550078,0,0,7,7,05
Oklahoma,State Senate,Anastasia Pittman,DEM,550078,0,0,374,374,48
Oklahoma,State Senate,Duane Crumbacher,REP,550078,0,0,89,89,48
Oklahoma,State House,Mike Shelton,DEM,550078,0,0,369,369,97
Oklahoma,State House,Tonni Canaday,REP,550078,0,0,94,94,97
Oklahoma,Governor,Joe Dorman,DEM,550079,0,0,467,467,
Oklahoma,Governor,Mary Fallin,REP,550079,0,0,107,107,
Oklahoma,Governor,Kimberly Willis,IND,550079,0,0,8,8,
Oklahoma,Governor,Richard Prawdzienski,IND,550079,0,0,5,5,
Oklahoma,Lieutenant Governor,Cathy Cummings,DEM,550079,0,0,455,455,
Oklahoma,Lieutenant Governor,Todd Lamb,REP,550079,0,0,130,130,
Oklahoma,Superintendent of Public Instruction,John Cox,DEM,550079,0,0,458,458,
Oklahoma,Superintendent of Public Instruction,Joy Hofmeister,REP,550079,0,0,126,126,
Oklahoma,Commissioner of Labor,Mike Workman,DEM,550079,0,0,460,460,
Oklahoma,Commissioner of Labor,Mark Costello,REP,550079,0,0,118,118,
Oklahoma,U.S. Senate,Matt Silverstein,DEM,550079,0,0,434,434,
Oklahoma,U.S. Senate,Jim Inhofe,REP,550079,0,0,134,134,
Oklahoma,U.S. Senate,Aaron Delozier,IND,550079,0,0,4,4,
Oklahoma,U.S. Senate,Ray Woods,IND,550079,0,0,5,5,
Oklahoma,U.S. Senate,Joan Farr,IND,550079,0,0,7,7,
Oklahoma,U.S. Senate,Connie Johnson,DEM,550079,0,0,455,455,
Oklahoma,U.S. Senate,James Lankford,REP,550079,0,0,123,123,
Oklahoma,U.S. Senate,Mark Beard,IND,550079,0,0,7,7,
Oklahoma,U.S. House,Al Mcaffrey,DEM,550079,0,0,440,440,05
Oklahoma,U.S. House,Steve Russell,REP,550079,0,0,128,128,05
Oklahoma,U.S. House,Buddy Ray,IND,550079,0,0,5,5,05
Oklahoma,U.S. House,Tom Boggs,IND,550079,0,0,4,4,05
Oklahoma,U.S. House,Robert Murphy,IND,550079,0,0,6,6,05
Oklahoma,State Senate,Anastasia Pittman,DEM,550079,0,0,474,474,48
Oklahoma,State Senate,Duane Crumbacher,REP,550079,0,0,106,106,48
Oklahoma,State House,Mike Shelton,DEM,550079,0,0,481,481,97
Oklahoma,State House,Tonni Canaday,REP,550079,0,0,99,99,97
Oklahoma,Governor,Joe Dorman,DEM,550080,0,0,454,454,
Oklahoma,Governor,Mary Fallin,REP,550080,0,0,565,565,
Oklahoma,Governor,Kimberly Willis,IND,550080,0,0,20,20,
Oklahoma,Governor,Richard Prawdzienski,IND,550080,0,0,7,7,
Oklahoma,Lieutenant Governor,Cathy Cummings,DEM,550080,0,0,357,357,
Oklahoma,Lieutenant Governor,Todd Lamb,REP,550080,0,0,683,683,
Oklahoma,Superintendent of Public Instruction,John Cox,DEM,550080,0,0,494,494,
Oklahoma,Superintendent of Public Instruction,Joy Hofmeister,REP,550080,0,0,545,545,
Oklahoma,Commissioner of Labor,Mike Workman,DEM,550080,0,0,393,393,
Oklahoma,Commissioner of Labor,Mark Costello,REP,550080,0,0,620,620,
Oklahoma,U.S. Senate,Matt Silverstein,DEM,550080,0,0,327,327,
Oklahoma,U.S. Senate,Jim Inhofe,REP,550080,0,0,689,689,
Oklahoma,U.S. Senate,Aaron Delozier,IND,550080,0,0,5,5,
Oklahoma,U.S. Senate,Ray Woods,IND,550080,0,0,10,10,
Oklahoma,U.S. Senate,Joan Farr,IND,550080,0,0,12,12,
Oklahoma,U.S. Senate,Connie Johnson,DEM,550080,0,0,342,342,
Oklahoma,U.S. Senate,James Lankford,REP,550080,0,0,679,679,
Oklahoma,U.S. Senate,Mark Beard,IND,550080,0,0,26,26,
Oklahoma,U.S. House,Bert Smith,DEM,550080,0,0,298,298,04
Oklahoma,U.S. House,Tom Cole,REP,550080,0,0,702,702,04
Oklahoma,U.S. House,Dennis Johnson,IND,550080,0,0,43,43,04
Oklahoma,State Senate,Hiawatha Jr.,DEM,550080,0,0,312,312,42
Oklahoma,State Senate,Jack Fry,REP,550080,0,0,649,649,42
Oklahoma,State Senate,Charles Thompson,IND,550080,0,0,74,74,42
Oklahoma,State House,Mark Deshazo,DEM,550080,0,0,341,341,95
Oklahoma,State House,Charlie Joyner,REP,550080,0,0,689,689,95
Oklahoma,Governor,Joe Dorman,DEM,550081,0,0,233,233,
Oklahoma,Governor,Mary Fallin,REP,550081,0,0,259,259,
Oklahoma,Governor,Kimberly Willis,IND,550081,0,0,8,8,
Oklahoma,Governor,Richard Prawdzienski,IND,550081,0,0,5,5,
Oklahoma,Lieutenant Governor,Cathy Cummings,DEM,550081,0,0,200,200,
Oklahoma,Lieutenant Governor,Todd Lamb,REP,550081,0,0,302,302,
Oklahoma,Superintendent of Public Instruction,John Cox,DEM,550081,0,0,237,237,
Oklahoma,Superintendent of Public Instruction,Joy Hofmeister,REP,550081,0,0,261,261,
Oklahoma,Commissioner of Labor,Mike Workman,DEM,550081,0,0,222,222,
Oklahoma,Commissioner of Labor,Mark Costello,REP,550081,0,0,267,267,
Oklahoma,U.S. Senate,Matt Silverstein,DEM,550081,0,0,168,168,
Oklahoma,U.S. Senate,Jim Inhofe,REP,550081,0,0,311,311,
Oklahoma,U.S. Senate,Aaron Delozier,IND,550081,0,0,5,5,
Oklahoma,U.S. Senate,Ray Woods,IND,550081,0,0,8,8,
Oklahoma,U.S. Senate,Joan Farr,IND,550081,0,0,11,11,
Oklahoma,U.S. Senate,Connie Johnson,DEM,550081,0,0,171,171,
Oklahoma,U.S. Senate,James Lankford,REP,550081,0,0,314,314,
Oklahoma,U.S. Senate,Mark Beard,IND,550081,0,0,16,16,
Oklahoma,U.S. House,Bert Smith,DEM,550081,0,0,151,151,04
Oklahoma,U.S. House,Tom Cole,REP,550081,0,0,318,318,04
Oklahoma,U.S. House,Dennis Johnson,IND,550081,0,0,32,32,04
Oklahoma,State Senate,Hiawatha Jr.,DEM,550081,0,0,165,165,42
Oklahoma,State Senate,Jack Fry,REP,550081,0,0,282,282,42
Oklahoma,State Senate,Charles Thompson,IND,550081,0,0,49,49,42
Oklahoma,State House,Mark Deshazo,DEM,550081,0,0,196,196,95
Oklahoma,State House,Charlie Joyner,REP,550081,0,0,303,303,95
Oklahoma,Governor,Joe Dorman,DEM,550082,0,0,101,101,
Oklahoma,Governor,Mary Fallin,REP,550082,0,0,132,132,
Oklahoma,Governor,Kimberly Willis,IND,550082,0,0,7,7,
Oklahoma,Governor,Richard Prawdzienski,IND,550082,0,0,4,4,
Oklahoma,Lieutenant Governor,Cathy Cummings,DEM,550082,0,0,97,97,
Oklahoma,Lieutenant Governor,Todd Lamb,REP,550082,0,0,146,146,
Oklahoma,Superintendent of Public Instruction,John Cox,DEM,550082,0,0,124,124,
Oklahoma,Superintendent of Public Instruction,Joy Hofmeister,REP,550082,0,0,117,117,
Oklahoma,Commissioner of Labor,Mike Workman,DEM,550082,0,0,100,100,
Oklahoma,Commissioner of Labor,Mark Costello,REP,550082,0,0,135,135,
Oklahoma,U.S. Senate,Matt Silverstein,DEM,550082,0,0,78,78,
Oklahoma,U.S. Senate,Jim Inhofe,REP,550082,0,0,147,147,
Oklahoma,U.S. Senate,Aaron Delozier,IND,550082,0,0,1,1,
Oklahoma,U.S. Senate,Ray Woods,IND,550082,0,0,10,10,
Oklahoma,U.S. Senate,Joan Farr,IND,550082,0,0,5,5,
Oklahoma,U.S. Senate,Connie Johnson,DEM,550082,0,0,91,91,
Oklahoma,U.S. Senate,James Lankford,REP,550082,0,0,148,148,
Oklahoma,U.S. Senate,Mark Beard,IND,550082,0,0,5,5,
Oklahoma,U.S. House,Bert Smith,DEM,550082,0,0,78,78,04
Oklahoma,U.S. House,Tom Cole,REP,550082,0,0,150,150,04
Oklahoma,U.S. House,Dennis Johnson,IND,550082,0,0,15,15,04
Oklahoma,State Senate,Hiawatha Jr.,DEM,550082,0,0,85,85,42
Oklahoma,State Senate,Jack Fry,REP,550082,0,0,137,137,42
Oklahoma,State Senate,Charles Thompson,IND,550082,0,0,19,19,42
Oklahoma,State House,Mark Deshazo,DEM,550082,0,0,91,91,95
Oklahoma,State House,Charlie Joyner,REP,550082,0,0,149,149,95
Oklahoma,Governor,Joe Dorman,DEM,550083,0,0,268,268,
Oklahoma,Governor,Mary Fallin,REP,550083,0,0,260,260,
Oklahoma,Governor,Kimberly Willis,IND,550083,0,0,27,27,
Oklahoma,Governor,Richard Prawdzienski,IND,550083,0,0,23,23,
Oklahoma,Lieutenant Governor,Cathy Cummings,DEM,550083,0,0,245,245,
Oklahoma,Lieutenant Governor,Todd Lamb,REP,550083,0,0,326,326,
Oklahoma,Superintendent of Public Instruction,John Cox,DEM,550083,0,0,280,280,
Oklahoma,Superintendent of Public Instruction,Joy Hofmeister,REP,550083,0,0,285,285,
Oklahoma,Commissioner of Labor,Mike Workman,DEM,550083,0,0,240,240,
Oklahoma,Commissioner of Labor,Mark Costello,REP,550083,0,0,318,318,
Oklahoma,U.S. Senate,Matt Silverstein,DEM,550083,0,0,203,203,
Oklahoma,U.S. Senate,Jim Inhofe,REP,550083,0,0,319,319,
Oklahoma,U.S. Senate,Aaron Delozier,IND,550083,0,0,11,11,
Oklahoma,U.S. Senate,Ray Woods,IND,550083,0,0,19,19,
Oklahoma,U.S. Senate,Joan Farr,IND,550083,0,0,21,21,
Oklahoma,U.S. Senate,Connie Johnson,DEM,550083,0,0,216,216,
Oklahoma,U.S. Senate,James Lankford,REP,550083,0,0,319,319,
Oklahoma,U.S. Senate,Mark Beard,IND,550083,0,0,39,39,
Oklahoma,U.S. House,Bert Smith,DEM,550083,0,0,179,179,04
Oklahoma,U.S. House,Tom Cole,REP,550083,0,0,333,333,04
Oklahoma,U.S. House,Dennis Johnson,IND,550083,0,0,61,61,04
Oklahoma,State Senate,Hiawatha Jr.,DEM,550083,0,0,185,185,42
Oklahoma,State Senate,Jack Fry,REP,550083,0,0,306,306,42
Oklahoma,State Senate,Charles Thompson,IND,550083,0,0,78,78,42
Oklahoma,State House,Mark Deshazo,DEM,550083,0,0,238,238,95
Oklahoma,State House,Charlie Joyner,REP,550083,0,0,322,322,95
Oklahoma,Governor,Joe Dorman,DEM,550084,0,0,234,234,
Oklahoma,Governor,Mary Fallin,REP,550084,0,0,198,198,
Oklahoma,Governor,Kimberly Willis,IND,550084,0,0,9,9,
Oklahoma,Governor,Richard Prawdzienski,IND,550084,0,0,6,6,
Oklahoma,Lieutenant Governor,Cathy Cummings,DEM,550084,0,0,188,188,
Oklahoma,Lieutenant Governor,Todd Lamb,REP,550084,0,0,259,259,
Oklahoma,Superintendent of Public Instruction,John Cox,DEM,550084,0,0,242,242,
Oklahoma,Superintendent of Public Instruction,Joy Hofmeister,REP,550084,0,0,205,205,
Oklahoma,Commissioner of Labor,Mike Workman,DEM,550084,0,0,203,203,
Oklahoma,Commissioner of Labor,Mark Costello,REP,550084,0,0,238,238,
Oklahoma,U.S. Senate,Matt Silverstein,DEM,550084,0,0,171,171,
Oklahoma,U.S. Senate,Jim Inhofe,REP,550084,0,0,255,255,
Oklahoma,U.S. Senate,Aaron Delozier,IND,550084,0,0,6,6,
Oklahoma,U.S. Senate,Ray Woods,IND,550084,0,0,7,7,
Oklahoma,U.S. Senate,Joan Farr,IND,550084,0,0,4,4,
Oklahoma,U.S. Senate,Connie Johnson,DEM,550084,0,0,184,184,
Oklahoma,U.S. Senate,James Lankford,REP,550084,0,0,245,245,
Oklahoma,U.S. Senate,Mark Beard,IND,550084,0,0,18,18,
Oklahoma,U.S. House,Bert Smith,DEM,550084,0,0,163,163,04
Oklahoma,U.S. House,Tom Cole,REP,550084,0,0,246,246,04
Oklahoma,U.S. House,Dennis Johnson,IND,550084,0,0,37,37,04
Oklahoma,State Senate,Hiawatha Jr.,DEM,550084,0,0,164,164,42
Oklahoma,State Senate,Jack Fry,REP,550084,0,0,240,240,42
Oklahoma,State Senate,Charles Thompson,IND,550084,0,0,41,41,42
Oklahoma,State House,Mark Deshazo,DEM,550084,0,0,189,189,95
Oklahoma,State House,Charlie Joyner,REP,550084,0,0,253,253,95
Oklahoma,Governor,Joe Dorman,DEM,550085,0,0,307,307,
Oklahoma,Governor,Mary Fallin,REP,550085,0,0,323,323,
Oklahoma,Governor,Kimberly Willis,IND,550085,0,0,19,19,
Oklahoma,Governor,Richard Prawdzienski,IND,550085,0,0,13,13,
Oklahoma,Lieutenant Governor,Cathy Cummings,DEM,550085,0,0,263,263,
Oklahoma,Lieutenant Governor,Todd Lamb,REP,550085,0,0,394,394,
Oklahoma,Superintendent of Public Instruction,John Cox,DEM,550085,0,0,330,330,
Oklahoma,Superintendent of Public Instruction,Joy Hofmeister,REP,550085,0,0,321,321,
Oklahoma,Commissioner of Labor,Mike Workman,DEM,550085,0,0,277,277,
Oklahoma,Commissioner of Labor,Mark Costello,REP,550085,0,0,366,366,
Oklahoma,U.S. Senate,Matt Silverstein,DEM,550085,0,0,220,220,
Oklahoma,U.S. Senate,Jim Inhofe,REP,550085,0,0,413,413,
Oklahoma,U.S. Senate,Aaron Delozier,IND,550085,0,0,7,7,
Oklahoma,U.S. Senate,Ray Woods,IND,550085,0,0,10,10,
Oklahoma,U.S. Senate,Joan Farr,IND,550085,0,0,7,7,
Oklahoma,U.S. Senate,Connie Johnson,DEM,550085,0,0,234,234,
Oklahoma,U.S. Senate,James Lankford,REP,550085,0,0,412,412,
Oklahoma,U.S. Senate,Mark Beard,IND,550085,0,0,17,17,
Oklahoma,U.S. House,Bert Smith,DEM,550085,0,0,217,217,04
Oklahoma,U.S. House,Tom Cole,REP,550085,0,0,423,423,04
Oklahoma,U.S. House,Dennis Johnson,IND,550085,0,0,20,20,04
Oklahoma,State Senate,Hiawatha Jr.,DEM,550085,0,0,207,207,42
Oklahoma,State Senate,Jack Fry,REP,550085,0,0,388,388,42
Oklahoma,State Senate,Charles Thompson,IND,550085,0,0,58,58,42
Oklahoma,State House,Mark Deshazo,DEM,550085,0,0,251,251,95
Oklahoma,State House,Charlie Joyner,REP,550085,0,0,404,404,95
Oklahoma,Governor,Joe Dorman,DEM,550086,0,0,386,386,
Oklahoma,Governor,Mary Fallin,REP,550086,0,0,459,459,
Oklahoma,Governor,Kimberly Willis,IND,550086,0,0,19,19,
Oklahoma,Governor,Richard Prawdzienski,IND,550086,0,0,9,9,
Oklahoma,Lieutenant Governor,Cathy Cummings,DEM,550086,0,0,316,316,
Oklahoma,Lieutenant Governor,Todd Lamb,REP,550086,0,0,552,552,
Oklahoma,Superintendent of Public Instruction,John Cox,DEM,550086,0,0,420,420,
Oklahoma,Superintendent of Public Instruction,Joy Hofmeister,REP,550086,0,0,440,440,
Oklahoma,Commissioner of Labor,Mike Workman,DEM,550086,0,0,333,333,
Oklahoma,Commissioner of Labor,Mark Costello,REP,550086,0,0,511,511,
Oklahoma,U.S. Senate,Matt Silverstein,DEM,550086,0,0,279,279,
Oklahoma,U.S. Senate,Jim Inhofe,REP,550086,0,0,554,554,
Oklahoma,U.S. Senate,Aaron Delozier,IND,550086,0,0,8,8,
Oklahoma,U.S. Senate,Ray Woods,IND,550086,0,0,11,11,
Oklahoma,U.S. Senate,Joan Farr,IND,550086,0,0,14,14,
Oklahoma,U.S. Senate,Connie Johnson,DEM,550086,0,0,297,297,
Oklahoma,U.S. Senate,James Lankford,REP,550086,0,0,552,552,
Oklahoma,U.S. Senate,Mark Beard,IND,550086,0,0,21,21,
Oklahoma,U.S. House,Bert Smith,DEM,550086,0,0,263,263,04
Oklahoma,U.S. House,Tom Cole,REP,550086,0,0,561,561,04
Oklahoma,U.S. House,Dennis Johnson,IND,550086,0,0,42,42,04
Oklahoma,State Senate,Hiawatha Jr.,DEM,550086,0,0,267,267,42
Oklahoma,State Senate,Jack Fry,REP,550086,0,0,522,522,42
Oklahoma,State Senate,Charles Thompson,IND,550086,0,0,75,75,42
Oklahoma,State House,Mark Deshazo,DEM,550086,0,0,294,294,95
Oklahoma,State House,Charlie Joyner,REP,550086,0,0,569,569,95
Oklahoma,Governor,Joe Dorman,DEM,550087,0,0,203,203,
Oklahoma,Governor,Mary Fallin,REP,550087,0,0,96,96,
Oklahoma,Governor,Kimberly Willis,IND,550087,0,0,8,8,
Oklahoma,Governor,Richard Prawdzienski,IND,550087,0,0,6,6,
Oklahoma,Lieutenant Governor,Cathy Cummings,DEM,550087,0,0,182,182,
Oklahoma,Lieutenant Governor,Todd Lamb,REP,550087,0,0,128,128,
Oklahoma,Superintendent of Public Instruction,John Cox,DEM,550087,0,0,201,201,
Oklahoma,Superintendent of Public Instruction,Joy Hofmeister,REP,550087,0,0,110,110,
Oklahoma,Commissioner of Labor,Mike Workman,DEM,550087,0,0,188,188,
Oklahoma,Commissioner of Labor,Mark Costello,REP,550087,0,0,121,121,
Oklahoma,U.S. Senate,Matt Silverstein,DEM,550087,0,0,159,159,
Oklahoma,U.S. Senate,Jim Inhofe,REP,550087,0,0,131,131,
Oklahoma,U.S. Senate,Aaron Delozier,IND,550087,0,0,5,5,
Oklahoma,U.S. Senate,Ray Woods,IND,550087,0,0,8,8,
Oklahoma,U.S. Senate,Joan Farr,IND,550087,0,0,7,7,
Oklahoma,U.S. Senate,Connie Johnson,DEM,550087,0,0,169,169,
Oklahoma,U.S. Senate,James Lankford,REP,550087,0,0,132,132,
Oklahoma,U.S. Senate,Mark Beard,IND,550087,0,0,10,10,
Oklahoma,U.S. House,Bert Smith,DEM,550087,0,0,162,162,04
Oklahoma,U.S. House,Tom Cole,REP,550087,0,0,126,126,04
Oklahoma,U.S. House,Dennis Johnson,IND,550087,0,0,23,23,04
Oklahoma,State Senate,Hiawatha Jr.,DEM,550087,0,0,179,179,42
Oklahoma,State Senate,Jack Fry,REP,550087,0,0,111,111,42
Oklahoma,State Senate,Charles Thompson,IND,550087,0,0,20,20,42
Oklahoma,State House,Mark Deshazo,DEM,550087,0,0,179,179,95
Oklahoma,State House,Charlie Joyner,REP,550087,0,0,129,129,95
Oklahoma,Governor,Joe Dorman,DEM,550088,0,0,166,166,
Oklahoma,Governor,Mary Fallin,REP,550088,0,0,65,65,
Oklahoma,Governor,Kimberly Willis,IND,550088,0,0,5,5,
Oklahoma,Governor,Richard Prawdzienski,IND,550088,0,0,5,5,
Oklahoma,Lieutenant Governor,Cathy Cummings,DEM,550088,0,0,157,157,
Oklahoma,Lieutenant Governor,Todd Lamb,REP,550088,0,0,81,81,
Oklahoma,Superintendent of Public Instruction,John Cox,DEM,550088,0,0,165,165,
Oklahoma,Superintendent of Public Instruction,Joy Hofmeister,REP,550088,0,0,74,74,
Oklahoma,Commissioner of Labor,Mike Workman,DEM,550088,0,0,159,159,
Oklahoma,Commissioner of Labor,Mark Costello,REP,550088,0,0,74,74,
Oklahoma,U.S. Senate,Matt Silverstein,DEM,550088,0,0,146,146,
Oklahoma,U.S. Senate,Jim Inhofe,REP,550088,0,0,82,82,
Oklahoma,U.S. Senate,Aaron Delozier,IND,550088,0,0,1,1,
Oklahoma,U.S. Senate,Ray Woods,IND,550088,0,0,5,5,
Oklahoma,U.S. Senate,Joan Farr,IND,550088,0,0,5,5,
Oklahoma,U.S. Senate,Connie Johnson,DEM,550088,0,0,151,151,
Oklahoma,U.S. Senate,James Lankford,REP,550088,0,0,76,76,
Oklahoma,U.S. Senate,Mark Beard,IND,550088,0,0,12,12,
Oklahoma,U.S. House,Bert Smith,DEM,550088,0,0,143,143,04
Oklahoma,U.S. House,Tom Cole,REP,550088,0,0,84,84,04
Oklahoma,U.S. House,Dennis Johnson,IND,550088,0,0,12,12,04
Oklahoma,State Senate,Hiawatha Jr.,DEM,550088,0,0,155,155,42
Oklahoma,State Senate,Jack Fry,REP,550088,0,0,73,73,42
Oklahoma,State Senate,Charles Thompson,IND,550088,0,0,11,11,42
Oklahoma,Governor,Joe Dorman,DEM,550089,0,0,341,341,
Oklahoma,Governor,Mary Fallin,REP,550089,0,0,93,93,
Oklahoma,Governor,Kimberly Willis,IND,550089,0,0,4,4,
Oklahoma,Governor,Richard Prawdzienski,IND,550089,0,0,1,1,
Oklahoma,Lieutenant Governor,Cathy Cummings,DEM,550089,0,0,320,320,
Oklahoma,Lieutenant Governor,Todd Lamb,REP,550089,0,0,118,118,
Oklahoma,Superintendent of Public Instruction,John Cox,DEM,550089,0,0,337,337,
Oklahoma,Superintendent of Public Instruction,Joy Hofmeister,REP,550089,0,0,97,97,
Oklahoma,Commissioner of Labor,Mike Workman,DEM,550089,0,0,331,331,
Oklahoma,Commissioner of Labor,Mark Costello,REP,550089,0,0,100,100,
Oklahoma,U.S. Senate,Matt Silverstein,DEM,550089,0,0,298,298,
Oklahoma,U.S. Senate,Jim Inhofe,REP,550089,0,0,124,124,
Oklahoma,U.S. Senate,Aaron Delozier,IND,550089,0,0,2,2,
Oklahoma,U.S. Senate,Ray Woods,IND,550089,0,0,3,3,
Oklahoma,U.S. Senate,Joan Farr,IND,550089,0,0,5,5,
Oklahoma,U.S. Senate,Connie Johnson,DEM,550089,0,0,313,313,
Oklahoma,U.S. Senate,James Lankford,REP,550089,0,0,117,117,
Oklahoma,U.S. Senate,Mark Beard,IND,550089,0,0,7,7,
Oklahoma,U.S. House,Al Mcaffrey,DEM,550089,0,0,314,314,05
Oklahoma,U.S. House,Steve Russell,REP,550089,0,0,110,110,05
Oklahoma,U.S. House,Buddy Ray,IND,550089,0,0,1,1,05
Oklahoma,U.S. House,Tom Boggs,IND,550089,0,0,2,2,05
Oklahoma,U.S. House,Robert Murphy,IND,550089,0,0,6,6,05
Oklahoma,State Senate,Anastasia Pittman,DEM,550089,0,0,339,339,48
Oklahoma,State Senate,Duane Crumbacher,REP,550089,0,0,93,93,48
Oklahoma,State House,Mike Shelton,DEM,550089,0,0,342,342,97
Oklahoma,State House,Tonni Canaday,REP,550089,0,0,91,91,97
Oklahoma,Governor,Joe Dorman,DEM,550090,0,0,63,63,
Oklahoma,Governor,Mary Fallin,REP,550090,0,0,25,25,
Oklahoma,Governor,Kimberly Willis,IND,550090,0,0,3,3,
Oklahoma,Governor,Richard Prawdzienski,IND,550090,0,0,1,1,
Oklahoma,Lieutenant Governor,Cathy Cummings,DEM,550090,0,0,64,64,
Oklahoma,Lieutenant Governor,Todd Lamb,REP,550090,0,0,28,28,
Oklahoma,Superintendent of Public Instruction,John Cox,DEM,550090,0,0,65,65,
Oklahoma,Superintendent of Public Instruction,Joy Hofmeister,REP,550090,0,0,27,27,
Oklahoma,Commissioner of Labor,Mike Workman,DEM,550090,0,0,65,65,
Oklahoma,Commissioner of Labor,Mark Costello,REP,550090,0,0,24,24,
Oklahoma,U.S. Senate,Matt Silverstein,DEM,550090,0,0,55,55,
Oklahoma,U.S. Senate,Jim Inhofe,REP,550090,0,0,34,34,
Oklahoma,U.S. Senate,Aaron Delozier,IND,550090,0,0,0,0,
Oklahoma,U.S. Senate,Ray Woods,IND,550090,0,0,2,2,
Oklahoma,U.S. Senate,Joan Farr,IND,550090,0,0,1,1,
Oklahoma,U.S. Senate,Connie Johnson,DEM,550090,0,0,56,56,
Oklahoma,U.S. Senate,James Lankford,REP,550090,0,0,29,29,
Oklahoma,U.S. Senate,Mark Beard,IND,550090,0,0,6,6,
Oklahoma,U.S. House,Al Mcaffrey,DEM,550090,0,0,57,57,05
Oklahoma,U.S. House,Steve Russell,REP,550090,0,0,29,29,05
Oklahoma,U.S. House,Buddy Ray,IND,550090,0,0,1,1,05
Oklahoma,U.S. House,Tom Boggs,IND,550090,0,0,2,2,05
Oklahoma,U.S. House,Robert Murphy,IND,550090,0,0,2,2,05
Oklahoma,State Senate,Anastasia Pittman,DEM,550090,0,0,71,71,48
Oklahoma,State Senate,Duane Crumbacher,REP,550090,0,0,21,21,48
Oklahoma,Governor,Joe Dorman,DEM,550091,0,0,57,57,
Oklahoma,Governor,Mary Fallin,REP,550091,0,0,45,45,
Oklahoma,Governor,Kimberly Willis,IND,550091,0,0,2,2,
Oklahoma,Governor,Richard Prawdzienski,IND,550091,0,0,0,0,
Oklahoma,Lieutenant Governor,Cathy Cummings,DEM,550091,0,0,50,50,
Oklahoma,Lieutenant Governor,Todd Lamb,REP,550091,0,0,54,54,
Oklahoma,Superintendent of Public Instruction,John Cox,DEM,550091,0,0,61,61,
Oklahoma,Superintendent of Public Instruction,Joy Hofmeister,REP,550091,0,0,43,43,
Oklahoma,Commissioner of Labor,Mike Workman,DEM,550091,0,0,55,55,
Oklahoma,Commissioner of Labor,Mark Costello,REP,550091,0,0,49,49,
Oklahoma,U.S. Senate,Matt Silverstein,DEM,550091,0,0,44,44,
Oklahoma,U.S. Senate,Jim Inhofe,REP,550091,0,0,57,57,
Oklahoma,U.S. Senate,Aaron Delozier,IND,550091,0,0,1,1,
Oklahoma,U.S. Senate,Ray Woods,IND,550091,0,0,1,1,
Oklahoma,U.S. Senate,Joan Farr,IND,550091,0,0,1,1,
Oklahoma,U.S. Senate,Connie Johnson,DEM,550091,0,0,50,50,
Oklahoma,U.S. Senate,James Lankford,REP,550091,0,0,51,51,
Oklahoma,U.S. Senate,Mark Beard,IND,550091,0,0,3,3,
Oklahoma,U.S. House,Bert Smith,DEM,550091,0,0,44,44,04
Oklahoma,U.S. House,Tom Cole,REP,550091,0,0,55,55,04
Oklahoma,U.S. House,Dennis Johnson,IND,550091,0,0,5,5,04
Oklahoma,State Senate,Anastasia Pittman,DEM,550091,0,0,55,55,48
Oklahoma,State Senate,Duane Crumbacher,REP,550091,0,0,49,49,48
Oklahoma,Governor,Joe Dorman,DEM,550092,0,0,522,522,
Oklahoma,Governor,Mary Fallin,REP,550092,0,0,390,390,
Oklahoma,Governor,Kimberly Willis,IND,550092,0,0,18,18,
Oklahoma,Governor,Richard Prawdzienski,IND,550092,0,0,6,6,
Oklahoma,Lieutenant Governor,Cathy Cummings,DEM,550092,0,0,453,453,
Oklahoma,Lieutenant Governor,Todd Lamb,REP,550092,0,0,481,481,
Oklahoma,Superintendent of Public Instruction,John Cox,DEM,550092,0,0,536,536,
Oklahoma,Superintendent of Public Instruction,Joy Hofmeister,REP,550092,0,0,398,398,
Oklahoma,Commissioner of Labor,Mike Workman,DEM,550092,0,0,487,487,
Oklahoma,Commissioner of Labor,Mark Costello,REP,550092,0,0,429,429,
Oklahoma,U.S. Senate,Matt Silverstein,DEM,550092,0,0,397,397,
Oklahoma,U.S. Senate,Jim Inhofe,REP,550092,0,0,490,490,
Oklahoma,U.S. Senate,Aaron Delozier,IND,550092,0,0,11,11,
Oklahoma,U.S. Senate,Ray Woods,IND,550092,0,0,18,18,
Oklahoma,U.S. Senate,Joan Farr,IND,550092,0,0,16,16,
Oklahoma,U.S. Senate,Connie Johnson,DEM,550092,0,0,430,430,
Oklahoma,U.S. Senate,James Lankford,REP,550092,0,0,479,479,
Oklahoma,U.S. Senate,Mark Beard,IND,550092,0,0,25,25,
Oklahoma,U.S. House,Bert Smith,DEM,550092,0,0,390,390,04
Oklahoma,U.S. House,Tom Cole,REP,550092,0,0,501,501,04
Oklahoma,U.S. House,Dennis Johnson,IND,550092,0,0,42,42,04
Oklahoma,State Senate,Hiawatha Jr.,DEM,550092,0,0,403,403,42
Oklahoma,State Senate,Jack Fry,REP,550092,0,0,461,461,42
Oklahoma,State Senate,Charles Thompson,IND,550092,0,0,67,67,42
Oklahoma,Governor,Joe Dorman,DEM,550093,0,0,166,166,
Oklahoma,Governor,Mary Fallin,REP,550093,0,0,286,286,
Oklahoma,Governor,Kimberly Willis,IND,550093,0,0,7,7,
Oklahoma,Governor,Richard Prawdzienski,IND,550093,0,0,2,2,
Oklahoma,Lieutenant Governor,Cathy Cummings,DEM,550093,0,0,115,115,
Oklahoma,Lieutenant Governor,Todd Lamb,REP,550093,0,0,345,345,
Oklahoma,Superintendent of Public Instruction,John Cox,DEM,550093,0,0,189,189,
Oklahoma,Superintendent of Public Instruction,Joy Hofmeister,REP,550093,0,0,268,268,
Oklahoma,Commissioner of Labor,Mike Workman,DEM,550093,0,0,125,125,
Oklahoma,Commissioner of Labor,Mark Costello,REP,550093,0,0,320,320,
Oklahoma,U.S. Senate,Matt Silverstein,DEM,550093,0,0,107,107,
Oklahoma,U.S. Senate,Jim Inhofe,REP,550093,0,0,348,348,
Oklahoma,U.S. Senate,Aaron Delozier,IND,550093,0,0,1,1,
Oklahoma,U.S. Senate,Ray Woods,IND,550093,0,0,4,4,
Oklahoma,U.S. Senate,Joan Farr,IND,550093,0,0,1,1,
Oklahoma,U.S. Senate,Connie Johnson,DEM,550093,0,0,104,104,
Oklahoma,U.S. Senate,James Lankford,REP,550093,0,0,349,349,
Oklahoma,U.S. Senate,Mark Beard,IND,550093,0,0,8,8,
Oklahoma,U.S. House,Bert Smith,DEM,550093,0,0,94,94,04
Oklahoma,U.S. House,Tom Cole,REP,550093,0,0,359,359,04
Oklahoma,U.S. House,Dennis Johnson,IND,550093,0,0,8,8,04
Oklahoma,Governor,Joe Dorman,DEM,550094,0,0,282,282,
Oklahoma,Governor,Mary Fallin,REP,550094,0,0,411,411,
Oklahoma,Governor,Kimberly Willis,IND,550094,0,0,21,21,
Oklahoma,Governor,Richard Prawdzienski,IND,550094,0,0,9,9,
Oklahoma,Lieutenant Governor,Cathy Cummings,DEM,550094,0,0,215,215,
Oklahoma,Lieutenant Governor,Todd Lamb,REP,550094,0,0,504,504,
Oklahoma,Superintendent of Public Instruction,John Cox,DEM,550094,0,0,299,299,
Oklahoma,Superintendent of Public Instruction,Joy Hofmeister,REP,550094,0,0,419,419,
Oklahoma,Commissioner of Labor,Mike Workman,DEM,550094,0,0,256,256,
Oklahoma,Commissioner of Labor,Mark Costello,REP,550094,0,0,450,450,
Oklahoma,U.S. Senate,Matt Silverstein,DEM,550094,0,0,185,185,
Oklahoma,U.S. Senate,Jim Inhofe,REP,550094,0,0,490,490,
Oklahoma,U.S. Senate,Aaron Delozier,IND,550094,0,0,5,5,
Oklahoma,U.S. Senate,Ray Woods,IND,550094,0,0,16,16,
Oklahoma,U.S. Senate,Joan Farr,IND,550094,0,0,20,20,
Oklahoma,U.S. Senate,Connie Johnson,DEM,550094,0,0,201,201,
Oklahoma,U.S. Senate,James Lankford,REP,550094,0,0,489,489,
Oklahoma,U.S. Senate,Mark Beard,IND,550094,0,0,29,29,
Oklahoma,U.S. House,Bert Smith,DEM,550094,0,0,180,180,04
Oklahoma,U.S. House,Tom Cole,REP,550094,0,0,504,504,04
Oklahoma,U.S. House,Dennis Johnson,IND,550094,0,0,33,33,04
Oklahoma,State Senate,Hiawatha Jr.,DEM,550094,0,0,178,178,42
Oklahoma,State Senate,Jack Fry,REP,550094,0,0,478,478,42
Oklahoma,State Senate,Charles Thompson,IND,550094,0,0,58,58,42
Oklahoma,Governor,Joe Dorman,DEM,550095,0,0,254,254,
Oklahoma,Governor,Mary Fallin,REP,550095,0,0,325,325,
Oklahoma,Governor,Kimberly Willis,IND,550095,0,0,8,8,
Oklahoma,Governor,Richard Prawdzienski,IND,550095,0,0,4,4,
Oklahoma,Lieutenant Governor,Cathy Cummings,DEM,550095,0,0,190,190,
Oklahoma,Lieutenant Governor,Todd Lamb,REP,550095,0,0,401,401,
Oklahoma,Superintendent of Public Instruction,John Cox,DEM,550095,0,0,279,279,
Oklahoma,Superintendent of Public Instruction,Joy Hofmeister,REP,550095,0,0,309,309,
Oklahoma,Commissioner of Labor,Mike Workman,DEM,550095,0,0,202,202,
Oklahoma,Commissioner of Labor,Mark Costello,REP,550095,0,0,356,356,
Oklahoma,U.S. Senate,Matt Silverstein,DEM,550095,0,0,177,177,
Oklahoma,U.S. Senate,Jim Inhofe,REP,550095,0,0,401,401,
Oklahoma,U.S. Senate,Aaron Delozier,IND,550095,0,0,0,0,
Oklahoma,U.S. Senate,Ray Woods,IND,550095,0,0,3,3,
Oklahoma,U.S. Senate,Joan Farr,IND,550095,0,0,9,9,
Oklahoma,U.S. Senate,Connie Johnson,DEM,550095,0,0,167,167,
Oklahoma,U.S. Senate,James Lankford,REP,550095,0,0,416,416,
Oklahoma,U.S. Senate,Mark Beard,IND,550095,0,0,12,12,
Oklahoma,U.S. House,Bert Smith,DEM,550095,0,0,150,150,04
Oklahoma,U.S. House,Tom Cole,REP,550095,0,0,416,416,04
Oklahoma,U.S. House,Dennis Johnson,IND,550095,0,0,25,25,04
Oklahoma,State Senate,Hiawatha Jr.,DEM,550095,0,0,146,146,42
Oklahoma,State Senate,Jack Fry,REP,550095,0,0,406,406,42
Oklahoma,State Senate,Charles Thompson,IND,550095,0,0,36,36,42
Oklahoma,Governor,Joe Dorman,DEM,550096,0,0,304,304,
Oklahoma,Governor,Mary Fallin,REP,550096,0,0,374,374,
Oklahoma,Governor,Kimberly Willis,IND,550096,0,0,15,15,
Oklahoma,Governor,Richard Prawdzienski,IND,550096,0,0,12,12,
Oklahoma,Lieutenant Governor,Cathy Cummings,DEM,550096,0,0,265,265,
Oklahoma,Lieutenant Governor,Todd Lamb,REP,550096,0,0,441,441,
Oklahoma,Superintendent of Public Instruction,John Cox,DEM,550096,0,0,325,325,
Oklahoma,Superintendent of Public Instruction,Joy Hofmeister,REP,550096,0,0,374,374,
Oklahoma,Commissioner of Labor,Mike Workman,DEM,550096,0,0,272,272,
Oklahoma,Commissioner of Labor,Mark Costello,REP,550096,0,0,418,418,
Oklahoma,U.S. Senate,Matt Silverstein,DEM,550096,0,0,227,227,
Oklahoma,U.S. Senate,Jim Inhofe,REP,550096,0,0,442,442,
Oklahoma,U.S. Senate,Aaron Delozier,IND,550096,0,0,4,4,
Oklahoma,U.S. Senate,Ray Woods,IND,550096,0,0,17,17,
Oklahoma,U.S. Senate,Joan Farr,IND,550096,0,0,11,11,
Oklahoma,U.S. Senate,Connie Johnson,DEM,550096,0,0,246,246,
Oklahoma,U.S. Senate,James Lankford,REP,550096,0,0,442,442,
Oklahoma,U.S. Senate,Mark Beard,IND,550096,0,0,19,19,
Oklahoma,U.S. House,Bert Smith,DEM,550096,0,0,215,215,04
Oklahoma,U.S. House,Tom Cole,REP,550096,0,0,456,456,04
Oklahoma,U.S. House,Dennis Johnson,IND,550096,0,0,31,31,04
Oklahoma,State Senate,Hiawatha Jr.,DEM,550096,0,0,201,201,42
Oklahoma,State Senate,Jack Fry,REP,550096,0,0,441,441,42
Oklahoma,State Senate,Charles Thompson,IND,550096,0,0,56,56,42
Oklahoma,Governor,Joe Dorman,DEM,550097,0,0,239,239,
Oklahoma,Governor,Mary Fallin,REP,550097,0,0,264,264,
Oklahoma,Governor,Kimberly Willis,IND,550097,0,0,8,8,
Oklahoma,Governor,Richard Prawdzienski,IND,550097,0,0,4,4,
Oklahoma,Lieutenant Governor,Cathy Cummings,DEM,550097,0,0,178,178,
Oklahoma,Lieutenant Governor,Todd Lamb,REP,550097,0,0,333,333,
Oklahoma,Superintendent of Public Instruction,John Cox,DEM,550097,0,0,263,263,
Oklahoma,Superintendent of Public Instruction,Joy Hofmeister,REP,550097,0,0,251,251,
Oklahoma,Commissioner of Labor,Mike Workman,DEM,550097,0,0,198,198,
Oklahoma,Commissioner of Labor,Mark Costello,REP,550097,0,0,304,304,
Oklahoma,U.S. Senate,Matt Silverstein,DEM,550097,0,0,153,153,
Oklahoma,U.S. Senate,Jim Inhofe,REP,550097,0,0,335,335,
Oklahoma,U.S. Senate,Aaron Delozier,IND,550097,0,0,12,12,
Oklahoma,U.S. Senate,Ray Woods,IND,550097,0,0,4,4,
Oklahoma,U.S. Senate,Joan Farr,IND,550097,0,0,10,10,
Oklahoma,U.S. Senate,Connie Johnson,DEM,550097,0,0,159,159,
Oklahoma,U.S. Senate,James Lankford,REP,550097,0,0,340,340,
Oklahoma,U.S. Senate,Mark Beard,IND,550097,0,0,18,18,
Oklahoma,U.S. House,Bert Smith,DEM,550097,0,0,142,142,04
Oklahoma,U.S. House,Tom Cole,REP,550097,0,0,347,347,04
Oklahoma,U.S. House,Dennis Johnson,IND,550097,0,0,26,26,04
Oklahoma,State Senate,Hiawatha Jr.,DEM,550097,0,0,149,149,42
Oklahoma,State Senate,Jack Fry,REP,550097,0,0,328,328,42
Oklahoma,State Senate,Charles Thompson,IND,550097,0,0,33,33,42
Oklahoma,Governor,Joe Dorman,DEM,550098,0,0,295,295,
Oklahoma,Governor,Mary Fallin,REP,550098,0,0,558,558,
Oklahoma,Governor,Kimberly Willis,IND,550098,0,0,11,11,
Oklahoma,Governor,Richard Prawdzienski,IND,550098,0,0,11,11,
Oklahoma,Lieutenant Governor,Cathy Cummings,DEM,550098,0,0,212,212,
Oklahoma,Lieutenant Governor,Todd Lamb,REP,550098,0,0,654,654,
Oklahoma,Superintendent of Public Instruction,John Cox,DEM,550098,0,0,312,312,
Oklahoma,Superintendent of Public Instruction,Joy Hofmeister,REP,550098,0,0,557,557,
Oklahoma,Commissioner of Labor,Mike Workman,DEM,550098,0,0,235,235,
Oklahoma,Commissioner of Labor,Mark Costello,REP,550098,0,0,606,606,
Oklahoma,U.S. Senate,Matt Silverstein,DEM,550098,0,0,169,169,
Oklahoma,U.S. Senate,Jim Inhofe,REP,550098,0,0,664,664,
Oklahoma,U.S. Senate,Aaron Delozier,IND,550098,0,0,7,7,
Oklahoma,U.S. Senate,Ray Woods,IND,550098,0,0,12,12,
Oklahoma,U.S. Senate,Joan Farr,IND,550098,0,0,14,14,
Oklahoma,U.S. Senate,Connie Johnson,DEM,550098,0,0,176,176,
Oklahoma,U.S. Senate,James Lankford,REP,550098,0,0,675,675,
Oklahoma,U.S. Senate,Mark Beard,IND,550098,0,0,19,19,
Oklahoma,U.S. House,Bert Smith,DEM,550098,0,0,159,159,04
Oklahoma,U.S. House,Tom Cole,REP,550098,0,0,669,669,04
Oklahoma,U.S. House,Dennis Johnson,IND,550098,0,0,38,38,04
Oklahoma,State Senate,Hiawatha Jr.,DEM,550098,0,0,160,160,42
Oklahoma,State Senate,Jack Fry,REP,550098,0,0,652,652,42
Oklahoma,State Senate,Charles Thompson,IND,550098,0,0,54,54,42
Oklahoma,Governor,Joe Dorman,DEM,550099,0,0,287,287,
Oklahoma,Governor,Mary Fallin,REP,550099,0,0,410,410,
Oklahoma,Governor,Kimberly Willis,IND,550099,0,0,19,19,
Oklahoma,Governor,Richard Prawdzienski,IND,550099,0,0,4,4,
Oklahoma,Lieutenant Governor,Cathy Cummings,DEM,550099,0,0,257,257,
Oklahoma,Lieutenant Governor,Todd Lamb,REP,550099,0,0,453,453,
Oklahoma,Superintendent of Public Instruction,John Cox,DEM,550099,0,0,272,272,
Oklahoma,Superintendent of Public Instruction,Joy Hofmeister,REP,550099,0,0,431,431,
Oklahoma,Commissioner of Labor,Mike Workman,DEM,550099,0,0,216,216,
Oklahoma,Commissioner of Labor,Mark Costello,REP,550099,0,0,467,467,
Oklahoma,U.S. Senate,Matt Silverstein,DEM,550099,0,0,219,219,
Oklahoma,U.S. Senate,Jim Inhofe,REP,550099,0,0,476,476,
Oklahoma,U.S. Senate,Aaron Delozier,IND,550099,0,0,5,5,
Oklahoma,U.S. Senate,Ray Woods,IND,550099,0,0,5,5,
Oklahoma,U.S. Senate,Joan Farr,IND,550099,0,0,9,9,
Oklahoma,U.S. Senate,Connie Johnson,DEM,550099,0,0,221,221,
Oklahoma,U.S. Senate,James Lankford,REP,550099,0,0,479,479,
Oklahoma,U.S. Senate,Mark Beard,IND,550099,0,0,16,16,
Oklahoma,U.S. House,Al Mcaffrey,DEM,550099,0,0,234,234,05
Oklahoma,U.S. House,Steve Russell,REP,550099,0,0,446,446,05
Oklahoma,U.S. House,Buddy Ray,IND,550099,0,0,5,5,05
Oklahoma,U.S. House,Tom Boggs,IND,550099,0,0,9,9,05
Oklahoma,U.S. House,Robert Murphy,IND,550099,0,0,10,10,05
Oklahoma,State Senate,John Handy Edwards,DEM,550099,0,0,272,272,40
Oklahoma,State Senate,Ervin Yen,REP,550099,0,0,440,440,40
Oklahoma,State House,Cyndi Munson,DEM,550099,0,0,275,275,85
Oklahoma,State House,David Dank,REP,550099,0,0,431,431,85
Oklahoma,Governor,Joe Dorman,DEM,550100,0,0,306,306,
Oklahoma,Governor,Mary Fallin,REP,550100,0,0,602,602,
Oklahoma,Governor,Kimberly Willis,IND,550100,0,0,10,10,
Oklahoma,Governor,Richard Prawdzienski,IND,550100,0,0,3,3,
Oklahoma,Lieutenant Governor,Cathy Cummings,DEM,550100,0,0,286,286,
Oklahoma,Lieutenant Governor,Todd Lamb,REP,550100,0,0,640,640,
Oklahoma,Superintendent of Public Instruction,John Cox,DEM,550100,0,0,295,295,
Oklahoma,Superintendent of Public Instruction,Joy Hofmeister,REP,550100,0,0,607,607,
Oklahoma,Commissioner of Labor,Mike Workman,DEM,550100,0,0,205,205,
Oklahoma,Commissioner of Labor,Mark Costello,REP,550100,0,0,675,675,
Oklahoma,U.S. Senate,Matt Silverstein,DEM,550100,0,0,227,227,
Oklahoma,U.S. Senate,Jim Inhofe,REP,550100,0,0,673,673,
Oklahoma,U.S. Senate,Aaron Delozier,IND,550100,0,0,4,4,
Oklahoma,U.S. Senate,Ray Woods,IND,550100,0,0,6,6,
Oklahoma,U.S. Senate,Joan Farr,IND,550100,0,0,8,8,
Oklahoma,U.S. Senate,Connie Johnson,DEM,550100,0,0,216,216,
Oklahoma,U.S. Senate,James Lankford,REP,550100,0,0,694,694,
Oklahoma,U.S. Senate,Mark Beard,IND,550100,0,0,11,11,
Oklahoma,U.S. House,Al Mcaffrey,DEM,550100,0,0,241,241,05
Oklahoma,U.S. House,Steve Russell,REP,550100,0,0,654,654,05
Oklahoma,U.S. House,Buddy Ray,IND,550100,0,0,1,1,05
Oklahoma,U.S. House,Tom Boggs,IND,550100,0,0,5,5,05
Oklahoma,U.S. House,Robert Murphy,IND,550100,0,0,7,7,05
Oklahoma,State Senate,John Handy Edwards,DEM,550100,0,0,278,278,40
Oklahoma,State Senate,Ervin Yen,REP,550100,0,0,647,647,40
Oklahoma,State House,Ed Holzberger,DEM,550100,0,0,168,168,83
Oklahoma,State House,Randy Mcdaniel,REP,550100,0,0,741,741,83
Oklahoma,Governor,Joe Dorman,DEM,550101,0,0,113,113,
Oklahoma,Governor,Mary Fallin,REP,550101,0,0,262,262,
Oklahoma,Governor,Kimberly Willis,IND,550101,0,0,6,6,
Oklahoma,Governor,Richard Prawdzienski,IND,550101,0,0,1,1,
Oklahoma,Lieutenant Governor,Cathy Cummings,DEM,550101,0,0,104,104,
Oklahoma,Lieutenant Governor,Todd Lamb,REP,550101,0,0,281,281,
Oklahoma,Superintendent of Public Instruction,John Cox,DEM,550101,0,0,117,117,
Oklahoma,Superintendent of Public Instruction,Joy Hofmeister,REP,550101,0,0,260,260,
Oklahoma,Commissioner of Labor,Mike Workman,DEM,550101,0,0,83,83,
Oklahoma,Commissioner of Labor,Mark Costello,REP,550101,0,0,289,289,
Oklahoma,U.S. Senate,Matt Silverstein,DEM,550101,0,0,88,88,
Oklahoma,U.S. Senate,Jim Inhofe,REP,550101,0,0,289,289,
Oklahoma,U.S. Senate,Aaron Delozier,IND,550101,0,0,0,0,
Oklahoma,U.S. Senate,Ray Woods,IND,550101,0,0,0,0,
Oklahoma,U.S. Senate,Joan Farr,IND,550101,0,0,4,4,
Oklahoma,U.S. Senate,Connie Johnson,DEM,550101,0,0,83,83,
Oklahoma,U.S. Senate,James Lankford,REP,550101,0,0,299,299,
Oklahoma,U.S. Senate,Mark Beard,IND,550101,0,0,3,3,
Oklahoma,U.S. House,Al Mcaffrey,DEM,550101,0,0,87,87,05
Oklahoma,U.S. House,Steve Russell,REP,550101,0,0,287,287,05
Oklahoma,U.S. House,Buddy Ray,IND,550101,0,0,1,1,05
Oklahoma,U.S. House,Tom Boggs,IND,550101,0,0,3,3,05
Oklahoma,U.S. House,Robert Murphy,IND,550101,0,0,3,3,05
Oklahoma,State Senate,John Handy Edwards,DEM,550101,0,0,98,98,40
Oklahoma,State Senate,Ervin Yen,REP,550101,0,0,289,289,40
Oklahoma,State House,Ed Holzberger,DEM,550101,0,0,62,62,83
Oklahoma,State House,Randy Mcdaniel,REP,550101,0,0,319,319,83
Oklahoma,Governor,Joe Dorman,DEM,550102,0,0,345,345,
Oklahoma,Governor,Mary Fallin,REP,550102,0,0,546,546,
Oklahoma,Governor,Kimberly Willis,IND,550102,0,0,17,17,
Oklahoma,Governor,Richard Prawdzienski,IND,550102,0,0,7,7,
Oklahoma,Lieutenant Governor,Cathy Cummings,DEM,550102,0,0,353,353,
Oklahoma,Lieutenant Governor,Todd Lamb,REP,550102,0,0,560,560,
Oklahoma,Superintendent of Public Instruction,John Cox,DEM,550102,0,0,369,369,
Oklahoma,Superintendent of Public Instruction,Joy Hofmeister,REP,550102,0,0,535,535,
Oklahoma,Commissioner of Labor,Mike Workman,DEM,550102,0,0,272,272,
Oklahoma,Commissioner of Labor,Mark Costello,REP,550102,0,0,614,614,
Oklahoma,U.S. Senate,Matt Silverstein,DEM,550102,0,0,267,267,
Oklahoma,U.S. Senate,Jim Inhofe,REP,550102,0,0,616,616,
Oklahoma,U.S. Senate,Aaron Delozier,IND,550102,0,0,7,7,
Oklahoma,U.S. Senate,Ray Woods,IND,550102,0,0,8,8,
Oklahoma,U.S. Senate,Joan Farr,IND,550102,0,0,11,11,
Oklahoma,U.S. Senate,Connie Johnson,DEM,550102,0,0,263,263,
Oklahoma,U.S. Senate,James Lankford,REP,550102,0,0,636,636,
Oklahoma,U.S. Senate,Mark Beard,IND,550102,0,0,16,16,
Oklahoma,U.S. House,Al Mcaffrey,DEM,550102,0,0,269,269,05
Oklahoma,U.S. House,Steve Russell,REP,550102,0,0,613,613,05
Oklahoma,U.S. House,Buddy Ray,IND,550102,0,0,5,5,05
Oklahoma,U.S. House,Tom Boggs,IND,550102,0,0,10,10,05
Oklahoma,U.S. House,Robert Murphy,IND,550102,0,0,9,9,05
Oklahoma,State Senate,John Handy Edwards,DEM,550102,0,0,299,299,40
Oklahoma,State Senate,Ervin Yen,REP,550102,0,0,603,603,40
Oklahoma,State House,Cyndi Munson,DEM,550102,0,0,323,323,85
Oklahoma,State House,David Dank,REP,550102,0,0,576,576,85
Oklahoma,Governor,Joe Dorman,DEM,550103,0,0,268,268,
Oklahoma,Governor,Mary Fallin,REP,550103,0,0,222,222,
Oklahoma,Governor,Kimberly Willis,IND,550103,0,0,12,12,
Oklahoma,Governor,Richard Prawdzienski,IND,550103,0,0,6,6,
Oklahoma,Lieutenant Governor,Cathy Cummings,DEM,550103,0,0,217,217,
Oklahoma,Lieutenant Governor,Todd Lamb,REP,550103,0,0,292,292,
Oklahoma,Superintendent of Public Instruction,John Cox,DEM,550103,0,0,262,262,
Oklahoma,Superintendent of Public Instruction,Joy Hofmeister,REP,550103,0,0,241,241,
Oklahoma,Commissioner of Labor,Mike Workman,DEM,550103,0,0,205,205,
Oklahoma,Commissioner of Labor,Mark Costello,REP,550103,0,0,281,281,
Oklahoma,U.S. Senate,Matt Silverstein,DEM,550103,0,0,200,200,
Oklahoma,U.S. Senate,Jim Inhofe,REP,550103,0,0,284,284,
Oklahoma,U.S. Senate,Aaron Delozier,IND,550103,0,0,4,4,
Oklahoma,U.S. Senate,Ray Woods,IND,550103,0,0,10,10,
Oklahoma,U.S. Senate,Joan Farr,IND,550103,0,0,6,6,
Oklahoma,U.S. Senate,Connie Johnson,DEM,550103,0,0,201,201,
Oklahoma,U.S. Senate,James Lankford,REP,550103,0,0,282,282,
Oklahoma,U.S. Senate,Mark Beard,IND,550103,0,0,22,22,
Oklahoma,U.S. House,Al Mcaffrey,DEM,550103,0,0,202,202,05
Oklahoma,U.S. House,Steve Russell,REP,550103,0,0,273,273,05
Oklahoma,U.S. House,Buddy Ray,IND,550103,0,0,11,11,05
Oklahoma,U.S. House,Tom Boggs,IND,550103,0,0,6,6,05
Oklahoma,U.S. House,Robert Murphy,IND,550103,0,0,11,11,05
Oklahoma,State Senate,John Handy Edwards,DEM,550103,0,0,261,261,40
Oklahoma,State Senate,Ervin Yen,REP,550103,0,0,241,241,40
Oklahoma,State House,Ed Holzberger,DEM,550103,0,0,197,197,83
Oklahoma,State House,Randy Mcdaniel,REP,550103,0,0,297,297,83
Oklahoma,Governor,Joe Dorman,DEM,550104,0,0,223,223,
Oklahoma,Governor,Mary Fallin,REP,550104,0,0,207,207,
Oklahoma,Governor,Kimberly Willis,IND,550104,0,0,12,12,
Oklahoma,Governor,Richard Prawdzienski,IND,550104,0,0,2,2,
Oklahoma,Lieutenant Governor,Cathy Cummings,DEM,550104,0,0,204,204,
Oklahoma,Lieutenant Governor,Todd Lamb,REP,550104,0,0,238,238,
Oklahoma,Superintendent of Public Instruction,John Cox,DEM,550104,0,0,231,231,
Oklahoma,Superintendent of Public Instruction,Joy Hofmeister,REP,550104,0,0,208,208,
Oklahoma,Commissioner of Labor,Mike Workman,DEM,550104,0,0,190,190,
Oklahoma,Commissioner of Labor,Mark Costello,REP,550104,0,0,240,240,
Oklahoma,U.S. Senate,Matt Silverstein,DEM,550104,0,0,181,181,
Oklahoma,U.S. Senate,Jim Inhofe,REP,550104,0,0,240,240,
Oklahoma,U.S. Senate,Aaron Delozier,IND,550104,0,0,7,7,
Oklahoma,U.S. Senate,Ray Woods,IND,550104,0,0,9,9,
Oklahoma,U.S. Senate,Joan Farr,IND,550104,0,0,5,5,
Oklahoma,U.S. Senate,Connie Johnson,DEM,550104,0,0,188,188,
Oklahoma,U.S. Senate,James Lankford,REP,550104,0,0,246,246,
Oklahoma,U.S. Senate,Mark Beard,IND,550104,0,0,10,10,
Oklahoma,U.S. House,Al Mcaffrey,DEM,550104,0,0,182,182,05
Oklahoma,U.S. House,Steve Russell,REP,550104,0,0,244,244,05
Oklahoma,U.S. House,Buddy Ray,IND,550104,0,0,7,7,05
Oklahoma,U.S. House,Tom Boggs,IND,550104,0,0,5,5,05
Oklahoma,U.S. House,Robert Murphy,IND,550104,0,0,5,5,05
Oklahoma,State House,Ed Holzberger,DEM,550104,0,0,194,194,83
Oklahoma,State House,Randy Mcdaniel,REP,550104,0,0,244,244,83
Oklahoma,Governor,Joe Dorman,DEM,550105,0,0,248,248,
Oklahoma,Governor,Mary Fallin,REP,550105,0,0,342,342,
Oklahoma,Governor,Kimberly Willis,IND,550105,0,0,9,9,
Oklahoma,Governor,Richard Prawdzienski,IND,550105,0,0,6,6,
Oklahoma,Lieutenant Governor,Cathy Cummings,DEM,550105,0,0,217,217,
Oklahoma,Lieutenant Governor,Todd Lamb,REP,550105,0,0,387,387,
Oklahoma,Superintendent of Public Instruction,John Cox,DEM,550105,0,0,235,235,
Oklahoma,Superintendent of Public Instruction,Joy Hofmeister,REP,550105,0,0,361,361,
Oklahoma,Commissioner of Labor,Mike Workman,DEM,550105,0,0,198,198,
Oklahoma,Commissioner of Labor,Mark Costello,REP,550105,0,0,386,386,
Oklahoma,U.S. Senate,Matt Silverstein,DEM,550105,0,0,175,175,
Oklahoma,U.S. Senate,Jim Inhofe,REP,550105,0,0,401,401,
Oklahoma,U.S. Senate,Aaron Delozier,IND,550105,0,0,8,8,
Oklahoma,U.S. Senate,Ray Woods,IND,550105,0,0,6,6,
Oklahoma,U.S. Senate,Joan Farr,IND,550105,0,0,7,7,
Oklahoma,U.S. Senate,Connie Johnson,DEM,550105,0,0,184,184,
Oklahoma,U.S. Senate,James Lankford,REP,550105,0,0,409,409,
Oklahoma,U.S. Senate,Mark Beard,IND,550105,0,0,11,11,
Oklahoma,U.S. House,Al Mcaffrey,DEM,550105,0,0,188,188,05
Oklahoma,U.S. House,Steve Russell,REP,550105,0,0,390,390,05
Oklahoma,U.S. House,Buddy Ray,IND,550105,0,0,4,4,05
Oklahoma,U.S. House,Tom Boggs,IND,550105,0,0,10,10,05
Oklahoma,U.S. House,Robert Murphy,IND,550105,0,0,4,4,05
Oklahoma,State House,Ed Holzberger,DEM,550105,0,0,185,185,83
Oklahoma,State House,Randy Mcdaniel,REP,550105,0,0,404,404,83
Oklahoma,Governor,Joe Dorman,DEM,550106,0,0,308,308,
Oklahoma,Governor,Mary Fallin,REP,550106,0,0,411,411,
Oklahoma,Governor,Kimberly Willis,IND,550106,0,0,12,12,
Oklahoma,Governor,Richard Prawdzienski,IND,550106,0,0,8,8,
Oklahoma,Lieutenant Governor,Cathy Cummings,DEM,550106,0,0,273,273,
Oklahoma,Lieutenant Governor,Todd Lamb,REP,550106,0,0,466,466,
Oklahoma,Superintendent of Public Instruction,John Cox,DEM,550106,0,0,309,309,
Oklahoma,Superintendent of Public Instruction,Joy Hofmeister,REP,550106,0,0,421,421,
Oklahoma,Commissioner of Labor,Mike Workman,DEM,550106,0,0,248,248,
Oklahoma,Commissioner of Labor,Mark Costello,REP,550106,0,0,463,463,
Oklahoma,U.S. Senate,Matt Silverstein,DEM,550106,0,0,220,220,
Oklahoma,U.S. Senate,Jim Inhofe,REP,550106,0,0,481,481,
Oklahoma,U.S. Senate,Aaron Delozier,IND,550106,0,0,9,9,
Oklahoma,U.S. Senate,Ray Woods,IND,550106,0,0,8,8,
Oklahoma,U.S. Senate,Joan Farr,IND,550106,0,0,14,14,
Oklahoma,U.S. Senate,Connie Johnson,DEM,550106,0,0,230,230,
Oklahoma,U.S. Senate,James Lankford,REP,550106,0,0,493,493,
Oklahoma,U.S. Senate,Mark Beard,IND,550106,0,0,17,17,
Oklahoma,U.S. House,Al Mcaffrey,DEM,550106,0,0,230,230,05
Oklahoma,U.S. House,Steve Russell,REP,550106,0,0,478,478,05
Oklahoma,U.S. House,Buddy Ray,IND,550106,0,0,5,5,05
Oklahoma,U.S. House,Tom Boggs,IND,550106,0,0,6,6,05
Oklahoma,U.S. House,Robert Murphy,IND,550106,0,0,11,11,05
Oklahoma,State House,Cyndi Munson,DEM,550106,0,0,301,301,85
Oklahoma,State House,David Dank,REP,550106,0,0,432,432,85
Oklahoma,Governor,Joe Dorman,DEM,550107,0,0,79,79,
Oklahoma,Governor,Mary Fallin,REP,550107,0,0,153,153,
Oklahoma,Governor,Kimberly Willis,IND,550107,0,0,5,5,
Oklahoma,Governor,Richard Prawdzienski,IND,550107,0,0,6,6,
Oklahoma,Lieutenant Governor,Cathy Cummings,DEM,550107,0,0,63,63,
Oklahoma,Lieutenant Governor,Todd Lamb,REP,550107,0,0,179,179,
Oklahoma,Superintendent of Public Instruction,John Cox,DEM,550107,0,0,79,79,
Oklahoma,Superintendent of Public Instruction,Joy Hofmeister,REP,550107,0,0,162,162,
Oklahoma,Commissioner of Labor,Mike Workman,DEM,550107,0,0,69,69,
Oklahoma,Commissioner of Labor,Mark Costello,REP,550107,0,0,170,170,
Oklahoma,U.S. Senate,Matt Silverstein,DEM,550107,0,0,54,54,
Oklahoma,U.S. Senate,Jim Inhofe,REP,550107,0,0,171,171,
Oklahoma,U.S. Senate,Aaron Delozier,IND,550107,0,0,5,5,
Oklahoma,U.S. Senate,Ray Woods,IND,550107,0,0,6,6,
Oklahoma,U.S. Senate,Joan Farr,IND,550107,0,0,6,6,
Oklahoma,U.S. Senate,Connie Johnson,DEM,550107,0,0,57,57,
Oklahoma,U.S. Senate,James Lankford,REP,550107,0,0,177,177,
Oklahoma,U.S. Senate,Mark Beard,IND,550107,0,0,9,9,
Oklahoma,U.S. House,Al Mcaffrey,DEM,550107,0,0,62,62,05
Oklahoma,U.S. House,Steve Russell,REP,550107,0,0,170,170,05
Oklahoma,U.S. House,Buddy Ray,IND,550107,0,0,2,2,05
Oklahoma,U.S. House,Tom Boggs,IND,550107,0,0,6,6,05
Oklahoma,U.S. House,Robert Murphy,IND,550107,0,0,3,3,05
Oklahoma,State House,Cecilia Taft,DEM,550107,0,0,81,81,96
Oklahoma,State House,Lewis Moore,REP,550107,0,0,160,160,96
Oklahoma,Governor,Joe Dorman,DEM,550108,0,0,75,75,
Oklahoma,Governor,Mary Fallin,REP,550108,0,0,133,133,
Oklahoma,Governor,Kimberly Willis,IND,550108,0,0,3,3,
Oklahoma,Governor,Richard Prawdzienski,IND,550108,0,0,1,1,
Oklahoma,Lieutenant Governor,Cathy Cummings,DEM,550108,0,0,61,61,
Oklahoma,Lieutenant Governor,Todd Lamb,REP,550108,0,0,155,155,
Oklahoma,Superintendent of Public Instruction,John Cox,DEM,550108,0,0,76,76,
Oklahoma,Superintendent of Public Instruction,Joy Hofmeister,REP,550108,0,0,136,136,
Oklahoma,Commissioner of Labor,Mike Workman,DEM,550108,0,0,66,66,
Oklahoma,Commissioner of Labor,Mark Costello,REP,550108,0,0,145,145,
Oklahoma,U.S. Senate,Matt Silverstein,DEM,550108,0,0,56,56,
Oklahoma,U.S. Senate,Jim Inhofe,REP,550108,0,0,156,156,
Oklahoma,U.S. Senate,Aaron Delozier,IND,550108,0,0,1,1,
Oklahoma,U.S. Senate,Ray Woods,IND,550108,0,0,1,1,
Oklahoma,U.S. Senate,Joan Farr,IND,550108,0,0,0,0,
Oklahoma,U.S. Senate,Connie Johnson,DEM,550108,0,0,57,57,
Oklahoma,U.S. Senate,James Lankford,REP,550108,0,0,158,158,
Oklahoma,U.S. Senate,Mark Beard,IND,550108,0,0,0,0,
Oklahoma,U.S. House,Al Mcaffrey,DEM,550108,0,0,56,56,05
Oklahoma,U.S. House,Steve Russell,REP,550108,0,0,154,154,05
Oklahoma,U.S. House,Buddy Ray,IND,550108,0,0,0,0,05
Oklahoma,U.S. House,Tom Boggs,IND,550108,0,0,2,2,05
Oklahoma,U.S. House,Robert Murphy,IND,550108,0,0,2,2,05
Oklahoma,State House,Cecilia Taft,DEM,550108,0,0,60,60,96
Oklahoma,State House,Lewis Moore,REP,550108,0,0,147,147,96
Oklahoma,Governor,Joe Dorman,DEM,550109,0,0,345,345,
Oklahoma,Governor,Mary Fallin,REP,550109,0,0,648,648,
Oklahoma,Governor,Kimberly Willis,IND,550109,0,0,10,10,
Oklahoma,Governor,Richard Prawdzienski,IND,550109,0,0,7,7,
Oklahoma,Lieutenant Governor,Cathy Cummings,DEM,550109,0,0,278,278,
Oklahoma,Lieutenant Governor,Todd Lamb,REP,550109,0,0,735,735,
Oklahoma,Superintendent of Public Instruction,John Cox,DEM,550109,0,0,365,365,
Oklahoma,Superintendent of Public Instruction,Joy Hofmeister,REP,550109,0,0,636,636,
Oklahoma,Commissioner of Labor,Mike Workman,DEM,550109,0,0,276,276,
Oklahoma,Commissioner of Labor,Mark Costello,REP,550109,0,0,711,711,
Oklahoma,U.S. Senate,Matt Silverstein,DEM,550109,0,0,243,243,
Oklahoma,U.S. Senate,Jim Inhofe,REP,550109,0,0,741,741,
Oklahoma,U.S. Senate,Aaron Delozier,IND,550109,0,0,6,6,
Oklahoma,U.S. Senate,Ray Woods,IND,550109,0,0,4,4,
Oklahoma,U.S. Senate,Joan Farr,IND,550109,0,0,11,11,
Oklahoma,U.S. Senate,Connie Johnson,DEM,550109,0,0,243,243,
Oklahoma,U.S. Senate,James Lankford,REP,550109,0,0,756,756,
Oklahoma,U.S. Senate,Mark Beard,IND,550109,0,0,15,15,
Oklahoma,U.S. House,Al Mcaffrey,DEM,550109,0,0,260,260,05
Oklahoma,U.S. House,Steve Russell,REP,550109,0,0,722,722,05
Oklahoma,U.S. House,Buddy Ray,IND,550109,0,0,5,5,05
Oklahoma,U.S. House,Tom Boggs,IND,550109,0,0,9,9,05
Oklahoma,U.S. House,Robert Murphy,IND,550109,0,0,8,8,05
Oklahoma,State House,Mike Shelton,DEM,550109,0,0,372,372,97
Oklahoma,State House,Tonni Canaday,REP,550109,0,0,611,611,97
Oklahoma,Governor,Joe Dorman,DEM,550110,0,0,75,75,
Oklahoma,Governor,Mary Fallin,REP,550110,0,0,196,196,
Oklahoma,Governor,Kimberly Willis,IND,550110,0,0,2,2,
Oklahoma,Governor,Richard Prawdzienski,IND,550110,0,0,3,3,
Oklahoma,Lieutenant Governor,Cathy Cummings,DEM,550110,0,0,59,59,
Oklahoma,Lieutenant Governor,Todd Lamb,REP,550110,0,0,215,215,
Oklahoma,Superintendent of Public Instruction,John Cox,DEM,550110,0,0,80,80,
Oklahoma,Superintendent of Public Instruction,Joy Hofmeister,REP,550110,0,0,193,193,
Oklahoma,Commissioner of Labor,Mike Workman,DEM,550110,0,0,56,56,
Oklahoma,Commissioner of Labor,Mark Costello,REP,550110,0,0,212,212,
Oklahoma,U.S. Senate,Matt Silverstein,DEM,550110,0,0,49,49,
Oklahoma,U.S. Senate,Jim Inhofe,REP,550110,0,0,222,222,
Oklahoma,U.S. Senate,Aaron Delozier,IND,550110,0,0,0,0,
Oklahoma,U.S. Senate,Ray Woods,IND,550110,0,0,0,0,
Oklahoma,U.S. Senate,Joan Farr,IND,550110,0,0,3,3,
Oklahoma,U.S. Senate,Connie Johnson,DEM,550110,0,0,55,55,
Oklahoma,U.S. Senate,James Lankford,REP,550110,0,0,216,216,
Oklahoma,U.S. Senate,Mark Beard,IND,550110,0,0,4,4,
Oklahoma,U.S. House,Al Mcaffrey,DEM,550110,0,0,49,49,05
Oklahoma,U.S. House,Steve Russell,REP,550110,0,0,218,218,05
Oklahoma,U.S. House,Buddy Ray,IND,550110,0,0,2,2,05
Oklahoma,U.S. House,Tom Boggs,IND,550110,0,0,0,0,05
Oklahoma,U.S. House,Robert Murphy,IND,550110,0,0,1,1,05
Oklahoma,State House,Mike Shelton,DEM,550110,0,0,77,77,97
Oklahoma,State House,Tonni Canaday,REP,550110,0,0,185,185,97
Oklahoma,Governor,Joe Dorman,DEM,550111,0,0,357,357,
Oklahoma,Governor,Mary Fallin,REP,550111,0,0,621,621,
Oklahoma,Governor,Kimberly Willis,IND,550111,0,0,16,16,
Oklahoma,Governor,Richard Prawdzienski,IND,550111,0,0,9,9,
Oklahoma,Lieutenant Governor,Cathy Cummings,DEM,550111,0,0,271,271,
Oklahoma,Lieutenant Governor,Todd Lamb,REP,550111,0,0,729,729,
Oklahoma,Superintendent of Public Instruction,John Cox,DEM,550111,0,0,356,356,
Oklahoma,Superintendent of Public Instruction,Joy Hofmeister,REP,550111,0,0,624,624,
Oklahoma,Commissioner of Labor,Mike Workman,DEM,550111,0,0,252,252,
Oklahoma,Commissioner of Labor,Mark Costello,REP,550111,0,0,710,710,
Oklahoma,U.S. Senate,Matt Silverstein,DEM,550111,0,0,240,240,
Oklahoma,U.S. Senate,Jim Inhofe,REP,550111,0,0,716,716,
Oklahoma,U.S. Senate,Aaron Delozier,IND,550111,0,0,10,10,
Oklahoma,U.S. Senate,Ray Woods,IND,550111,0,0,8,8,
Oklahoma,U.S. Senate,Joan Farr,IND,550111,0,0,10,10,
Oklahoma,U.S. Senate,Connie Johnson,DEM,550111,0,0,246,246,
Oklahoma,U.S. Senate,James Lankford,REP,550111,0,0,738,738,
Oklahoma,U.S. Senate,Mark Beard,IND,550111,0,0,17,17,
Oklahoma,U.S. House,Al Mcaffrey,DEM,550111,0,0,249,249,05
Oklahoma,U.S. House,Steve Russell,REP,550111,0,0,716,716,05
Oklahoma,U.S. House,Buddy Ray,IND,550111,0,0,7,7,05
Oklahoma,U.S. House,Tom Boggs,IND,550111,0,0,5,5,05
Oklahoma,U.S. House,Robert Murphy,IND,550111,0,0,10,10,05
Oklahoma,Governor,Joe Dorman,DEM,550112,0,0,41,41,
Oklahoma,Governor,Mary Fallin,REP,550112,0,0,65,65,
Oklahoma,Governor,Kimberly Willis,IND,550112,0,0,1,1,
Oklahoma,Governor,Richard Prawdzienski,IND,550112,0,0,2,2,
Oklahoma,Lieutenant Governor,Cathy Cummings,DEM,550112,0,0,43,43,
Oklahoma,Lieutenant Governor,Todd Lamb,REP,550112,0,0,66,66,
Oklahoma,Superintendent of Public Instruction,John Cox,DEM,550112,0,0,38,38,
Oklahoma,Superintendent of Public Instruction,Joy Hofmeister,REP,550112,0,0,69,69,
Oklahoma,Commissioner of Labor,Mike Workman,DEM,550112,0,0,34,34,
Oklahoma,Commissioner of Labor,Mark Costello,REP,550112,0,0,71,71,
Oklahoma,U.S. Senate,Matt Silverstein,DEM,550112,0,0,32,32,
Oklahoma,U.S. Senate,Jim Inhofe,REP,550112,0,0,69,69,
Oklahoma,U.S. Senate,Aaron Delozier,IND,550112,0,0,0,0,
Oklahoma,U.S. Senate,Ray Woods,IND,550112,0,0,2,2,
Oklahoma,U.S. Senate,Joan Farr,IND,550112,0,0,3,3,
Oklahoma,U.S. Senate,Connie Johnson,DEM,550112,0,0,35,35,
Oklahoma,U.S. Senate,James Lankford,REP,550112,0,0,73,73,
Oklahoma,U.S. Senate,Mark Beard,IND,550112,0,0,1,1,
Oklahoma,U.S. House,Al Mcaffrey,DEM,550112,0,0,37,37,05
Oklahoma,U.S. House,Steve Russell,REP,550112,0,0,71,71,05
Oklahoma,U.S. House,Buddy Ray,IND,550112,0,0,1,1,05
Oklahoma,U.S. House,Tom Boggs,IND,550112,0,0,0,0,05
Oklahoma,U.S. House,Robert Murphy,IND,550112,0,0,0,0,05
Oklahoma,State Senate,Anastasia Pittman,DEM,550112,0,0,43,43,48
Oklahoma,State Senate,Duane Crumbacher,REP,550112,0,0,62,62,48
Oklahoma,State House,Mike Shelton,DEM,550112,0,0,51,51,97
Oklahoma,State House,Tonni Canaday,REP,550112,0,0,56,56,97
Oklahoma,Governor,Joe Dorman,DEM,550113,0,0,92,92,
Oklahoma,Governor,Mary Fallin,REP,550113,0,0,102,102,
Oklahoma,Governor,Kimberly Willis,IND,550113,0,0,2,2,
Oklahoma,Governor,Richard Prawdzienski,IND,550113,0,0,1,1,
Oklahoma,Lieutenant Governor,Cathy Cummings,DEM,550113,0,0,87,87,
Oklahoma,Lieutenant Governor,Todd Lamb,REP,550113,0,0,110,110,
Oklahoma,Superintendent of Public Instruction,John Cox,DEM,550113,0,0,97,97,
Oklahoma,Superintendent of Public Instruction,Joy Hofmeister,REP,550113,0,0,99,99,
Oklahoma,Commissioner of Labor,Mike Workman,DEM,550113,0,0,86,86,
Oklahoma,Commissioner of Labor,Mark Costello,REP,550113,0,0,110,110,
Oklahoma,U.S. Senate,Matt Silverstein,DEM,550113,0,0,78,78,
Oklahoma,U.S. Senate,Jim Inhofe,REP,550113,0,0,114,114,
Oklahoma,U.S. Senate,Aaron Delozier,IND,550113,0,0,1,1,
Oklahoma,U.S. Senate,Ray Woods,IND,550113,0,0,2,2,
Oklahoma,U.S. Senate,Joan Farr,IND,550113,0,0,2,2,
Oklahoma,U.S. Senate,Connie Johnson,DEM,550113,0,0,84,84,
Oklahoma,U.S. Senate,James Lankford,REP,550113,0,0,108,108,
Oklahoma,U.S. Senate,Mark Beard,IND,550113,0,0,5,5,
Oklahoma,U.S. House,Al Mcaffrey,DEM,550113,0,0,78,78,05
Oklahoma,U.S. House,Steve Russell,REP,550113,0,0,110,110,05
Oklahoma,U.S. House,Buddy Ray,IND,550113,0,0,1,1,05
Oklahoma,U.S. House,Tom Boggs,IND,550113,0,0,5,5,05
Oklahoma,U.S. House,Robert Murphy,IND,550113,0,0,2,2,05
Oklahoma,State Senate,Anastasia Pittman,DEM,550113,0,0,86,86,48
Oklahoma,State Senate,Duane Crumbacher,REP,550113,0,0,106,106,48
Oklahoma,State House,Mike Shelton,DEM,550113,0,0,93,93,97
Oklahoma,State House,Tonni Canaday,REP,550113,0,0,99,99,97
Oklahoma,Governor,Joe Dorman,DEM,550114,0,0,536,536,
Oklahoma,Governor,Mary Fallin,REP,550114,0,0,52,52,
Oklahoma,Governor,Kimberly Willis,IND,550114,0,0,4,4,
Oklahoma,Governor,Richard Prawdzienski,IND,550114,0,0,0,0,
Oklahoma,Lieutenant Governor,Cathy Cummings,DEM,550114,0,0,516,516,
Oklahoma,Lieutenant Governor,Todd Lamb,REP,550114,0,0,73,73,
Oklahoma,Superintendent of Public Instruction,John Cox,DEM,550114,0,0,533,533,
Oklahoma,Superintendent of Public Instruction,Joy Hofmeister,REP,550114,0,0,54,54,
Oklahoma,Commissioner of Labor,Mike Workman,DEM,550114,0,0,517,517,
Oklahoma,Commissioner of Labor,Mark Costello,REP,550114,0,0,62,62,
Oklahoma,U.S. Senate,Matt Silverstein,DEM,550114,0,0,505,505,
Oklahoma,U.S. Senate,Jim Inhofe,REP,550114,0,0,64,64,
Oklahoma,U.S. Senate,Aaron Delozier,IND,550114,0,0,2,2,
Oklahoma,U.S. Senate,Ray Woods,IND,550114,0,0,12,12,
Oklahoma,U.S. Senate,Joan Farr,IND,550114,0,0,5,5,
Oklahoma,U.S. Senate,Connie Johnson,DEM,550114,0,0,536,536,
Oklahoma,U.S. Senate,James Lankford,REP,550114,0,0,53,53,
Oklahoma,U.S. Senate,Mark Beard,IND,550114,0,0,4,4,
Oklahoma,U.S. House,Al Mcaffrey,DEM,550114,0,0,523,523,05
Oklahoma,U.S. House,Steve Russell,REP,550114,0,0,47,47,05
Oklahoma,U.S. House,Buddy Ray,IND,550114,0,0,4,4,05
Oklahoma,U.S. House,Tom Boggs,IND,550114,0,0,2,2,05
Oklahoma,U.S. House,Robert Murphy,IND,550114,0,0,10,10,05
Oklahoma,State Senate,Anastasia Pittman,DEM,550114,0,0,545,545,48
Oklahoma,State Senate,Duane Crumbacher,REP,550114,0,0,43,43,48
Oklahoma,State House,Mike Shelton,DEM,550114,0,0,546,546,97
Oklahoma,State House,Tonni Canaday,REP,550114,0,0,46,46,97
Oklahoma,Governor,Joe Dorman,DEM,550115,0,0,709,709,
Oklahoma,Governor,Mary Fallin,REP,550115,0,0,14,14,
Oklahoma,Governor,Kimberly Willis,IND,550115,0,0,9,9,
Oklahoma,Governor,Richard Prawdzienski,IND,550115,0,0,2,2,
Oklahoma,Lieutenant Governor,Cathy Cummings,DEM,550115,0,0,674,674,
Oklahoma,Lieutenant Governor,Todd Lamb,REP,550115,0,0,57,57,
Oklahoma,Superintendent of Public Instruction,John Cox,DEM,550115,0,0,701,701,
Oklahoma,Superintendent of Public Instruction,Joy Hofmeister,REP,550115,0,0,31,31,
Oklahoma,Commissioner of Labor,Mike Workman,DEM,550115,0,0,698,698,
Oklahoma,Commissioner of Labor,Mark Costello,REP,550115,0,0,28,28,
Oklahoma,U.S. Senate,Matt Silverstein,DEM,550115,0,0,652,652,
Oklahoma,U.S. Senate,Jim Inhofe,REP,550115,0,0,55,55,
Oklahoma,U.S. Senate,Aaron Delozier,IND,550115,0,0,2,2,
Oklahoma,U.S. Senate,Ray Woods,IND,550115,0,0,10,10,
Oklahoma,U.S. Senate,Joan Farr,IND,550115,0,0,12,12,
Oklahoma,U.S. Senate,Connie Johnson,DEM,550115,0,0,699,699,
Oklahoma,U.S. Senate,James Lankford,REP,550115,0,0,32,32,
Oklahoma,U.S. Senate,Mark Beard,IND,550115,0,0,5,5,
Oklahoma,U.S. House,Al Mcaffrey,DEM,550115,0,0,669,669,05
Oklahoma,U.S. House,Steve Russell,REP,550115,0,0,35,35,05
Oklahoma,U.S. House,Buddy Ray,IND,550115,0,0,5,5,05
Oklahoma,U.S. House,Tom Boggs,IND,550115,0,0,7,7,05
Oklahoma,U.S. House,Robert Murphy,IND,550115,0,0,9,9,05
Oklahoma,State Senate,Anastasia Pittman,DEM,550115,0,0,709,709,48
Oklahoma,State Senate,Duane Crumbacher,REP,550115,0,0,25,25,48
Oklahoma,State House,Mike Shelton,DEM,550115,0,0,706,706,97
Oklahoma,State House,Tonni Canaday,REP,550115,0,0,26,26,97
Oklahoma,Governor,Joe Dorman,DEM,550116,0,0,164,164,
Oklahoma,Governor,Mary Fallin,REP,550116,0,0,69,69,
Oklahoma,Governor,Kimberly Willis,IND,550116,0,0,3,3,
Oklahoma,Governor,Richard Prawdzienski,IND,550116,0,0,2,2,
Oklahoma,Lieutenant Governor,Cathy Cummings,DEM,550116,0,0,134,134,
Oklahoma,Lieutenant Governor,Todd Lamb,REP,550116,0,0,100,100,
Oklahoma,Superintendent of Public Instruction,John Cox,DEM,550116,0,0,149,149,
Oklahoma,Superintendent of Public Instruction,Joy Hofmeister,REP,550116,0,0,84,84,
Oklahoma,Commissioner of Labor,Mike Workman,DEM,550116,0,0,137,137,
Oklahoma,Commissioner of Labor,Mark Costello,REP,550116,0,0,92,92,
Oklahoma,U.S. Senate,Matt Silverstein,DEM,550116,0,0,124,124,
Oklahoma,U.S. Senate,Jim Inhofe,REP,550116,0,0,102,102,
Oklahoma,U.S. Senate,Aaron Delozier,IND,550116,0,0,5,5,
Oklahoma,U.S. Senate,Ray Woods,IND,550116,0,0,2,2,
Oklahoma,U.S. Senate,Joan Farr,IND,550116,0,0,4,4,
Oklahoma,U.S. Senate,Connie Johnson,DEM,550116,0,0,135,135,
Oklahoma,U.S. Senate,James Lankford,REP,550116,0,0,100,100,
Oklahoma,U.S. Senate,Mark Beard,IND,550116,0,0,2,2,
Oklahoma,U.S. House,Al Mcaffrey,DEM,550116,0,0,132,132,05
Oklahoma,U.S. House,Steve Russell,REP,550116,0,0,88,88,05
Oklahoma,U.S. House,Buddy Ray,IND,550116,0,0,1,1,05
Oklahoma,U.S. House,Tom Boggs,IND,550116,0,0,5,5,05
Oklahoma,U.S. House,Robert Murphy,IND,550116,0,0,6,6,05
Oklahoma,State Senate,Anastasia Pittman,DEM,550116,0,0,152,152,48
Oklahoma,State Senate,Duane Crumbacher,REP,550116,0,0,80,80,48
Oklahoma,State House,George Young,DEM,550116,0,0,148,148,99
Oklahoma,State House,Willard Linzy,REP,550116,0,0,81,81,99
Oklahoma,Governor,Joe Dorman,DEM,550117,0,0,816,816,
Oklahoma,Governor,Mary Fallin,REP,550117,0,0,80,80,
Oklahoma,Governor,Kimberly Willis,IND,550117,0,0,9,9,
Oklahoma,Governor,Richard Prawdzienski,IND,550117,0,0,8,8,
Oklahoma,Lieutenant Governor,Cathy Cummings,DEM,550117,0,0,793,793,
Oklahoma,Lieutenant Governor,Todd Lamb,REP,550117,0,0,115,115,
Oklahoma,Superintendent of Public Instruction,John Cox,DEM,550117,0,0,817,817,
Oklahoma,Superintendent of Public Instruction,Joy Hofmeister,REP,550117,0,0,90,90,
Oklahoma,Commissioner of Labor,Mike Workman,DEM,550117,0,0,802,802,
Oklahoma,Commissioner of Labor,Mark Costello,REP,550117,0,0,100,100,
Oklahoma,U.S. Senate,Matt Silverstein,DEM,550117,0,0,750,750,
Oklahoma,U.S. Senate,Jim Inhofe,REP,550117,0,0,129,129,
Oklahoma,U.S. Senate,Aaron Delozier,IND,550117,0,0,5,5,
Oklahoma,U.S. Senate,Ray Woods,IND,550117,0,0,12,12,
Oklahoma,U.S. Senate,Joan Farr,IND,550117,0,0,10,10,
Oklahoma,U.S. Senate,Connie Johnson,DEM,550117,0,0,802,802,
Oklahoma,U.S. Senate,James Lankford,REP,550117,0,0,98,98,
Oklahoma,U.S. Senate,Mark Beard,IND,550117,0,0,11,11,
Oklahoma,U.S. House,Al Mcaffrey,DEM,550117,0,0,783,783,05
Oklahoma,U.S. House,Steve Russell,REP,550117,0,0,98,98,05
Oklahoma,U.S. House,Buddy Ray,IND,550117,0,0,4,4,05
Oklahoma,U.S. House,Tom Boggs,IND,550117,0,0,9,9,05
Oklahoma,U.S. House,Robert Murphy,IND,550117,0,0,8,8,05
Oklahoma,State Senate,Anastasia Pittman,DEM,550117,0,0,820,820,48
Oklahoma,State Senate,Duane Crumbacher,REP,550117,0,0,87,87,48
Oklahoma,State House,Mike Shelton,DEM,550117,0,0,827,827,97
Oklahoma,State House,Tonni Canaday,REP,550117,0,0,77,77,97
Oklahoma,Governor,Joe Dorman,DEM,550118,0,0,572,572,
Oklahoma,Governor,Mary Fallin,REP,550118,0,0,114,114,
Oklahoma,Governor,Kimberly Willis,IND,550118,0,0,16,16,
Oklahoma,Governor,Richard Prawdzienski,IND,550118,0,0,5,5,
Oklahoma,Lieutenant Governor,Cathy Cummings,DEM,550118,0,0,542,542,
Oklahoma,Lieutenant Governor,Todd Lamb,REP,550118,0,0,159,159,
Oklahoma,Superintendent of Public Instruction,John Cox,DEM,550118,0,0,560,560,
Oklahoma,Superintendent of Public Instruction,Joy Hofmeister,REP,550118,0,0,141,141,
Oklahoma,Commissioner of Labor,Mike Workman,DEM,550118,0,0,540,540,
Oklahoma,Commissioner of Labor,Mark Costello,REP,550118,0,0,161,161,
Oklahoma,U.S. Senate,Matt Silverstein,DEM,550118,0,0,513,513,
Oklahoma,U.S. Senate,Jim Inhofe,REP,550118,0,0,158,158,
Oklahoma,U.S. Senate,Aaron Delozier,IND,550118,0,0,3,3,
Oklahoma,U.S. Senate,Ray Woods,IND,550118,0,0,16,16,
Oklahoma,U.S. Senate,Joan Farr,IND,550118,0,0,10,10,
Oklahoma,U.S. Senate,Connie Johnson,DEM,550118,0,0,536,536,
Oklahoma,U.S. Senate,James Lankford,REP,550118,0,0,151,151,
Oklahoma,U.S. Senate,Mark Beard,IND,550118,0,0,17,17,
Oklahoma,U.S. House,Al Mcaffrey,DEM,550118,0,0,510,510,05
Oklahoma,U.S. House,Steve Russell,REP,550118,0,0,154,154,05
Oklahoma,U.S. House,Buddy Ray,IND,550118,0,0,9,9,05
Oklahoma,U.S. House,Tom Boggs,IND,550118,0,0,15,15,05
Oklahoma,U.S. House,Robert Murphy,IND,550118,0,0,13,13,05
Oklahoma,State Senate,Anastasia Pittman,DEM,550118,0,0,576,576,48
Oklahoma,State Senate,Duane Crumbacher,REP,550118,0,0,127,127,48
Oklahoma,State House,George Young,DEM,550118,0,0,553,553,99
Oklahoma,State House,Willard Linzy,REP,550118,0,0,142,142,99
Oklahoma,Governor,Joe Dorman,DEM,550119,0,0,71,71,
Oklahoma,Governor,Mary Fallin,REP,550119,0,0,59,59,
Oklahoma,Governor,Kimberly Willis,IND,550119,0,0,2,2,
Oklahoma,Governor,Richard Prawdzienski,IND,550119,0,0,2,2,
Oklahoma,Lieutenant Governor,Cathy Cummings,DEM,550119,0,0,60,60,
Oklahoma,Lieutenant Governor,Todd Lamb,REP,550119,0,0,74,74,
Oklahoma,Superintendent of Public Instruction,John Cox,DEM,550119,0,0,64,64,
Oklahoma,Superintendent of Public Instruction,Joy Hofmeister,REP,550119,0,0,69,69,
Oklahoma,Commissioner of Labor,Mike Workman,DEM,550119,0,0,57,57,
Oklahoma,Commissioner of Labor,Mark Costello,REP,550119,0,0,72,72,
Oklahoma,U.S. Senate,Matt Silverstein,DEM,550119,0,0,58,58,
Oklahoma,U.S. Senate,Jim Inhofe,REP,550119,0,0,71,71,
Oklahoma,U.S. Senate,Aaron Delozier,IND,550119,0,0,1,1,
Oklahoma,U.S. Senate,Ray Woods,IND,550119,0,0,0,0,
Oklahoma,U.S. Senate,Joan Farr,IND,550119,0,0,3,3,
Oklahoma,U.S. Senate,Connie Johnson,DEM,550119,0,0,55,55,
Oklahoma,U.S. Senate,James Lankford,REP,550119,0,0,77,77,
Oklahoma,U.S. Senate,Mark Beard,IND,550119,0,0,2,2,
Oklahoma,U.S. House,Al Mcaffrey,DEM,550119,0,0,56,56,05
Oklahoma,U.S. House,Steve Russell,REP,550119,0,0,71,71,05
Oklahoma,U.S. House,Buddy Ray,IND,550119,0,0,3,3,05
Oklahoma,U.S. House,Tom Boggs,IND,550119,0,0,1,1,05
Oklahoma,U.S. House,Robert Murphy,IND,550119,0,0,1,1,05
Oklahoma,State Senate,John Handy Edwards,DEM,550119,0,0,64,64,40
Oklahoma,State Senate,Ervin Yen,REP,550119,0,0,70,70,40
Oklahoma,State House,Ed Holzberger,DEM,550119,0,0,51,51,83
Oklahoma,State House,Randy Mcdaniel,REP,550119,0,0,84,84,83
Oklahoma,Governor,Joe Dorman,DEM,550120,0,0,415,415,
Oklahoma,Governor,Mary Fallin,REP,550120,0,0,110,110,
Oklahoma,Governor,Kimberly Willis,IND,550120,0,0,6,6,
Oklahoma,Governor,Richard Prawdzienski,IND,550120,0,0,10,10,
Oklahoma,Lieutenant Governor,Cathy Cummings,DEM,550120,0,0,397,397,
Oklahoma,Lieutenant Governor,Todd Lamb,REP,550120,0,0,146,146,
Oklahoma,Superintendent of Public Instruction,John Cox,DEM,550120,0,0,424,424,
Oklahoma,Superintendent of Public Instruction,Joy Hofmeister,REP,550120,0,0,114,114,
Oklahoma,Commissioner of Labor,Mike Workman,DEM,550120,0,0,400,400,
Oklahoma,Commissioner of Labor,Mark Costello,REP,550120,0,0,132,132,
Oklahoma,U.S. Senate,Matt Silverstein,DEM,550120,0,0,374,374,
Oklahoma,U.S. Senate,Jim Inhofe,REP,550120,0,0,151,151,
Oklahoma,U.S. Senate,Aaron Delozier,IND,550120,0,0,7,7,
Oklahoma,U.S. Senate,Ray Woods,IND,550120,0,0,5,5,
Oklahoma,U.S. Senate,Joan Farr,IND,550120,0,0,4,4,
Oklahoma,U.S. Senate,Connie Johnson,DEM,550120,0,0,393,393,
Oklahoma,U.S. Senate,James Lankford,REP,550120,0,0,134,134,
Oklahoma,U.S. Senate,Mark Beard,IND,550120,0,0,15,15,
Oklahoma,U.S. House,Al Mcaffrey,DEM,550120,0,0,384,384,05
Oklahoma,U.S. House,Steve Russell,REP,550120,0,0,129,129,05
Oklahoma,U.S. House,Buddy Ray,IND,550120,0,0,11,11,05
Oklahoma,U.S. House,Tom Boggs,IND,550120,0,0,8,8,05
Oklahoma,U.S. House,Robert Murphy,IND,550120,0,0,8,8,05
Oklahoma,State Senate,Anastasia Pittman,DEM,550120,0,0,435,435,48
Oklahoma,State Senate,Duane Crumbacher,REP,550120,0,0,104,104,48
Oklahoma,State House,George Young,DEM,550120,0,0,418,418,99
Oklahoma,State House,Willard Linzy,REP,550120,0,0,117,117,99
Oklahoma,Governor,Joe Dorman,DEM,550121,0,0,662,662,
Oklahoma,Governor,Mary Fallin,REP,550121,0,0,81,81,
Oklahoma,Governor,Kimberly Willis,IND,550121,0,0,9,9,
Oklahoma,Governor,Richard Prawdzienski,IND,550121,0,0,5,5,
Oklahoma,Lieutenant Governor,Cathy Cummings,DEM,550121,0,0,633,633,
Oklahoma,Lieutenant Governor,Todd Lamb,REP,550121,0,0,124,124,
Oklahoma,Superintendent of Public Instruction,John Cox,DEM,550121,0,0,660,660,
Oklahoma,Superintendent of Public Instruction,Joy Hofmeister,REP,550121,0,0,95,95,
Oklahoma,Commissioner of Labor,Mike Workman,DEM,550121,0,0,637,637,
Oklahoma,Commissioner of Labor,Mark Costello,REP,550121,0,0,116,116,
Oklahoma,U.S. Senate,Matt Silverstein,DEM,550121,0,0,608,608,
Oklahoma,U.S. Senate,Jim Inhofe,REP,550121,0,0,125,125,
Oklahoma,U.S. Senate,Aaron Delozier,IND,550121,0,0,2,2,
Oklahoma,U.S. Senate,Ray Woods,IND,550121,0,0,6,6,
Oklahoma,U.S. Senate,Joan Farr,IND,550121,0,0,16,16,
Oklahoma,U.S. Senate,Connie Johnson,DEM,550121,0,0,630,630,
Oklahoma,U.S. Senate,James Lankford,REP,550121,0,0,110,110,
Oklahoma,U.S. Senate,Mark Beard,IND,550121,0,0,15,15,
Oklahoma,U.S. House,Al Mcaffrey,DEM,550121,0,0,633,633,05
Oklahoma,U.S. House,Steve Russell,REP,550121,0,0,100,100,05
Oklahoma,U.S. House,Buddy Ray,IND,550121,0,0,8,8,05
Oklahoma,U.S. House,Tom Boggs,IND,550121,0,0,5,5,05
Oklahoma,U.S. House,Robert Murphy,IND,550121,0,0,7,7,05
Oklahoma,State Senate,Anastasia Pittman,DEM,550121,0,0,665,665,48
Oklahoma,State Senate,Duane Crumbacher,REP,550121,0,0,85,85,48
Oklahoma,State House,George Young,DEM,550121,0,0,641,641,99
Oklahoma,State House,Willard Linzy,REP,550121,0,0,109,109,99
Oklahoma,Governor,Joe Dorman,DEM,550122,0,0,375,375,
Oklahoma,Governor,Mary Fallin,REP,550122,0,0,119,119,
Oklahoma,Governor,Kimberly Willis,IND,550122,0,0,7,7,
Oklahoma,Governor,Richard Prawdzienski,IND,550122,0,0,3,3,
Oklahoma,Lieutenant Governor,Cathy Cummings,DEM,550122,0,0,356,356,
Oklahoma,Lieutenant Governor,Todd Lamb,REP,550122,0,0,145,145,
Oklahoma,Superintendent of Public Instruction,John Cox,DEM,550122,0,0,372,372,
Oklahoma,Superintendent of Public Instruction,Joy Hofmeister,REP,550122,0,0,130,130,
Oklahoma,Commissioner of Labor,Mike Workman,DEM,550122,0,0,358,358,
Oklahoma,Commissioner of Labor,Mark Costello,REP,550122,0,0,136,136,
Oklahoma,U.S. Senate,Matt Silverstein,DEM,550122,0,0,345,345,
Oklahoma,U.S. Senate,Jim Inhofe,REP,550122,0,0,138,138,
Oklahoma,U.S. Senate,Aaron Delozier,IND,550122,0,0,3,3,
Oklahoma,U.S. Senate,Ray Woods,IND,550122,0,0,7,7,
Oklahoma,U.S. Senate,Joan Farr,IND,550122,0,0,8,8,
Oklahoma,U.S. Senate,Connie Johnson,DEM,550122,0,0,356,356,
Oklahoma,U.S. Senate,James Lankford,REP,550122,0,0,143,143,
Oklahoma,U.S. Senate,Mark Beard,IND,550122,0,0,5,5,
Oklahoma,U.S. House,Al Mcaffrey,DEM,550122,0,0,347,347,05
Oklahoma,U.S. House,Steve Russell,REP,550122,0,0,135,135,05
Oklahoma,U.S. House,Buddy Ray,IND,550122,0,0,4,4,05
Oklahoma,U.S. House,Tom Boggs,IND,550122,0,0,7,7,05
Oklahoma,U.S. House,Robert Murphy,IND,550122,0,0,4,4,05
Oklahoma,State Senate,Anastasia Pittman,DEM,550122,0,0,391,391,48
Oklahoma,State Senate,Duane Crumbacher,REP,550122,0,0,106,106,48
Oklahoma,State House,George Young,DEM,550122,0,0,369,369,99
Oklahoma,State House,Willard Linzy,REP,550122,0,0,123,123,99
Oklahoma,Governor,Joe Dorman,DEM,550123,0,0,499,499,
Oklahoma,Governor,Mary Fallin,REP,550123,0,0,200,200,
Oklahoma,Governor,Kimberly Willis,IND,550123,0,0,6,6,
Oklahoma,Governor,Richard Prawdzienski,IND,550123,0,0,3,3,
Oklahoma,Lieutenant Governor,Cathy Cummings,DEM,550123,0,0,473,473,
Oklahoma,Lieutenant Governor,Todd Lamb,REP,550123,0,0,235,235,
Oklahoma,Superintendent of Public Instruction,John Cox,DEM,550123,0,0,501,501,
Oklahoma,Superintendent of Public Instruction,Joy Hofmeister,REP,550123,0,0,204,204,
Oklahoma,Commissioner of Labor,Mike Workman,DEM,550123,0,0,464,464,
Oklahoma,Commissioner of Labor,Mark Costello,REP,550123,0,0,234,234,
Oklahoma,U.S. Senate,Matt Silverstein,DEM,550123,0,0,448,448,
Oklahoma,U.S. Senate,Jim Inhofe,REP,550123,0,0,241,241,
Oklahoma,U.S. Senate,Aaron Delozier,IND,550123,0,0,4,4,
Oklahoma,U.S. Senate,Ray Woods,IND,550123,0,0,7,7,
Oklahoma,U.S. Senate,Joan Farr,IND,550123,0,0,5,5,
Oklahoma,U.S. Senate,Connie Johnson,DEM,550123,0,0,478,478,
Oklahoma,U.S. Senate,James Lankford,REP,550123,0,0,221,221,
Oklahoma,U.S. Senate,Mark Beard,IND,550123,0,0,9,9,
Oklahoma,U.S. House,Al Mcaffrey,DEM,550123,0,0,454,454,05
Oklahoma,U.S. House,Steve Russell,REP,550123,0,0,222,222,05
Oklahoma,U.S. House,Buddy Ray,IND,550123,0,0,7,7,05
Oklahoma,U.S. House,Tom Boggs,IND,550123,0,0,4,4,05
Oklahoma,U.S. House,Robert Murphy,IND,550123,0,0,14,14,05
Oklahoma,State Senate,Anastasia Pittman,DEM,550123,0,0,513,513,48
Oklahoma,State Senate,Duane Crumbacher,REP,550123,0,0,190,190,48
Oklahoma,State House,George Young,DEM,550123,0,0,474,474,99
Oklahoma,State House,Willard Linzy,REP,550123,0,0,228,228,99
Oklahoma,Governor,Joe Dorman,DEM,550124,0,0,368,368,
Oklahoma,Governor,Mary Fallin,REP,550124,0,0,251,251,
Oklahoma,Governor,Kimberly Willis,IND,550124,0,0,13,13,
Oklahoma,Governor,Richard Prawdzienski,IND,550124,0,0,4,4,
Oklahoma,Lieutenant Governor,Cathy Cummings,DEM,550124,0,0,347,347,
Oklahoma,Lieutenant Governor,Todd Lamb,REP,550124,0,0,290,290,
Oklahoma,Superintendent of Public Instruction,John Cox,DEM,550124,0,0,376,376,
Oklahoma,Superintendent of Public Instruction,Joy Hofmeister,REP,550124,0,0,251,251,
Oklahoma,Commissioner of Labor,Mike Workman,DEM,550124,0,0,350,350,
Oklahoma,Commissioner of Labor,Mark Costello,REP,550124,0,0,280,280,
Oklahoma,U.S. Senate,Matt Silverstein,DEM,550124,0,0,320,320,
Oklahoma,U.S. Senate,Jim Inhofe,REP,550124,0,0,292,292,
Oklahoma,U.S. Senate,Aaron Delozier,IND,550124,0,0,3,3,
Oklahoma,U.S. Senate,Ray Woods,IND,550124,0,0,11,11,
Oklahoma,U.S. Senate,Joan Farr,IND,550124,0,0,6,6,
Oklahoma,U.S. Senate,Connie Johnson,DEM,550124,0,0,333,333,
Oklahoma,U.S. Senate,James Lankford,REP,550124,0,0,287,287,
Oklahoma,U.S. Senate,Mark Beard,IND,550124,0,0,16,16,
Oklahoma,U.S. House,Al Mcaffrey,DEM,550124,0,0,327,327,05
Oklahoma,U.S. House,Steve Russell,REP,550124,0,0,284,284,05
Oklahoma,U.S. House,Buddy Ray,IND,550124,0,0,5,5,05
Oklahoma,U.S. House,Tom Boggs,IND,550124,0,0,5,5,05
Oklahoma,U.S. House,Robert Murphy,IND,550124,0,0,14,14,05
Oklahoma,State Senate,Anastasia Pittman,DEM,550124,0,0,369,369,48
Oklahoma,State Senate,Duane Crumbacher,REP,550124,0,0,254,254,48
Oklahoma,State House,Ed Holzberger,DEM,550124,0,0,325,325,83
Oklahoma,State House,Randy Mcdaniel,REP,550124,0,0,305,305,83
Oklahoma,Governor,Joe Dorman,DEM,550125,0,0,202,202,
Oklahoma,Governor,Mary Fallin,REP,550125,0,0,56,56,
Oklahoma,Governor,Kimberly Willis,IND,550125,0,0,7,7,
Oklahoma,Governor,Richard Prawdzienski,IND,550125,0,0,2,2,
Oklahoma,Lieutenant Governor,Cathy Cummings,DEM,550125,0,0,191,191,
Oklahoma,Lieutenant Governor,Todd Lamb,REP,550125,0,0,77,77,
Oklahoma,Superintendent of Public Instruction,John Cox,DEM,550125,0,0,190,190,
Oklahoma,Superintendent of Public Instruction,Joy Hofmeister,REP,550125,0,0,75,75,
Oklahoma,Commissioner of Labor,Mike Workman,DEM,550125,0,0,185,185,
Oklahoma,Commissioner of Labor,Mark Costello,REP,550125,0,0,77,77,
Oklahoma,U.S. Senate,Matt Silverstein,DEM,550125,0,0,175,175,
Oklahoma,U.S. Senate,Jim Inhofe,REP,550125,0,0,74,74,
Oklahoma,U.S. Senate,Aaron Delozier,IND,550125,0,0,1,1,
Oklahoma,U.S. Senate,Ray Woods,IND,550125,0,0,8,8,
Oklahoma,U.S. Senate,Joan Farr,IND,550125,0,0,5,5,
Oklahoma,U.S. Senate,Connie Johnson,DEM,550125,0,0,178,178,
Oklahoma,U.S. Senate,James Lankford,REP,550125,0,0,79,79,
Oklahoma,U.S. Senate,Mark Beard,IND,550125,0,0,10,10,
Oklahoma,U.S. House,Al Mcaffrey,DEM,550125,0,0,173,173,05
Oklahoma,U.S. House,Steve Russell,REP,550125,0,0,72,72,05
Oklahoma,U.S. House,Buddy Ray,IND,550125,0,0,7,7,05
Oklahoma,U.S. House,Tom Boggs,IND,550125,0,0,6,6,05
Oklahoma,U.S. House,Robert Murphy,IND,550125,0,0,7,7,05
Oklahoma,State Senate,Anastasia Pittman,DEM,550125,0,0,193,193,48
Oklahoma,State Senate,Duane Crumbacher,REP,550125,0,0,65,65,48
Oklahoma,State House,George Young,DEM,550125,0,0,194,194,99
Oklahoma,State House,Willard Linzy,REP,550125,0,0,64,64,99
Oklahoma,Governor,Joe Dorman,DEM,550126,0,0,400,400,
Oklahoma,Governor,Mary Fallin,REP,550126,0,0,153,153,
Oklahoma,Governor,Kimberly Willis,IND,550126,0,0,9,9,
Oklahoma,Governor,Richard Prawdzienski,IND,550126,0,0,4,4,
Oklahoma,Lieutenant Governor,Cathy Cummings,DEM,550126,0,0,364,364,
Oklahoma,Lieutenant Governor,Todd Lamb,REP,550126,0,0,199,199,
Oklahoma,Superintendent of Public Instruction,John Cox,DEM,550126,0,0,393,393,
Oklahoma,Superintendent of Public Instruction,Joy Hofmeister,REP,550126,0,0,167,167,
Oklahoma,Commissioner of Labor,Mike Workman,DEM,550126,0,0,365,365,
Oklahoma,Commissioner of Labor,Mark Costello,REP,550126,0,0,188,188,
Oklahoma,U.S. Senate,Matt Silverstein,DEM,550126,0,0,353,353,
Oklahoma,U.S. Senate,Jim Inhofe,REP,550126,0,0,192,192,
Oklahoma,U.S. Senate,Aaron Delozier,IND,550126,0,0,1,1,
Oklahoma,U.S. Senate,Ray Woods,IND,550126,0,0,7,7,
Oklahoma,U.S. Senate,Joan Farr,IND,550126,0,0,8,8,
Oklahoma,U.S. Senate,Connie Johnson,DEM,550126,0,0,364,364,
Oklahoma,U.S. Senate,James Lankford,REP,550126,0,0,187,187,
Oklahoma,U.S. Senate,Mark Beard,IND,550126,0,0,15,15,
Oklahoma,U.S. House,Al Mcaffrey,DEM,550126,0,0,359,359,05
Oklahoma,U.S. House,Steve Russell,REP,550126,0,0,179,179,05
Oklahoma,U.S. House,Buddy Ray,IND,550126,0,0,8,8,05
Oklahoma,U.S. House,Tom Boggs,IND,550126,0,0,6,6,05
Oklahoma,U.S. House,Robert Murphy,IND,550126,0,0,10,10,05
Oklahoma,State Senate,Anastasia Pittman,DEM,550126,0,0,388,388,48
Oklahoma,State Senate,Duane Crumbacher,REP,550126,0,0,165,165,48
Oklahoma,State House,Ed Holzberger,DEM,550126,0,0,361,361,83
Oklahoma,State House,Randy Mcdaniel,REP,550126,0,0,196,196,83
Oklahoma,Governor,Joe Dorman,DEM,550127,0,0,314,314,
Oklahoma,Governor,Mary Fallin,REP,550127,0,0,468,468,
Oklahoma,Governor,Kimberly Willis,IND,550127,0,0,9,9,
Oklahoma,Governor,Richard Prawdzienski,IND,550127,0,0,5,5,
Oklahoma,Lieutenant Governor,Cathy Cummings,DEM,550127,0,0,249,249,
Oklahoma,Lieutenant Governor,Todd Lamb,REP,550127,0,0,545,545,
Oklahoma,Superintendent of Public Instruction,John Cox,DEM,550127,0,0,317,317,
Oklahoma,Superintendent of Public Instruction,Joy Hofmeister,REP,550127,0,0,472,472,
Oklahoma,Commissioner of Labor,Mike Workman,DEM,550127,0,0,250,250,
Oklahoma,Commissioner of Labor,Mark Costello,REP,550127,0,0,526,526,
Oklahoma,U.S. Senate,Matt Silverstein,DEM,550127,0,0,240,240,
Oklahoma,U.S. Senate,Jim Inhofe,REP,550127,0,0,525,525,
Oklahoma,U.S. Senate,Aaron Delozier,IND,550127,0,0,6,6,
Oklahoma,U.S. Senate,Ray Woods,IND,550127,0,0,15,15,
Oklahoma,U.S. Senate,Joan Farr,IND,550127,0,0,8,8,
Oklahoma,U.S. Senate,Connie Johnson,DEM,550127,0,0,238,238,
Oklahoma,U.S. Senate,James Lankford,REP,550127,0,0,543,543,
Oklahoma,U.S. Senate,Mark Beard,IND,550127,0,0,16,16,
Oklahoma,U.S. House,Al Mcaffrey,DEM,550127,0,0,238,238,05
Oklahoma,U.S. House,Steve Russell,REP,550127,0,0,529,529,05
Oklahoma,U.S. House,Buddy Ray,IND,550127,0,0,11,11,05
Oklahoma,U.S. House,Tom Boggs,IND,550127,0,0,8,8,05
Oklahoma,U.S. House,Robert Murphy,IND,550127,0,0,6,6,05
Oklahoma,State House,Ed Holzberger,DEM,550127,0,0,239,239,83
Oklahoma,State House,Randy Mcdaniel,REP,550127,0,0,542,542,83
Oklahoma,Governor,Joe Dorman,DEM,550128,0,0,287,287,
Oklahoma,Governor,Mary Fallin,REP,550128,0,0,353,353,
Oklahoma,Governor,Kimberly Willis,IND,550128,0,0,18,18,
Oklahoma,Governor,Richard Prawdzienski,IND,550128,0,0,9,9,
Oklahoma,Lieutenant Governor,Cathy Cummings,DEM,550128,0,0,253,253,
Oklahoma,Lieutenant Governor,Todd Lamb,REP,550128,0,0,409,409,
Oklahoma,Superintendent of Public Instruction,John Cox,DEM,550128,0,0,308,308,
Oklahoma,Superintendent of Public Instruction,Joy Hofmeister,REP,550128,0,0,349,349,
Oklahoma,Commissioner of Labor,Mike Workman,DEM,550128,0,0,249,249,
Oklahoma,Commissioner of Labor,Mark Costello,REP,550128,0,0,407,407,
Oklahoma,U.S. Senate,Matt Silverstein,DEM,550128,0,0,235,235,
Oklahoma,U.S. Senate,Jim Inhofe,REP,550128,0,0,400,400,
Oklahoma,U.S. Senate,Aaron Delozier,IND,550128,0,0,8,8,
Oklahoma,U.S. Senate,Ray Woods,IND,550128,0,0,9,9,
Oklahoma,U.S. Senate,Joan Farr,IND,550128,0,0,8,8,
Oklahoma,U.S. Senate,Connie Johnson,DEM,550128,0,0,243,243,
Oklahoma,U.S. Senate,James Lankford,REP,550128,0,0,410,410,
Oklahoma,U.S. Senate,Mark Beard,IND,550128,0,0,13,13,
Oklahoma,U.S. House,Al Mcaffrey,DEM,550128,0,0,230,230,05
Oklahoma,U.S. House,Steve Russell,REP,550128,0,0,399,399,05
Oklahoma,U.S. House,Buddy Ray,IND,550128,0,0,5,5,05
Oklahoma,U.S. House,Tom Boggs,IND,550128,0,0,12,12,05
Oklahoma,U.S. House,Robert Murphy,IND,550128,0,0,13,13,05
Oklahoma,State House,Ed Holzberger,DEM,550128,0,0,235,235,83
Oklahoma,State House,Randy Mcdaniel,REP,550128,0,0,419,419,83
Oklahoma,Governor,Joe Dorman,DEM,550129,0,0,146,146,
Oklahoma,Governor,Mary Fallin,REP,550129,0,0,198,198,
Oklahoma,Governor,Kimberly Willis,IND,550129,0,0,3,3,
Oklahoma,Governor,Richard Prawdzienski,IND,550129,0,0,2,2,
Oklahoma,Lieutenant Governor,Cathy Cummings,DEM,550129,0,0,122,122,
Oklahoma,Lieutenant Governor,Todd Lamb,REP,550129,0,0,225,225,
Oklahoma,Superintendent of Public Instruction,John Cox,DEM,550129,0,0,147,147,
Oklahoma,Superintendent of Public Instruction,Joy Hofmeister,REP,550129,0,0,195,195,
Oklahoma,Commissioner of Labor,Mike Workman,DEM,550129,0,0,125,125,
Oklahoma,Commissioner of Labor,Mark Costello,REP,550129,0,0,214,214,
Oklahoma,U.S. Senate,Matt Silverstein,DEM,550129,0,0,122,122,
Oklahoma,U.S. Senate,Jim Inhofe,REP,550129,0,0,215,215,
Oklahoma,U.S. Senate,Aaron Delozier,IND,550129,0,0,3,3,
Oklahoma,U.S. Senate,Ray Woods,IND,550129,0,0,4,4,
Oklahoma,U.S. Senate,Joan Farr,IND,550129,0,0,1,1,
Oklahoma,U.S. Senate,Connie Johnson,DEM,550129,0,0,126,126,
Oklahoma,U.S. Senate,James Lankford,REP,550129,0,0,216,216,
Oklahoma,U.S. Senate,Mark Beard,IND,550129,0,0,7,7,
Oklahoma,U.S. House,Al Mcaffrey,DEM,550129,0,0,118,118,05
Oklahoma,U.S. House,Steve Russell,REP,550129,0,0,214,214,05
Oklahoma,U.S. House,Buddy Ray,IND,550129,0,0,1,1,05
Oklahoma,U.S. House,Tom Boggs,IND,550129,0,0,4,4,05
Oklahoma,U.S. House,Robert Murphy,IND,550129,0,0,5,5,05
Oklahoma,State House,Ed Holzberger,DEM,550129,0,0,123,123,83
Oklahoma,State House,Randy Mcdaniel,REP,550129,0,0,211,211,83
Oklahoma,Governor,Joe Dorman,DEM,550130,0,0,441,441,
Oklahoma,Governor,Mary Fallin,REP,550130,0,0,575,575,
Oklahoma,Governor,Kimberly Willis,IND,550130,0,0,11,11,
Oklahoma,Governor,Richard Prawdzienski,IND,550130,0,0,5,5,
Oklahoma,Lieutenant Governor,Cathy Cummings,DEM,550130,0,0,344,344,
Oklahoma,Lieutenant Governor,Todd Lamb,REP,550130,0,0,687,687,
Oklahoma,Superintendent of Public Instruction,John Cox,DEM,550130,0,0,428,428,
Oklahoma,Superintendent of Public Instruction,Joy Hofmeister,REP,550130,0,0,595,595,
Oklahoma,Commissioner of Labor,Mike Workman,DEM,550130,0,0,344,344,
Oklahoma,Commissioner of Labor,Mark Costello,REP,550130,0,0,659,659,
Oklahoma,U.S. Senate,Matt Silverstein,DEM,550130,0,0,336,336,
Oklahoma,U.S. Senate,Jim Inhofe,REP,550130,0,0,666,666,
Oklahoma,U.S. Senate,Aaron Delozier,IND,550130,0,0,7,7,
Oklahoma,U.S. Senate,Ray Woods,IND,550130,0,0,8,8,
Oklahoma,U.S. Senate,Joan Farr,IND,550130,0,0,9,9,
Oklahoma,U.S. Senate,Connie Johnson,DEM,550130,0,0,331,331,
Oklahoma,U.S. Senate,James Lankford,REP,550130,0,0,678,678,
Oklahoma,U.S. Senate,Mark Beard,IND,550130,0,0,23,23,
Oklahoma,U.S. House,Al Mcaffrey,DEM,550130,0,0,323,323,05
Oklahoma,U.S. House,Steve Russell,REP,550130,0,0,658,658,05
Oklahoma,U.S. House,Buddy Ray,IND,550130,0,0,7,7,05
Oklahoma,U.S. House,Tom Boggs,IND,550130,0,0,15,15,05
Oklahoma,U.S. House,Robert Murphy,IND,550130,0,0,18,18,05
Oklahoma,State House,Ed Holzberger,DEM,550130,0,0,341,341,83
Oklahoma,State House,Randy Mcdaniel,REP,550130,0,0,668,668,83
Oklahoma,Governor,Joe Dorman,DEM,550131,0,0,200,200,
Oklahoma,Governor,Mary Fallin,REP,550131,0,0,324,324,
Oklahoma,Governor,Kimberly Willis,IND,550131,0,0,8,8,
Oklahoma,Governor,Richard Prawdzienski,IND,550131,0,0,1,1,
Oklahoma,Lieutenant Governor,Cathy Cummings,DEM,550131,0,0,138,138,
Oklahoma,Lieutenant Governor,Todd Lamb,REP,550131,0,0,393,393,
Oklahoma,Superintendent of Public Instruction,John Cox,DEM,550131,0,0,201,201,
Oklahoma,Superintendent of Public Instruction,Joy Hofmeister,REP,550131,0,0,328,328,
Oklahoma,Commissioner of Labor,Mike Workman,DEM,550131,0,0,144,144,
Oklahoma,Commissioner of Labor,Mark Costello,REP,550131,0,0,379,379,
Oklahoma,U.S. Senate,Matt Silverstein,DEM,550131,0,0,137,137,
Oklahoma,U.S. Senate,Jim Inhofe,REP,550131,0,0,378,378,
Oklahoma,U.S. Senate,Aaron Delozier,IND,550131,0,0,2,2,
Oklahoma,U.S. Senate,Ray Woods,IND,550131,0,0,7,7,
Oklahoma,U.S. Senate,Joan Farr,IND,550131,0,0,5,5,
Oklahoma,U.S. Senate,Connie Johnson,DEM,550131,0,0,132,132,
Oklahoma,U.S. Senate,James Lankford,REP,550131,0,0,385,385,
Oklahoma,U.S. Senate,Mark Beard,IND,550131,0,0,17,17,
Oklahoma,U.S. House,Al Mcaffrey,DEM,550131,0,0,128,128,05
Oklahoma,U.S. House,Steve Russell,REP,550131,0,0,384,384,05
Oklahoma,U.S. House,Buddy Ray,IND,550131,0,0,5,5,05
Oklahoma,U.S. House,Tom Boggs,IND,550131,0,0,7,7,05
Oklahoma,U.S. House,Robert Murphy,IND,550131,0,0,6,6,05
Oklahoma,State House,Ed Holzberger,DEM,550131,0,0,136,136,83
Oklahoma,State House,Randy Mcdaniel,REP,550131,0,0,388,388,83
Oklahoma,Governor,Joe Dorman,DEM,550132,0,0,178,178,
Oklahoma,Governor,Mary Fallin,REP,550132,0,0,312,312,
Oklahoma,Governor,Kimberly Willis,IND,550132,0,0,6,6,
Oklahoma,Governor,Richard Prawdzienski,IND,550132,0,0,4,4,
Oklahoma,Lieutenant Governor,Cathy Cummings,DEM,550132,0,0,135,135,
Oklahoma,Lieutenant Governor,Todd Lamb,REP,550132,0,0,364,364,
Oklahoma,Superintendent of Public Instruction,John Cox,DEM,550132,0,0,168,168,
Oklahoma,Superintendent of Public Instruction,Joy Hofmeister,REP,550132,0,0,329,329,
Oklahoma,Commissioner of Labor,Mike Workman,DEM,550132,0,0,134,134,
Oklahoma,Commissioner of Labor,Mark Costello,REP,550132,0,0,356,356,
Oklahoma,U.S. Senate,Matt Silverstein,DEM,550132,0,0,119,119,
Oklahoma,U.S. Senate,Jim Inhofe,REP,550132,0,0,364,364,
Oklahoma,U.S. Senate,Aaron Delozier,IND,550132,0,0,2,2,
Oklahoma,U.S. Senate,Ray Woods,IND,550132,0,0,7,7,
Oklahoma,U.S. Senate,Joan Farr,IND,550132,0,0,3,3,
Oklahoma,U.S. Senate,Connie Johnson,DEM,550132,0,0,120,120,
Oklahoma,U.S. Senate,James Lankford,REP,550132,0,0,364,364,
Oklahoma,U.S. Senate,Mark Beard,IND,550132,0,0,14,14,
Oklahoma,U.S. House,Al Mcaffrey,DEM,550132,0,0,129,129,05
Oklahoma,U.S. House,Steve Russell,REP,550132,0,0,350,350,05
Oklahoma,U.S. House,Buddy Ray,IND,550132,0,0,2,2,05
Oklahoma,U.S. House,Tom Boggs,IND,550132,0,0,7,7,05
Oklahoma,U.S. House,Robert Murphy,IND,550132,0,0,8,8,05
Oklahoma,State House,Ed Holzberger,DEM,550132,0,0,127,127,83
Oklahoma,State House,Randy Mcdaniel,REP,550132,0,0,360,360,83
Oklahoma,Governor,Joe Dorman,DEM,550133,0,0,219,219,
Oklahoma,Governor,Mary Fallin,REP,550133,0,0,289,289,
Oklahoma,Governor,Kimberly Willis,IND,550133,0,0,9,9,
Oklahoma,Governor,Richard Prawdzienski,IND,550133,0,0,7,7,
Oklahoma,Lieutenant Governor,Cathy Cummings,DEM,550133,0,0,166,166,
Oklahoma,Lieutenant Governor,Todd Lamb,REP,550133,0,0,352,352,
Oklahoma,Superintendent of Public Instruction,John Cox,DEM,550133,0,0,197,197,
Oklahoma,Superintendent of Public Instruction,Joy Hofmeister,REP,550133,0,0,316,316,
Oklahoma,Commissioner of Labor,Mike Workman,DEM,550133,0,0,170,170,
Oklahoma,Commissioner of Labor,Mark Costello,REP,550133,0,0,336,336,
Oklahoma,U.S. Senate,Matt Silverstein,DEM,550133,0,0,154,154,
Oklahoma,U.S. Senate,Jim Inhofe,REP,550133,0,0,343,343,
Oklahoma,U.S. Senate,Aaron Delozier,IND,550133,0,0,8,8,
Oklahoma,U.S. Senate,Ray Woods,IND,550133,0,0,5,5,
Oklahoma,U.S. Senate,Joan Farr,IND,550133,0,0,8,8,
Oklahoma,U.S. Senate,Connie Johnson,DEM,550133,0,0,159,159,
Oklahoma,U.S. Senate,James Lankford,REP,550133,0,0,349,349,
Oklahoma,U.S. Senate,Mark Beard,IND,550133,0,0,14,14,
Oklahoma,U.S. House,Al Mcaffrey,DEM,550133,0,0,150,150,05
Oklahoma,U.S. House,Steve Russell,REP,550133,0,0,340,340,05
Oklahoma,U.S. House,Buddy Ray,IND,550133,0,0,4,4,05
Oklahoma,U.S. House,Tom Boggs,IND,550133,0,0,7,7,05
Oklahoma,U.S. House,Robert Murphy,IND,550133,0,0,10,10,05
Oklahoma,Governor,Joe Dorman,DEM,550134,0,0,415,415,
Oklahoma,Governor,Mary Fallin,REP,550134,0,0,693,693,
Oklahoma,Governor,Kimberly Willis,IND,550134,0,0,19,19,
Oklahoma,Governor,Richard Prawdzienski,IND,550134,0,0,12,12,
Oklahoma,Lieutenant Governor,Cathy Cummings,DEM,550134,0,0,309,309,
Oklahoma,Lieutenant Governor,Todd Lamb,REP,550134,0,0,822,822,
Oklahoma,Superintendent of Public Instruction,John Cox,DEM,550134,0,0,418,418,
Oklahoma,Superintendent of Public Instruction,Joy Hofmeister,REP,550134,0,0,709,709,
Oklahoma,Commissioner of Labor,Mike Workman,DEM,550134,0,0,298,298,
Oklahoma,Commissioner of Labor,Mark Costello,REP,550134,0,0,804,804,
Oklahoma,U.S. Senate,Matt Silverstein,DEM,550134,0,0,300,300,
Oklahoma,U.S. Senate,Jim Inhofe,REP,550134,0,0,801,801,
Oklahoma,U.S. Senate,Aaron Delozier,IND,550134,0,0,10,10,
Oklahoma,U.S. Senate,Ray Woods,IND,550134,0,0,6,6,
Oklahoma,U.S. Senate,Joan Farr,IND,550134,0,0,11,11,
Oklahoma,U.S. Senate,Connie Johnson,DEM,550134,0,0,287,287,
Oklahoma,U.S. Senate,James Lankford,REP,550134,0,0,821,821,
Oklahoma,U.S. Senate,Mark Beard,IND,550134,0,0,25,25,
Oklahoma,U.S. House,Al Mcaffrey,DEM,550134,0,0,287,287,05
Oklahoma,U.S. House,Steve Russell,REP,550134,0,0,802,802,05
Oklahoma,U.S. House,Buddy Ray,IND,550134,0,0,9,9,05
Oklahoma,U.S. House,Tom Boggs,IND,550134,0,0,12,12,05
Oklahoma,U.S. House,Robert Murphy,IND,550134,0,0,11,11,05
Oklahoma,Governor,Joe Dorman,DEM,550135,0,0,127,127,
Oklahoma,Governor,Mary Fallin,REP,550135,0,0,163,163,
Oklahoma,Governor,Kimberly Willis,IND,550135,0,0,4,4,
Oklahoma,Governor,Richard Prawdzienski,IND,550135,0,0,5,5,
Oklahoma,Lieutenant Governor,Cathy Cummings,DEM,550135,0,0,86,86,
Oklahoma,Lieutenant Governor,Todd Lamb,REP,550135,0,0,213,213,
Oklahoma,Superintendent of Public Instruction,John Cox,DEM,550135,0,0,116,116,
Oklahoma,Superintendent of Public Instruction,Joy Hofmeister,REP,550135,0,0,183,183,
Oklahoma,Commissioner of Labor,Mike Workman,DEM,550135,0,0,84,84,
Oklahoma,Commissioner of Labor,Mark Costello,REP,550135,0,0,207,207,
Oklahoma,U.S. Senate,Matt Silverstein,DEM,550135,0,0,86,86,
Oklahoma,U.S. Senate,Jim Inhofe,REP,550135,0,0,205,205,
Oklahoma,U.S. Senate,Aaron Delozier,IND,550135,0,0,1,1,
Oklahoma,U.S. Senate,Ray Woods,IND,550135,0,0,1,1,
Oklahoma,U.S. Senate,Joan Farr,IND,550135,0,0,1,1,
Oklahoma,U.S. Senate,Connie Johnson,DEM,550135,0,0,80,80,
Oklahoma,U.S. Senate,James Lankford,REP,550135,0,0,214,214,
Oklahoma,U.S. Senate,Mark Beard,IND,550135,0,0,4,4,
Oklahoma,U.S. House,Al Mcaffrey,DEM,550135,0,0,85,85,05
Oklahoma,U.S. House,Steve Russell,REP,550135,0,0,209,209,05
Oklahoma,U.S. House,Buddy Ray,IND,550135,0,0,1,1,05
Oklahoma,U.S. House,Tom Boggs,IND,550135,0,0,1,1,05
Oklahoma,U.S. House,Robert Murphy,IND,550135,0,0,1,1,05
Oklahoma,Governor,Joe Dorman,DEM,550136,0,0,466,466,
Oklahoma,Governor,Mary Fallin,REP,550136,0,0,630,630,
Oklahoma,Governor,Kimberly Willis,IND,550136,0,0,12,12,
Oklahoma,Governor,Richard Prawdzienski,IND,550136,0,0,5,5,
Oklahoma,Lieutenant Governor,Cathy Cummings,DEM,550136,0,0,326,326,
Oklahoma,Lieutenant Governor,Todd Lamb,REP,550136,0,0,787,787,
Oklahoma,Superintendent of Public Instruction,John Cox,DEM,550136,0,0,410,410,
Oklahoma,Superintendent of Public Instruction,Joy Hofmeister,REP,550136,0,0,700,700,
Oklahoma,Commissioner of Labor,Mike Workman,DEM,550136,0,0,313,313,
Oklahoma,Commissioner of Labor,Mark Costello,REP,550136,0,0,765,765,
Oklahoma,U.S. Senate,Matt Silverstein,DEM,550136,0,0,295,295,
Oklahoma,U.S. Senate,Jim Inhofe,REP,550136,0,0,789,789,
Oklahoma,U.S. Senate,Aaron Delozier,IND,550136,0,0,6,6,
Oklahoma,U.S. Senate,Ray Woods,IND,550136,0,0,5,5,
Oklahoma,U.S. Senate,Joan Farr,IND,550136,0,0,11,11,
Oklahoma,U.S. Senate,Connie Johnson,DEM,550136,0,0,273,273,
Oklahoma,U.S. Senate,James Lankford,REP,550136,0,0,823,823,
Oklahoma,U.S. Senate,Mark Beard,IND,550136,0,0,16,16,
Oklahoma,U.S. House,Al Mcaffrey,DEM,550136,0,0,300,300,05
Oklahoma,U.S. House,Steve Russell,REP,550136,0,0,767,767,05
Oklahoma,U.S. House,Buddy Ray,IND,550136,0,0,12,12,05
Oklahoma,U.S. House,Tom Boggs,IND,550136,0,0,9,9,05
Oklahoma,U.S. House,Robert Murphy,IND,550136,0,0,10,10,05
Oklahoma,Governor,Joe Dorman,DEM,550137,0,0,173,173,
Oklahoma,Governor,Mary Fallin,REP,550137,0,0,481,481,
Oklahoma,Governor,Kimberly Willis,IND,550137,0,0,7,7,
Oklahoma,Governor,Richard Prawdzienski,IND,550137,0,0,7,7,
Oklahoma,Lieutenant Governor,Cathy Cummings,DEM,550137,0,0,101,101,
Oklahoma,Lieutenant Governor,Todd Lamb,REP,550137,0,0,566,566,
Oklahoma,Superintendent of Public Instruction,John Cox,DEM,550137,0,0,178,178,
Oklahoma,Superintendent of Public Instruction,Joy Hofmeister,REP,550137,0,0,486,486,
Oklahoma,Commissioner of Labor,Mike Workman,DEM,550137,0,0,103,103,
Oklahoma,Commissioner of Labor,Mark Costello,REP,550137,0,0,551,551,
Oklahoma,U.S. Senate,Matt Silverstein,DEM,550137,0,0,86,86,
Oklahoma,U.S. Senate,Jim Inhofe,REP,550137,0,0,563,563,
Oklahoma,U.S. Senate,Aaron Delozier,IND,550137,0,0,7,7,
Oklahoma,U.S. Senate,Ray Woods,IND,550137,0,0,3,3,
Oklahoma,U.S. Senate,Joan Farr,IND,550137,0,0,4,4,
Oklahoma,U.S. Senate,Connie Johnson,DEM,550137,0,0,86,86,
Oklahoma,U.S. Senate,James Lankford,REP,550137,0,0,570,570,
Oklahoma,U.S. Senate,Mark Beard,IND,550137,0,0,11,11,
Oklahoma,U.S. House,Al Mcaffrey,DEM,550137,0,0,88,88,05
Oklahoma,U.S. House,Steve Russell,REP,550137,0,0,554,554,05
Oklahoma,U.S. House,Buddy Ray,IND,550137,0,0,3,3,05
Oklahoma,U.S. House,Tom Boggs,IND,550137,0,0,5,5,05
Oklahoma,U.S. House,Robert Murphy,IND,550137,0,0,6,6,05
Oklahoma,Governor,Joe Dorman,DEM,550138,0,0,87,87,
Oklahoma,Governor,Mary Fallin,REP,550138,0,0,218,218,
Oklahoma,Governor,Kimberly Willis,IND,550138,0,0,5,5,
Oklahoma,Governor,Richard Prawdzienski,IND,550138,0,0,1,1,
Oklahoma,Lieutenant Governor,Cathy Cummings,DEM,550138,0,0,53,53,
Oklahoma,Lieutenant Governor,Todd Lamb,REP,550138,0,0,262,262,
Oklahoma,Superintendent of Public Instruction,John Cox,DEM,550138,0,0,93,93,
Oklahoma,Superintendent of Public Instruction,Joy Hofmeister,REP,550138,0,0,220,220,
Oklahoma,Commissioner of Labor,Mike Workman,DEM,550138,0,0,62,62,
Oklahoma,Commissioner of Labor,Mark Costello,REP,550138,0,0,244,244,
Oklahoma,U.S. Senate,Matt Silverstein,DEM,550138,0,0,56,56,
Oklahoma,U.S. Senate,Jim Inhofe,REP,550138,0,0,250,250,
Oklahoma,U.S. Senate,Aaron Delozier,IND,550138,0,0,1,1,
Oklahoma,U.S. Senate,Ray Woods,IND,550138,0,0,3,3,
Oklahoma,U.S. Senate,Joan Farr,IND,550138,0,0,3,3,
Oklahoma,U.S. Senate,Connie Johnson,DEM,550138,0,0,50,50,
Oklahoma,U.S. Senate,James Lankford,REP,550138,0,0,257,257,
Oklahoma,U.S. Senate,Mark Beard,IND,550138,0,0,7,7,
Oklahoma,U.S. House,Al Mcaffrey,DEM,550138,0,0,48,48,05
Oklahoma,U.S. House,Steve Russell,REP,550138,0,0,256,256,05
Oklahoma,U.S. House,Buddy Ray,IND,550138,0,0,2,2,05
Oklahoma,U.S. House,Tom Boggs,IND,550138,0,0,4,4,05
Oklahoma,U.S. House,Robert Murphy,IND,550138,0,0,2,2,05
Oklahoma,Governor,Joe Dorman,DEM,550139,0,0,442,442,
Oklahoma,Governor,Mary Fallin,REP,550139,0,0,712,712,
Oklahoma,Governor,Kimberly Willis,IND,550139,0,0,18,18,
Oklahoma,Governor,Richard Prawdzienski,IND,550139,0,0,7,7,
Oklahoma,Lieutenant Governor,Cathy Cummings,DEM,550139,0,0,283,283,
Oklahoma,Lieutenant Governor,Todd Lamb,REP,550139,0,0,894,894,
Oklahoma,Superintendent of Public Instruction,John Cox,DEM,550139,0,0,428,428,
Oklahoma,Superintendent of Public Instruction,Joy Hofmeister,REP,550139,0,0,744,744,
Oklahoma,Commissioner of Labor,Mike Workman,DEM,550139,0,0,270,270,
Oklahoma,Commissioner of Labor,Mark Costello,REP,550139,0,0,872,872,
Oklahoma,U.S. Senate,Matt Silverstein,DEM,550139,0,0,246,246,
Oklahoma,U.S. Senate,Jim Inhofe,REP,550139,0,0,891,891,
Oklahoma,U.S. Senate,Aaron Delozier,IND,550139,0,0,11,11,
Oklahoma,U.S. Senate,Ray Woods,IND,550139,0,0,8,8,
Oklahoma,U.S. Senate,Joan Farr,IND,550139,0,0,11,11,
Oklahoma,U.S. Senate,Connie Johnson,DEM,550139,0,0,266,266,
Oklahoma,U.S. Senate,James Lankford,REP,550139,0,0,885,885,
Oklahoma,U.S. Senate,Mark Beard,IND,550139,0,0,25,25,
Oklahoma,U.S. House,Al Mcaffrey,DEM,550139,0,0,268,268,05
Oklahoma,U.S. House,Steve Russell,REP,550139,0,0,859,859,05
Oklahoma,U.S. House,Buddy Ray,IND,550139,0,0,7,7,05
Oklahoma,U.S. House,Tom Boggs,IND,550139,0,0,10,10,05
Oklahoma,U.S. House,Robert Murphy,IND,550139,0,0,12,12,05
Oklahoma,Governor,Joe Dorman,DEM,550140,0,0,168,168,
Oklahoma,Governor,Mary Fallin,REP,550140,0,0,387,387,
Oklahoma,Governor,Kimberly Willis,IND,550140,0,0,4,4,
Oklahoma,Governor,Richard Prawdzienski,IND,550140,0,0,3,3,
Oklahoma,Lieutenant Governor,Cathy Cummings,DEM,550140,0,0,136,136,
Oklahoma,Lieutenant Governor,Todd Lamb,REP,550140,0,0,425,425,
Oklahoma,Superintendent of Public Instruction,John Cox,DEM,550140,0,0,164,164,
Oklahoma,Superintendent of Public Instruction,Joy Hofmeister,REP,550140,0,0,395,395,
Oklahoma,Commissioner of Labor,Mike Workman,DEM,550140,0,0,114,114,
Oklahoma,Commissioner of Labor,Mark Costello,REP,550140,0,0,434,434,
Oklahoma,U.S. Senate,Matt Silverstein,DEM,550140,0,0,118,118,
Oklahoma,U.S. Senate,Jim Inhofe,REP,550140,0,0,427,427,
Oklahoma,U.S. Senate,Aaron Delozier,IND,550140,0,0,3,3,
Oklahoma,U.S. Senate,Ray Woods,IND,550140,0,0,3,3,
Oklahoma,U.S. Senate,Joan Farr,IND,550140,0,0,6,6,
Oklahoma,U.S. Senate,Connie Johnson,DEM,550140,0,0,109,109,
Oklahoma,U.S. Senate,James Lankford,REP,550140,0,0,444,444,
Oklahoma,U.S. Senate,Mark Beard,IND,550140,0,0,7,7,
Oklahoma,U.S. House,Al Mcaffrey,DEM,550140,0,0,112,112,05
Oklahoma,U.S. House,Steve Russell,REP,550140,0,0,428,428,05
Oklahoma,U.S. House,Buddy Ray,IND,550140,0,0,3,3,05
Oklahoma,U.S. House,Tom Boggs,IND,550140,0,0,3,3,05
Oklahoma,U.S. House,Robert Murphy,IND,550140,0,0,8,8,05
Oklahoma,Governor,Joe Dorman,DEM,550141,0,0,333,333,
Oklahoma,Governor,Mary Fallin,REP,550141,0,0,557,557,
Oklahoma,Governor,Kimberly Willis,IND,550141,0,0,13,13,
Oklahoma,Governor,Richard Prawdzienski,IND,550141,0,0,8,8,
Oklahoma,Lieutenant Governor,Cathy Cummings,DEM,550141,0,0,254,254,
Oklahoma,Lieutenant Governor,Todd Lamb,REP,550141,0,0,655,655,
Oklahoma,Superintendent of Public Instruction,John Cox,DEM,550141,0,0,353,353,
Oklahoma,Superintendent of Public Instruction,Joy Hofmeister,REP,550141,0,0,551,551,
Oklahoma,Commissioner of Labor,Mike Workman,DEM,550141,0,0,256,256,
Oklahoma,Commissioner of Labor,Mark Costello,REP,550141,0,0,627,627,
Oklahoma,U.S. Senate,Matt Silverstein,DEM,550141,0,0,225,225,
Oklahoma,U.S. Senate,Jim Inhofe,REP,550141,0,0,652,652,
Oklahoma,U.S. Senate,Aaron Delozier,IND,550141,0,0,11,11,
Oklahoma,U.S. Senate,Ray Woods,IND,550141,0,0,6,6,
Oklahoma,U.S. Senate,Joan Farr,IND,550141,0,0,6,6,
Oklahoma,U.S. Senate,Connie Johnson,DEM,550141,0,0,229,229,
Oklahoma,U.S. Senate,James Lankford,REP,550141,0,0,658,658,
Oklahoma,U.S. Senate,Mark Beard,IND,550141,0,0,20,20,
Oklahoma,U.S. House,Al Mcaffrey,DEM,550141,0,0,225,225,05
Oklahoma,U.S. House,Steve Russell,REP,550141,0,0,647,647,05
Oklahoma,U.S. House,Buddy Ray,IND,550141,0,0,4,4,05
Oklahoma,U.S. House,Tom Boggs,IND,550141,0,0,12,12,05
Oklahoma,U.S. House,Robert Murphy,IND,550141,0,0,12,12,05
Oklahoma,Governor,Joe Dorman,DEM,550142,0,0,512,512,
Oklahoma,Governor,Mary Fallin,REP,550142,0,0,643,643,
Oklahoma,Governor,Kimberly Willis,IND,550142,0,0,16,16,
Oklahoma,Governor,Richard Prawdzienski,IND,550142,0,0,16,16,
Oklahoma,Lieutenant Governor,Cathy Cummings,DEM,550142,0,0,409,409,
Oklahoma,Lieutenant Governor,Todd Lamb,REP,550142,0,0,774,774,
Oklahoma,Superintendent of Public Instruction,John Cox,DEM,550142,0,0,540,540,
Oklahoma,Superintendent of Public Instruction,Joy Hofmeister,REP,550142,0,0,634,634,
Oklahoma,Commissioner of Labor,Mike Workman,DEM,550142,0,0,419,419,
Oklahoma,Commissioner of Labor,Mark Costello,REP,550142,0,0,724,724,
Oklahoma,U.S. Senate,Matt Silverstein,DEM,550142,0,0,388,388,
Oklahoma,U.S. Senate,Jim Inhofe,REP,550142,0,0,746,746,
Oklahoma,U.S. Senate,Aaron Delozier,IND,550142,0,0,12,12,
Oklahoma,U.S. Senate,Ray Woods,IND,550142,0,0,16,16,
Oklahoma,U.S. Senate,Joan Farr,IND,550142,0,0,18,18,
Oklahoma,U.S. Senate,Connie Johnson,DEM,550142,0,0,394,394,
Oklahoma,U.S. Senate,James Lankford,REP,550142,0,0,754,754,
Oklahoma,U.S. Senate,Mark Beard,IND,550142,0,0,30,30,
Oklahoma,U.S. House,Al Mcaffrey,DEM,550142,0,0,401,401,05
Oklahoma,U.S. House,Steve Russell,REP,550142,0,0,731,731,05
Oklahoma,U.S. House,Buddy Ray,IND,550142,0,0,12,12,05
Oklahoma,U.S. House,Tom Boggs,IND,550142,0,0,14,14,05
Oklahoma,U.S. House,Robert Murphy,IND,550142,0,0,11,11,05
Oklahoma,Governor,Joe Dorman,DEM,550143,0,0,223,223,
Oklahoma,Governor,Mary Fallin,REP,550143,0,0,501,501,
Oklahoma,Governor,Kimberly Willis,IND,550143,0,0,11,11,
Oklahoma,Governor,Richard Prawdzienski,IND,550143,0,0,4,4,
Oklahoma,Lieutenant Governor,Cathy Cummings,DEM,550143,0,0,183,183,
Oklahoma,Lieutenant Governor,Todd Lamb,REP,550143,0,0,553,553,
Oklahoma,Superintendent of Public Instruction,John Cox,DEM,550143,0,0,239,239,
Oklahoma,Superintendent of Public Instruction,Joy Hofmeister,REP,550143,0,0,490,490,
Oklahoma,Commissioner of Labor,Mike Workman,DEM,550143,0,0,180,180,
Oklahoma,Commissioner of Labor,Mark Costello,REP,550143,0,0,541,541,
Oklahoma,U.S. Senate,Matt Silverstein,DEM,550143,0,0,163,163,
Oklahoma,U.S. Senate,Jim Inhofe,REP,550143,0,0,546,546,
Oklahoma,U.S. Senate,Aaron Delozier,IND,550143,0,0,6,6,
Oklahoma,U.S. Senate,Ray Woods,IND,550143,0,0,8,8,
Oklahoma,U.S. Senate,Joan Farr,IND,550143,0,0,7,7,
Oklahoma,U.S. Senate,Connie Johnson,DEM,550143,0,0,163,163,
Oklahoma,U.S. Senate,James Lankford,REP,550143,0,0,565,565,
Oklahoma,U.S. Senate,Mark Beard,IND,550143,0,0,12,12,
Oklahoma,U.S. House,Al Mcaffrey,DEM,550143,0,0,163,163,05
Oklahoma,U.S. House,Steve Russell,REP,550143,0,0,550,550,05
Oklahoma,U.S. House,Buddy Ray,IND,550143,0,0,9,9,05
Oklahoma,U.S. House,Tom Boggs,IND,550143,0,0,3,3,05
Oklahoma,U.S. House,Robert Murphy,IND,550143,0,0,7,7,05
Oklahoma,Governor,Joe Dorman,DEM,550144,0,0,260,260,
Oklahoma,Governor,Mary Fallin,REP,550144,0,0,471,471,
Oklahoma,Governor,Kimberly Willis,IND,550144,0,0,9,9,
Oklahoma,Governor,Richard Prawdzienski,IND,550144,0,0,4,4,
Oklahoma,Lieutenant Governor,Cathy Cummings,DEM,550144,0,0,230,230,
Oklahoma,Lieutenant Governor,Todd Lamb,REP,550144,0,0,516,516,
Oklahoma,Superintendent of Public Instruction,John Cox,DEM,550144,0,0,280,280,
Oklahoma,Superintendent of Public Instruction,Joy Hofmeister,REP,550144,0,0,464,464,
Oklahoma,Commissioner of Labor,Mike Workman,DEM,550144,0,0,212,212,
Oklahoma,Commissioner of Labor,Mark Costello,REP,550144,0,0,520,520,
Oklahoma,U.S. Senate,Matt Silverstein,DEM,550144,0,0,208,208,
Oklahoma,U.S. Senate,Jim Inhofe,REP,550144,0,0,506,506,
Oklahoma,U.S. Senate,Aaron Delozier,IND,550144,0,0,7,7,
Oklahoma,U.S. Senate,Ray Woods,IND,550144,0,0,7,7,
Oklahoma,U.S. Senate,Joan Farr,IND,550144,0,0,9,9,
Oklahoma,U.S. Senate,Connie Johnson,DEM,550144,0,0,198,198,
Oklahoma,U.S. Senate,James Lankford,REP,550144,0,0,532,532,
Oklahoma,U.S. Senate,Mark Beard,IND,550144,0,0,15,15,
Oklahoma,U.S. House,Al Mcaffrey,DEM,550144,0,0,200,200,05
Oklahoma,U.S. House,Steve Russell,REP,550144,0,0,526,526,05
Oklahoma,U.S. House,Buddy Ray,IND,550144,0,0,1,1,05
Oklahoma,U.S. House,Tom Boggs,IND,550144,0,0,11,11,05
Oklahoma,U.S. House,Robert Murphy,IND,550144,0,0,4,4,05
Oklahoma,Governor,Joe Dorman,DEM,550145,0,0,224,224,
Oklahoma,Governor,Mary Fallin,REP,550145,0,0,481,481,
Oklahoma,Governor,Kimberly Willis,IND,550145,0,0,6,6,
Oklahoma,Governor,Richard Prawdzienski,IND,550145,0,0,3,3,
Oklahoma,Lieutenant Governor,Cathy Cummings,DEM,550145,0,0,180,180,
Oklahoma,Lieutenant Governor,Todd Lamb,REP,550145,0,0,535,535,
Oklahoma,Superintendent of Public Instruction,John Cox,DEM,550145,0,0,234,234,
Oklahoma,Superintendent of Public Instruction,Joy Hofmeister,REP,550145,0,0,478,478,
Oklahoma,Commissioner of Labor,Mike Workman,DEM,550145,0,0,161,161,
Oklahoma,Commissioner of Labor,Mark Costello,REP,550145,0,0,539,539,
Oklahoma,U.S. Senate,Matt Silverstein,DEM,550145,0,0,162,162,
Oklahoma,U.S. Senate,Jim Inhofe,REP,550145,0,0,535,535,
Oklahoma,U.S. Senate,Aaron Delozier,IND,550145,0,0,5,5,
Oklahoma,U.S. Senate,Ray Woods,IND,550145,0,0,4,4,
Oklahoma,U.S. Senate,Joan Farr,IND,550145,0,0,2,2,
Oklahoma,U.S. Senate,Connie Johnson,DEM,550145,0,0,158,158,
Oklahoma,U.S. Senate,James Lankford,REP,550145,0,0,545,545,
Oklahoma,U.S. Senate,Mark Beard,IND,550145,0,0,11,11,
Oklahoma,U.S. House,Al Mcaffrey,DEM,550145,0,0,157,157,05
Oklahoma,U.S. House,Steve Russell,REP,550145,0,0,542,542,05
Oklahoma,U.S. House,Buddy Ray,IND,550145,0,0,5,5,05
Oklahoma,U.S. House,Tom Boggs,IND,550145,0,0,4,4,05
Oklahoma,U.S. House,Robert Murphy,IND,550145,0,0,4,4,05
Oklahoma,State House,Ed Holzberger,DEM,550145,0,0,145,145,83
Oklahoma,State House,Randy Mcdaniel,REP,550145,0,0,562,562,83
Oklahoma,Governor,Joe Dorman,DEM,550146,0,0,359,359,
Oklahoma,Governor,Mary Fallin,REP,550146,0,0,650,650,
Oklahoma,Governor,Kimberly Willis,IND,550146,0,0,23,23,
Oklahoma,Governor,Richard Prawdzienski,IND,550146,0,0,7,7,
Oklahoma,Lieutenant Governor,Cathy Cummings,DEM,550146,0,0,327,327,
Oklahoma,Lieutenant Governor,Todd Lamb,REP,550146,0,0,711,711,
Oklahoma,Superintendent of Public Instruction,John Cox,DEM,550146,0,0,367,367,
Oklahoma,Superintendent of Public Instruction,Joy Hofmeister,REP,550146,0,0,665,665,
Oklahoma,Commissioner of Labor,Mike Workman,DEM,550146,0,0,284,284,
Oklahoma,Commissioner of Labor,Mark Costello,REP,550146,0,0,736,736,
Oklahoma,U.S. Senate,Matt Silverstein,DEM,550146,0,0,273,273,
Oklahoma,U.S. Senate,Jim Inhofe,REP,550146,0,0,727,727,
Oklahoma,U.S. Senate,Aaron Delozier,IND,550146,0,0,9,9,
Oklahoma,U.S. Senate,Ray Woods,IND,550146,0,0,8,8,
Oklahoma,U.S. Senate,Joan Farr,IND,550146,0,0,17,17,
Oklahoma,U.S. Senate,Connie Johnson,DEM,550146,0,0,271,271,
Oklahoma,U.S. Senate,James Lankford,REP,550146,0,0,739,739,
Oklahoma,U.S. Senate,Mark Beard,IND,550146,0,0,31,31,
Oklahoma,U.S. House,Al Mcaffrey,DEM,550146,0,0,273,273,05
Oklahoma,U.S. House,Steve Russell,REP,550146,0,0,727,727,05
Oklahoma,U.S. House,Buddy Ray,IND,550146,0,0,12,12,05
Oklahoma,U.S. House,Tom Boggs,IND,550146,0,0,9,9,05
Oklahoma,U.S. House,Robert Murphy,IND,550146,0,0,11,11,05
Oklahoma,State House,Cyndi Munson,DEM,550146,0,0,346,346,85
Oklahoma,State House,David Dank,REP,550146,0,0,690,690,85
Oklahoma,Governor,Joe Dorman,DEM,550147,0,0,132,132,
Oklahoma,Governor,Mary Fallin,REP,550147,0,0,217,217,
Oklahoma,Governor,Kimberly Willis,IND,550147,0,0,7,7,
Oklahoma,Governor,Richard Prawdzienski,IND,550147,0,0,6,6,
Oklahoma,Lieutenant Governor,Cathy Cummings,DEM,550147,0,0,107,107,
Oklahoma,Lieutenant Governor,Todd Lamb,REP,550147,0,0,255,255,
Oklahoma,Superintendent of Public Instruction,John Cox,DEM,550147,0,0,136,136,
Oklahoma,Superintendent of Public Instruction,Joy Hofmeister,REP,550147,0,0,222,222,
Oklahoma,Commissioner of Labor,Mike Workman,DEM,550147,0,0,102,102,
Oklahoma,Commissioner of Labor,Mark Costello,REP,550147,0,0,246,246,
Oklahoma,U.S. Senate,Matt Silverstein,DEM,550147,0,0,101,101,
Oklahoma,U.S. Senate,Jim Inhofe,REP,550147,0,0,248,248,
Oklahoma,U.S. Senate,Aaron Delozier,IND,550147,0,0,1,1,
Oklahoma,U.S. Senate,Ray Woods,IND,550147,0,0,2,2,
Oklahoma,U.S. Senate,Joan Farr,IND,550147,0,0,7,7,
Oklahoma,U.S. Senate,Connie Johnson,DEM,550147,0,0,109,109,
Oklahoma,U.S. Senate,James Lankford,REP,550147,0,0,246,246,
Oklahoma,U.S. Senate,Mark Beard,IND,550147,0,0,9,9,
Oklahoma,U.S. House,Al Mcaffrey,DEM,550147,0,0,109,109,05
Oklahoma,U.S. House,Steve Russell,REP,550147,0,0,240,240,05
Oklahoma,U.S. House,Buddy Ray,IND,550147,0,0,1,1,05
Oklahoma,U.S. House,Tom Boggs,IND,550147,0,0,4,4,05
Oklahoma,U.S. House,Robert Murphy,IND,550147,0,0,7,7,05
Oklahoma,State House,Cyndi Munson,DEM,550147,0,0,125,125,85
Oklahoma,State House,David Dank,REP,550147,0,0,232,232,85
Oklahoma,Governor,Joe Dorman,DEM,550148,0,0,409,409,
Oklahoma,Governor,Mary Fallin,REP,550148,0,0,591,591,
Oklahoma,Governor,Kimberly Willis,IND,550148,0,0,23,23,
Oklahoma,Governor,Richard Prawdzienski,IND,550148,0,0,13,13,
Oklahoma,Lieutenant Governor,Cathy Cummings,DEM,550148,0,0,341,341,
Oklahoma,Lieutenant Governor,Todd Lamb,REP,550148,0,0,690,690,
Oklahoma,Superintendent of Public Instruction,John Cox,DEM,550148,0,0,446,446,
Oklahoma,Superintendent of Public Instruction,Joy Hofmeister,REP,550148,0,0,575,575,
Oklahoma,Commissioner of Labor,Mike Workman,DEM,550148,0,0,331,331,
Oklahoma,Commissioner of Labor,Mark Costello,REP,550148,0,0,671,671,
Oklahoma,U.S. Senate,Matt Silverstein,DEM,550148,0,0,311,311,
Oklahoma,U.S. Senate,Jim Inhofe,REP,550148,0,0,689,689,
Oklahoma,U.S. Senate,Aaron Delozier,IND,550148,0,0,7,7,
Oklahoma,U.S. Senate,Ray Woods,IND,550148,0,0,7,7,
Oklahoma,U.S. Senate,Joan Farr,IND,550148,0,0,15,15,
Oklahoma,U.S. Senate,Connie Johnson,DEM,550148,0,0,307,307,
Oklahoma,U.S. Senate,James Lankford,REP,550148,0,0,693,693,
Oklahoma,U.S. Senate,Mark Beard,IND,550148,0,0,35,35,
Oklahoma,U.S. House,Al Mcaffrey,DEM,550148,0,0,316,316,05
Oklahoma,U.S. House,Steve Russell,REP,550148,0,0,685,685,05
Oklahoma,U.S. House,Buddy Ray,IND,550148,0,0,7,7,05
Oklahoma,U.S. House,Tom Boggs,IND,550148,0,0,11,11,05
Oklahoma,U.S. House,Robert Murphy,IND,550148,0,0,9,9,05
Oklahoma,Governor,Joe Dorman,DEM,550149,0,0,355,355,
Oklahoma,Governor,Mary Fallin,REP,550149,0,0,825,825,
Oklahoma,Governor,Kimberly Willis,IND,550149,0,0,11,11,
Oklahoma,Governor,Richard Prawdzienski,IND,550149,0,0,4,4,
Oklahoma,Lieutenant Governor,Cathy Cummings,DEM,550149,0,0,254,254,
Oklahoma,Lieutenant Governor,Todd Lamb,REP,550149,0,0,942,942,
Oklahoma,Superintendent of Public Instruction,John Cox,DEM,550149,0,0,383,383,
Oklahoma,Superintendent of Public Instruction,Joy Hofmeister,REP,550149,0,0,804,804,
Oklahoma,Commissioner of Labor,Mike Workman,DEM,550149,0,0,273,273,
Oklahoma,Commissioner of Labor,Mark Costello,REP,550149,0,0,893,893,
Oklahoma,U.S. Senate,Matt Silverstein,DEM,550149,0,0,247,247,
Oklahoma,U.S. Senate,Jim Inhofe,REP,550149,0,0,920,920,
Oklahoma,U.S. Senate,Aaron Delozier,IND,550149,0,0,9,9,
Oklahoma,U.S. Senate,Ray Woods,IND,550149,0,0,7,7,
Oklahoma,U.S. Senate,Joan Farr,IND,550149,0,0,7,7,
Oklahoma,U.S. Senate,Connie Johnson,DEM,550149,0,0,233,233,
Oklahoma,U.S. Senate,James Lankford,REP,550149,0,0,945,945,
Oklahoma,U.S. Senate,Mark Beard,IND,550149,0,0,22,22,
Oklahoma,U.S. House,Al Mcaffrey,DEM,550149,0,0,243,243,05
Oklahoma,U.S. House,Steve Russell,REP,550149,0,0,923,923,05
Oklahoma,U.S. House,Buddy Ray,IND,550149,0,0,5,5,05
Oklahoma,U.S. House,Tom Boggs,IND,550149,0,0,9,9,05
Oklahoma,U.S. House,Robert Murphy,IND,550149,0,0,8,8,05
Oklahoma,Governor,Joe Dorman,DEM,550150,0,0,433,433,
Oklahoma,Governor,Mary Fallin,REP,550150,0,0,616,616,
Oklahoma,Governor,Kimberly Willis,IND,550150,0,0,23,23,
Oklahoma,Governor,Richard Prawdzienski,IND,550150,0,0,5,5,
Oklahoma,Lieutenant Governor,Cathy Cummings,DEM,550150,0,0,346,346,
Oklahoma,Lieutenant Governor,Todd Lamb,REP,550150,0,0,721,721,
Oklahoma,Superintendent of Public Instruction,John Cox,DEM,550150,0,0,457,457,
Oklahoma,Superintendent of Public Instruction,Joy Hofmeister,REP,550150,0,0,605,605,
Oklahoma,Commissioner of Labor,Mike Workman,DEM,550150,0,0,349,349,
Oklahoma,Commissioner of Labor,Mark Costello,REP,550150,0,0,688,688,
Oklahoma,U.S. Senate,Matt Silverstein,DEM,550150,0,0,312,312,
Oklahoma,U.S. Senate,Jim Inhofe,REP,550150,0,0,705,705,
Oklahoma,U.S. Senate,Aaron Delozier,IND,550150,0,0,11,11,
Oklahoma,U.S. Senate,Ray Woods,IND,550150,0,0,11,11,
Oklahoma,U.S. Senate,Joan Farr,IND,550150,0,0,20,20,
Oklahoma,U.S. Senate,Connie Johnson,DEM,550150,0,0,321,321,
Oklahoma,U.S. Senate,James Lankford,REP,550150,0,0,722,722,
Oklahoma,U.S. Senate,Mark Beard,IND,550150,0,0,27,27,
Oklahoma,U.S. House,Al Mcaffrey,DEM,550150,0,0,310,310,05
Oklahoma,U.S. House,Steve Russell,REP,550150,0,0,706,706,05
Oklahoma,U.S. House,Buddy Ray,IND,550150,0,0,6,6,05
Oklahoma,U.S. House,Tom Boggs,IND,550150,0,0,20,20,05
Oklahoma,U.S. House,Robert Murphy,IND,550150,0,0,16,16,05
Oklahoma,State House,Donald Smith,DEM,550150,0,0,338,338,10
Oklahoma,State House,Elise Hall,REP,550150,0,0,712,712,10
Oklahoma,Governor,Joe Dorman,DEM,550151,0,0,424,424,
Oklahoma,Governor,Mary Fallin,REP,550151,0,0,585,585,
Oklahoma,Governor,Kimberly Willis,IND,550151,0,0,18,18,
Oklahoma,Governor,Richard Prawdzienski,IND,550151,0,0,13,13,
Oklahoma,Lieutenant Governor,Cathy Cummings,DEM,550151,0,0,358,358,
Oklahoma,Lieutenant Governor,Todd Lamb,REP,550151,0,0,679,679,
Oklahoma,Superintendent of Public Instruction,John Cox,DEM,550151,0,0,447,447,
Oklahoma,Superintendent of Public Instruction,Joy Hofmeister,REP,550151,0,0,586,586,
Oklahoma,Commissioner of Labor,Mike Workman,DEM,550151,0,0,355,355,
Oklahoma,Commissioner of Labor,Mark Costello,REP,550151,0,0,666,666,
Oklahoma,U.S. Senate,Matt Silverstein,DEM,550151,0,0,327,327,
Oklahoma,U.S. Senate,Jim Inhofe,REP,550151,0,0,670,670,
Oklahoma,U.S. Senate,Aaron Delozier,IND,550151,0,0,13,13,
Oklahoma,U.S. Senate,Ray Woods,IND,550151,0,0,11,11,
Oklahoma,U.S. Senate,Joan Farr,IND,550151,0,0,12,12,
Oklahoma,U.S. Senate,Connie Johnson,DEM,550151,0,0,329,329,
Oklahoma,U.S. Senate,James Lankford,REP,550151,0,0,686,686,
Oklahoma,U.S. Senate,Mark Beard,IND,550151,0,0,25,25,
Oklahoma,U.S. House,Al Mcaffrey,DEM,550151,0,0,320,320,05
Oklahoma,U.S. House,Steve Russell,REP,550151,0,0,684,684,05
Oklahoma,U.S. House,Buddy Ray,IND,550151,0,0,4,4,05
Oklahoma,U.S. House,Tom Boggs,IND,550151,0,0,12,12,05
Oklahoma,U.S. House,Robert Murphy,IND,550151,0,0,11,11,05
Oklahoma,State House,Donald Smith,DEM,550151,0,0,362,362,10
Oklahoma,State House,Elise Hall,REP,550151,0,0,663,663,10
Oklahoma,Governor,Joe Dorman,DEM,550152,0,0,381,381,
Oklahoma,Governor,Mary Fallin,REP,550152,0,0,547,547,
Oklahoma,Governor,Kimberly Willis,IND,550152,0,0,19,19,
Oklahoma,Governor,Richard Prawdzienski,IND,550152,0,0,17,17,
Oklahoma,Lieutenant Governor,Cathy Cummings,DEM,550152,0,0,289,289,
Oklahoma,Lieutenant Governor,Todd Lamb,REP,550152,0,0,669,669,
Oklahoma,Superintendent of Public Instruction,John Cox,DEM,550152,0,0,398,398,
Oklahoma,Superintendent of Public Instruction,Joy Hofmeister,REP,550152,0,0,554,554,
Oklahoma,Commissioner of Labor,Mike Workman,DEM,550152,0,0,306,306,
Oklahoma,Commissioner of Labor,Mark Costello,REP,550152,0,0,632,632,
Oklahoma,U.S. Senate,Matt Silverstein,DEM,550152,0,0,271,271,
Oklahoma,U.S. Senate,Jim Inhofe,REP,550152,0,0,664,664,
Oklahoma,U.S. Senate,Aaron Delozier,IND,550152,0,0,8,8,
Oklahoma,U.S. Senate,Ray Woods,IND,550152,0,0,6,6,
Oklahoma,U.S. Senate,Joan Farr,IND,550152,0,0,9,9,
Oklahoma,U.S. Senate,Connie Johnson,DEM,550152,0,0,274,274,
Oklahoma,U.S. Senate,James Lankford,REP,550152,0,0,656,656,
Oklahoma,U.S. Senate,Mark Beard,IND,550152,0,0,30,30,
Oklahoma,U.S. House,Al Mcaffrey,DEM,550152,0,0,276,276,05
Oklahoma,U.S. House,Steve Russell,REP,550152,0,0,654,654,05
Oklahoma,U.S. House,Buddy Ray,IND,550152,0,0,8,8,05
Oklahoma,U.S. House,Tom Boggs,IND,550152,0,0,9,9,05
Oklahoma,U.S. House,Robert Murphy,IND,550152,0,0,5,5,05
Oklahoma,State House,Donald Smith,DEM,550152,0,0,298,298,10
Oklahoma,State House,Elise Hall,REP,550152,0,0,650,650,10
Oklahoma,Governor,Joe Dorman,DEM,550153,0,0,437,437,
Oklahoma,Governor,Mary Fallin,REP,550153,0,0,741,741,
Oklahoma,Governor,Kimberly Willis,IND,550153,0,0,20,20,
Oklahoma,Governor,Richard Prawdzienski,IND,550153,0,0,8,8,
Oklahoma,Lieutenant Governor,Cathy Cummings,DEM,550153,0,0,357,357,
Oklahoma,Lieutenant Governor,Todd Lamb,REP,550153,0,0,844,844,
Oklahoma,Superintendent of Public Instruction,John Cox,DEM,550153,0,0,479,479,
Oklahoma,Superintendent of Public Instruction,Joy Hofmeister,REP,550153,0,0,709,709,
Oklahoma,Commissioner of Labor,Mike Workman,DEM,550153,0,0,358,358,
Oklahoma,Commissioner of Labor,Mark Costello,REP,550153,0,0,810,810,
Oklahoma,U.S. Senate,Matt Silverstein,DEM,550153,0,0,319,319,
Oklahoma,U.S. Senate,Jim Inhofe,REP,550153,0,0,847,847,
Oklahoma,U.S. Senate,Aaron Delozier,IND,550153,0,0,7,7,
Oklahoma,U.S. Senate,Ray Woods,IND,550153,0,0,6,6,
Oklahoma,U.S. Senate,Joan Farr,IND,550153,0,0,15,15,
Oklahoma,U.S. Senate,Connie Johnson,DEM,550153,0,0,313,313,
Oklahoma,U.S. Senate,James Lankford,REP,550153,0,0,860,860,
Oklahoma,U.S. Senate,Mark Beard,IND,550153,0,0,33,33,
Oklahoma,U.S. House,Al Mcaffrey,DEM,550153,0,0,317,317,05
Oklahoma,U.S. House,Steve Russell,REP,550153,0,0,818,818,05
Oklahoma,U.S. House,Buddy Ray,IND,550153,0,0,14,14,05
Oklahoma,U.S. House,Tom Boggs,IND,550153,0,0,19,19,05
Oklahoma,U.S. House,Robert Murphy,IND,550153,0,0,20,20,05
Oklahoma,State House,Donald Smith,DEM,550153,0,0,363,363,10
Oklahoma,State House,Elise Hall,REP,550153,0,0,813,813,10
Oklahoma,Governor,Joe Dorman,DEM,550154,0,0,548,548,
Oklahoma,Governor,Mary Fallin,REP,550154,0,0,759,759,
Oklahoma,Governor,Kimberly Willis,IND,550154,0,0,21,21,
Oklahoma,Governor,Richard Prawdzienski,IND,550154,0,0,17,17,
Oklahoma,Lieutenant Governor,Cathy Cummings,DEM,550154,0,0,450,450,
Oklahoma,Lieutenant Governor,Todd Lamb,REP,550154,0,0,894,894,
Oklahoma,Superintendent of Public Instruction,John Cox,DEM,550154,0,0,585,585,
Oklahoma,Superintendent of Public Instruction,Joy Hofmeister,REP,550154,0,0,748,748,
Oklahoma,Commissioner of Labor,Mike Workman,DEM,550154,0,0,451,451,
Oklahoma,Commissioner of Labor,Mark Costello,REP,550154,0,0,853,853,
Oklahoma,U.S. Senate,Matt Silverstein,DEM,550154,0,0,403,403,
Oklahoma,U.S. Senate,Jim Inhofe,REP,550154,0,0,880,880,
Oklahoma,U.S. Senate,Aaron Delozier,IND,550154,0,0,15,15,
Oklahoma,U.S. Senate,Ray Woods,IND,550154,0,0,18,18,
Oklahoma,U.S. Senate,Joan Farr,IND,550154,0,0,21,21,
Oklahoma,U.S. Senate,Connie Johnson,DEM,550154,0,0,425,425,
Oklahoma,U.S. Senate,James Lankford,REP,550154,0,0,882,882,
Oklahoma,U.S. Senate,Mark Beard,IND,550154,0,0,38,38,
Oklahoma,U.S. House,Al Mcaffrey,DEM,550154,0,0,417,417,05
Oklahoma,U.S. House,Steve Russell,REP,550154,0,0,869,869,05
Oklahoma,U.S. House,Buddy Ray,IND,550154,0,0,10,10,05
Oklahoma,U.S. House,Tom Boggs,IND,550154,0,0,19,19,05
Oklahoma,U.S. House,Robert Murphy,IND,550154,0,0,12,12,05
Oklahoma,State House,Cyndi Munson,DEM,550154,0,0,524,524,85
Oklahoma,State House,David Dank,REP,550154,0,0,804,804,85
Oklahoma,Governor,Joe Dorman,DEM,550155,0,0,141,141,
Oklahoma,Governor,Mary Fallin,REP,550155,0,0,181,181,
Oklahoma,Governor,Kimberly Willis,IND,550155,0,0,2,2,
Oklahoma,Governor,Richard Prawdzienski,IND,550155,0,0,3,3,
Oklahoma,Lieutenant Governor,Cathy Cummings,DEM,550155,0,0,113,113,
Oklahoma,Lieutenant Governor,Todd Lamb,REP,550155,0,0,212,212,
Oklahoma,Superintendent of Public Instruction,John Cox,DEM,550155,0,0,152,152,
Oklahoma,Superintendent of Public Instruction,Joy Hofmeister,REP,550155,0,0,174,174,
Oklahoma,Commissioner of Labor,Mike Workman,DEM,550155,0,0,114,114,
Oklahoma,Commissioner of Labor,Mark Costello,REP,550155,0,0,205,205,
Oklahoma,U.S. Senate,Matt Silverstein,DEM,550155,0,0,100,100,
Oklahoma,U.S. Senate,Jim Inhofe,REP,550155,0,0,221,221,
Oklahoma,U.S. Senate,Aaron Delozier,IND,550155,0,0,0,0,
Oklahoma,U.S. Senate,Ray Woods,IND,550155,0,0,3,3,
Oklahoma,U.S. Senate,Joan Farr,IND,550155,0,0,2,2,
Oklahoma,U.S. Senate,Connie Johnson,DEM,550155,0,0,101,101,
Oklahoma,U.S. Senate,James Lankford,REP,550155,0,0,214,214,
Oklahoma,U.S. Senate,Mark Beard,IND,550155,0,0,10,10,
Oklahoma,U.S. House,Al Mcaffrey,DEM,550155,0,0,100,100,05
Oklahoma,U.S. House,Steve Russell,REP,550155,0,0,213,213,05
Oklahoma,U.S. House,Buddy Ray,IND,550155,0,0,2,2,05
Oklahoma,U.S. House,Tom Boggs,IND,550155,0,0,3,3,05
Oklahoma,U.S. House,Robert Murphy,IND,550155,0,0,5,5,05
Oklahoma,State House,Cyndi Munson,DEM,550155,0,0,126,126,85
Oklahoma,State House,David Dank,REP,550155,0,0,197,197,85
Oklahoma,Governor,Joe Dorman,DEM,550156,0,0,444,444,
Oklahoma,Governor,Mary Fallin,REP,550156,0,0,508,508,
Oklahoma,Governor,Kimberly Willis,IND,550156,0,0,15,15,
Oklahoma,Governor,Richard Prawdzienski,IND,550156,0,0,6,6,
Oklahoma,Lieutenant Governor,Cathy Cummings,DEM,550156,0,0,385,385,
Oklahoma,Lieutenant Governor,Todd Lamb,REP,550156,0,0,582,582,
Oklahoma,Superintendent of Public Instruction,John Cox,DEM,550156,0,0,468,468,
Oklahoma,Superintendent of Public Instruction,Joy Hofmeister,REP,550156,0,0,497,497,
Oklahoma,Commissioner of Labor,Mike Workman,DEM,550156,0,0,406,406,
Oklahoma,Commissioner of Labor,Mark Costello,REP,550156,0,0,544,544,
Oklahoma,U.S. Senate,Matt Silverstein,DEM,550156,0,0,374,374,
Oklahoma,U.S. Senate,Jim Inhofe,REP,550156,0,0,567,567,
Oklahoma,U.S. Senate,Aaron Delozier,IND,550156,0,0,9,9,
Oklahoma,U.S. Senate,Ray Woods,IND,550156,0,0,10,10,
Oklahoma,U.S. Senate,Joan Farr,IND,550156,0,0,7,7,
Oklahoma,U.S. Senate,Connie Johnson,DEM,550156,0,0,378,378,
Oklahoma,U.S. Senate,James Lankford,REP,550156,0,0,568,568,
Oklahoma,U.S. Senate,Mark Beard,IND,550156,0,0,22,22,
Oklahoma,U.S. House,Al Mcaffrey,DEM,550156,0,0,368,368,05
Oklahoma,U.S. House,Steve Russell,REP,550156,0,0,556,556,05
Oklahoma,U.S. House,Buddy Ray,IND,550156,0,0,11,11,05
Oklahoma,U.S. House,Tom Boggs,IND,550156,0,0,15,15,05
Oklahoma,U.S. House,Robert Murphy,IND,550156,0,0,14,14,05
Oklahoma,State House,Cyndi Munson,DEM,550156,0,0,443,443,85
Oklahoma,State House,David Dank,REP,550156,0,0,518,518,85
Oklahoma,Governor,Joe Dorman,DEM,550157,0,0,18,18,
Oklahoma,Governor,Mary Fallin,REP,550157,0,0,9,9,
Oklahoma,Governor,Kimberly Willis,IND,550157,0,0,1,1,
Oklahoma,Governor,Richard Prawdzienski,IND,550157,0,0,0,0,
Oklahoma,Lieutenant Governor,Cathy Cummings,DEM,550157,0,0,18,18,
Oklahoma,Lieutenant Governor,Todd Lamb,REP,550157,0,0,10,10,
Oklahoma,Superintendent of Public Instruction,John Cox,DEM,550157,0,0,21,21,
Oklahoma,Superintendent of Public Instruction,Joy Hofmeister,REP,550157,0,0,7,7,
Oklahoma,Commissioner of Labor,Mike Workman,DEM,550157,0,0,19,19,
Oklahoma,Commissioner of Labor,Mark Costello,REP,550157,0,0,9,9,
Oklahoma,U.S. Senate,Matt Silverstein,DEM,550157,0,0,18,18,
Oklahoma,U.S. Senate,Jim Inhofe,REP,550157,0,0,9,9,
Oklahoma,U.S. Senate,Aaron Delozier,IND,550157,0,0,0,0,
Oklahoma,U.S. Senate,Ray Woods,IND,550157,0,0,0,0,
Oklahoma,U.S. Senate,Joan Farr,IND,550157,0,0,1,1,
Oklahoma,U.S. Senate,Connie Johnson,DEM,550157,0,0,18,18,
Oklahoma,U.S. Senate,James Lankford,REP,550157,0,0,8,8,
Oklahoma,U.S. Senate,Mark Beard,IND,550157,0,0,2,2,
Oklahoma,U.S. House,Al Mcaffrey,DEM,550157,0,0,18,18,05
Oklahoma,U.S. House,Steve Russell,REP,550157,0,0,9,9,05
Oklahoma,U.S. House,Buddy Ray,IND,550157,0,0,0,0,05
Oklahoma,U.S. House,Tom Boggs,IND,550157,0,0,0,0,05
Oklahoma,U.S. House,Robert Murphy,IND,550157,0,0,1,1,05
Oklahoma,State House,Donald Smith,DEM,550157,0,0,18,18,10
Oklahoma,State House,Elise Hall,REP,550157,0,0,10,10,10
Oklahoma,Governor,Joe Dorman,DEM,550158,0,0,311,311,
Oklahoma,Governor,Mary Fallin,REP,550158,0,0,380,380,
Oklahoma,Governor,Kimberly Willis,IND,550158,0,0,18,18,
Oklahoma,Governor,Richard Prawdzienski,IND,550158,0,0,7,7,
Oklahoma,Lieutenant Governor,Cathy Cummings,DEM,550158,0,0,276,276,
Oklahoma,Lieutenant Governor,Todd Lamb,REP,550158,0,0,441,441,
Oklahoma,Superintendent of Public Instruction,John Cox,DEM,550158,0,0,321,321,
Oklahoma,Superintendent of Public Instruction,Joy Hofmeister,REP,550158,0,0,391,391,
Oklahoma,Commissioner of Labor,Mike Workman,DEM,550158,0,0,285,285,
Oklahoma,Commissioner of Labor,Mark Costello,REP,550158,0,0,417,417,
Oklahoma,U.S. Senate,Matt Silverstein,DEM,550158,0,0,250,250,
Oklahoma,U.S. Senate,Jim Inhofe,REP,550158,0,0,438,438,
Oklahoma,U.S. Senate,Aaron Delozier,IND,550158,0,0,4,4,
Oklahoma,U.S. Senate,Ray Woods,IND,550158,0,0,10,10,
Oklahoma,U.S. Senate,Joan Farr,IND,550158,0,0,9,9,
Oklahoma,U.S. Senate,Connie Johnson,DEM,550158,0,0,267,267,
Oklahoma,U.S. Senate,James Lankford,REP,550158,0,0,433,433,
Oklahoma,U.S. Senate,Mark Beard,IND,550158,0,0,19,19,
Oklahoma,U.S. House,Al Mcaffrey,DEM,550158,0,0,263,263,05
Oklahoma,U.S. House,Steve Russell,REP,550158,0,0,420,420,05
Oklahoma,U.S. House,Buddy Ray,IND,550158,0,0,10,10,05
Oklahoma,U.S. House,Tom Boggs,IND,550158,0,0,10,10,05
Oklahoma,U.S. House,Robert Murphy,IND,550158,0,0,10,10,05
Oklahoma,State House,Donald Smith,DEM,550158,0,0,277,277,10
Oklahoma,State House,Elise Hall,REP,550158,0,0,430,430,10
Oklahoma,Governor,Joe Dorman,DEM,550159,0,0,415,415,
Oklahoma,Governor,Mary Fallin,REP,550159,0,0,425,425,
Oklahoma,Governor,Kimberly Willis,IND,550159,0,0,16,16,
Oklahoma,Governor,Richard Prawdzienski,IND,550159,0,0,14,14,
Oklahoma,Lieutenant Governor,Cathy Cummings,DEM,550159,0,0,347,347,
Oklahoma,Lieutenant Governor,Todd Lamb,REP,550159,0,0,523,523,
Oklahoma,Superintendent of Public Instruction,John Cox,DEM,550159,0,0,425,425,
Oklahoma,Superintendent of Public Instruction,Joy Hofmeister,REP,550159,0,0,441,441,
Oklahoma,Commissioner of Labor,Mike Workman,DEM,550159,0,0,366,366,
Oklahoma,Commissioner of Labor,Mark Costello,REP,550159,0,0,482,482,
Oklahoma,U.S. Senate,Matt Silverstein,DEM,550159,0,0,300,300,
Oklahoma,U.S. Senate,Jim Inhofe,REP,550159,0,0,516,516,
Oklahoma,U.S. Senate,Aaron Delozier,IND,550159,0,0,19,19,
Oklahoma,U.S. Senate,Ray Woods,IND,550159,0,0,14,14,
Oklahoma,U.S. Senate,Joan Farr,IND,550159,0,0,12,12,
Oklahoma,U.S. Senate,Connie Johnson,DEM,550159,0,0,332,332,
Oklahoma,U.S. Senate,James Lankford,REP,550159,0,0,506,506,
Oklahoma,U.S. Senate,Mark Beard,IND,550159,0,0,29,29,
Oklahoma,U.S. House,Al Mcaffrey,DEM,550159,0,0,318,318,05
Oklahoma,U.S. House,Steve Russell,REP,550159,0,0,497,497,05
Oklahoma,U.S. House,Buddy Ray,IND,550159,0,0,9,9,05
Oklahoma,U.S. House,Tom Boggs,IND,550159,0,0,18,18,05
Oklahoma,U.S. House,Robert Murphy,IND,550159,0,0,23,23,05
Oklahoma,State House,Donald Smith,DEM,550159,0,0,345,345,10
Oklahoma,State House,Elise Hall,REP,550159,0,0,515,515,10
Oklahoma,Governor,Joe Dorman,DEM,550160,0,0,220,220,
Oklahoma,Governor,Mary Fallin,REP,550160,0,0,602,602,
Oklahoma,Governor,Kimberly Willis,IND,550160,0,0,12,12,
Oklahoma,Governor,Richard Prawdzienski,IND,550160,0,0,1,1,
Oklahoma,Lieutenant Governor,Cathy Cummings,DEM,550160,0,0,166,166,
Oklahoma,Lieutenant Governor,Todd Lamb,REP,550160,0,0,669,669,
Oklahoma,Superintendent of Public Instruction,John Cox,DEM,550160,0,0,251,251,
Oklahoma,Superintendent of Public Instruction,Joy Hofmeister,REP,550160,0,0,573,573,
Oklahoma,Commissioner of Labor,Mike Workman,DEM,550160,0,0,176,176,
Oklahoma,Commissioner of Labor,Mark Costello,REP,550160,0,0,637,637,
Oklahoma,U.S. Senate,Matt Silverstein,DEM,550160,0,0,141,141,
Oklahoma,U.S. Senate,Jim Inhofe,REP,550160,0,0,668,668,
Oklahoma,U.S. Senate,Aaron Delozier,IND,550160,0,0,4,4,
Oklahoma,U.S. Senate,Ray Woods,IND,550160,0,0,1,1,
Oklahoma,U.S. Senate,Joan Farr,IND,550160,0,0,14,14,
Oklahoma,U.S. Senate,Connie Johnson,DEM,550160,0,0,142,142,
Oklahoma,U.S. Senate,James Lankford,REP,550160,0,0,680,680,
Oklahoma,U.S. Senate,Mark Beard,IND,550160,0,0,12,12,
Oklahoma,U.S. House,Al Mcaffrey,DEM,550160,0,0,151,151,05
Oklahoma,U.S. House,Steve Russell,REP,550160,0,0,657,657,05
Oklahoma,U.S. House,Buddy Ray,IND,550160,0,0,5,5,05
Oklahoma,U.S. House,Tom Boggs,IND,550160,0,0,6,6,05
Oklahoma,U.S. House,Robert Murphy,IND,550160,0,0,7,7,05
Oklahoma,State House,Donald Smith,DEM,550160,0,0,176,176,10
Oklahoma,State House,Elise Hall,REP,550160,0,0,640,640,10
Oklahoma,Governor,Joe Dorman,DEM,550161,0,0,261,261,
Oklahoma,Governor,Mary Fallin,REP,550161,0,0,184,184,
Oklahoma,Governor,Kimberly Willis,IND,550161,0,0,15,15,
Oklahoma,Governor,Richard Prawdzienski,IND,550161,0,0,9,9,
Oklahoma,Lieutenant Governor,Cathy Cummings,DEM,550161,0,0,236,236,
Oklahoma,Lieutenant Governor,Todd Lamb,REP,550161,0,0,230,230,
Oklahoma,Superintendent of Public Instruction,John Cox,DEM,550161,0,0,265,265,
Oklahoma,Superintendent of Public Instruction,Joy Hofmeister,REP,550161,0,0,202,202,
Oklahoma,Commissioner of Labor,Mike Workman,DEM,550161,0,0,248,248,
Oklahoma,Commissioner of Labor,Mark Costello,REP,550161,0,0,212,212,
Oklahoma,U.S. Senate,Matt Silverstein,DEM,550161,0,0,223,223,
Oklahoma,U.S. Senate,Jim Inhofe,REP,550161,0,0,216,216,
Oklahoma,U.S. Senate,Aaron Delozier,IND,550161,0,0,5,5,
Oklahoma,U.S. Senate,Ray Woods,IND,550161,0,0,7,7,
Oklahoma,U.S. Senate,Joan Farr,IND,550161,0,0,15,15,
Oklahoma,U.S. Senate,Connie Johnson,DEM,550161,0,0,235,235,
Oklahoma,U.S. Senate,James Lankford,REP,550161,0,0,217,217,
Oklahoma,U.S. Senate,Mark Beard,IND,550161,0,0,12,12,
Oklahoma,U.S. House,Al Mcaffrey,DEM,550161,0,0,220,220,05
Oklahoma,U.S. House,Steve Russell,REP,550161,0,0,220,220,05
Oklahoma,U.S. House,Buddy Ray,IND,550161,0,0,4,4,05
Oklahoma,U.S. House,Tom Boggs,IND,550161,0,0,12,12,05
Oklahoma,U.S. House,Robert Murphy,IND,550161,0,0,9,9,05
Oklahoma,State House,Donald Smith,DEM,550161,0,0,250,250,10
Oklahoma,State House,Elise Hall,REP,550161,0,0,213,213,10
Oklahoma,Governor,Joe Dorman,DEM,550162,0,0,185,185,
Oklahoma,Governor,Mary Fallin,REP,550162,0,0,366,366,
Oklahoma,Governor,Kimberly Willis,IND,550162,0,0,10,10,
Oklahoma,Governor,Richard Prawdzienski,IND,550162,0,0,9,9,
Oklahoma,Lieutenant Governor,Cathy Cummings,DEM,550162,0,0,158,158,
Oklahoma,Lieutenant Governor,Todd Lamb,REP,550162,0,0,412,412,
Oklahoma,Superintendent of Public Instruction,John Cox,DEM,550162,0,0,203,203,
Oklahoma,Superintendent of Public Instruction,Joy Hofmeister,REP,550162,0,0,357,357,
Oklahoma,Commissioner of Labor,Mike Workman,DEM,550162,0,0,153,153,
Oklahoma,Commissioner of Labor,Mark Costello,REP,550162,0,0,401,401,
Oklahoma,U.S. Senate,Matt Silverstein,DEM,550162,0,0,130,130,
Oklahoma,U.S. Senate,Jim Inhofe,REP,550162,0,0,420,420,
Oklahoma,U.S. Senate,Aaron Delozier,IND,550162,0,0,9,9,
Oklahoma,U.S. Senate,Ray Woods,IND,550162,0,0,4,4,
Oklahoma,U.S. Senate,Joan Farr,IND,550162,0,0,4,4,
Oklahoma,U.S. Senate,Connie Johnson,DEM,550162,0,0,132,132,
Oklahoma,U.S. Senate,James Lankford,REP,550162,0,0,428,428,
Oklahoma,U.S. Senate,Mark Beard,IND,550162,0,0,12,12,
Oklahoma,U.S. House,Al Mcaffrey,DEM,550162,0,0,145,145,05
Oklahoma,U.S. House,Steve Russell,REP,550162,0,0,395,395,05
Oklahoma,U.S. House,Buddy Ray,IND,550162,0,0,8,8,05
Oklahoma,U.S. House,Tom Boggs,IND,550162,0,0,5,5,05
Oklahoma,U.S. House,Robert Murphy,IND,550162,0,0,5,5,05
Oklahoma,Governor,Joe Dorman,DEM,550163,0,0,256,256,
Oklahoma,Governor,Mary Fallin,REP,550163,0,0,292,292,
Oklahoma,Governor,Kimberly Willis,IND,550163,0,0,6,6,
Oklahoma,Governor,Richard Prawdzienski,IND,550163,0,0,11,11,
Oklahoma,Lieutenant Governor,Cathy Cummings,DEM,550163,0,0,221,221,
Oklahoma,Lieutenant Governor,Todd Lamb,REP,550163,0,0,338,338,
Oklahoma,Superintendent of Public Instruction,John Cox,DEM,550163,0,0,266,266,
Oklahoma,Superintendent of Public Instruction,Joy Hofmeister,REP,550163,0,0,292,292,
Oklahoma,Commissioner of Labor,Mike Workman,DEM,550163,0,0,239,239,
Oklahoma,Commissioner of Labor,Mark Costello,REP,550163,0,0,304,304,
Oklahoma,U.S. Senate,Matt Silverstein,DEM,550163,0,0,204,204,
Oklahoma,U.S. Senate,Jim Inhofe,REP,550163,0,0,330,330,
Oklahoma,U.S. Senate,Aaron Delozier,IND,550163,0,0,2,2,
Oklahoma,U.S. Senate,Ray Woods,IND,550163,0,0,12,12,
Oklahoma,U.S. Senate,Joan Farr,IND,550163,0,0,8,8,
Oklahoma,U.S. Senate,Connie Johnson,DEM,550163,0,0,211,211,
Oklahoma,U.S. Senate,James Lankford,REP,550163,0,0,335,335,
Oklahoma,U.S. Senate,Mark Beard,IND,550163,0,0,17,17,
Oklahoma,U.S. House,Al Mcaffrey,DEM,550163,0,0,207,207,05
Oklahoma,U.S. House,Steve Russell,REP,550163,0,0,320,320,05
Oklahoma,U.S. House,Buddy Ray,IND,550163,0,0,10,10,05
Oklahoma,U.S. House,Tom Boggs,IND,550163,0,0,7,7,05
Oklahoma,U.S. House,Robert Murphy,IND,550163,0,0,9,9,05
Oklahoma,Governor,Joe Dorman,DEM,550164,0,0,180,180,
Oklahoma,Governor,Mary Fallin,REP,550164,0,0,188,188,
Oklahoma,Governor,Kimberly Willis,IND,550164,0,0,13,13,
Oklahoma,Governor,Richard Prawdzienski,IND,550164,0,0,5,5,
Oklahoma,Lieutenant Governor,Cathy Cummings,DEM,550164,0,0,136,136,
Oklahoma,Lieutenant Governor,Todd Lamb,REP,550164,0,0,248,248,
Oklahoma,Superintendent of Public Instruction,John Cox,DEM,550164,0,0,173,173,
Oklahoma,Superintendent of Public Instruction,Joy Hofmeister,REP,550164,0,0,211,211,
Oklahoma,Commissioner of Labor,Mike Workman,DEM,550164,0,0,145,145,
Oklahoma,Commissioner of Labor,Mark Costello,REP,550164,0,0,235,235,
Oklahoma,U.S. Senate,Matt Silverstein,DEM,550164,0,0,113,113,
Oklahoma,U.S. Senate,Jim Inhofe,REP,550164,0,0,252,252,
Oklahoma,U.S. Senate,Aaron Delozier,IND,550164,0,0,3,3,
Oklahoma,U.S. Senate,Ray Woods,IND,550164,0,0,8,8,
Oklahoma,U.S. Senate,Joan Farr,IND,550164,0,0,7,7,
Oklahoma,U.S. Senate,Connie Johnson,DEM,550164,0,0,122,122,
Oklahoma,U.S. Senate,James Lankford,REP,550164,0,0,250,250,
Oklahoma,U.S. Senate,Mark Beard,IND,550164,0,0,13,13,
Oklahoma,U.S. House,Al Mcaffrey,DEM,550164,0,0,110,110,05
Oklahoma,U.S. House,Steve Russell,REP,550164,0,0,254,254,05
Oklahoma,U.S. House,Buddy Ray,IND,550164,0,0,2,2,05
Oklahoma,U.S. House,Tom Boggs,IND,550164,0,0,5,5,05
Oklahoma,U.S. House,Robert Murphy,IND,550164,0,0,13,13,05
Oklahoma,State Senate,Michael Brooks-Jimenez,DEM,550164,0,0,149,149,44
Oklahoma,State Senate,Ralph Shortey,REP,550164,0,0,205,205,44
Oklahoma,State Senate,Constance Fawcett,IND,550164,0,0,28,28,44
Oklahoma,Governor,Joe Dorman,DEM,550165,0,0,170,170,
Oklahoma,Governor,Mary Fallin,REP,550165,0,0,362,362,
Oklahoma,Governor,Kimberly Willis,IND,550165,0,0,16,16,
Oklahoma,Governor,Richard Prawdzienski,IND,550165,0,0,5,5,
Oklahoma,Lieutenant Governor,Cathy Cummings,DEM,550165,0,0,112,112,
Oklahoma,Lieutenant Governor,Todd Lamb,REP,550165,0,0,439,439,
Oklahoma,Superintendent of Public Instruction,John Cox,DEM,550165,0,0,186,186,
Oklahoma,Superintendent of Public Instruction,Joy Hofmeister,REP,550165,0,0,361,361,
Oklahoma,Commissioner of Labor,Mike Workman,DEM,550165,0,0,133,133,
Oklahoma,Commissioner of Labor,Mark Costello,REP,550165,0,0,404,404,
Oklahoma,U.S. Senate,Matt Silverstein,DEM,550165,0,0,93,93,
Oklahoma,U.S. Senate,Jim Inhofe,REP,550165,0,0,439,439,
Oklahoma,U.S. Senate,Aaron Delozier,IND,550165,0,0,2,2,
Oklahoma,U.S. Senate,Ray Woods,IND,550165,0,0,9,9,
Oklahoma,U.S. Senate,Joan Farr,IND,550165,0,0,7,7,
Oklahoma,U.S. Senate,Connie Johnson,DEM,550165,0,0,98,98,
Oklahoma,U.S. Senate,James Lankford,REP,550165,0,0,441,441,
Oklahoma,U.S. Senate,Mark Beard,IND,550165,0,0,15,15,
Oklahoma,U.S. House,Al Mcaffrey,DEM,550165,0,0,105,105,05
Oklahoma,U.S. House,Steve Russell,REP,550165,0,0,418,418,05
Oklahoma,U.S. House,Buddy Ray,IND,550165,0,0,5,5,05
Oklahoma,U.S. House,Tom Boggs,IND,550165,0,0,11,11,05
Oklahoma,U.S. House,Robert Murphy,IND,550165,0,0,10,10,05
Oklahoma,State Senate,Michael Brooks-Jimenez,DEM,550165,0,0,157,157,44
Oklahoma,State Senate,Ralph Shortey,REP,550165,0,0,349,349,44
Oklahoma,State Senate,Constance Fawcett,IND,550165,0,0,40,40,44
Oklahoma,Governor,Joe Dorman,DEM,550166,0,0,57,57,
Oklahoma,Governor,Mary Fallin,REP,550166,0,0,99,99,
Oklahoma,Governor,Kimberly Willis,IND,550166,0,0,3,3,
Oklahoma,Governor,Richard Prawdzienski,IND,550166,0,0,2,2,
Oklahoma,Lieutenant Governor,Cathy Cummings,DEM,550166,0,0,52,52,
Oklahoma,Lieutenant Governor,Todd Lamb,REP,550166,0,0,107,107,
Oklahoma,Superintendent of Public Instruction,John Cox,DEM,550166,0,0,69,69,
Oklahoma,Superintendent of Public Instruction,Joy Hofmeister,REP,550166,0,0,89,89,
Oklahoma,Commissioner of Labor,Mike Workman,DEM,550166,0,0,58,58,
Oklahoma,Commissioner of Labor,Mark Costello,REP,550166,0,0,96,96,
Oklahoma,U.S. Senate,Matt Silverstein,DEM,550166,0,0,47,47,
Oklahoma,U.S. Senate,Jim Inhofe,REP,550166,0,0,106,106,
Oklahoma,U.S. Senate,Aaron Delozier,IND,550166,0,0,0,0,
Oklahoma,U.S. Senate,Ray Woods,IND,550166,0,0,2,2,
Oklahoma,U.S. Senate,Joan Farr,IND,550166,0,0,5,5,
Oklahoma,U.S. Senate,Connie Johnson,DEM,550166,0,0,47,47,
Oklahoma,U.S. Senate,James Lankford,REP,550166,0,0,108,108,
Oklahoma,U.S. Senate,Mark Beard,IND,550166,0,0,6,6,
Oklahoma,U.S. House,Al Mcaffrey,DEM,550166,0,0,46,46,05
Oklahoma,U.S. House,Steve Russell,REP,550166,0,0,101,101,05
Oklahoma,U.S. House,Buddy Ray,IND,550166,0,0,1,1,05
Oklahoma,U.S. House,Tom Boggs,IND,550166,0,0,5,5,05
Oklahoma,U.S. House,Robert Murphy,IND,550166,0,0,4,4,05
Oklahoma,State Senate,Michael Brooks-Jimenez,DEM,550166,0,0,59,59,44
Oklahoma,State Senate,Ralph Shortey,REP,550166,0,0,90,90,44
Oklahoma,State Senate,Constance Fawcett,IND,550166,0,0,12,12,44
Oklahoma,Governor,Joe Dorman,DEM,550167,0,0,90,90,
Oklahoma,Governor,Mary Fallin,REP,550167,0,0,95,95,
Oklahoma,Governor,Kimberly Willis,IND,550167,0,0,7,7,
Oklahoma,Governor,Richard Prawdzienski,IND,550167,0,0,4,4,
Oklahoma,Lieutenant Governor,Cathy Cummings,DEM,550167,0,0,90,90,
Oklahoma,Lieutenant Governor,Todd Lamb,REP,550167,0,0,103,103,
Oklahoma,Superintendent of Public Instruction,John Cox,DEM,550167,0,0,97,97,
Oklahoma,Superintendent of Public Instruction,Joy Hofmeister,REP,550167,0,0,95,95,
Oklahoma,Commissioner of Labor,Mike Workman,DEM,550167,0,0,91,91,
Oklahoma,Commissioner of Labor,Mark Costello,REP,550167,0,0,95,95,
Oklahoma,U.S. Senate,Matt Silverstein,DEM,550167,0,0,71,71,
Oklahoma,U.S. Senate,Jim Inhofe,REP,550167,0,0,111,111,
Oklahoma,U.S. Senate,Aaron Delozier,IND,550167,0,0,4,4,
Oklahoma,U.S. Senate,Ray Woods,IND,550167,0,0,5,5,
Oklahoma,U.S. Senate,Joan Farr,IND,550167,0,0,2,2,
Oklahoma,U.S. Senate,Connie Johnson,DEM,550167,0,0,78,78,
Oklahoma,U.S. Senate,James Lankford,REP,550167,0,0,107,107,
Oklahoma,U.S. Senate,Mark Beard,IND,550167,0,0,11,11,
Oklahoma,U.S. House,Al Mcaffrey,DEM,550167,0,0,79,79,05
Oklahoma,U.S. House,Steve Russell,REP,550167,0,0,99,99,05
Oklahoma,U.S. House,Buddy Ray,IND,550167,0,0,7,7,05
Oklahoma,U.S. House,Tom Boggs,IND,550167,0,0,4,4,05
Oklahoma,U.S. House,Robert Murphy,IND,550167,0,0,1,1,05
Oklahoma,Governor,Joe Dorman,DEM,550168,0,0,59,59,
Oklahoma,Governor,Mary Fallin,REP,550168,0,0,75,75,
Oklahoma,Governor,Kimberly Willis,IND,550168,0,0,3,3,
Oklahoma,Governor,Richard Prawdzienski,IND,550168,0,0,0,0,
Oklahoma,Lieutenant Governor,Cathy Cummings,DEM,550168,0,0,54,54,
Oklahoma,Lieutenant Governor,Todd Lamb,REP,550168,0,0,82,82,
Oklahoma,Superintendent of Public Instruction,John Cox,DEM,550168,0,0,59,59,
Oklahoma,Superintendent of Public Instruction,Joy Hofmeister,REP,550168,0,0,77,77,
Oklahoma,Commissioner of Labor,Mike Workman,DEM,550168,0,0,60,60,
Oklahoma,Commissioner of Labor,Mark Costello,REP,550168,0,0,75,75,
Oklahoma,U.S. Senate,Matt Silverstein,DEM,550168,0,0,46,46,
Oklahoma,U.S. Senate,Jim Inhofe,REP,550168,0,0,81,81,
Oklahoma,U.S. Senate,Aaron Delozier,IND,550168,0,0,2,2,
Oklahoma,U.S. Senate,Ray Woods,IND,550168,0,0,2,2,
Oklahoma,U.S. Senate,Joan Farr,IND,550168,0,0,5,5,
Oklahoma,U.S. Senate,Connie Johnson,DEM,550168,0,0,49,49,
Oklahoma,U.S. Senate,James Lankford,REP,550168,0,0,80,80,
Oklahoma,U.S. Senate,Mark Beard,IND,550168,0,0,7,7,
Oklahoma,U.S. House,Al Mcaffrey,DEM,550168,0,0,55,55,05
Oklahoma,U.S. House,Steve Russell,REP,550168,0,0,74,74,05
Oklahoma,U.S. House,Buddy Ray,IND,550168,0,0,3,3,05
Oklahoma,U.S. House,Tom Boggs,IND,550168,0,0,3,3,05
Oklahoma,U.S. House,Robert Murphy,IND,550168,0,0,2,2,05
Oklahoma,Governor,Joe Dorman,DEM,550169,0,0,194,194,
Oklahoma,Governor,Mary Fallin,REP,550169,0,0,256,256,
Oklahoma,Governor,Kimberly Willis,IND,550169,0,0,12,12,
Oklahoma,Governor,Richard Prawdzienski,IND,550169,0,0,2,2,
Oklahoma,Lieutenant Governor,Cathy Cummings,DEM,550169,0,0,193,193,
Oklahoma,Lieutenant Governor,Todd Lamb,REP,550169,0,0,267,267,
Oklahoma,Superintendent of Public Instruction,John Cox,DEM,550169,0,0,210,210,
Oklahoma,Superintendent of Public Instruction,Joy Hofmeister,REP,550169,0,0,248,248,
Oklahoma,Commissioner of Labor,Mike Workman,DEM,550169,0,0,188,188,
Oklahoma,Commissioner of Labor,Mark Costello,REP,550169,0,0,262,262,
Oklahoma,U.S. Senate,Matt Silverstein,DEM,550169,0,0,164,164,
Oklahoma,U.S. Senate,Jim Inhofe,REP,550169,0,0,279,279,
Oklahoma,U.S. Senate,Aaron Delozier,IND,550169,0,0,4,4,
Oklahoma,U.S. Senate,Ray Woods,IND,550169,0,0,5,5,
Oklahoma,U.S. Senate,Joan Farr,IND,550169,0,0,9,9,
Oklahoma,U.S. Senate,Connie Johnson,DEM,550169,0,0,172,172,
Oklahoma,U.S. Senate,James Lankford,REP,550169,0,0,275,275,
Oklahoma,U.S. Senate,Mark Beard,IND,550169,0,0,17,17,
Oklahoma,U.S. House,Al Mcaffrey,DEM,550169,0,0,166,166,05
Oklahoma,U.S. House,Steve Russell,REP,550169,0,0,272,272,05
Oklahoma,U.S. House,Buddy Ray,IND,550169,0,0,5,5,05
Oklahoma,U.S. House,Tom Boggs,IND,550169,0,0,11,11,05
Oklahoma,U.S. House,Robert Murphy,IND,550169,0,0,5,5,05
Oklahoma,Governor,Joe Dorman,DEM,550170,0,0,191,191,
Oklahoma,Governor,Mary Fallin,REP,550170,0,0,229,229,
Oklahoma,Governor,Kimberly Willis,IND,550170,0,0,10,10,
Oklahoma,Governor,Richard Prawdzienski,IND,550170,0,0,6,6,
Oklahoma,Lieutenant Governor,Cathy Cummings,DEM,550170,0,0,170,170,
Oklahoma,Lieutenant Governor,Todd Lamb,REP,550170,0,0,262,262,
Oklahoma,Superintendent of Public Instruction,John Cox,DEM,550170,0,0,211,211,
Oklahoma,Superintendent of Public Instruction,Joy Hofmeister,REP,550170,0,0,223,223,
Oklahoma,Commissioner of Labor,Mike Workman,DEM,550170,0,0,181,181,
Oklahoma,Commissioner of Labor,Mark Costello,REP,550170,0,0,248,248,
Oklahoma,U.S. Senate,Matt Silverstein,DEM,550170,0,0,136,136,
Oklahoma,U.S. Senate,Jim Inhofe,REP,550170,0,0,265,265,
Oklahoma,U.S. Senate,Aaron Delozier,IND,550170,0,0,8,8,
Oklahoma,U.S. Senate,Ray Woods,IND,550170,0,0,10,10,
Oklahoma,U.S. Senate,Joan Farr,IND,550170,0,0,12,12,
Oklahoma,U.S. Senate,Connie Johnson,DEM,550170,0,0,163,163,
Oklahoma,U.S. Senate,James Lankford,REP,550170,0,0,257,257,
Oklahoma,U.S. Senate,Mark Beard,IND,550170,0,0,15,15,
Oklahoma,U.S. House,Al Mcaffrey,DEM,550170,0,0,161,161,05
Oklahoma,U.S. House,Steve Russell,REP,550170,0,0,252,252,05
Oklahoma,U.S. House,Buddy Ray,IND,550170,0,0,6,6,05
Oklahoma,U.S. House,Tom Boggs,IND,550170,0,0,7,7,05
Oklahoma,U.S. House,Robert Murphy,IND,550170,0,0,8,8,05
Oklahoma,Governor,Joe Dorman,DEM,550171,0,0,356,356,
Oklahoma,Governor,Mary Fallin,REP,550171,0,0,246,246,
Oklahoma,Governor,Kimberly Willis,IND,550171,0,0,14,14,
Oklahoma,Governor,Richard Prawdzienski,IND,550171,0,0,9,9,
Oklahoma,Lieutenant Governor,Cathy Cummings,DEM,550171,0,0,304,304,
Oklahoma,Lieutenant Governor,Todd Lamb,REP,550171,0,0,316,316,
Oklahoma,Superintendent of Public Instruction,John Cox,DEM,550171,0,0,353,353,
Oklahoma,Superintendent of Public Instruction,Joy Hofmeister,REP,550171,0,0,267,267,
Oklahoma,Commissioner of Labor,Mike Workman,DEM,550171,0,0,318,318,
Oklahoma,Commissioner of Labor,Mark Costello,REP,550171,0,0,289,289,
Oklahoma,U.S. Senate,Matt Silverstein,DEM,550171,0,0,267,267,
Oklahoma,U.S. Senate,Jim Inhofe,REP,550171,0,0,311,311,
Oklahoma,U.S. Senate,Aaron Delozier,IND,550171,0,0,6,6,
Oklahoma,U.S. Senate,Ray Woods,IND,550171,0,0,8,8,
Oklahoma,U.S. Senate,Joan Farr,IND,550171,0,0,24,24,
Oklahoma,U.S. Senate,Connie Johnson,DEM,550171,0,0,295,295,
Oklahoma,U.S. Senate,James Lankford,REP,550171,0,0,302,302,
Oklahoma,U.S. Senate,Mark Beard,IND,550171,0,0,25,25,
Oklahoma,U.S. House,Al Mcaffrey,DEM,550171,0,0,291,291,05
Oklahoma,U.S. House,Steve Russell,REP,550171,0,0,293,293,05
Oklahoma,U.S. House,Buddy Ray,IND,550171,0,0,6,6,05
Oklahoma,U.S. House,Tom Boggs,IND,550171,0,0,12,12,05
Oklahoma,U.S. House,Robert Murphy,IND,550171,0,0,12,12,05
Oklahoma,State House,Collin Walke,DEM,550171,0,0,337,337,87
Oklahoma,State House,Jason Nelson,REP,550171,0,0,281,281,87
Oklahoma,Governor,Joe Dorman,DEM,550172,0,0,365,365,
Oklahoma,Governor,Mary Fallin,REP,550172,0,0,316,316,
Oklahoma,Governor,Kimberly Willis,IND,550172,0,0,12,12,
Oklahoma,Governor,Richard Prawdzienski,IND,550172,0,0,9,9,
Oklahoma,Lieutenant Governor,Cathy Cummings,DEM,550172,0,0,334,334,
Oklahoma,Lieutenant Governor,Todd Lamb,REP,550172,0,0,362,362,
Oklahoma,Superintendent of Public Instruction,John Cox,DEM,550172,0,0,371,371,
Oklahoma,Superintendent of Public Instruction,Joy Hofmeister,REP,550172,0,0,323,323,
Oklahoma,Commissioner of Labor,Mike Workman,DEM,550172,0,0,344,344,
Oklahoma,Commissioner of Labor,Mark Costello,REP,550172,0,0,340,340,
Oklahoma,U.S. Senate,Matt Silverstein,DEM,550172,0,0,295,295,
Oklahoma,U.S. Senate,Jim Inhofe,REP,550172,0,0,377,377,
Oklahoma,U.S. Senate,Aaron Delozier,IND,550172,0,0,7,7,
Oklahoma,U.S. Senate,Ray Woods,IND,550172,0,0,7,7,
Oklahoma,U.S. Senate,Joan Farr,IND,550172,0,0,11,11,
Oklahoma,U.S. Senate,Connie Johnson,DEM,550172,0,0,311,311,
Oklahoma,U.S. Senate,James Lankford,REP,550172,0,0,367,367,
Oklahoma,U.S. Senate,Mark Beard,IND,550172,0,0,17,17,
Oklahoma,U.S. House,Al Mcaffrey,DEM,550172,0,0,297,297,05
Oklahoma,U.S. House,Steve Russell,REP,550172,0,0,364,364,05
Oklahoma,U.S. House,Buddy Ray,IND,550172,0,0,8,8,05
Oklahoma,U.S. House,Tom Boggs,IND,550172,0,0,10,10,05
Oklahoma,U.S. House,Robert Murphy,IND,550172,0,0,9,9,05
Oklahoma,State Senate,John Handy Edwards,DEM,550172,0,0,369,369,40
Oklahoma,State Senate,Ervin Yen,REP,550172,0,0,321,321,40
Oklahoma,State House,Collin Walke,DEM,550172,0,0,359,359,87
Oklahoma,State House,Jason Nelson,REP,550172,0,0,336,336,87
Oklahoma,Governor,Joe Dorman,DEM,550173,0,0,349,349,
Oklahoma,Governor,Mary Fallin,REP,550173,0,0,421,421,
Oklahoma,Governor,Kimberly Willis,IND,550173,0,0,14,14,
Oklahoma,Governor,Richard Prawdzienski,IND,550173,0,0,6,6,
Oklahoma,Lieutenant Governor,Cathy Cummings,DEM,550173,0,0,289,289,
Oklahoma,Lieutenant Governor,Todd Lamb,REP,550173,0,0,501,501,
Oklahoma,Superintendent of Public Instruction,John Cox,DEM,550173,0,0,351,351,
Oklahoma,Superintendent of Public Instruction,Joy Hofmeister,REP,550173,0,0,433,433,
Oklahoma,Commissioner of Labor,Mike Workman,DEM,550173,0,0,318,318,
Oklahoma,Commissioner of Labor,Mark Costello,REP,550173,0,0,459,459,
Oklahoma,U.S. Senate,Matt Silverstein,DEM,550173,0,0,271,271,
Oklahoma,U.S. Senate,Jim Inhofe,REP,550173,0,0,491,491,
Oklahoma,U.S. Senate,Aaron Delozier,IND,550173,0,0,8,8,
Oklahoma,U.S. Senate,Ray Woods,IND,550173,0,0,9,9,
Oklahoma,U.S. Senate,Joan Farr,IND,550173,0,0,8,8,
Oklahoma,U.S. Senate,Connie Johnson,DEM,550173,0,0,268,268,
Oklahoma,U.S. Senate,James Lankford,REP,550173,0,0,499,499,
Oklahoma,U.S. Senate,Mark Beard,IND,550173,0,0,24,24,
Oklahoma,U.S. House,Al Mcaffrey,DEM,550173,0,0,282,282,05
Oklahoma,U.S. House,Steve Russell,REP,550173,0,0,486,486,05
Oklahoma,U.S. House,Buddy Ray,IND,550173,0,0,4,4,05
Oklahoma,U.S. House,Tom Boggs,IND,550173,0,0,8,8,05
Oklahoma,U.S. House,Robert Murphy,IND,550173,0,0,10,10,05
Oklahoma,State Senate,John Handy Edwards,DEM,550173,0,0,325,325,40
Oklahoma,State Senate,Ervin Yen,REP,550173,0,0,459,459,40
Oklahoma,Governor,Joe Dorman,DEM,550174,0,0,185,185,
Oklahoma,Governor,Mary Fallin,REP,550174,0,0,233,233,
Oklahoma,Governor,Kimberly Willis,IND,550174,0,0,9,9,
Oklahoma,Governor,Richard Prawdzienski,IND,550174,0,0,4,4,
Oklahoma,Lieutenant Governor,Cathy Cummings,DEM,550174,0,0,164,164,
Oklahoma,Lieutenant Governor,Todd Lamb,REP,550174,0,0,265,265,
Oklahoma,Superintendent of Public Instruction,John Cox,DEM,550174,0,0,188,188,
Oklahoma,Superintendent of Public Instruction,Joy Hofmeister,REP,550174,0,0,237,237,
Oklahoma,Commissioner of Labor,Mike Workman,DEM,550174,0,0,169,169,
Oklahoma,Commissioner of Labor,Mark Costello,REP,550174,0,0,251,251,
Oklahoma,U.S. Senate,Matt Silverstein,DEM,550174,0,0,154,154,
Oklahoma,U.S. Senate,Jim Inhofe,REP,550174,0,0,260,260,
Oklahoma,U.S. Senate,Aaron Delozier,IND,550174,0,0,4,4,
Oklahoma,U.S. Senate,Ray Woods,IND,550174,0,0,5,5,
Oklahoma,U.S. Senate,Joan Farr,IND,550174,0,0,5,5,
Oklahoma,U.S. Senate,Connie Johnson,DEM,550174,0,0,146,146,
Oklahoma,U.S. Senate,James Lankford,REP,550174,0,0,273,273,
Oklahoma,U.S. Senate,Mark Beard,IND,550174,0,0,12,12,
Oklahoma,U.S. House,Al Mcaffrey,DEM,550174,0,0,156,156,05
Oklahoma,U.S. House,Steve Russell,REP,550174,0,0,258,258,05
Oklahoma,U.S. House,Buddy Ray,IND,550174,0,0,4,4,05
Oklahoma,U.S. House,Tom Boggs,IND,550174,0,0,5,5,05
Oklahoma,U.S. House,Robert Murphy,IND,550174,0,0,6,6,05
Oklahoma,State Senate,John Handy Edwards,DEM,550174,0,0,179,179,40
Oklahoma,State Senate,Ervin Yen,REP,550174,0,0,246,246,40
Oklahoma,Governor,Joe Dorman,DEM,550175,0,0,102,102,
Oklahoma,Governor,Mary Fallin,REP,550175,0,0,102,102,
Oklahoma,Governor,Kimberly Willis,IND,550175,0,0,6,6,
Oklahoma,Governor,Richard Prawdzienski,IND,550175,0,0,5,5,
Oklahoma,Lieutenant Governor,Cathy Cummings,DEM,550175,0,0,89,89,
Oklahoma,Lieutenant Governor,Todd Lamb,REP,550175,0,0,125,125,
Oklahoma,Superintendent of Public Instruction,John Cox,DEM,550175,0,0,104,104,
Oklahoma,Superintendent of Public Instruction,Joy Hofmeister,REP,550175,0,0,111,111,
Oklahoma,Commissioner of Labor,Mike Workman,DEM,550175,0,0,84,84,
Oklahoma,Commissioner of Labor,Mark Costello,REP,550175,0,0,123,123,
Oklahoma,U.S. Senate,Matt Silverstein,DEM,550175,0,0,73,73,
Oklahoma,U.S. Senate,Jim Inhofe,REP,550175,0,0,130,130,
Oklahoma,U.S. Senate,Aaron Delozier,IND,550175,0,0,6,6,
Oklahoma,U.S. Senate,Ray Woods,IND,550175,0,0,2,2,
Oklahoma,U.S. Senate,Joan Farr,IND,550175,0,0,5,5,
Oklahoma,U.S. Senate,Connie Johnson,DEM,550175,0,0,70,70,
Oklahoma,U.S. Senate,James Lankford,REP,550175,0,0,137,137,
Oklahoma,U.S. Senate,Mark Beard,IND,550175,0,0,10,10,
Oklahoma,U.S. House,Al Mcaffrey,DEM,550175,0,0,64,64,05
Oklahoma,U.S. House,Steve Russell,REP,550175,0,0,131,131,05
Oklahoma,U.S. House,Buddy Ray,IND,550175,0,0,3,3,05
Oklahoma,U.S. House,Tom Boggs,IND,550175,0,0,8,8,05
Oklahoma,U.S. House,Robert Murphy,IND,550175,0,0,8,8,05
Oklahoma,State Senate,John Handy Edwards,DEM,550175,0,0,93,93,40
Oklahoma,State Senate,Ervin Yen,REP,550175,0,0,119,119,40
Oklahoma,Governor,Joe Dorman,DEM,550176,0,0,297,297,
Oklahoma,Governor,Mary Fallin,REP,550176,0,0,327,327,
Oklahoma,Governor,Kimberly Willis,IND,550176,0,0,17,17,
Oklahoma,Governor,Richard Prawdzienski,IND,550176,0,0,9,9,
Oklahoma,Lieutenant Governor,Cathy Cummings,DEM,550176,0,0,254,254,
Oklahoma,Lieutenant Governor,Todd Lamb,REP,550176,0,0,391,391,
Oklahoma,Superintendent of Public Instruction,John Cox,DEM,550176,0,0,294,294,
Oklahoma,Superintendent of Public Instruction,Joy Hofmeister,REP,550176,0,0,352,352,
Oklahoma,Commissioner of Labor,Mike Workman,DEM,550176,0,0,249,249,
Oklahoma,Commissioner of Labor,Mark Costello,REP,550176,0,0,381,381,
Oklahoma,U.S. Senate,Matt Silverstein,DEM,550176,0,0,221,221,
Oklahoma,U.S. Senate,Jim Inhofe,REP,550176,0,0,401,401,
Oklahoma,U.S. Senate,Aaron Delozier,IND,550176,0,0,11,11,
Oklahoma,U.S. Senate,Ray Woods,IND,550176,0,0,9,9,
Oklahoma,U.S. Senate,Joan Farr,IND,550176,0,0,6,6,
Oklahoma,U.S. Senate,Connie Johnson,DEM,550176,0,0,230,230,
Oklahoma,U.S. Senate,James Lankford,REP,550176,0,0,399,399,
Oklahoma,U.S. Senate,Mark Beard,IND,550176,0,0,23,23,
Oklahoma,U.S. House,Al Mcaffrey,DEM,550176,0,0,220,220,05
Oklahoma,U.S. House,Steve Russell,REP,550176,0,0,386,386,05
Oklahoma,U.S. House,Buddy Ray,IND,550176,0,0,10,10,05
Oklahoma,U.S. House,Tom Boggs,IND,550176,0,0,12,12,05
Oklahoma,U.S. House,Robert Murphy,IND,550176,0,0,11,11,05
Oklahoma,State Senate,John Handy Edwards,DEM,550176,0,0,259,259,40
Oklahoma,State Senate,Ervin Yen,REP,550176,0,0,378,378,40
Oklahoma,State House,Collin Walke,DEM,550176,0,0,247,247,87
Oklahoma,State House,Jason Nelson,REP,550176,0,0,390,390,87
Oklahoma,Governor,Joe Dorman,DEM,550177,0,0,299,299,
Oklahoma,Governor,Mary Fallin,REP,550177,0,0,383,383,
Oklahoma,Governor,Kimberly Willis,IND,550177,0,0,16,16,
Oklahoma,Governor,Richard Prawdzienski,IND,550177,0,0,5,5,
Oklahoma,Lieutenant Governor,Cathy Cummings,DEM,550177,0,0,265,265,
Oklahoma,Lieutenant Governor,Todd Lamb,REP,550177,0,0,433,433,
Oklahoma,Superintendent of Public Instruction,John Cox,DEM,550177,0,0,321,321,
Oklahoma,Superintendent of Public Instruction,Joy Hofmeister,REP,550177,0,0,374,374,
Oklahoma,Commissioner of Labor,Mike Workman,DEM,550177,0,0,277,277,
Oklahoma,Commissioner of Labor,Mark Costello,REP,550177,0,0,402,402,
Oklahoma,U.S. Senate,Matt Silverstein,DEM,550177,0,0,237,237,
Oklahoma,U.S. Senate,Jim Inhofe,REP,550177,0,0,435,435,
Oklahoma,U.S. Senate,Aaron Delozier,IND,550177,0,0,8,8,
Oklahoma,U.S. Senate,Ray Woods,IND,550177,0,0,6,6,
Oklahoma,U.S. Senate,Joan Farr,IND,550177,0,0,10,10,
Oklahoma,U.S. Senate,Connie Johnson,DEM,550177,0,0,243,243,
Oklahoma,U.S. Senate,James Lankford,REP,550177,0,0,435,435,
Oklahoma,U.S. Senate,Mark Beard,IND,550177,0,0,23,23,
Oklahoma,U.S. House,Al Mcaffrey,DEM,550177,0,0,242,242,05
Oklahoma,U.S. House,Steve Russell,REP,550177,0,0,418,418,05
Oklahoma,U.S. House,Buddy Ray,IND,550177,0,0,9,9,05
Oklahoma,U.S. House,Tom Boggs,IND,550177,0,0,9,9,05
Oklahoma,U.S. House,Robert Murphy,IND,550177,0,0,14,14,05
Oklahoma,State Senate,John Handy Edwards,DEM,550177,0,0,283,283,40
Oklahoma,State Senate,Ervin Yen,REP,550177,0,0,406,406,40
Oklahoma,State House,Collin Walke,DEM,550177,0,0,271,271,87
Oklahoma,State House,Jason Nelson,REP,550177,0,0,424,424,87
Oklahoma,Governor,Joe Dorman,DEM,550178,0,0,247,247,
Oklahoma,Governor,Mary Fallin,REP,550178,0,0,270,270,
Oklahoma,Governor,Kimberly Willis,IND,550178,0,0,11,11,
Oklahoma,Governor,Richard Prawdzienski,IND,550178,0,0,1,1,
Oklahoma,Lieutenant Governor,Cathy Cummings,DEM,550178,0,0,210,210,
Oklahoma,Lieutenant Governor,Todd Lamb,REP,550178,0,0,319,319,
Oklahoma,Superintendent of Public Instruction,John Cox,DEM,550178,0,0,250,250,
Oklahoma,Superintendent of Public Instruction,Joy Hofmeister,REP,550178,0,0,276,276,
Oklahoma,Commissioner of Labor,Mike Workman,DEM,550178,0,0,217,217,
Oklahoma,Commissioner of Labor,Mark Costello,REP,550178,0,0,300,300,
Oklahoma,U.S. Senate,Matt Silverstein,DEM,550178,0,0,188,188,
Oklahoma,U.S. Senate,Jim Inhofe,REP,550178,0,0,316,316,
Oklahoma,U.S. Senate,Aaron Delozier,IND,550178,0,0,8,8,
Oklahoma,U.S. Senate,Ray Woods,IND,550178,0,0,8,8,
Oklahoma,U.S. Senate,Joan Farr,IND,550178,0,0,6,6,
Oklahoma,U.S. Senate,Connie Johnson,DEM,550178,0,0,198,198,
Oklahoma,U.S. Senate,James Lankford,REP,550178,0,0,325,325,
Oklahoma,U.S. Senate,Mark Beard,IND,550178,0,0,7,7,
Oklahoma,U.S. House,Al Mcaffrey,DEM,550178,0,0,201,201,05
Oklahoma,U.S. House,Steve Russell,REP,550178,0,0,316,316,05
Oklahoma,U.S. House,Buddy Ray,IND,550178,0,0,2,2,05
Oklahoma,U.S. House,Tom Boggs,IND,550178,0,0,3,3,05
Oklahoma,U.S. House,Robert Murphy,IND,550178,0,0,7,7,05
Oklahoma,State Senate,John Handy Edwards,DEM,550178,0,0,232,232,40
Oklahoma,State Senate,Ervin Yen,REP,550178,0,0,294,294,40
Oklahoma,State House,Collin Walke,DEM,550178,0,0,218,218,87
Oklahoma,State House,Jason Nelson,REP,550178,0,0,305,305,87
Oklahoma,Governor,Joe Dorman,DEM,550179,0,0,357,357,
Oklahoma,Governor,Mary Fallin,REP,550179,0,0,405,405,
Oklahoma,Governor,Kimberly Willis,IND,550179,0,0,15,15,
Oklahoma,Governor,Richard Prawdzienski,IND,550179,0,0,6,6,
Oklahoma,Lieutenant Governor,Cathy Cummings,DEM,550179,0,0,319,319,
Oklahoma,Lieutenant Governor,Todd Lamb,REP,550179,0,0,461,461,
Oklahoma,Superintendent of Public Instruction,John Cox,DEM,550179,0,0,351,351,
Oklahoma,Superintendent of Public Instruction,Joy Hofmeister,REP,550179,0,0,423,423,
Oklahoma,Commissioner of Labor,Mike Workman,DEM,550179,0,0,282,282,
Oklahoma,Commissioner of Labor,Mark Costello,REP,550179,0,0,472,472,
Oklahoma,U.S. Senate,Matt Silverstein,DEM,550179,0,0,268,268,
Oklahoma,U.S. Senate,Jim Inhofe,REP,550179,0,0,491,491,
Oklahoma,U.S. Senate,Aaron Delozier,IND,550179,0,0,4,4,
Oklahoma,U.S. Senate,Ray Woods,IND,550179,0,0,6,6,
Oklahoma,U.S. Senate,Joan Farr,IND,550179,0,0,9,9,
Oklahoma,U.S. Senate,Connie Johnson,DEM,550179,0,0,272,272,
Oklahoma,U.S. Senate,James Lankford,REP,550179,0,0,484,484,
Oklahoma,U.S. Senate,Mark Beard,IND,550179,0,0,25,25,
Oklahoma,U.S. House,Al Mcaffrey,DEM,550179,0,0,286,286,05
Oklahoma,U.S. House,Steve Russell,REP,550179,0,0,468,468,05
Oklahoma,U.S. House,Buddy Ray,IND,550179,0,0,3,3,05
Oklahoma,U.S. House,Tom Boggs,IND,550179,0,0,8,8,05
Oklahoma,U.S. House,Robert Murphy,IND,550179,0,0,7,7,05
Oklahoma,State Senate,John Handy Edwards,DEM,550179,0,0,307,307,40
Oklahoma,State Senate,Ervin Yen,REP,550179,0,0,473,473,40
Oklahoma,State House,Cyndi Munson,DEM,550179,0,0,337,337,85
Oklahoma,State House,David Dank,REP,550179,0,0,440,440,85
Oklahoma,Governor,Joe Dorman,DEM,550180,0,0,243,243,
Oklahoma,Governor,Mary Fallin,REP,550180,0,0,227,227,
Oklahoma,Governor,Kimberly Willis,IND,550180,0,0,10,10,
Oklahoma,Governor,Richard Prawdzienski,IND,550180,0,0,6,6,
Oklahoma,Lieutenant Governor,Cathy Cummings,DEM,550180,0,0,209,209,
Oklahoma,Lieutenant Governor,Todd Lamb,REP,550180,0,0,276,276,
Oklahoma,Superintendent of Public Instruction,John Cox,DEM,550180,0,0,237,237,
Oklahoma,Superintendent of Public Instruction,Joy Hofmeister,REP,550180,0,0,244,244,
Oklahoma,Commissioner of Labor,Mike Workman,DEM,550180,0,0,210,210,
Oklahoma,Commissioner of Labor,Mark Costello,REP,550180,0,0,267,267,
Oklahoma,U.S. Senate,Matt Silverstein,DEM,550180,0,0,190,190,
Oklahoma,U.S. Senate,Jim Inhofe,REP,550180,0,0,274,274,
Oklahoma,U.S. Senate,Aaron Delozier,IND,550180,0,0,5,5,
Oklahoma,U.S. Senate,Ray Woods,IND,550180,0,0,8,8,
Oklahoma,U.S. Senate,Joan Farr,IND,550180,0,0,7,7,
Oklahoma,U.S. Senate,Connie Johnson,DEM,550180,0,0,194,194,
Oklahoma,U.S. Senate,James Lankford,REP,550180,0,0,275,275,
Oklahoma,U.S. Senate,Mark Beard,IND,550180,0,0,18,18,
Oklahoma,U.S. House,Al Mcaffrey,DEM,550180,0,0,193,193,05
Oklahoma,U.S. House,Steve Russell,REP,550180,0,0,266,266,05
Oklahoma,U.S. House,Buddy Ray,IND,550180,0,0,6,6,05
Oklahoma,U.S. House,Tom Boggs,IND,550180,0,0,9,9,05
Oklahoma,U.S. House,Robert Murphy,IND,550180,0,0,3,3,05
Oklahoma,State Senate,John Handy Edwards,DEM,550180,0,0,223,223,40
Oklahoma,State Senate,Ervin Yen,REP,550180,0,0,253,253,40
Oklahoma,State House,Cyndi Munson,DEM,550180,0,0,234,234,85
Oklahoma,State House,David Dank,REP,550180,0,0,242,242,85
Oklahoma,Governor,Joe Dorman,DEM,550181,0,0,179,179,
Oklahoma,Governor,Mary Fallin,REP,550181,0,0,139,139,
Oklahoma,Governor,Kimberly Willis,IND,550181,0,0,3,3,
Oklahoma,Governor,Richard Prawdzienski,IND,550181,0,0,4,4,
Oklahoma,Lieutenant Governor,Cathy Cummings,DEM,550181,0,0,163,163,
Oklahoma,Lieutenant Governor,Todd Lamb,REP,550181,0,0,159,159,
Oklahoma,Superintendent of Public Instruction,John Cox,DEM,550181,0,0,180,180,
Oklahoma,Superintendent of Public Instruction,Joy Hofmeister,REP,550181,0,0,140,140,
Oklahoma,Commissioner of Labor,Mike Workman,DEM,550181,0,0,155,155,
Oklahoma,Commissioner of Labor,Mark Costello,REP,550181,0,0,158,158,
Oklahoma,U.S. Senate,Matt Silverstein,DEM,550181,0,0,147,147,
Oklahoma,U.S. Senate,Jim Inhofe,REP,550181,0,0,167,167,
Oklahoma,U.S. Senate,Aaron Delozier,IND,550181,0,0,1,1,
Oklahoma,U.S. Senate,Ray Woods,IND,550181,0,0,3,3,
Oklahoma,U.S. Senate,Joan Farr,IND,550181,0,0,7,7,
Oklahoma,U.S. Senate,Connie Johnson,DEM,550181,0,0,145,145,
Oklahoma,U.S. Senate,James Lankford,REP,550181,0,0,165,165,
Oklahoma,U.S. Senate,Mark Beard,IND,550181,0,0,14,14,
Oklahoma,U.S. House,Al Mcaffrey,DEM,550181,0,0,147,147,05
Oklahoma,U.S. House,Steve Russell,REP,550181,0,0,162,162,05
Oklahoma,U.S. House,Buddy Ray,IND,550181,0,0,6,6,05
Oklahoma,U.S. House,Tom Boggs,IND,550181,0,0,6,6,05
Oklahoma,U.S. House,Robert Murphy,IND,550181,0,0,3,3,05
Oklahoma,State Senate,John Handy Edwards,DEM,550181,0,0,167,167,40
Oklahoma,State Senate,Ervin Yen,REP,550181,0,0,154,154,40
Oklahoma,State House,Cyndi Munson,DEM,550181,0,0,166,166,85
Oklahoma,State House,David Dank,REP,550181,0,0,154,154,85
Oklahoma,Governor,Joe Dorman,DEM,550182,0,0,173,173,
Oklahoma,Governor,Mary Fallin,REP,550182,0,0,91,91,
Oklahoma,Governor,Kimberly Willis,IND,550182,0,0,6,6,
Oklahoma,Governor,Richard Prawdzienski,IND,550182,0,0,0,0,
Oklahoma,Lieutenant Governor,Cathy Cummings,DEM,550182,0,0,154,154,
Oklahoma,Lieutenant Governor,Todd Lamb,REP,550182,0,0,113,113,
Oklahoma,Superintendent of Public Instruction,John Cox,DEM,550182,0,0,155,155,
Oklahoma,Superintendent of Public Instruction,Joy Hofmeister,REP,550182,0,0,109,109,
Oklahoma,Commissioner of Labor,Mike Workman,DEM,550182,0,0,149,149,
Oklahoma,Commissioner of Labor,Mark Costello,REP,550182,0,0,112,112,
Oklahoma,U.S. Senate,Matt Silverstein,DEM,550182,0,0,141,141,
Oklahoma,U.S. Senate,Jim Inhofe,REP,550182,0,0,115,115,
Oklahoma,U.S. Senate,Aaron Delozier,IND,550182,0,0,1,1,
Oklahoma,U.S. Senate,Ray Woods,IND,550182,0,0,3,3,
Oklahoma,U.S. Senate,Joan Farr,IND,550182,0,0,7,7,
Oklahoma,U.S. Senate,Connie Johnson,DEM,550182,0,0,147,147,
Oklahoma,U.S. Senate,James Lankford,REP,550182,0,0,111,111,
Oklahoma,U.S. Senate,Mark Beard,IND,550182,0,0,6,6,
Oklahoma,U.S. House,Al Mcaffrey,DEM,550182,0,0,151,151,05
Oklahoma,U.S. House,Steve Russell,REP,550182,0,0,107,107,05
Oklahoma,U.S. House,Buddy Ray,IND,550182,0,0,3,3,05
Oklahoma,U.S. House,Tom Boggs,IND,550182,0,0,1,1,05
Oklahoma,U.S. House,Robert Murphy,IND,550182,0,0,2,2,05
Oklahoma,State Senate,John Handy Edwards,DEM,550182,0,0,156,156,40
Oklahoma,State Senate,Ervin Yen,REP,550182,0,0,106,106,40
Oklahoma,State House,Collin Walke,DEM,550182,0,0,160,160,87
Oklahoma,State House,Jason Nelson,REP,550182,0,0,102,102,87
Oklahoma,Governor,Joe Dorman,DEM,550183,0,0,328,328,
Oklahoma,Governor,Mary Fallin,REP,550183,0,0,283,283,
Oklahoma,Governor,Kimberly Willis,IND,550183,0,0,13,13,
Oklahoma,Governor,Richard Prawdzienski,IND,550183,0,0,3,3,
Oklahoma,Lieutenant Governor,Cathy Cummings,DEM,550183,0,0,283,283,
Oklahoma,Lieutenant Governor,Todd Lamb,REP,550183,0,0,339,339,
Oklahoma,Superintendent of Public Instruction,John Cox,DEM,550183,0,0,314,314,
Oklahoma,Superintendent of Public Instruction,Joy Hofmeister,REP,550183,0,0,307,307,
Oklahoma,Commissioner of Labor,Mike Workman,DEM,550183,0,0,284,284,
Oklahoma,Commissioner of Labor,Mark Costello,REP,550183,0,0,316,316,
Oklahoma,U.S. Senate,Matt Silverstein,DEM,550183,0,0,269,269,
Oklahoma,U.S. Senate,Jim Inhofe,REP,550183,0,0,327,327,
Oklahoma,U.S. Senate,Aaron Delozier,IND,550183,0,0,6,6,
Oklahoma,U.S. Senate,Ray Woods,IND,550183,0,0,14,14,
Oklahoma,U.S. Senate,Joan Farr,IND,550183,0,0,3,3,
Oklahoma,U.S. Senate,Connie Johnson,DEM,550183,0,0,261,261,
Oklahoma,U.S. Senate,James Lankford,REP,550183,0,0,341,341,
Oklahoma,U.S. Senate,Mark Beard,IND,550183,0,0,21,21,
Oklahoma,U.S. House,Al Mcaffrey,DEM,550183,0,0,262,262,05
Oklahoma,U.S. House,Steve Russell,REP,550183,0,0,333,333,05
Oklahoma,U.S. House,Buddy Ray,IND,550183,0,0,11,11,05
Oklahoma,U.S. House,Tom Boggs,IND,550183,0,0,6,6,05
Oklahoma,U.S. House,Robert Murphy,IND,550183,0,0,6,6,05
Oklahoma,State Senate,John Handy Edwards,DEM,550183,0,0,299,299,40
Oklahoma,State Senate,Ervin Yen,REP,550183,0,0,320,320,40
Oklahoma,State House,Collin Walke,DEM,550183,0,0,300,300,87
Oklahoma,State House,Jason Nelson,REP,550183,0,0,318,318,87
Oklahoma,Governor,Joe Dorman,DEM,550184,0,0,380,380,
Oklahoma,Governor,Mary Fallin,REP,550184,0,0,265,265,
Oklahoma,Governor,Kimberly Willis,IND,550184,0,0,26,26,
Oklahoma,Governor,Richard Prawdzienski,IND,550184,0,0,13,13,
Oklahoma,Lieutenant Governor,Cathy Cummings,DEM,550184,0,0,350,350,
Oklahoma,Lieutenant Governor,Todd Lamb,REP,550184,0,0,330,330,
Oklahoma,Superintendent of Public Instruction,John Cox,DEM,550184,0,0,374,374,
Oklahoma,Superintendent of Public Instruction,Joy Hofmeister,REP,550184,0,0,300,300,
Oklahoma,Commissioner of Labor,Mike Workman,DEM,550184,0,0,360,360,
Oklahoma,Commissioner of Labor,Mark Costello,REP,550184,0,0,305,305,
Oklahoma,U.S. Senate,Matt Silverstein,DEM,550184,0,0,331,331,
Oklahoma,U.S. Senate,Jim Inhofe,REP,550184,0,0,311,311,
Oklahoma,U.S. Senate,Aaron Delozier,IND,550184,0,0,11,11,
Oklahoma,U.S. Senate,Ray Woods,IND,550184,0,0,18,18,
Oklahoma,U.S. Senate,Joan Farr,IND,550184,0,0,11,11,
Oklahoma,U.S. Senate,Connie Johnson,DEM,550184,0,0,329,329,
Oklahoma,U.S. Senate,James Lankford,REP,550184,0,0,328,328,
Oklahoma,U.S. Senate,Mark Beard,IND,550184,0,0,25,25,
Oklahoma,U.S. House,Al Mcaffrey,DEM,550184,0,0,336,336,05
Oklahoma,U.S. House,Steve Russell,REP,550184,0,0,300,300,05
Oklahoma,U.S. House,Buddy Ray,IND,550184,0,0,10,10,05
Oklahoma,U.S. House,Tom Boggs,IND,550184,0,0,15,15,05
Oklahoma,U.S. House,Robert Murphy,IND,550184,0,0,14,14,05
Oklahoma,State Senate,John Handy Edwards,DEM,550184,0,0,383,383,40
Oklahoma,State Senate,Ervin Yen,REP,550184,0,0,292,292,40
Oklahoma,State House,Collin Walke,DEM,550184,0,0,382,382,87
Oklahoma,State House,Jason Nelson,REP,550184,0,0,294,294,87
Oklahoma,Governor,Joe Dorman,DEM,550185,0,0,153,153,
Oklahoma,Governor,Mary Fallin,REP,550185,0,0,66,66,
Oklahoma,Governor,Kimberly Willis,IND,550185,0,0,7,7,
Oklahoma,Governor,Richard Prawdzienski,IND,550185,0,0,4,4,
Oklahoma,Lieutenant Governor,Cathy Cummings,DEM,550185,0,0,142,142,
Oklahoma,Lieutenant Governor,Todd Lamb,REP,550185,0,0,86,86,
Oklahoma,Superintendent of Public Instruction,John Cox,DEM,550185,0,0,143,143,
Oklahoma,Superintendent of Public Instruction,Joy Hofmeister,REP,550185,0,0,83,83,
Oklahoma,Commissioner of Labor,Mike Workman,DEM,550185,0,0,131,131,
Oklahoma,Commissioner of Labor,Mark Costello,REP,550185,0,0,93,93,
Oklahoma,U.S. Senate,Matt Silverstein,DEM,550185,0,0,123,123,
Oklahoma,U.S. Senate,Jim Inhofe,REP,550185,0,0,89,89,
Oklahoma,U.S. Senate,Aaron Delozier,IND,550185,0,0,2,2,
Oklahoma,U.S. Senate,Ray Woods,IND,550185,0,0,6,6,
Oklahoma,U.S. Senate,Joan Farr,IND,550185,0,0,8,8,
Oklahoma,U.S. Senate,Connie Johnson,DEM,550185,0,0,132,132,
Oklahoma,U.S. Senate,James Lankford,REP,550185,0,0,84,84,
Oklahoma,U.S. Senate,Mark Beard,IND,550185,0,0,12,12,
Oklahoma,U.S. House,Al Mcaffrey,DEM,550185,0,0,132,132,05
Oklahoma,U.S. House,Steve Russell,REP,550185,0,0,81,81,05
Oklahoma,U.S. House,Buddy Ray,IND,550185,0,0,4,4,05
Oklahoma,U.S. House,Tom Boggs,IND,550185,0,0,4,4,05
Oklahoma,U.S. House,Robert Murphy,IND,550185,0,0,4,4,05
Oklahoma,State Senate,John Handy Edwards,DEM,550185,0,0,143,143,40
Oklahoma,State Senate,Ervin Yen,REP,550185,0,0,83,83,40
Oklahoma,Governor,Joe Dorman,DEM,550186,0,0,256,256,
Oklahoma,Governor,Mary Fallin,REP,550186,0,0,133,133,
Oklahoma,Governor,Kimberly Willis,IND,550186,0,0,11,11,
Oklahoma,Governor,Richard Prawdzienski,IND,550186,0,0,4,4,
Oklahoma,Lieutenant Governor,Cathy Cummings,DEM,550186,0,0,240,240,
Oklahoma,Lieutenant Governor,Todd Lamb,REP,550186,0,0,164,164,
Oklahoma,Superintendent of Public Instruction,John Cox,DEM,550186,0,0,241,241,
Oklahoma,Superintendent of Public Instruction,Joy Hofmeister,REP,550186,0,0,155,155,
Oklahoma,Commissioner of Labor,Mike Workman,DEM,550186,0,0,224,224,
Oklahoma,Commissioner of Labor,Mark Costello,REP,550186,0,0,165,165,
Oklahoma,U.S. Senate,Matt Silverstein,DEM,550186,0,0,218,218,
Oklahoma,U.S. Senate,Jim Inhofe,REP,550186,0,0,163,163,
Oklahoma,U.S. Senate,Aaron Delozier,IND,550186,0,0,6,6,
Oklahoma,U.S. Senate,Ray Woods,IND,550186,0,0,3,3,
Oklahoma,U.S. Senate,Joan Farr,IND,550186,0,0,8,8,
Oklahoma,U.S. Senate,Connie Johnson,DEM,550186,0,0,225,225,
Oklahoma,U.S. Senate,James Lankford,REP,550186,0,0,165,165,
Oklahoma,U.S. Senate,Mark Beard,IND,550186,0,0,12,12,
Oklahoma,U.S. House,Al Mcaffrey,DEM,550186,0,0,225,225,05
Oklahoma,U.S. House,Steve Russell,REP,550186,0,0,159,159,05
Oklahoma,U.S. House,Buddy Ray,IND,550186,0,0,6,6,05
Oklahoma,U.S. House,Tom Boggs,IND,550186,0,0,3,3,05
Oklahoma,U.S. House,Robert Murphy,IND,550186,0,0,8,8,05
Oklahoma,Governor,Joe Dorman,DEM,550187,0,0,44,44,
Oklahoma,Governor,Mary Fallin,REP,550187,0,0,21,21,
Oklahoma,Governor,Kimberly Willis,IND,550187,0,0,1,1,
Oklahoma,Governor,Richard Prawdzienski,IND,550187,0,0,1,1,
Oklahoma,Lieutenant Governor,Cathy Cummings,DEM,550187,0,0,37,37,
Oklahoma,Lieutenant Governor,Todd Lamb,REP,550187,0,0,30,30,
Oklahoma,Superintendent of Public Instruction,John Cox,DEM,550187,0,0,43,43,
Oklahoma,Superintendent of Public Instruction,Joy Hofmeister,REP,550187,0,0,24,24,
Oklahoma,Commissioner of Labor,Mike Workman,DEM,550187,0,0,34,34,
Oklahoma,Commissioner of Labor,Mark Costello,REP,550187,0,0,30,30,
Oklahoma,U.S. Senate,Matt Silverstein,DEM,550187,0,0,32,32,
Oklahoma,U.S. Senate,Jim Inhofe,REP,550187,0,0,31,31,
Oklahoma,U.S. Senate,Aaron Delozier,IND,550187,0,0,0,0,
Oklahoma,U.S. Senate,Ray Woods,IND,550187,0,0,2,2,
Oklahoma,U.S. Senate,Joan Farr,IND,550187,0,0,2,2,
Oklahoma,U.S. Senate,Connie Johnson,DEM,550187,0,0,34,34,
Oklahoma,U.S. Senate,James Lankford,REP,550187,0,0,29,29,
Oklahoma,U.S. Senate,Mark Beard,IND,550187,0,0,2,2,
Oklahoma,U.S. House,Al Mcaffrey,DEM,550187,0,0,36,36,05
Oklahoma,U.S. House,Steve Russell,REP,550187,0,0,24,24,05
Oklahoma,U.S. House,Buddy Ray,IND,550187,0,0,2,2,05
Oklahoma,U.S. House,Tom Boggs,IND,550187,0,0,2,2,05
Oklahoma,U.S. House,Robert Murphy,IND,550187,0,0,1,1,05
Oklahoma,Governor,Joe Dorman,DEM,550188,0,0,4,4,
Oklahoma,Governor,Mary Fallin,REP,550188,0,0,0,0,
Oklahoma,Governor,Kimberly Willis,IND,550188,0,0,0,0,
Oklahoma,Governor,Richard Prawdzienski,IND,550188,0,0,0,0,
Oklahoma,Lieutenant Governor,Cathy Cummings,DEM,550188,0,0,4,4,
Oklahoma,Lieutenant Governor,Todd Lamb,REP,550188,0,0,0,0,
Oklahoma,Superintendent of Public Instruction,John Cox,DEM,550188,0,0,4,4,
Oklahoma,Superintendent of Public Instruction,Joy Hofmeister,REP,550188,0,0,0,0,
Oklahoma,Commissioner of Labor,Mike Workman,DEM,550188,0,0,4,4,
Oklahoma,Commissioner of Labor,Mark Costello,REP,550188,0,0,0,0,
Oklahoma,U.S. Senate,Matt Silverstein,DEM,550188,0,0,4,4,
Oklahoma,U.S. Senate,Jim Inhofe,REP,550188,0,0,0,0,
Oklahoma,U.S. Senate,Aaron Delozier,IND,550188,0,0,0,0,
Oklahoma,U.S. Senate,Ray Woods,IND,550188,0,0,0,0,
Oklahoma,U.S. Senate,Joan Farr,IND,550188,0,0,0,0,
Oklahoma,U.S. Senate,Connie Johnson,DEM,550188,0,0,4,4,
Oklahoma,U.S. Senate,James Lankford,REP,550188,0,0,0,0,
Oklahoma,U.S. Senate,Mark Beard,IND,550188,0,0,0,0,
Oklahoma,U.S. House,Al Mcaffrey,DEM,550188,0,0,4,4,05
Oklahoma,U.S. House,Steve Russell,REP,550188,0,0,0,0,05
Oklahoma,U.S. House,Buddy Ray,IND,550188,0,0,0,0,05
Oklahoma,U.S. House,Tom Boggs,IND,550188,0,0,0,0,05
Oklahoma,U.S. House,Robert Murphy,IND,550188,0,0,0,0,05
Oklahoma,State Senate,Michael Brooks-Jimenez,DEM,550188,0,0,4,4,44
Oklahoma,State Senate,Ralph Shortey,REP,550188,0,0,0,0,44
Oklahoma,State Senate,Constance Fawcett,IND,550188,0,0,0,0,44
Oklahoma,Governor,Joe Dorman,DEM,550189,0,0,42,42,
Oklahoma,Governor,Mary Fallin,REP,550189,0,0,24,24,
Oklahoma,Governor,Kimberly Willis,IND,550189,0,0,4,4,
Oklahoma,Governor,Richard Prawdzienski,IND,550189,0,0,1,1,
Oklahoma,Lieutenant Governor,Cathy Cummings,DEM,550189,0,0,41,41,
Oklahoma,Lieutenant Governor,Todd Lamb,REP,550189,0,0,29,29,
Oklahoma,Superintendent of Public Instruction,John Cox,DEM,550189,0,0,41,41,
Oklahoma,Superintendent of Public Instruction,Joy Hofmeister,REP,550189,0,0,28,28,
Oklahoma,Commissioner of Labor,Mike Workman,DEM,550189,0,0,39,39,
Oklahoma,Commissioner of Labor,Mark Costello,REP,550189,0,0,28,28,
Oklahoma,U.S. Senate,Matt Silverstein,DEM,550189,0,0,34,34,
Oklahoma,U.S. Senate,Jim Inhofe,REP,550189,0,0,28,28,
Oklahoma,U.S. Senate,Aaron Delozier,IND,550189,0,0,1,1,
Oklahoma,U.S. Senate,Ray Woods,IND,550189,0,0,5,5,
Oklahoma,U.S. Senate,Joan Farr,IND,550189,0,0,2,2,
Oklahoma,U.S. Senate,Connie Johnson,DEM,550189,0,0,37,37,
Oklahoma,U.S. Senate,James Lankford,REP,550189,0,0,31,31,
Oklahoma,U.S. Senate,Mark Beard,IND,550189,0,0,1,1,
Oklahoma,U.S. House,Al Mcaffrey,DEM,550189,0,0,35,35,05
Oklahoma,U.S. House,Steve Russell,REP,550189,0,0,26,26,05
Oklahoma,U.S. House,Buddy Ray,IND,550189,0,0,2,2,05
Oklahoma,U.S. House,Tom Boggs,IND,550189,0,0,3,3,05
Oklahoma,U.S. House,Robert Murphy,IND,550189,0,0,4,4,05
Oklahoma,State Senate,Michael Brooks-Jimenez,DEM,550189,0,0,41,41,44
Oklahoma,State Senate,Ralph Shortey,REP,550189,0,0,19,19,44
Oklahoma,State Senate,Constance Fawcett,IND,550189,0,0,8,8,44
Oklahoma,Governor,Joe Dorman,DEM,550190,0,0,125,125,
Oklahoma,Governor,Mary Fallin,REP,550190,0,0,54,54,
Oklahoma,Governor,Kimberly Willis,IND,550190,0,0,7,7,
Oklahoma,Governor,Richard Prawdzienski,IND,550190,0,0,3,3,
Oklahoma,Lieutenant Governor,Cathy Cummings,DEM,550190,0,0,119,119,
Oklahoma,Lieutenant Governor,Todd Lamb,REP,550190,0,0,67,67,
Oklahoma,Superintendent of Public Instruction,John Cox,DEM,550190,0,0,116,116,
Oklahoma,Superintendent of Public Instruction,Joy Hofmeister,REP,550190,0,0,71,71,
Oklahoma,Commissioner of Labor,Mike Workman,DEM,550190,0,0,117,117,
Oklahoma,Commissioner of Labor,Mark Costello,REP,550190,0,0,66,66,
Oklahoma,U.S. Senate,Matt Silverstein,DEM,550190,0,0,108,108,
Oklahoma,U.S. Senate,Jim Inhofe,REP,550190,0,0,62,62,
Oklahoma,U.S. Senate,Aaron Delozier,IND,550190,0,0,7,7,
Oklahoma,U.S. Senate,Ray Woods,IND,550190,0,0,5,5,
Oklahoma,U.S. Senate,Joan Farr,IND,550190,0,0,7,7,
Oklahoma,U.S. Senate,Connie Johnson,DEM,550190,0,0,110,110,
Oklahoma,U.S. Senate,James Lankford,REP,550190,0,0,67,67,
Oklahoma,U.S. Senate,Mark Beard,IND,550190,0,0,10,10,
Oklahoma,U.S. House,Al Mcaffrey,DEM,550190,0,0,121,121,05
Oklahoma,U.S. House,Steve Russell,REP,550190,0,0,58,58,05
Oklahoma,U.S. House,Buddy Ray,IND,550190,0,0,2,2,05
Oklahoma,U.S. House,Tom Boggs,IND,550190,0,0,2,2,05
Oklahoma,U.S. House,Robert Murphy,IND,550190,0,0,6,6,05
Oklahoma,Governor,Joe Dorman,DEM,550191,0,0,259,259,
Oklahoma,Governor,Mary Fallin,REP,550191,0,0,96,96,
Oklahoma,Governor,Kimberly Willis,IND,550191,0,0,8,8,
Oklahoma,Governor,Richard Prawdzienski,IND,550191,0,0,4,4,
Oklahoma,Lieutenant Governor,Cathy Cummings,DEM,550191,0,0,241,241,
Oklahoma,Lieutenant Governor,Todd Lamb,REP,550191,0,0,123,123,
Oklahoma,Superintendent of Public Instruction,John Cox,DEM,550191,0,0,249,249,
Oklahoma,Superintendent of Public Instruction,Joy Hofmeister,REP,550191,0,0,115,115,
Oklahoma,Commissioner of Labor,Mike Workman,DEM,550191,0,0,235,235,
Oklahoma,Commissioner of Labor,Mark Costello,REP,550191,0,0,121,121,
Oklahoma,U.S. Senate,Matt Silverstein,DEM,550191,0,0,221,221,
Oklahoma,U.S. Senate,Jim Inhofe,REP,550191,0,0,118,118,
Oklahoma,U.S. Senate,Aaron Delozier,IND,550191,0,0,5,5,
Oklahoma,U.S. Senate,Ray Woods,IND,550191,0,0,9,9,
Oklahoma,U.S. Senate,Joan Farr,IND,550191,0,0,8,8,
Oklahoma,U.S. Senate,Connie Johnson,DEM,550191,0,0,225,225,
Oklahoma,U.S. Senate,James Lankford,REP,550191,0,0,126,126,
Oklahoma,U.S. Senate,Mark Beard,IND,550191,0,0,13,13,
Oklahoma,U.S. House,Al Mcaffrey,DEM,550191,0,0,237,237,05
Oklahoma,U.S. House,Steve Russell,REP,550191,0,0,107,107,05
Oklahoma,U.S. House,Buddy Ray,IND,550191,0,0,5,5,05
Oklahoma,U.S. House,Tom Boggs,IND,550191,0,0,4,4,05
Oklahoma,U.S. House,Robert Murphy,IND,550191,0,0,9,9,05
Oklahoma,State Senate,Michael Brooks-Jimenez,DEM,550191,0,0,248,248,44
Oklahoma,State Senate,Ralph Shortey,REP,550191,0,0,79,79,44
Oklahoma,State Senate,Constance Fawcett,IND,550191,0,0,33,33,44
Oklahoma,Governor,Joe Dorman,DEM,550192,0,0,524,524,
Oklahoma,Governor,Mary Fallin,REP,550192,0,0,226,226,
Oklahoma,Governor,Kimberly Willis,IND,550192,0,0,14,14,
Oklahoma,Governor,Richard Prawdzienski,IND,550192,0,0,3,3,
Oklahoma,Lieutenant Governor,Cathy Cummings,DEM,550192,0,0,473,473,
Oklahoma,Lieutenant Governor,Todd Lamb,REP,550192,0,0,292,292,
Oklahoma,Superintendent of Public Instruction,John Cox,DEM,550192,0,0,475,475,
Oklahoma,Superintendent of Public Instruction,Joy Hofmeister,REP,550192,0,0,283,283,
Oklahoma,Commissioner of Labor,Mike Workman,DEM,550192,0,0,449,449,
Oklahoma,Commissioner of Labor,Mark Costello,REP,550192,0,0,292,292,
Oklahoma,U.S. Senate,Matt Silverstein,DEM,550192,0,0,425,425,
Oklahoma,U.S. Senate,Jim Inhofe,REP,550192,0,0,296,296,
Oklahoma,U.S. Senate,Aaron Delozier,IND,550192,0,0,12,12,
Oklahoma,U.S. Senate,Ray Woods,IND,550192,0,0,11,11,
Oklahoma,U.S. Senate,Joan Farr,IND,550192,0,0,15,15,
Oklahoma,U.S. Senate,Connie Johnson,DEM,550192,0,0,448,448,
Oklahoma,U.S. Senate,James Lankford,REP,550192,0,0,280,280,
Oklahoma,U.S. Senate,Mark Beard,IND,550192,0,0,33,33,
Oklahoma,U.S. House,Al Mcaffrey,DEM,550192,0,0,456,456,05
Oklahoma,U.S. House,Steve Russell,REP,550192,0,0,267,267,05
Oklahoma,U.S. House,Buddy Ray,IND,550192,0,0,11,11,05
Oklahoma,U.S. House,Tom Boggs,IND,550192,0,0,10,10,05
Oklahoma,U.S. House,Robert Murphy,IND,550192,0,0,17,17,05
Oklahoma,Governor,Joe Dorman,DEM,550193,0,0,359,359,
Oklahoma,Governor,Mary Fallin,REP,550193,0,0,144,144,
Oklahoma,Governor,Kimberly Willis,IND,550193,0,0,5,5,
Oklahoma,Governor,Richard Prawdzienski,IND,550193,0,0,7,7,
Oklahoma,Lieutenant Governor,Cathy Cummings,DEM,550193,0,0,328,328,
Oklahoma,Lieutenant Governor,Todd Lamb,REP,550193,0,0,179,179,
Oklahoma,Superintendent of Public Instruction,John Cox,DEM,550193,0,0,344,344,
Oklahoma,Superintendent of Public Instruction,Joy Hofmeister,REP,550193,0,0,162,162,
Oklahoma,Commissioner of Labor,Mike Workman,DEM,550193,0,0,314,314,
Oklahoma,Commissioner of Labor,Mark Costello,REP,550193,0,0,182,182,
Oklahoma,U.S. Senate,Matt Silverstein,DEM,550193,0,0,302,302,
Oklahoma,U.S. Senate,Jim Inhofe,REP,550193,0,0,175,175,
Oklahoma,U.S. Senate,Aaron Delozier,IND,550193,0,0,8,8,
Oklahoma,U.S. Senate,Ray Woods,IND,550193,0,0,8,8,
Oklahoma,U.S. Senate,Joan Farr,IND,550193,0,0,17,17,
Oklahoma,U.S. Senate,Connie Johnson,DEM,550193,0,0,314,314,
Oklahoma,U.S. Senate,James Lankford,REP,550193,0,0,175,175,
Oklahoma,U.S. Senate,Mark Beard,IND,550193,0,0,23,23,
Oklahoma,U.S. House,Al Mcaffrey,DEM,550193,0,0,332,332,05
Oklahoma,U.S. House,Steve Russell,REP,550193,0,0,155,155,05
Oklahoma,U.S. House,Buddy Ray,IND,550193,0,0,4,4,05
Oklahoma,U.S. House,Tom Boggs,IND,550193,0,0,9,9,05
Oklahoma,U.S. House,Robert Murphy,IND,550193,0,0,7,7,05
Oklahoma,Governor,Joe Dorman,DEM,550194,0,0,313,313,
Oklahoma,Governor,Mary Fallin,REP,550194,0,0,137,137,
Oklahoma,Governor,Kimberly Willis,IND,550194,0,0,10,10,
Oklahoma,Governor,Richard Prawdzienski,IND,550194,0,0,4,4,
Oklahoma,Lieutenant Governor,Cathy Cummings,DEM,550194,0,0,290,290,
Oklahoma,Lieutenant Governor,Todd Lamb,REP,550194,0,0,173,173,
Oklahoma,Superintendent of Public Instruction,John Cox,DEM,550194,0,0,304,304,
Oklahoma,Superintendent of Public Instruction,Joy Hofmeister,REP,550194,0,0,158,158,
Oklahoma,Commissioner of Labor,Mike Workman,DEM,550194,0,0,290,290,
Oklahoma,Commissioner of Labor,Mark Costello,REP,550194,0,0,165,165,
Oklahoma,U.S. Senate,Matt Silverstein,DEM,550194,0,0,266,266,
Oklahoma,U.S. Senate,Jim Inhofe,REP,550194,0,0,163,163,
Oklahoma,U.S. Senate,Aaron Delozier,IND,550194,0,0,6,6,
Oklahoma,U.S. Senate,Ray Woods,IND,550194,0,0,9,9,
Oklahoma,U.S. Senate,Joan Farr,IND,550194,0,0,19,19,
Oklahoma,U.S. Senate,Connie Johnson,DEM,550194,0,0,279,279,
Oklahoma,U.S. Senate,James Lankford,REP,550194,0,0,165,165,
Oklahoma,U.S. Senate,Mark Beard,IND,550194,0,0,18,18,
Oklahoma,U.S. House,Al Mcaffrey,DEM,550194,0,0,275,275,05
Oklahoma,U.S. House,Steve Russell,REP,550194,0,0,159,159,05
Oklahoma,U.S. House,Buddy Ray,IND,550194,0,0,6,6,05
Oklahoma,U.S. House,Tom Boggs,IND,550194,0,0,7,7,05
Oklahoma,U.S. House,Robert Murphy,IND,550194,0,0,12,12,05
Oklahoma,State Senate,John Handy Edwards,DEM,550194,0,0,312,312,40
Oklahoma,State Senate,Ervin Yen,REP,550194,0,0,147,147,40
Oklahoma,Governor,Joe Dorman,DEM,550195,0,0,527,527,
Oklahoma,Governor,Mary Fallin,REP,550195,0,0,372,372,
Oklahoma,Governor,Kimberly Willis,IND,550195,0,0,23,23,
Oklahoma,Governor,Richard Prawdzienski,IND,550195,0,0,7,7,
Oklahoma,Lieutenant Governor,Cathy Cummings,DEM,550195,0,0,490,490,
Oklahoma,Lieutenant Governor,Todd Lamb,REP,550195,0,0,435,435,
Oklahoma,Superintendent of Public Instruction,John Cox,DEM,550195,0,0,548,548,
Oklahoma,Superintendent of Public Instruction,Joy Hofmeister,REP,550195,0,0,373,373,
Oklahoma,Commissioner of Labor,Mike Workman,DEM,550195,0,0,480,480,
Oklahoma,Commissioner of Labor,Mark Costello,REP,550195,0,0,425,425,
Oklahoma,U.S. Senate,Matt Silverstein,DEM,550195,0,0,453,453,
Oklahoma,U.S. Senate,Jim Inhofe,REP,550195,0,0,440,440,
Oklahoma,U.S. Senate,Aaron Delozier,IND,550195,0,0,9,9,
Oklahoma,U.S. Senate,Ray Woods,IND,550195,0,0,11,11,
Oklahoma,U.S. Senate,Joan Farr,IND,550195,0,0,10,10,
Oklahoma,U.S. Senate,Connie Johnson,DEM,550195,0,0,443,443,
Oklahoma,U.S. Senate,James Lankford,REP,550195,0,0,452,452,
Oklahoma,U.S. Senate,Mark Beard,IND,550195,0,0,34,34,
Oklahoma,U.S. House,Al Mcaffrey,DEM,550195,0,0,452,452,05
Oklahoma,U.S. House,Steve Russell,REP,550195,0,0,432,432,05
Oklahoma,U.S. House,Buddy Ray,IND,550195,0,0,9,9,05
Oklahoma,U.S. House,Tom Boggs,IND,550195,0,0,12,12,05
Oklahoma,U.S. House,Robert Murphy,IND,550195,0,0,14,14,05
Oklahoma,State Senate,John Handy Edwards,DEM,550195,0,0,510,510,40
Oklahoma,State Senate,Ervin Yen,REP,550195,0,0,407,407,40
Oklahoma,State House,Collin Walke,DEM,550195,0,0,515,515,87
Oklahoma,State House,Jason Nelson,REP,550195,0,0,399,399,87
Oklahoma,Governor,Joe Dorman,DEM,550196,0,0,604,604,
Oklahoma,Governor,Mary Fallin,REP,550196,0,0,619,619,
Oklahoma,Governor,Kimberly Willis,IND,550196,0,0,17,17,
Oklahoma,Governor,Richard Prawdzienski,IND,550196,0,0,9,9,
Oklahoma,Lieutenant Governor,Cathy Cummings,DEM,550196,0,0,526,526,
Oklahoma,Lieutenant Governor,Todd Lamb,REP,550196,0,0,721,721,
Oklahoma,Superintendent of Public Instruction,John Cox,DEM,550196,0,0,551,551,
Oklahoma,Superintendent of Public Instruction,Joy Hofmeister,REP,550196,0,0,681,681,
Oklahoma,Commissioner of Labor,Mike Workman,DEM,550196,0,0,479,479,
Oklahoma,Commissioner of Labor,Mark Costello,REP,550196,0,0,729,729,
Oklahoma,U.S. Senate,Matt Silverstein,DEM,550196,0,0,465,465,
Oklahoma,U.S. Senate,Jim Inhofe,REP,550196,0,0,733,733,
Oklahoma,U.S. Senate,Aaron Delozier,IND,550196,0,0,9,9,
Oklahoma,U.S. Senate,Ray Woods,IND,550196,0,0,11,11,
Oklahoma,U.S. Senate,Joan Farr,IND,550196,0,0,20,20,
Oklahoma,U.S. Senate,Connie Johnson,DEM,550196,0,0,471,471,
Oklahoma,U.S. Senate,James Lankford,REP,550196,0,0,741,741,
Oklahoma,U.S. Senate,Mark Beard,IND,550196,0,0,35,35,
Oklahoma,U.S. House,Al Mcaffrey,DEM,550196,0,0,496,496,05
Oklahoma,U.S. House,Steve Russell,REP,550196,0,0,697,697,05
Oklahoma,U.S. House,Buddy Ray,IND,550196,0,0,6,6,05
Oklahoma,U.S. House,Tom Boggs,IND,550196,0,0,12,12,05
Oklahoma,U.S. House,Robert Murphy,IND,550196,0,0,18,18,05
Oklahoma,State Senate,John Handy Edwards,DEM,550196,0,0,538,538,40
Oklahoma,State Senate,Ervin Yen,REP,550196,0,0,705,705,40
Oklahoma,State House,Cyndi Munson,DEM,550196,0,0,564,564,85
Oklahoma,State House,David Dank,REP,550196,0,0,664,664,85
Oklahoma,Governor,Joe Dorman,DEM,550197,0,0,394,394,
Oklahoma,Governor,Mary Fallin,REP,550197,0,0,133,133,
Oklahoma,Governor,Kimberly Willis,IND,550197,0,0,12,12,
Oklahoma,Governor,Richard Prawdzienski,IND,550197,0,0,6,6,
Oklahoma,Lieutenant Governor,Cathy Cummings,DEM,550197,0,0,360,360,
Oklahoma,Lieutenant Governor,Todd Lamb,REP,550197,0,0,180,180,
Oklahoma,Superintendent of Public Instruction,John Cox,DEM,550197,0,0,367,367,
Oklahoma,Superintendent of Public Instruction,Joy Hofmeister,REP,550197,0,0,172,172,
Oklahoma,Commissioner of Labor,Mike Workman,DEM,550197,0,0,362,362,
Oklahoma,Commissioner of Labor,Mark Costello,REP,550197,0,0,168,168,
Oklahoma,U.S. Senate,Matt Silverstein,DEM,550197,0,0,327,327,
Oklahoma,U.S. Senate,Jim Inhofe,REP,550197,0,0,181,181,
Oklahoma,U.S. Senate,Aaron Delozier,IND,550197,0,0,9,9,
Oklahoma,U.S. Senate,Ray Woods,IND,550197,0,0,12,12,
Oklahoma,U.S. Senate,Joan Farr,IND,550197,0,0,12,12,
Oklahoma,U.S. Senate,Connie Johnson,DEM,550197,0,0,338,338,
Oklahoma,U.S. Senate,James Lankford,REP,550197,0,0,178,178,
Oklahoma,U.S. Senate,Mark Beard,IND,550197,0,0,24,24,
Oklahoma,U.S. House,Al Mcaffrey,DEM,550197,0,0,353,353,05
Oklahoma,U.S. House,Steve Russell,REP,550197,0,0,165,165,05
Oklahoma,U.S. House,Buddy Ray,IND,550197,0,0,5,5,05
Oklahoma,U.S. House,Tom Boggs,IND,550197,0,0,7,7,05
Oklahoma,U.S. House,Robert Murphy,IND,550197,0,0,11,11,05
Oklahoma,State Senate,John Handy Edwards,DEM,550197,0,0,369,369,40
Oklahoma,State Senate,Ervin Yen,REP,550197,0,0,164,164,40
Oklahoma,Governor,Joe Dorman,DEM,550198,0,0,380,380,
Oklahoma,Governor,Mary Fallin,REP,550198,0,0,147,147,
Oklahoma,Governor,Kimberly Willis,IND,550198,0,0,8,8,
Oklahoma,Governor,Richard Prawdzienski,IND,550198,0,0,3,3,
Oklahoma,Lieutenant Governor,Cathy Cummings,DEM,550198,0,0,337,337,
Oklahoma,Lieutenant Governor,Todd Lamb,REP,550198,0,0,201,201,
Oklahoma,Superintendent of Public Instruction,John Cox,DEM,550198,0,0,347,347,
Oklahoma,Superintendent of Public Instruction,Joy Hofmeister,REP,550198,0,0,185,185,
Oklahoma,Commissioner of Labor,Mike Workman,DEM,550198,0,0,324,324,
Oklahoma,Commissioner of Labor,Mark Costello,REP,550198,0,0,202,202,
Oklahoma,U.S. Senate,Matt Silverstein,DEM,550198,0,0,324,324,
Oklahoma,U.S. Senate,Jim Inhofe,REP,550198,0,0,192,192,
Oklahoma,U.S. Senate,Aaron Delozier,IND,550198,0,0,7,7,
Oklahoma,U.S. Senate,Ray Woods,IND,550198,0,0,5,5,
Oklahoma,U.S. Senate,Joan Farr,IND,550198,0,0,6,6,
Oklahoma,U.S. Senate,Connie Johnson,DEM,550198,0,0,327,327,
Oklahoma,U.S. Senate,James Lankford,REP,550198,0,0,198,198,
Oklahoma,U.S. Senate,Mark Beard,IND,550198,0,0,13,13,
Oklahoma,U.S. House,Al Mcaffrey,DEM,550198,0,0,337,337,05
Oklahoma,U.S. House,Steve Russell,REP,550198,0,0,171,171,05
Oklahoma,U.S. House,Buddy Ray,IND,550198,0,0,9,9,05
Oklahoma,U.S. House,Tom Boggs,IND,550198,0,0,8,8,05
Oklahoma,U.S. House,Robert Murphy,IND,550198,0,0,10,10,05
Oklahoma,State House,Cyndi Munson,DEM,550198,0,0,363,363,85
Oklahoma,State House,David Dank,REP,550198,0,0,169,169,85
Oklahoma,Governor,Joe Dorman,DEM,550199,0,0,391,391,
Oklahoma,Governor,Mary Fallin,REP,550199,0,0,183,183,
Oklahoma,Governor,Kimberly Willis,IND,550199,0,0,12,12,
Oklahoma,Governor,Richard Prawdzienski,IND,550199,0,0,2,2,
Oklahoma,Lieutenant Governor,Cathy Cummings,DEM,550199,0,0,348,348,
Oklahoma,Lieutenant Governor,Todd Lamb,REP,550199,0,0,240,240,
Oklahoma,Superintendent of Public Instruction,John Cox,DEM,550199,0,0,340,340,
Oklahoma,Superintendent of Public Instruction,Joy Hofmeister,REP,550199,0,0,242,242,
Oklahoma,Commissioner of Labor,Mike Workman,DEM,550199,0,0,319,319,
Oklahoma,Commissioner of Labor,Mark Costello,REP,550199,0,0,257,257,
Oklahoma,U.S. Senate,Matt Silverstein,DEM,550199,0,0,326,326,
Oklahoma,U.S. Senate,Jim Inhofe,REP,550199,0,0,242,242,
Oklahoma,U.S. Senate,Aaron Delozier,IND,550199,0,0,3,3,
Oklahoma,U.S. Senate,Ray Woods,IND,550199,0,0,5,5,
Oklahoma,U.S. Senate,Joan Farr,IND,550199,0,0,10,10,
Oklahoma,U.S. Senate,Connie Johnson,DEM,550199,0,0,322,322,
Oklahoma,U.S. Senate,James Lankford,REP,550199,0,0,254,254,
Oklahoma,U.S. Senate,Mark Beard,IND,550199,0,0,15,15,
Oklahoma,U.S. House,Al Mcaffrey,DEM,550199,0,0,344,344,05
Oklahoma,U.S. House,Steve Russell,REP,550199,0,0,229,229,05
Oklahoma,U.S. House,Buddy Ray,IND,550199,0,0,4,4,05
Oklahoma,U.S. House,Tom Boggs,IND,550199,0,0,6,6,05
Oklahoma,U.S. House,Robert Murphy,IND,550199,0,0,6,6,05
Oklahoma,State House,Cyndi Munson,DEM,550199,0,0,370,370,85
Oklahoma,State House,David Dank,REP,550199,0,0,216,216,85
Oklahoma,Governor,Joe Dorman,DEM,550200,0,0,740,740,
Oklahoma,Governor,Mary Fallin,REP,550200,0,0,183,183,
Oklahoma,Governor,Kimberly Willis,IND,550200,0,0,10,10,
Oklahoma,Governor,Richard Prawdzienski,IND,550200,0,0,17,17,
Oklahoma,Lieutenant Governor,Cathy Cummings,DEM,550200,0,0,689,689,
Oklahoma,Lieutenant Governor,Todd Lamb,REP,550200,0,0,254,254,
Oklahoma,Superintendent of Public Instruction,John Cox,DEM,550200,0,0,673,673,
Oklahoma,Superintendent of Public Instruction,Joy Hofmeister,REP,550200,0,0,261,261,
Oklahoma,Commissioner of Labor,Mike Workman,DEM,550200,0,0,646,646,
Oklahoma,Commissioner of Labor,Mark Costello,REP,550200,0,0,271,271,
Oklahoma,U.S. Senate,Matt Silverstein,DEM,550200,0,0,628,628,
Oklahoma,U.S. Senate,Jim Inhofe,REP,550200,0,0,254,254,
Oklahoma,U.S. Senate,Aaron Delozier,IND,550200,0,0,17,17,
Oklahoma,U.S. Senate,Ray Woods,IND,550200,0,0,19,19,
Oklahoma,U.S. Senate,Joan Farr,IND,550200,0,0,24,24,
Oklahoma,U.S. Senate,Connie Johnson,DEM,550200,0,0,661,661,
Oklahoma,U.S. Senate,James Lankford,REP,550200,0,0,254,254,
Oklahoma,U.S. Senate,Mark Beard,IND,550200,0,0,28,28,
Oklahoma,U.S. House,Al Mcaffrey,DEM,550200,0,0,695,695,05
Oklahoma,U.S. House,Steve Russell,REP,550200,0,0,210,210,05
Oklahoma,U.S. House,Buddy Ray,IND,550200,0,0,8,8,05
Oklahoma,U.S. House,Tom Boggs,IND,550200,0,0,11,11,05
Oklahoma,U.S. House,Robert Murphy,IND,550200,0,0,17,17,05
Oklahoma,Governor,Joe Dorman,DEM,550201,0,0,332,332,
Oklahoma,Governor,Mary Fallin,REP,550201,0,0,108,108,
Oklahoma,Governor,Kimberly Willis,IND,550201,0,0,8,8,
Oklahoma,Governor,Richard Prawdzienski,IND,550201,0,0,11,11,
Oklahoma,Lieutenant Governor,Cathy Cummings,DEM,550201,0,0,314,314,
Oklahoma,Lieutenant Governor,Todd Lamb,REP,550201,0,0,144,144,
Oklahoma,Superintendent of Public Instruction,John Cox,DEM,550201,0,0,318,318,
Oklahoma,Superintendent of Public Instruction,Joy Hofmeister,REP,550201,0,0,132,132,
Oklahoma,Commissioner of Labor,Mike Workman,DEM,550201,0,0,316,316,
Oklahoma,Commissioner of Labor,Mark Costello,REP,550201,0,0,128,128,
Oklahoma,U.S. Senate,Matt Silverstein,DEM,550201,0,0,290,290,
Oklahoma,U.S. Senate,Jim Inhofe,REP,550201,0,0,136,136,
Oklahoma,U.S. Senate,Aaron Delozier,IND,550201,0,0,4,4,
Oklahoma,U.S. Senate,Ray Woods,IND,550201,0,0,6,6,
Oklahoma,U.S. Senate,Joan Farr,IND,550201,0,0,21,21,
Oklahoma,U.S. Senate,Connie Johnson,DEM,550201,0,0,288,288,
Oklahoma,U.S. Senate,James Lankford,REP,550201,0,0,148,148,
Oklahoma,U.S. Senate,Mark Beard,IND,550201,0,0,21,21,
Oklahoma,U.S. House,Al Mcaffrey,DEM,550201,0,0,297,297,05
Oklahoma,U.S. House,Steve Russell,REP,550201,0,0,133,133,05
Oklahoma,U.S. House,Buddy Ray,IND,550201,0,0,8,8,05
Oklahoma,U.S. House,Tom Boggs,IND,550201,0,0,12,12,05
Oklahoma,U.S. House,Robert Murphy,IND,550201,0,0,7,7,05
Oklahoma,State Senate,John Handy Edwards,DEM,550201,0,0,324,324,40
Oklahoma,State Senate,Ervin Yen,REP,550201,0,0,129,129,40
Oklahoma,Governor,Joe Dorman,DEM,550202,0,0,267,267,
Oklahoma,Governor,Mary Fallin,REP,550202,0,0,120,120,
Oklahoma,Governor,Kimberly Willis,IND,550202,0,0,6,6,
Oklahoma,Governor,Richard Prawdzienski,IND,550202,0,0,9,9,
Oklahoma,Lieutenant Governor,Cathy Cummings,DEM,550202,0,0,256,256,
Oklahoma,Lieutenant Governor,Todd Lamb,REP,550202,0,0,142,142,
Oklahoma,Superintendent of Public Instruction,John Cox,DEM,550202,0,0,255,255,
Oklahoma,Superintendent of Public Instruction,Joy Hofmeister,REP,550202,0,0,142,142,
Oklahoma,Commissioner of Labor,Mike Workman,DEM,550202,0,0,244,244,
Oklahoma,Commissioner of Labor,Mark Costello,REP,550202,0,0,148,148,
Oklahoma,U.S. Senate,Matt Silverstein,DEM,550202,0,0,226,226,
Oklahoma,U.S. Senate,Jim Inhofe,REP,550202,0,0,157,157,
Oklahoma,U.S. Senate,Aaron Delozier,IND,550202,0,0,5,5,
Oklahoma,U.S. Senate,Ray Woods,IND,550202,0,0,5,5,
Oklahoma,U.S. Senate,Joan Farr,IND,550202,0,0,7,7,
Oklahoma,U.S. Senate,Connie Johnson,DEM,550202,0,0,239,239,
Oklahoma,U.S. Senate,James Lankford,REP,550202,0,0,148,148,
Oklahoma,U.S. Senate,Mark Beard,IND,550202,0,0,14,14,
Oklahoma,U.S. House,Al Mcaffrey,DEM,550202,0,0,248,248,05
Oklahoma,U.S. House,Steve Russell,REP,550202,0,0,135,135,05
Oklahoma,U.S. House,Buddy Ray,IND,550202,0,0,5,5,05
Oklahoma,U.S. House,Tom Boggs,IND,550202,0,0,4,4,05
Oklahoma,U.S. House,Robert Murphy,IND,550202,0,0,8,8,05
Oklahoma,State Senate,John Handy Edwards,DEM,550202,0,0,247,247,40
Oklahoma,State Senate,Ervin Yen,REP,550202,0,0,147,147,40
Oklahoma,Governor,Joe Dorman,DEM,550203,0,0,309,309,
Oklahoma,Governor,Mary Fallin,REP,550203,0,0,121,121,
Oklahoma,Governor,Kimberly Willis,IND,550203,0,0,7,7,
Oklahoma,Governor,Richard Prawdzienski,IND,550203,0,0,4,4,
Oklahoma,Lieutenant Governor,Cathy Cummings,DEM,550203,0,0,269,269,
Oklahoma,Lieutenant Governor,Todd Lamb,REP,550203,0,0,164,164,
Oklahoma,Superintendent of Public Instruction,John Cox,DEM,550203,0,0,291,291,
Oklahoma,Superintendent of Public Instruction,Joy Hofmeister,REP,550203,0,0,140,140,
Oklahoma,Commissioner of Labor,Mike Workman,DEM,550203,0,0,261,261,
Oklahoma,Commissioner of Labor,Mark Costello,REP,550203,0,0,158,158,
Oklahoma,U.S. Senate,Matt Silverstein,DEM,550203,0,0,250,250,
Oklahoma,U.S. Senate,Jim Inhofe,REP,550203,0,0,158,158,
Oklahoma,U.S. Senate,Aaron Delozier,IND,550203,0,0,6,6,
Oklahoma,U.S. Senate,Ray Woods,IND,550203,0,0,7,7,
Oklahoma,U.S. Senate,Joan Farr,IND,550203,0,0,10,10,
Oklahoma,U.S. Senate,Connie Johnson,DEM,550203,0,0,274,274,
Oklahoma,U.S. Senate,James Lankford,REP,550203,0,0,147,147,
Oklahoma,U.S. Senate,Mark Beard,IND,550203,0,0,12,12,
Oklahoma,U.S. House,Al Mcaffrey,DEM,550203,0,0,280,280,05
Oklahoma,U.S. House,Steve Russell,REP,550203,0,0,140,140,05
Oklahoma,U.S. House,Buddy Ray,IND,550203,0,0,5,5,05
Oklahoma,U.S. House,Tom Boggs,IND,550203,0,0,4,4,05
Oklahoma,U.S. House,Robert Murphy,IND,550203,0,0,5,5,05
Oklahoma,Governor,Joe Dorman,DEM,550204,0,0,759,759,
Oklahoma,Governor,Mary Fallin,REP,550204,0,0,296,296,
Oklahoma,Governor,Kimberly Willis,IND,550204,0,0,18,18,
Oklahoma,Governor,Richard Prawdzienski,IND,550204,0,0,10,10,
Oklahoma,Lieutenant Governor,Cathy Cummings,DEM,550204,0,0,672,672,
Oklahoma,Lieutenant Governor,Todd Lamb,REP,550204,0,0,404,404,
Oklahoma,Superintendent of Public Instruction,John Cox,DEM,550204,0,0,655,655,
Oklahoma,Superintendent of Public Instruction,Joy Hofmeister,REP,550204,0,0,406,406,
Oklahoma,Commissioner of Labor,Mike Workman,DEM,550204,0,0,637,637,
Oklahoma,Commissioner of Labor,Mark Costello,REP,550204,0,0,391,391,
Oklahoma,U.S. Senate,Matt Silverstein,DEM,550204,0,0,642,642,
Oklahoma,U.S. Senate,Jim Inhofe,REP,550204,0,0,386,386,
Oklahoma,U.S. Senate,Aaron Delozier,IND,550204,0,0,17,17,
Oklahoma,U.S. Senate,Ray Woods,IND,550204,0,0,9,9,
Oklahoma,U.S. Senate,Joan Farr,IND,550204,0,0,17,17,
Oklahoma,U.S. Senate,Connie Johnson,DEM,550204,0,0,643,643,
Oklahoma,U.S. Senate,James Lankford,REP,550204,0,0,410,410,
Oklahoma,U.S. Senate,Mark Beard,IND,550204,0,0,26,26,
Oklahoma,U.S. House,Al Mcaffrey,DEM,550204,0,0,731,731,05
Oklahoma,U.S. House,Steve Russell,REP,550204,0,0,315,315,05
Oklahoma,U.S. House,Buddy Ray,IND,550204,0,0,7,7,05
Oklahoma,U.S. House,Tom Boggs,IND,550204,0,0,9,9,05
Oklahoma,U.S. House,Robert Murphy,IND,550204,0,0,16,16,05
Oklahoma,Governor,Joe Dorman,DEM,550205,0,0,215,215,
Oklahoma,Governor,Mary Fallin,REP,550205,0,0,102,102,
Oklahoma,Governor,Kimberly Willis,IND,550205,0,0,6,6,
Oklahoma,Governor,Richard Prawdzienski,IND,550205,0,0,6,6,
Oklahoma,Lieutenant Governor,Cathy Cummings,DEM,550205,0,0,194,194,
Oklahoma,Lieutenant Governor,Todd Lamb,REP,550205,0,0,131,131,
Oklahoma,Superintendent of Public Instruction,John Cox,DEM,550205,0,0,207,207,
Oklahoma,Superintendent of Public Instruction,Joy Hofmeister,REP,550205,0,0,117,117,
Oklahoma,Commissioner of Labor,Mike Workman,DEM,550205,0,0,190,190,
Oklahoma,Commissioner of Labor,Mark Costello,REP,550205,0,0,129,129,
Oklahoma,U.S. Senate,Matt Silverstein,DEM,550205,0,0,182,182,
Oklahoma,U.S. Senate,Jim Inhofe,REP,550205,0,0,130,130,
Oklahoma,U.S. Senate,Aaron Delozier,IND,550205,0,0,4,4,
Oklahoma,U.S. Senate,Ray Woods,IND,550205,0,0,2,2,
Oklahoma,U.S. Senate,Joan Farr,IND,550205,0,0,8,8,
Oklahoma,U.S. Senate,Connie Johnson,DEM,550205,0,0,188,188,
Oklahoma,U.S. Senate,James Lankford,REP,550205,0,0,133,133,
Oklahoma,U.S. Senate,Mark Beard,IND,550205,0,0,9,9,
Oklahoma,U.S. House,Al Mcaffrey,DEM,550205,0,0,192,192,05
Oklahoma,U.S. House,Steve Russell,REP,550205,0,0,121,121,05
Oklahoma,U.S. House,Buddy Ray,IND,550205,0,0,5,5,05
Oklahoma,U.S. House,Tom Boggs,IND,550205,0,0,5,5,05
Oklahoma,U.S. House,Robert Murphy,IND,550205,0,0,4,4,05
Oklahoma,Governor,Joe Dorman,DEM,550206,0,0,93,93,
Oklahoma,Governor,Mary Fallin,REP,550206,0,0,36,36,
Oklahoma,Governor,Kimberly Willis,IND,550206,0,0,8,8,
Oklahoma,Governor,Richard Prawdzienski,IND,550206,0,0,0,0,
Oklahoma,Lieutenant Governor,Cathy Cummings,DEM,550206,0,0,91,91,
Oklahoma,Lieutenant Governor,Todd Lamb,REP,550206,0,0,46,46,
Oklahoma,Superintendent of Public Instruction,John Cox,DEM,550206,0,0,97,97,
Oklahoma,Superintendent of Public Instruction,Joy Hofmeister,REP,550206,0,0,39,39,
Oklahoma,Commissioner of Labor,Mike Workman,DEM,550206,0,0,100,100,
Oklahoma,Commissioner of Labor,Mark Costello,REP,550206,0,0,35,35,
Oklahoma,U.S. Senate,Matt Silverstein,DEM,550206,0,0,81,81,
Oklahoma,U.S. Senate,Jim Inhofe,REP,550206,0,0,48,48,
Oklahoma,U.S. Senate,Aaron Delozier,IND,550206,0,0,0,0,
Oklahoma,U.S. Senate,Ray Woods,IND,550206,0,0,4,4,
Oklahoma,U.S. Senate,Joan Farr,IND,550206,0,0,4,4,
Oklahoma,U.S. Senate,Connie Johnson,DEM,550206,0,0,86,86,
Oklahoma,U.S. Senate,James Lankford,REP,550206,0,0,43,43,
Oklahoma,U.S. Senate,Mark Beard,IND,550206,0,0,7,7,
Oklahoma,U.S. House,Al Mcaffrey,DEM,550206,0,0,88,88,05
Oklahoma,U.S. House,Steve Russell,REP,550206,0,0,39,39,05
Oklahoma,U.S. House,Buddy Ray,IND,550206,0,0,3,3,05
Oklahoma,U.S. House,Tom Boggs,IND,550206,0,0,1,1,05
Oklahoma,U.S. House,Robert Murphy,IND,550206,0,0,5,5,05
Oklahoma,Governor,Joe Dorman,DEM,550207,0,0,188,188,
Oklahoma,Governor,Mary Fallin,REP,550207,0,0,168,168,
Oklahoma,Governor,Kimberly Willis,IND,550207,0,0,11,11,
Oklahoma,Governor,Richard Prawdzienski,IND,550207,0,0,7,7,
Oklahoma,Lieutenant Governor,Cathy Cummings,DEM,550207,0,0,191,191,
Oklahoma,Lieutenant Governor,Todd Lamb,REP,550207,0,0,180,180,
Oklahoma,Superintendent of Public Instruction,John Cox,DEM,550207,0,0,202,202,
Oklahoma,Superintendent of Public Instruction,Joy Hofmeister,REP,550207,0,0,168,168,
Oklahoma,Commissioner of Labor,Mike Workman,DEM,550207,0,0,195,195,
Oklahoma,Commissioner of Labor,Mark Costello,REP,550207,0,0,169,169,
Oklahoma,U.S. Senate,Matt Silverstein,DEM,550207,0,0,153,153,
Oklahoma,U.S. Senate,Jim Inhofe,REP,550207,0,0,185,185,
Oklahoma,U.S. Senate,Aaron Delozier,IND,550207,0,0,5,5,
Oklahoma,U.S. Senate,Ray Woods,IND,550207,0,0,6,6,
Oklahoma,U.S. Senate,Joan Farr,IND,550207,0,0,16,16,
Oklahoma,U.S. Senate,Connie Johnson,DEM,550207,0,0,166,166,
Oklahoma,U.S. Senate,James Lankford,REP,550207,0,0,186,186,
Oklahoma,U.S. Senate,Mark Beard,IND,550207,0,0,15,15,
Oklahoma,U.S. House,Al Mcaffrey,DEM,550207,0,0,176,176,05
Oklahoma,U.S. House,Steve Russell,REP,550207,0,0,170,170,05
Oklahoma,U.S. House,Buddy Ray,IND,550207,0,0,5,5,05
Oklahoma,U.S. House,Tom Boggs,IND,550207,0,0,5,5,05
Oklahoma,U.S. House,Robert Murphy,IND,550207,0,0,9,9,05
Oklahoma,Governor,Joe Dorman,DEM,550208,0,0,2,2,
Oklahoma,Governor,Mary Fallin,REP,550208,0,0,4,4,
Oklahoma,Governor,Kimberly Willis,IND,550208,0,0,0,0,
Oklahoma,Governor,Richard Prawdzienski,IND,550208,0,0,0,0,
Oklahoma,Lieutenant Governor,Cathy Cummings,DEM,550208,0,0,2,2,
Oklahoma,Lieutenant Governor,Todd Lamb,REP,550208,0,0,4,4,
Oklahoma,Superintendent of Public Instruction,John Cox,DEM,550208,0,0,2,2,
Oklahoma,Superintendent of Public Instruction,Joy Hofmeister,REP,550208,0,0,4,4,
Oklahoma,Commissioner of Labor,Mike Workman,DEM,550208,0,0,2,2,
Oklahoma,Commissioner of Labor,Mark Costello,REP,550208,0,0,2,2,
Oklahoma,U.S. Senate,Matt Silverstein,DEM,550208,0,0,1,1,
Oklahoma,U.S. Senate,Jim Inhofe,REP,550208,0,0,5,5,
Oklahoma,U.S. Senate,Aaron Delozier,IND,550208,0,0,0,0,
Oklahoma,U.S. Senate,Ray Woods,IND,550208,0,0,0,0,
Oklahoma,U.S. Senate,Joan Farr,IND,550208,0,0,0,0,
Oklahoma,U.S. Senate,Connie Johnson,DEM,550208,0,0,2,2,
Oklahoma,U.S. Senate,James Lankford,REP,550208,0,0,4,4,
Oklahoma,U.S. Senate,Mark Beard,IND,550208,0,0,0,0,
Oklahoma,U.S. House,Al Mcaffrey,DEM,550208,0,0,1,1,05
Oklahoma,U.S. House,Steve Russell,REP,550208,0,0,4,4,05
Oklahoma,U.S. House,Buddy Ray,IND,550208,0,0,0,0,05
Oklahoma,U.S. House,Tom Boggs,IND,550208,0,0,0,0,05
Oklahoma,U.S. House,Robert Murphy,IND,550208,0,0,0,0,05
Oklahoma,State Senate,Michael Brooks-Jimenez,DEM,550208,0,0,1,1,44
Oklahoma,State Senate,Ralph Shortey,REP,550208,0,0,1,1,44
Oklahoma,State Senate,Constance Fawcett,IND,550208,0,0,2,2,44
Oklahoma,Governor,Joe Dorman,DEM,550209,0,0,163,163,
Oklahoma,Governor,Mary Fallin,REP,550209,0,0,132,132,
Oklahoma,Governor,Kimberly Willis,IND,550209,0,0,14,14,
Oklahoma,Governor,Richard Prawdzienski,IND,550209,0,0,6,6,
Oklahoma,Lieutenant Governor,Cathy Cummings,DEM,550209,0,0,162,162,
Oklahoma,Lieutenant Governor,Todd Lamb,REP,550209,0,0,149,149,
Oklahoma,Superintendent of Public Instruction,John Cox,DEM,550209,0,0,177,177,
Oklahoma,Superintendent of Public Instruction,Joy Hofmeister,REP,550209,0,0,135,135,
Oklahoma,Commissioner of Labor,Mike Workman,DEM,550209,0,0,185,185,
Oklahoma,Commissioner of Labor,Mark Costello,REP,550209,0,0,124,124,
Oklahoma,U.S. Senate,Matt Silverstein,DEM,550209,0,0,140,140,
Oklahoma,U.S. Senate,Jim Inhofe,REP,550209,0,0,145,145,
Oklahoma,U.S. Senate,Aaron Delozier,IND,550209,0,0,5,5,
Oklahoma,U.S. Senate,Ray Woods,IND,550209,0,0,7,7,
Oklahoma,U.S. Senate,Joan Farr,IND,550209,0,0,13,13,
Oklahoma,U.S. Senate,Connie Johnson,DEM,550209,0,0,156,156,
Oklahoma,U.S. Senate,James Lankford,REP,550209,0,0,144,144,
Oklahoma,U.S. Senate,Mark Beard,IND,550209,0,0,12,12,
Oklahoma,U.S. House,Al Mcaffrey,DEM,550209,0,0,152,152,05
Oklahoma,U.S. House,Steve Russell,REP,550209,0,0,140,140,05
Oklahoma,U.S. House,Buddy Ray,IND,550209,0,0,4,4,05
Oklahoma,U.S. House,Tom Boggs,IND,550209,0,0,3,3,05
Oklahoma,U.S. House,Robert Murphy,IND,550209,0,0,10,10,05
Oklahoma,Governor,Joe Dorman,DEM,550210,0,0,132,132,
Oklahoma,Governor,Mary Fallin,REP,550210,0,0,138,138,
Oklahoma,Governor,Kimberly Willis,IND,550210,0,0,6,6,
Oklahoma,Governor,Richard Prawdzienski,IND,550210,0,0,6,6,
Oklahoma,Lieutenant Governor,Cathy Cummings,DEM,550210,0,0,119,119,
Oklahoma,Lieutenant Governor,Todd Lamb,REP,550210,0,0,160,160,
Oklahoma,Superintendent of Public Instruction,John Cox,DEM,550210,0,0,132,132,
Oklahoma,Superintendent of Public Instruction,Joy Hofmeister,REP,550210,0,0,144,144,
Oklahoma,Commissioner of Labor,Mike Workman,DEM,550210,0,0,128,128,
Oklahoma,Commissioner of Labor,Mark Costello,REP,550210,0,0,145,145,
Oklahoma,U.S. Senate,Matt Silverstein,DEM,550210,0,0,99,99,
Oklahoma,U.S. Senate,Jim Inhofe,REP,550210,0,0,165,165,
Oklahoma,U.S. Senate,Aaron Delozier,IND,550210,0,0,7,7,
Oklahoma,U.S. Senate,Ray Woods,IND,550210,0,0,4,4,
Oklahoma,U.S. Senate,Joan Farr,IND,550210,0,0,6,6,
Oklahoma,U.S. Senate,Connie Johnson,DEM,550210,0,0,110,110,
Oklahoma,U.S. Senate,James Lankford,REP,550210,0,0,160,160,
Oklahoma,U.S. Senate,Mark Beard,IND,550210,0,0,11,11,
Oklahoma,U.S. House,Al Mcaffrey,DEM,550210,0,0,111,111,05
Oklahoma,U.S. House,Steve Russell,REP,550210,0,0,146,146,05
Oklahoma,U.S. House,Buddy Ray,IND,550210,0,0,7,7,05
Oklahoma,U.S. House,Tom Boggs,IND,550210,0,0,8,8,05
Oklahoma,U.S. House,Robert Murphy,IND,550210,0,0,6,6,05
Oklahoma,Governor,Joe Dorman,DEM,550211,0,0,142,142,
Oklahoma,Governor,Mary Fallin,REP,550211,0,0,100,100,
Oklahoma,Governor,Kimberly Willis,IND,550211,0,0,10,10,
Oklahoma,Governor,Richard Prawdzienski,IND,550211,0,0,3,3,
Oklahoma,Lieutenant Governor,Cathy Cummings,DEM,550211,0,0,134,134,
Oklahoma,Lieutenant Governor,Todd Lamb,REP,550211,0,0,121,121,
Oklahoma,Superintendent of Public Instruction,John Cox,DEM,550211,0,0,143,143,
Oklahoma,Superintendent of Public Instruction,Joy Hofmeister,REP,550211,0,0,113,113,
Oklahoma,Commissioner of Labor,Mike Workman,DEM,550211,0,0,126,126,
Oklahoma,Commissioner of Labor,Mark Costello,REP,550211,0,0,124,124,
Oklahoma,U.S. Senate,Matt Silverstein,DEM,550211,0,0,110,110,
Oklahoma,U.S. Senate,Jim Inhofe,REP,550211,0,0,128,128,
Oklahoma,U.S. Senate,Aaron Delozier,IND,550211,0,0,1,1,
Oklahoma,U.S. Senate,Ray Woods,IND,550211,0,0,9,9,
Oklahoma,U.S. Senate,Joan Farr,IND,550211,0,0,5,5,
Oklahoma,U.S. Senate,Connie Johnson,DEM,550211,0,0,113,113,
Oklahoma,U.S. Senate,James Lankford,REP,550211,0,0,132,132,
Oklahoma,U.S. Senate,Mark Beard,IND,550211,0,0,9,9,
Oklahoma,U.S. House,Al Mcaffrey,DEM,550211,0,0,126,126,05
Oklahoma,U.S. House,Steve Russell,REP,550211,0,0,119,119,05
Oklahoma,U.S. House,Buddy Ray,IND,550211,0,0,2,2,05
Oklahoma,U.S. House,Tom Boggs,IND,550211,0,0,3,3,05
Oklahoma,U.S. House,Robert Murphy,IND,550211,0,0,4,4,05
Oklahoma,Governor,Joe Dorman,DEM,550212,0,0,120,120,
Oklahoma,Governor,Mary Fallin,REP,550212,0,0,114,114,
Oklahoma,Governor,Kimberly Willis,IND,550212,0,0,3,3,
Oklahoma,Governor,Richard Prawdzienski,IND,550212,0,0,2,2,
Oklahoma,Lieutenant Governor,Cathy Cummings,DEM,550212,0,0,100,100,
Oklahoma,Lieutenant Governor,Todd Lamb,REP,550212,0,0,138,138,
Oklahoma,Superintendent of Public Instruction,John Cox,DEM,550212,0,0,121,121,
Oklahoma,Superintendent of Public Instruction,Joy Hofmeister,REP,550212,0,0,113,113,
Oklahoma,Commissioner of Labor,Mike Workman,DEM,550212,0,0,112,112,
Oklahoma,Commissioner of Labor,Mark Costello,REP,550212,0,0,121,121,
Oklahoma,U.S. Senate,Matt Silverstein,DEM,550212,0,0,89,89,
Oklahoma,U.S. Senate,Jim Inhofe,REP,550212,0,0,136,136,
Oklahoma,U.S. Senate,Aaron Delozier,IND,550212,0,0,4,4,
Oklahoma,U.S. Senate,Ray Woods,IND,550212,0,0,4,4,
Oklahoma,U.S. Senate,Joan Farr,IND,550212,0,0,2,2,
Oklahoma,U.S. Senate,Connie Johnson,DEM,550212,0,0,94,94,
Oklahoma,U.S. Senate,James Lankford,REP,550212,0,0,137,137,
Oklahoma,U.S. Senate,Mark Beard,IND,550212,0,0,7,7,
Oklahoma,U.S. House,Al Mcaffrey,DEM,550212,0,0,98,98,05
Oklahoma,U.S. House,Steve Russell,REP,550212,0,0,129,129,05
Oklahoma,U.S. House,Buddy Ray,IND,550212,0,0,1,1,05
Oklahoma,U.S. House,Tom Boggs,IND,550212,0,0,3,3,05
Oklahoma,U.S. House,Robert Murphy,IND,550212,0,0,7,7,05
Oklahoma,Governor,Joe Dorman,DEM,550213,0,0,82,82,
Oklahoma,Governor,Mary Fallin,REP,550213,0,0,57,57,
Oklahoma,Governor,Kimberly Willis,IND,550213,0,0,6,6,
Oklahoma,Governor,Richard Prawdzienski,IND,550213,0,0,0,0,
Oklahoma,Lieutenant Governor,Cathy Cummings,DEM,550213,0,0,77,77,
Oklahoma,Lieutenant Governor,Todd Lamb,REP,550213,0,0,67,67,
Oklahoma,Superintendent of Public Instruction,John Cox,DEM,550213,0,0,88,88,
Oklahoma,Superintendent of Public Instruction,Joy Hofmeister,REP,550213,0,0,55,55,
Oklahoma,Commissioner of Labor,Mike Workman,DEM,550213,0,0,79,79,
Oklahoma,Commissioner of Labor,Mark Costello,REP,550213,0,0,64,64,
Oklahoma,U.S. Senate,Matt Silverstein,DEM,550213,0,0,69,69,
Oklahoma,U.S. Senate,Jim Inhofe,REP,550213,0,0,70,70,
Oklahoma,U.S. Senate,Aaron Delozier,IND,550213,0,0,2,2,
Oklahoma,U.S. Senate,Ray Woods,IND,550213,0,0,2,2,
Oklahoma,U.S. Senate,Joan Farr,IND,550213,0,0,2,2,
Oklahoma,U.S. Senate,Connie Johnson,DEM,550213,0,0,73,73,
Oklahoma,U.S. Senate,James Lankford,REP,550213,0,0,64,64,
Oklahoma,U.S. Senate,Mark Beard,IND,550213,0,0,8,8,
Oklahoma,U.S. House,Al Mcaffrey,DEM,550213,0,0,78,78,05
Oklahoma,U.S. House,Steve Russell,REP,550213,0,0,60,60,05
Oklahoma,U.S. House,Buddy Ray,IND,550213,0,0,2,2,05
Oklahoma,U.S. House,Tom Boggs,IND,550213,0,0,1,1,05
Oklahoma,U.S. House,Robert Murphy,IND,550213,0,0,2,2,05
Oklahoma,Governor,Joe Dorman,DEM,550214,0,0,99,99,
Oklahoma,Governor,Mary Fallin,REP,550214,0,0,128,128,
Oklahoma,Governor,Kimberly Willis,IND,550214,0,0,7,7,
Oklahoma,Governor,Richard Prawdzienski,IND,550214,0,0,6,6,
Oklahoma,Lieutenant Governor,Cathy Cummings,DEM,550214,0,0,93,93,
Oklahoma,Lieutenant Governor,Todd Lamb,REP,550214,0,0,145,145,
Oklahoma,Superintendent of Public Instruction,John Cox,DEM,550214,0,0,97,97,
Oklahoma,Superintendent of Public Instruction,Joy Hofmeister,REP,550214,0,0,143,143,
Oklahoma,Commissioner of Labor,Mike Workman,DEM,550214,0,0,94,94,
Oklahoma,Commissioner of Labor,Mark Costello,REP,550214,0,0,139,139,
Oklahoma,U.S. Senate,Matt Silverstein,DEM,550214,0,0,71,71,
Oklahoma,U.S. Senate,Jim Inhofe,REP,550214,0,0,153,153,
Oklahoma,U.S. Senate,Aaron Delozier,IND,550214,0,0,4,4,
Oklahoma,U.S. Senate,Ray Woods,IND,550214,0,0,6,6,
Oklahoma,U.S. Senate,Joan Farr,IND,550214,0,0,7,7,
Oklahoma,U.S. Senate,Connie Johnson,DEM,550214,0,0,84,84,
Oklahoma,U.S. Senate,James Lankford,REP,550214,0,0,144,144,
Oklahoma,U.S. Senate,Mark Beard,IND,550214,0,0,12,12,
Oklahoma,U.S. House,Al Mcaffrey,DEM,550214,0,0,86,86,05
Oklahoma,U.S. House,Steve Russell,REP,550214,0,0,134,134,05
Oklahoma,U.S. House,Buddy Ray,IND,550214,0,0,2,2,05
Oklahoma,U.S. House,Tom Boggs,IND,550214,0,0,7,7,05
Oklahoma,U.S. House,Robert Murphy,IND,550214,0,0,7,7,05
Oklahoma,State Senate,Michael Brooks-Jimenez,DEM,550214,0,0,113,113,44
Oklahoma,State Senate,Ralph Shortey,REP,550214,0,0,110,110,44
Oklahoma,State Senate,Constance Fawcett,IND,550214,0,0,18,18,44
Oklahoma,State House,William Lee Molden,DEM,550214,0,0,106,106,93
Oklahoma,State House,Mike Christian,REP,550214,0,0,130,130,93
Oklahoma,Governor,Joe Dorman,DEM,550215,0,0,141,141,
Oklahoma,Governor,Mary Fallin,REP,550215,0,0,119,119,
Oklahoma,Governor,Kimberly Willis,IND,550215,0,0,9,9,
Oklahoma,Governor,Richard Prawdzienski,IND,550215,0,0,3,3,
Oklahoma,Lieutenant Governor,Cathy Cummings,DEM,550215,0,0,131,131,
Oklahoma,Lieutenant Governor,Todd Lamb,REP,550215,0,0,141,141,
Oklahoma,Superintendent of Public Instruction,John Cox,DEM,550215,0,0,153,153,
Oklahoma,Superintendent of Public Instruction,Joy Hofmeister,REP,550215,0,0,117,117,
Oklahoma,Commissioner of Labor,Mike Workman,DEM,550215,0,0,147,147,
Oklahoma,Commissioner of Labor,Mark Costello,REP,550215,0,0,119,119,
Oklahoma,U.S. Senate,Matt Silverstein,DEM,550215,0,0,118,118,
Oklahoma,U.S. Senate,Jim Inhofe,REP,550215,0,0,141,141,
Oklahoma,U.S. Senate,Aaron Delozier,IND,550215,0,0,5,5,
Oklahoma,U.S. Senate,Ray Woods,IND,550215,0,0,2,2,
Oklahoma,U.S. Senate,Joan Farr,IND,550215,0,0,3,3,
Oklahoma,U.S. Senate,Connie Johnson,DEM,550215,0,0,121,121,
Oklahoma,U.S. Senate,James Lankford,REP,550215,0,0,147,147,
Oklahoma,U.S. Senate,Mark Beard,IND,550215,0,0,4,4,
Oklahoma,U.S. House,Al Mcaffrey,DEM,550215,0,0,124,124,05
Oklahoma,U.S. House,Steve Russell,REP,550215,0,0,131,131,05
Oklahoma,U.S. House,Buddy Ray,IND,550215,0,0,2,2,05
Oklahoma,U.S. House,Tom Boggs,IND,550215,0,0,4,4,05
Oklahoma,U.S. House,Robert Murphy,IND,550215,0,0,8,8,05
Oklahoma,Governor,Joe Dorman,DEM,550216,0,0,4,4,
Oklahoma,Governor,Mary Fallin,REP,550216,0,0,3,3,
Oklahoma,Governor,Kimberly Willis,IND,550216,0,0,0,0,
Oklahoma,Governor,Richard Prawdzienski,IND,550216,0,0,0,0,
Oklahoma,Lieutenant Governor,Cathy Cummings,DEM,550216,0,0,5,5,
Oklahoma,Lieutenant Governor,Todd Lamb,REP,550216,0,0,2,2,
Oklahoma,Superintendent of Public Instruction,John Cox,DEM,550216,0,0,5,5,
Oklahoma,Superintendent of Public Instruction,Joy Hofmeister,REP,550216,0,0,2,2,
Oklahoma,Commissioner of Labor,Mike Workman,DEM,550216,0,0,4,4,
Oklahoma,Commissioner of Labor,Mark Costello,REP,550216,0,0,2,2,
Oklahoma,U.S. Senate,Matt Silverstein,DEM,550216,0,0,4,4,
Oklahoma,U.S. Senate,Jim Inhofe,REP,550216,0,0,3,3,
Oklahoma,U.S. Senate,Aaron Delozier,IND,550216,0,0,0,0,
Oklahoma,U.S. Senate,Ray Woods,IND,550216,0,0,0,0,
Oklahoma,U.S. Senate,Joan Farr,IND,550216,0,0,0,0,
Oklahoma,U.S. Senate,Connie Johnson,DEM,550216,0,0,4,4,
Oklahoma,U.S. Senate,James Lankford,REP,550216,0,0,3,3,
Oklahoma,U.S. Senate,Mark Beard,IND,550216,0,0,0,0,
Oklahoma,U.S. House,Al Mcaffrey,DEM,550216,0,0,3,3,05
Oklahoma,U.S. House,Steve Russell,REP,550216,0,0,3,3,05
Oklahoma,U.S. House,Buddy Ray,IND,550216,0,0,0,0,05
Oklahoma,U.S. House,Tom Boggs,IND,550216,0,0,1,1,05
Oklahoma,U.S. House,Robert Murphy,IND,550216,0,0,0,0,05
Oklahoma,State House,William Lee Molden,DEM,550216,0,0,5,5,93
Oklahoma,State House,Mike Christian,REP,550216,0,0,2,2,93
Oklahoma,Governor,Joe Dorman,DEM,550217,0,0,172,172,
Oklahoma,Governor,Mary Fallin,REP,550217,0,0,207,207,
Oklahoma,Governor,Kimberly Willis,IND,550217,0,0,12,12,
Oklahoma,Governor,Richard Prawdzienski,IND,550217,0,0,1,1,
Oklahoma,Lieutenant Governor,Cathy Cummings,DEM,550217,0,0,169,169,
Oklahoma,Lieutenant Governor,Todd Lamb,REP,550217,0,0,221,221,
Oklahoma,Superintendent of Public Instruction,John Cox,DEM,550217,0,0,192,192,
Oklahoma,Superintendent of Public Instruction,Joy Hofmeister,REP,550217,0,0,196,196,
Oklahoma,Commissioner of Labor,Mike Workman,DEM,550217,0,0,171,171,
Oklahoma,Commissioner of Labor,Mark Costello,REP,550217,0,0,211,211,
Oklahoma,U.S. Senate,Matt Silverstein,DEM,550217,0,0,142,142,
Oklahoma,U.S. Senate,Jim Inhofe,REP,550217,0,0,229,229,
Oklahoma,U.S. Senate,Aaron Delozier,IND,550217,0,0,4,4,
Oklahoma,U.S. Senate,Ray Woods,IND,550217,0,0,6,6,
Oklahoma,U.S. Senate,Joan Farr,IND,550217,0,0,10,10,
Oklahoma,U.S. Senate,Connie Johnson,DEM,550217,0,0,149,149,
Oklahoma,U.S. Senate,James Lankford,REP,550217,0,0,232,232,
Oklahoma,U.S. Senate,Mark Beard,IND,550217,0,0,10,10,
Oklahoma,U.S. House,Al Mcaffrey,DEM,550217,0,0,150,150,05
Oklahoma,U.S. House,Steve Russell,REP,550217,0,0,218,218,05
Oklahoma,U.S. House,Buddy Ray,IND,550217,0,0,5,5,05
Oklahoma,U.S. House,Tom Boggs,IND,550217,0,0,10,10,05
Oklahoma,U.S. House,Robert Murphy,IND,550217,0,0,5,5,05
Oklahoma,State Senate,Michael Brooks-Jimenez,DEM,550217,0,0,188,188,44
Oklahoma,State Senate,Ralph Shortey,REP,550217,0,0,180,180,44
Oklahoma,State Senate,Constance Fawcett,IND,550217,0,0,19,19,44
Oklahoma,Governor,Joe Dorman,DEM,550218,0,0,227,227,
Oklahoma,Governor,Mary Fallin,REP,550218,0,0,297,297,
Oklahoma,Governor,Kimberly Willis,IND,550218,0,0,13,13,
Oklahoma,Governor,Richard Prawdzienski,IND,550218,0,0,6,6,
Oklahoma,Lieutenant Governor,Cathy Cummings,DEM,550218,0,0,203,203,
Oklahoma,Lieutenant Governor,Todd Lamb,REP,550218,0,0,339,339,
Oklahoma,Superintendent of Public Instruction,John Cox,DEM,550218,0,0,259,259,
Oklahoma,Superintendent of Public Instruction,Joy Hofmeister,REP,550218,0,0,278,278,
Oklahoma,Commissioner of Labor,Mike Workman,DEM,550218,0,0,217,217,
Oklahoma,Commissioner of Labor,Mark Costello,REP,550218,0,0,313,313,
Oklahoma,U.S. Senate,Matt Silverstein,DEM,550218,0,0,173,173,
Oklahoma,U.S. Senate,Jim Inhofe,REP,550218,0,0,345,345,
Oklahoma,U.S. Senate,Aaron Delozier,IND,550218,0,0,7,7,
Oklahoma,U.S. Senate,Ray Woods,IND,550218,0,0,7,7,
Oklahoma,U.S. Senate,Joan Farr,IND,550218,0,0,10,10,
Oklahoma,U.S. Senate,Connie Johnson,DEM,550218,0,0,183,183,
Oklahoma,U.S. Senate,James Lankford,REP,550218,0,0,343,343,
Oklahoma,U.S. Senate,Mark Beard,IND,550218,0,0,17,17,
Oklahoma,U.S. House,Al Mcaffrey,DEM,550218,0,0,188,188,05
Oklahoma,U.S. House,Steve Russell,REP,550218,0,0,324,324,05
Oklahoma,U.S. House,Buddy Ray,IND,550218,0,0,10,10,05
Oklahoma,U.S. House,Tom Boggs,IND,550218,0,0,3,3,05
Oklahoma,U.S. House,Robert Murphy,IND,550218,0,0,13,13,05
Oklahoma,State Senate,Michael Brooks-Jimenez,DEM,550218,0,0,256,256,44
Oklahoma,State Senate,Ralph Shortey,REP,550218,0,0,251,251,44
Oklahoma,State Senate,Constance Fawcett,IND,550218,0,0,31,31,44
Oklahoma,State House,William Lee Molden,DEM,550218,0,0,227,227,93
Oklahoma,State House,Mike Christian,REP,550218,0,0,306,306,93
Oklahoma,Governor,Joe Dorman,DEM,550219,0,0,115,115,
Oklahoma,Governor,Mary Fallin,REP,550219,0,0,132,132,
Oklahoma,Governor,Kimberly Willis,IND,550219,0,0,5,5,
Oklahoma,Governor,Richard Prawdzienski,IND,550219,0,0,3,3,
Oklahoma,Lieutenant Governor,Cathy Cummings,DEM,550219,0,0,111,111,
Oklahoma,Lieutenant Governor,Todd Lamb,REP,550219,0,0,144,144,
Oklahoma,Superintendent of Public Instruction,John Cox,DEM,550219,0,0,115,115,
Oklahoma,Superintendent of Public Instruction,Joy Hofmeister,REP,550219,0,0,138,138,
Oklahoma,Commissioner of Labor,Mike Workman,DEM,550219,0,0,115,115,
Oklahoma,Commissioner of Labor,Mark Costello,REP,550219,0,0,136,136,
Oklahoma,U.S. Senate,Matt Silverstein,DEM,550219,0,0,96,96,
Oklahoma,U.S. Senate,Jim Inhofe,REP,550219,0,0,147,147,
Oklahoma,U.S. Senate,Aaron Delozier,IND,550219,0,0,1,1,
Oklahoma,U.S. Senate,Ray Woods,IND,550219,0,0,5,5,
Oklahoma,U.S. Senate,Joan Farr,IND,550219,0,0,5,5,
Oklahoma,U.S. Senate,Connie Johnson,DEM,550219,0,0,94,94,
Oklahoma,U.S. Senate,James Lankford,REP,550219,0,0,155,155,
Oklahoma,U.S. Senate,Mark Beard,IND,550219,0,0,5,5,
Oklahoma,U.S. House,Al Mcaffrey,DEM,550219,0,0,98,98,05
Oklahoma,U.S. House,Steve Russell,REP,550219,0,0,146,146,05
Oklahoma,U.S. House,Buddy Ray,IND,550219,0,0,5,5,05
Oklahoma,U.S. House,Tom Boggs,IND,550219,0,0,0,0,05
Oklahoma,U.S. House,Robert Murphy,IND,550219,0,0,5,5,05
Oklahoma,State House,William Lee Molden,DEM,550219,0,0,112,112,93
Oklahoma,State House,Mike Christian,REP,550219,0,0,141,141,93
Oklahoma,Governor,Joe Dorman,DEM,550220,0,0,224,224,
Oklahoma,Governor,Mary Fallin,REP,550220,0,0,265,265,
Oklahoma,Governor,Kimberly Willis,IND,550220,0,0,14,14,
Oklahoma,Governor,Richard Prawdzienski,IND,550220,0,0,6,6,
Oklahoma,Lieutenant Governor,Cathy Cummings,DEM,550220,0,0,205,205,
Oklahoma,Lieutenant Governor,Todd Lamb,REP,550220,0,0,303,303,
Oklahoma,Superintendent of Public Instruction,John Cox,DEM,550220,0,0,229,229,
Oklahoma,Superintendent of Public Instruction,Joy Hofmeister,REP,550220,0,0,271,271,
Oklahoma,Commissioner of Labor,Mike Workman,DEM,550220,0,0,224,224,
Oklahoma,Commissioner of Labor,Mark Costello,REP,550220,0,0,274,274,
Oklahoma,U.S. Senate,Matt Silverstein,DEM,550220,0,0,194,194,
Oklahoma,U.S. Senate,Jim Inhofe,REP,550220,0,0,299,299,
Oklahoma,U.S. Senate,Aaron Delozier,IND,550220,0,0,3,3,
Oklahoma,U.S. Senate,Ray Woods,IND,550220,0,0,6,6,
Oklahoma,U.S. Senate,Joan Farr,IND,550220,0,0,5,5,
Oklahoma,U.S. Senate,Connie Johnson,DEM,550220,0,0,191,191,
Oklahoma,U.S. Senate,James Lankford,REP,550220,0,0,305,305,
Oklahoma,U.S. Senate,Mark Beard,IND,550220,0,0,15,15,
Oklahoma,U.S. House,Al Mcaffrey,DEM,550220,0,0,197,197,05
Oklahoma,U.S. House,Steve Russell,REP,550220,0,0,286,286,05
Oklahoma,U.S. House,Buddy Ray,IND,550220,0,0,7,7,05
Oklahoma,U.S. House,Tom Boggs,IND,550220,0,0,8,8,05
Oklahoma,U.S. House,Robert Murphy,IND,550220,0,0,8,8,05
Oklahoma,State Senate,Michael Brooks-Jimenez,DEM,550220,0,0,244,244,44
Oklahoma,State Senate,Ralph Shortey,REP,550220,0,0,243,243,44
Oklahoma,State Senate,Constance Fawcett,IND,550220,0,0,25,25,44
Oklahoma,State House,William Lee Molden,DEM,550220,0,0,219,219,93
Oklahoma,State House,Mike Christian,REP,550220,0,0,284,284,93
Oklahoma,Governor,Joe Dorman,DEM,550221,0,0,276,276,
Oklahoma,Governor,Mary Fallin,REP,550221,0,0,359,359,
Oklahoma,Governor,Kimberly Willis,IND,550221,0,0,8,8,
Oklahoma,Governor,Richard Prawdzienski,IND,550221,0,0,7,7,
Oklahoma,Lieutenant Governor,Cathy Cummings,DEM,550221,0,0,239,239,
Oklahoma,Lieutenant Governor,Todd Lamb,REP,550221,0,0,407,407,
Oklahoma,Superintendent of Public Instruction,John Cox,DEM,550221,0,0,286,286,
Oklahoma,Superintendent of Public Instruction,Joy Hofmeister,REP,550221,0,0,355,355,
Oklahoma,Commissioner of Labor,Mike Workman,DEM,550221,0,0,258,258,
Oklahoma,Commissioner of Labor,Mark Costello,REP,550221,0,0,374,374,
Oklahoma,U.S. Senate,Matt Silverstein,DEM,550221,0,0,218,218,
Oklahoma,U.S. Senate,Jim Inhofe,REP,550221,0,0,404,404,
Oklahoma,U.S. Senate,Aaron Delozier,IND,550221,0,0,8,8,
Oklahoma,U.S. Senate,Ray Woods,IND,550221,0,0,9,9,
Oklahoma,U.S. Senate,Joan Farr,IND,550221,0,0,6,6,
Oklahoma,U.S. Senate,Connie Johnson,DEM,550221,0,0,217,217,
Oklahoma,U.S. Senate,James Lankford,REP,550221,0,0,412,412,
Oklahoma,U.S. Senate,Mark Beard,IND,550221,0,0,15,15,
Oklahoma,U.S. House,Al Mcaffrey,DEM,550221,0,0,228,228,05
Oklahoma,U.S. House,Steve Russell,REP,550221,0,0,394,394,05
Oklahoma,U.S. House,Buddy Ray,IND,550221,0,0,7,7,05
Oklahoma,U.S. House,Tom Boggs,IND,550221,0,0,4,4,05
Oklahoma,U.S. House,Robert Murphy,IND,550221,0,0,8,8,05
Oklahoma,State Senate,Michael Brooks-Jimenez,DEM,550221,0,0,298,298,44
Oklahoma,State Senate,Ralph Shortey,REP,550221,0,0,324,324,44
Oklahoma,State Senate,Constance Fawcett,IND,550221,0,0,18,18,44
Oklahoma,State House,William Lee Molden,DEM,550221,0,0,276,276,93
Oklahoma,State House,Mike Christian,REP,550221,0,0,359,359,93
Oklahoma,Governor,Joe Dorman,DEM,550222,0,0,142,142,
Oklahoma,Governor,Mary Fallin,REP,550222,0,0,164,164,
Oklahoma,Governor,Kimberly Willis,IND,550222,0,0,8,8,
Oklahoma,Governor,Richard Prawdzienski,IND,550222,0,0,3,3,
Oklahoma,Lieutenant Governor,Cathy Cummings,DEM,550222,0,0,119,119,
Oklahoma,Lieutenant Governor,Todd Lamb,REP,550222,0,0,198,198,
Oklahoma,Superintendent of Public Instruction,John Cox,DEM,550222,0,0,141,141,
Oklahoma,Superintendent of Public Instruction,Joy Hofmeister,REP,550222,0,0,173,173,
Oklahoma,Commissioner of Labor,Mike Workman,DEM,550222,0,0,141,141,
Oklahoma,Commissioner of Labor,Mark Costello,REP,550222,0,0,168,168,
Oklahoma,U.S. Senate,Matt Silverstein,DEM,550222,0,0,92,92,
Oklahoma,U.S. Senate,Jim Inhofe,REP,550222,0,0,205,205,
Oklahoma,U.S. Senate,Aaron Delozier,IND,550222,0,0,2,2,
Oklahoma,U.S. Senate,Ray Woods,IND,550222,0,0,7,7,
Oklahoma,U.S. Senate,Joan Farr,IND,550222,0,0,8,8,
Oklahoma,U.S. Senate,Connie Johnson,DEM,550222,0,0,101,101,
Oklahoma,U.S. Senate,James Lankford,REP,550222,0,0,207,207,
Oklahoma,U.S. Senate,Mark Beard,IND,550222,0,0,10,10,
Oklahoma,U.S. House,Al Mcaffrey,DEM,550222,0,0,114,114,05
Oklahoma,U.S. House,Steve Russell,REP,550222,0,0,183,183,05
Oklahoma,U.S. House,Buddy Ray,IND,550222,0,0,5,5,05
Oklahoma,U.S. House,Tom Boggs,IND,550222,0,0,3,3,05
Oklahoma,U.S. House,Robert Murphy,IND,550222,0,0,7,7,05
Oklahoma,State Senate,Michael Brooks-Jimenez,DEM,550222,0,0,133,133,44
Oklahoma,State Senate,Ralph Shortey,REP,550222,0,0,157,157,44
Oklahoma,State Senate,Constance Fawcett,IND,550222,0,0,22,22,44
Oklahoma,State House,William Lee Molden,DEM,550222,0,0,135,135,93
Oklahoma,State House,Mike Christian,REP,550222,0,0,177,177,93
Oklahoma,Governor,Joe Dorman,DEM,550223,0,0,150,150,
Oklahoma,Governor,Mary Fallin,REP,550223,0,0,113,113,
Oklahoma,Governor,Kimberly Willis,IND,550223,0,0,4,4,
Oklahoma,Governor,Richard Prawdzienski,IND,550223,0,0,2,2,
Oklahoma,Lieutenant Governor,Cathy Cummings,DEM,550223,0,0,127,127,
Oklahoma,Lieutenant Governor,Todd Lamb,REP,550223,0,0,142,142,
Oklahoma,Superintendent of Public Instruction,John Cox,DEM,550223,0,0,148,148,
Oklahoma,Superintendent of Public Instruction,Joy Hofmeister,REP,550223,0,0,119,119,
Oklahoma,Commissioner of Labor,Mike Workman,DEM,550223,0,0,141,141,
Oklahoma,Commissioner of Labor,Mark Costello,REP,550223,0,0,126,126,
Oklahoma,U.S. Senate,Matt Silverstein,DEM,550223,0,0,106,106,
Oklahoma,U.S. Senate,Jim Inhofe,REP,550223,0,0,143,143,
Oklahoma,U.S. Senate,Aaron Delozier,IND,550223,0,0,10,10,
Oklahoma,U.S. Senate,Ray Woods,IND,550223,0,0,4,4,
Oklahoma,U.S. Senate,Joan Farr,IND,550223,0,0,4,4,
Oklahoma,U.S. Senate,Connie Johnson,DEM,550223,0,0,114,114,
Oklahoma,U.S. Senate,James Lankford,REP,550223,0,0,144,144,
Oklahoma,U.S. Senate,Mark Beard,IND,550223,0,0,12,12,
Oklahoma,U.S. House,Al Mcaffrey,DEM,550223,0,0,118,118,05
Oklahoma,U.S. House,Steve Russell,REP,550223,0,0,135,135,05
Oklahoma,U.S. House,Buddy Ray,IND,550223,0,0,5,5,05
Oklahoma,U.S. House,Tom Boggs,IND,550223,0,0,5,5,05
Oklahoma,U.S. House,Robert Murphy,IND,550223,0,0,5,5,05
Oklahoma,State Senate,Michael Brooks-Jimenez,DEM,550223,0,0,138,138,44
Oklahoma,State Senate,Ralph Shortey,REP,550223,0,0,112,112,44
Oklahoma,State Senate,Constance Fawcett,IND,550223,0,0,19,19,44
Oklahoma,Governor,Joe Dorman,DEM,550224,0,0,172,172,
Oklahoma,Governor,Mary Fallin,REP,550224,0,0,151,151,
Oklahoma,Governor,Kimberly Willis,IND,550224,0,0,10,10,
Oklahoma,Governor,Richard Prawdzienski,IND,550224,0,0,6,6,
Oklahoma,Lieutenant Governor,Cathy Cummings,DEM,550224,0,0,156,156,
Oklahoma,Lieutenant Governor,Todd Lamb,REP,550224,0,0,181,181,
Oklahoma,Superintendent of Public Instruction,John Cox,DEM,550224,0,0,177,177,
Oklahoma,Superintendent of Public Instruction,Joy Hofmeister,REP,550224,0,0,160,160,
Oklahoma,Commissioner of Labor,Mike Workman,DEM,550224,0,0,175,175,
Oklahoma,Commissioner of Labor,Mark Costello,REP,550224,0,0,160,160,
Oklahoma,U.S. Senate,Matt Silverstein,DEM,550224,0,0,127,127,
Oklahoma,U.S. Senate,Jim Inhofe,REP,550224,0,0,186,186,
Oklahoma,U.S. Senate,Aaron Delozier,IND,550224,0,0,2,2,
Oklahoma,U.S. Senate,Ray Woods,IND,550224,0,0,10,10,
Oklahoma,U.S. Senate,Joan Farr,IND,550224,0,0,12,12,
Oklahoma,U.S. Senate,Connie Johnson,DEM,550224,0,0,142,142,
Oklahoma,U.S. Senate,James Lankford,REP,550224,0,0,178,178,
Oklahoma,U.S. Senate,Mark Beard,IND,550224,0,0,18,18,
Oklahoma,U.S. House,Al Mcaffrey,DEM,550224,0,0,141,141,05
Oklahoma,U.S. House,Steve Russell,REP,550224,0,0,174,174,05
Oklahoma,U.S. House,Buddy Ray,IND,550224,0,0,4,4,05
Oklahoma,U.S. House,Tom Boggs,IND,550224,0,0,11,11,05
Oklahoma,U.S. House,Robert Murphy,IND,550224,0,0,8,8,05
Oklahoma,State Senate,Michael Brooks-Jimenez,DEM,550224,0,0,168,168,44
Oklahoma,State Senate,Ralph Shortey,REP,550224,0,0,143,143,44
Oklahoma,State Senate,Constance Fawcett,IND,550224,0,0,27,27,44
Oklahoma,State House,William Lee Molden,DEM,550224,0,0,159,159,93
Oklahoma,State House,Mike Christian,REP,550224,0,0,177,177,93
Oklahoma,Governor,Joe Dorman,DEM,550225,0,0,24,24,
Oklahoma,Governor,Mary Fallin,REP,550225,0,0,31,31,
Oklahoma,Governor,Kimberly Willis,IND,550225,0,0,2,2,
Oklahoma,Governor,Richard Prawdzienski,IND,550225,0,0,2,2,
Oklahoma,Lieutenant Governor,Cathy Cummings,DEM,550225,0,0,25,25,
Oklahoma,Lieutenant Governor,Todd Lamb,REP,550225,0,0,33,33,
Oklahoma,Superintendent of Public Instruction,John Cox,DEM,550225,0,0,26,26,
Oklahoma,Superintendent of Public Instruction,Joy Hofmeister,REP,550225,0,0,32,32,
Oklahoma,Commissioner of Labor,Mike Workman,DEM,550225,0,0,29,29,
Oklahoma,Commissioner of Labor,Mark Costello,REP,550225,0,0,29,29,
Oklahoma,U.S. Senate,Matt Silverstein,DEM,550225,0,0,22,22,
Oklahoma,U.S. Senate,Jim Inhofe,REP,550225,0,0,33,33,
Oklahoma,U.S. Senate,Aaron Delozier,IND,550225,0,0,1,1,
Oklahoma,U.S. Senate,Ray Woods,IND,550225,0,0,0,0,
Oklahoma,U.S. Senate,Joan Farr,IND,550225,0,0,1,1,
Oklahoma,U.S. Senate,Connie Johnson,DEM,550225,0,0,23,23,
Oklahoma,U.S. Senate,James Lankford,REP,550225,0,0,34,34,
Oklahoma,U.S. Senate,Mark Beard,IND,550225,0,0,1,1,
Oklahoma,U.S. House,Al Mcaffrey,DEM,550225,0,0,23,23,05
Oklahoma,U.S. House,Steve Russell,REP,550225,0,0,33,33,05
Oklahoma,U.S. House,Buddy Ray,IND,550225,0,0,0,0,05
Oklahoma,U.S. House,Tom Boggs,IND,550225,0,0,1,1,05
Oklahoma,U.S. House,Robert Murphy,IND,550225,0,0,1,1,05
Oklahoma,State Senate,Michael Brooks-Jimenez,DEM,550225,0,0,20,20,44
Oklahoma,State Senate,Ralph Shortey,REP,550225,0,0,33,33,44
Oklahoma,State Senate,Constance Fawcett,IND,550225,0,0,6,6,44
Oklahoma,Governor,Joe Dorman,DEM,550226,0,0,159,159,
Oklahoma,Governor,Mary Fallin,REP,550226,0,0,198,198,
Oklahoma,Governor,Kimberly Willis,IND,550226,0,0,10,10,
Oklahoma,Governor,Richard Prawdzienski,IND,550226,0,0,5,5,
Oklahoma,Lieutenant Governor,Cathy Cummings,DEM,550226,0,0,152,152,
Oklahoma,Lieutenant Governor,Todd Lamb,REP,550226,0,0,219,219,
Oklahoma,Superintendent of Public Instruction,John Cox,DEM,550226,0,0,184,184,
Oklahoma,Superintendent of Public Instruction,Joy Hofmeister,REP,550226,0,0,186,186,
Oklahoma,Commissioner of Labor,Mike Workman,DEM,550226,0,0,159,159,
Oklahoma,Commissioner of Labor,Mark Costello,REP,550226,0,0,206,206,
Oklahoma,U.S. Senate,Matt Silverstein,DEM,550226,0,0,135,135,
Oklahoma,U.S. Senate,Jim Inhofe,REP,550226,0,0,216,216,
Oklahoma,U.S. Senate,Aaron Delozier,IND,550226,0,0,6,6,
Oklahoma,U.S. Senate,Ray Woods,IND,550226,0,0,9,9,
Oklahoma,U.S. Senate,Joan Farr,IND,550226,0,0,6,6,
Oklahoma,U.S. Senate,Connie Johnson,DEM,550226,0,0,135,135,
Oklahoma,U.S. Senate,James Lankford,REP,550226,0,0,223,223,
Oklahoma,U.S. Senate,Mark Beard,IND,550226,0,0,13,13,
Oklahoma,U.S. House,Al Mcaffrey,DEM,550226,0,0,133,133,05
Oklahoma,U.S. House,Steve Russell,REP,550226,0,0,214,214,05
Oklahoma,U.S. House,Buddy Ray,IND,550226,0,0,2,2,05
Oklahoma,U.S. House,Tom Boggs,IND,550226,0,0,10,10,05
Oklahoma,U.S. House,Robert Murphy,IND,550226,0,0,9,9,05
Oklahoma,State Senate,Michael Brooks-Jimenez,DEM,550226,0,0,157,157,44
Oklahoma,State Senate,Ralph Shortey,REP,550226,0,0,183,183,44
Oklahoma,State Senate,Constance Fawcett,IND,550226,0,0,31,31,44
Oklahoma,Governor,Joe Dorman,DEM,550227,0,0,132,132,
Oklahoma,Governor,Mary Fallin,REP,550227,0,0,131,131,
Oklahoma,Governor,Kimberly Willis,IND,550227,0,0,10,10,
Oklahoma,Governor,Richard Prawdzienski,IND,550227,0,0,5,5,
Oklahoma,Lieutenant Governor,Cathy Cummings,DEM,550227,0,0,114,114,
Oklahoma,Lieutenant Governor,Todd Lamb,REP,550227,0,0,162,162,
Oklahoma,Superintendent of Public Instruction,John Cox,DEM,550227,0,0,152,152,
Oklahoma,Superintendent of Public Instruction,Joy Hofmeister,REP,550227,0,0,122,122,
Oklahoma,Commissioner of Labor,Mike Workman,DEM,550227,0,0,136,136,
Oklahoma,Commissioner of Labor,Mark Costello,REP,550227,0,0,132,132,
Oklahoma,U.S. Senate,Matt Silverstein,DEM,550227,0,0,105,105,
Oklahoma,U.S. Senate,Jim Inhofe,REP,550227,0,0,155,155,
Oklahoma,U.S. Senate,Aaron Delozier,IND,550227,0,0,3,3,
Oklahoma,U.S. Senate,Ray Woods,IND,550227,0,0,9,9,
Oklahoma,U.S. Senate,Joan Farr,IND,550227,0,0,2,2,
Oklahoma,U.S. Senate,Connie Johnson,DEM,550227,0,0,109,109,
Oklahoma,U.S. Senate,James Lankford,REP,550227,0,0,156,156,
Oklahoma,U.S. Senate,Mark Beard,IND,550227,0,0,12,12,
Oklahoma,U.S. House,Al Mcaffrey,DEM,550227,0,0,112,112,05
Oklahoma,U.S. House,Steve Russell,REP,550227,0,0,142,142,05
Oklahoma,U.S. House,Buddy Ray,IND,550227,0,0,6,6,05
Oklahoma,U.S. House,Tom Boggs,IND,550227,0,0,5,5,05
Oklahoma,U.S. House,Robert Murphy,IND,550227,0,0,7,7,05
Oklahoma,State Senate,Michael Brooks-Jimenez,DEM,550227,0,0,142,142,44
Oklahoma,State Senate,Ralph Shortey,REP,550227,0,0,114,114,44
Oklahoma,State Senate,Constance Fawcett,IND,550227,0,0,17,17,44
Oklahoma,Governor,Joe Dorman,DEM,550228,0,0,138,138,
Oklahoma,Governor,Mary Fallin,REP,550228,0,0,124,124,
Oklahoma,Governor,Kimberly Willis,IND,550228,0,0,10,10,
Oklahoma,Governor,Richard Prawdzienski,IND,550228,0,0,0,0,
Oklahoma,Lieutenant Governor,Cathy Cummings,DEM,550228,0,0,124,124,
Oklahoma,Lieutenant Governor,Todd Lamb,REP,550228,0,0,145,145,
Oklahoma,Superintendent of Public Instruction,John Cox,DEM,550228,0,0,147,147,
Oklahoma,Superintendent of Public Instruction,Joy Hofmeister,REP,550228,0,0,123,123,
Oklahoma,Commissioner of Labor,Mike Workman,DEM,550228,0,0,124,124,
Oklahoma,Commissioner of Labor,Mark Costello,REP,550228,0,0,139,139,
Oklahoma,U.S. Senate,Matt Silverstein,DEM,550228,0,0,116,116,
Oklahoma,U.S. Senate,Jim Inhofe,REP,550228,0,0,143,143,
Oklahoma,U.S. Senate,Aaron Delozier,IND,550228,0,0,1,1,
Oklahoma,U.S. Senate,Ray Woods,IND,550228,0,0,5,5,
Oklahoma,U.S. Senate,Joan Farr,IND,550228,0,0,6,6,
Oklahoma,U.S. Senate,Connie Johnson,DEM,550228,0,0,119,119,
Oklahoma,U.S. Senate,James Lankford,REP,550228,0,0,141,141,
Oklahoma,U.S. Senate,Mark Beard,IND,550228,0,0,9,9,
Oklahoma,U.S. House,Al Mcaffrey,DEM,550228,0,0,111,111,05
Oklahoma,U.S. House,Steve Russell,REP,550228,0,0,144,144,05
Oklahoma,U.S. House,Buddy Ray,IND,550228,0,0,3,3,05
Oklahoma,U.S. House,Tom Boggs,IND,550228,0,0,4,4,05
Oklahoma,U.S. House,Robert Murphy,IND,550228,0,0,7,7,05
Oklahoma,State Senate,Michael Brooks-Jimenez,DEM,550228,0,0,134,134,44
Oklahoma,State Senate,Ralph Shortey,REP,550228,0,0,120,120,44
Oklahoma,State Senate,Constance Fawcett,IND,550228,0,0,12,12,44
Oklahoma,Governor,Joe Dorman,DEM,550229,0,0,213,213,
Oklahoma,Governor,Mary Fallin,REP,550229,0,0,275,275,
Oklahoma,Governor,Kimberly Willis,IND,550229,0,0,12,12,
Oklahoma,Governor,Richard Prawdzienski,IND,550229,0,0,10,10,
Oklahoma,Lieutenant Governor,Cathy Cummings,DEM,550229,0,0,177,177,
Oklahoma,Lieutenant Governor,Todd Lamb,REP,550229,0,0,327,327,
Oklahoma,Superintendent of Public Instruction,John Cox,DEM,550229,0,0,224,224,
Oklahoma,Superintendent of Public Instruction,Joy Hofmeister,REP,550229,0,0,281,281,
Oklahoma,Commissioner of Labor,Mike Workman,DEM,550229,0,0,190,190,
Oklahoma,Commissioner of Labor,Mark Costello,REP,550229,0,0,304,304,
Oklahoma,U.S. Senate,Matt Silverstein,DEM,550229,0,0,149,149,
Oklahoma,U.S. Senate,Jim Inhofe,REP,550229,0,0,338,338,
Oklahoma,U.S. Senate,Aaron Delozier,IND,550229,0,0,7,7,
Oklahoma,U.S. Senate,Ray Woods,IND,550229,0,0,6,6,
Oklahoma,U.S. Senate,Joan Farr,IND,550229,0,0,8,8,
Oklahoma,U.S. Senate,Connie Johnson,DEM,550229,0,0,154,154,
Oklahoma,U.S. Senate,James Lankford,REP,550229,0,0,341,341,
Oklahoma,U.S. Senate,Mark Beard,IND,550229,0,0,16,16,
Oklahoma,U.S. House,Al Mcaffrey,DEM,550229,0,0,169,169,05
Oklahoma,U.S. House,Steve Russell,REP,550229,0,0,306,306,05
Oklahoma,U.S. House,Buddy Ray,IND,550229,0,0,8,8,05
Oklahoma,U.S. House,Tom Boggs,IND,550229,0,0,10,10,05
Oklahoma,U.S. House,Robert Murphy,IND,550229,0,0,13,13,05
Oklahoma,State Senate,Michael Brooks-Jimenez,DEM,550229,0,0,212,212,44
Oklahoma,State Senate,Ralph Shortey,REP,550229,0,0,267,267,44
Oklahoma,State Senate,Constance Fawcett,IND,550229,0,0,27,27,44
Oklahoma,State House,William Lee Molden,DEM,550229,0,0,187,187,93
Oklahoma,State House,Mike Christian,REP,550229,0,0,312,312,93
Oklahoma,Governor,Joe Dorman,DEM,550230,0,0,221,221,
Oklahoma,Governor,Mary Fallin,REP,550230,0,0,354,354,
Oklahoma,Governor,Kimberly Willis,IND,550230,0,0,10,10,
Oklahoma,Governor,Richard Prawdzienski,IND,550230,0,0,6,6,
Oklahoma,Lieutenant Governor,Cathy Cummings,DEM,550230,0,0,173,173,
Oklahoma,Lieutenant Governor,Todd Lamb,REP,550230,0,0,417,417,
Oklahoma,Superintendent of Public Instruction,John Cox,DEM,550230,0,0,246,246,
Oklahoma,Superintendent of Public Instruction,Joy Hofmeister,REP,550230,0,0,336,336,
Oklahoma,Commissioner of Labor,Mike Workman,DEM,550230,0,0,202,202,
Oklahoma,Commissioner of Labor,Mark Costello,REP,550230,0,0,369,369,
Oklahoma,U.S. Senate,Matt Silverstein,DEM,550230,0,0,152,152,
Oklahoma,U.S. Senate,Jim Inhofe,REP,550230,0,0,412,412,
Oklahoma,U.S. Senate,Aaron Delozier,IND,550230,0,0,4,4,
Oklahoma,U.S. Senate,Ray Woods,IND,550230,0,0,9,9,
Oklahoma,U.S. Senate,Joan Farr,IND,550230,0,0,10,10,
Oklahoma,U.S. Senate,Connie Johnson,DEM,550230,0,0,163,163,
Oklahoma,U.S. Senate,James Lankford,REP,550230,0,0,406,406,
Oklahoma,U.S. Senate,Mark Beard,IND,550230,0,0,22,22,
Oklahoma,U.S. House,Al Mcaffrey,DEM,550230,0,0,160,160,05
Oklahoma,U.S. House,Steve Russell,REP,550230,0,0,402,402,05
Oklahoma,U.S. House,Buddy Ray,IND,550230,0,0,6,6,05
Oklahoma,U.S. House,Tom Boggs,IND,550230,0,0,7,7,05
Oklahoma,U.S. House,Robert Murphy,IND,550230,0,0,10,10,05
Oklahoma,State Senate,Michael Brooks-Jimenez,DEM,550230,0,0,222,222,44
Oklahoma,State Senate,Ralph Shortey,REP,550230,0,0,322,322,44
Oklahoma,State Senate,Constance Fawcett,IND,550230,0,0,40,40,44
Oklahoma,State House,William Lee Molden,DEM,550230,0,0,190,190,93
Oklahoma,State House,Mike Christian,REP,550230,0,0,384,384,93
Oklahoma,Governor,Joe Dorman,DEM,550231,0,0,160,160,
Oklahoma,Governor,Mary Fallin,REP,550231,0,0,199,199,
Oklahoma,Governor,Kimberly Willis,IND,550231,0,0,9,9,
Oklahoma,Governor,Richard Prawdzienski,IND,550231,0,0,1,1,
Oklahoma,Lieutenant Governor,Cathy Cummings,DEM,550231,0,0,131,131,
Oklahoma,Lieutenant Governor,Todd Lamb,REP,550231,0,0,237,237,
Oklahoma,Superintendent of Public Instruction,John Cox,DEM,550231,0,0,170,170,
Oklahoma,Superintendent of Public Instruction,Joy Hofmeister,REP,550231,0,0,196,196,
Oklahoma,Commissioner of Labor,Mike Workman,DEM,550231,0,0,149,149,
Oklahoma,Commissioner of Labor,Mark Costello,REP,550231,0,0,214,214,
Oklahoma,U.S. Senate,Matt Silverstein,DEM,550231,0,0,120,120,
Oklahoma,U.S. Senate,Jim Inhofe,REP,550231,0,0,233,233,
Oklahoma,U.S. Senate,Aaron Delozier,IND,550231,0,0,3,3,
Oklahoma,U.S. Senate,Ray Woods,IND,550231,0,0,7,7,
Oklahoma,U.S. Senate,Joan Farr,IND,550231,0,0,3,3,
Oklahoma,U.S. Senate,Connie Johnson,DEM,550231,0,0,119,119,
Oklahoma,U.S. Senate,James Lankford,REP,550231,0,0,238,238,
Oklahoma,U.S. Senate,Mark Beard,IND,550231,0,0,11,11,
Oklahoma,U.S. House,Al Mcaffrey,DEM,550231,0,0,127,127,05
Oklahoma,U.S. House,Steve Russell,REP,550231,0,0,226,226,05
Oklahoma,U.S. House,Buddy Ray,IND,550231,0,0,5,5,05
Oklahoma,U.S. House,Tom Boggs,IND,550231,0,0,5,5,05
Oklahoma,U.S. House,Robert Murphy,IND,550231,0,0,4,4,05
Oklahoma,State Senate,Michael Brooks-Jimenez,DEM,550231,0,0,158,158,44
Oklahoma,State Senate,Ralph Shortey,REP,550231,0,0,185,185,44
Oklahoma,State Senate,Constance Fawcett,IND,550231,0,0,23,23,44
Oklahoma,State House,William Lee Molden,DEM,550231,0,0,135,135,93
Oklahoma,State House,Mike Christian,REP,550231,0,0,225,225,93
Oklahoma,Governor,Joe Dorman,DEM,550232,0,0,187,187,
Oklahoma,Governor,Mary Fallin,REP,550232,0,0,286,286,
Oklahoma,Governor,Kimberly Willis,IND,550232,0,0,9,9,
Oklahoma,Governor,Richard Prawdzienski,IND,550232,0,0,6,6,
Oklahoma,Lieutenant Governor,Cathy Cummings,DEM,550232,0,0,157,157,
Oklahoma,Lieutenant Governor,Todd Lamb,REP,550232,0,0,329,329,
Oklahoma,Superintendent of Public Instruction,John Cox,DEM,550232,0,0,201,201,
Oklahoma,Superintendent of Public Instruction,Joy Hofmeister,REP,550232,0,0,281,281,
Oklahoma,Commissioner of Labor,Mike Workman,DEM,550232,0,0,170,170,
Oklahoma,Commissioner of Labor,Mark Costello,REP,550232,0,0,298,298,
Oklahoma,U.S. Senate,Matt Silverstein,DEM,550232,0,0,127,127,
Oklahoma,U.S. Senate,Jim Inhofe,REP,550232,0,0,340,340,
Oklahoma,U.S. Senate,Aaron Delozier,IND,550232,0,0,5,5,
Oklahoma,U.S. Senate,Ray Woods,IND,550232,0,0,4,4,
Oklahoma,U.S. Senate,Joan Farr,IND,550232,0,0,9,9,
Oklahoma,U.S. Senate,Connie Johnson,DEM,550232,0,0,142,142,
Oklahoma,U.S. Senate,James Lankford,REP,550232,0,0,335,335,
Oklahoma,U.S. Senate,Mark Beard,IND,550232,0,0,9,9,
Oklahoma,U.S. House,Al Mcaffrey,DEM,550232,0,0,143,143,05
Oklahoma,U.S. House,Steve Russell,REP,550232,0,0,316,316,05
Oklahoma,U.S. House,Buddy Ray,IND,550232,0,0,5,5,05
Oklahoma,U.S. House,Tom Boggs,IND,550232,0,0,5,5,05
Oklahoma,U.S. House,Robert Murphy,IND,550232,0,0,11,11,05
Oklahoma,State Senate,Michael Brooks-Jimenez,DEM,550232,0,0,172,172,44
Oklahoma,State Senate,Ralph Shortey,REP,550232,0,0,281,281,44
Oklahoma,State Senate,Constance Fawcett,IND,550232,0,0,25,25,44
Oklahoma,Governor,Joe Dorman,DEM,550233,0,0,63,63,
Oklahoma,Governor,Mary Fallin,REP,550233,0,0,85,85,
Oklahoma,Governor,Kimberly Willis,IND,550233,0,0,4,4,
Oklahoma,Governor,Richard Prawdzienski,IND,550233,0,0,2,2,
Oklahoma,Lieutenant Governor,Cathy Cummings,DEM,550233,0,0,54,54,
Oklahoma,Lieutenant Governor,Todd Lamb,REP,550233,0,0,98,98,
Oklahoma,Superintendent of Public Instruction,John Cox,DEM,550233,0,0,70,70,
Oklahoma,Superintendent of Public Instruction,Joy Hofmeister,REP,550233,0,0,79,79,
Oklahoma,Commissioner of Labor,Mike Workman,DEM,550233,0,0,68,68,
Oklahoma,Commissioner of Labor,Mark Costello,REP,550233,0,0,81,81,
Oklahoma,U.S. Senate,Matt Silverstein,DEM,550233,0,0,49,49,
Oklahoma,U.S. Senate,Jim Inhofe,REP,550233,0,0,96,96,
Oklahoma,U.S. Senate,Aaron Delozier,IND,550233,0,0,1,1,
Oklahoma,U.S. Senate,Ray Woods,IND,550233,0,0,2,2,
Oklahoma,U.S. Senate,Joan Farr,IND,550233,0,0,5,5,
Oklahoma,U.S. Senate,Connie Johnson,DEM,550233,0,0,51,51,
Oklahoma,U.S. Senate,James Lankford,REP,550233,0,0,100,100,
Oklahoma,U.S. Senate,Mark Beard,IND,550233,0,0,2,2,
Oklahoma,U.S. House,Al Mcaffrey,DEM,550233,0,0,56,56,05
Oklahoma,U.S. House,Steve Russell,REP,550233,0,0,88,88,05
Oklahoma,U.S. House,Buddy Ray,IND,550233,0,0,3,3,05
Oklahoma,U.S. House,Tom Boggs,IND,550233,0,0,3,3,05
Oklahoma,U.S. House,Robert Murphy,IND,550233,0,0,2,2,05
Oklahoma,Governor,Joe Dorman,DEM,550234,0,0,146,146,
Oklahoma,Governor,Mary Fallin,REP,550234,0,0,183,183,
Oklahoma,Governor,Kimberly Willis,IND,550234,0,0,10,10,
Oklahoma,Governor,Richard Prawdzienski,IND,550234,0,0,9,9,
Oklahoma,Lieutenant Governor,Cathy Cummings,DEM,550234,0,0,130,130,
Oklahoma,Lieutenant Governor,Todd Lamb,REP,550234,0,0,217,217,
Oklahoma,Superintendent of Public Instruction,John Cox,DEM,550234,0,0,165,165,
Oklahoma,Superintendent of Public Instruction,Joy Hofmeister,REP,550234,0,0,180,180,
Oklahoma,Commissioner of Labor,Mike Workman,DEM,550234,0,0,163,163,
Oklahoma,Commissioner of Labor,Mark Costello,REP,550234,0,0,179,179,
Oklahoma,U.S. Senate,Matt Silverstein,DEM,550234,0,0,124,124,
Oklahoma,U.S. Senate,Jim Inhofe,REP,550234,0,0,195,195,
Oklahoma,U.S. Senate,Aaron Delozier,IND,550234,0,0,8,8,
Oklahoma,U.S. Senate,Ray Woods,IND,550234,0,0,11,11,
Oklahoma,U.S. Senate,Joan Farr,IND,550234,0,0,5,5,
Oklahoma,U.S. Senate,Connie Johnson,DEM,550234,0,0,121,121,
Oklahoma,U.S. Senate,James Lankford,REP,550234,0,0,205,205,
Oklahoma,U.S. Senate,Mark Beard,IND,550234,0,0,20,20,
Oklahoma,U.S. House,Al Mcaffrey,DEM,550234,0,0,131,131,05
Oklahoma,U.S. House,Steve Russell,REP,550234,0,0,192,192,05
Oklahoma,U.S. House,Buddy Ray,IND,550234,0,0,9,9,05
Oklahoma,U.S. House,Tom Boggs,IND,550234,0,0,7,7,05
Oklahoma,U.S. House,Robert Murphy,IND,550234,0,0,7,7,05
Oklahoma,Governor,Joe Dorman,DEM,550235,0,0,170,170,
Oklahoma,Governor,Mary Fallin,REP,550235,0,0,87,87,
Oklahoma,Governor,Kimberly Willis,IND,550235,0,0,1,1,
Oklahoma,Governor,Richard Prawdzienski,IND,550235,0,0,2,2,
Oklahoma,Lieutenant Governor,Cathy Cummings,DEM,550235,0,0,158,158,
Oklahoma,Lieutenant Governor,Todd Lamb,REP,550235,0,0,100,100,
Oklahoma,Superintendent of Public Instruction,John Cox,DEM,550235,0,0,166,166,
Oklahoma,Superintendent of Public Instruction,Joy Hofmeister,REP,550235,0,0,90,90,
Oklahoma,Commissioner of Labor,Mike Workman,DEM,550235,0,0,172,172,
Oklahoma,Commissioner of Labor,Mark Costello,REP,550235,0,0,83,83,
Oklahoma,U.S. Senate,Matt Silverstein,DEM,550235,0,0,140,140,
Oklahoma,U.S. Senate,Jim Inhofe,REP,550235,0,0,101,101,
Oklahoma,U.S. Senate,Aaron Delozier,IND,550235,0,0,5,5,
Oklahoma,U.S. Senate,Ray Woods,IND,550235,0,0,8,8,
Oklahoma,U.S. Senate,Joan Farr,IND,550235,0,0,4,4,
Oklahoma,U.S. Senate,Connie Johnson,DEM,550235,0,0,150,150,
Oklahoma,U.S. Senate,James Lankford,REP,550235,0,0,103,103,
Oklahoma,U.S. Senate,Mark Beard,IND,550235,0,0,6,6,
Oklahoma,U.S. House,Al Mcaffrey,DEM,550235,0,0,162,162,05
Oklahoma,U.S. House,Steve Russell,REP,550235,0,0,85,85,05
Oklahoma,U.S. House,Buddy Ray,IND,550235,0,0,2,2,05
Oklahoma,U.S. House,Tom Boggs,IND,550235,0,0,4,4,05
Oklahoma,U.S. House,Robert Murphy,IND,550235,0,0,4,4,05
Oklahoma,Governor,Joe Dorman,DEM,550236,0,0,0,0,
Oklahoma,Governor,Mary Fallin,REP,550236,0,0,0,0,
Oklahoma,Governor,Kimberly Willis,IND,550236,0,0,0,0,
Oklahoma,Governor,Richard Prawdzienski,IND,550236,0,0,0,0,
Oklahoma,Lieutenant Governor,Cathy Cummings,DEM,550236,0,0,0,0,
Oklahoma,Lieutenant Governor,Todd Lamb,REP,550236,0,0,0,0,
Oklahoma,Superintendent of Public Instruction,John Cox,DEM,550236,0,0,0,0,
Oklahoma,Superintendent of Public Instruction,Joy Hofmeister,REP,550236,0,0,0,0,
Oklahoma,Commissioner of Labor,Mike Workman,DEM,550236,0,0,0,0,
Oklahoma,Commissioner of Labor,Mark Costello,REP,550236,0,0,0,0,
Oklahoma,U.S. Senate,Matt Silverstein,DEM,550236,0,0,0,0,
Oklahoma,U.S. Senate,Jim Inhofe,REP,550236,0,0,0,0,
Oklahoma,U.S. Senate,Aaron Delozier,IND,550236,0,0,0,0,
Oklahoma,U.S. Senate,Ray Woods,IND,550236,0,0,0,0,
Oklahoma,U.S. Senate,Joan Farr,IND,550236,0,0,0,0,
Oklahoma,U.S. Senate,Connie Johnson,DEM,550236,0,0,0,0,
Oklahoma,U.S. Senate,James Lankford,REP,550236,0,0,0,0,
Oklahoma,U.S. Senate,Mark Beard,IND,550236,0,0,0,0,
Oklahoma,U.S. House,Al Mcaffrey,DEM,550236,0,0,0,0,05
Oklahoma,U.S. House,Steve Russell,REP,550236,0,0,0,0,05
Oklahoma,U.S. House,Buddy Ray,IND,550236,0,0,0,0,05
Oklahoma,U.S. House,Tom Boggs,IND,550236,0,0,0,0,05
Oklahoma,U.S. House,Robert Murphy,IND,550236,0,0,0,0,05
Oklahoma,State House,George Young,DEM,550236,0,0,0,0,99
Oklahoma,State House,Willard Linzy,REP,550236,0,0,0,0,99
Oklahoma,Governor,Joe Dorman,DEM,550237,0,0,1,1,
Oklahoma,Governor,Mary Fallin,REP,550237,0,0,0,0,
Oklahoma,Governor,Kimberly Willis,IND,550237,0,0,0,0,
Oklahoma,Governor,Richard Prawdzienski,IND,550237,0,0,0,0,
Oklahoma,Lieutenant Governor,Cathy Cummings,DEM,550237,0,0,1,1,
Oklahoma,Lieutenant Governor,Todd Lamb,REP,550237,0,0,0,0,
Oklahoma,Superintendent of Public Instruction,John Cox,DEM,550237,0,0,1,1,
Oklahoma,Superintendent of Public Instruction,Joy Hofmeister,REP,550237,0,0,0,0,
Oklahoma,Commissioner of Labor,Mike Workman,DEM,550237,0,0,1,1,
Oklahoma,Commissioner of Labor,Mark Costello,REP,550237,0,0,0,0,
Oklahoma,U.S. Senate,Matt Silverstein,DEM,550237,0,0,1,1,
Oklahoma,U.S. Senate,Jim Inhofe,REP,550237,0,0,0,0,
Oklahoma,U.S. Senate,Aaron Delozier,IND,550237,0,0,0,0,
Oklahoma,U.S. Senate,Ray Woods,IND,550237,0,0,0,0,
Oklahoma,U.S. Senate,Joan Farr,IND,550237,0,0,0,0,
Oklahoma,U.S. Senate,Connie Johnson,DEM,550237,0,0,1,1,
Oklahoma,U.S. Senate,James Lankford,REP,550237,0,0,0,0,
Oklahoma,U.S. Senate,Mark Beard,IND,550237,0,0,0,0,
Oklahoma,U.S. House,Al Mcaffrey,DEM,550237,0,0,1,1,05
Oklahoma,U.S. House,Steve Russell,REP,550237,0,0,0,0,05
Oklahoma,U.S. House,Buddy Ray,IND,550237,0,0,0,0,05
Oklahoma,U.S. House,Tom Boggs,IND,550237,0,0,0,0,05
Oklahoma,U.S. House,Robert Murphy,IND,550237,0,0,0,0,05
Oklahoma,State House,George Young,DEM,550237,0,0,1,1,99
Oklahoma,State House,Willard Linzy,REP,550237,0,0,0,0,99
Oklahoma,Governor,Joe Dorman,DEM,550238,0,0,0,0,
Oklahoma,Governor,Mary Fallin,REP,550238,0,0,0,0,
Oklahoma,Governor,Kimberly Willis,IND,550238,0,0,0,0,
Oklahoma,Governor,Richard Prawdzienski,IND,550238,0,0,0,0,
Oklahoma,Lieutenant Governor,Cathy Cummings,DEM,550238,0,0,0,0,
Oklahoma,Lieutenant Governor,Todd Lamb,REP,550238,0,0,0,0,
Oklahoma,Superintendent of Public Instruction,John Cox,DEM,550238,0,0,0,0,
Oklahoma,Superintendent of Public Instruction,Joy Hofmeister,REP,550238,0,0,0,0,
Oklahoma,Commissioner of Labor,Mike Workman,DEM,550238,0,0,0,0,
Oklahoma,Commissioner of Labor,Mark Costello,REP,550238,0,0,0,0,
Oklahoma,U.S. Senate,Matt Silverstein,DEM,550238,0,0,0,0,
Oklahoma,U.S. Senate,Jim Inhofe,REP,550238,0,0,0,0,
Oklahoma,U.S. Senate,Aaron Delozier,IND,550238,0,0,0,0,
Oklahoma,U.S. Senate,Ray Woods,IND,550238,0,0,0,0,
Oklahoma,U.S. Senate,Joan Farr,IND,550238,0,0,0,0,
Oklahoma,U.S. Senate,Connie Johnson,DEM,550238,0,0,0,0,
Oklahoma,U.S. Senate,James Lankford,REP,550238,0,0,0,0,
Oklahoma,U.S. Senate,Mark Beard,IND,550238,0,0,0,0,
Oklahoma,U.S. House,Al Mcaffrey,DEM,550238,0,0,0,0,05
Oklahoma,U.S. House,Steve Russell,REP,550238,0,0,0,0,05
Oklahoma,U.S. House,Buddy Ray,IND,550238,0,0,0,0,05
Oklahoma,U.S. House,Tom Boggs,IND,550238,0,0,0,0,05
Oklahoma,U.S. House,Robert Murphy,IND,550238,0,0,0,0,05
Oklahoma,State House,George Young,DEM,550238,0,0,0,0,99
Oklahoma,State House,Willard Linzy,REP,550238,0,0,0,0,99
Oklahoma,Governor,Joe Dorman,DEM,550239,0,0,368,368,
Oklahoma,Governor,Mary Fallin,REP,550239,0,0,66,66,
Oklahoma,Governor,Kimberly Willis,IND,550239,0,0,7,7,
Oklahoma,Governor,Richard Prawdzienski,IND,550239,0,0,1,1,
Oklahoma,Lieutenant Governor,Cathy Cummings,DEM,550239,0,0,342,342,
Oklahoma,Lieutenant Governor,Todd Lamb,REP,550239,0,0,99,99,
Oklahoma,Superintendent of Public Instruction,John Cox,DEM,550239,0,0,346,346,
Oklahoma,Superintendent of Public Instruction,Joy Hofmeister,REP,550239,0,0,91,91,
Oklahoma,Commissioner of Labor,Mike Workman,DEM,550239,0,0,344,344,
Oklahoma,Commissioner of Labor,Mark Costello,REP,550239,0,0,86,86,
Oklahoma,U.S. Senate,Matt Silverstein,DEM,550239,0,0,333,333,
Oklahoma,U.S. Senate,Jim Inhofe,REP,550239,0,0,93,93,
Oklahoma,U.S. Senate,Aaron Delozier,IND,550239,0,0,6,6,
Oklahoma,U.S. Senate,Ray Woods,IND,550239,0,0,4,4,
Oklahoma,U.S. Senate,Joan Farr,IND,550239,0,0,5,5,
Oklahoma,U.S. Senate,Connie Johnson,DEM,550239,0,0,349,349,
Oklahoma,U.S. Senate,James Lankford,REP,550239,0,0,87,87,
Oklahoma,U.S. Senate,Mark Beard,IND,550239,0,0,7,7,
Oklahoma,U.S. House,Al Mcaffrey,DEM,550239,0,0,339,339,05
Oklahoma,U.S. House,Steve Russell,REP,550239,0,0,88,88,05
Oklahoma,U.S. House,Buddy Ray,IND,550239,0,0,2,2,05
Oklahoma,U.S. House,Tom Boggs,IND,550239,0,0,4,4,05
Oklahoma,U.S. House,Robert Murphy,IND,550239,0,0,7,7,05
Oklahoma,State Senate,Anastasia Pittman,DEM,550239,0,0,369,369,48
Oklahoma,State Senate,Duane Crumbacher,REP,550239,0,0,69,69,48
Oklahoma,State House,George Young,DEM,550239,0,0,352,352,99
Oklahoma,State House,Willard Linzy,REP,550239,0,0,85,85,99
Oklahoma,Governor,Joe Dorman,DEM,550240,0,0,459,459,
Oklahoma,Governor,Mary Fallin,REP,550240,0,0,23,23,
Oklahoma,Governor,Kimberly Willis,IND,550240,0,0,7,7,
Oklahoma,Governor,Richard Prawdzienski,IND,550240,0,0,1,1,
Oklahoma,Lieutenant Governor,Cathy Cummings,DEM,550240,0,0,447,447,
Oklahoma,Lieutenant Governor,Todd Lamb,REP,550240,0,0,40,40,
Oklahoma,Superintendent of Public Instruction,John Cox,DEM,550240,0,0,459,459,
Oklahoma,Superintendent of Public Instruction,Joy Hofmeister,REP,550240,0,0,29,29,
Oklahoma,Commissioner of Labor,Mike Workman,DEM,550240,0,0,458,458,
Oklahoma,Commissioner of Labor,Mark Costello,REP,550240,0,0,26,26,
Oklahoma,U.S. Senate,Matt Silverstein,DEM,550240,0,0,433,433,
Oklahoma,U.S. Senate,Jim Inhofe,REP,550240,0,0,39,39,
Oklahoma,U.S. Senate,Aaron Delozier,IND,550240,0,0,3,3,
Oklahoma,U.S. Senate,Ray Woods,IND,550240,0,0,6,6,
Oklahoma,U.S. Senate,Joan Farr,IND,550240,0,0,5,5,
Oklahoma,U.S. Senate,Connie Johnson,DEM,550240,0,0,461,461,
Oklahoma,U.S. Senate,James Lankford,REP,550240,0,0,28,28,
Oklahoma,U.S. Senate,Mark Beard,IND,550240,0,0,2,2,
Oklahoma,U.S. House,Al Mcaffrey,DEM,550240,0,0,451,451,05
Oklahoma,U.S. House,Steve Russell,REP,550240,0,0,24,24,05
Oklahoma,U.S. House,Buddy Ray,IND,550240,0,0,4,4,05
Oklahoma,U.S. House,Tom Boggs,IND,550240,0,0,6,6,05
Oklahoma,U.S. House,Robert Murphy,IND,550240,0,0,3,3,05
Oklahoma,State Senate,Anastasia Pittman,DEM,550240,0,0,470,470,48
Oklahoma,State Senate,Duane Crumbacher,REP,550240,0,0,19,19,48
Oklahoma,State House,George Young,DEM,550240,0,0,458,458,99
Oklahoma,State House,Willard Linzy,REP,550240,0,0,29,29,99
Oklahoma,Governor,Joe Dorman,DEM,550241,0,0,341,341,
Oklahoma,Governor,Mary Fallin,REP,550241,0,0,40,40,
Oklahoma,Governor,Kimberly Willis,IND,550241,0,0,2,2,
Oklahoma,Governor,Richard Prawdzienski,IND,550241,0,0,2,2,
Oklahoma,Lieutenant Governor,Cathy Cummings,DEM,550241,0,0,324,324,
Oklahoma,Lieutenant Governor,Todd Lamb,REP,550241,0,0,61,61,
Oklahoma,Superintendent of Public Instruction,John Cox,DEM,550241,0,0,330,330,
Oklahoma,Superintendent of Public Instruction,Joy Hofmeister,REP,550241,0,0,55,55,
Oklahoma,Commissioner of Labor,Mike Workman,DEM,550241,0,0,321,321,
Oklahoma,Commissioner of Labor,Mark Costello,REP,550241,0,0,61,61,
Oklahoma,U.S. Senate,Matt Silverstein,DEM,550241,0,0,307,307,
Oklahoma,U.S. Senate,Jim Inhofe,REP,550241,0,0,66,66,
Oklahoma,U.S. Senate,Aaron Delozier,IND,550241,0,0,5,5,
Oklahoma,U.S. Senate,Ray Woods,IND,550241,0,0,3,3,
Oklahoma,U.S. Senate,Joan Farr,IND,550241,0,0,4,4,
Oklahoma,U.S. Senate,Connie Johnson,DEM,550241,0,0,324,324,
Oklahoma,U.S. Senate,James Lankford,REP,550241,0,0,56,56,
Oklahoma,U.S. Senate,Mark Beard,IND,550241,0,0,5,5,
Oklahoma,U.S. House,Al Mcaffrey,DEM,550241,0,0,327,327,05
Oklahoma,U.S. House,Steve Russell,REP,550241,0,0,52,52,05
Oklahoma,U.S. House,Buddy Ray,IND,550241,0,0,2,2,05
Oklahoma,U.S. House,Tom Boggs,IND,550241,0,0,0,0,05
Oklahoma,U.S. House,Robert Murphy,IND,550241,0,0,4,4,05
Oklahoma,State Senate,Anastasia Pittman,DEM,550241,0,0,340,340,48
Oklahoma,State Senate,Duane Crumbacher,REP,550241,0,0,43,43,48
Oklahoma,State House,George Young,DEM,550241,0,0,328,328,99
Oklahoma,State House,Willard Linzy,REP,550241,0,0,55,55,99
Oklahoma,Governor,Joe Dorman,DEM,550242,0,0,374,374,
Oklahoma,Governor,Mary Fallin,REP,550242,0,0,2,2,
Oklahoma,Governor,Kimberly Willis,IND,550242,0,0,7,7,
Oklahoma,Governor,Richard Prawdzienski,IND,550242,0,0,1,1,
Oklahoma,Lieutenant Governor,Cathy Cummings,DEM,550242,0,0,361,361,
Oklahoma,Lieutenant Governor,Todd Lamb,REP,550242,0,0,18,18,
Oklahoma,Superintendent of Public Instruction,John Cox,DEM,550242,0,0,369,369,
Oklahoma,Superintendent of Public Instruction,Joy Hofmeister,REP,550242,0,0,12,12,
Oklahoma,Commissioner of Labor,Mike Workman,DEM,550242,0,0,365,365,
Oklahoma,Commissioner of Labor,Mark Costello,REP,550242,0,0,14,14,
Oklahoma,U.S. Senate,Matt Silverstein,DEM,550242,0,0,346,346,
Oklahoma,U.S. Senate,Jim Inhofe,REP,550242,0,0,21,21,
Oklahoma,U.S. Senate,Aaron Delozier,IND,550242,0,0,2,2,
Oklahoma,U.S. Senate,Ray Woods,IND,550242,0,0,3,3,
Oklahoma,U.S. Senate,Joan Farr,IND,550242,0,0,6,6,
Oklahoma,U.S. Senate,Connie Johnson,DEM,550242,0,0,372,372,
Oklahoma,U.S. Senate,James Lankford,REP,550242,0,0,8,8,
Oklahoma,U.S. Senate,Mark Beard,IND,550242,0,0,5,5,
Oklahoma,U.S. House,Al Mcaffrey,DEM,550242,0,0,360,360,05
Oklahoma,U.S. House,Steve Russell,REP,550242,0,0,15,15,05
Oklahoma,U.S. House,Buddy Ray,IND,550242,0,0,1,1,05
Oklahoma,U.S. House,Tom Boggs,IND,550242,0,0,0,0,05
Oklahoma,U.S. House,Robert Murphy,IND,550242,0,0,4,4,05
Oklahoma,State Senate,Anastasia Pittman,DEM,550242,0,0,376,376,48
Oklahoma,State Senate,Duane Crumbacher,REP,550242,0,0,5,5,48
Oklahoma,State House,Mike Shelton,DEM,550242,0,0,377,377,97
Oklahoma,State House,Tonni Canaday,REP,550242,0,0,6,6,97
Oklahoma,Governor,Joe Dorman,DEM,550243,0,0,498,498,
Oklahoma,Governor,Mary Fallin,REP,550243,0,0,14,14,
Oklahoma,Governor,Kimberly Willis,IND,550243,0,0,6,6,
Oklahoma,Governor,Richard Prawdzienski,IND,550243,0,0,3,3,
Oklahoma,Lieutenant Governor,Cathy Cummings,DEM,550243,0,0,494,494,
Oklahoma,Lieutenant Governor,Todd Lamb,REP,550243,0,0,26,26,
Oklahoma,Superintendent of Public Instruction,John Cox,DEM,550243,0,0,502,502,
Oklahoma,Superintendent of Public Instruction,Joy Hofmeister,REP,550243,0,0,19,19,
Oklahoma,Commissioner of Labor,Mike Workman,DEM,550243,0,0,497,497,
Oklahoma,Commissioner of Labor,Mark Costello,REP,550243,0,0,23,23,
Oklahoma,U.S. Senate,Matt Silverstein,DEM,550243,0,0,477,477,
Oklahoma,U.S. Senate,Jim Inhofe,REP,550243,0,0,26,26,
Oklahoma,U.S. Senate,Aaron Delozier,IND,550243,0,0,3,3,
Oklahoma,U.S. Senate,Ray Woods,IND,550243,0,0,8,8,
Oklahoma,U.S. Senate,Joan Farr,IND,550243,0,0,2,2,
Oklahoma,U.S. Senate,Connie Johnson,DEM,550243,0,0,507,507,
Oklahoma,U.S. Senate,James Lankford,REP,550243,0,0,11,11,
Oklahoma,U.S. Senate,Mark Beard,IND,550243,0,0,3,3,
Oklahoma,U.S. House,Al Mcaffrey,DEM,550243,0,0,491,491,05
Oklahoma,U.S. House,Steve Russell,REP,550243,0,0,14,14,05
Oklahoma,U.S. House,Buddy Ray,IND,550243,0,0,5,5,05
Oklahoma,U.S. House,Tom Boggs,IND,550243,0,0,7,7,05
Oklahoma,U.S. House,Robert Murphy,IND,550243,0,0,3,3,05
Oklahoma,State Senate,Anastasia Pittman,DEM,550243,0,0,509,509,48
Oklahoma,State Senate,Duane Crumbacher,REP,550243,0,0,11,11,48
Oklahoma,State House,Mike Shelton,DEM,550243,0,0,508,508,97
Oklahoma,State House,Tonni Canaday,REP,550243,0,0,14,14,97
Oklahoma,Governor,Joe Dorman,DEM,550244,0,0,471,471,
Oklahoma,Governor,Mary Fallin,REP,550244,0,0,16,16,
Oklahoma,Governor,Kimberly Willis,IND,550244,0,0,4,4,
Oklahoma,Governor,Richard Prawdzienski,IND,550244,0,0,3,3,
Oklahoma,Lieutenant Governor,Cathy Cummings,DEM,550244,0,0,461,461,
Oklahoma,Lieutenant Governor,Todd Lamb,REP,550244,0,0,26,26,
Oklahoma,Superintendent of Public Instruction,John Cox,DEM,550244,0,0,468,468,
Oklahoma,Superintendent of Public Instruction,Joy Hofmeister,REP,550244,0,0,22,22,
Oklahoma,Commissioner of Labor,Mike Workman,DEM,550244,0,0,470,470,
Oklahoma,Commissioner of Labor,Mark Costello,REP,550244,0,0,17,17,
Oklahoma,U.S. Senate,Matt Silverstein,DEM,550244,0,0,440,440,
Oklahoma,U.S. Senate,Jim Inhofe,REP,550244,0,0,27,27,
Oklahoma,U.S. Senate,Aaron Delozier,IND,550244,0,0,2,2,
Oklahoma,U.S. Senate,Ray Woods,IND,550244,0,0,10,10,
Oklahoma,U.S. Senate,Joan Farr,IND,550244,0,0,7,7,
Oklahoma,U.S. Senate,Connie Johnson,DEM,550244,0,0,476,476,
Oklahoma,U.S. Senate,James Lankford,REP,550244,0,0,13,13,
Oklahoma,U.S. Senate,Mark Beard,IND,550244,0,0,3,3,
Oklahoma,U.S. House,Al Mcaffrey,DEM,550244,0,0,461,461,05
Oklahoma,U.S. House,Steve Russell,REP,550244,0,0,16,16,05
Oklahoma,U.S. House,Buddy Ray,IND,550244,0,0,2,2,05
Oklahoma,U.S. House,Tom Boggs,IND,550244,0,0,5,5,05
Oklahoma,U.S. House,Robert Murphy,IND,550244,0,0,4,4,05
Oklahoma,State Senate,Anastasia Pittman,DEM,550244,0,0,480,480,48
Oklahoma,State Senate,Duane Crumbacher,REP,550244,0,0,12,12,48
Oklahoma,State House,George Young,DEM,550244,0,0,464,464,99
Oklahoma,State House,Willard Linzy,REP,550244,0,0,27,27,99
Oklahoma,Governor,Joe Dorman,DEM,550245,0,0,574,574,
Oklahoma,Governor,Mary Fallin,REP,550245,0,0,12,12,
Oklahoma,Governor,Kimberly Willis,IND,550245,0,0,16,16,
Oklahoma,Governor,Richard Prawdzienski,IND,550245,0,0,2,2,
Oklahoma,Lieutenant Governor,Cathy Cummings,DEM,550245,0,0,572,572,
Oklahoma,Lieutenant Governor,Todd Lamb,REP,550245,0,0,32,32,
Oklahoma,Superintendent of Public Instruction,John Cox,DEM,550245,0,0,577,577,
Oklahoma,Superintendent of Public Instruction,Joy Hofmeister,REP,550245,0,0,25,25,
Oklahoma,Commissioner of Labor,Mike Workman,DEM,550245,0,0,579,579,
Oklahoma,Commissioner of Labor,Mark Costello,REP,550245,0,0,22,22,
Oklahoma,U.S. Senate,Matt Silverstein,DEM,550245,0,0,548,548,
Oklahoma,U.S. Senate,Jim Inhofe,REP,550245,0,0,32,32,
Oklahoma,U.S. Senate,Aaron Delozier,IND,550245,0,0,2,2,
Oklahoma,U.S. Senate,Ray Woods,IND,550245,0,0,10,10,
Oklahoma,U.S. Senate,Joan Farr,IND,550245,0,0,8,8,
Oklahoma,U.S. Senate,Connie Johnson,DEM,550245,0,0,581,581,
Oklahoma,U.S. Senate,James Lankford,REP,550245,0,0,20,20,
Oklahoma,U.S. Senate,Mark Beard,IND,550245,0,0,3,3,
Oklahoma,U.S. House,Al Mcaffrey,DEM,550245,0,0,558,558,05
Oklahoma,U.S. House,Steve Russell,REP,550245,0,0,24,24,05
Oklahoma,U.S. House,Buddy Ray,IND,550245,0,0,3,3,05
Oklahoma,U.S. House,Tom Boggs,IND,550245,0,0,7,7,05
Oklahoma,U.S. House,Robert Murphy,IND,550245,0,0,9,9,05
Oklahoma,State Senate,Anastasia Pittman,DEM,550245,0,0,595,595,48
Oklahoma,State Senate,Duane Crumbacher,REP,550245,0,0,7,7,48
Oklahoma,State House,George Young,DEM,550245,0,0,579,579,99
Oklahoma,State House,Willard Linzy,REP,550245,0,0,24,24,99
Oklahoma,Governor,Joe Dorman,DEM,550246,0,0,47,47,
Oklahoma,Governor,Mary Fallin,REP,550246,0,0,53,53,
Oklahoma,Governor,Kimberly Willis,IND,550246,0,0,6,6,
Oklahoma,Governor,Richard Prawdzienski,IND,550246,0,0,1,1,
Oklahoma,Lieutenant Governor,Cathy Cummings,DEM,550246,0,0,38,38,
Oklahoma,Lieutenant Governor,Todd Lamb,REP,550246,0,0,68,68,
Oklahoma,Superintendent of Public Instruction,John Cox,DEM,550246,0,0,48,48,
Oklahoma,Superintendent of Public Instruction,Joy Hofmeister,REP,550246,0,0,59,59,
Oklahoma,Commissioner of Labor,Mike Workman,DEM,550246,0,0,44,44,
Oklahoma,Commissioner of Labor,Mark Costello,REP,550246,0,0,62,62,
Oklahoma,U.S. Senate,Matt Silverstein,DEM,550246,0,0,33,33,
Oklahoma,U.S. Senate,Jim Inhofe,REP,550246,0,0,62,62,
Oklahoma,U.S. Senate,Aaron Delozier,IND,550246,0,0,4,4,
Oklahoma,U.S. Senate,Ray Woods,IND,550246,0,0,2,2,
Oklahoma,U.S. Senate,Joan Farr,IND,550246,0,0,4,4,
Oklahoma,U.S. Senate,Connie Johnson,DEM,550246,0,0,38,38,
Oklahoma,U.S. Senate,James Lankford,REP,550246,0,0,63,63,
Oklahoma,U.S. Senate,Mark Beard,IND,550246,0,0,4,4,
Oklahoma,U.S. House,Al Mcaffrey,DEM,550246,0,0,34,34,05
Oklahoma,U.S. House,Steve Russell,REP,550246,0,0,59,59,05
Oklahoma,U.S. House,Buddy Ray,IND,550246,0,0,3,3,05
Oklahoma,U.S. House,Tom Boggs,IND,550246,0,0,5,5,05
Oklahoma,U.S. House,Robert Murphy,IND,550246,0,0,4,4,05
Oklahoma,Governor,Joe Dorman,DEM,550247,0,0,199,199,
Oklahoma,Governor,Mary Fallin,REP,550247,0,0,102,102,
Oklahoma,Governor,Kimberly Willis,IND,550247,0,0,3,3,
Oklahoma,Governor,Richard Prawdzienski,IND,550247,0,0,3,3,
Oklahoma,Lieutenant Governor,Cathy Cummings,DEM,550247,0,0,189,189,
Oklahoma,Lieutenant Governor,Todd Lamb,REP,550247,0,0,117,117,
Oklahoma,Superintendent of Public Instruction,John Cox,DEM,550247,0,0,209,209,
Oklahoma,Superintendent of Public Instruction,Joy Hofmeister,REP,550247,0,0,98,98,
Oklahoma,Commissioner of Labor,Mike Workman,DEM,550247,0,0,207,207,
Oklahoma,Commissioner of Labor,Mark Costello,REP,550247,0,0,98,98,
Oklahoma,U.S. Senate,Matt Silverstein,DEM,550247,0,0,183,183,
Oklahoma,U.S. Senate,Jim Inhofe,REP,550247,0,0,116,116,
Oklahoma,U.S. Senate,Aaron Delozier,IND,550247,0,0,0,0,
Oklahoma,U.S. Senate,Ray Woods,IND,550247,0,0,2,2,
Oklahoma,U.S. Senate,Joan Farr,IND,550247,0,0,6,6,
Oklahoma,U.S. Senate,Connie Johnson,DEM,550247,0,0,191,191,
Oklahoma,U.S. Senate,James Lankford,REP,550247,0,0,110,110,
Oklahoma,U.S. Senate,Mark Beard,IND,550247,0,0,6,6,
Oklahoma,U.S. House,Al Mcaffrey,DEM,550247,0,0,185,185,05
Oklahoma,U.S. House,Steve Russell,REP,550247,0,0,105,105,05
Oklahoma,U.S. House,Buddy Ray,IND,550247,0,0,3,3,05
Oklahoma,U.S. House,Tom Boggs,IND,550247,0,0,3,3,05
Oklahoma,U.S. House,Robert Murphy,IND,550247,0,0,7,7,05
Oklahoma,Governor,Joe Dorman,DEM,550248,0,0,588,588,
Oklahoma,Governor,Mary Fallin,REP,550248,0,0,256,256,
Oklahoma,Governor,Kimberly Willis,IND,550248,0,0,18,18,
Oklahoma,Governor,Richard Prawdzienski,IND,550248,0,0,9,9,
Oklahoma,Lieutenant Governor,Cathy Cummings,DEM,550248,0,0,561,561,
Oklahoma,Lieutenant Governor,Todd Lamb,REP,550248,0,0,307,307,
Oklahoma,Superintendent of Public Instruction,John Cox,DEM,550248,0,0,612,612,
Oklahoma,Superintendent of Public Instruction,Joy Hofmeister,REP,550248,0,0,257,257,
Oklahoma,Commissioner of Labor,Mike Workman,DEM,550248,0,0,581,581,
Oklahoma,Commissioner of Labor,Mark Costello,REP,550248,0,0,276,276,
Oklahoma,U.S. Senate,Matt Silverstein,DEM,550248,0,0,521,521,
Oklahoma,U.S. Senate,Jim Inhofe,REP,550248,0,0,315,315,
Oklahoma,U.S. Senate,Aaron Delozier,IND,550248,0,0,11,11,
Oklahoma,U.S. Senate,Ray Woods,IND,550248,0,0,6,6,
Oklahoma,U.S. Senate,Joan Farr,IND,550248,0,0,15,15,
Oklahoma,U.S. Senate,Connie Johnson,DEM,550248,0,0,551,551,
Oklahoma,U.S. Senate,James Lankford,REP,550248,0,0,298,298,
Oklahoma,U.S. Senate,Mark Beard,IND,550248,0,0,18,18,
Oklahoma,U.S. House,Al Mcaffrey,DEM,550248,0,0,542,542,05
Oklahoma,U.S. House,Steve Russell,REP,550248,0,0,296,296,05
Oklahoma,U.S. House,Buddy Ray,IND,550248,0,0,10,10,05
Oklahoma,U.S. House,Tom Boggs,IND,550248,0,0,10,10,05
Oklahoma,U.S. House,Robert Murphy,IND,550248,0,0,10,10,05
Oklahoma,Governor,Joe Dorman,DEM,550249,0,0,531,531,
Oklahoma,Governor,Mary Fallin,REP,550249,0,0,477,477,
Oklahoma,Governor,Kimberly Willis,IND,550249,0,0,16,16,
Oklahoma,Governor,Richard Prawdzienski,IND,550249,0,0,6,6,
Oklahoma,Lieutenant Governor,Cathy Cummings,DEM,550249,0,0,475,475,
Oklahoma,Lieutenant Governor,Todd Lamb,REP,550249,0,0,554,554,
Oklahoma,Superintendent of Public Instruction,John Cox,DEM,550249,0,0,567,567,
Oklahoma,Superintendent of Public Instruction,Joy Hofmeister,REP,550249,0,0,457,457,
Oklahoma,Commissioner of Labor,Mike Workman,DEM,550249,0,0,509,509,
Oklahoma,Commissioner of Labor,Mark Costello,REP,550249,0,0,499,499,
Oklahoma,U.S. Senate,Matt Silverstein,DEM,550249,0,0,445,445,
Oklahoma,U.S. Senate,Jim Inhofe,REP,550249,0,0,554,554,
Oklahoma,U.S. Senate,Aaron Delozier,IND,550249,0,0,8,8,
Oklahoma,U.S. Senate,Ray Woods,IND,550249,0,0,6,6,
Oklahoma,U.S. Senate,Joan Farr,IND,550249,0,0,13,13,
Oklahoma,U.S. Senate,Connie Johnson,DEM,550249,0,0,477,477,
Oklahoma,U.S. Senate,James Lankford,REP,550249,0,0,542,542,
Oklahoma,U.S. Senate,Mark Beard,IND,550249,0,0,15,15,
Oklahoma,U.S. House,Al Mcaffrey,DEM,550249,0,0,452,452,05
Oklahoma,U.S. House,Steve Russell,REP,550249,0,0,553,553,05
Oklahoma,U.S. House,Buddy Ray,IND,550249,0,0,6,6,05
Oklahoma,U.S. House,Tom Boggs,IND,550249,0,0,8,8,05
Oklahoma,U.S. House,Robert Murphy,IND,550249,0,0,7,7,05
Oklahoma,Governor,Joe Dorman,DEM,550250,0,0,295,295,
Oklahoma,Governor,Mary Fallin,REP,550250,0,0,298,298,
Oklahoma,Governor,Kimberly Willis,IND,550250,0,0,10,10,
Oklahoma,Governor,Richard Prawdzienski,IND,550250,0,0,10,10,
Oklahoma,Lieutenant Governor,Cathy Cummings,DEM,550250,0,0,262,262,
Oklahoma,Lieutenant Governor,Todd Lamb,REP,550250,0,0,348,348,
Oklahoma,Superintendent of Public Instruction,John Cox,DEM,550250,0,0,314,314,
Oklahoma,Superintendent of Public Instruction,Joy Hofmeister,REP,550250,0,0,298,298,
Oklahoma,Commissioner of Labor,Mike Workman,DEM,550250,0,0,271,271,
Oklahoma,Commissioner of Labor,Mark Costello,REP,550250,0,0,333,333,
Oklahoma,U.S. Senate,Matt Silverstein,DEM,550250,0,0,237,237,
Oklahoma,U.S. Senate,Jim Inhofe,REP,550250,0,0,352,352,
Oklahoma,U.S. Senate,Aaron Delozier,IND,550250,0,0,3,3,
Oklahoma,U.S. Senate,Ray Woods,IND,550250,0,0,7,7,
Oklahoma,U.S. Senate,Joan Farr,IND,550250,0,0,12,12,
Oklahoma,U.S. Senate,Connie Johnson,DEM,550250,0,0,253,253,
Oklahoma,U.S. Senate,James Lankford,REP,550250,0,0,339,339,
Oklahoma,U.S. Senate,Mark Beard,IND,550250,0,0,20,20,
Oklahoma,U.S. House,Al Mcaffrey,DEM,550250,0,0,244,244,05
Oklahoma,U.S. House,Steve Russell,REP,550250,0,0,335,335,05
Oklahoma,U.S. House,Buddy Ray,IND,550250,0,0,4,4,05
Oklahoma,U.S. House,Tom Boggs,IND,550250,0,0,16,16,05
Oklahoma,U.S. House,Robert Murphy,IND,550250,0,0,7,7,05
Oklahoma,Governor,Joe Dorman,DEM,550251,0,0,453,453,
Oklahoma,Governor,Mary Fallin,REP,550251,0,0,411,411,
Oklahoma,Governor,Kimberly Willis,IND,550251,0,0,16,16,
Oklahoma,Governor,Richard Prawdzienski,IND,550251,0,0,12,12,
Oklahoma,Lieutenant Governor,Cathy Cummings,DEM,550251,0,0,418,418,
Oklahoma,Lieutenant Governor,Todd Lamb,REP,550251,0,0,471,471,
Oklahoma,Superintendent of Public Instruction,John Cox,DEM,550251,0,0,478,478,
Oklahoma,Superintendent of Public Instruction,Joy Hofmeister,REP,550251,0,0,408,408,
Oklahoma,Commissioner of Labor,Mike Workman,DEM,550251,0,0,428,428,
Oklahoma,Commissioner of Labor,Mark Costello,REP,550251,0,0,449,449,
Oklahoma,U.S. Senate,Matt Silverstein,DEM,550251,0,0,370,370,
Oklahoma,U.S. Senate,Jim Inhofe,REP,550251,0,0,486,486,
Oklahoma,U.S. Senate,Aaron Delozier,IND,550251,0,0,11,11,
Oklahoma,U.S. Senate,Ray Woods,IND,550251,0,0,10,10,
Oklahoma,U.S. Senate,Joan Farr,IND,550251,0,0,10,10,
Oklahoma,U.S. Senate,Connie Johnson,DEM,550251,0,0,391,391,
Oklahoma,U.S. Senate,James Lankford,REP,550251,0,0,474,474,
Oklahoma,U.S. Senate,Mark Beard,IND,550251,0,0,24,24,
Oklahoma,U.S. House,Bert Smith,DEM,550251,0,0,356,356,04
Oklahoma,U.S. House,Tom Cole,REP,550251,0,0,488,488,04
Oklahoma,U.S. House,Dennis Johnson,IND,550251,0,0,46,46,04
Oklahoma,State Senate,Hiawatha Jr.,DEM,550251,0,0,381,381,42
Oklahoma,State Senate,Jack Fry,REP,550251,0,0,451,451,42
Oklahoma,State Senate,Charles Thompson,IND,550251,0,0,51,51,42
Oklahoma,State House,Mark Deshazo,DEM,550251,0,0,408,408,95
Oklahoma,State House,Charlie Joyner,REP,550251,0,0,476,476,95
Oklahoma,Governor,Joe Dorman,DEM,550252,0,0,331,331,
Oklahoma,Governor,Mary Fallin,REP,550252,0,0,627,627,
Oklahoma,Governor,Kimberly Willis,IND,550252,0,0,18,18,
Oklahoma,Governor,Richard Prawdzienski,IND,550252,0,0,15,15,
Oklahoma,Lieutenant Governor,Cathy Cummings,DEM,550252,0,0,242,242,
Oklahoma,Lieutenant Governor,Todd Lamb,REP,550252,0,0,745,745,
Oklahoma,Superintendent of Public Instruction,John Cox,DEM,550252,0,0,394,394,
Oklahoma,Superintendent of Public Instruction,Joy Hofmeister,REP,550252,0,0,589,589,
Oklahoma,Commissioner of Labor,Mike Workman,DEM,550252,0,0,250,250,
Oklahoma,Commissioner of Labor,Mark Costello,REP,550252,0,0,708,708,
Oklahoma,U.S. Senate,Matt Silverstein,DEM,550252,0,0,199,199,
Oklahoma,U.S. Senate,Jim Inhofe,REP,550252,0,0,750,750,
Oklahoma,U.S. Senate,Aaron Delozier,IND,550252,0,0,14,14,
Oklahoma,U.S. Senate,Ray Woods,IND,550252,0,0,12,12,
Oklahoma,U.S. Senate,Joan Farr,IND,550252,0,0,8,8,
Oklahoma,U.S. Senate,Connie Johnson,DEM,550252,0,0,199,199,
Oklahoma,U.S. Senate,James Lankford,REP,550252,0,0,766,766,
Oklahoma,U.S. Senate,Mark Beard,IND,550252,0,0,26,26,
Oklahoma,U.S. House,Bert Smith,DEM,550252,0,0,177,177,04
Oklahoma,U.S. House,Tom Cole,REP,550252,0,0,776,776,04
Oklahoma,U.S. House,Dennis Johnson,IND,550252,0,0,37,37,04
Oklahoma,State Senate,Hiawatha Jr.,DEM,550252,0,0,190,190,42
Oklahoma,State Senate,Jack Fry,REP,550252,0,0,728,728,42
Oklahoma,State Senate,Charles Thompson,IND,550252,0,0,62,62,42
Oklahoma,State House,Mark Deshazo,DEM,550252,0,0,237,237,95
Oklahoma,State House,Charlie Joyner,REP,550252,0,0,738,738,95
Oklahoma,Governor,Joe Dorman,DEM,550253,0,0,78,78,
Oklahoma,Governor,Mary Fallin,REP,550253,0,0,188,188,
Oklahoma,Governor,Kimberly Willis,IND,550253,0,0,7,7,
Oklahoma,Governor,Richard Prawdzienski,IND,550253,0,0,4,4,
Oklahoma,Lieutenant Governor,Cathy Cummings,DEM,550253,0,0,55,55,
Oklahoma,Lieutenant Governor,Todd Lamb,REP,550253,0,0,219,219,
Oklahoma,Superintendent of Public Instruction,John Cox,DEM,550253,0,0,91,91,
Oklahoma,Superintendent of Public Instruction,Joy Hofmeister,REP,550253,0,0,182,182,
Oklahoma,Commissioner of Labor,Mike Workman,DEM,550253,0,0,60,60,
Oklahoma,Commissioner of Labor,Mark Costello,REP,550253,0,0,208,208,
Oklahoma,U.S. Senate,Matt Silverstein,DEM,550253,0,0,42,42,
Oklahoma,U.S. Senate,Jim Inhofe,REP,550253,0,0,221,221,
Oklahoma,U.S. Senate,Aaron Delozier,IND,550253,0,0,4,4,
Oklahoma,U.S. Senate,Ray Woods,IND,550253,0,0,5,5,
Oklahoma,U.S. Senate,Joan Farr,IND,550253,0,0,2,2,
Oklahoma,U.S. Senate,Connie Johnson,DEM,550253,0,0,45,45,
Oklahoma,U.S. Senate,James Lankford,REP,550253,0,0,215,215,
Oklahoma,U.S. Senate,Mark Beard,IND,550253,0,0,15,15,
Oklahoma,U.S. House,Al Mcaffrey,DEM,550253,0,0,43,43,05
Oklahoma,U.S. House,Steve Russell,REP,550253,0,0,208,208,05
Oklahoma,U.S. House,Buddy Ray,IND,550253,0,0,6,6,05
Oklahoma,U.S. House,Tom Boggs,IND,550253,0,0,6,6,05
Oklahoma,U.S. House,Robert Murphy,IND,550253,0,0,9,9,05
Oklahoma,State Senate,Hiawatha Jr.,DEM,550253,0,0,38,38,42
Oklahoma,State Senate,Jack Fry,REP,550253,0,0,215,215,42
Oklahoma,State Senate,Charles Thompson,IND,550253,0,0,19,19,42
Oklahoma,Governor,Joe Dorman,DEM,550254,0,0,232,232,
Oklahoma,Governor,Mary Fallin,REP,550254,0,0,558,558,
Oklahoma,Governor,Kimberly Willis,IND,550254,0,0,16,16,
Oklahoma,Governor,Richard Prawdzienski,IND,550254,0,0,13,13,
Oklahoma,Lieutenant Governor,Cathy Cummings,DEM,550254,0,0,163,163,
Oklahoma,Lieutenant Governor,Todd Lamb,REP,550254,0,0,651,651,
Oklahoma,Superintendent of Public Instruction,John Cox,DEM,550254,0,0,244,244,
Oklahoma,Superintendent of Public Instruction,Joy Hofmeister,REP,550254,0,0,566,566,
Oklahoma,Commissioner of Labor,Mike Workman,DEM,550254,0,0,189,189,
Oklahoma,Commissioner of Labor,Mark Costello,REP,550254,0,0,610,610,
Oklahoma,U.S. Senate,Matt Silverstein,DEM,550254,0,0,153,153,
Oklahoma,U.S. Senate,Jim Inhofe,REP,550254,0,0,632,632,
Oklahoma,U.S. Senate,Aaron Delozier,IND,550254,0,0,7,7,
Oklahoma,U.S. Senate,Ray Woods,IND,550254,0,0,8,8,
Oklahoma,U.S. Senate,Joan Farr,IND,550254,0,0,6,6,
Oklahoma,U.S. Senate,Connie Johnson,DEM,550254,0,0,152,152,
Oklahoma,U.S. Senate,James Lankford,REP,550254,0,0,643,643,
Oklahoma,U.S. Senate,Mark Beard,IND,550254,0,0,24,24,
Oklahoma,U.S. House,Al Mcaffrey,DEM,550254,0,0,148,148,05
Oklahoma,U.S. House,Steve Russell,REP,550254,0,0,643,643,05
Oklahoma,U.S. House,Buddy Ray,IND,550254,0,0,5,5,05
Oklahoma,U.S. House,Tom Boggs,IND,550254,0,0,10,10,05
Oklahoma,U.S. House,Robert Murphy,IND,550254,0,0,8,8,05
Oklahoma,Governor,Joe Dorman,DEM,550255,0,0,0,0,
Oklahoma,Governor,Mary Fallin,REP,550255,0,0,0,0,
Oklahoma,Governor,Kimberly Willis,IND,550255,0,0,0,0,
Oklahoma,Governor,Richard Prawdzienski,IND,550255,0,0,0,0,
Oklahoma,Lieutenant Governor,Cathy Cummings,DEM,550255,0,0,0,0,
Oklahoma,Lieutenant Governor,Todd Lamb,REP,550255,0,0,0,0,
Oklahoma,Superintendent of Public Instruction,John Cox,DEM,550255,0,0,0,0,
Oklahoma,Superintendent of Public Instruction,Joy Hofmeister,REP,550255,0,0,0,0,
Oklahoma,Commissioner of Labor,Mike Workman,DEM,550255,0,0,0,0,
Oklahoma,Commissioner of Labor,Mark Costello,REP,550255,0,0,0,0,
Oklahoma,U.S. Senate,Matt Silverstein,DEM,550255,0,0,0,0,
Oklahoma,U.S. Senate,Jim Inhofe,REP,550255,0,0,0,0,
Oklahoma,U.S. Senate,Aaron Delozier,IND,550255,0,0,0,0,
Oklahoma,U.S. Senate,Ray Woods,IND,550255,0,0,0,0,
Oklahoma,U.S. Senate,Joan Farr,IND,550255,0,0,0,0,
Oklahoma,U.S. Senate,Connie Johnson,DEM,550255,0,0,0,0,
Oklahoma,U.S. Senate,James Lankford,REP,550255,0,0,0,0,
Oklahoma,U.S. Senate,Mark Beard,IND,550255,0,0,0,0,
Oklahoma,U.S. House,Bert Smith,DEM,550255,0,0,0,0,04
Oklahoma,U.S. House,Tom Cole,REP,550255,0,0,0,0,04
Oklahoma,U.S. House,Dennis Johnson,IND,550255,0,0,0,0,04
Oklahoma,State Senate,Hiawatha Jr.,DEM,550255,0,0,0,0,42
Oklahoma,State Senate,Jack Fry,REP,550255,0,0,0,0,42
Oklahoma,State Senate,Charles Thompson,IND,550255,0,0,0,0,42
Oklahoma,State House,Mark Deshazo,DEM,550255,0,0,0,0,95
Oklahoma,State House,Charlie Joyner,REP,550255,0,0,0,0,95
Oklahoma,Governor,Joe Dorman,DEM,550256,0,0,0,0,
Oklahoma,Governor,Mary Fallin,REP,550256,0,0,0,0,
Oklahoma,Governor,Kimberly Willis,IND,550256,0,0,0,0,
Oklahoma,Governor,Richard Prawdzienski,IND,550256,0,0,0,0,
Oklahoma,Lieutenant Governor,Cathy Cummings,DEM,550256,0,0,0,0,
Oklahoma,Lieutenant Governor,Todd Lamb,REP,550256,0,0,0,0,
Oklahoma,Superintendent of Public Instruction,John Cox,DEM,550256,0,0,0,0,
Oklahoma,Superintendent of Public Instruction,Joy Hofmeister,REP,550256,0,0,0,0,
Oklahoma,Commissioner of Labor,Mike Workman,DEM,550256,0,0,0,0,
Oklahoma,Commissioner of Labor,Mark Costello,REP,550256,0,0,0,0,
Oklahoma,U.S. Senate,Matt Silverstein,DEM,550256,0,0,0,0,
Oklahoma,U.S. Senate,Jim Inhofe,REP,550256,0,0,0,0,
Oklahoma,U.S. Senate,Aaron Delozier,IND,550256,0,0,0,0,
Oklahoma,U.S. Senate,Ray Woods,IND,550256,0,0,0,0,
Oklahoma,U.S. Senate,Joan Farr,IND,550256,0,0,0,0,
Oklahoma,U.S. Senate,Connie Johnson,DEM,550256,0,0,0,0,
Oklahoma,U.S. Senate,James Lankford,REP,550256,0,0,0,0,
Oklahoma,U.S. Senate,Mark Beard,IND,550256,0,0,0,0,
Oklahoma,U.S. House,Al Mcaffrey,DEM,550256,0,0,0,0,05
Oklahoma,U.S. House,Steve Russell,REP,550256,0,0,0,0,05
Oklahoma,U.S. House,Buddy Ray,IND,550256,0,0,0,0,05
Oklahoma,U.S. House,Tom Boggs,IND,550256,0,0,0,0,05
Oklahoma,U.S. House,Robert Murphy,IND,550256,0,0,0,0,05
Oklahoma,Governor,Joe Dorman,DEM,550257,0,0,39,39,
Oklahoma,Governor,Mary Fallin,REP,550257,0,0,16,16,
Oklahoma,Governor,Kimberly Willis,IND,550257,0,0,1,1,
Oklahoma,Governor,Richard Prawdzienski,IND,550257,0,0,0,0,
Oklahoma,Lieutenant Governor,Cathy Cummings,DEM,550257,0,0,37,37,
Oklahoma,Lieutenant Governor,Todd Lamb,REP,550257,0,0,19,19,
Oklahoma,Superintendent of Public Instruction,John Cox,DEM,550257,0,0,38,38,
Oklahoma,Superintendent of Public Instruction,Joy Hofmeister,REP,550257,0,0,18,18,
Oklahoma,Commissioner of Labor,Mike Workman,DEM,550257,0,0,38,38,
Oklahoma,Commissioner of Labor,Mark Costello,REP,550257,0,0,17,17,
Oklahoma,U.S. Senate,Matt Silverstein,DEM,550257,0,0,31,31,
Oklahoma,U.S. Senate,Jim Inhofe,REP,550257,0,0,21,21,
Oklahoma,U.S. Senate,Aaron Delozier,IND,550257,0,0,2,2,
Oklahoma,U.S. Senate,Ray Woods,IND,550257,0,0,2,2,
Oklahoma,U.S. Senate,Joan Farr,IND,550257,0,0,0,0,
Oklahoma,U.S. Senate,Connie Johnson,DEM,550257,0,0,36,36,
Oklahoma,U.S. Senate,James Lankford,REP,550257,0,0,19,19,
Oklahoma,U.S. Senate,Mark Beard,IND,550257,0,0,0,0,
Oklahoma,U.S. House,Al Mcaffrey,DEM,550257,0,0,34,34,05
Oklahoma,U.S. House,Steve Russell,REP,550257,0,0,22,22,05
Oklahoma,U.S. House,Buddy Ray,IND,550257,0,0,0,0,05
Oklahoma,U.S. House,Tom Boggs,IND,550257,0,0,0,0,05
Oklahoma,U.S. House,Robert Murphy,IND,550257,0,0,0,0,05
Oklahoma,State Senate,Anastasia Pittman,DEM,550257,0,0,41,41,48
Oklahoma,State Senate,Duane Crumbacher,REP,550257,0,0,12,12,48
Oklahoma,State House,George Young,DEM,550257,0,0,39,39,99
Oklahoma,State House,Willard Linzy,REP,550257,0,0,15,15,99
Oklahoma,Governor,Joe Dorman,DEM,559999,2685,3637,0,6322,
Oklahoma,Governor,Mary Fallin,REP,559999,4579,2222,0,6801,
Oklahoma,Governor,Kimberly Willis,IND,559999,85,55,0,140,
Oklahoma,Governor,Richard Prawdzienski,IND,559999,63,37,0,100,
Oklahoma,Lieutenant Governor,Cathy Cummings,DEM,559999,2469,3307,0,5776,
Oklahoma,Lieutenant Governor,Todd Lamb,REP,559999,4935,2614,0,7549,
Oklahoma,Superintendent of Public Instruction,John Cox,DEM,559999,3134,3674,0,6808,
Oklahoma,Superintendent of Public Instruction,Joy Hofmeister,REP,559999,4171,2241,0,6412,
Oklahoma,Commissioner of Labor,Mike Workman,DEM,559999,2533,3345,0,5878,
Oklahoma,Commissioner of Labor,Mark Costello,REP,559999,4607,2481,0,7088,
Oklahoma,U.S. Senate,Matt Silverstein,DEM,559999,2335,3221,0,5556,
Oklahoma,U.S. Senate,Jim Inhofe,REP,559999,4851,2543,0,7394,
Oklahoma,U.S. Senate,Aaron Delozier,IND,559999,39,29,0,68,
Oklahoma,U.S. Senate,Ray Woods,IND,559999,58,40,0,98,
Oklahoma,U.S. Senate,Joan Farr,IND,559999,81,55,0,136,
Oklahoma,U.S. Senate,Connie Johnson,DEM,559999,2279,3276,0,5555,
Oklahoma,U.S. Senate,James Lankford,REP,559999,5002,2579,1,7582,
Oklahoma,U.S. Senate,Mark Beard,IND,559999,131,91,0,222,
Oklahoma,U.S. House,Bert Smith,DEM,559999,142,152,0,294,04
Oklahoma,U.S. House,Tom Cole,REP,559999,419,134,0,553,04
Oklahoma,U.S. House,Dennis Johnson,IND,559999,17,9,0,26,04
Oklahoma,U.S. House,Al Mcaffrey,DEM,559999,2242,3131,0,5373,05
Oklahoma,U.S. House,Steve Russell,REP,559999,4374,2362,0,6736,05
Oklahoma,U.S. House,Buddy Ray,IND,559999,28,25,0,53,05
Oklahoma,U.S. House,Tom Boggs,IND,559999,47,34,0,81,05
Oklahoma,U.S. House,Robert Murphy,IND,559999,78,62,0,140,05
Oklahoma,State Senate,John Handy Edwards,DEM,559999,411,382,0,793,40
Oklahoma,State Senate,Ervin Yen,REP,559999,571,313,0,884,40
Oklahoma,State Senate,Hiawatha Jr.,DEM,559999,187,171,0,358,42
Oklahoma,State Senate,Jack Fry,REP,559999,452,158,0,610,42
Oklahoma,State Senate,Charles Thompson,IND,559999,37,15,0,52,42
Oklahoma,State Senate,Michael Brooks-Jimenez,DEM,559999,174,90,0,264,44
Oklahoma,State Senate,Ralph Shortey,REP,559999,183,60,0,243,44
Oklahoma,State Senate,Constance Fawcett,IND,559999,20,9,0,29,44
Oklahoma,State Senate,Anastasia Pittman,DEM,559999,386,1482,0,1868,48
Oklahoma,State Senate,Duane Crumbacher,REP,559999,158,108,0,266,48
Oklahoma,State House,Ed Holzberger,DEM,559999,161,199,0,360,83
Oklahoma,State House,Randy Mcdaniel,REP,559999,482,228,0,710,83
Oklahoma,State House,Cyndi Munson,DEM,559999,331,259,0,590,85
Oklahoma,State House,David Dank,REP,559999,516,246,0,762,85
Oklahoma,State House,Collin Walke,DEM,559999,160,160,0,320,87
Oklahoma,State House,Jason Nelson,REP,559999,184,123,0,307,87
Oklahoma,State House,William Lee Molden,DEM,559999,96,41,0,137,93
Oklahoma,State House,Mike Christian,REP,559999,144,38,0,182,93
Oklahoma,State House,Mark Deshazo,DEM,559999,94,82,0,176,95
Oklahoma,State House,Charlie Joyner,REP,559999,194,70,0,264,95
Oklahoma,State House,Cecilia Taft,DEM,559999,138,107,0,245,96
Oklahoma,State House,Lewis Moore,REP,559999,385,242,0,627,96
Oklahoma,State House,Mike Shelton,DEM,559999,241,873,0,1114,97
Oklahoma,State House,Tonni Canaday,REP,559999,92,73,0,165,97
Oklahoma,State House,George Young,DEM,559999,145,557,0,702,99
Oklahoma,State House,Willard Linzy,REP,559999,65,67,0,132,99
Oklahoma,State House,Donald Smith,DEM,559999,150,125,0,275,10
Oklahoma,State House,Elise Hall,REP,559999,367,112,0,479,10
Okmulgee,Governor,Joe Dorman,DEM,560001,2,13,92,107,
Okmulgee,Governor,Mary Fallin,REP,560001,0,8,25,33,
Okmulgee,Governor,Kimberly Willis,IND,560001,0,0,6,6,
Okmulgee,Governor,Richard Prawdzienski,IND,560001,0,0,1,1,
Okmulgee,Lieutenant Governor,Cathy Cummings,DEM,560001,2,13,91,106,
Okmulgee,Lieutenant Governor,Todd Lamb,REP,560001,1,8,32,41,
Okmulgee,Superintendent of Public Instruction,John Cox,DEM,560001,2,16,98,116,
Okmulgee,Superintendent of Public Instruction,Joy Hofmeister,REP,560001,1,5,25,31,
Okmulgee,Commissioner of Labor,Mike Workman,DEM,560001,2,14,93,109,
Okmulgee,Commissioner of Labor,Mark Costello,REP,560001,1,7,30,38,
Okmulgee,U.S. Senate,Matt Silverstein,DEM,560001,2,12,86,100,
Okmulgee,U.S. Senate,Jim Inhofe,REP,560001,1,7,31,39,
Okmulgee,U.S. Senate,Aaron Delozier,IND,560001,0,2,4,6,
Okmulgee,U.S. Senate,Ray Woods,IND,560001,0,0,2,2,
Okmulgee,U.S. Senate,Joan Farr,IND,560001,0,0,0,0,
Okmulgee,U.S. Senate,Connie Johnson,DEM,560001,2,13,89,104,
Okmulgee,U.S. Senate,James Lankford,REP,560001,1,7,31,39,
Okmulgee,U.S. Senate,Mark Beard,IND,560001,0,1,4,5,
Okmulgee,U.S. House,Earl Everett,DEM,560001,2,12,83,97,02
Okmulgee,U.S. House,Markwayne Mullin,REP,560001,1,9,32,42,02
Okmulgee,U.S. House,Jon Douthitt,IND,560001,0,0,9,9,02
Okmulgee,State Senate,Selina Jayne-Dornan,DEM,560001,2,12,95,109,8
Okmulgee,State Senate,Roger Thompson,REP,560001,1,9,29,39,8
Okmulgee,State House,Jerry Shoemake,DEM,560001,2,15,101,118,16
Okmulgee,State House,James Bo Delso,REP,560001,0,6,23,29,16
Okmulgee,Governor,Joe Dorman,DEM,560002,13,29,215,257,
Okmulgee,Governor,Mary Fallin,REP,560002,0,0,21,21,
Okmulgee,Governor,Kimberly Willis,IND,560002,0,0,4,4,
Okmulgee,Governor,Richard Prawdzienski,IND,560002,0,0,0,0,
Okmulgee,Lieutenant Governor,Cathy Cummings,DEM,560002,13,27,213,253,
Okmulgee,Lieutenant Governor,Todd Lamb,REP,560002,0,1,26,27,
Okmulgee,Superintendent of Public Instruction,John Cox,DEM,560002,13,29,217,259,
Okmulgee,Superintendent of Public Instruction,Joy Hofmeister,REP,560002,0,0,23,23,
Okmulgee,Commissioner of Labor,Mike Workman,DEM,560002,13,29,222,264,
Okmulgee,Commissioner of Labor,Mark Costello,REP,560002,0,0,16,16,
Okmulgee,U.S. Senate,Matt Silverstein,DEM,560002,13,27,205,245,
Okmulgee,U.S. Senate,Jim Inhofe,REP,560002,0,2,28,30,
Okmulgee,U.S. Senate,Aaron Delozier,IND,560002,0,0,2,2,
Okmulgee,U.S. Senate,Ray Woods,IND,560002,0,0,0,0,
Okmulgee,U.S. Senate,Joan Farr,IND,560002,0,0,3,3,
Okmulgee,U.S. Senate,Connie Johnson,DEM,560002,13,27,211,251,
Okmulgee,U.S. Senate,James Lankford,REP,560002,0,2,23,25,
Okmulgee,U.S. Senate,Mark Beard,IND,560002,0,0,6,6,
Okmulgee,U.S. House,Earl Everett,DEM,560002,13,27,204,244,02
Okmulgee,U.S. House,Markwayne Mullin,REP,560002,0,2,30,32,02
Okmulgee,U.S. House,Jon Douthitt,IND,560002,0,0,4,4,02
Okmulgee,State Senate,Selina Jayne-Dornan,DEM,560002,13,27,219,259,8
Okmulgee,State Senate,Roger Thompson,REP,560002,0,2,21,23,8
Okmulgee,State House,Jerry Shoemake,DEM,560002,13,28,227,268,16
Okmulgee,State House,James Bo Delso,REP,560002,0,1,13,14,16
Okmulgee,Governor,Joe Dorman,DEM,560004,1,6,27,34,
Okmulgee,Governor,Mary Fallin,REP,560004,1,0,33,34,
Okmulgee,Governor,Kimberly Willis,IND,560004,0,0,1,1,
Okmulgee,Governor,Richard Prawdzienski,IND,560004,0,0,1,1,
Okmulgee,Lieutenant Governor,Cathy Cummings,DEM,560004,1,6,22,29,
Okmulgee,Lieutenant Governor,Todd Lamb,REP,560004,1,0,38,39,
Okmulgee,Superintendent of Public Instruction,John Cox,DEM,560004,1,6,35,42,
Okmulgee,Superintendent of Public Instruction,Joy Hofmeister,REP,560004,1,0,25,26,
Okmulgee,Commissioner of Labor,Mike Workman,DEM,560004,1,6,27,34,
Okmulgee,Commissioner of Labor,Mark Costello,REP,560004,1,0,32,33,
Okmulgee,U.S. Senate,Matt Silverstein,DEM,560004,1,6,17,24,
Okmulgee,U.S. Senate,Jim Inhofe,REP,560004,0,0,42,42,
Okmulgee,U.S. Senate,Aaron Delozier,IND,560004,1,0,0,1,
Okmulgee,U.S. Senate,Ray Woods,IND,560004,0,0,1,1,
Okmulgee,U.S. Senate,Joan Farr,IND,560004,0,0,2,2,
Okmulgee,U.S. Senate,Connie Johnson,DEM,560004,1,6,21,28,
Okmulgee,U.S. Senate,James Lankford,REP,560004,1,0,37,38,
Okmulgee,U.S. Senate,Mark Beard,IND,560004,0,0,3,3,
Okmulgee,U.S. House,Earl Everett,DEM,560004,1,6,15,22,02
Okmulgee,U.S. House,Markwayne Mullin,REP,560004,1,0,41,42,02
Okmulgee,U.S. House,Jon Douthitt,IND,560004,0,0,4,4,02
Okmulgee,State Senate,Selina Jayne-Dornan,DEM,560004,1,6,29,36,8
Okmulgee,State Senate,Roger Thompson,REP,560004,1,0,31,32,8
Okmulgee,State House,Jerry Shoemake,DEM,560004,1,6,44,51,16
Okmulgee,State House,James Bo Delso,REP,560004,1,0,18,19,16
Okmulgee,Governor,Joe Dorman,DEM,560005,0,8,112,120,
Okmulgee,Governor,Mary Fallin,REP,560005,1,7,113,121,
Okmulgee,Governor,Kimberly Willis,IND,560005,0,2,4,6,
Okmulgee,Governor,Richard Prawdzienski,IND,560005,0,0,1,1,
Okmulgee,Lieutenant Governor,Cathy Cummings,DEM,560005,0,5,98,103,
Okmulgee,Lieutenant Governor,Todd Lamb,REP,560005,1,12,128,141,
Okmulgee,Superintendent of Public Instruction,John Cox,DEM,560005,0,9,134,143,
Okmulgee,Superintendent of Public Instruction,Joy Hofmeister,REP,560005,1,8,92,101,
Okmulgee,Commissioner of Labor,Mike Workman,DEM,560005,1,8,136,145,
Okmulgee,Commissioner of Labor,Mark Costello,REP,560005,0,9,89,98,
Okmulgee,U.S. Senate,Matt Silverstein,DEM,560005,0,7,85,92,
Okmulgee,U.S. Senate,Jim Inhofe,REP,560005,1,10,137,148,
Okmulgee,U.S. Senate,Aaron Delozier,IND,560005,0,0,3,3,
Okmulgee,U.S. Senate,Ray Woods,IND,560005,0,0,2,2,
Okmulgee,U.S. Senate,Joan Farr,IND,560005,0,0,2,2,
Okmulgee,U.S. Senate,Connie Johnson,DEM,560005,0,5,89,94,
Okmulgee,U.S. Senate,James Lankford,REP,560005,1,12,126,139,
Okmulgee,U.S. Senate,Mark Beard,IND,560005,0,0,11,11,
Okmulgee,U.S. House,Earl Everett,DEM,560005,0,6,88,94,02
Okmulgee,U.S. House,Markwayne Mullin,REP,560005,1,10,129,140,02
Okmulgee,U.S. House,Jon Douthitt,IND,560005,0,1,9,10,02
Okmulgee,State Senate,Selina Jayne-Dornan,DEM,560005,1,8,122,131,8
Okmulgee,State Senate,Roger Thompson,REP,560005,0,9,105,114,8
Okmulgee,State House,Jerry Shoemake,DEM,560005,1,12,155,168,16
Okmulgee,State House,James Bo Delso,REP,560005,0,5,74,79,16
Okmulgee,Governor,Joe Dorman,DEM,560006,0,9,50,59,
Okmulgee,Governor,Mary Fallin,REP,560006,0,5,55,60,
Okmulgee,Governor,Kimberly Willis,IND,560006,0,1,3,4,
Okmulgee,Governor,Richard Prawdzienski,IND,560006,0,1,0,1,
Okmulgee,Lieutenant Governor,Cathy Cummings,DEM,560006,0,10,51,61,
Okmulgee,Lieutenant Governor,Todd Lamb,REP,560006,0,6,57,63,
Okmulgee,Superintendent of Public Instruction,John Cox,DEM,560006,0,10,59,69,
Okmulgee,Superintendent of Public Instruction,Joy Hofmeister,REP,560006,0,6,49,55,
Okmulgee,Commissioner of Labor,Mike Workman,DEM,560006,0,10,54,64,
Okmulgee,Commissioner of Labor,Mark Costello,REP,560006,0,6,54,60,
Okmulgee,U.S. Senate,Matt Silverstein,DEM,560006,0,7,39,46,
Okmulgee,U.S. Senate,Jim Inhofe,REP,560006,0,8,60,68,
Okmulgee,U.S. Senate,Aaron Delozier,IND,560006,0,0,2,2,
Okmulgee,U.S. Senate,Ray Woods,IND,560006,0,0,1,1,
Okmulgee,U.S. Senate,Joan Farr,IND,560006,0,1,5,6,
Okmulgee,U.S. Senate,Connie Johnson,DEM,560006,0,8,44,52,
Okmulgee,U.S. Senate,James Lankford,REP,560006,0,7,60,67,
Okmulgee,U.S. Senate,Mark Beard,IND,560006,0,1,4,5,
Okmulgee,U.S. House,Earl Everett,DEM,560006,0,7,35,42,02
Okmulgee,U.S. House,Markwayne Mullin,REP,560006,0,8,69,77,02
Okmulgee,U.S. House,Jon Douthitt,IND,560006,0,1,4,5,02
Okmulgee,State Senate,Selina Jayne-Dornan,DEM,560006,0,11,49,60,8
Okmulgee,State Senate,Roger Thompson,REP,560006,0,5,58,63,8
Okmulgee,State House,Jerry Shoemake,DEM,560006,0,12,75,87,16
Okmulgee,State House,James Bo Delso,REP,560006,0,4,32,36,16
Okmulgee,Governor,Joe Dorman,DEM,560007,1,9,115,125,
Okmulgee,Governor,Mary Fallin,REP,560007,2,18,140,160,
Okmulgee,Governor,Kimberly Willis,IND,560007,0,0,1,1,
Okmulgee,Governor,Richard Prawdzienski,IND,560007,0,0,4,4,
Okmulgee,Lieutenant Governor,Cathy Cummings,DEM,560007,1,8,111,120,
Okmulgee,Lieutenant Governor,Todd Lamb,REP,560007,2,19,148,169,
Okmulgee,Superintendent of Public Instruction,John Cox,DEM,560007,1,12,131,144,
Okmulgee,Superintendent of Public Instruction,Joy Hofmeister,REP,560007,2,15,126,143,
Okmulgee,Commissioner of Labor,Mike Workman,DEM,560007,1,12,127,140,
Okmulgee,Commissioner of Labor,Mark Costello,REP,560007,2,15,129,146,
Okmulgee,U.S. Senate,Matt Silverstein,DEM,560007,1,8,93,102,
Okmulgee,U.S. Senate,Jim Inhofe,REP,560007,2,18,158,178,
Okmulgee,U.S. Senate,Aaron Delozier,IND,560007,0,1,3,4,
Okmulgee,U.S. Senate,Ray Woods,IND,560007,0,0,4,4,
Okmulgee,U.S. Senate,Joan Farr,IND,560007,0,0,3,3,
Okmulgee,U.S. Senate,Connie Johnson,DEM,560007,1,8,101,110,
Okmulgee,U.S. Senate,James Lankford,REP,560007,2,19,150,171,
Okmulgee,U.S. Senate,Mark Beard,IND,560007,0,0,8,8,
Okmulgee,U.S. House,Earl Everett,DEM,560007,0,8,83,91,02
Okmulgee,U.S. House,Markwayne Mullin,REP,560007,3,19,164,186,02
Okmulgee,U.S. House,Jon Douthitt,IND,560007,0,0,12,12,02
Okmulgee,State Senate,Selina Jayne-Dornan,DEM,560007,1,10,111,122,8
Okmulgee,State Senate,Roger Thompson,REP,560007,2,17,145,164,8
Okmulgee,State House,Jerry Shoemake,DEM,560007,1,12,172,185,16
Okmulgee,State House,James Bo Delso,REP,560007,2,15,86,103,16
Okmulgee,Governor,Joe Dorman,DEM,560008,1,3,56,60,
Okmulgee,Governor,Mary Fallin,REP,560008,1,7,71,79,
Okmulgee,Governor,Kimberly Willis,IND,560008,0,0,4,4,
Okmulgee,Governor,Richard Prawdzienski,IND,560008,0,0,5,5,
Okmulgee,Lieutenant Governor,Cathy Cummings,DEM,560008,1,4,45,50,
Okmulgee,Lieutenant Governor,Todd Lamb,REP,560008,1,6,91,98,
Okmulgee,Superintendent of Public Instruction,John Cox,DEM,560008,1,3,68,72,
Okmulgee,Superintendent of Public Instruction,Joy Hofmeister,REP,560008,1,7,68,76,
Okmulgee,Commissioner of Labor,Mike Workman,DEM,560008,1,5,62,68,
Okmulgee,Commissioner of Labor,Mark Costello,REP,560008,1,5,72,78,
Okmulgee,U.S. Senate,Matt Silverstein,DEM,560008,0,3,42,45,
Okmulgee,U.S. Senate,Jim Inhofe,REP,560008,2,5,88,95,
Okmulgee,U.S. Senate,Aaron Delozier,IND,560008,0,0,0,0,
Okmulgee,U.S. Senate,Ray Woods,IND,560008,0,0,3,3,
Okmulgee,U.S. Senate,Joan Farr,IND,560008,0,1,2,3,
Okmulgee,U.S. Senate,Connie Johnson,DEM,560008,0,5,46,51,
Okmulgee,U.S. Senate,James Lankford,REP,560008,2,5,84,91,
Okmulgee,U.S. Senate,Mark Beard,IND,560008,0,0,4,4,
Okmulgee,U.S. House,Earl Everett,DEM,560008,0,4,40,44,02
Okmulgee,U.S. House,Markwayne Mullin,REP,560008,2,6,88,96,02
Okmulgee,U.S. House,Jon Douthitt,IND,560008,0,0,6,6,02
Okmulgee,State Senate,Selina Jayne-Dornan,DEM,560008,1,4,58,63,8
Okmulgee,State Senate,Roger Thompson,REP,560008,1,6,77,84,8
Okmulgee,State House,Jerry Shoemake,DEM,560008,1,4,87,92,16
Okmulgee,State House,James Bo Delso,REP,560008,1,6,47,54,16
Okmulgee,Governor,Joe Dorman,DEM,560009,2,8,69,79,
Okmulgee,Governor,Mary Fallin,REP,560009,4,7,62,73,
Okmulgee,Governor,Kimberly Willis,IND,560009,0,0,3,3,
Okmulgee,Governor,Richard Prawdzienski,IND,560009,0,0,1,1,
Okmulgee,Lieutenant Governor,Cathy Cummings,DEM,560009,2,6,63,71,
Okmulgee,Lieutenant Governor,Todd Lamb,REP,560009,3,9,72,84,
Okmulgee,Superintendent of Public Instruction,John Cox,DEM,560009,2,8,71,81,
Okmulgee,Superintendent of Public Instruction,Joy Hofmeister,REP,560009,3,7,64,74,
Okmulgee,Commissioner of Labor,Mike Workman,DEM,560009,3,7,67,77,
Okmulgee,Commissioner of Labor,Mark Costello,REP,560009,1,8,67,76,
Okmulgee,U.S. Senate,Matt Silverstein,DEM,560009,1,6,60,67,
Okmulgee,U.S. Senate,Jim Inhofe,REP,560009,4,9,70,83,
Okmulgee,U.S. Senate,Aaron Delozier,IND,560009,0,0,1,1,
Okmulgee,U.S. Senate,Ray Woods,IND,560009,0,0,2,2,
Okmulgee,U.S. Senate,Joan Farr,IND,560009,1,0,2,3,
Okmulgee,U.S. Senate,Connie Johnson,DEM,560009,3,7,60,70,
Okmulgee,U.S. Senate,James Lankford,REP,560009,2,8,67,77,
Okmulgee,U.S. Senate,Mark Beard,IND,560009,1,0,8,9,
Okmulgee,U.S. House,Earl Everett,DEM,560009,0,3,51,54,02
Okmulgee,U.S. House,Markwayne Mullin,REP,560009,5,9,78,92,02
Okmulgee,U.S. House,Jon Douthitt,IND,560009,0,3,5,8,02
Okmulgee,State Senate,Selina Jayne-Dornan,DEM,560009,3,9,64,76,8
Okmulgee,State Senate,Roger Thompson,REP,560009,3,6,70,79,8
Okmulgee,State House,Jerry Shoemake,DEM,560009,3,11,82,96,16
Okmulgee,State House,James Bo Delso,REP,560009,2,4,51,57,16
Okmulgee,Governor,Joe Dorman,DEM,560010,0,8,60,68,
Okmulgee,Governor,Mary Fallin,REP,560010,2,3,77,82,
Okmulgee,Governor,Kimberly Willis,IND,560010,0,0,2,2,
Okmulgee,Governor,Richard Prawdzienski,IND,560010,0,0,1,1,
Okmulgee,Lieutenant Governor,Cathy Cummings,DEM,560010,0,7,45,52,
Okmulgee,Lieutenant Governor,Todd Lamb,REP,560010,2,4,96,102,
Okmulgee,Superintendent of Public Instruction,John Cox,DEM,560010,0,8,69,77,
Okmulgee,Superintendent of Public Instruction,Joy Hofmeister,REP,560010,2,3,71,76,
Okmulgee,Commissioner of Labor,Mike Workman,DEM,560010,0,8,58,66,
Okmulgee,Commissioner of Labor,Mark Costello,REP,560010,2,3,77,82,
Okmulgee,U.S. Senate,Matt Silverstein,DEM,560010,0,7,42,49,
Okmulgee,U.S. Senate,Jim Inhofe,REP,560010,2,4,95,101,
Okmulgee,U.S. Senate,Aaron Delozier,IND,560010,0,0,2,2,
Okmulgee,U.S. Senate,Ray Woods,IND,560010,0,0,2,2,
Okmulgee,U.S. Senate,Joan Farr,IND,560010,0,0,0,0,
Okmulgee,U.S. Senate,Connie Johnson,DEM,560010,0,7,38,45,
Okmulgee,U.S. Senate,James Lankford,REP,560010,2,4,97,103,
Okmulgee,U.S. Senate,Mark Beard,IND,560010,0,0,4,4,
Okmulgee,U.S. House,Earl Everett,DEM,560010,0,5,29,34,02
Okmulgee,U.S. House,Markwayne Mullin,REP,560010,2,6,106,114,02
Okmulgee,U.S. House,Jon Douthitt,IND,560010,0,0,6,6,02
Okmulgee,State Senate,Selina Jayne-Dornan,DEM,560010,0,6,43,49,8
Okmulgee,State Senate,Roger Thompson,REP,560010,2,5,95,102,8
Okmulgee,Governor,Joe Dorman,DEM,560011,1,3,89,93,
Okmulgee,Governor,Mary Fallin,REP,560011,6,12,110,128,
Okmulgee,Governor,Kimberly Willis,IND,560011,2,0,5,7,
Okmulgee,Governor,Richard Prawdzienski,IND,560011,0,0,4,4,
Okmulgee,Lieutenant Governor,Cathy Cummings,DEM,560011,2,2,74,78,
Okmulgee,Lieutenant Governor,Todd Lamb,REP,560011,8,14,133,155,
Okmulgee,Superintendent of Public Instruction,John Cox,DEM,560011,5,7,106,118,
Okmulgee,Superintendent of Public Instruction,Joy Hofmeister,REP,560011,5,7,101,113,
Okmulgee,Commissioner of Labor,Mike Workman,DEM,560011,2,3,95,100,
Okmulgee,Commissioner of Labor,Mark Costello,REP,560011,7,10,106,123,
Okmulgee,U.S. Senate,Matt Silverstein,DEM,560011,1,1,74,76,
Okmulgee,U.S. Senate,Jim Inhofe,REP,560011,8,13,127,148,
Okmulgee,U.S. Senate,Aaron Delozier,IND,560011,1,0,1,2,
Okmulgee,U.S. Senate,Ray Woods,IND,560011,0,0,3,3,
Okmulgee,U.S. Senate,Joan Farr,IND,560011,0,0,2,2,
Okmulgee,U.S. Senate,Connie Johnson,DEM,560011,2,2,70,74,
Okmulgee,U.S. Senate,James Lankford,REP,560011,8,12,133,153,
Okmulgee,U.S. Senate,Mark Beard,IND,560011,0,0,5,5,
Okmulgee,U.S. House,Earl Everett,DEM,560011,2,1,58,61,02
Okmulgee,U.S. House,Markwayne Mullin,REP,560011,6,15,136,157,02
Okmulgee,U.S. House,Jon Douthitt,IND,560011,2,0,12,14,02
Okmulgee,State Senate,Selina Jayne-Dornan,DEM,560011,2,2,79,83,8
Okmulgee,State Senate,Roger Thompson,REP,560011,7,12,127,146,8
Okmulgee,State House,Jerry Shoemake,DEM,560011,4,10,136,150,16
Okmulgee,State House,James Bo Delso,REP,560011,5,5,70,80,16
Okmulgee,Governor,Joe Dorman,DEM,560012,4,30,228,262,
Okmulgee,Governor,Mary Fallin,REP,560012,5,15,278,298,
Okmulgee,Governor,Kimberly Willis,IND,560012,1,1,7,9,
Okmulgee,Governor,Richard Prawdzienski,IND,560012,0,1,3,4,
Okmulgee,Lieutenant Governor,Cathy Cummings,DEM,560012,2,23,182,207,
Okmulgee,Lieutenant Governor,Todd Lamb,REP,560012,7,24,330,361,
Okmulgee,Superintendent of Public Instruction,John Cox,DEM,560012,3,28,283,314,
Okmulgee,Superintendent of Public Instruction,Joy Hofmeister,REP,560012,7,18,230,255,
Okmulgee,Commissioner of Labor,Mike Workman,DEM,560012,3,26,211,240,
Okmulgee,Commissioner of Labor,Mark Costello,REP,560012,6,19,286,311,
Okmulgee,U.S. Senate,Matt Silverstein,DEM,560012,2,24,176,202,
Okmulgee,U.S. Senate,Jim Inhofe,REP,560012,7,20,328,355,
Okmulgee,U.S. Senate,Aaron Delozier,IND,560012,0,1,2,3,
Okmulgee,U.S. Senate,Ray Woods,IND,560012,1,0,5,6,
Okmulgee,U.S. Senate,Joan Farr,IND,560012,0,2,3,5,
Okmulgee,U.S. Senate,Connie Johnson,DEM,560012,1,21,167,189,
Okmulgee,U.S. Senate,James Lankford,REP,560012,7,22,329,358,
Okmulgee,U.S. Senate,Mark Beard,IND,560012,1,4,16,21,
Okmulgee,U.S. House,Earl Everett,DEM,560012,2,18,147,167,02
Okmulgee,U.S. House,Markwayne Mullin,REP,560012,8,25,346,379,02
Okmulgee,U.S. House,Jon Douthitt,IND,560012,0,3,21,24,02
Okmulgee,State Senate,Selina Jayne-Dornan,DEM,560012,2,26,212,240,8
Okmulgee,State Senate,Roger Thompson,REP,560012,7,20,302,329,8
Okmulgee,State House,Jerry Shoemake,DEM,560012,5,36,360,401,16
Okmulgee,State House,James Bo Delso,REP,560012,5,10,154,169,16
Okmulgee,Governor,Joe Dorman,DEM,560013,1,4,138,143,
Okmulgee,Governor,Mary Fallin,REP,560013,1,2,95,98,
Okmulgee,Governor,Kimberly Willis,IND,560013,0,0,5,5,
Okmulgee,Governor,Richard Prawdzienski,IND,560013,0,0,0,0,
Okmulgee,Lieutenant Governor,Cathy Cummings,DEM,560013,0,3,122,125,
Okmulgee,Lieutenant Governor,Todd Lamb,REP,560013,2,3,112,117,
Okmulgee,Superintendent of Public Instruction,John Cox,DEM,560013,0,6,157,163,
Okmulgee,Superintendent of Public Instruction,Joy Hofmeister,REP,560013,2,0,80,82,
Okmulgee,Commissioner of Labor,Mike Workman,DEM,560013,1,6,153,160,
Okmulgee,Commissioner of Labor,Mark Costello,REP,560013,1,0,77,78,
Okmulgee,U.S. Senate,Matt Silverstein,DEM,560013,1,2,110,113,
Okmulgee,U.S. Senate,Jim Inhofe,REP,560013,1,4,121,126,
Okmulgee,U.S. Senate,Aaron Delozier,IND,560013,0,0,2,2,
Okmulgee,U.S. Senate,Ray Woods,IND,560013,0,0,2,2,
Okmulgee,U.S. Senate,Joan Farr,IND,560013,0,0,4,4,
Okmulgee,U.S. Senate,Connie Johnson,DEM,560013,1,2,124,127,
Okmulgee,U.S. Senate,James Lankford,REP,560013,1,4,107,112,
Okmulgee,U.S. Senate,Mark Beard,IND,560013,0,0,6,6,
Okmulgee,U.S. House,Earl Everett,DEM,560013,0,3,98,101,02
Okmulgee,U.S. House,Markwayne Mullin,REP,560013,2,3,128,133,02
Okmulgee,U.S. House,Jon Douthitt,IND,560013,0,0,11,11,02
Okmulgee,State Senate,Selina Jayne-Dornan,DEM,560013,1,2,133,136,8
Okmulgee,State Senate,Roger Thompson,REP,560013,1,4,101,106,8
Okmulgee,State House,Jerry Shoemake,DEM,560013,1,6,165,172,16
Okmulgee,State House,James Bo Delso,REP,560013,1,0,71,72,16
Okmulgee,Governor,Joe Dorman,DEM,560014,3,2,71,76,
Okmulgee,Governor,Mary Fallin,REP,560014,2,3,74,79,
Okmulgee,Governor,Kimberly Willis,IND,560014,0,0,3,3,
Okmulgee,Governor,Richard Prawdzienski,IND,560014,0,0,1,1,
Okmulgee,Lieutenant Governor,Cathy Cummings,DEM,560014,3,1,66,70,
Okmulgee,Lieutenant Governor,Todd Lamb,REP,560014,1,4,82,87,
Okmulgee,Superintendent of Public Instruction,John Cox,DEM,560014,3,3,78,84,
Okmulgee,Superintendent of Public Instruction,Joy Hofmeister,REP,560014,0,2,69,71,
Okmulgee,Commissioner of Labor,Mike Workman,DEM,560014,3,2,80,85,
Okmulgee,Commissioner of Labor,Mark Costello,REP,560014,1,3,68,72,
Okmulgee,U.S. Senate,Matt Silverstein,DEM,560014,2,1,61,64,
Okmulgee,U.S. Senate,Jim Inhofe,REP,560014,2,4,84,90,
Okmulgee,U.S. Senate,Aaron Delozier,IND,560014,1,0,0,1,
Okmulgee,U.S. Senate,Ray Woods,IND,560014,0,0,2,2,
Okmulgee,U.S. Senate,Joan Farr,IND,560014,0,0,2,2,
Okmulgee,U.S. Senate,Connie Johnson,DEM,560014,3,1,65,69,
Okmulgee,U.S. Senate,James Lankford,REP,560014,1,4,79,84,
Okmulgee,U.S. Senate,Mark Beard,IND,560014,0,0,5,5,
Okmulgee,U.S. House,Earl Everett,DEM,560014,2,1,49,52,02
Okmulgee,U.S. House,Markwayne Mullin,REP,560014,0,4,88,92,02
Okmulgee,U.S. House,Jon Douthitt,IND,560014,0,0,12,12,02
Okmulgee,State Senate,Selina Jayne-Dornan,DEM,560014,3,2,65,70,8
Okmulgee,State Senate,Roger Thompson,REP,560014,2,3,85,90,8
Okmulgee,State House,Jerry Shoemake,DEM,560014,5,2,86,93,16
Okmulgee,State House,James Bo Delso,REP,560014,0,3,61,64,16
Okmulgee,Governor,Joe Dorman,DEM,560015,10,7,203,220,
Okmulgee,Governor,Mary Fallin,REP,560015,7,9,199,215,
Okmulgee,Governor,Kimberly Willis,IND,560015,1,0,7,8,
Okmulgee,Governor,Richard Prawdzienski,IND,560015,0,0,8,8,
Okmulgee,Lieutenant Governor,Cathy Cummings,DEM,560015,6,3,172,181,
Okmulgee,Lieutenant Governor,Todd Lamb,REP,560015,13,12,244,269,
Okmulgee,Superintendent of Public Instruction,John Cox,DEM,560015,11,9,255,275,
Okmulgee,Superintendent of Public Instruction,Joy Hofmeister,REP,560015,8,6,160,174,
Okmulgee,Commissioner of Labor,Mike Workman,DEM,560015,9,4,210,223,
Okmulgee,Commissioner of Labor,Mark Costello,REP,560015,9,10,197,216,
Okmulgee,U.S. Senate,Matt Silverstein,DEM,560015,5,4,161,170,
Okmulgee,U.S. Senate,Jim Inhofe,REP,560015,13,11,244,268,
Okmulgee,U.S. Senate,Aaron Delozier,IND,560015,0,0,2,2,
Okmulgee,U.S. Senate,Ray Woods,IND,560015,1,1,6,8,
Okmulgee,U.S. Senate,Joan Farr,IND,560015,0,0,5,5,
Okmulgee,U.S. Senate,Connie Johnson,DEM,560015,6,5,169,180,
Okmulgee,U.S. Senate,James Lankford,REP,560015,12,8,227,247,
Okmulgee,U.S. Senate,Mark Beard,IND,560015,1,1,20,22,
Okmulgee,U.S. House,Earl Everett,DEM,560015,4,2,134,140,02
Okmulgee,U.S. House,Markwayne Mullin,REP,560015,13,14,264,291,02
Okmulgee,U.S. House,Jon Douthitt,IND,560015,2,0,17,19,02
Okmulgee,State Senate,Selina Jayne-Dornan,DEM,560015,9,5,186,200,8
Okmulgee,State Senate,Roger Thompson,REP,560015,10,11,229,250,8
Okmulgee,State House,Jerry Shoemake,DEM,560015,12,10,271,293,16
Okmulgee,State House,James Bo Delso,REP,560015,7,6,144,157,16
Okmulgee,Governor,Joe Dorman,DEM,560016,2,4,125,131,
Okmulgee,Governor,Mary Fallin,REP,560016,6,4,117,127,
Okmulgee,Governor,Kimberly Willis,IND,560016,0,0,7,7,
Okmulgee,Governor,Richard Prawdzienski,IND,560016,0,0,2,2,
Okmulgee,Lieutenant Governor,Cathy Cummings,DEM,560016,2,4,94,100,
Okmulgee,Lieutenant Governor,Todd Lamb,REP,560016,6,3,155,164,
Okmulgee,Superintendent of Public Instruction,John Cox,DEM,560016,3,5,146,154,
Okmulgee,Superintendent of Public Instruction,Joy Hofmeister,REP,560016,5,3,105,113,
Okmulgee,Commissioner of Labor,Mike Workman,DEM,560016,3,4,122,129,
Okmulgee,Commissioner of Labor,Mark Costello,REP,560016,5,4,121,130,
Okmulgee,U.S. Senate,Matt Silverstein,DEM,560016,2,4,91,97,
Okmulgee,U.S. Senate,Jim Inhofe,REP,560016,6,4,149,159,
Okmulgee,U.S. Senate,Aaron Delozier,IND,560016,0,0,1,1,
Okmulgee,U.S. Senate,Ray Woods,IND,560016,0,0,5,5,
Okmulgee,U.S. Senate,Joan Farr,IND,560016,0,0,3,3,
Okmulgee,U.S. Senate,Connie Johnson,DEM,560016,2,4,90,96,
Okmulgee,U.S. Senate,James Lankford,REP,560016,6,4,149,159,
Okmulgee,U.S. Senate,Mark Beard,IND,560016,0,0,10,10,
Okmulgee,U.S. House,Earl Everett,DEM,560016,3,3,76,82,02
Okmulgee,U.S. House,Markwayne Mullin,REP,560016,5,5,159,169,02
Okmulgee,U.S. House,Jon Douthitt,IND,560016,0,0,11,11,02
Okmulgee,State Senate,Selina Jayne-Dornan,DEM,560016,2,4,112,118,8
Okmulgee,State Senate,Roger Thompson,REP,560016,6,4,136,146,8
Okmulgee,Governor,Joe Dorman,DEM,560018,5,2,115,122,
Okmulgee,Governor,Mary Fallin,REP,560018,4,6,81,91,
Okmulgee,Governor,Kimberly Willis,IND,560018,0,0,5,5,
Okmulgee,Governor,Richard Prawdzienski,IND,560018,0,0,3,3,
Okmulgee,Lieutenant Governor,Cathy Cummings,DEM,560018,7,2,88,97,
Okmulgee,Lieutenant Governor,Todd Lamb,REP,560018,1,6,115,122,
Okmulgee,Superintendent of Public Instruction,John Cox,DEM,560018,6,2,132,140,
Okmulgee,Superintendent of Public Instruction,Joy Hofmeister,REP,560018,3,6,72,81,
Okmulgee,Commissioner of Labor,Mike Workman,DEM,560018,7,1,113,121,
Okmulgee,Commissioner of Labor,Mark Costello,REP,560018,2,6,85,93,
Okmulgee,U.S. Senate,Matt Silverstein,DEM,560018,5,1,90,96,
Okmulgee,U.S. Senate,Jim Inhofe,REP,560018,3,7,110,120,
Okmulgee,U.S. Senate,Aaron Delozier,IND,560018,0,0,1,1,
Okmulgee,U.S. Senate,Ray Woods,IND,560018,0,0,1,1,
Okmulgee,U.S. Senate,Joan Farr,IND,560018,1,0,2,3,
Okmulgee,U.S. Senate,Connie Johnson,DEM,560018,5,0,83,88,
Okmulgee,U.S. Senate,James Lankford,REP,560018,4,8,115,127,
Okmulgee,U.S. Senate,Mark Beard,IND,560018,0,0,7,7,
Okmulgee,U.S. House,Earl Everett,DEM,560018,4,1,73,78,02
Okmulgee,U.S. House,Markwayne Mullin,REP,560018,5,7,123,135,02
Okmulgee,U.S. House,Jon Douthitt,IND,560018,0,0,7,7,02
Okmulgee,State Senate,Selina Jayne-Dornan,DEM,560018,6,2,99,107,8
Okmulgee,State Senate,Roger Thompson,REP,560018,3,6,104,113,8
Okmulgee,State House,Jerry Shoemake,DEM,560018,6,1,126,133,16
Okmulgee,State House,James Bo Delso,REP,560018,3,6,75,84,16
Okmulgee,Governor,Joe Dorman,DEM,560019,1,2,96,99,
Okmulgee,Governor,Mary Fallin,REP,560019,2,4,98,104,
Okmulgee,Governor,Kimberly Willis,IND,560019,0,0,2,2,
Okmulgee,Governor,Richard Prawdzienski,IND,560019,0,0,5,5,
Okmulgee,Lieutenant Governor,Cathy Cummings,DEM,560019,1,2,76,79,
Okmulgee,Lieutenant Governor,Todd Lamb,REP,560019,2,4,124,130,
Okmulgee,Superintendent of Public Instruction,John Cox,DEM,560019,1,2,114,117,
Okmulgee,Superintendent of Public Instruction,Joy Hofmeister,REP,560019,2,4,87,93,
Okmulgee,Commissioner of Labor,Mike Workman,DEM,560019,1,2,99,102,
Okmulgee,Commissioner of Labor,Mark Costello,REP,560019,2,4,96,102,
Okmulgee,U.S. Senate,Matt Silverstein,DEM,560019,1,2,68,71,
Okmulgee,U.S. Senate,Jim Inhofe,REP,560019,2,4,128,134,
Okmulgee,U.S. Senate,Aaron Delozier,IND,560019,0,0,0,0,
Okmulgee,U.S. Senate,Ray Woods,IND,560019,0,0,0,0,
Okmulgee,U.S. Senate,Joan Farr,IND,560019,0,0,1,1,
Okmulgee,U.S. Senate,Connie Johnson,DEM,560019,1,2,68,71,
Okmulgee,U.S. Senate,James Lankford,REP,560019,2,4,126,132,
Okmulgee,U.S. Senate,Mark Beard,IND,560019,0,0,7,7,
Okmulgee,U.S. House,Earl Everett,DEM,560019,1,0,59,60,02
Okmulgee,U.S. House,Markwayne Mullin,REP,560019,2,6,136,144,02
Okmulgee,U.S. House,Jon Douthitt,IND,560019,0,0,5,5,02
Okmulgee,State Senate,Selina Jayne-Dornan,DEM,560019,1,2,96,99,8
Okmulgee,State Senate,Roger Thompson,REP,560019,2,4,104,110,8
Okmulgee,Governor,Joe Dorman,DEM,560020,9,15,377,401,
Okmulgee,Governor,Mary Fallin,REP,560020,13,10,442,465,
Okmulgee,Governor,Kimberly Willis,IND,560020,0,1,20,21,
Okmulgee,Governor,Richard Prawdzienski,IND,560020,0,0,12,12,
Okmulgee,Lieutenant Governor,Cathy Cummings,DEM,560020,5,12,310,327,
Okmulgee,Lieutenant Governor,Todd Lamb,REP,560020,17,14,539,570,
Okmulgee,Superintendent of Public Instruction,John Cox,DEM,560020,11,19,456,486,
Okmulgee,Superintendent of Public Instruction,Joy Hofmeister,REP,560020,11,7,388,406,
Okmulgee,Commissioner of Labor,Mike Workman,DEM,560020,8,16,383,407,
Okmulgee,Commissioner of Labor,Mark Costello,REP,560020,13,8,449,470,
Okmulgee,U.S. Senate,Matt Silverstein,DEM,560020,7,10,281,298,
Okmulgee,U.S. Senate,Jim Inhofe,REP,560020,15,15,540,570,
Okmulgee,U.S. Senate,Aaron Delozier,IND,560020,0,0,7,7,
Okmulgee,U.S. Senate,Ray Woods,IND,560020,0,1,10,11,
Okmulgee,U.S. Senate,Joan Farr,IND,560020,0,0,11,11,
Okmulgee,U.S. Senate,Connie Johnson,DEM,560020,3,7,303,313,
Okmulgee,U.S. Senate,James Lankford,REP,560020,18,18,519,555,
Okmulgee,U.S. Senate,Mark Beard,IND,560020,1,1,26,28,
Okmulgee,U.S. House,Earl Everett,DEM,560020,3,8,244,255,02
Okmulgee,U.S. House,Markwayne Mullin,REP,560020,18,16,561,595,02
Okmulgee,U.S. House,Jon Douthitt,IND,560020,1,0,43,44,02
Okmulgee,State Senate,Selina Jayne-Dornan,DEM,560020,5,11,373,389,8
Okmulgee,State Senate,Roger Thompson,REP,560020,17,15,468,500,8
Okmulgee,Governor,Joe Dorman,DEM,560021,2,7,114,123,
Okmulgee,Governor,Mary Fallin,REP,560021,0,1,66,67,
Okmulgee,Governor,Kimberly Willis,IND,560021,0,0,3,3,
Okmulgee,Governor,Richard Prawdzienski,IND,560021,0,0,1,1,
Okmulgee,Lieutenant Governor,Cathy Cummings,DEM,560021,2,7,104,113,
Okmulgee,Lieutenant Governor,Todd Lamb,REP,560021,0,1,80,81,
Okmulgee,Superintendent of Public Instruction,John Cox,DEM,560021,2,7,129,138,
Okmulgee,Superintendent of Public Instruction,Joy Hofmeister,REP,560021,0,1,55,56,
Okmulgee,Commissioner of Labor,Mike Workman,DEM,560021,2,7,119,128,
Okmulgee,Commissioner of Labor,Mark Costello,REP,560021,0,1,62,63,
Okmulgee,U.S. Senate,Matt Silverstein,DEM,560021,2,7,103,112,
Okmulgee,U.S. Senate,Jim Inhofe,REP,560021,0,1,79,80,
Okmulgee,U.S. Senate,Aaron Delozier,IND,560021,0,0,2,2,
Okmulgee,U.S. Senate,Ray Woods,IND,560021,0,0,0,0,
Okmulgee,U.S. Senate,Joan Farr,IND,560021,0,0,0,0,
Okmulgee,U.S. Senate,Connie Johnson,DEM,560021,2,7,98,107,
Okmulgee,U.S. Senate,James Lankford,REP,560021,0,1,83,84,
Okmulgee,U.S. Senate,Mark Beard,IND,560021,0,0,3,3,
Okmulgee,U.S. House,Earl Everett,DEM,560021,2,7,85,94,02
Okmulgee,U.S. House,Markwayne Mullin,REP,560021,0,1,96,97,02
Okmulgee,U.S. House,Jon Douthitt,IND,560021,0,0,1,1,02
Okmulgee,State Senate,Selina Jayne-Dornan,DEM,560021,2,7,117,126,8
Okmulgee,State Senate,Roger Thompson,REP,560021,0,1,66,67,8
Okmulgee,State House,Jerry Shoemake,DEM,560021,2,7,144,153,16
Okmulgee,State House,James Bo Delso,REP,560021,0,1,39,40,16
Okmulgee,Governor,Joe Dorman,DEM,560026,1,3,195,199,
Okmulgee,Governor,Mary Fallin,REP,560026,1,19,273,293,
Okmulgee,Governor,Kimberly Willis,IND,560026,0,0,10,10,
Okmulgee,Governor,Richard Prawdzienski,IND,560026,0,1,5,6,
Okmulgee,Lieutenant Governor,Cathy Cummings,DEM,560026,1,1,137,139,
Okmulgee,Lieutenant Governor,Todd Lamb,REP,560026,1,22,346,369,
Okmulgee,Superintendent of Public Instruction,John Cox,DEM,560026,1,4,252,257,
Okmulgee,Superintendent of Public Instruction,Joy Hofmeister,REP,560026,1,19,229,249,
Okmulgee,Commissioner of Labor,Mike Workman,DEM,560026,1,4,190,195,
Okmulgee,Commissioner of Labor,Mark Costello,REP,560026,1,19,280,300,
Okmulgee,U.S. Senate,Matt Silverstein,DEM,560026,1,3,119,123,
Okmulgee,U.S. Senate,Jim Inhofe,REP,560026,1,18,348,367,
Okmulgee,U.S. Senate,Aaron Delozier,IND,560026,0,0,0,0,
Okmulgee,U.S. Senate,Ray Woods,IND,560026,0,0,8,8,
Okmulgee,U.S. Senate,Joan Farr,IND,560026,0,2,5,7,
Okmulgee,U.S. Senate,Connie Johnson,DEM,560026,1,4,115,120,
Okmulgee,U.S. Senate,James Lankford,REP,560026,1,19,352,372,
Okmulgee,U.S. Senate,Mark Beard,IND,560026,0,0,14,14,
Okmulgee,U.S. House,Earl Everett,DEM,560026,1,1,84,86,02
Okmulgee,U.S. House,Markwayne Mullin,REP,560026,1,22,378,401,02
Okmulgee,U.S. House,Jon Douthitt,IND,560026,0,0,15,15,02
Okmulgee,State Senate,Selina Jayne-Dornan,DEM,560026,1,5,165,171,8
Okmulgee,State Senate,Roger Thompson,REP,560026,1,18,315,334,8
Okmulgee,State House,Jerry Shoemake,DEM,560026,1,12,334,347,16
Okmulgee,State House,James Bo Delso,REP,560026,1,11,150,162,16
Okmulgee,Governor,Joe Dorman,DEM,560027,4,6,136,146,
Okmulgee,Governor,Mary Fallin,REP,560027,7,3,173,183,
Okmulgee,Governor,Kimberly Willis,IND,560027,0,0,7,7,
Okmulgee,Governor,Richard Prawdzienski,IND,560027,0,0,4,4,
Okmulgee,Lieutenant Governor,Cathy Cummings,DEM,560027,2,5,105,112,
Okmulgee,Lieutenant Governor,Todd Lamb,REP,560027,9,4,210,223,
Okmulgee,Superintendent of Public Instruction,John Cox,DEM,560027,3,5,173,181,
Okmulgee,Superintendent of Public Instruction,Joy Hofmeister,REP,560027,8,4,146,158,
Okmulgee,Commissioner of Labor,Mike Workman,DEM,560027,4,5,137,146,
Okmulgee,Commissioner of Labor,Mark Costello,REP,560027,7,4,178,189,
Okmulgee,U.S. Senate,Matt Silverstein,DEM,560027,3,5,90,98,
Okmulgee,U.S. Senate,Jim Inhofe,REP,560027,8,4,214,226,
Okmulgee,U.S. Senate,Aaron Delozier,IND,560027,0,0,3,3,
Okmulgee,U.S. Senate,Ray Woods,IND,560027,0,0,5,5,
Okmulgee,U.S. Senate,Joan Farr,IND,560027,0,0,3,3,
Okmulgee,U.S. Senate,Connie Johnson,DEM,560027,1,4,93,98,
Okmulgee,U.S. Senate,James Lankford,REP,560027,10,5,218,233,
Okmulgee,U.S. Senate,Mark Beard,IND,560027,0,0,7,7,
Okmulgee,U.S. House,Earl Everett,DEM,560027,1,3,69,73,02
Okmulgee,U.S. House,Markwayne Mullin,REP,560027,10,4,227,241,02
Okmulgee,U.S. House,Jon Douthitt,IND,560027,0,1,20,21,02
Okmulgee,State Senate,Selina Jayne-Dornan,DEM,560027,3,6,125,134,8
Okmulgee,State Senate,Roger Thompson,REP,560027,8,3,190,201,8
Okmulgee,State House,Jerry Shoemake,DEM,560027,7,5,198,210,16
Okmulgee,State House,James Bo Delso,REP,560027,4,4,116,124,16
Okmulgee,Governor,Joe Dorman,DEM,560029,4,5,197,206,
Okmulgee,Governor,Mary Fallin,REP,560029,20,17,423,460,
Okmulgee,Governor,Kimberly Willis,IND,560029,0,0,13,13,
Okmulgee,Governor,Richard Prawdzienski,IND,560029,2,0,11,13,
Okmulgee,Lieutenant Governor,Cathy Cummings,DEM,560029,5,4,165,174,
Okmulgee,Lieutenant Governor,Todd Lamb,REP,560029,22,18,478,518,
Okmulgee,Superintendent of Public Instruction,John Cox,DEM,560029,7,6,253,266,
Okmulgee,Superintendent of Public Instruction,Joy Hofmeister,REP,560029,19,16,389,424,
Okmulgee,Commissioner of Labor,Mike Workman,DEM,560029,6,4,211,221,
Okmulgee,Commissioner of Labor,Mark Costello,REP,560029,20,17,424,461,
Okmulgee,U.S. Senate,Matt Silverstein,DEM,560029,4,4,163,171,
Okmulgee,U.S. Senate,Jim Inhofe,REP,560029,21,18,465,504,
Okmulgee,U.S. Senate,Aaron Delozier,IND,560029,0,0,3,3,
Okmulgee,U.S. Senate,Ray Woods,IND,560029,2,0,6,8,
Okmulgee,U.S. Senate,Joan Farr,IND,560029,0,0,6,6,
Okmulgee,U.S. Senate,Connie Johnson,DEM,560029,5,4,147,156,
Okmulgee,U.S. Senate,James Lankford,REP,560029,21,18,478,517,
Okmulgee,U.S. Senate,Mark Beard,IND,560029,1,0,20,21,
Okmulgee,U.S. House,Earl Everett,DEM,560029,3,3,127,133,02
Okmulgee,U.S. House,Markwayne Mullin,REP,560029,22,19,490,531,02
Okmulgee,U.S. House,Jon Douthitt,IND,560029,2,0,27,29,02
Okmulgee,State Senate,Selina Jayne-Dornan,DEM,560029,6,3,185,194,8
Okmulgee,State Senate,Roger Thompson,REP,560029,21,20,455,496,8
Okmulgee,Governor,Joe Dorman,DEM,560031,0,1,55,56,
Okmulgee,Governor,Mary Fallin,REP,560031,1,5,77,83,
Okmulgee,Governor,Kimberly Willis,IND,560031,0,0,4,4,
Okmulgee,Governor,Richard Prawdzienski,IND,560031,0,0,0,0,
Okmulgee,Lieutenant Governor,Cathy Cummings,DEM,560031,0,0,45,45,
Okmulgee,Lieutenant Governor,Todd Lamb,REP,560031,1,7,92,100,
Okmulgee,Superintendent of Public Instruction,John Cox,DEM,560031,0,1,72,73,
Okmulgee,Superintendent of Public Instruction,Joy Hofmeister,REP,560031,1,6,64,71,
Okmulgee,Commissioner of Labor,Mike Workman,DEM,560031,0,3,65,68,
Okmulgee,Commissioner of Labor,Mark Costello,REP,560031,1,4,69,74,
Okmulgee,U.S. Senate,Matt Silverstein,DEM,560031,0,0,38,38,
Okmulgee,U.S. Senate,Jim Inhofe,REP,560031,1,7,93,101,
Okmulgee,U.S. Senate,Aaron Delozier,IND,560031,0,0,1,1,
Okmulgee,U.S. Senate,Ray Woods,IND,560031,0,0,2,2,
Okmulgee,U.S. Senate,Joan Farr,IND,560031,0,0,3,3,
Okmulgee,U.S. Senate,Connie Johnson,DEM,560031,0,1,34,35,
Okmulgee,U.S. Senate,James Lankford,REP,560031,1,5,99,105,
Okmulgee,U.S. Senate,Mark Beard,IND,560031,0,1,4,5,
Okmulgee,U.S. House,Earl Everett,DEM,560031,0,1,19,20,02
Okmulgee,U.S. House,Markwayne Mullin,REP,560031,1,6,108,115,02
Okmulgee,U.S. House,Jon Douthitt,IND,560031,0,0,10,10,02
Okmulgee,State Senate,Selina Jayne-Dornan,DEM,560031,0,1,56,57,8
Okmulgee,State Senate,Roger Thompson,REP,560031,1,6,81,88,8
Okmulgee,Governor,Joe Dorman,DEM,560032,0,5,97,102,
Okmulgee,Governor,Mary Fallin,REP,560032,3,10,109,122,
Okmulgee,Governor,Kimberly Willis,IND,560032,1,0,0,1,
Okmulgee,Governor,Richard Prawdzienski,IND,560032,0,0,2,2,
Okmulgee,Lieutenant Governor,Cathy Cummings,DEM,560032,1,4,88,93,
Okmulgee,Lieutenant Governor,Todd Lamb,REP,560032,3,10,119,132,
Okmulgee,Superintendent of Public Instruction,John Cox,DEM,560032,1,8,108,117,
Okmulgee,Superintendent of Public Instruction,Joy Hofmeister,REP,560032,3,7,98,108,
Okmulgee,Commissioner of Labor,Mike Workman,DEM,560032,1,5,100,106,
Okmulgee,Commissioner of Labor,Mark Costello,REP,560032,3,9,105,117,
Okmulgee,U.S. Senate,Matt Silverstein,DEM,560032,1,4,80,85,
Okmulgee,U.S. Senate,Jim Inhofe,REP,560032,3,10,120,133,
Okmulgee,U.S. Senate,Aaron Delozier,IND,560032,0,0,3,3,
Okmulgee,U.S. Senate,Ray Woods,IND,560032,0,0,1,1,
Okmulgee,U.S. Senate,Joan Farr,IND,560032,0,0,3,3,
Okmulgee,U.S. Senate,Connie Johnson,DEM,560032,0,4,84,88,
Okmulgee,U.S. Senate,James Lankford,REP,560032,3,11,113,127,
Okmulgee,U.S. Senate,Mark Beard,IND,560032,1,0,9,10,
Okmulgee,U.S. House,Earl Everett,DEM,560032,0,5,66,71,02
Okmulgee,U.S. House,Markwayne Mullin,REP,560032,3,10,133,146,02
Okmulgee,U.S. House,Jon Douthitt,IND,560032,1,0,8,9,02
Okmulgee,State Senate,Selina Jayne-Dornan,DEM,560032,1,6,100,107,8
Okmulgee,State Senate,Roger Thompson,REP,560032,3,9,107,119,8
Okmulgee,Governor,Joe Dorman,DEM,560033,3,10,92,105,
Okmulgee,Governor,Mary Fallin,REP,560033,0,5,116,121,
Okmulgee,Governor,Kimberly Willis,IND,560033,0,0,8,8,
Okmulgee,Governor,Richard Prawdzienski,IND,560033,0,1,3,4,
Okmulgee,Lieutenant Governor,Cathy Cummings,DEM,560033,1,9,71,81,
Okmulgee,Lieutenant Governor,Todd Lamb,REP,560033,2,7,147,156,
Okmulgee,Superintendent of Public Instruction,John Cox,DEM,560033,3,11,108,122,
Okmulgee,Superintendent of Public Instruction,Joy Hofmeister,REP,560033,0,5,109,114,
Okmulgee,Commissioner of Labor,Mike Workman,DEM,560033,3,10,98,111,
Okmulgee,Commissioner of Labor,Mark Costello,REP,560033,0,5,114,119,
Okmulgee,U.S. Senate,Matt Silverstein,DEM,560033,1,10,69,80,
Okmulgee,U.S. Senate,Jim Inhofe,REP,560033,2,6,145,153,
Okmulgee,U.S. Senate,Aaron Delozier,IND,560033,0,0,1,1,
Okmulgee,U.S. Senate,Ray Woods,IND,560033,0,0,2,2,
Okmulgee,U.S. Senate,Joan Farr,IND,560033,0,0,3,3,
Okmulgee,U.S. Senate,Connie Johnson,DEM,560033,1,10,63,74,
Okmulgee,U.S. Senate,James Lankford,REP,560033,2,6,149,157,
Okmulgee,U.S. Senate,Mark Beard,IND,560033,0,0,8,8,
Okmulgee,U.S. House,Earl Everett,DEM,560033,1,9,55,65,02
Okmulgee,U.S. House,Markwayne Mullin,REP,560033,2,7,157,166,02
Okmulgee,U.S. House,Jon Douthitt,IND,560033,0,0,8,8,02
Okmulgee,State Senate,Selina Jayne-Dornan,DEM,560033,1,10,89,100,8
Okmulgee,State Senate,Roger Thompson,REP,560033,2,6,130,138,8
Okmulgee,Governor,Joe Dorman,DEM,560034,1,2,64,67,
Okmulgee,Governor,Mary Fallin,REP,560034,4,7,120,131,
Okmulgee,Governor,Kimberly Willis,IND,560034,0,0,4,4,
Okmulgee,Governor,Richard Prawdzienski,IND,560034,0,0,0,0,
Okmulgee,Lieutenant Governor,Cathy Cummings,DEM,560034,1,2,45,48,
Okmulgee,Lieutenant Governor,Todd Lamb,REP,560034,4,7,143,154,
Okmulgee,Superintendent of Public Instruction,John Cox,DEM,560034,3,3,97,103,
Okmulgee,Superintendent of Public Instruction,Joy Hofmeister,REP,560034,2,6,90,98,
Okmulgee,Commissioner of Labor,Mike Workman,DEM,560034,1,5,82,88,
Okmulgee,Commissioner of Labor,Mark Costello,REP,560034,4,4,103,111,
Okmulgee,U.S. Senate,Matt Silverstein,DEM,560034,1,2,37,40,
Okmulgee,U.S. Senate,Jim Inhofe,REP,560034,4,7,144,155,
Okmulgee,U.S. Senate,Aaron Delozier,IND,560034,0,0,0,0,
Okmulgee,U.S. Senate,Ray Woods,IND,560034,0,0,4,4,
Okmulgee,U.S. Senate,Joan Farr,IND,560034,0,0,1,1,
Okmulgee,U.S. Senate,Connie Johnson,DEM,560034,1,2,37,40,
Okmulgee,U.S. Senate,James Lankford,REP,560034,4,7,146,157,
Okmulgee,U.S. Senate,Mark Beard,IND,560034,0,0,4,4,
Okmulgee,U.S. House,Earl Everett,DEM,560034,1,2,26,29,02
Okmulgee,U.S. House,Markwayne Mullin,REP,560034,4,7,157,168,02
Okmulgee,U.S. House,Jon Douthitt,IND,560034,0,0,4,4,02
Okmulgee,State Senate,Selina Jayne-Dornan,DEM,560034,1,2,45,48,8
Okmulgee,State Senate,Roger Thompson,REP,560034,4,7,140,151,8
Okmulgee,State House,Jerry Shoemake,DEM,560034,1,7,135,143,16
Okmulgee,State House,James Bo Delso,REP,560034,4,2,52,58,16
Okmulgee,Governor,Joe Dorman,DEM,560035,0,2,85,87,
Okmulgee,Governor,Mary Fallin,REP,560035,2,3,87,92,
Okmulgee,Governor,Kimberly Willis,IND,560035,0,0,1,1,
Okmulgee,Governor,Richard Prawdzienski,IND,560035,0,0,3,3,
Okmulgee,Lieutenant Governor,Cathy Cummings,DEM,560035,1,1,73,75,
Okmulgee,Lieutenant Governor,Todd Lamb,REP,560035,1,3,103,107,
Okmulgee,Superintendent of Public Instruction,John Cox,DEM,560035,1,2,101,104,
Okmulgee,Superintendent of Public Instruction,Joy Hofmeister,REP,560035,1,3,75,79,
Okmulgee,Commissioner of Labor,Mike Workman,DEM,560035,1,1,95,97,
Okmulgee,Commissioner of Labor,Mark Costello,REP,560035,1,3,79,83,
Okmulgee,U.S. Senate,Matt Silverstein,DEM,560035,0,2,64,66,
Okmulgee,U.S. Senate,Jim Inhofe,REP,560035,2,3,105,110,
Okmulgee,U.S. Senate,Aaron Delozier,IND,560035,0,0,3,3,
Okmulgee,U.S. Senate,Ray Woods,IND,560035,0,0,2,2,
Okmulgee,U.S. Senate,Joan Farr,IND,560035,0,0,2,2,
Okmulgee,U.S. Senate,Connie Johnson,DEM,560035,1,2,69,72,
Okmulgee,U.S. Senate,James Lankford,REP,560035,1,3,99,103,
Okmulgee,U.S. Senate,Mark Beard,IND,560035,0,0,6,6,
Okmulgee,U.S. House,Earl Everett,DEM,560035,0,2,55,57,02
Okmulgee,U.S. House,Markwayne Mullin,REP,560035,2,3,111,116,02
Okmulgee,U.S. House,Jon Douthitt,IND,560035,0,0,7,7,02
Okmulgee,State Senate,Selina Jayne-Dornan,DEM,560035,1,2,77,80,8
Okmulgee,State Senate,Roger Thompson,REP,560035,1,3,96,100,8
Okmulgee,State House,Jerry Shoemake,DEM,560035,1,0,111,112,16
Okmulgee,State House,James Bo Delso,REP,560035,1,5,65,71,16
Okmulgee,Governor,Joe Dorman,DEM,560036,3,8,153,164,
Okmulgee,Governor,Mary Fallin,REP,560036,3,28,230,261,
Okmulgee,Governor,Kimberly Willis,IND,560036,0,0,13,13,
Okmulgee,Governor,Richard Prawdzienski,IND,560036,0,0,3,3,
Okmulgee,Lieutenant Governor,Cathy Cummings,DEM,560036,3,9,126,138,
Okmulgee,Lieutenant Governor,Todd Lamb,REP,560036,3,27,273,303,
Okmulgee,Superintendent of Public Instruction,John Cox,DEM,560036,3,14,197,214,
Okmulgee,Superintendent of Public Instruction,Joy Hofmeister,REP,560036,3,22,201,226,
Okmulgee,Commissioner of Labor,Mike Workman,DEM,560036,4,13,174,191,
Okmulgee,Commissioner of Labor,Mark Costello,REP,560036,2,22,219,243,
Okmulgee,U.S. Senate,Matt Silverstein,DEM,560036,3,7,117,127,
Okmulgee,U.S. Senate,Jim Inhofe,REP,560036,3,29,269,301,
Okmulgee,U.S. Senate,Aaron Delozier,IND,560036,0,0,5,5,
Okmulgee,U.S. Senate,Ray Woods,IND,560036,0,0,3,3,
Okmulgee,U.S. Senate,Joan Farr,IND,560036,0,0,4,4,
Okmulgee,U.S. Senate,Connie Johnson,DEM,560036,1,8,117,126,
Okmulgee,U.S. Senate,James Lankford,REP,560036,3,27,266,296,
Okmulgee,U.S. Senate,Mark Beard,IND,560036,2,0,17,19,
Okmulgee,U.S. House,Earl Everett,DEM,560036,3,6,96,105,02
Okmulgee,U.S. House,Markwayne Mullin,REP,560036,3,29,287,319,02
Okmulgee,U.S. House,Jon Douthitt,IND,560036,0,0,17,17,02
Okmulgee,State Senate,Selina Jayne-Dornan,DEM,560036,6,12,166,184,8
Okmulgee,State Senate,Roger Thompson,REP,560036,0,25,233,258,8
Okmulgee,State House,Jerry Shoemake,DEM,560036,6,21,269,296,16
Okmulgee,State House,James Bo Delso,REP,560036,0,15,127,142,16
Okmulgee,Governor,Joe Dorman,DEM,560038,0,2,67,69,
Okmulgee,Governor,Mary Fallin,REP,560038,1,2,81,84,
Okmulgee,Governor,Kimberly Willis,IND,560038,0,0,2,2,
Okmulgee,Governor,Richard Prawdzienski,IND,560038,0,0,2,2,
Okmulgee,Lieutenant Governor,Cathy Cummings,DEM,560038,0,2,59,61,
Okmulgee,Lieutenant Governor,Todd Lamb,REP,560038,1,2,93,96,
Okmulgee,Superintendent of Public Instruction,John Cox,DEM,560038,0,2,91,93,
Okmulgee,Superintendent of Public Instruction,Joy Hofmeister,REP,560038,0,2,62,64,
Okmulgee,Commissioner of Labor,Mike Workman,DEM,560038,0,2,66,68,
Okmulgee,Commissioner of Labor,Mark Costello,REP,560038,1,2,81,84,
Okmulgee,U.S. Senate,Matt Silverstein,DEM,560038,0,2,46,48,
Okmulgee,U.S. Senate,Jim Inhofe,REP,560038,0,2,100,102,
Okmulgee,U.S. Senate,Aaron Delozier,IND,560038,0,0,3,3,
Okmulgee,U.S. Senate,Ray Woods,IND,560038,0,0,1,1,
Okmulgee,U.S. Senate,Joan Farr,IND,560038,0,0,2,2,
Okmulgee,U.S. Senate,Connie Johnson,DEM,560038,0,2,45,47,
Okmulgee,U.S. Senate,James Lankford,REP,560038,0,2,101,103,
Okmulgee,U.S. Senate,Mark Beard,IND,560038,1,0,6,7,
Okmulgee,U.S. House,Earl Everett,DEM,560038,0,1,30,31,02
Okmulgee,U.S. House,Markwayne Mullin,REP,560038,1,3,114,118,02
Okmulgee,U.S. House,Jon Douthitt,IND,560038,0,0,10,10,02
Okmulgee,State Senate,Selina Jayne-Dornan,DEM,560038,0,2,51,53,8
Okmulgee,State Senate,Roger Thompson,REP,560038,1,2,101,104,8
Osage,Governor,Joe Dorman,DEM,570101,1,1,29,31,
Osage,Governor,Mary Fallin,REP,570101,2,2,64,68,
Osage,Governor,Kimberly Willis,IND,570101,0,0,4,4,
Osage,Governor,Richard Prawdzienski,IND,570101,0,0,1,1,
Osage,Lieutenant Governor,Cathy Cummings,DEM,570101,1,1,21,23,
Osage,Lieutenant Governor,Todd Lamb,REP,570101,2,2,75,79,
Osage,Superintendent of Public Instruction,John Cox,DEM,570101,1,1,48,50,
Osage,Superintendent of Public Instruction,Joy Hofmeister,REP,570101,2,2,49,53,
Osage,Commissioner of Labor,Mike Workman,DEM,570101,1,1,33,35,
Osage,Commissioner of Labor,Mark Costello,REP,570101,2,2,54,58,
Osage,U.S. Senate,Matt Silverstein,DEM,570101,1,1,17,19,
Osage,U.S. Senate,Jim Inhofe,REP,570101,2,2,74,78,
Osage,U.S. Senate,Aaron Delozier,IND,570101,0,0,0,0,
Osage,U.S. Senate,Ray Woods,IND,570101,0,0,2,2,
Osage,U.S. Senate,Joan Farr,IND,570101,0,0,3,3,
Osage,U.S. Senate,Connie Johnson,DEM,570101,1,1,19,21,
Osage,U.S. Senate,James Lankford,REP,570101,2,2,70,74,
Osage,U.S. Senate,Mark Beard,IND,570101,0,0,5,5,
Osage,U.S. House,Frankie Robbins,DEM,570101,1,1,24,26,03
Osage,U.S. House,Frank Lucas,REP,570101,2,2,70,74,03
Osage,State House,Anthony Tucker,DEM,570101,1,1,29,31,10
Osage,State House,Travis Dunlap,REP,570101,2,2,66,70,10
Osage,Governor,Joe Dorman,DEM,570102,4,3,34,41,
Osage,Governor,Mary Fallin,REP,570102,2,3,65,70,
Osage,Governor,Kimberly Willis,IND,570102,0,0,4,4,
Osage,Governor,Richard Prawdzienski,IND,570102,0,0,1,1,
Osage,Lieutenant Governor,Cathy Cummings,DEM,570102,4,1,29,34,
Osage,Lieutenant Governor,Todd Lamb,REP,570102,2,5,75,82,
Osage,Superintendent of Public Instruction,John Cox,DEM,570102,4,2,37,43,
Osage,Superintendent of Public Instruction,Joy Hofmeister,REP,570102,2,3,65,70,
Osage,Commissioner of Labor,Mike Workman,DEM,570102,5,1,30,36,
Osage,Commissioner of Labor,Mark Costello,REP,570102,1,4,71,76,
Osage,U.S. Senate,Matt Silverstein,DEM,570102,4,0,23,27,
Osage,U.S. Senate,Jim Inhofe,REP,570102,2,6,76,84,
Osage,U.S. Senate,Aaron Delozier,IND,570102,0,0,0,0,
Osage,U.S. Senate,Ray Woods,IND,570102,0,0,1,1,
Osage,U.S. Senate,Joan Farr,IND,570102,0,0,4,4,
Osage,U.S. Senate,Connie Johnson,DEM,570102,4,1,24,29,
Osage,U.S. Senate,James Lankford,REP,570102,2,5,74,81,
Osage,U.S. Senate,Mark Beard,IND,570102,0,0,6,6,
Osage,U.S. House,Frankie Robbins,DEM,570102,4,0,27,31,03
Osage,U.S. House,Frank Lucas,REP,570102,2,6,77,85,03
Osage,State House,Jim Massey,DEM,570102,5,1,31,37,36
Osage,State House,Sean Roberts,REP,570102,1,5,72,78,36
Osage,Governor,Joe Dorman,DEM,570103,0,2,53,55,
Osage,Governor,Mary Fallin,REP,570103,2,1,112,115,
Osage,Governor,Kimberly Willis,IND,570103,0,0,6,6,
Osage,Governor,Richard Prawdzienski,IND,570103,0,0,1,1,
Osage,Lieutenant Governor,Cathy Cummings,DEM,570103,0,1,38,39,
Osage,Lieutenant Governor,Todd Lamb,REP,570103,2,2,135,139,
Osage,Superintendent of Public Instruction,John Cox,DEM,570103,0,1,64,65,
Osage,Superintendent of Public Instruction,Joy Hofmeister,REP,570103,2,2,108,112,
Osage,Commissioner of Labor,Mike Workman,DEM,570103,0,2,59,61,
Osage,Commissioner of Labor,Mark Costello,REP,570103,2,1,110,113,
Osage,U.S. Senate,Matt Silverstein,DEM,570103,0,1,24,25,
Osage,U.S. Senate,Jim Inhofe,REP,570103,2,2,138,142,
Osage,U.S. Senate,Aaron Delozier,IND,570103,0,0,1,1,
Osage,U.S. Senate,Ray Woods,IND,570103,0,0,3,3,
Osage,U.S. Senate,Joan Farr,IND,570103,0,0,7,7,
Osage,U.S. Senate,Connie Johnson,DEM,570103,0,1,35,36,
Osage,U.S. Senate,James Lankford,REP,570103,2,2,126,130,
Osage,U.S. Senate,Mark Beard,IND,570103,0,0,11,11,
Osage,U.S. House,Frankie Robbins,DEM,570103,0,1,34,35,03
Osage,U.S. House,Frank Lucas,REP,570103,2,2,138,142,03
Osage,Governor,Joe Dorman,DEM,570105,7,0,165,172,
Osage,Governor,Mary Fallin,REP,570105,17,0,279,296,
Osage,Governor,Kimberly Willis,IND,570105,0,0,11,11,
Osage,Governor,Richard Prawdzienski,IND,570105,0,0,4,4,
Osage,Lieutenant Governor,Cathy Cummings,DEM,570105,8,0,115,123,
Osage,Lieutenant Governor,Todd Lamb,REP,570105,16,0,346,362,
Osage,Superintendent of Public Instruction,John Cox,DEM,570105,11,0,186,197,
Osage,Superintendent of Public Instruction,Joy Hofmeister,REP,570105,12,0,273,285,
Osage,Commissioner of Labor,Mike Workman,DEM,570105,9,0,155,164,
Osage,Commissioner of Labor,Mark Costello,REP,570105,13,0,295,308,
Osage,U.S. Senate,Matt Silverstein,DEM,570105,6,0,121,127,
Osage,U.S. Senate,Jim Inhofe,REP,570105,17,0,324,341,
Osage,U.S. Senate,Aaron Delozier,IND,570105,0,0,2,2,
Osage,U.S. Senate,Ray Woods,IND,570105,1,0,9,10,
Osage,U.S. Senate,Joan Farr,IND,570105,0,0,5,5,
Osage,U.S. Senate,Connie Johnson,DEM,570105,8,0,104,112,
Osage,U.S. Senate,James Lankford,REP,570105,16,0,339,355,
Osage,U.S. Senate,Mark Beard,IND,570105,0,0,18,18,
Osage,U.S. House,Frankie Robbins,DEM,570105,6,0,124,130,03
Osage,U.S. House,Frank Lucas,REP,570105,18,0,336,354,03
Osage,Governor,Joe Dorman,DEM,570106,0,0,14,14,
Osage,Governor,Mary Fallin,REP,570106,0,0,35,35,
Osage,Governor,Kimberly Willis,IND,570106,0,0,2,2,
Osage,Governor,Richard Prawdzienski,IND,570106,0,0,0,0,
Osage,Lieutenant Governor,Cathy Cummings,DEM,570106,0,0,15,15,
Osage,Lieutenant Governor,Todd Lamb,REP,570106,0,0,36,36,
Osage,Superintendent of Public Instruction,John Cox,DEM,570106,0,0,13,13,
Osage,Superintendent of Public Instruction,Joy Hofmeister,REP,570106,0,0,37,37,
Osage,Commissioner of Labor,Mike Workman,DEM,570106,0,0,13,13,
Osage,Commissioner of Labor,Mark Costello,REP,570106,0,0,38,38,
Osage,U.S. Senate,Matt Silverstein,DEM,570106,0,0,8,8,
Osage,U.S. Senate,Jim Inhofe,REP,570106,0,0,40,40,
Osage,U.S. Senate,Aaron Delozier,IND,570106,0,0,1,1,
Osage,U.S. Senate,Ray Woods,IND,570106,0,0,1,1,
Osage,U.S. Senate,Joan Farr,IND,570106,0,0,1,1,
Osage,U.S. Senate,Connie Johnson,DEM,570106,0,0,12,12,
Osage,U.S. Senate,James Lankford,REP,570106,0,0,36,36,
Osage,U.S. Senate,Mark Beard,IND,570106,0,0,2,2,
Osage,U.S. House,Frankie Robbins,DEM,570106,0,0,7,7,03
Osage,U.S. House,Frank Lucas,REP,570106,0,0,43,43,03
Osage,Governor,Joe Dorman,DEM,570107,10,47,335,392,
Osage,Governor,Mary Fallin,REP,570107,13,57,274,344,
Osage,Governor,Kimberly Willis,IND,570107,0,2,28,30,
Osage,Governor,Richard Prawdzienski,IND,570107,0,1,15,16,
Osage,Lieutenant Governor,Cathy Cummings,DEM,570107,13,24,263,300,
Osage,Lieutenant Governor,Todd Lamb,REP,570107,10,82,384,476,
Osage,Superintendent of Public Instruction,John Cox,DEM,570107,16,46,372,434,
Osage,Superintendent of Public Instruction,Joy Hofmeister,REP,570107,7,60,275,342,
Osage,Commissioner of Labor,Mike Workman,DEM,570107,13,41,330,384,
Osage,Commissioner of Labor,Mark Costello,REP,570107,9,61,299,369,
Osage,U.S. Senate,Matt Silverstein,DEM,570107,8,26,215,249,
Osage,U.S. Senate,Jim Inhofe,REP,570107,16,79,395,490,
Osage,U.S. Senate,Aaron Delozier,IND,570107,0,1,11,12,
Osage,U.S. Senate,Ray Woods,IND,570107,0,0,12,12,
Osage,U.S. Senate,Joan Farr,IND,570107,0,1,13,14,
Osage,U.S. Senate,Connie Johnson,DEM,570107,10,29,228,267,
Osage,U.S. Senate,James Lankford,REP,570107,13,76,389,478,
Osage,U.S. Senate,Mark Beard,IND,570107,1,3,30,34,
Osage,U.S. House,Frankie Robbins,DEM,570107,7,23,232,262,03
Osage,U.S. House,Frank Lucas,REP,570107,17,85,410,512,03
Osage,Governor,Joe Dorman,DEM,570108,5,32,207,244,
Osage,Governor,Mary Fallin,REP,570108,8,16,161,185,
Osage,Governor,Kimberly Willis,IND,570108,0,1,10,11,
Osage,Governor,Richard Prawdzienski,IND,570108,0,1,2,3,
Osage,Lieutenant Governor,Cathy Cummings,DEM,570108,3,27,161,191,
Osage,Lieutenant Governor,Todd Lamb,REP,570108,10,22,216,248,
Osage,Superintendent of Public Instruction,John Cox,DEM,570108,9,30,206,245,
Osage,Superintendent of Public Instruction,Joy Hofmeister,REP,570108,4,19,171,194,
Osage,Commissioner of Labor,Mike Workman,DEM,570108,4,32,205,241,
Osage,Commissioner of Labor,Mark Costello,REP,570108,7,15,167,189,
Osage,U.S. Senate,Matt Silverstein,DEM,570108,3,22,141,166,
Osage,U.S. Senate,Jim Inhofe,REP,570108,10,25,229,264,
Osage,U.S. Senate,Aaron Delozier,IND,570108,0,1,3,4,
Osage,U.S. Senate,Ray Woods,IND,570108,0,0,2,2,
Osage,U.S. Senate,Joan Farr,IND,570108,0,2,5,7,
Osage,U.S. Senate,Connie Johnson,DEM,570108,3,26,146,175,
Osage,U.S. Senate,James Lankford,REP,570108,9,19,213,241,
Osage,U.S. Senate,Mark Beard,IND,570108,1,5,14,20,
Osage,U.S. House,Frankie Robbins,DEM,570108,3,23,148,174,03
Osage,U.S. House,Frank Lucas,REP,570108,10,26,226,262,03
Osage,State House,Jim Massey,DEM,570108,2,32,197,231,36
Osage,State House,Sean Roberts,REP,570108,9,15,176,200,36
Osage,Governor,Joe Dorman,DEM,570109,5,1,142,148,
Osage,Governor,Mary Fallin,REP,570109,10,4,324,338,
Osage,Governor,Kimberly Willis,IND,570109,0,0,16,16,
Osage,Governor,Richard Prawdzienski,IND,570109,0,0,1,1,
Osage,Lieutenant Governor,Cathy Cummings,DEM,570109,5,1,103,109,
Osage,Lieutenant Governor,Todd Lamb,REP,570109,10,4,380,394,
Osage,Superintendent of Public Instruction,John Cox,DEM,570109,7,1,174,182,
Osage,Superintendent of Public Instruction,Joy Hofmeister,REP,570109,8,4,307,319,
Osage,Commissioner of Labor,Mike Workman,DEM,570109,6,0,122,128,
Osage,Commissioner of Labor,Mark Costello,REP,570109,9,5,353,367,
Osage,U.S. Senate,Matt Silverstein,DEM,570109,3,1,106,110,
Osage,U.S. Senate,Jim Inhofe,REP,570109,12,4,364,380,
Osage,U.S. Senate,Aaron Delozier,IND,570109,0,0,2,2,
Osage,U.S. Senate,Ray Woods,IND,570109,0,0,3,3,
Osage,U.S. Senate,Joan Farr,IND,570109,0,0,4,4,
Osage,U.S. Senate,Connie Johnson,DEM,570109,5,1,97,103,
Osage,U.S. Senate,James Lankford,REP,570109,9,4,366,379,
Osage,U.S. Senate,Mark Beard,IND,570109,1,0,19,20,
Osage,U.S. House,Frankie Robbins,DEM,570109,3,1,99,103,03
Osage,U.S. House,Frank Lucas,REP,570109,12,4,383,399,03
Osage,State House,Anthony Tucker,DEM,570109,2,1,117,120,10
Osage,State House,Travis Dunlap,REP,570109,13,4,362,379,10
Osage,Governor,Joe Dorman,DEM,570110,6,2,139,147,
Osage,Governor,Mary Fallin,REP,570110,8,10,278,296,
Osage,Governor,Kimberly Willis,IND,570110,1,1,9,11,
Osage,Governor,Richard Prawdzienski,IND,570110,0,0,4,4,
Osage,Lieutenant Governor,Cathy Cummings,DEM,570110,4,1,80,85,
Osage,Lieutenant Governor,Todd Lamb,REP,570110,11,12,349,372,
Osage,Superintendent of Public Instruction,John Cox,DEM,570110,6,6,169,181,
Osage,Superintendent of Public Instruction,Joy Hofmeister,REP,570110,9,7,257,273,
Osage,Commissioner of Labor,Mike Workman,DEM,570110,5,3,140,148,
Osage,Commissioner of Labor,Mark Costello,REP,570110,10,10,280,300,
Osage,U.S. Senate,Matt Silverstein,DEM,570110,4,2,74,80,
Osage,U.S. Senate,Jim Inhofe,REP,570110,11,9,348,368,
Osage,U.S. Senate,Aaron Delozier,IND,570110,0,0,2,2,
Osage,U.S. Senate,Ray Woods,IND,570110,0,1,1,2,
Osage,U.S. Senate,Joan Farr,IND,570110,0,1,2,3,
Osage,U.S. Senate,Connie Johnson,DEM,570110,4,1,78,83,
Osage,U.S. Senate,James Lankford,REP,570110,10,10,337,357,
Osage,U.S. Senate,Mark Beard,IND,570110,1,2,13,16,
Osage,U.S. House,Frankie Robbins,DEM,570110,4,2,85,91,03
Osage,U.S. House,Frank Lucas,REP,570110,11,10,341,362,03
Osage,State House,Jim Massey,DEM,570110,4,3,116,123,36
Osage,State House,Sean Roberts,REP,570110,11,9,306,326,36
Osage,Governor,Joe Dorman,DEM,570111,0,5,60,65,
Osage,Governor,Mary Fallin,REP,570111,0,4,88,92,
Osage,Governor,Kimberly Willis,IND,570111,0,0,5,5,
Osage,Governor,Richard Prawdzienski,IND,570111,0,1,1,2,
Osage,Lieutenant Governor,Cathy Cummings,DEM,570111,0,2,35,37,
Osage,Lieutenant Governor,Todd Lamb,REP,570111,0,8,118,126,
Osage,Superintendent of Public Instruction,John Cox,DEM,570111,0,2,74,76,
Osage,Superintendent of Public Instruction,Joy Hofmeister,REP,570111,0,7,79,86,
Osage,Commissioner of Labor,Mike Workman,DEM,570111,0,5,56,61,
Osage,Commissioner of Labor,Mark Costello,REP,570111,0,4,93,97,
Osage,U.S. Senate,Matt Silverstein,DEM,570111,0,1,31,32,
Osage,U.S. Senate,Jim Inhofe,REP,570111,0,9,117,126,
Osage,U.S. Senate,Aaron Delozier,IND,570111,0,0,4,4,
Osage,U.S. Senate,Ray Woods,IND,570111,0,0,0,0,
Osage,U.S. Senate,Joan Farr,IND,570111,0,0,1,1,
Osage,U.S. Senate,Connie Johnson,DEM,570111,0,2,33,35,
Osage,U.S. Senate,James Lankford,REP,570111,0,7,112,119,
Osage,U.S. Senate,Mark Beard,IND,570111,0,0,7,7,
Osage,U.S. House,Frankie Robbins,DEM,570111,0,1,39,40,03
Osage,U.S. House,Frank Lucas,REP,570111,0,7,115,122,03
Osage,State House,Jim Massey,DEM,570111,0,1,44,45,36
Osage,State House,Sean Roberts,REP,570111,0,8,107,115,36
Osage,Governor,Joe Dorman,DEM,570112,13,2,87,102,
Osage,Governor,Mary Fallin,REP,570112,9,4,132,145,
Osage,Governor,Kimberly Willis,IND,570112,0,0,7,7,
Osage,Governor,Richard Prawdzienski,IND,570112,0,0,4,4,
Osage,Lieutenant Governor,Cathy Cummings,DEM,570112,8,1,63,72,
Osage,Lieutenant Governor,Todd Lamb,REP,570112,14,5,162,181,
Osage,Superintendent of Public Instruction,John Cox,DEM,570112,10,2,102,114,
Osage,Superintendent of Public Instruction,Joy Hofmeister,REP,570112,11,4,126,141,
Osage,Commissioner of Labor,Mike Workman,DEM,570112,11,3,80,94,
Osage,Commissioner of Labor,Mark Costello,REP,570112,10,3,139,152,
Osage,U.S. Senate,Matt Silverstein,DEM,570112,4,1,57,62,
Osage,U.S. Senate,Jim Inhofe,REP,570112,18,3,162,183,
Osage,U.S. Senate,Aaron Delozier,IND,570112,0,1,4,5,
Osage,U.S. Senate,Ray Woods,IND,570112,0,0,2,2,
Osage,U.S. Senate,Joan Farr,IND,570112,0,1,4,5,
Osage,U.S. Senate,Connie Johnson,DEM,570112,7,2,61,70,
Osage,U.S. Senate,James Lankford,REP,570112,13,3,148,164,
Osage,U.S. Senate,Mark Beard,IND,570112,1,1,15,17,
Osage,U.S. House,Frankie Robbins,DEM,570112,9,1,59,69,03
Osage,U.S. House,Frank Lucas,REP,570112,12,5,163,180,03
Osage,State House,Jim Massey,DEM,570112,6,3,82,91,36
Osage,State House,Sean Roberts,REP,570112,15,3,138,156,36
Osage,Governor,Joe Dorman,DEM,570113,0,1,19,20,
Osage,Governor,Mary Fallin,REP,570113,0,0,27,27,
Osage,Governor,Kimberly Willis,IND,570113,0,0,0,0,
Osage,Governor,Richard Prawdzienski,IND,570113,0,0,0,0,
Osage,Lieutenant Governor,Cathy Cummings,DEM,570113,0,1,15,16,
Osage,Lieutenant Governor,Todd Lamb,REP,570113,0,0,29,29,
Osage,Superintendent of Public Instruction,John Cox,DEM,570113,0,1,21,22,
Osage,Superintendent of Public Instruction,Joy Hofmeister,REP,570113,0,0,25,25,
Osage,Commissioner of Labor,Mike Workman,DEM,570113,0,1,23,24,
Osage,Commissioner of Labor,Mark Costello,REP,570113,0,0,19,19,
Osage,U.S. Senate,Matt Silverstein,DEM,570113,0,0,14,14,
Osage,U.S. Senate,Jim Inhofe,REP,570113,0,1,32,33,
Osage,U.S. Senate,Aaron Delozier,IND,570113,0,0,0,0,
Osage,U.S. Senate,Ray Woods,IND,570113,0,0,0,0,
Osage,U.S. Senate,Joan Farr,IND,570113,0,0,0,0,
Osage,U.S. Senate,Connie Johnson,DEM,570113,0,1,17,18,
Osage,U.S. Senate,James Lankford,REP,570113,0,0,28,28,
Osage,U.S. Senate,Mark Beard,IND,570113,0,0,0,0,
Osage,U.S. House,Frankie Robbins,DEM,570113,0,0,13,13,03
Osage,U.S. House,Frank Lucas,REP,570113,0,1,31,32,03
Osage,Governor,Joe Dorman,DEM,570201,10,1,335,346,
Osage,Governor,Mary Fallin,REP,570201,25,3,669,697,
Osage,Governor,Kimberly Willis,IND,570201,3,0,32,35,
Osage,Governor,Richard Prawdzienski,IND,570201,0,0,15,15,
Osage,Lieutenant Governor,Cathy Cummings,DEM,570201,10,1,237,248,
Osage,Lieutenant Governor,Todd Lamb,REP,570201,28,3,809,840,
Osage,Superintendent of Public Instruction,John Cox,DEM,570201,13,1,406,420,
Osage,Superintendent of Public Instruction,Joy Hofmeister,REP,570201,27,3,635,665,
Osage,Commissioner of Labor,Mike Workman,DEM,570201,11,1,321,333,
Osage,Commissioner of Labor,Mark Costello,REP,570201,27,3,702,732,
Osage,U.S. Senate,Matt Silverstein,DEM,570201,8,1,241,250,
Osage,U.S. Senate,Jim Inhofe,REP,570201,29,3,770,802,
Osage,U.S. Senate,Aaron Delozier,IND,570201,3,0,15,18,
Osage,U.S. Senate,Ray Woods,IND,570201,0,0,10,10,
Osage,U.S. Senate,Joan Farr,IND,570201,0,0,14,14,
Osage,U.S. Senate,Connie Johnson,DEM,570201,9,1,219,229,
Osage,U.S. Senate,James Lankford,REP,570201,29,2,793,824,
Osage,U.S. Senate,Mark Beard,IND,570201,2,1,36,39,
Osage,U.S. House,Frankie Robbins,DEM,570201,8,1,241,250,03
Osage,U.S. House,Frank Lucas,REP,570201,32,3,792,827,03
Osage,State House,Jim Massey,DEM,570201,12,1,310,323,36
Osage,State House,Sean Roberts,REP,570201,28,3,725,756,36
Osage,Governor,Joe Dorman,DEM,570202,48,4,805,857,
Osage,Governor,Mary Fallin,REP,570202,12,0,100,112,
Osage,Governor,Kimberly Willis,IND,570202,1,0,18,19,
Osage,Governor,Richard Prawdzienski,IND,570202,0,0,2,2,
Osage,Lieutenant Governor,Cathy Cummings,DEM,570202,48,4,782,834,
Osage,Lieutenant Governor,Todd Lamb,REP,570202,12,0,140,152,
Osage,Superintendent of Public Instruction,John Cox,DEM,570202,49,4,793,846,
Osage,Superintendent of Public Instruction,Joy Hofmeister,REP,570202,11,0,130,141,
Osage,Commissioner of Labor,Mike Workman,DEM,570202,49,4,795,848,
Osage,Commissioner of Labor,Mark Costello,REP,570202,11,0,124,135,
Osage,U.S. Senate,Matt Silverstein,DEM,570202,49,4,765,818,
Osage,U.S. Senate,Jim Inhofe,REP,570202,12,0,129,141,
Osage,U.S. Senate,Aaron Delozier,IND,570202,0,0,3,3,
Osage,U.S. Senate,Ray Woods,IND,570202,0,0,14,14,
Osage,U.S. Senate,Joan Farr,IND,570202,0,0,11,11,
Osage,U.S. Senate,Connie Johnson,DEM,570202,49,4,800,853,
Osage,U.S. Senate,James Lankford,REP,570202,11,0,109,120,
Osage,U.S. Senate,Mark Beard,IND,570202,1,0,17,18,
Osage,U.S. House,Frankie Robbins,DEM,570202,49,4,790,843,03
Osage,U.S. House,Frank Lucas,REP,570202,13,0,129,142,03
Osage,Governor,Joe Dorman,DEM,570203,18,3,399,420,
Osage,Governor,Mary Fallin,REP,570203,40,6,826,872,
Osage,Governor,Kimberly Willis,IND,570203,1,0,22,23,
Osage,Governor,Richard Prawdzienski,IND,570203,0,0,17,17,
Osage,Lieutenant Governor,Cathy Cummings,DEM,570203,13,2,283,298,
Osage,Lieutenant Governor,Todd Lamb,REP,570203,46,7,975,1028,
Osage,Superintendent of Public Instruction,John Cox,DEM,570203,20,7,441,468,
Osage,Superintendent of Public Instruction,Joy Hofmeister,REP,570203,36,2,816,854,
Osage,Commissioner of Labor,Mike Workman,DEM,570203,14,2,345,361,
Osage,Commissioner of Labor,Mark Costello,REP,570203,42,7,895,944,
Osage,U.S. Senate,Matt Silverstein,DEM,570203,12,3,269,284,
Osage,U.S. Senate,Jim Inhofe,REP,570203,45,6,947,998,
Osage,U.S. Senate,Aaron Delozier,IND,570203,1,0,24,25,
Osage,U.S. Senate,Ray Woods,IND,570203,0,0,10,10,
Osage,U.S. Senate,Joan Farr,IND,570203,1,0,10,11,
Osage,U.S. Senate,Connie Johnson,DEM,570203,13,3,241,257,
Osage,U.S. Senate,James Lankford,REP,570203,44,5,976,1025,
Osage,U.S. Senate,Mark Beard,IND,570203,0,1,40,41,
Osage,U.S. House,Frankie Robbins,DEM,570203,12,1,277,290,03
Osage,U.S. House,Frank Lucas,REP,570203,47,8,975,1030,03
Osage,State House,Jim Massey,DEM,570203,15,3,395,413,36
Osage,State House,Sean Roberts,REP,570203,41,6,856,903,36
Osage,Governor,Joe Dorman,DEM,570204,9,1,136,146,
Osage,Governor,Mary Fallin,REP,570204,3,3,211,217,
Osage,Governor,Kimberly Willis,IND,570204,0,0,18,18,
Osage,Governor,Richard Prawdzienski,IND,570204,0,0,2,2,
Osage,Lieutenant Governor,Cathy Cummings,DEM,570204,6,1,109,116,
Osage,Lieutenant Governor,Todd Lamb,REP,570204,6,3,258,267,
Osage,Superintendent of Public Instruction,John Cox,DEM,570204,8,1,150,159,
Osage,Superintendent of Public Instruction,Joy Hofmeister,REP,570204,4,3,213,220,
Osage,Commissioner of Labor,Mike Workman,DEM,570204,6,1,140,147,
Osage,Commissioner of Labor,Mark Costello,REP,570204,6,3,221,230,
Osage,U.S. Senate,Matt Silverstein,DEM,570204,6,1,98,105,
Osage,U.S. Senate,Jim Inhofe,REP,570204,6,3,250,259,
Osage,U.S. Senate,Aaron Delozier,IND,570204,0,0,7,7,
Osage,U.S. Senate,Ray Woods,IND,570204,0,0,2,2,
Osage,U.S. Senate,Joan Farr,IND,570204,0,0,5,5,
Osage,U.S. Senate,Connie Johnson,DEM,570204,5,1,98,104,
Osage,U.S. Senate,James Lankford,REP,570204,7,3,257,267,
Osage,U.S. Senate,Mark Beard,IND,570204,0,0,12,12,
Osage,U.S. House,Frankie Robbins,DEM,570204,6,1,109,116,03
Osage,U.S. House,Frank Lucas,REP,570204,6,3,253,262,03
Osage,State House,Jim Massey,DEM,570204,2,1,142,145,36
Osage,State House,Sean Roberts,REP,570204,10,3,214,227,36
Osage,Governor,Joe Dorman,DEM,570205,1,0,51,52,
Osage,Governor,Mary Fallin,REP,570205,2,0,63,65,
Osage,Governor,Kimberly Willis,IND,570205,0,0,3,3,
Osage,Governor,Richard Prawdzienski,IND,570205,0,0,2,2,
Osage,Lieutenant Governor,Cathy Cummings,DEM,570205,1,0,43,44,
Osage,Lieutenant Governor,Todd Lamb,REP,570205,2,0,76,78,
Osage,Superintendent of Public Instruction,John Cox,DEM,570205,3,0,51,54,
Osage,Superintendent of Public Instruction,Joy Hofmeister,REP,570205,0,0,68,68,
Osage,Commissioner of Labor,Mike Workman,DEM,570205,1,0,51,52,
Osage,Commissioner of Labor,Mark Costello,REP,570205,2,0,67,69,
Osage,U.S. Senate,Matt Silverstein,DEM,570205,1,0,39,40,
Osage,U.S. Senate,Jim Inhofe,REP,570205,2,0,77,79,
Osage,U.S. Senate,Aaron Delozier,IND,570205,0,0,1,1,
Osage,U.S. Senate,Ray Woods,IND,570205,0,0,0,0,
Osage,U.S. Senate,Joan Farr,IND,570205,0,0,2,2,
Osage,U.S. Senate,Connie Johnson,DEM,570205,1,0,44,45,
Osage,U.S. Senate,James Lankford,REP,570205,2,0,71,73,
Osage,U.S. Senate,Mark Beard,IND,570205,0,0,3,3,
Osage,U.S. House,Frankie Robbins,DEM,570205,1,0,47,48,03
Osage,U.S. House,Frank Lucas,REP,570205,2,0,72,74,03
Osage,State House,Jim Massey,DEM,570205,1,0,54,55,36
Osage,State House,Sean Roberts,REP,570205,2,0,65,67,36
Osage,Governor,Joe Dorman,DEM,570301,10,5,177,192,
Osage,Governor,Mary Fallin,REP,570301,7,2,192,201,
Osage,Governor,Kimberly Willis,IND,570301,0,0,8,8,
Osage,Governor,Richard Prawdzienski,IND,570301,0,0,4,4,
Osage,Lieutenant Governor,Cathy Cummings,DEM,570301,9,3,139,151,
Osage,Lieutenant Governor,Todd Lamb,REP,570301,7,4,239,250,
Osage,Superintendent of Public Instruction,John Cox,DEM,570301,12,4,180,196,
Osage,Superintendent of Public Instruction,Joy Hofmeister,REP,570301,4,3,199,206,
Osage,Commissioner of Labor,Mike Workman,DEM,570301,10,4,184,198,
Osage,Commissioner of Labor,Mark Costello,REP,570301,6,3,185,194,
Osage,U.S. Senate,Matt Silverstein,DEM,570301,9,4,113,126,
Osage,U.S. Senate,Jim Inhofe,REP,570301,7,3,257,267,
Osage,U.S. Senate,Aaron Delozier,IND,570301,1,0,1,2,
Osage,U.S. Senate,Ray Woods,IND,570301,0,0,6,6,
Osage,U.S. Senate,Joan Farr,IND,570301,0,0,3,3,
Osage,U.S. Senate,Connie Johnson,DEM,570301,9,4,138,151,
Osage,U.S. Senate,James Lankford,REP,570301,7,3,224,234,
Osage,U.S. Senate,Mark Beard,IND,570301,1,0,14,15,
Osage,U.S. House,Frankie Robbins,DEM,570301,8,2,120,130,03
Osage,U.S. House,Frank Lucas,REP,570301,8,5,257,270,03
Osage,State House,Jim Massey,DEM,570301,9,4,143,156,36
Osage,State House,Sean Roberts,REP,570301,8,2,233,243,36
Osage,Governor,Joe Dorman,DEM,570302,2,0,53,55,
Osage,Governor,Mary Fallin,REP,570302,4,0,48,52,
Osage,Governor,Kimberly Willis,IND,570302,0,0,2,2,
Osage,Governor,Richard Prawdzienski,IND,570302,0,0,0,0,
Osage,Lieutenant Governor,Cathy Cummings,DEM,570302,3,0,41,44,
Osage,Lieutenant Governor,Todd Lamb,REP,570302,3,0,62,65,
Osage,Superintendent of Public Instruction,John Cox,DEM,570302,3,0,49,52,
Osage,Superintendent of Public Instruction,Joy Hofmeister,REP,570302,3,0,54,57,
Osage,Commissioner of Labor,Mike Workman,DEM,570302,2,0,50,52,
Osage,Commissioner of Labor,Mark Costello,REP,570302,4,0,49,53,
Osage,U.S. Senate,Matt Silverstein,DEM,570302,1,0,36,37,
Osage,U.S. Senate,Jim Inhofe,REP,570302,3,0,60,63,
Osage,U.S. Senate,Aaron Delozier,IND,570302,0,0,2,2,
Osage,U.S. Senate,Ray Woods,IND,570302,1,0,2,3,
Osage,U.S. Senate,Joan Farr,IND,570302,1,0,3,4,
Osage,U.S. Senate,Connie Johnson,DEM,570302,0,0,38,38,
Osage,U.S. Senate,James Lankford,REP,570302,5,0,57,62,
Osage,U.S. Senate,Mark Beard,IND,570302,1,0,9,10,
Osage,U.S. House,Frankie Robbins,DEM,570302,2,0,40,42,03
Osage,U.S. House,Frank Lucas,REP,570302,4,0,63,67,03
Osage,Governor,Joe Dorman,DEM,570303,5,2,70,77,
Osage,Governor,Mary Fallin,REP,570303,11,3,117,131,
Osage,Governor,Kimberly Willis,IND,570303,0,0,3,3,
Osage,Governor,Richard Prawdzienski,IND,570303,0,0,2,2,
Osage,Lieutenant Governor,Cathy Cummings,DEM,570303,4,2,56,62,
Osage,Lieutenant Governor,Todd Lamb,REP,570303,12,3,132,147,
Osage,Superintendent of Public Instruction,John Cox,DEM,570303,4,3,77,84,
Osage,Superintendent of Public Instruction,Joy Hofmeister,REP,570303,12,2,114,128,
Osage,Commissioner of Labor,Mike Workman,DEM,570303,6,2,67,75,
Osage,Commissioner of Labor,Mark Costello,REP,570303,9,3,122,134,
Osage,U.S. Senate,Matt Silverstein,DEM,570303,4,2,51,57,
Osage,U.S. Senate,Jim Inhofe,REP,570303,12,3,136,151,
Osage,U.S. Senate,Aaron Delozier,IND,570303,0,0,2,2,
Osage,U.S. Senate,Ray Woods,IND,570303,0,0,2,2,
Osage,U.S. Senate,Joan Farr,IND,570303,0,0,1,1,
Osage,U.S. Senate,Connie Johnson,DEM,570303,6,2,46,54,
Osage,U.S. Senate,James Lankford,REP,570303,10,3,142,155,
Osage,U.S. Senate,Mark Beard,IND,570303,0,0,4,4,
Osage,U.S. House,Frankie Robbins,DEM,570303,5,2,57,64,03
Osage,U.S. House,Frank Lucas,REP,570303,11,3,135,149,03
Osage,Governor,Joe Dorman,DEM,570305,5,1,100,106,
Osage,Governor,Mary Fallin,REP,570305,7,0,146,153,
Osage,Governor,Kimberly Willis,IND,570305,0,0,5,5,
Osage,Governor,Richard Prawdzienski,IND,570305,1,0,5,6,
Osage,Lieutenant Governor,Cathy Cummings,DEM,570305,4,0,74,78,
Osage,Lieutenant Governor,Todd Lamb,REP,570305,9,1,179,189,
Osage,Superintendent of Public Instruction,John Cox,DEM,570305,3,1,109,113,
Osage,Superintendent of Public Instruction,Joy Hofmeister,REP,570305,10,0,143,153,
Osage,Commissioner of Labor,Mike Workman,DEM,570305,8,1,90,99,
Osage,Commissioner of Labor,Mark Costello,REP,570305,5,0,156,161,
Osage,U.S. Senate,Matt Silverstein,DEM,570305,3,1,72,76,
Osage,U.S. Senate,Jim Inhofe,REP,570305,9,0,167,176,
Osage,U.S. Senate,Aaron Delozier,IND,570305,1,0,4,5,
Osage,U.S. Senate,Ray Woods,IND,570305,0,0,7,7,
Osage,U.S. Senate,Joan Farr,IND,570305,0,0,2,2,
Osage,U.S. Senate,Connie Johnson,DEM,570305,2,0,62,64,
Osage,U.S. Senate,James Lankford,REP,570305,11,1,175,187,
Osage,U.S. Senate,Mark Beard,IND,570305,0,0,14,14,
Osage,U.S. House,Frankie Robbins,DEM,570305,3,1,72,76,03
Osage,U.S. House,Frank Lucas,REP,570305,10,0,178,188,03
Osage,State House,Wannetta Cloyd,DEM,570305,7,1,75,83,35
Osage,State House,Dennis Casey,REP,570305,6,0,175,181,35
Osage,Governor,Joe Dorman,DEM,570306,2,0,122,124,
Osage,Governor,Mary Fallin,REP,570306,8,3,182,193,
Osage,Governor,Kimberly Willis,IND,570306,0,0,8,8,
Osage,Governor,Richard Prawdzienski,IND,570306,0,0,0,0,
Osage,Lieutenant Governor,Cathy Cummings,DEM,570306,2,0,80,82,
Osage,Lieutenant Governor,Todd Lamb,REP,570306,8,3,222,233,
Osage,Superintendent of Public Instruction,John Cox,DEM,570306,2,0,140,142,
Osage,Superintendent of Public Instruction,Joy Hofmeister,REP,570306,8,3,168,179,
Osage,Commissioner of Labor,Mike Workman,DEM,570306,2,0,107,109,
Osage,Commissioner of Labor,Mark Costello,REP,570306,8,3,189,200,
Osage,U.S. Senate,Matt Silverstein,DEM,570306,2,0,73,75,
Osage,U.S. Senate,Jim Inhofe,REP,570306,8,3,226,237,
Osage,U.S. Senate,Aaron Delozier,IND,570306,0,0,1,1,
Osage,U.S. Senate,Ray Woods,IND,570306,0,0,5,5,
Osage,U.S. Senate,Joan Farr,IND,570306,0,0,3,3,
Osage,U.S. Senate,Connie Johnson,DEM,570306,2,0,73,75,
Osage,U.S. Senate,James Lankford,REP,570306,8,3,222,233,
Osage,U.S. Senate,Mark Beard,IND,570306,0,0,11,11,
Osage,U.S. House,Frankie Robbins,DEM,570306,0,0,78,78,03
Osage,U.S. House,Frank Lucas,REP,570306,10,3,225,238,03
Osage,State House,Jim Massey,DEM,570306,0,0,101,101,36
Osage,State House,Sean Roberts,REP,570306,10,3,204,217,36
Osage,Governor,Joe Dorman,DEM,570307,10,4,235,249,
Osage,Governor,Mary Fallin,REP,570307,7,1,149,157,
Osage,Governor,Kimberly Willis,IND,570307,0,0,17,17,
Osage,Governor,Richard Prawdzienski,IND,570307,0,0,7,7,
Osage,Lieutenant Governor,Cathy Cummings,DEM,570307,6,3,182,191,
Osage,Lieutenant Governor,Todd Lamb,REP,570307,11,2,220,233,
Osage,Superintendent of Public Instruction,John Cox,DEM,570307,8,4,249,261,
Osage,Superintendent of Public Instruction,Joy Hofmeister,REP,570307,8,1,156,165,
Osage,Commissioner of Labor,Mike Workman,DEM,570307,7,4,219,230,
Osage,Commissioner of Labor,Mark Costello,REP,570307,9,1,177,187,
Osage,U.S. Senate,Matt Silverstein,DEM,570307,6,4,148,158,
Osage,U.S. Senate,Jim Inhofe,REP,570307,11,1,239,251,
Osage,U.S. Senate,Aaron Delozier,IND,570307,0,0,3,3,
Osage,U.S. Senate,Ray Woods,IND,570307,0,0,8,8,
Osage,U.S. Senate,Joan Farr,IND,570307,0,0,7,7,
Osage,U.S. Senate,Connie Johnson,DEM,570307,5,3,154,162,
Osage,U.S. Senate,James Lankford,REP,570307,11,1,222,234,
Osage,U.S. Senate,Mark Beard,IND,570307,1,1,27,29,
Osage,U.S. House,Frankie Robbins,DEM,570307,5,2,158,165,03
Osage,U.S. House,Frank Lucas,REP,570307,12,3,247,262,03
Osage,State House,Jim Massey,DEM,570307,8,3,191,202,36
Osage,State House,Sean Roberts,REP,570307,9,2,214,225,36
Osage,Governor,Joe Dorman,DEM,570308,4,3,224,231,
Osage,Governor,Mary Fallin,REP,570308,11,1,411,423,
Osage,Governor,Kimberly Willis,IND,570308,1,0,12,13,
Osage,Governor,Richard Prawdzienski,IND,570308,0,0,4,4,
Osage,Lieutenant Governor,Cathy Cummings,DEM,570308,4,1,165,170,
Osage,Lieutenant Governor,Todd Lamb,REP,570308,12,3,485,500,
Osage,Superintendent of Public Instruction,John Cox,DEM,570308,4,2,238,244,
Osage,Superintendent of Public Instruction,Joy Hofmeister,REP,570308,12,2,411,425,
Osage,Commissioner of Labor,Mike Workman,DEM,570308,4,1,202,207,
Osage,Commissioner of Labor,Mark Costello,REP,570308,12,3,437,452,
Osage,U.S. Senate,Matt Silverstein,DEM,570308,3,1,171,175,
Osage,U.S. Senate,Jim Inhofe,REP,570308,12,3,459,474,
Osage,U.S. Senate,Aaron Delozier,IND,570308,0,0,10,10,
Osage,U.S. Senate,Ray Woods,IND,570308,1,0,6,7,
Osage,U.S. Senate,Joan Farr,IND,570308,0,0,5,5,
Osage,U.S. Senate,Connie Johnson,DEM,570308,4,1,150,155,
Osage,U.S. Senate,James Lankford,REP,570308,11,3,477,491,
Osage,U.S. Senate,Mark Beard,IND,570308,1,0,23,24,
Osage,U.S. House,Frankie Robbins,DEM,570308,3,1,166,170,03
Osage,U.S. House,Frank Lucas,REP,570308,13,3,482,498,03
Osage,State House,Jim Massey,DEM,570308,4,2,206,212,36
Osage,State House,Sean Roberts,REP,570308,12,2,439,453,36
Osage,Governor,Joe Dorman,DEM,570309,4,0,87,91,
Osage,Governor,Mary Fallin,REP,570309,14,2,235,251,
Osage,Governor,Kimberly Willis,IND,570309,0,0,5,5,
Osage,Governor,Richard Prawdzienski,IND,570309,0,0,4,4,
Osage,Lieutenant Governor,Cathy Cummings,DEM,570309,2,0,56,58,
Osage,Lieutenant Governor,Todd Lamb,REP,570309,16,2,273,291,
Osage,Superintendent of Public Instruction,John Cox,DEM,570309,6,1,85,92,
Osage,Superintendent of Public Instruction,Joy Hofmeister,REP,570309,12,1,246,259,
Osage,Commissioner of Labor,Mike Workman,DEM,570309,1,1,86,88,
Osage,Commissioner of Labor,Mark Costello,REP,570309,17,1,237,255,
Osage,U.S. Senate,Matt Silverstein,DEM,570309,0,0,59,59,
Osage,U.S. Senate,Jim Inhofe,REP,570309,18,2,260,280,
Osage,U.S. Senate,Aaron Delozier,IND,570309,0,0,2,2,
Osage,U.S. Senate,Ray Woods,IND,570309,0,0,7,7,
Osage,U.S. Senate,Joan Farr,IND,570309,0,0,3,3,
Osage,U.S. Senate,Connie Johnson,DEM,570309,0,0,50,50,
Osage,U.S. Senate,James Lankford,REP,570309,18,2,268,288,
Osage,U.S. Senate,Mark Beard,IND,570309,0,0,11,11,
Osage,U.S. House,Frankie Robbins,DEM,570309,0,0,61,61,03
Osage,U.S. House,Frank Lucas,REP,570309,18,2,269,289,03
Osage,State House,Jim Massey,DEM,570309,6,0,80,86,36
Osage,State House,Sean Roberts,REP,570309,11,2,247,260,36
Osage,Governor,Joe Dorman,DEM,570310,20,2,465,487,
Osage,Governor,Mary Fallin,REP,570310,6,1,49,56,
Osage,Governor,Kimberly Willis,IND,570310,0,0,3,3,
Osage,Governor,Richard Prawdzienski,IND,570310,0,0,0,0,
Osage,Lieutenant Governor,Cathy Cummings,DEM,570310,19,2,455,476,
Osage,Lieutenant Governor,Todd Lamb,REP,570310,7,1,61,69,
Osage,Superintendent of Public Instruction,John Cox,DEM,570310,17,2,453,472,
Osage,Superintendent of Public Instruction,Joy Hofmeister,REP,570310,9,1,64,74,
Osage,Commissioner of Labor,Mike Workman,DEM,570310,18,2,466,486,
Osage,Commissioner of Labor,Mark Costello,REP,570310,7,1,48,56,
Osage,U.S. Senate,Matt Silverstein,DEM,570310,19,2,438,459,
Osage,U.S. Senate,Jim Inhofe,REP,570310,7,1,64,72,
Osage,U.S. Senate,Aaron Delozier,IND,570310,0,0,2,2,
Osage,U.S. Senate,Ray Woods,IND,570310,0,0,6,6,
Osage,U.S. Senate,Joan Farr,IND,570310,0,0,5,5,
Osage,U.S. Senate,Connie Johnson,DEM,570310,20,2,460,482,
Osage,U.S. Senate,James Lankford,REP,570310,6,1,50,57,
Osage,U.S. Senate,Mark Beard,IND,570310,0,0,7,7,
Osage,U.S. House,Frankie Robbins,DEM,570310,19,2,457,478,03
Osage,U.S. House,Frank Lucas,REP,570310,7,1,58,66,03
Osage,Governor,Joe Dorman,DEM,570311,6,0,21,27,
Osage,Governor,Mary Fallin,REP,570311,7,2,29,38,
Osage,Governor,Kimberly Willis,IND,570311,0,0,1,1,
Osage,Governor,Richard Prawdzienski,IND,570311,0,0,0,0,
Osage,Lieutenant Governor,Cathy Cummings,DEM,570311,5,0,19,24,
Osage,Lieutenant Governor,Todd Lamb,REP,570311,8,2,32,42,
Osage,Superintendent of Public Instruction,John Cox,DEM,570311,4,0,22,26,
Osage,Superintendent of Public Instruction,Joy Hofmeister,REP,570311,9,2,29,40,
Osage,Commissioner of Labor,Mike Workman,DEM,570311,2,0,24,26,
Osage,Commissioner of Labor,Mark Costello,REP,570311,10,2,27,39,
Osage,U.S. Senate,Matt Silverstein,DEM,570311,5,0,21,26,
Osage,U.S. Senate,Jim Inhofe,REP,570311,8,2,30,40,
Osage,U.S. Senate,Aaron Delozier,IND,570311,0,0,0,0,
Osage,U.S. Senate,Ray Woods,IND,570311,0,0,0,0,
Osage,U.S. Senate,Joan Farr,IND,570311,0,0,0,0,
Osage,U.S. Senate,Connie Johnson,DEM,570311,4,0,20,24,
Osage,U.S. Senate,James Lankford,REP,570311,9,2,31,42,
Osage,U.S. Senate,Mark Beard,IND,570311,0,0,0,0,
Osage,U.S. House,Frankie Robbins,DEM,570311,2,0,19,21,03
Osage,U.S. House,Frank Lucas,REP,570311,11,2,32,45,03
Osage,Governor,Joe Dorman,DEM,570312,3,0,115,118,
Osage,Governor,Mary Fallin,REP,570312,14,2,216,232,
Osage,Governor,Kimberly Willis,IND,570312,0,1,8,9,
Osage,Governor,Richard Prawdzienski,IND,570312,0,0,2,2,
Osage,Lieutenant Governor,Cathy Cummings,DEM,570312,3,0,86,89,
Osage,Lieutenant Governor,Todd Lamb,REP,570312,14,3,253,270,
Osage,Superintendent of Public Instruction,John Cox,DEM,570312,2,0,118,120,
Osage,Superintendent of Public Instruction,Joy Hofmeister,REP,570312,15,3,222,240,
Osage,Commissioner of Labor,Mike Workman,DEM,570312,3,0,99,102,
Osage,Commissioner of Labor,Mark Costello,REP,570312,14,3,235,252,
Osage,U.S. Senate,Matt Silverstein,DEM,570312,2,0,91,93,
Osage,U.S. Senate,Jim Inhofe,REP,570312,14,3,242,259,
Osage,U.S. Senate,Aaron Delozier,IND,570312,1,0,3,4,
Osage,U.S. Senate,Ray Woods,IND,570312,0,0,0,0,
Osage,U.S. Senate,Joan Farr,IND,570312,0,0,3,3,
Osage,U.S. Senate,Connie Johnson,DEM,570312,3,0,81,84,
Osage,U.S. Senate,James Lankford,REP,570312,14,2,249,265,
Osage,U.S. Senate,Mark Beard,IND,570312,0,1,9,10,
Osage,U.S. House,Frankie Robbins,DEM,570312,3,0,84,87,03
Osage,U.S. House,Frank Lucas,REP,570312,14,3,252,269,03
Ottawa,Governor,Joe Dorman,DEM,580002,3,8,95,106,
Ottawa,Governor,Mary Fallin,REP,580002,5,9,146,160,
Ottawa,Governor,Kimberly Willis,IND,580002,0,0,3,3,
Ottawa,Governor,Richard Prawdzienski,IND,580002,0,0,2,2,
Ottawa,Lieutenant Governor,Cathy Cummings,DEM,580002,2,6,91,99,
Ottawa,Lieutenant Governor,Todd Lamb,REP,580002,6,11,152,169,
Ottawa,Superintendent of Public Instruction,John Cox,DEM,580002,2,5,115,122,
Ottawa,Superintendent of Public Instruction,Joy Hofmeister,REP,580002,6,12,132,150,
Ottawa,Commissioner of Labor,Mike Workman,DEM,580002,1,6,110,117,
Ottawa,Commissioner of Labor,Mark Costello,REP,580002,7,10,136,153,
Ottawa,U.S. Senate,Matt Silverstein,DEM,580002,1,6,78,85,
Ottawa,U.S. Senate,Jim Inhofe,REP,580002,7,10,159,176,
Ottawa,U.S. Senate,Aaron Delozier,IND,580002,0,0,3,3,
Ottawa,U.S. Senate,Ray Woods,IND,580002,0,1,1,2,
Ottawa,U.S. Senate,Joan Farr,IND,580002,0,0,3,3,
Ottawa,U.S. Senate,Connie Johnson,DEM,580002,1,6,80,87,
Ottawa,U.S. Senate,James Lankford,REP,580002,7,11,155,173,
Ottawa,U.S. Senate,Mark Beard,IND,580002,0,0,11,11,
Ottawa,U.S. House,Earl Everett,DEM,580002,1,4,52,57,02
Ottawa,U.S. House,Markwayne Mullin,REP,580002,7,11,152,170,02
Ottawa,U.S. House,Jon Douthitt,IND,580002,0,2,40,42,02
Ottawa,Governor,Joe Dorman,DEM,580003,3,9,150,162,
Ottawa,Governor,Mary Fallin,REP,580003,6,12,202,220,
Ottawa,Governor,Kimberly Willis,IND,580003,1,0,8,9,
Ottawa,Governor,Richard Prawdzienski,IND,580003,0,1,7,8,
Ottawa,Lieutenant Governor,Cathy Cummings,DEM,580003,2,10,127,139,
Ottawa,Lieutenant Governor,Todd Lamb,REP,580003,8,13,238,259,
Ottawa,Superintendent of Public Instruction,John Cox,DEM,580003,2,12,180,194,
Ottawa,Superintendent of Public Instruction,Joy Hofmeister,REP,580003,8,11,184,203,
Ottawa,Commissioner of Labor,Mike Workman,DEM,580003,2,11,146,159,
Ottawa,Commissioner of Labor,Mark Costello,REP,580003,8,10,213,231,
Ottawa,U.S. Senate,Matt Silverstein,DEM,580003,3,8,105,116,
Ottawa,U.S. Senate,Jim Inhofe,REP,580003,7,14,245,266,
Ottawa,U.S. Senate,Aaron Delozier,IND,580003,0,0,6,6,
Ottawa,U.S. Senate,Ray Woods,IND,580003,0,0,4,4,
Ottawa,U.S. Senate,Joan Farr,IND,580003,0,0,4,4,
Ottawa,U.S. Senate,Connie Johnson,DEM,580003,2,8,103,113,
Ottawa,U.S. Senate,James Lankford,REP,580003,8,13,242,263,
Ottawa,U.S. Senate,Mark Beard,IND,580003,0,1,18,19,
Ottawa,U.S. House,Earl Everett,DEM,580003,3,5,65,73,02
Ottawa,U.S. House,Markwayne Mullin,REP,580003,6,12,230,248,02
Ottawa,U.S. House,Jon Douthitt,IND,580003,1,6,69,76,02
Ottawa,Governor,Joe Dorman,DEM,580004,2,10,72,84,
Ottawa,Governor,Mary Fallin,REP,580004,0,11,84,95,
Ottawa,Governor,Kimberly Willis,IND,580004,1,0,2,3,
Ottawa,Governor,Richard Prawdzienski,IND,580004,0,0,3,3,
Ottawa,Lieutenant Governor,Cathy Cummings,DEM,580004,2,6,53,61,
Ottawa,Lieutenant Governor,Todd Lamb,REP,580004,1,15,105,121,
Ottawa,Superintendent of Public Instruction,John Cox,DEM,580004,2,14,80,96,
Ottawa,Superintendent of Public Instruction,Joy Hofmeister,REP,580004,1,7,81,89,
Ottawa,Commissioner of Labor,Mike Workman,DEM,580004,2,7,65,74,
Ottawa,Commissioner of Labor,Mark Costello,REP,580004,1,12,92,105,
Ottawa,U.S. Senate,Matt Silverstein,DEM,580004,2,7,45,54,
Ottawa,U.S. Senate,Jim Inhofe,REP,580004,0,12,108,120,
Ottawa,U.S. Senate,Aaron Delozier,IND,580004,1,1,3,5,
Ottawa,U.S. Senate,Ray Woods,IND,580004,0,0,2,2,
Ottawa,U.S. Senate,Joan Farr,IND,580004,0,1,3,4,
Ottawa,U.S. Senate,Connie Johnson,DEM,580004,2,8,53,63,
Ottawa,U.S. Senate,James Lankford,REP,580004,0,11,101,112,
Ottawa,U.S. Senate,Mark Beard,IND,580004,1,1,4,6,
Ottawa,U.S. House,Earl Everett,DEM,580004,2,5,34,41,02
Ottawa,U.S. House,Markwayne Mullin,REP,580004,0,10,100,110,02
Ottawa,U.S. House,Jon Douthitt,IND,580004,1,5,27,33,02
Ottawa,Governor,Joe Dorman,DEM,580005,0,4,76,80,
Ottawa,Governor,Mary Fallin,REP,580005,5,7,83,95,
Ottawa,Governor,Kimberly Willis,IND,580005,2,0,6,8,
Ottawa,Governor,Richard Prawdzienski,IND,580005,0,0,3,3,
Ottawa,Lieutenant Governor,Cathy Cummings,DEM,580005,1,3,69,73,
Ottawa,Lieutenant Governor,Todd Lamb,REP,580005,6,8,99,113,
Ottawa,Superintendent of Public Instruction,John Cox,DEM,580005,1,3,78,82,
Ottawa,Superintendent of Public Instruction,Joy Hofmeister,REP,580005,6,8,86,100,
Ottawa,Commissioner of Labor,Mike Workman,DEM,580005,1,4,75,80,
Ottawa,Commissioner of Labor,Mark Costello,REP,580005,6,7,90,103,
Ottawa,U.S. Senate,Matt Silverstein,DEM,580005,0,4,63,67,
Ottawa,U.S. Senate,Jim Inhofe,REP,580005,7,7,95,109,
Ottawa,U.S. Senate,Aaron Delozier,IND,580005,0,0,5,5,
Ottawa,U.S. Senate,Ray Woods,IND,580005,0,0,0,0,
Ottawa,U.S. Senate,Joan Farr,IND,580005,0,0,4,4,
Ottawa,U.S. Senate,Connie Johnson,DEM,580005,1,4,65,70,
Ottawa,U.S. Senate,James Lankford,REP,580005,6,7,94,107,
Ottawa,U.S. Senate,Mark Beard,IND,580005,0,0,7,7,
Ottawa,U.S. House,Earl Everett,DEM,580005,1,3,50,54,02
Ottawa,U.S. House,Markwayne Mullin,REP,580005,6,7,91,104,02
Ottawa,U.S. House,Jon Douthitt,IND,580005,0,1,24,25,02
Ottawa,Governor,Joe Dorman,DEM,580007,2,10,186,198,
Ottawa,Governor,Mary Fallin,REP,580007,4,14,284,302,
Ottawa,Governor,Kimberly Willis,IND,580007,0,1,11,12,
Ottawa,Governor,Richard Prawdzienski,IND,580007,0,0,3,3,
Ottawa,Lieutenant Governor,Cathy Cummings,DEM,580007,2,9,151,162,
Ottawa,Lieutenant Governor,Todd Lamb,REP,580007,4,16,329,349,
Ottawa,Superintendent of Public Instruction,John Cox,DEM,580007,2,9,214,225,
Ottawa,Superintendent of Public Instruction,Joy Hofmeister,REP,580007,4,16,268,288,
Ottawa,Commissioner of Labor,Mike Workman,DEM,580007,2,11,166,179,
Ottawa,Commissioner of Labor,Mark Costello,REP,580007,4,14,312,330,
Ottawa,U.S. Senate,Matt Silverstein,DEM,580007,2,11,123,136,
Ottawa,U.S. Senate,Jim Inhofe,REP,580007,4,15,340,359,
Ottawa,U.S. Senate,Aaron Delozier,IND,580007,0,0,11,11,
Ottawa,U.S. Senate,Ray Woods,IND,580007,0,0,6,6,
Ottawa,U.S. Senate,Joan Farr,IND,580007,0,0,5,5,
Ottawa,U.S. Senate,Connie Johnson,DEM,580007,2,11,131,144,
Ottawa,U.S. Senate,James Lankford,REP,580007,4,13,327,344,
Ottawa,U.S. Senate,Mark Beard,IND,580007,0,1,25,26,
Ottawa,U.S. House,Earl Everett,DEM,580007,2,6,98,106,02
Ottawa,U.S. House,Markwayne Mullin,REP,580007,4,17,322,343,02
Ottawa,U.S. House,Jon Douthitt,IND,580007,0,3,63,66,02
Ottawa,Governor,Joe Dorman,DEM,580008,1,2,46,49,
Ottawa,Governor,Mary Fallin,REP,580008,2,5,66,73,
Ottawa,Governor,Kimberly Willis,IND,580008,0,0,5,5,
Ottawa,Governor,Richard Prawdzienski,IND,580008,0,0,0,0,
Ottawa,Lieutenant Governor,Cathy Cummings,DEM,580008,1,1,44,46,
Ottawa,Lieutenant Governor,Todd Lamb,REP,580008,2,6,70,78,
Ottawa,Superintendent of Public Instruction,John Cox,DEM,580008,2,2,48,52,
Ottawa,Superintendent of Public Instruction,Joy Hofmeister,REP,580008,1,5,68,74,
Ottawa,Commissioner of Labor,Mike Workman,DEM,580008,1,2,47,50,
Ottawa,Commissioner of Labor,Mark Costello,REP,580008,2,5,65,72,
Ottawa,U.S. Senate,Matt Silverstein,DEM,580008,1,0,39,40,
Ottawa,U.S. Senate,Jim Inhofe,REP,580008,2,7,73,82,
Ottawa,U.S. Senate,Aaron Delozier,IND,580008,0,0,0,0,
Ottawa,U.S. Senate,Ray Woods,IND,580008,0,0,1,1,
Ottawa,U.S. Senate,Joan Farr,IND,580008,0,0,3,3,
Ottawa,U.S. Senate,Connie Johnson,DEM,580008,1,0,39,40,
Ottawa,U.S. Senate,James Lankford,REP,580008,2,5,67,74,
Ottawa,U.S. Senate,Mark Beard,IND,580008,0,2,7,9,
Ottawa,U.S. House,Earl Everett,DEM,580008,1,0,34,35,02
Ottawa,U.S. House,Markwayne Mullin,REP,580008,2,6,65,73,02
Ottawa,U.S. House,Jon Douthitt,IND,580008,0,1,17,18,02
Ottawa,Governor,Joe Dorman,DEM,580009,1,4,69,74,
Ottawa,Governor,Mary Fallin,REP,580009,1,7,96,104,
Ottawa,Governor,Kimberly Willis,IND,580009,0,0,1,1,
Ottawa,Governor,Richard Prawdzienski,IND,580009,0,0,3,3,
Ottawa,Lieutenant Governor,Cathy Cummings,DEM,580009,2,7,64,73,
Ottawa,Lieutenant Governor,Todd Lamb,REP,580009,0,4,104,108,
Ottawa,Superintendent of Public Instruction,John Cox,DEM,580009,1,4,85,90,
Ottawa,Superintendent of Public Instruction,Joy Hofmeister,REP,580009,1,7,84,92,
Ottawa,Commissioner of Labor,Mike Workman,DEM,580009,2,6,75,83,
Ottawa,Commissioner of Labor,Mark Costello,REP,580009,0,5,91,96,
Ottawa,U.S. Senate,Matt Silverstein,DEM,580009,1,4,56,61,
Ottawa,U.S. Senate,Jim Inhofe,REP,580009,0,5,107,112,
Ottawa,U.S. Senate,Aaron Delozier,IND,580009,0,0,0,0,
Ottawa,U.S. Senate,Ray Woods,IND,580009,0,1,1,2,
Ottawa,U.S. Senate,Joan Farr,IND,580009,1,1,3,5,
Ottawa,U.S. Senate,Connie Johnson,DEM,580009,1,5,60,66,
Ottawa,U.S. Senate,James Lankford,REP,580009,0,5,102,107,
Ottawa,U.S. Senate,Mark Beard,IND,580009,1,1,5,7,
Ottawa,U.S. House,Earl Everett,DEM,580009,1,2,52,55,02
Ottawa,U.S. House,Markwayne Mullin,REP,580009,1,6,98,105,02
Ottawa,U.S. House,Jon Douthitt,IND,580009,0,3,16,19,02
Ottawa,Governor,Joe Dorman,DEM,580011,3,11,104,118,
Ottawa,Governor,Mary Fallin,REP,580011,7,10,124,141,
Ottawa,Governor,Kimberly Willis,IND,580011,0,2,5,7,
Ottawa,Governor,Richard Prawdzienski,IND,580011,0,0,8,8,
Ottawa,Lieutenant Governor,Cathy Cummings,DEM,580011,4,7,99,110,
Ottawa,Lieutenant Governor,Todd Lamb,REP,580011,6,15,138,159,
Ottawa,Superintendent of Public Instruction,John Cox,DEM,580011,5,13,125,143,
Ottawa,Superintendent of Public Instruction,Joy Hofmeister,REP,580011,5,9,112,126,
Ottawa,Commissioner of Labor,Mike Workman,DEM,580011,4,6,114,124,
Ottawa,Commissioner of Labor,Mark Costello,REP,580011,5,15,120,140,
Ottawa,U.S. Senate,Matt Silverstein,DEM,580011,4,7,84,95,
Ottawa,U.S. Senate,Jim Inhofe,REP,580011,6,14,146,166,
Ottawa,U.S. Senate,Aaron Delozier,IND,580011,0,0,3,3,
Ottawa,U.S. Senate,Ray Woods,IND,580011,0,0,3,3,
Ottawa,U.S. Senate,Joan Farr,IND,580011,0,2,6,8,
Ottawa,U.S. Senate,Connie Johnson,DEM,580011,3,3,87,93,
Ottawa,U.S. Senate,James Lankford,REP,580011,6,17,140,163,
Ottawa,U.S. Senate,Mark Beard,IND,580011,1,2,12,15,
Ottawa,U.S. House,Earl Everett,DEM,580011,2,3,76,81,02
Ottawa,U.S. House,Markwayne Mullin,REP,580011,7,15,126,148,02
Ottawa,U.S. House,Jon Douthitt,IND,580011,1,5,39,45,02
Ottawa,Governor,Joe Dorman,DEM,580012,1,7,83,91,
Ottawa,Governor,Mary Fallin,REP,580012,5,5,96,106,
Ottawa,Governor,Kimberly Willis,IND,580012,0,0,7,7,
Ottawa,Governor,Richard Prawdzienski,IND,580012,0,0,1,1,
Ottawa,Lieutenant Governor,Cathy Cummings,DEM,580012,1,6,71,78,
Ottawa,Lieutenant Governor,Todd Lamb,REP,580012,4,6,116,126,
Ottawa,Superintendent of Public Instruction,John Cox,DEM,580012,1,8,92,101,
Ottawa,Superintendent of Public Instruction,Joy Hofmeister,REP,580012,5,4,94,103,
Ottawa,Commissioner of Labor,Mike Workman,DEM,580012,1,5,89,95,
Ottawa,Commissioner of Labor,Mark Costello,REP,580012,5,7,96,108,
Ottawa,U.S. Senate,Matt Silverstein,DEM,580012,1,6,61,68,
Ottawa,U.S. Senate,Jim Inhofe,REP,580012,5,6,116,127,
Ottawa,U.S. Senate,Aaron Delozier,IND,580012,0,0,4,4,
Ottawa,U.S. Senate,Ray Woods,IND,580012,0,0,4,4,
Ottawa,U.S. Senate,Joan Farr,IND,580012,0,0,2,2,
Ottawa,U.S. Senate,Connie Johnson,DEM,580012,1,5,56,62,
Ottawa,U.S. Senate,James Lankford,REP,580012,5,7,115,127,
Ottawa,U.S. Senate,Mark Beard,IND,580012,0,0,14,14,
Ottawa,U.S. House,Earl Everett,DEM,580012,0,5,44,49,02
Ottawa,U.S. House,Markwayne Mullin,REP,580012,5,7,110,122,02
Ottawa,U.S. House,Jon Douthitt,IND,580012,1,0,32,33,02
Ottawa,Governor,Joe Dorman,DEM,580014,2,4,192,198,
Ottawa,Governor,Mary Fallin,REP,580014,0,1,200,201,
Ottawa,Governor,Kimberly Willis,IND,580014,0,0,15,15,
Ottawa,Governor,Richard Prawdzienski,IND,580014,0,0,6,6,
Ottawa,Lieutenant Governor,Cathy Cummings,DEM,580014,2,4,171,177,
Ottawa,Lieutenant Governor,Todd Lamb,REP,580014,0,1,241,242,
Ottawa,Superintendent of Public Instruction,John Cox,DEM,580014,2,4,225,231,
Ottawa,Superintendent of Public Instruction,Joy Hofmeister,REP,580014,0,1,188,189,
Ottawa,Commissioner of Labor,Mike Workman,DEM,580014,2,4,177,183,
Ottawa,Commissioner of Labor,Mark Costello,REP,580014,0,1,231,232,
Ottawa,U.S. Senate,Matt Silverstein,DEM,580014,2,4,140,146,
Ottawa,U.S. Senate,Jim Inhofe,REP,580014,0,1,248,249,
Ottawa,U.S. Senate,Aaron Delozier,IND,580014,0,0,7,7,
Ottawa,U.S. Senate,Ray Woods,IND,580014,0,0,7,7,
Ottawa,U.S. Senate,Joan Farr,IND,580014,0,0,10,10,
Ottawa,U.S. Senate,Connie Johnson,DEM,580014,2,4,143,149,
Ottawa,U.S. Senate,James Lankford,REP,580014,0,1,244,245,
Ottawa,U.S. Senate,Mark Beard,IND,580014,0,0,25,25,
Ottawa,U.S. House,Earl Everett,DEM,580014,2,4,117,123,02
Ottawa,U.S. House,Markwayne Mullin,REP,580014,0,1,240,241,02
Ottawa,U.S. House,Jon Douthitt,IND,580014,0,0,54,54,02
Ottawa,Governor,Joe Dorman,DEM,580023,0,1,164,165,
Ottawa,Governor,Mary Fallin,REP,580023,0,4,100,104,
Ottawa,Governor,Kimberly Willis,IND,580023,0,0,5,5,
Ottawa,Governor,Richard Prawdzienski,IND,580023,0,0,4,4,
Ottawa,Lieutenant Governor,Cathy Cummings,DEM,580023,0,0,151,151,
Ottawa,Lieutenant Governor,Todd Lamb,REP,580023,0,5,114,119,
Ottawa,Superintendent of Public Instruction,John Cox,DEM,580023,0,1,174,175,
Ottawa,Superintendent of Public Instruction,Joy Hofmeister,REP,580023,0,4,96,100,
Ottawa,Commissioner of Labor,Mike Workman,DEM,580023,0,1,159,160,
Ottawa,Commissioner of Labor,Mark Costello,REP,580023,0,4,108,112,
Ottawa,U.S. Senate,Matt Silverstein,DEM,580023,0,0,123,123,
Ottawa,U.S. Senate,Jim Inhofe,REP,580023,0,5,131,136,
Ottawa,U.S. Senate,Aaron Delozier,IND,580023,0,0,6,6,
Ottawa,U.S. Senate,Ray Woods,IND,580023,0,0,5,5,
Ottawa,U.S. Senate,Joan Farr,IND,580023,0,0,4,4,
Ottawa,U.S. Senate,Connie Johnson,DEM,580023,0,0,129,129,
Ottawa,U.S. Senate,James Lankford,REP,580023,0,5,120,125,
Ottawa,U.S. Senate,Mark Beard,IND,580023,0,0,18,18,
Ottawa,U.S. House,Earl Everett,DEM,580023,0,0,106,106,02
Ottawa,U.S. House,Markwayne Mullin,REP,580023,0,5,126,131,02
Ottawa,U.S. House,Jon Douthitt,IND,580023,0,0,37,37,02
Ottawa,Governor,Joe Dorman,DEM,580024,0,1,44,45,
Ottawa,Governor,Mary Fallin,REP,580024,1,1,89,91,
Ottawa,Governor,Kimberly Willis,IND,580024,0,0,3,3,
Ottawa,Governor,Richard Prawdzienski,IND,580024,0,0,0,0,
Ottawa,Lieutenant Governor,Cathy Cummings,DEM,580024,0,1,44,45,
Ottawa,Lieutenant Governor,Todd Lamb,REP,580024,1,1,91,93,
Ottawa,Superintendent of Public Instruction,John Cox,DEM,580024,0,1,53,54,
Ottawa,Superintendent of Public Instruction,Joy Hofmeister,REP,580024,1,1,83,85,
Ottawa,Commissioner of Labor,Mike Workman,DEM,580024,0,1,48,49,
Ottawa,Commissioner of Labor,Mark Costello,REP,580024,1,1,88,90,
Ottawa,U.S. Senate,Matt Silverstein,DEM,580024,0,1,38,39,
Ottawa,U.S. Senate,Jim Inhofe,REP,580024,1,1,93,95,
Ottawa,U.S. Senate,Aaron Delozier,IND,580024,0,0,0,0,
Ottawa,U.S. Senate,Ray Woods,IND,580024,0,0,3,3,
Ottawa,U.S. Senate,Joan Farr,IND,580024,0,0,2,2,
Ottawa,U.S. Senate,Connie Johnson,DEM,580024,0,1,42,43,
Ottawa,U.S. Senate,James Lankford,REP,580024,1,1,91,93,
Ottawa,U.S. Senate,Mark Beard,IND,580024,0,0,3,3,
Ottawa,U.S. House,Earl Everett,DEM,580024,0,1,35,36,02
Ottawa,U.S. House,Markwayne Mullin,REP,580024,1,1,93,95,02
Ottawa,U.S. House,Jon Douthitt,IND,580024,0,0,8,8,02
Ottawa,Governor,Joe Dorman,DEM,580025,1,1,103,105,
Ottawa,Governor,Mary Fallin,REP,580025,3,1,220,224,
Ottawa,Governor,Kimberly Willis,IND,580025,0,0,7,7,
Ottawa,Governor,Richard Prawdzienski,IND,580025,0,0,3,3,
Ottawa,Lieutenant Governor,Cathy Cummings,DEM,580025,1,1,95,97,
Ottawa,Lieutenant Governor,Todd Lamb,REP,580025,3,1,238,242,
Ottawa,Superintendent of Public Instruction,John Cox,DEM,580025,1,1,129,131,
Ottawa,Superintendent of Public Instruction,Joy Hofmeister,REP,580025,3,1,204,208,
Ottawa,Commissioner of Labor,Mike Workman,DEM,580025,1,1,108,110,
Ottawa,Commissioner of Labor,Mark Costello,REP,580025,3,1,224,228,
Ottawa,U.S. Senate,Matt Silverstein,DEM,580025,1,1,72,74,
Ottawa,U.S. Senate,Jim Inhofe,REP,580025,3,1,245,249,
Ottawa,U.S. Senate,Aaron Delozier,IND,580025,0,0,6,6,
Ottawa,U.S. Senate,Ray Woods,IND,580025,0,0,3,3,
Ottawa,U.S. Senate,Joan Farr,IND,580025,0,0,6,6,
Ottawa,U.S. Senate,Connie Johnson,DEM,580025,1,1,76,78,
Ottawa,U.S. Senate,James Lankford,REP,580025,3,1,239,243,
Ottawa,U.S. Senate,Mark Beard,IND,580025,0,0,17,17,
Ottawa,U.S. House,Earl Everett,DEM,580025,1,1,58,60,02
Ottawa,U.S. House,Markwayne Mullin,REP,580025,3,1,235,239,02
Ottawa,U.S. House,Jon Douthitt,IND,580025,0,0,40,40,02
Ottawa,Governor,Joe Dorman,DEM,580026,2,0,99,101,
Ottawa,Governor,Mary Fallin,REP,580026,11,2,232,245,
Ottawa,Governor,Kimberly Willis,IND,580026,0,0,14,14,
Ottawa,Governor,Richard Prawdzienski,IND,580026,0,0,6,6,
Ottawa,Lieutenant Governor,Cathy Cummings,DEM,580026,2,0,94,96,
Ottawa,Lieutenant Governor,Todd Lamb,REP,580026,11,2,253,266,
Ottawa,Superintendent of Public Instruction,John Cox,DEM,580026,2,0,131,133,
Ottawa,Superintendent of Public Instruction,Joy Hofmeister,REP,580026,11,2,217,230,
Ottawa,Commissioner of Labor,Mike Workman,DEM,580026,2,0,96,98,
Ottawa,Commissioner of Labor,Mark Costello,REP,580026,11,2,249,262,
Ottawa,U.S. Senate,Matt Silverstein,DEM,580026,2,0,76,78,
Ottawa,U.S. Senate,Jim Inhofe,REP,580026,11,2,256,269,
Ottawa,U.S. Senate,Aaron Delozier,IND,580026,0,0,4,4,
Ottawa,U.S. Senate,Ray Woods,IND,580026,0,0,5,5,
Ottawa,U.S. Senate,Joan Farr,IND,580026,0,0,9,9,
Ottawa,U.S. Senate,Connie Johnson,DEM,580026,2,0,80,82,
Ottawa,U.S. Senate,James Lankford,REP,580026,11,2,255,268,
Ottawa,U.S. Senate,Mark Beard,IND,580026,0,0,15,15,
Ottawa,U.S. House,Earl Everett,DEM,580026,2,0,76,78,02
Ottawa,U.S. House,Markwayne Mullin,REP,580026,10,2,249,261,02
Ottawa,U.S. House,Jon Douthitt,IND,580026,1,0,23,24,02
Ottawa,Governor,Joe Dorman,DEM,580028,5,4,175,184,
Ottawa,Governor,Mary Fallin,REP,580028,6,14,324,344,
Ottawa,Governor,Kimberly Willis,IND,580028,0,0,13,13,
Ottawa,Governor,Richard Prawdzienski,IND,580028,0,1,9,10,
Ottawa,Lieutenant Governor,Cathy Cummings,DEM,580028,4,4,150,158,
Ottawa,Lieutenant Governor,Todd Lamb,REP,580028,7,15,372,394,
Ottawa,Superintendent of Public Instruction,John Cox,DEM,580028,5,8,239,252,
Ottawa,Superintendent of Public Instruction,Joy Hofmeister,REP,580028,6,11,279,296,
Ottawa,Commissioner of Labor,Mike Workman,DEM,580028,6,5,203,214,
Ottawa,Commissioner of Labor,Mark Costello,REP,580028,5,14,313,332,
Ottawa,U.S. Senate,Matt Silverstein,DEM,580028,4,5,135,144,
Ottawa,U.S. Senate,Jim Inhofe,REP,580028,7,13,354,374,
Ottawa,U.S. Senate,Aaron Delozier,IND,580028,0,0,10,10,
Ottawa,U.S. Senate,Ray Woods,IND,580028,0,0,10,10,
Ottawa,U.S. Senate,Joan Farr,IND,580028,0,1,11,12,
Ottawa,U.S. Senate,Connie Johnson,DEM,580028,4,3,134,141,
Ottawa,U.S. Senate,James Lankford,REP,580028,7,15,359,381,
Ottawa,U.S. Senate,Mark Beard,IND,580028,0,1,28,29,
Ottawa,U.S. House,Earl Everett,DEM,580028,3,2,109,114,02
Ottawa,U.S. House,Markwayne Mullin,REP,580028,8,15,365,388,02
Ottawa,U.S. House,Jon Douthitt,IND,580028,0,2,47,49,02
Ottawa,Governor,Joe Dorman,DEM,580031,1,15,168,184,
Ottawa,Governor,Mary Fallin,REP,580031,2,11,266,279,
Ottawa,Governor,Kimberly Willis,IND,580031,0,0,13,13,
Ottawa,Governor,Richard Prawdzienski,IND,580031,0,0,6,6,
Ottawa,Lieutenant Governor,Cathy Cummings,DEM,580031,0,11,151,162,
Ottawa,Lieutenant Governor,Todd Lamb,REP,580031,3,15,300,318,
Ottawa,Superintendent of Public Instruction,John Cox,DEM,580031,0,16,210,226,
Ottawa,Superintendent of Public Instruction,Joy Hofmeister,REP,580031,3,9,242,254,
Ottawa,Commissioner of Labor,Mike Workman,DEM,580031,1,14,174,189,
Ottawa,Commissioner of Labor,Mark Costello,REP,580031,2,12,269,283,
Ottawa,U.S. Senate,Matt Silverstein,DEM,580031,0,10,124,134,
Ottawa,U.S. Senate,Jim Inhofe,REP,580031,3,16,307,326,
Ottawa,U.S. Senate,Aaron Delozier,IND,580031,0,0,10,10,
Ottawa,U.S. Senate,Ray Woods,IND,580031,0,0,4,4,
Ottawa,U.S. Senate,Joan Farr,IND,580031,0,0,4,4,
Ottawa,U.S. Senate,Connie Johnson,DEM,580031,0,13,132,145,
Ottawa,U.S. Senate,James Lankford,REP,580031,3,13,298,314,
Ottawa,U.S. Senate,Mark Beard,IND,580031,0,0,20,20,
Ottawa,U.S. House,Earl Everett,DEM,580031,0,11,106,117,02
Ottawa,U.S. House,Markwayne Mullin,REP,580031,3,15,293,311,02
Ottawa,U.S. House,Jon Douthitt,IND,580031,0,0,55,55,02
Ottawa,Governor,Joe Dorman,DEM,580034,1,5,116,122,
Ottawa,Governor,Mary Fallin,REP,580034,3,7,156,166,
Ottawa,Governor,Kimberly Willis,IND,580034,0,1,8,9,
Ottawa,Governor,Richard Prawdzienski,IND,580034,0,0,2,2,
Ottawa,Lieutenant Governor,Cathy Cummings,DEM,580034,0,3,96,99,
Ottawa,Lieutenant Governor,Todd Lamb,REP,580034,4,10,184,198,
Ottawa,Superintendent of Public Instruction,John Cox,DEM,580034,1,6,146,153,
Ottawa,Superintendent of Public Instruction,Joy Hofmeister,REP,580034,3,7,133,143,
Ottawa,Commissioner of Labor,Mike Workman,DEM,580034,0,3,116,119,
Ottawa,Commissioner of Labor,Mark Costello,REP,580034,4,10,162,176,
Ottawa,U.S. Senate,Matt Silverstein,DEM,580034,0,3,79,82,
Ottawa,U.S. Senate,Jim Inhofe,REP,580034,4,9,183,196,
Ottawa,U.S. Senate,Aaron Delozier,IND,580034,0,0,4,4,
Ottawa,U.S. Senate,Ray Woods,IND,580034,0,1,8,9,
Ottawa,U.S. Senate,Joan Farr,IND,580034,0,0,7,7,
Ottawa,U.S. Senate,Connie Johnson,DEM,580034,0,4,79,83,
Ottawa,U.S. Senate,James Lankford,REP,580034,4,8,185,197,
Ottawa,U.S. Senate,Mark Beard,IND,580034,0,1,18,19,
Ottawa,U.S. House,Earl Everett,DEM,580034,0,1,63,64,02
Ottawa,U.S. House,Markwayne Mullin,REP,580034,4,11,192,207,02
Ottawa,U.S. House,Jon Douthitt,IND,580034,0,1,28,29,02
Pawnee,Governor,Joe Dorman,DEM,590104,2,22,130,154,
Pawnee,Governor,Mary Fallin,REP,590104,3,20,239,262,
Pawnee,Governor,Kimberly Willis,IND,590104,1,0,9,10,
Pawnee,Governor,Richard Prawdzienski,IND,590104,0,0,2,2,
Pawnee,Lieutenant Governor,Cathy Cummings,DEM,590104,3,14,96,113,
Pawnee,Lieutenant Governor,Todd Lamb,REP,590104,3,27,282,312,
Pawnee,Superintendent of Public Instruction,John Cox,DEM,590104,3,24,169,196,
Pawnee,Superintendent of Public Instruction,Joy Hofmeister,REP,590104,3,18,210,231,
Pawnee,Commissioner of Labor,Mike Workman,DEM,590104,3,25,148,176,
Pawnee,Commissioner of Labor,Mark Costello,REP,590104,3,16,225,244,
Pawnee,U.S. Senate,Matt Silverstein,DEM,590104,3,14,89,106,
Pawnee,U.S. Senate,Jim Inhofe,REP,590104,3,27,284,314,
Pawnee,U.S. Senate,Aaron Delozier,IND,590104,0,0,3,3,
Pawnee,U.S. Senate,Ray Woods,IND,590104,0,0,2,2,
Pawnee,U.S. Senate,Joan Farr,IND,590104,0,0,2,2,
Pawnee,U.S. Senate,Connie Johnson,DEM,590104,3,14,90,107,
Pawnee,U.S. Senate,James Lankford,REP,590104,3,27,278,308,
Pawnee,U.S. Senate,Mark Beard,IND,590104,0,0,10,10,
Pawnee,U.S. House,Frankie Robbins,DEM,590104,3,13,90,106,03
Pawnee,U.S. House,Frank Lucas,REP,590104,3,28,289,320,03
Pawnee,State House,Wannetta Cloyd,DEM,590104,3,7,66,76,35
Pawnee,State House,Dennis Casey,REP,590104,3,35,311,349,35
Pawnee,Governor,Joe Dorman,DEM,590111,0,0,78,78,
Pawnee,Governor,Mary Fallin,REP,590111,0,0,116,116,
Pawnee,Governor,Kimberly Willis,IND,590111,0,0,8,8,
Pawnee,Governor,Richard Prawdzienski,IND,590111,0,0,8,8,
Pawnee,Lieutenant Governor,Cathy Cummings,DEM,590111,0,0,61,61,
Pawnee,Lieutenant Governor,Todd Lamb,REP,590111,0,0,147,147,
Pawnee,Superintendent of Public Instruction,John Cox,DEM,590111,0,0,90,90,
Pawnee,Superintendent of Public Instruction,Joy Hofmeister,REP,590111,0,0,118,118,
Pawnee,Commissioner of Labor,Mike Workman,DEM,590111,0,0,85,85,
Pawnee,Commissioner of Labor,Mark Costello,REP,590111,0,0,117,117,
Pawnee,U.S. Senate,Matt Silverstein,DEM,590111,0,0,62,62,
Pawnee,U.S. Senate,Jim Inhofe,REP,590111,0,0,138,138,
Pawnee,U.S. Senate,Aaron Delozier,IND,590111,0,0,5,5,
Pawnee,U.S. Senate,Ray Woods,IND,590111,0,0,4,4,
Pawnee,U.S. Senate,Joan Farr,IND,590111,0,0,1,1,
Pawnee,U.S. Senate,Connie Johnson,DEM,590111,0,0,67,67,
Pawnee,U.S. Senate,James Lankford,REP,590111,0,0,129,129,
Pawnee,U.S. Senate,Mark Beard,IND,590111,0,0,11,11,
Pawnee,U.S. House,Frankie Robbins,DEM,590111,0,0,59,59,03
Pawnee,U.S. House,Frank Lucas,REP,590111,0,0,148,148,03
Pawnee,State House,Wannetta Cloyd,DEM,590111,0,0,77,77,35
Pawnee,State House,Dennis Casey,REP,590111,0,0,128,128,35
Pawnee,Governor,Joe Dorman,DEM,590112,2,1,54,57,
Pawnee,Governor,Mary Fallin,REP,590112,1,0,89,90,
Pawnee,Governor,Kimberly Willis,IND,590112,0,1,4,5,
Pawnee,Governor,Richard Prawdzienski,IND,590112,0,0,1,1,
Pawnee,Lieutenant Governor,Cathy Cummings,DEM,590112,2,1,44,47,
Pawnee,Lieutenant Governor,Todd Lamb,REP,590112,1,1,102,104,
Pawnee,Superintendent of Public Instruction,John Cox,DEM,590112,2,1,70,73,
Pawnee,Superintendent of Public Instruction,Joy Hofmeister,REP,590112,1,1,75,77,
Pawnee,Commissioner of Labor,Mike Workman,DEM,590112,2,1,67,70,
Pawnee,Commissioner of Labor,Mark Costello,REP,590112,0,1,74,75,
Pawnee,U.S. Senate,Matt Silverstein,DEM,590112,1,1,40,42,
Pawnee,U.S. Senate,Jim Inhofe,REP,590112,1,1,103,105,
Pawnee,U.S. Senate,Aaron Delozier,IND,590112,0,0,1,1,
Pawnee,U.S. Senate,Ray Woods,IND,590112,1,0,1,2,
Pawnee,U.S. Senate,Joan Farr,IND,590112,0,0,2,2,
Pawnee,U.S. Senate,Connie Johnson,DEM,590112,1,1,42,44,
Pawnee,U.S. Senate,James Lankford,REP,590112,0,0,99,99,
Pawnee,U.S. Senate,Mark Beard,IND,590112,1,1,3,5,
Pawnee,U.S. House,Frankie Robbins,DEM,590112,2,1,46,49,03
Pawnee,U.S. House,Frank Lucas,REP,590112,1,1,102,104,03
Pawnee,State House,Wannetta Cloyd,DEM,590112,0,1,35,36,35
Pawnee,State House,Dennis Casey,REP,590112,3,1,110,114,35
Pawnee,Governor,Joe Dorman,DEM,590118,2,3,180,185,
Pawnee,Governor,Mary Fallin,REP,590118,11,10,302,323,
Pawnee,Governor,Kimberly Willis,IND,590118,0,2,10,12,
Pawnee,Governor,Richard Prawdzienski,IND,590118,0,0,6,6,
Pawnee,Lieutenant Governor,Cathy Cummings,DEM,590118,2,2,123,127,
Pawnee,Lieutenant Governor,Todd Lamb,REP,590118,12,13,373,398,
Pawnee,Superintendent of Public Instruction,John Cox,DEM,590118,4,5,220,229,
Pawnee,Superintendent of Public Instruction,Joy Hofmeister,REP,590118,10,10,275,295,
Pawnee,Commissioner of Labor,Mike Workman,DEM,590118,2,5,166,173,
Pawnee,Commissioner of Labor,Mark Costello,REP,590118,12,10,323,345,
Pawnee,U.S. Senate,Matt Silverstein,DEM,590118,1,2,136,139,
Pawnee,U.S. Senate,Jim Inhofe,REP,590118,11,12,346,369,
Pawnee,U.S. Senate,Aaron Delozier,IND,590118,1,0,4,5,
Pawnee,U.S. Senate,Ray Woods,IND,590118,1,1,1,3,
Pawnee,U.S. Senate,Joan Farr,IND,590118,0,0,7,7,
Pawnee,U.S. Senate,Connie Johnson,DEM,590118,1,0,123,124,
Pawnee,U.S. Senate,James Lankford,REP,590118,10,12,365,387,
Pawnee,U.S. Senate,Mark Beard,IND,590118,3,3,10,16,
Pawnee,U.S. House,Frankie Robbins,DEM,590118,2,2,124,128,03
Pawnee,U.S. House,Frank Lucas,REP,590118,12,13,370,395,03
Pawnee,State House,Wannetta Cloyd,DEM,590118,2,1,127,130,35
Pawnee,State House,Dennis Casey,REP,590118,11,14,366,391,35
Pawnee,Governor,Joe Dorman,DEM,590202,9,22,287,318,
Pawnee,Governor,Mary Fallin,REP,590202,5,36,336,377,
Pawnee,Governor,Kimberly Willis,IND,590202,0,5,10,15,
Pawnee,Governor,Richard Prawdzienski,IND,590202,0,1,10,11,
Pawnee,Lieutenant Governor,Cathy Cummings,DEM,590202,6,20,206,232,
Pawnee,Lieutenant Governor,Todd Lamb,REP,590202,8,45,435,488,
Pawnee,Superintendent of Public Instruction,John Cox,DEM,590202,6,36,311,353,
Pawnee,Superintendent of Public Instruction,Joy Hofmeister,REP,590202,7,29,330,366,
Pawnee,Commissioner of Labor,Mike Workman,DEM,590202,4,26,292,322,
Pawnee,Commissioner of Labor,Mark Costello,REP,590202,9,35,339,383,
Pawnee,U.S. Senate,Matt Silverstein,DEM,590202,7,14,187,208,
Pawnee,U.S. Senate,Jim Inhofe,REP,590202,7,46,422,475,
Pawnee,U.S. Senate,Aaron Delozier,IND,590202,0,0,14,14,
Pawnee,U.S. Senate,Ray Woods,IND,590202,0,0,6,6,
Pawnee,U.S. Senate,Joan Farr,IND,590202,0,3,8,11,
Pawnee,U.S. Senate,Connie Johnson,DEM,590202,4,17,204,225,
Pawnee,U.S. Senate,James Lankford,REP,590202,9,43,412,464,
Pawnee,U.S. Senate,Mark Beard,IND,590202,1,3,25,29,
Pawnee,U.S. House,Frankie Robbins,DEM,590202,4,10,188,202,03
Pawnee,U.S. House,Frank Lucas,REP,590202,10,54,456,520,03
Pawnee,State House,Wannetta Cloyd,DEM,590202,0,7,166,173,35
Pawnee,State House,Dennis Casey,REP,590202,13,57,476,546,35
Pawnee,Governor,Joe Dorman,DEM,590215,0,0,42,42,
Pawnee,Governor,Mary Fallin,REP,590215,0,1,36,37,
Pawnee,Governor,Kimberly Willis,IND,590215,0,0,3,3,
Pawnee,Governor,Richard Prawdzienski,IND,590215,0,0,1,1,
Pawnee,Lieutenant Governor,Cathy Cummings,DEM,590215,0,0,38,38,
Pawnee,Lieutenant Governor,Todd Lamb,REP,590215,0,1,44,45,
Pawnee,Superintendent of Public Instruction,John Cox,DEM,590215,0,0,49,49,
Pawnee,Superintendent of Public Instruction,Joy Hofmeister,REP,590215,0,1,33,34,
Pawnee,Commissioner of Labor,Mike Workman,DEM,590215,0,0,45,45,
Pawnee,Commissioner of Labor,Mark Costello,REP,590215,0,1,34,35,
Pawnee,U.S. Senate,Matt Silverstein,DEM,590215,0,0,31,31,
Pawnee,U.S. Senate,Jim Inhofe,REP,590215,0,1,48,49,
Pawnee,U.S. Senate,Aaron Delozier,IND,590215,0,0,0,0,
Pawnee,U.S. Senate,Ray Woods,IND,590215,0,0,1,1,
Pawnee,U.S. Senate,Joan Farr,IND,590215,0,0,1,1,
Pawnee,U.S. Senate,Connie Johnson,DEM,590215,0,0,33,33,
Pawnee,U.S. Senate,James Lankford,REP,590215,0,1,43,44,
Pawnee,U.S. Senate,Mark Beard,IND,590215,0,0,6,6,
Pawnee,U.S. House,Frankie Robbins,DEM,590215,0,0,34,34,03
Pawnee,U.S. House,Frank Lucas,REP,590215,0,1,48,49,03
Pawnee,State House,Wannetta Cloyd,DEM,590215,0,0,39,39,35
Pawnee,State House,Dennis Casey,REP,590215,0,1,43,44,35
Pawnee,Governor,Joe Dorman,DEM,590217,3,3,162,168,
Pawnee,Governor,Mary Fallin,REP,590217,2,4,212,218,
Pawnee,Governor,Kimberly Willis,IND,590217,0,1,7,8,
Pawnee,Governor,Richard Prawdzienski,IND,590217,0,0,7,7,
Pawnee,Lieutenant Governor,Cathy Cummings,DEM,590217,3,0,101,104,
Pawnee,Lieutenant Governor,Todd Lamb,REP,590217,2,8,287,297,
Pawnee,Superintendent of Public Instruction,John Cox,DEM,590217,2,3,168,173,
Pawnee,Superintendent of Public Instruction,Joy Hofmeister,REP,590217,3,5,218,226,
Pawnee,Commissioner of Labor,Mike Workman,DEM,590217,3,2,141,146,
Pawnee,Commissioner of Labor,Mark Costello,REP,590217,2,6,241,249,
Pawnee,U.S. Senate,Matt Silverstein,DEM,590217,3,2,80,85,
Pawnee,U.S. Senate,Jim Inhofe,REP,590217,2,6,296,304,
Pawnee,U.S. Senate,Aaron Delozier,IND,590217,0,0,3,3,
Pawnee,U.S. Senate,Ray Woods,IND,590217,0,0,7,7,
Pawnee,U.S. Senate,Joan Farr,IND,590217,0,0,2,2,
Pawnee,U.S. Senate,Connie Johnson,DEM,590217,2,0,83,85,
Pawnee,U.S. Senate,James Lankford,REP,590217,3,8,287,298,
Pawnee,U.S. Senate,Mark Beard,IND,590217,0,0,15,15,
Pawnee,U.S. House,Frankie Robbins,DEM,590217,3,1,88,92,03
Pawnee,U.S. House,Frank Lucas,REP,590217,2,7,297,306,03
Pawnee,State House,Wannetta Cloyd,DEM,590217,3,0,96,99,35
Pawnee,State House,Dennis Casey,REP,590217,2,8,288,298,35
Pawnee,Governor,Joe Dorman,DEM,590307,3,1,190,194,
Pawnee,Governor,Mary Fallin,REP,590307,13,8,382,403,
Pawnee,Governor,Kimberly Willis,IND,590307,1,0,9,10,
Pawnee,Governor,Richard Prawdzienski,IND,590307,1,0,6,7,
Pawnee,Lieutenant Governor,Cathy Cummings,DEM,590307,3,1,134,138,
Pawnee,Lieutenant Governor,Todd Lamb,REP,590307,15,8,454,477,
Pawnee,Superintendent of Public Instruction,John Cox,DEM,590307,2,3,210,215,
Pawnee,Superintendent of Public Instruction,Joy Hofmeister,REP,590307,15,6,378,399,
Pawnee,Commissioner of Labor,Mike Workman,DEM,590307,3,1,169,173,
Pawnee,Commissioner of Labor,Mark Costello,REP,590307,14,8,407,429,
Pawnee,U.S. Senate,Matt Silverstein,DEM,590307,3,1,142,146,
Pawnee,U.S. Senate,Jim Inhofe,REP,590307,13,8,428,449,
Pawnee,U.S. Senate,Aaron Delozier,IND,590307,0,0,4,4,
Pawnee,U.S. Senate,Ray Woods,IND,590307,1,0,6,7,
Pawnee,U.S. Senate,Joan Farr,IND,590307,1,0,9,10,
Pawnee,U.S. Senate,Connie Johnson,DEM,590307,2,1,130,133,
Pawnee,U.S. Senate,James Lankford,REP,590307,15,8,445,468,
Pawnee,U.S. Senate,Mark Beard,IND,590307,1,0,17,18,
Pawnee,U.S. House,Frankie Robbins,DEM,590307,3,1,136,140,03
Pawnee,U.S. House,Frank Lucas,REP,590307,15,8,452,475,03
Pawnee,State House,Wannetta Cloyd,DEM,590307,3,1,134,138,35
Pawnee,State House,Dennis Casey,REP,590307,15,8,448,471,35
Pawnee,Governor,Joe Dorman,DEM,590309,0,0,34,34,
Pawnee,Governor,Mary Fallin,REP,590309,3,2,102,107,
Pawnee,Governor,Kimberly Willis,IND,590309,0,0,2,2,
Pawnee,Governor,Richard Prawdzienski,IND,590309,0,0,2,2,
Pawnee,Lieutenant Governor,Cathy Cummings,DEM,590309,0,0,29,29,
Pawnee,Lieutenant Governor,Todd Lamb,REP,590309,3,2,111,116,
Pawnee,Superintendent of Public Instruction,John Cox,DEM,590309,0,0,40,40,
Pawnee,Superintendent of Public Instruction,Joy Hofmeister,REP,590309,3,2,100,105,
Pawnee,Commissioner of Labor,Mike Workman,DEM,590309,1,0,38,39,
Pawnee,Commissioner of Labor,Mark Costello,REP,590309,2,2,100,104,
Pawnee,U.S. Senate,Matt Silverstein,DEM,590309,0,0,27,27,
Pawnee,U.S. Senate,Jim Inhofe,REP,590309,2,2,109,113,
Pawnee,U.S. Senate,Aaron Delozier,IND,590309,0,0,0,0,
Pawnee,U.S. Senate,Ray Woods,IND,590309,1,0,1,2,
Pawnee,U.S. Senate,Joan Farr,IND,590309,0,0,3,3,
Pawnee,U.S. Senate,Connie Johnson,DEM,590309,0,0,27,27,
Pawnee,U.S. Senate,James Lankford,REP,590309,2,2,106,110,
Pawnee,U.S. Senate,Mark Beard,IND,590309,1,0,7,8,
Pawnee,U.S. House,Frankie Robbins,DEM,590309,1,0,29,30,03
Pawnee,U.S. House,Frank Lucas,REP,590309,2,2,110,114,03
Pawnee,State House,Wannetta Cloyd,DEM,590309,1,0,30,31,35
Pawnee,State House,Dennis Casey,REP,590309,2,2,108,112,35
Pawnee,Governor,Joe Dorman,DEM,590314,0,4,112,116,
Pawnee,Governor,Mary Fallin,REP,590314,10,5,243,258,
Pawnee,Governor,Kimberly Willis,IND,590314,0,0,10,10,
Pawnee,Governor,Richard Prawdzienski,IND,590314,0,0,8,8,
Pawnee,Lieutenant Governor,Cathy Cummings,DEM,590314,1,4,98,103,
Pawnee,Lieutenant Governor,Todd Lamb,REP,590314,8,5,273,286,
Pawnee,Superintendent of Public Instruction,John Cox,DEM,590314,3,4,134,141,
Pawnee,Superintendent of Public Instruction,Joy Hofmeister,REP,590314,5,4,238,247,
Pawnee,Commissioner of Labor,Mike Workman,DEM,590314,0,4,119,123,
Pawnee,Commissioner of Labor,Mark Costello,REP,590314,8,4,247,259,
Pawnee,U.S. Senate,Matt Silverstein,DEM,590314,0,4,87,91,
Pawnee,U.S. Senate,Jim Inhofe,REP,590314,9,5,272,286,
Pawnee,U.S. Senate,Aaron Delozier,IND,590314,0,0,5,5,
Pawnee,U.S. Senate,Ray Woods,IND,590314,1,0,6,7,
Pawnee,U.S. Senate,Joan Farr,IND,590314,0,0,4,4,
Pawnee,U.S. Senate,Connie Johnson,DEM,590314,0,4,81,85,
Pawnee,U.S. Senate,James Lankford,REP,590314,8,5,267,280,
Pawnee,U.S. Senate,Mark Beard,IND,590314,0,0,21,21,
Pawnee,U.S. House,Frankie Robbins,DEM,590314,0,3,84,87,03
Pawnee,U.S. House,Frank Lucas,REP,590314,8,6,285,299,03
Pawnee,State House,Wannetta Cloyd,DEM,590314,2,1,115,118,35
Pawnee,State House,Dennis Casey,REP,590314,6,8,255,269,35
Payne,Governor,Joe Dorman,DEM,600001,3,7,109,119,
Payne,Governor,Mary Fallin,REP,600001,0,7,81,88,
Payne,Governor,Kimberly Willis,IND,600001,0,0,3,3,
Payne,Governor,Richard Prawdzienski,IND,600001,2,0,1,3,
Payne,Lieutenant Governor,Cathy Cummings,DEM,600001,5,7,91,103,
Payne,Lieutenant Governor,Todd Lamb,REP,600001,0,7,103,110,
Payne,Superintendent of Public Instruction,John Cox,DEM,600001,5,9,105,119,
Payne,Superintendent of Public Instruction,Joy Hofmeister,REP,600001,0,5,88,93,
Payne,Commissioner of Labor,Mike Workman,DEM,600001,5,6,102,113,
Payne,Commissioner of Labor,Mark Costello,REP,600001,0,8,87,95,
Payne,U.S. Senate,Matt Silverstein,DEM,600001,2,6,76,84,
Payne,U.S. Senate,Jim Inhofe,REP,600001,1,7,101,109,
Payne,U.S. Senate,Aaron Delozier,IND,600001,0,0,6,6,
Payne,U.S. Senate,Ray Woods,IND,600001,0,0,2,2,
Payne,U.S. Senate,Joan Farr,IND,600001,2,1,8,11,
Payne,U.S. Senate,Connie Johnson,DEM,600001,4,6,83,93,
Payne,U.S. Senate,James Lankford,REP,600001,0,7,99,106,
Payne,U.S. Senate,Mark Beard,IND,600001,1,1,11,13,
Payne,U.S. House,Frankie Robbins,DEM,600001,4,7,86,97,03
Payne,U.S. House,Frank Lucas,REP,600001,1,7,106,114,03
Payne,Governor,Joe Dorman,DEM,600002,5,11,239,255,
Payne,Governor,Mary Fallin,REP,600002,9,15,195,219,
Payne,Governor,Kimberly Willis,IND,600002,0,1,6,7,
Payne,Governor,Richard Prawdzienski,IND,600002,0,0,7,7,
Payne,Lieutenant Governor,Cathy Cummings,DEM,600002,4,12,190,206,
Payne,Lieutenant Governor,Todd Lamb,REP,600002,10,15,254,279,
Payne,Superintendent of Public Instruction,John Cox,DEM,600002,6,12,224,242,
Payne,Superintendent of Public Instruction,Joy Hofmeister,REP,600002,8,15,218,241,
Payne,Commissioner of Labor,Mike Workman,DEM,600002,6,12,208,226,
Payne,Commissioner of Labor,Mark Costello,REP,600002,8,15,224,247,
Payne,U.S. Senate,Matt Silverstein,DEM,600002,5,11,162,178,
Payne,U.S. Senate,Jim Inhofe,REP,600002,8,16,255,279,
Payne,U.S. Senate,Aaron Delozier,IND,600002,0,0,9,9,
Payne,U.S. Senate,Ray Woods,IND,600002,0,0,6,6,
Payne,U.S. Senate,Joan Farr,IND,600002,1,0,10,11,
Payne,U.S. Senate,Connie Johnson,DEM,600002,5,10,174,189,
Payne,U.S. Senate,James Lankford,REP,600002,9,16,255,280,
Payne,U.S. Senate,Mark Beard,IND,600002,0,1,16,17,
Payne,U.S. House,Frankie Robbins,DEM,600002,5,11,169,185,03
Payne,U.S. House,Frank Lucas,REP,600002,9,15,272,296,03
Payne,Governor,Joe Dorman,DEM,600003,1,6,114,121,
Payne,Governor,Mary Fallin,REP,600003,4,9,91,104,
Payne,Governor,Kimberly Willis,IND,600003,0,1,13,14,
Payne,Governor,Richard Prawdzienski,IND,600003,0,1,2,3,
Payne,Lieutenant Governor,Cathy Cummings,DEM,600003,0,6,96,102,
Payne,Lieutenant Governor,Todd Lamb,REP,600003,4,11,120,135,
Payne,Superintendent of Public Instruction,John Cox,DEM,600003,0,6,107,113,
Payne,Superintendent of Public Instruction,Joy Hofmeister,REP,600003,5,11,111,127,
Payne,Commissioner of Labor,Mike Workman,DEM,600003,1,10,104,115,
Payne,Commissioner of Labor,Mark Costello,REP,600003,4,7,111,122,
Payne,U.S. Senate,Matt Silverstein,DEM,600003,1,4,86,91,
Payne,U.S. Senate,Jim Inhofe,REP,600003,4,11,122,137,
Payne,U.S. Senate,Aaron Delozier,IND,600003,0,1,4,5,
Payne,U.S. Senate,Ray Woods,IND,600003,0,1,3,4,
Payne,U.S. Senate,Joan Farr,IND,600003,0,0,5,5,
Payne,U.S. Senate,Connie Johnson,DEM,600003,1,7,88,96,
Payne,U.S. Senate,James Lankford,REP,600003,4,8,115,127,
Payne,U.S. Senate,Mark Beard,IND,600003,0,2,15,17,
Payne,U.S. House,Frankie Robbins,DEM,600003,1,7,90,98,03
Payne,U.S. House,Frank Lucas,REP,600003,4,10,128,142,03
Payne,Governor,Joe Dorman,DEM,600004,6,27,344,377,
Payne,Governor,Mary Fallin,REP,600004,2,29,291,322,
Payne,Governor,Kimberly Willis,IND,600004,0,0,8,8,
Payne,Governor,Richard Prawdzienski,IND,600004,0,1,2,3,
Payne,Lieutenant Governor,Cathy Cummings,DEM,600004,3,23,231,257,
Payne,Lieutenant Governor,Todd Lamb,REP,600004,5,34,411,450,
Payne,Superintendent of Public Instruction,John Cox,DEM,600004,7,35,340,382,
Payne,Superintendent of Public Instruction,Joy Hofmeister,REP,600004,1,22,297,320,
Payne,Commissioner of Labor,Mike Workman,DEM,600004,4,26,282,312,
Payne,Commissioner of Labor,Mark Costello,REP,600004,3,29,347,379,
Payne,U.S. Senate,Matt Silverstein,DEM,600004,4,25,236,265,
Payne,U.S. Senate,Jim Inhofe,REP,600004,4,32,377,413,
Payne,U.S. Senate,Aaron Delozier,IND,600004,0,0,11,11,
Payne,U.S. Senate,Ray Woods,IND,600004,0,0,5,5,
Payne,U.S. Senate,Joan Farr,IND,600004,0,0,12,12,
Payne,U.S. Senate,Connie Johnson,DEM,600004,3,24,237,264,
Payne,U.S. Senate,James Lankford,REP,600004,5,33,396,434,
Payne,U.S. Senate,Mark Beard,IND,600004,0,0,11,11,
Payne,U.S. House,Frankie Robbins,DEM,600004,4,22,229,255,03
Payne,U.S. House,Frank Lucas,REP,600004,4,35,412,451,03
Payne,Governor,Joe Dorman,DEM,600005,1,5,64,70,
Payne,Governor,Mary Fallin,REP,600005,0,2,71,73,
Payne,Governor,Kimberly Willis,IND,600005,0,0,2,2,
Payne,Governor,Richard Prawdzienski,IND,600005,0,0,1,1,
Payne,Lieutenant Governor,Cathy Cummings,DEM,600005,0,3,43,46,
Payne,Lieutenant Governor,Todd Lamb,REP,600005,1,4,95,100,
Payne,Superintendent of Public Instruction,John Cox,DEM,600005,1,4,66,71,
Payne,Superintendent of Public Instruction,Joy Hofmeister,REP,600005,0,3,73,76,
Payne,Commissioner of Labor,Mike Workman,DEM,600005,0,5,42,47,
Payne,Commissioner of Labor,Mark Costello,REP,600005,1,2,95,98,
Payne,U.S. Senate,Matt Silverstein,DEM,600005,1,4,34,39,
Payne,U.S. Senate,Jim Inhofe,REP,600005,0,2,98,100,
Payne,U.S. Senate,Aaron Delozier,IND,600005,0,0,3,3,
Payne,U.S. Senate,Ray Woods,IND,600005,0,0,3,3,
Payne,U.S. Senate,Joan Farr,IND,600005,0,1,1,2,
Payne,U.S. Senate,Connie Johnson,DEM,600005,0,2,36,38,
Payne,U.S. Senate,James Lankford,REP,600005,1,4,97,102,
Payne,U.S. Senate,Mark Beard,IND,600005,0,1,5,6,
Payne,U.S. House,Frankie Robbins,DEM,600005,0,4,32,36,03
Payne,U.S. House,Frank Lucas,REP,600005,1,3,105,109,03
Payne,State House,Wannetta Cloyd,DEM,600005,0,4,29,33,35
Payne,State House,Dennis Casey,REP,600005,1,3,107,111,35
Payne,Governor,Joe Dorman,DEM,600006,9,38,378,425,
Payne,Governor,Mary Fallin,REP,600006,2,31,286,319,
Payne,Governor,Kimberly Willis,IND,600006,0,0,13,13,
Payne,Governor,Richard Prawdzienski,IND,600006,0,0,9,9,
Payne,Lieutenant Governor,Cathy Cummings,DEM,600006,9,29,257,295,
Payne,Lieutenant Governor,Todd Lamb,REP,600006,2,40,424,466,
Payne,Superintendent of Public Instruction,John Cox,DEM,600006,8,31,347,386,
Payne,Superintendent of Public Instruction,Joy Hofmeister,REP,600006,3,38,333,374,
Payne,Commissioner of Labor,Mike Workman,DEM,600006,9,35,277,321,
Payne,Commissioner of Labor,Mark Costello,REP,600006,2,34,390,426,
Payne,U.S. Senate,Matt Silverstein,DEM,600006,7,29,251,287,
Payne,U.S. Senate,Jim Inhofe,REP,600006,2,38,407,447,
Payne,U.S. Senate,Aaron Delozier,IND,600006,0,0,7,7,
Payne,U.S. Senate,Ray Woods,IND,600006,2,1,4,7,
Payne,U.S. Senate,Joan Farr,IND,600006,0,1,11,12,
Payne,U.S. Senate,Connie Johnson,DEM,600006,9,28,246,283,
Payne,U.S. Senate,James Lankford,REP,600006,2,40,412,454,
Payne,U.S. Senate,Mark Beard,IND,600006,0,1,28,29,
Payne,U.S. House,Frankie Robbins,DEM,600006,9,26,238,273,03
Payne,U.S. House,Frank Lucas,REP,600006,2,43,444,489,03
Payne,Governor,Joe Dorman,DEM,600007,6,10,125,141,
Payne,Governor,Mary Fallin,REP,600007,2,3,51,56,
Payne,Governor,Kimberly Willis,IND,600007,0,0,4,4,
Payne,Governor,Richard Prawdzienski,IND,600007,0,0,4,4,
Payne,Lieutenant Governor,Cathy Cummings,DEM,600007,4,10,112,126,
Payne,Lieutenant Governor,Todd Lamb,REP,600007,4,3,70,77,
Payne,Superintendent of Public Instruction,John Cox,DEM,600007,5,10,114,129,
Payne,Superintendent of Public Instruction,Joy Hofmeister,REP,600007,3,3,67,73,
Payne,Commissioner of Labor,Mike Workman,DEM,600007,5,9,104,118,
Payne,Commissioner of Labor,Mark Costello,REP,600007,3,4,76,83,
Payne,U.S. Senate,Matt Silverstein,DEM,600007,4,10,97,111,
Payne,U.S. Senate,Jim Inhofe,REP,600007,4,3,73,80,
Payne,U.S. Senate,Aaron Delozier,IND,600007,0,0,3,3,
Payne,U.S. Senate,Ray Woods,IND,600007,0,0,4,4,
Payne,U.S. Senate,Joan Farr,IND,600007,0,0,5,5,
Payne,U.S. Senate,Connie Johnson,DEM,600007,4,10,95,109,
Payne,U.S. Senate,James Lankford,REP,600007,4,3,80,87,
Payne,U.S. Senate,Mark Beard,IND,600007,0,0,8,8,
Payne,U.S. House,Frankie Robbins,DEM,600007,4,8,100,112,03
Payne,U.S. House,Frank Lucas,REP,600007,4,5,82,91,03
Payne,Governor,Joe Dorman,DEM,600008,13,25,211,249,
Payne,Governor,Mary Fallin,REP,600008,3,11,129,143,
Payne,Governor,Kimberly Willis,IND,600008,0,1,14,15,
Payne,Governor,Richard Prawdzienski,IND,600008,2,0,9,11,
Payne,Lieutenant Governor,Cathy Cummings,DEM,600008,13,21,190,224,
Payne,Lieutenant Governor,Todd Lamb,REP,600008,5,16,172,193,
Payne,Superintendent of Public Instruction,John Cox,DEM,600008,13,23,203,239,
Payne,Superintendent of Public Instruction,Joy Hofmeister,REP,600008,4,14,158,176,
Payne,Commissioner of Labor,Mike Workman,DEM,600008,13,22,191,226,
Payne,Commissioner of Labor,Mark Costello,REP,600008,3,14,157,174,
Payne,U.S. Senate,Matt Silverstein,DEM,600008,13,18,175,206,
Payne,U.S. Senate,Jim Inhofe,REP,600008,5,16,163,184,
Payne,U.S. Senate,Aaron Delozier,IND,600008,0,0,7,7,
Payne,U.S. Senate,Ray Woods,IND,600008,0,1,7,8,
Payne,U.S. Senate,Joan Farr,IND,600008,0,0,6,6,
Payne,U.S. Senate,Connie Johnson,DEM,600008,12,20,167,199,
Payne,U.S. Senate,James Lankford,REP,600008,6,16,171,193,
Payne,U.S. Senate,Mark Beard,IND,600008,0,1,18,19,
Payne,U.S. House,Frankie Robbins,DEM,600008,12,18,171,201,03
Payne,U.S. House,Frank Lucas,REP,600008,6,17,183,206,03
Payne,Governor,Joe Dorman,DEM,600009,10,50,363,423,
Payne,Governor,Mary Fallin,REP,600009,18,43,345,406,
Payne,Governor,Kimberly Willis,IND,600009,0,2,5,7,
Payne,Governor,Richard Prawdzienski,IND,600009,0,0,8,8,
Payne,Lieutenant Governor,Cathy Cummings,DEM,600009,6,38,272,316,
Payne,Lieutenant Governor,Todd Lamb,REP,600009,22,56,448,526,
Payne,Superintendent of Public Instruction,John Cox,DEM,600009,8,50,332,390,
Payne,Superintendent of Public Instruction,Joy Hofmeister,REP,600009,20,45,384,449,
Payne,Commissioner of Labor,Mike Workman,DEM,600009,8,37,282,327,
Payne,Commissioner of Labor,Mark Costello,REP,600009,19,51,416,486,
Payne,U.S. Senate,Matt Silverstein,DEM,600009,9,39,260,308,
Payne,U.S. Senate,Jim Inhofe,REP,600009,20,51,437,508,
Payne,U.S. Senate,Aaron Delozier,IND,600009,0,1,7,8,
Payne,U.S. Senate,Ray Woods,IND,600009,0,3,1,4,
Payne,U.S. Senate,Joan Farr,IND,600009,0,0,15,15,
Payne,U.S. Senate,Connie Johnson,DEM,600009,8,38,256,302,
Payne,U.S. Senate,James Lankford,REP,600009,21,54,442,517,
Payne,U.S. Senate,Mark Beard,IND,600009,0,2,21,23,
Payne,U.S. House,Frankie Robbins,DEM,600009,6,32,239,277,03
Payne,U.S. House,Frank Lucas,REP,600009,23,61,482,566,03
Payne,Governor,Joe Dorman,DEM,600010,1,10,196,207,
Payne,Governor,Mary Fallin,REP,600010,3,8,101,112,
Payne,Governor,Kimberly Willis,IND,600010,0,0,6,6,
Payne,Governor,Richard Prawdzienski,IND,600010,0,1,5,6,
Payne,Lieutenant Governor,Cathy Cummings,DEM,600010,0,5,163,168,
Payne,Lieutenant Governor,Todd Lamb,REP,600010,3,14,141,158,
Payne,Superintendent of Public Instruction,John Cox,DEM,600010,2,9,186,197,
Payne,Superintendent of Public Instruction,Joy Hofmeister,REP,600010,2,10,117,129,
Payne,Commissioner of Labor,Mike Workman,DEM,600010,1,8,163,172,
Payne,Commissioner of Labor,Mark Costello,REP,600010,1,10,132,143,
Payne,U.S. Senate,Matt Silverstein,DEM,600010,0,7,163,170,
Payne,U.S. Senate,Jim Inhofe,REP,600010,4,12,130,146,
Payne,U.S. Senate,Aaron Delozier,IND,600010,0,0,4,4,
Payne,U.S. Senate,Ray Woods,IND,600010,0,0,4,4,
Payne,U.S. Senate,Joan Farr,IND,600010,0,0,7,7,
Payne,U.S. Senate,Connie Johnson,DEM,600010,0,8,167,175,
Payne,U.S. Senate,James Lankford,REP,600010,3,11,131,145,
Payne,U.S. Senate,Mark Beard,IND,600010,0,0,10,10,
Payne,U.S. House,Frankie Robbins,DEM,600010,0,6,153,159,03
Payne,U.S. House,Frank Lucas,REP,600010,4,13,151,168,03
Payne,Governor,Joe Dorman,DEM,600011,1,19,117,137,
Payne,Governor,Mary Fallin,REP,600011,3,12,70,85,
Payne,Governor,Kimberly Willis,IND,600011,0,0,0,0,
Payne,Governor,Richard Prawdzienski,IND,600011,0,0,2,2,
Payne,Lieutenant Governor,Cathy Cummings,DEM,600011,1,16,93,110,
Payne,Lieutenant Governor,Todd Lamb,REP,600011,2,15,94,111,
Payne,Superintendent of Public Instruction,John Cox,DEM,600011,1,17,102,120,
Payne,Superintendent of Public Instruction,Joy Hofmeister,REP,600011,2,14,85,101,
Payne,Commissioner of Labor,Mike Workman,DEM,600011,1,16,91,108,
Payne,Commissioner of Labor,Mark Costello,REP,600011,2,13,92,107,
Payne,U.S. Senate,Matt Silverstein,DEM,600011,1,15,89,105,
Payne,U.S. Senate,Jim Inhofe,REP,600011,3,14,95,112,
Payne,U.S. Senate,Aaron Delozier,IND,600011,0,0,1,1,
Payne,U.S. Senate,Ray Woods,IND,600011,0,0,0,0,
Payne,U.S. Senate,Joan Farr,IND,600011,0,1,3,4,
Payne,U.S. Senate,Connie Johnson,DEM,600011,1,16,89,106,
Payne,U.S. Senate,James Lankford,REP,600011,3,14,92,109,
Payne,U.S. Senate,Mark Beard,IND,600011,0,0,6,6,
Payne,U.S. House,Frankie Robbins,DEM,600011,1,13,85,99,03
Payne,U.S. House,Frank Lucas,REP,600011,3,17,101,121,03
Payne,Governor,Joe Dorman,DEM,600012,1,15,117,133,
Payne,Governor,Mary Fallin,REP,600012,1,3,45,49,
Payne,Governor,Kimberly Willis,IND,600012,0,1,3,4,
Payne,Governor,Richard Prawdzienski,IND,600012,0,0,4,4,
Payne,Lieutenant Governor,Cathy Cummings,DEM,600012,1,15,94,110,
Payne,Lieutenant Governor,Todd Lamb,REP,600012,1,4,69,74,
Payne,Superintendent of Public Instruction,John Cox,DEM,600012,1,15,109,125,
Payne,Superintendent of Public Instruction,Joy Hofmeister,REP,600012,1,4,56,61,
Payne,Commissioner of Labor,Mike Workman,DEM,600012,1,13,94,108,
Payne,Commissioner of Labor,Mark Costello,REP,600012,1,5,65,71,
Payne,U.S. Senate,Matt Silverstein,DEM,600012,1,13,92,106,
Payne,U.S. Senate,Jim Inhofe,REP,600012,1,5,67,73,
Payne,U.S. Senate,Aaron Delozier,IND,600012,0,0,2,2,
Payne,U.S. Senate,Ray Woods,IND,600012,0,0,2,2,
Payne,U.S. Senate,Joan Farr,IND,600012,0,0,5,5,
Payne,U.S. Senate,Connie Johnson,DEM,600012,1,13,89,103,
Payne,U.S. Senate,James Lankford,REP,600012,1,6,70,77,
Payne,U.S. Senate,Mark Beard,IND,600012,0,0,8,8,
Payne,U.S. House,Frankie Robbins,DEM,600012,1,13,95,109,03
Payne,U.S. House,Frank Lucas,REP,600012,1,6,69,76,03
Payne,Governor,Joe Dorman,DEM,600013,9,43,383,435,
Payne,Governor,Mary Fallin,REP,600013,13,54,383,450,
Payne,Governor,Kimberly Willis,IND,600013,0,1,15,16,
Payne,Governor,Richard Prawdzienski,IND,600013,0,1,7,8,
Payne,Lieutenant Governor,Cathy Cummings,DEM,600013,6,36,306,348,
Payne,Lieutenant Governor,Todd Lamb,REP,600013,16,62,475,553,
Payne,Superintendent of Public Instruction,John Cox,DEM,600013,7,49,371,427,
Payne,Superintendent of Public Instruction,Joy Hofmeister,REP,600013,14,50,413,477,
Payne,Commissioner of Labor,Mike Workman,DEM,600013,8,42,322,372,
Payne,Commissioner of Labor,Mark Costello,REP,600013,14,54,449,517,
Payne,U.S. Senate,Matt Silverstein,DEM,600013,4,36,283,323,
Payne,U.S. Senate,Jim Inhofe,REP,600013,17,59,469,545,
Payne,U.S. Senate,Aaron Delozier,IND,600013,0,0,7,7,
Payne,U.S. Senate,Ray Woods,IND,600013,0,1,17,18,
Payne,U.S. Senate,Joan Farr,IND,600013,1,1,5,7,
Payne,U.S. Senate,Connie Johnson,DEM,600013,7,40,289,336,
Payne,U.S. Senate,James Lankford,REP,600013,14,58,474,546,
Payne,U.S. Senate,Mark Beard,IND,600013,1,0,21,22,
Payne,U.S. House,Frankie Robbins,DEM,600013,5,38,274,317,03
Payne,U.S. House,Frank Lucas,REP,600013,16,61,508,585,03
Payne,Governor,Joe Dorman,DEM,600014,0,1,12,13,
Payne,Governor,Mary Fallin,REP,600014,0,0,6,6,
Payne,Governor,Kimberly Willis,IND,600014,0,0,0,0,
Payne,Governor,Richard Prawdzienski,IND,600014,0,0,0,0,
Payne,Lieutenant Governor,Cathy Cummings,DEM,600014,0,1,11,12,
Payne,Lieutenant Governor,Todd Lamb,REP,600014,0,0,6,6,
Payne,Superintendent of Public Instruction,John Cox,DEM,600014,0,1,12,13,
Payne,Superintendent of Public Instruction,Joy Hofmeister,REP,600014,0,0,6,6,
Payne,Commissioner of Labor,Mike Workman,DEM,600014,0,1,10,11,
Payne,Commissioner of Labor,Mark Costello,REP,600014,0,0,6,6,
Payne,U.S. Senate,Matt Silverstein,DEM,600014,0,1,9,10,
Payne,U.S. Senate,Jim Inhofe,REP,600014,0,0,8,8,
Payne,U.S. Senate,Aaron Delozier,IND,600014,0,0,0,0,
Payne,U.S. Senate,Ray Woods,IND,600014,0,0,0,0,
Payne,U.S. Senate,Joan Farr,IND,600014,0,0,0,0,
Payne,U.S. Senate,Connie Johnson,DEM,600014,0,1,9,10,
Payne,U.S. Senate,James Lankford,REP,600014,0,0,7,7,
Payne,U.S. Senate,Mark Beard,IND,600014,0,0,1,1,
Payne,U.S. House,Frankie Robbins,DEM,600014,0,1,8,9,03
Payne,U.S. House,Frank Lucas,REP,600014,0,0,9,9,03
Payne,Governor,Joe Dorman,DEM,600015,5,31,238,274,
Payne,Governor,Mary Fallin,REP,600015,5,18,158,181,
Payne,Governor,Kimberly Willis,IND,600015,0,0,12,12,
Payne,Governor,Richard Prawdzienski,IND,600015,0,0,8,8,
Payne,Lieutenant Governor,Cathy Cummings,DEM,600015,6,27,200,233,
Payne,Lieutenant Governor,Todd Lamb,REP,600015,4,22,216,242,
Payne,Superintendent of Public Instruction,John Cox,DEM,600015,7,33,250,290,
Payne,Superintendent of Public Instruction,Joy Hofmeister,REP,600015,3,16,165,184,
Payne,Commissioner of Labor,Mike Workman,DEM,600015,7,25,220,252,
Payne,Commissioner of Labor,Mark Costello,REP,600015,3,21,188,212,
Payne,U.S. Senate,Matt Silverstein,DEM,600015,6,25,186,217,
Payne,U.S. Senate,Jim Inhofe,REP,600015,3,22,211,236,
Payne,U.S. Senate,Aaron Delozier,IND,600015,0,0,5,5,
Payne,U.S. Senate,Ray Woods,IND,600015,0,0,5,5,
Payne,U.S. Senate,Joan Farr,IND,600015,1,1,8,10,
Payne,U.S. Senate,Connie Johnson,DEM,600015,5,27,196,228,
Payne,U.S. Senate,James Lankford,REP,600015,5,22,204,231,
Payne,U.S. Senate,Mark Beard,IND,600015,0,0,16,16,
Payne,U.S. House,Frankie Robbins,DEM,600015,3,24,175,202,03
Payne,U.S. House,Frank Lucas,REP,600015,7,25,237,269,03
Payne,Governor,Joe Dorman,DEM,600016,15,96,497,608,
Payne,Governor,Mary Fallin,REP,600016,23,120,543,686,
Payne,Governor,Kimberly Willis,IND,600016,0,2,13,15,
Payne,Governor,Richard Prawdzienski,IND,600016,0,0,9,9,
Payne,Lieutenant Governor,Cathy Cummings,DEM,600016,12,70,341,423,
Payne,Lieutenant Governor,Todd Lamb,REP,600016,26,147,714,887,
Payne,Superintendent of Public Instruction,John Cox,DEM,600016,8,96,450,554,
Payne,Superintendent of Public Instruction,Joy Hofmeister,REP,600016,30,120,602,752,
Payne,Commissioner of Labor,Mike Workman,DEM,600016,12,90,371,473,
Payne,Commissioner of Labor,Mark Costello,REP,600016,26,121,653,800,
Payne,U.S. Senate,Matt Silverstein,DEM,600016,12,76,351,439,
Payne,U.S. Senate,Jim Inhofe,REP,600016,26,136,671,833,
Payne,U.S. Senate,Aaron Delozier,IND,600016,0,0,10,10,
Payne,U.S. Senate,Ray Woods,IND,600016,0,1,5,6,
Payne,U.S. Senate,Joan Farr,IND,600016,0,2,11,13,
Payne,U.S. Senate,Connie Johnson,DEM,600016,10,73,338,421,
Payne,U.S. Senate,James Lankford,REP,600016,28,142,696,866,
Payne,U.S. Senate,Mark Beard,IND,600016,0,1,18,19,
Payne,U.S. House,Frankie Robbins,DEM,600016,9,64,310,383,03
Payne,U.S. House,Frank Lucas,REP,600016,29,151,740,920,03
Payne,Governor,Joe Dorman,DEM,600101,7,7,165,179,
Payne,Governor,Mary Fallin,REP,600101,14,2,251,267,
Payne,Governor,Kimberly Willis,IND,600101,0,0,11,11,
Payne,Governor,Richard Prawdzienski,IND,600101,0,0,7,7,
Payne,Lieutenant Governor,Cathy Cummings,DEM,600101,7,5,112,124,
Payne,Lieutenant Governor,Todd Lamb,REP,600101,14,4,324,342,
Payne,Superintendent of Public Instruction,John Cox,DEM,600101,8,7,188,203,
Payne,Superintendent of Public Instruction,Joy Hofmeister,REP,600101,13,2,248,263,
Payne,Commissioner of Labor,Mike Workman,DEM,600101,6,5,149,160,
Payne,Commissioner of Labor,Mark Costello,REP,600101,15,4,282,301,
Payne,U.S. Senate,Matt Silverstein,DEM,600101,6,5,104,115,
Payne,U.S. Senate,Jim Inhofe,REP,600101,14,4,311,329,
Payne,U.S. Senate,Aaron Delozier,IND,600101,0,0,2,2,
Payne,U.S. Senate,Ray Woods,IND,600101,0,0,3,3,
Payne,U.S. Senate,Joan Farr,IND,600101,1,0,16,17,
Payne,U.S. Senate,Connie Johnson,DEM,600101,6,5,113,124,
Payne,U.S. Senate,James Lankford,REP,600101,15,4,302,321,
Payne,U.S. Senate,Mark Beard,IND,600101,0,0,21,21,
Payne,U.S. House,Frankie Robbins,DEM,600101,6,5,122,133,03
Payne,U.S. House,Frank Lucas,REP,600101,15,4,313,332,03
Payne,Governor,Joe Dorman,DEM,600102,10,7,168,185,
Payne,Governor,Mary Fallin,REP,600102,8,4,304,316,
Payne,Governor,Kimberly Willis,IND,600102,0,0,11,11,
Payne,Governor,Richard Prawdzienski,IND,600102,0,0,5,5,
Payne,Lieutenant Governor,Cathy Cummings,DEM,600102,9,7,113,129,
Payne,Lieutenant Governor,Todd Lamb,REP,600102,9,4,372,385,
Payne,Superintendent of Public Instruction,John Cox,DEM,600102,9,5,191,205,
Payne,Superintendent of Public Instruction,Joy Hofmeister,REP,600102,9,6,295,310,
Payne,Commissioner of Labor,Mike Workman,DEM,600102,9,6,143,158,
Payne,Commissioner of Labor,Mark Costello,REP,600102,8,4,339,351,
Payne,U.S. Senate,Matt Silverstein,DEM,600102,9,5,106,120,
Payne,U.S. Senate,Jim Inhofe,REP,600102,9,5,361,375,
Payne,U.S. Senate,Aaron Delozier,IND,600102,0,0,4,4,
Payne,U.S. Senate,Ray Woods,IND,600102,0,0,6,6,
Payne,U.S. Senate,Joan Farr,IND,600102,0,1,11,12,
Payne,U.S. Senate,Connie Johnson,DEM,600102,10,4,109,123,
Payne,U.S. Senate,James Lankford,REP,600102,8,7,356,371,
Payne,U.S. Senate,Mark Beard,IND,600102,0,0,23,23,
Payne,U.S. House,Frankie Robbins,DEM,600102,8,4,110,122,03
Payne,U.S. House,Frank Lucas,REP,600102,10,7,376,393,03
Payne,Governor,Joe Dorman,DEM,600103,7,0,152,159,
Payne,Governor,Mary Fallin,REP,600103,6,1,282,289,
Payne,Governor,Kimberly Willis,IND,600103,0,0,22,22,
Payne,Governor,Richard Prawdzienski,IND,600103,0,0,8,8,
Payne,Lieutenant Governor,Cathy Cummings,DEM,600103,5,0,103,108,
Payne,Lieutenant Governor,Todd Lamb,REP,600103,8,1,359,368,
Payne,Superintendent of Public Instruction,John Cox,DEM,600103,8,0,188,196,
Payne,Superintendent of Public Instruction,Joy Hofmeister,REP,600103,5,1,277,283,
Payne,Commissioner of Labor,Mike Workman,DEM,600103,5,0,135,140,
Payne,Commissioner of Labor,Mark Costello,REP,600103,8,1,322,331,
Payne,U.S. Senate,Matt Silverstein,DEM,600103,5,0,94,99,
Payne,U.S. Senate,Jim Inhofe,REP,600103,8,1,348,357,
Payne,U.S. Senate,Aaron Delozier,IND,600103,0,0,5,5,
Payne,U.S. Senate,Ray Woods,IND,600103,0,0,5,5,
Payne,U.S. Senate,Joan Farr,IND,600103,0,0,8,8,
Payne,U.S. Senate,Connie Johnson,DEM,600103,5,0,94,99,
Payne,U.S. Senate,James Lankford,REP,600103,8,1,352,361,
Payne,U.S. Senate,Mark Beard,IND,600103,0,0,16,16,
Payne,U.S. House,Frankie Robbins,DEM,600103,5,0,94,99,03
Payne,U.S. House,Frank Lucas,REP,600103,8,1,368,377,03
Payne,Governor,Joe Dorman,DEM,600104,3,2,179,184,
Payne,Governor,Mary Fallin,REP,600104,7,5,322,334,
Payne,Governor,Kimberly Willis,IND,600104,0,0,8,8,
Payne,Governor,Richard Prawdzienski,IND,600104,0,0,2,2,
Payne,Lieutenant Governor,Cathy Cummings,DEM,600104,3,1,108,112,
Payne,Lieutenant Governor,Todd Lamb,REP,600104,7,6,402,415,
Payne,Superintendent of Public Instruction,John Cox,DEM,600104,3,2,197,202,
Payne,Superintendent of Public Instruction,Joy Hofmeister,REP,600104,7,5,312,324,
Payne,Commissioner of Labor,Mike Workman,DEM,600104,3,1,145,149,
Payne,Commissioner of Labor,Mark Costello,REP,600104,7,6,360,373,
Payne,U.S. Senate,Matt Silverstein,DEM,600104,3,1,105,109,
Payne,U.S. Senate,Jim Inhofe,REP,600104,7,6,395,408,
Payne,U.S. Senate,Aaron Delozier,IND,600104,0,0,3,3,
Payne,U.S. Senate,Ray Woods,IND,600104,0,0,4,4,
Payne,U.S. Senate,Joan Farr,IND,600104,0,0,4,4,
Payne,U.S. Senate,Connie Johnson,DEM,600104,3,1,103,107,
Payne,U.S. Senate,James Lankford,REP,600104,7,6,390,403,
Payne,U.S. Senate,Mark Beard,IND,600104,0,0,15,15,
Payne,U.S. House,Frankie Robbins,DEM,600104,3,1,110,114,03
Payne,U.S. House,Frank Lucas,REP,600104,7,6,401,414,03
Payne,Governor,Joe Dorman,DEM,600201,6,5,197,208,
Payne,Governor,Mary Fallin,REP,600201,3,1,281,285,
Payne,Governor,Kimberly Willis,IND,600201,0,0,10,10,
Payne,Governor,Richard Prawdzienski,IND,600201,0,0,4,4,
Payne,Lieutenant Governor,Cathy Cummings,DEM,600201,5,2,154,161,
Payne,Lieutenant Governor,Todd Lamb,REP,600201,4,4,335,343,
Payne,Superintendent of Public Instruction,John Cox,DEM,600201,5,6,239,250,
Payne,Superintendent of Public Instruction,Joy Hofmeister,REP,600201,4,0,251,255,
Payne,Commissioner of Labor,Mike Workman,DEM,600201,5,5,193,203,
Payne,Commissioner of Labor,Mark Costello,REP,600201,4,1,284,289,
Payne,U.S. Senate,Matt Silverstein,DEM,600201,4,2,138,144,
Payne,U.S. Senate,Jim Inhofe,REP,600201,4,3,336,343,
Payne,U.S. Senate,Aaron Delozier,IND,600201,0,1,3,4,
Payne,U.S. Senate,Ray Woods,IND,600201,0,0,9,9,
Payne,U.S. Senate,Joan Farr,IND,600201,1,0,5,6,
Payne,U.S. Senate,Connie Johnson,DEM,600201,6,2,138,146,
Payne,U.S. Senate,James Lankford,REP,600201,3,4,337,344,
Payne,U.S. Senate,Mark Beard,IND,600201,0,0,17,17,
Payne,U.S. House,Frankie Robbins,DEM,600201,4,2,142,148,03
Payne,U.S. House,Frank Lucas,REP,600201,4,4,349,357,03
Payne,Governor,Joe Dorman,DEM,600301,6,22,420,448,
Payne,Governor,Mary Fallin,REP,600301,17,33,522,572,
Payne,Governor,Kimberly Willis,IND,600301,0,1,18,19,
Payne,Governor,Richard Prawdzienski,IND,600301,0,1,11,12,
Payne,Lieutenant Governor,Cathy Cummings,DEM,600301,5,11,255,271,
Payne,Lieutenant Governor,Todd Lamb,REP,600301,18,46,711,775,
Payne,Superintendent of Public Instruction,John Cox,DEM,600301,10,24,427,461,
Payne,Superintendent of Public Instruction,Joy Hofmeister,REP,600301,12,33,537,582,
Payne,Commissioner of Labor,Mike Workman,DEM,600301,5,20,334,359,
Payne,Commissioner of Labor,Mark Costello,REP,600301,17,37,605,659,
Payne,U.S. Senate,Matt Silverstein,DEM,600301,7,15,228,250,
Payne,U.S. Senate,Jim Inhofe,REP,600301,15,40,703,758,
Payne,U.S. Senate,Aaron Delozier,IND,600301,0,1,7,8,
Payne,U.S. Senate,Ray Woods,IND,600301,0,0,16,16,
Payne,U.S. Senate,Joan Farr,IND,600301,1,1,12,14,
Payne,U.S. Senate,Connie Johnson,DEM,600301,5,16,234,255,
Payne,U.S. Senate,James Lankford,REP,600301,16,40,707,763,
Payne,U.S. Senate,Mark Beard,IND,600301,2,1,24,27,
Payne,U.S. House,Frankie Robbins,DEM,600301,5,13,235,253,03
Payne,U.S. House,Frank Lucas,REP,600301,18,44,729,791,03
Payne,Governor,Joe Dorman,DEM,600401,21,60,440,521,
Payne,Governor,Mary Fallin,REP,600401,18,77,537,632,
Payne,Governor,Kimberly Willis,IND,600401,0,0,13,13,
Payne,Governor,Richard Prawdzienski,IND,600401,0,0,6,6,
Payne,Lieutenant Governor,Cathy Cummings,DEM,600401,19,51,277,347,
Payne,Lieutenant Governor,Todd Lamb,REP,600401,19,85,712,816,
Payne,Superintendent of Public Instruction,John Cox,DEM,600401,20,53,424,497,
Payne,Superintendent of Public Instruction,Joy Hofmeister,REP,600401,18,84,566,668,
Payne,Commissioner of Labor,Mike Workman,DEM,600401,20,49,324,393,
Payne,Commissioner of Labor,Mark Costello,REP,600401,18,77,642,737,
Payne,U.S. Senate,Matt Silverstein,DEM,600401,18,45,297,360,
Payne,U.S. Senate,Jim Inhofe,REP,600401,21,88,660,769,
Payne,U.S. Senate,Aaron Delozier,IND,600401,0,0,7,7,
Payne,U.S. Senate,Ray Woods,IND,600401,0,0,9,9,
Payne,U.S. Senate,Joan Farr,IND,600401,0,2,14,16,
Payne,U.S. Senate,Connie Johnson,DEM,600401,17,43,277,337,
Payne,U.S. Senate,James Lankford,REP,600401,21,94,690,805,
Payne,U.S. Senate,Mark Beard,IND,600401,0,1,23,24,
Payne,U.S. House,Frankie Robbins,DEM,600401,14,43,262,319,03
Payne,U.S. House,Frank Lucas,REP,600401,24,94,728,846,03
Payne,Governor,Joe Dorman,DEM,600402,2,12,163,177,
Payne,Governor,Mary Fallin,REP,600402,9,29,235,273,
Payne,Governor,Kimberly Willis,IND,600402,0,0,2,2,
Payne,Governor,Richard Prawdzienski,IND,600402,0,0,3,3,
Payne,Lieutenant Governor,Cathy Cummings,DEM,600402,3,10,119,132,
Payne,Lieutenant Governor,Todd Lamb,REP,600402,8,32,280,320,
Payne,Superintendent of Public Instruction,John Cox,DEM,600402,1,12,161,174,
Payne,Superintendent of Public Instruction,Joy Hofmeister,REP,600402,10,30,239,279,
Payne,Commissioner of Labor,Mike Workman,DEM,600402,3,13,137,153,
Payne,Commissioner of Labor,Mark Costello,REP,600402,8,29,250,287,
Payne,U.S. Senate,Matt Silverstein,DEM,600402,3,11,117,131,
Payne,U.S. Senate,Jim Inhofe,REP,600402,7,31,270,308,
Payne,U.S. Senate,Aaron Delozier,IND,600402,0,0,3,3,
Payne,U.S. Senate,Ray Woods,IND,600402,1,0,5,6,
Payne,U.S. Senate,Joan Farr,IND,600402,0,0,6,6,
Payne,U.S. Senate,Connie Johnson,DEM,600402,3,8,116,127,
Payne,U.S. Senate,James Lankford,REP,600402,8,33,268,309,
Payne,U.S. Senate,Mark Beard,IND,600402,0,0,15,15,
Payne,U.S. House,Frankie Robbins,DEM,600402,3,9,109,121,03
Payne,U.S. House,Frank Lucas,REP,600402,8,33,292,333,03
Payne,Governor,Joe Dorman,DEM,600403,3,17,127,147,
Payne,Governor,Mary Fallin,REP,600403,1,24,225,250,
Payne,Governor,Kimberly Willis,IND,600403,0,0,5,5,
Payne,Governor,Richard Prawdzienski,IND,600403,0,0,2,2,
Payne,Lieutenant Governor,Cathy Cummings,DEM,600403,3,12,88,103,
Payne,Lieutenant Governor,Todd Lamb,REP,600403,1,29,271,301,
Payne,Superintendent of Public Instruction,John Cox,DEM,600403,3,16,131,150,
Payne,Superintendent of Public Instruction,Joy Hofmeister,REP,600403,1,25,230,256,
Payne,Commissioner of Labor,Mike Workman,DEM,600403,3,18,103,124,
Payne,Commissioner of Labor,Mark Costello,REP,600403,1,21,246,268,
Payne,U.S. Senate,Matt Silverstein,DEM,600403,3,13,84,100,
Payne,U.S. Senate,Jim Inhofe,REP,600403,3,27,264,294,
Payne,U.S. Senate,Aaron Delozier,IND,600403,0,0,3,3,
Payne,U.S. Senate,Ray Woods,IND,600403,0,0,1,1,
Payne,U.S. Senate,Joan Farr,IND,600403,0,1,3,4,
Payne,U.S. Senate,Connie Johnson,DEM,600403,3,16,93,112,
Payne,U.S. Senate,James Lankford,REP,600403,3,25,262,290,
Payne,U.S. Senate,Mark Beard,IND,600403,0,0,4,4,
Payne,U.S. House,Frankie Robbins,DEM,600403,3,16,77,96,03
Payne,U.S. House,Frank Lucas,REP,600403,3,25,281,309,03
Payne,State House,Wannetta Cloyd,DEM,600403,3,11,74,88,35
Payne,State House,Dennis Casey,REP,600403,1,30,282,313,35
Payne,Governor,Joe Dorman,DEM,600404,0,3,31,34,
Payne,Governor,Mary Fallin,REP,600404,1,8,32,41,
Payne,Governor,Kimberly Willis,IND,600404,0,0,2,2,
Payne,Governor,Richard Prawdzienski,IND,600404,0,0,1,1,
Payne,Lieutenant Governor,Cathy Cummings,DEM,600404,0,1,20,21,
Payne,Lieutenant Governor,Todd Lamb,REP,600404,1,9,46,56,
Payne,Superintendent of Public Instruction,John Cox,DEM,600404,0,4,35,39,
Payne,Superintendent of Public Instruction,Joy Hofmeister,REP,600404,1,6,31,38,
Payne,Commissioner of Labor,Mike Workman,DEM,600404,0,3,22,25,
Payne,Commissioner of Labor,Mark Costello,REP,600404,1,5,41,47,
Payne,U.S. Senate,Matt Silverstein,DEM,600404,0,3,19,22,
Payne,U.S. Senate,Jim Inhofe,REP,600404,1,8,42,51,
Payne,U.S. Senate,Aaron Delozier,IND,600404,0,0,2,2,
Payne,U.S. Senate,Ray Woods,IND,600404,0,0,0,0,
Payne,U.S. Senate,Joan Farr,IND,600404,0,0,2,2,
Payne,U.S. Senate,Connie Johnson,DEM,600404,0,2,14,16,
Payne,U.S. Senate,James Lankford,REP,600404,1,8,48,57,
Payne,U.S. Senate,Mark Beard,IND,600404,0,0,3,3,
Payne,U.S. House,Frankie Robbins,DEM,600404,0,3,14,17,03
Payne,U.S. House,Frank Lucas,REP,600404,1,8,52,61,03
Payne,Governor,Joe Dorman,DEM,600405,7,21,215,243,
Payne,Governor,Mary Fallin,REP,600405,8,24,337,369,
Payne,Governor,Kimberly Willis,IND,600405,1,1,6,8,
Payne,Governor,Richard Prawdzienski,IND,600405,0,0,3,3,
Payne,Lieutenant Governor,Cathy Cummings,DEM,600405,6,16,128,150,
Payne,Lieutenant Governor,Todd Lamb,REP,600405,10,29,430,469,
Payne,Superintendent of Public Instruction,John Cox,DEM,600405,8,24,233,265,
Payne,Superintendent of Public Instruction,Joy Hofmeister,REP,600405,8,22,324,354,
Payne,Commissioner of Labor,Mike Workman,DEM,600405,6,19,167,192,
Payne,Commissioner of Labor,Mark Costello,REP,600405,10,26,381,417,
Payne,U.S. Senate,Matt Silverstein,DEM,600405,5,13,122,140,
Payne,U.S. Senate,Jim Inhofe,REP,600405,10,29,416,455,
Payne,U.S. Senate,Aaron Delozier,IND,600405,0,0,10,10,
Payne,U.S. Senate,Ray Woods,IND,600405,0,2,6,8,
Payne,U.S. Senate,Joan Farr,IND,600405,1,1,3,5,
Payne,U.S. Senate,Connie Johnson,DEM,600405,6,17,119,142,
Payne,U.S. Senate,James Lankford,REP,600405,10,26,424,460,
Payne,U.S. Senate,Mark Beard,IND,600405,0,2,13,15,
Payne,U.S. House,Frankie Robbins,DEM,600405,5,18,115,138,03
Payne,U.S. House,Frank Lucas,REP,600405,11,27,442,480,03
Payne,Governor,Joe Dorman,DEM,600406,5,8,134,147,
Payne,Governor,Mary Fallin,REP,600406,7,7,316,330,
Payne,Governor,Kimberly Willis,IND,600406,0,0,13,13,
Payne,Governor,Richard Prawdzienski,IND,600406,0,0,7,7,
Payne,Lieutenant Governor,Cathy Cummings,DEM,600406,3,5,90,98,
Payne,Lieutenant Governor,Todd Lamb,REP,600406,9,9,379,397,
Payne,Superintendent of Public Instruction,John Cox,DEM,600406,5,9,178,192,
Payne,Superintendent of Public Instruction,Joy Hofmeister,REP,600406,7,6,286,299,
Payne,Commissioner of Labor,Mike Workman,DEM,600406,1,7,117,125,
Payne,Commissioner of Labor,Mark Costello,REP,600406,10,8,338,356,
Payne,U.S. Senate,Matt Silverstein,DEM,600406,3,4,74,81,
Payne,U.S. Senate,Jim Inhofe,REP,600406,9,11,376,396,
Payne,U.S. Senate,Aaron Delozier,IND,600406,0,0,2,2,
Payne,U.S. Senate,Ray Woods,IND,600406,0,0,8,8,
Payne,U.S. Senate,Joan Farr,IND,600406,0,0,6,6,
Payne,U.S. Senate,Connie Johnson,DEM,600406,3,6,69,78,
Payne,U.S. Senate,James Lankford,REP,600406,9,9,383,401,
Payne,U.S. Senate,Mark Beard,IND,600406,0,0,15,15,
Payne,U.S. House,Frankie Robbins,DEM,600406,3,5,80,88,03
Payne,U.S. House,Frank Lucas,REP,600406,9,10,385,404,03
Payne,State House,Wannetta Cloyd,DEM,600406,3,5,79,87,35
Payne,State House,Dennis Casey,REP,600406,9,10,387,406,35
Payne,Governor,Joe Dorman,DEM,600407,8,16,202,226,
Payne,Governor,Mary Fallin,REP,600407,10,18,277,305,
Payne,Governor,Kimberly Willis,IND,600407,0,0,11,11,
Payne,Governor,Richard Prawdzienski,IND,600407,0,0,8,8,
Payne,Lieutenant Governor,Cathy Cummings,DEM,600407,6,10,132,148,
Payne,Lieutenant Governor,Todd Lamb,REP,600407,12,24,364,400,
Payne,Superintendent of Public Instruction,John Cox,DEM,600407,8,12,209,229,
Payne,Superintendent of Public Instruction,Joy Hofmeister,REP,600407,10,22,286,318,
Payne,Commissioner of Labor,Mike Workman,DEM,600407,9,9,167,185,
Payne,Commissioner of Labor,Mark Costello,REP,600407,9,23,319,351,
Payne,U.S. Senate,Matt Silverstein,DEM,600407,8,7,117,132,
Payne,U.S. Senate,Jim Inhofe,REP,600407,10,23,358,391,
Payne,U.S. Senate,Aaron Delozier,IND,600407,0,0,8,8,
Payne,U.S. Senate,Ray Woods,IND,600407,0,1,5,6,
Payne,U.S. Senate,Joan Farr,IND,600407,0,1,7,8,
Payne,U.S. Senate,Connie Johnson,DEM,600407,6,10,126,142,
Payne,U.S. Senate,James Lankford,REP,600407,11,21,351,383,
Payne,U.S. Senate,Mark Beard,IND,600407,1,2,15,18,
Payne,U.S. House,Frankie Robbins,DEM,600407,6,9,116,131,03
Payne,U.S. House,Frank Lucas,REP,600407,11,25,378,414,03
Payne,Governor,Joe Dorman,DEM,600408,2,1,75,78,
Payne,Governor,Mary Fallin,REP,600408,3,6,97,106,
Payne,Governor,Kimberly Willis,IND,600408,0,1,2,3,
Payne,Governor,Richard Prawdzienski,IND,600408,0,0,1,1,
Payne,Lieutenant Governor,Cathy Cummings,DEM,600408,2,1,50,53,
Payne,Lieutenant Governor,Todd Lamb,REP,600408,3,7,124,134,
Payne,Superintendent of Public Instruction,John Cox,DEM,600408,2,2,71,75,
Payne,Superintendent of Public Instruction,Joy Hofmeister,REP,600408,3,6,103,112,
Payne,Commissioner of Labor,Mike Workman,DEM,600408,2,3,62,67,
Payne,Commissioner of Labor,Mark Costello,REP,600408,3,5,108,116,
Payne,U.S. Senate,Matt Silverstein,DEM,600408,2,0,54,56,
Payne,U.S. Senate,Jim Inhofe,REP,600408,3,8,115,126,
Payne,U.S. Senate,Aaron Delozier,IND,600408,0,0,1,1,
Payne,U.S. Senate,Ray Woods,IND,600408,0,0,1,1,
Payne,U.S. Senate,Joan Farr,IND,600408,0,0,3,3,
Payne,U.S. Senate,Connie Johnson,DEM,600408,3,0,47,50,
Payne,U.S. Senate,James Lankford,REP,600408,2,8,123,133,
Payne,U.S. Senate,Mark Beard,IND,600408,0,0,3,3,
Payne,U.S. House,Frankie Robbins,DEM,600408,2,0,41,43,03
Payne,U.S. House,Frank Lucas,REP,600408,3,8,133,144,03
Payne,Governor,Joe Dorman,DEM,600409,3,7,155,165,
Payne,Governor,Mary Fallin,REP,600409,7,30,249,286,
Payne,Governor,Kimberly Willis,IND,600409,0,2,10,12,
Payne,Governor,Richard Prawdzienski,IND,600409,0,0,7,7,
Payne,Lieutenant Governor,Cathy Cummings,DEM,600409,4,6,101,111,
Payne,Lieutenant Governor,Todd Lamb,REP,600409,5,33,319,357,
Payne,Superintendent of Public Instruction,John Cox,DEM,600409,4,12,176,192,
Payne,Superintendent of Public Instruction,Joy Hofmeister,REP,600409,5,26,243,274,
Payne,Commissioner of Labor,Mike Workman,DEM,600409,5,10,117,132,
Payne,Commissioner of Labor,Mark Costello,REP,600409,4,28,291,323,
Payne,U.S. Senate,Matt Silverstein,DEM,600409,3,4,94,101,
Payne,U.S. Senate,Jim Inhofe,REP,600409,6,33,314,353,
Payne,U.S. Senate,Aaron Delozier,IND,600409,0,1,2,3,
Payne,U.S. Senate,Ray Woods,IND,600409,0,0,5,5,
Payne,U.S. Senate,Joan Farr,IND,600409,0,1,5,6,
Payne,U.S. Senate,Connie Johnson,DEM,600409,0,7,91,98,
Payne,U.S. Senate,James Lankford,REP,600409,9,31,319,359,
Payne,U.S. Senate,Mark Beard,IND,600409,0,1,11,12,
Payne,U.S. House,Frankie Robbins,DEM,600409,3,5,89,97,03
Payne,U.S. House,Frank Lucas,REP,600409,6,33,330,369,03
Pittsburg,Governor,Joe Dorman,DEM,610001,0,2,38,40,
Pittsburg,Governor,Mary Fallin,REP,610001,0,1,17,18,
Pittsburg,Governor,Kimberly Willis,IND,610001,0,0,1,1,
Pittsburg,Governor,Richard Prawdzienski,IND,610001,0,1,0,1,
Pittsburg,Lieutenant Governor,Cathy Cummings,DEM,610001,0,1,33,34,
Pittsburg,Lieutenant Governor,Todd Lamb,REP,610001,0,3,23,26,
Pittsburg,Superintendent of Public Instruction,John Cox,DEM,610001,0,2,43,45,
Pittsburg,Superintendent of Public Instruction,Joy Hofmeister,REP,610001,0,2,13,15,
Pittsburg,Commissioner of Labor,Mike Workman,DEM,610001,0,1,40,41,
Pittsburg,Commissioner of Labor,Mark Costello,REP,610001,0,2,16,18,
Pittsburg,U.S. Senate,Matt Silverstein,DEM,610001,0,1,31,32,
Pittsburg,U.S. Senate,Jim Inhofe,REP,610001,0,2,23,25,
Pittsburg,U.S. Senate,Aaron Delozier,IND,610001,0,1,1,2,
Pittsburg,U.S. Senate,Ray Woods,IND,610001,0,0,1,1,
Pittsburg,U.S. Senate,Joan Farr,IND,610001,0,0,0,0,
Pittsburg,U.S. Senate,Connie Johnson,DEM,610001,0,1,33,34,
Pittsburg,U.S. Senate,James Lankford,REP,610001,0,3,20,23,
Pittsburg,U.S. Senate,Mark Beard,IND,610001,0,0,3,3,
Pittsburg,U.S. House,Earl Everett,DEM,610001,0,1,29,30,02
Pittsburg,U.S. House,Markwayne Mullin,REP,610001,0,3,22,25,02
Pittsburg,U.S. House,Jon Douthitt,IND,610001,0,0,5,5,02
Pittsburg,State House,Brian Renegar,DEM,610001,0,3,42,45,17
Pittsburg,State House,Micah Thompson,REP,610001,0,1,14,15,17
Pittsburg,Governor,Joe Dorman,DEM,610003,8,15,139,162,
Pittsburg,Governor,Mary Fallin,REP,610003,1,9,156,166,
Pittsburg,Governor,Kimberly Willis,IND,610003,0,0,12,12,
Pittsburg,Governor,Richard Prawdzienski,IND,610003,0,0,3,3,
Pittsburg,Lieutenant Governor,Cathy Cummings,DEM,610003,8,9,121,138,
Pittsburg,Lieutenant Governor,Todd Lamb,REP,610003,1,15,185,201,
Pittsburg,Superintendent of Public Instruction,John Cox,DEM,610003,8,16,170,194,
Pittsburg,Superintendent of Public Instruction,Joy Hofmeister,REP,610003,1,9,137,147,
Pittsburg,Commissioner of Labor,Mike Workman,DEM,610003,8,13,154,175,
Pittsburg,Commissioner of Labor,Mark Costello,REP,610003,1,12,149,162,
Pittsburg,U.S. Senate,Matt Silverstein,DEM,610003,7,9,103,119,
Pittsburg,U.S. Senate,Jim Inhofe,REP,610003,1,16,196,213,
Pittsburg,U.S. Senate,Aaron Delozier,IND,610003,0,0,1,1,
Pittsburg,U.S. Senate,Ray Woods,IND,610003,1,0,8,9,
Pittsburg,U.S. Senate,Joan Farr,IND,610003,0,0,1,1,
Pittsburg,U.S. Senate,Connie Johnson,DEM,610003,7,11,111,129,
Pittsburg,U.S. Senate,James Lankford,REP,610003,1,14,178,193,
Pittsburg,U.S. Senate,Mark Beard,IND,610003,1,0,19,20,
Pittsburg,U.S. House,Earl Everett,DEM,610003,8,10,96,114,02
Pittsburg,U.S. House,Markwayne Mullin,REP,610003,1,14,195,210,02
Pittsburg,U.S. House,Jon Douthitt,IND,610003,0,1,19,20,02
Pittsburg,State House,Brian Renegar,DEM,610003,8,20,223,251,17
Pittsburg,State House,Micah Thompson,REP,610003,1,5,84,90,17
Pittsburg,Governor,Joe Dorman,DEM,610004,6,42,239,287,
Pittsburg,Governor,Mary Fallin,REP,610004,4,26,313,343,
Pittsburg,Governor,Kimberly Willis,IND,610004,0,2,8,10,
Pittsburg,Governor,Richard Prawdzienski,IND,610004,0,1,7,8,
Pittsburg,Lieutenant Governor,Cathy Cummings,DEM,610004,5,31,181,217,
Pittsburg,Lieutenant Governor,Todd Lamb,REP,610004,5,40,384,429,
Pittsburg,Superintendent of Public Instruction,John Cox,DEM,610004,5,48,286,339,
Pittsburg,Superintendent of Public Instruction,Joy Hofmeister,REP,610004,5,23,279,307,
Pittsburg,Commissioner of Labor,Mike Workman,DEM,610004,5,36,212,253,
Pittsburg,Commissioner of Labor,Mark Costello,REP,610004,5,33,346,384,
Pittsburg,U.S. Senate,Matt Silverstein,DEM,610004,3,24,150,177,
Pittsburg,U.S. Senate,Jim Inhofe,REP,610004,7,46,407,460,
Pittsburg,U.S. Senate,Aaron Delozier,IND,610004,0,0,1,1,
Pittsburg,U.S. Senate,Ray Woods,IND,610004,0,0,4,4,
Pittsburg,U.S. Senate,Joan Farr,IND,610004,0,0,4,4,
Pittsburg,U.S. Senate,Connie Johnson,DEM,610004,3,29,156,188,
Pittsburg,U.S. Senate,James Lankford,REP,610004,7,40,397,444,
Pittsburg,U.S. Senate,Mark Beard,IND,610004,0,1,15,16,
Pittsburg,U.S. House,Earl Everett,DEM,610004,4,27,134,165,02
Pittsburg,U.S. House,Markwayne Mullin,REP,610004,6,43,408,457,02
Pittsburg,U.S. House,Jon Douthitt,IND,610004,0,1,22,23,02
Pittsburg,Governor,Joe Dorman,DEM,610005,1,10,111,122,
Pittsburg,Governor,Mary Fallin,REP,610005,1,9,122,132,
Pittsburg,Governor,Kimberly Willis,IND,610005,0,0,10,10,
Pittsburg,Governor,Richard Prawdzienski,IND,610005,0,1,8,9,
Pittsburg,Lieutenant Governor,Cathy Cummings,DEM,610005,1,10,78,89,
Pittsburg,Lieutenant Governor,Todd Lamb,REP,610005,1,10,171,182,
Pittsburg,Superintendent of Public Instruction,John Cox,DEM,610005,1,12,133,146,
Pittsburg,Superintendent of Public Instruction,Joy Hofmeister,REP,610005,1,8,117,126,
Pittsburg,Commissioner of Labor,Mike Workman,DEM,610005,1,10,105,116,
Pittsburg,Commissioner of Labor,Mark Costello,REP,610005,1,10,141,152,
Pittsburg,U.S. Senate,Matt Silverstein,DEM,610005,1,8,64,73,
Pittsburg,U.S. Senate,Jim Inhofe,REP,610005,1,12,181,194,
Pittsburg,U.S. Senate,Aaron Delozier,IND,610005,0,0,1,1,
Pittsburg,U.S. Senate,Ray Woods,IND,610005,0,0,3,3,
Pittsburg,U.S. Senate,Joan Farr,IND,610005,0,0,2,2,
Pittsburg,U.S. Senate,Connie Johnson,DEM,610005,1,9,79,89,
Pittsburg,U.S. Senate,James Lankford,REP,610005,1,11,154,166,
Pittsburg,U.S. Senate,Mark Beard,IND,610005,0,0,16,16,
Pittsburg,U.S. House,Earl Everett,DEM,610005,1,10,56,67,02
Pittsburg,U.S. House,Markwayne Mullin,REP,610005,1,10,178,189,02
Pittsburg,U.S. House,Jon Douthitt,IND,610005,0,0,16,16,02
Pittsburg,Governor,Joe Dorman,DEM,610006,2,14,111,127,
Pittsburg,Governor,Mary Fallin,REP,610006,7,15,162,184,
Pittsburg,Governor,Kimberly Willis,IND,610006,0,0,5,5,
Pittsburg,Governor,Richard Prawdzienski,IND,610006,0,0,4,4,
Pittsburg,Lieutenant Governor,Cathy Cummings,DEM,610006,2,12,79,93,
Pittsburg,Lieutenant Governor,Todd Lamb,REP,610006,7,17,203,227,
Pittsburg,Superintendent of Public Instruction,John Cox,DEM,610006,3,13,143,159,
Pittsburg,Superintendent of Public Instruction,Joy Hofmeister,REP,610006,6,15,137,158,
Pittsburg,Commissioner of Labor,Mike Workman,DEM,610006,3,12,96,111,
Pittsburg,Commissioner of Labor,Mark Costello,REP,610006,6,15,179,200,
Pittsburg,U.S. Senate,Matt Silverstein,DEM,610006,4,11,64,79,
Pittsburg,U.S. Senate,Jim Inhofe,REP,610006,5,17,208,230,
Pittsburg,U.S. Senate,Aaron Delozier,IND,610006,0,0,3,3,
Pittsburg,U.S. Senate,Ray Woods,IND,610006,0,0,3,3,
Pittsburg,U.S. Senate,Joan Farr,IND,610006,0,0,3,3,
Pittsburg,U.S. Senate,Connie Johnson,DEM,610006,2,11,67,80,
Pittsburg,U.S. Senate,James Lankford,REP,610006,7,17,197,221,
Pittsburg,U.S. Senate,Mark Beard,IND,610006,0,0,13,13,
Pittsburg,U.S. House,Earl Everett,DEM,610006,2,10,55,67,02
Pittsburg,U.S. House,Markwayne Mullin,REP,610006,7,18,204,229,02
Pittsburg,U.S. House,Jon Douthitt,IND,610006,0,0,22,22,02
Pittsburg,Governor,Joe Dorman,DEM,610007,3,17,136,156,
Pittsburg,Governor,Mary Fallin,REP,610007,0,10,163,173,
Pittsburg,Governor,Kimberly Willis,IND,610007,0,0,7,7,
Pittsburg,Governor,Richard Prawdzienski,IND,610007,0,0,7,7,
Pittsburg,Lieutenant Governor,Cathy Cummings,DEM,610007,2,16,98,116,
Pittsburg,Lieutenant Governor,Todd Lamb,REP,610007,1,11,211,223,
Pittsburg,Superintendent of Public Instruction,John Cox,DEM,610007,1,22,158,181,
Pittsburg,Superintendent of Public Instruction,Joy Hofmeister,REP,610007,2,5,153,160,
Pittsburg,Commissioner of Labor,Mike Workman,DEM,610007,1,17,122,140,
Pittsburg,Commissioner of Labor,Mark Costello,REP,610007,2,10,184,196,
Pittsburg,U.S. Senate,Matt Silverstein,DEM,610007,3,12,86,101,
Pittsburg,U.S. Senate,Jim Inhofe,REP,610007,0,14,223,237,
Pittsburg,U.S. Senate,Aaron Delozier,IND,610007,0,0,1,1,
Pittsburg,U.S. Senate,Ray Woods,IND,610007,0,0,0,0,
Pittsburg,U.S. Senate,Joan Farr,IND,610007,0,1,3,4,
Pittsburg,U.S. Senate,Connie Johnson,DEM,610007,1,12,88,101,
Pittsburg,U.S. Senate,James Lankford,REP,610007,2,14,212,228,
Pittsburg,U.S. Senate,Mark Beard,IND,610007,0,1,10,11,
Pittsburg,U.S. House,Earl Everett,DEM,610007,1,12,67,80,02
Pittsburg,U.S. House,Markwayne Mullin,REP,610007,2,14,222,238,02
Pittsburg,U.S. House,Jon Douthitt,IND,610007,0,1,21,22,02
Pittsburg,State House,Brian Renegar,DEM,610007,3,25,228,256,17
Pittsburg,State House,Micah Thompson,REP,610007,0,2,81,83,17
Pittsburg,Governor,Joe Dorman,DEM,610008,0,11,110,121,
Pittsburg,Governor,Mary Fallin,REP,610008,0,6,78,84,
Pittsburg,Governor,Kimberly Willis,IND,610008,0,0,6,6,
Pittsburg,Governor,Richard Prawdzienski,IND,610008,0,0,4,4,
Pittsburg,Lieutenant Governor,Cathy Cummings,DEM,610008,0,9,100,109,
Pittsburg,Lieutenant Governor,Todd Lamb,REP,610008,0,8,99,107,
Pittsburg,Superintendent of Public Instruction,John Cox,DEM,610008,0,10,129,139,
Pittsburg,Superintendent of Public Instruction,Joy Hofmeister,REP,610008,0,7,69,76,
Pittsburg,Commissioner of Labor,Mike Workman,DEM,610008,0,10,122,132,
Pittsburg,Commissioner of Labor,Mark Costello,REP,610008,0,7,73,80,
Pittsburg,U.S. Senate,Matt Silverstein,DEM,610008,0,7,76,83,
Pittsburg,U.S. Senate,Jim Inhofe,REP,610008,0,6,114,120,
Pittsburg,U.S. Senate,Aaron Delozier,IND,610008,0,0,1,1,
Pittsburg,U.S. Senate,Ray Woods,IND,610008,0,1,5,6,
Pittsburg,U.S. Senate,Joan Farr,IND,610008,0,3,3,6,
Pittsburg,U.S. Senate,Connie Johnson,DEM,610008,0,8,87,95,
Pittsburg,U.S. Senate,James Lankford,REP,610008,0,8,95,103,
Pittsburg,U.S. Senate,Mark Beard,IND,610008,0,1,13,14,
Pittsburg,U.S. House,Earl Everett,DEM,610008,0,8,68,76,02
Pittsburg,U.S. House,Markwayne Mullin,REP,610008,0,8,113,121,02
Pittsburg,U.S. House,Jon Douthitt,IND,610008,0,1,16,17,02
Pittsburg,Governor,Joe Dorman,DEM,610011,8,20,200,228,
Pittsburg,Governor,Mary Fallin,REP,610011,4,16,205,225,
Pittsburg,Governor,Kimberly Willis,IND,610011,0,0,14,14,
Pittsburg,Governor,Richard Prawdzienski,IND,610011,0,0,11,11,
Pittsburg,Lieutenant Governor,Cathy Cummings,DEM,610011,8,14,161,183,
Pittsburg,Lieutenant Governor,Todd Lamb,REP,610011,4,22,268,294,
Pittsburg,Superintendent of Public Instruction,John Cox,DEM,610011,9,25,234,268,
Pittsburg,Superintendent of Public Instruction,Joy Hofmeister,REP,610011,3,11,195,209,
Pittsburg,Commissioner of Labor,Mike Workman,DEM,610011,8,17,207,232,
Pittsburg,Commissioner of Labor,Mark Costello,REP,610011,4,17,218,239,
Pittsburg,U.S. Senate,Matt Silverstein,DEM,610011,7,14,119,140,
Pittsburg,U.S. Senate,Jim Inhofe,REP,610011,5,22,297,324,
Pittsburg,U.S. Senate,Aaron Delozier,IND,610011,0,0,3,3,
Pittsburg,U.S. Senate,Ray Woods,IND,610011,0,0,7,7,
Pittsburg,U.S. Senate,Joan Farr,IND,610011,0,0,4,4,
Pittsburg,U.S. Senate,Connie Johnson,DEM,610011,8,15,131,154,
Pittsburg,U.S. Senate,James Lankford,REP,610011,4,19,270,293,
Pittsburg,U.S. Senate,Mark Beard,IND,610011,0,1,27,28,
Pittsburg,U.S. House,Earl Everett,DEM,610011,8,14,108,130,02
Pittsburg,U.S. House,Markwayne Mullin,REP,610011,4,22,298,324,02
Pittsburg,U.S. House,Jon Douthitt,IND,610011,0,0,24,24,02
Pittsburg,Governor,Joe Dorman,DEM,610014,2,24,195,221,
Pittsburg,Governor,Mary Fallin,REP,610014,3,13,211,227,
Pittsburg,Governor,Kimberly Willis,IND,610014,0,2,12,14,
Pittsburg,Governor,Richard Prawdzienski,IND,610014,0,1,2,3,
Pittsburg,Lieutenant Governor,Cathy Cummings,DEM,610014,1,19,150,170,
Pittsburg,Lieutenant Governor,Todd Lamb,REP,610014,4,20,267,291,
Pittsburg,Superintendent of Public Instruction,John Cox,DEM,610014,1,23,223,247,
Pittsburg,Superintendent of Public Instruction,Joy Hofmeister,REP,610014,4,17,197,218,
Pittsburg,Commissioner of Labor,Mike Workman,DEM,610014,1,21,201,223,
Pittsburg,Commissioner of Labor,Mark Costello,REP,610014,4,17,208,229,
Pittsburg,U.S. Senate,Matt Silverstein,DEM,610014,1,18,122,141,
Pittsburg,U.S. Senate,Jim Inhofe,REP,610014,4,22,282,308,
Pittsburg,U.S. Senate,Aaron Delozier,IND,610014,0,0,2,2,
Pittsburg,U.S. Senate,Ray Woods,IND,610014,0,0,2,2,
Pittsburg,U.S. Senate,Joan Farr,IND,610014,0,0,9,9,
Pittsburg,U.S. Senate,Connie Johnson,DEM,610014,1,15,134,150,
Pittsburg,U.S. Senate,James Lankford,REP,610014,4,23,268,295,
Pittsburg,U.S. Senate,Mark Beard,IND,610014,0,1,14,15,
Pittsburg,U.S. House,Earl Everett,DEM,610014,1,13,122,136,02
Pittsburg,U.S. House,Markwayne Mullin,REP,610014,4,22,278,304,02
Pittsburg,U.S. House,Jon Douthitt,IND,610014,0,4,16,20,02
Pittsburg,State House,Brian Renegar,DEM,610014,1,30,282,313,17
Pittsburg,State House,Micah Thompson,REP,610014,4,10,137,151,17
Pittsburg,Governor,Joe Dorman,DEM,610015,0,5,62,67,
Pittsburg,Governor,Mary Fallin,REP,610015,0,1,20,21,
Pittsburg,Governor,Kimberly Willis,IND,610015,1,0,0,1,
Pittsburg,Governor,Richard Prawdzienski,IND,610015,0,0,1,1,
Pittsburg,Lieutenant Governor,Cathy Cummings,DEM,610015,0,4,58,62,
Pittsburg,Lieutenant Governor,Todd Lamb,REP,610015,1,2,25,28,
Pittsburg,Superintendent of Public Instruction,John Cox,DEM,610015,0,5,62,67,
Pittsburg,Superintendent of Public Instruction,Joy Hofmeister,REP,610015,1,1,21,23,
Pittsburg,Commissioner of Labor,Mike Workman,DEM,610015,0,4,63,67,
Pittsburg,Commissioner of Labor,Mark Costello,REP,610015,1,2,20,23,
Pittsburg,U.S. Senate,Matt Silverstein,DEM,610015,0,4,49,53,
Pittsburg,U.S. Senate,Jim Inhofe,REP,610015,0,2,33,35,
Pittsburg,U.S. Senate,Aaron Delozier,IND,610015,0,0,0,0,
Pittsburg,U.S. Senate,Ray Woods,IND,610015,0,0,0,0,
Pittsburg,U.S. Senate,Joan Farr,IND,610015,1,0,0,1,
Pittsburg,U.S. Senate,Connie Johnson,DEM,610015,0,4,60,64,
Pittsburg,U.S. Senate,James Lankford,REP,610015,0,2,23,25,
Pittsburg,U.S. Senate,Mark Beard,IND,610015,1,0,0,1,
Pittsburg,U.S. House,Earl Everett,DEM,610015,0,3,47,50,02
Pittsburg,U.S. House,Markwayne Mullin,REP,610015,0,2,31,33,02
Pittsburg,U.S. House,Jon Douthitt,IND,610015,1,1,3,5,02
Pittsburg,Governor,Joe Dorman,DEM,610019,2,3,53,58,
Pittsburg,Governor,Mary Fallin,REP,610019,2,4,68,74,
Pittsburg,Governor,Kimberly Willis,IND,610019,0,0,4,4,
Pittsburg,Governor,Richard Prawdzienski,IND,610019,0,0,1,1,
Pittsburg,Lieutenant Governor,Cathy Cummings,DEM,610019,2,1,52,55,
Pittsburg,Lieutenant Governor,Todd Lamb,REP,610019,2,6,75,83,
Pittsburg,Superintendent of Public Instruction,John Cox,DEM,610019,2,2,61,65,
Pittsburg,Superintendent of Public Instruction,Joy Hofmeister,REP,610019,2,5,61,68,
Pittsburg,Commissioner of Labor,Mike Workman,DEM,610019,2,2,57,61,
Pittsburg,Commissioner of Labor,Mark Costello,REP,610019,2,5,63,70,
Pittsburg,U.S. Senate,Matt Silverstein,DEM,610019,1,0,35,36,
Pittsburg,U.S. Senate,Jim Inhofe,REP,610019,3,7,90,100,
Pittsburg,U.S. Senate,Aaron Delozier,IND,610019,0,0,0,0,
Pittsburg,U.S. Senate,Ray Woods,IND,610019,0,0,0,0,
Pittsburg,U.S. Senate,Joan Farr,IND,610019,0,0,2,2,
Pittsburg,U.S. Senate,Connie Johnson,DEM,610019,0,1,41,42,
Pittsburg,U.S. Senate,James Lankford,REP,610019,4,6,80,90,
Pittsburg,U.S. Senate,Mark Beard,IND,610019,0,0,5,5,
Pittsburg,U.S. House,Earl Everett,DEM,610019,0,0,35,35,02
Pittsburg,U.S. House,Markwayne Mullin,REP,610019,4,7,85,96,02
Pittsburg,U.S. House,Jon Douthitt,IND,610019,0,0,6,6,02
Pittsburg,State House,Brian Renegar,DEM,610019,3,3,78,84,17
Pittsburg,State House,Micah Thompson,REP,610019,1,4,48,53,17
Pittsburg,Governor,Joe Dorman,DEM,610020,0,3,30,33,
Pittsburg,Governor,Mary Fallin,REP,610020,0,1,26,27,
Pittsburg,Governor,Kimberly Willis,IND,610020,0,0,0,0,
Pittsburg,Governor,Richard Prawdzienski,IND,610020,0,0,0,0,
Pittsburg,Lieutenant Governor,Cathy Cummings,DEM,610020,0,3,20,23,
Pittsburg,Lieutenant Governor,Todd Lamb,REP,610020,0,1,36,37,
Pittsburg,Superintendent of Public Instruction,John Cox,DEM,610020,0,4,41,45,
Pittsburg,Superintendent of Public Instruction,Joy Hofmeister,REP,610020,0,0,12,12,
Pittsburg,Commissioner of Labor,Mike Workman,DEM,610020,0,3,30,33,
Pittsburg,Commissioner of Labor,Mark Costello,REP,610020,0,1,25,26,
Pittsburg,U.S. Senate,Matt Silverstein,DEM,610020,0,3,20,23,
Pittsburg,U.S. Senate,Jim Inhofe,REP,610020,0,1,35,36,
Pittsburg,U.S. Senate,Aaron Delozier,IND,610020,0,0,0,0,
Pittsburg,U.S. Senate,Ray Woods,IND,610020,0,0,1,1,
Pittsburg,U.S. Senate,Joan Farr,IND,610020,0,0,0,0,
Pittsburg,U.S. Senate,Connie Johnson,DEM,610020,0,3,24,27,
Pittsburg,U.S. Senate,James Lankford,REP,610020,0,1,32,33,
Pittsburg,U.S. Senate,Mark Beard,IND,610020,0,0,0,0,
Pittsburg,U.S. House,Earl Everett,DEM,610020,0,3,17,20,02
Pittsburg,U.S. House,Markwayne Mullin,REP,610020,0,1,34,35,02
Pittsburg,U.S. House,Jon Douthitt,IND,610020,0,0,5,5,02
Pittsburg,State House,Brian Renegar,DEM,610020,0,4,47,51,17
Pittsburg,State House,Micah Thompson,REP,610020,0,0,9,9,17
Pittsburg,Governor,Joe Dorman,DEM,610021,3,17,154,174,
Pittsburg,Governor,Mary Fallin,REP,610021,0,13,182,195,
Pittsburg,Governor,Kimberly Willis,IND,610021,0,0,8,8,
Pittsburg,Governor,Richard Prawdzienski,IND,610021,0,0,3,3,
Pittsburg,Lieutenant Governor,Cathy Cummings,DEM,610021,2,14,120,136,
Pittsburg,Lieutenant Governor,Todd Lamb,REP,610021,1,16,226,243,
Pittsburg,Superintendent of Public Instruction,John Cox,DEM,610021,3,17,200,220,
Pittsburg,Superintendent of Public Instruction,Joy Hofmeister,REP,610021,0,13,144,157,
Pittsburg,Commissioner of Labor,Mike Workman,DEM,610021,2,14,164,180,
Pittsburg,Commissioner of Labor,Mark Costello,REP,610021,1,15,178,194,
Pittsburg,U.S. Senate,Matt Silverstein,DEM,610021,1,10,100,111,
Pittsburg,U.S. Senate,Jim Inhofe,REP,610021,2,19,237,258,
Pittsburg,U.S. Senate,Aaron Delozier,IND,610021,0,0,1,1,
Pittsburg,U.S. Senate,Ray Woods,IND,610021,0,1,8,9,
Pittsburg,U.S. Senate,Joan Farr,IND,610021,0,0,2,2,
Pittsburg,U.S. Senate,Connie Johnson,DEM,610021,0,13,115,128,
Pittsburg,U.S. Senate,James Lankford,REP,610021,2,17,220,239,
Pittsburg,U.S. Senate,Mark Beard,IND,610021,1,0,9,10,
Pittsburg,U.S. House,Earl Everett,DEM,610021,0,10,92,102,02
Pittsburg,U.S. House,Markwayne Mullin,REP,610021,3,20,232,255,02
Pittsburg,U.S. House,Jon Douthitt,IND,610021,0,0,20,20,02
Pittsburg,Governor,Joe Dorman,DEM,610023,0,3,32,35,
Pittsburg,Governor,Mary Fallin,REP,610023,2,0,44,46,
Pittsburg,Governor,Kimberly Willis,IND,610023,0,0,2,2,
Pittsburg,Governor,Richard Prawdzienski,IND,610023,0,0,0,0,
Pittsburg,Lieutenant Governor,Cathy Cummings,DEM,610023,0,3,25,28,
Pittsburg,Lieutenant Governor,Todd Lamb,REP,610023,2,0,53,55,
Pittsburg,Superintendent of Public Instruction,John Cox,DEM,610023,1,3,48,52,
Pittsburg,Superintendent of Public Instruction,Joy Hofmeister,REP,610023,1,0,29,30,
Pittsburg,Commissioner of Labor,Mike Workman,DEM,610023,0,3,37,40,
Pittsburg,Commissioner of Labor,Mark Costello,REP,610023,2,0,41,43,
Pittsburg,U.S. Senate,Matt Silverstein,DEM,610023,0,1,17,18,
Pittsburg,U.S. Senate,Jim Inhofe,REP,610023,2,2,58,62,
Pittsburg,U.S. Senate,Aaron Delozier,IND,610023,0,0,0,0,
Pittsburg,U.S. Senate,Ray Woods,IND,610023,0,0,3,3,
Pittsburg,U.S. Senate,Joan Farr,IND,610023,0,0,0,0,
Pittsburg,U.S. Senate,Connie Johnson,DEM,610023,0,1,17,18,
Pittsburg,U.S. Senate,James Lankford,REP,610023,2,2,60,64,
Pittsburg,U.S. Senate,Mark Beard,IND,610023,0,0,1,1,
Pittsburg,U.S. House,Earl Everett,DEM,610023,0,1,19,20,02
Pittsburg,U.S. House,Markwayne Mullin,REP,610023,2,2,57,61,02
Pittsburg,U.S. House,Jon Douthitt,IND,610023,0,0,2,2,02
Pittsburg,Governor,Joe Dorman,DEM,610026,0,2,72,74,
Pittsburg,Governor,Mary Fallin,REP,610026,3,14,113,130,
Pittsburg,Governor,Kimberly Willis,IND,610026,0,0,5,5,
Pittsburg,Governor,Richard Prawdzienski,IND,610026,0,0,4,4,
Pittsburg,Lieutenant Governor,Cathy Cummings,DEM,610026,0,2,60,62,
Pittsburg,Lieutenant Governor,Todd Lamb,REP,610026,3,14,134,151,
Pittsburg,Superintendent of Public Instruction,John Cox,DEM,610026,0,7,100,107,
Pittsburg,Superintendent of Public Instruction,Joy Hofmeister,REP,610026,3,9,92,104,
Pittsburg,Commissioner of Labor,Mike Workman,DEM,610026,0,2,88,90,
Pittsburg,Commissioner of Labor,Mark Costello,REP,610026,3,13,103,119,
Pittsburg,U.S. Senate,Matt Silverstein,DEM,610026,0,2,34,36,
Pittsburg,U.S. Senate,Jim Inhofe,REP,610026,2,14,153,169,
Pittsburg,U.S. Senate,Aaron Delozier,IND,610026,0,0,1,1,
Pittsburg,U.S. Senate,Ray Woods,IND,610026,0,0,1,1,
Pittsburg,U.S. Senate,Joan Farr,IND,610026,1,0,3,4,
Pittsburg,U.S. Senate,Connie Johnson,DEM,610026,0,2,52,54,
Pittsburg,U.S. Senate,James Lankford,REP,610026,2,14,133,149,
Pittsburg,U.S. Senate,Mark Beard,IND,610026,1,0,7,8,
Pittsburg,U.S. House,Earl Everett,DEM,610026,0,1,34,35,02
Pittsburg,U.S. House,Markwayne Mullin,REP,610026,2,15,151,168,02
Pittsburg,U.S. House,Jon Douthitt,IND,610026,1,0,8,9,02
Pittsburg,State House,Brian Renegar,DEM,610026,1,5,118,124,17
Pittsburg,State House,Micah Thompson,REP,610026,2,11,76,89,17
Pittsburg,Governor,Joe Dorman,DEM,610027,2,8,174,184,
Pittsburg,Governor,Mary Fallin,REP,610027,5,6,355,366,
Pittsburg,Governor,Kimberly Willis,IND,610027,0,1,18,19,
Pittsburg,Governor,Richard Prawdzienski,IND,610027,0,0,3,3,
Pittsburg,Lieutenant Governor,Cathy Cummings,DEM,610027,1,5,131,137,
Pittsburg,Lieutenant Governor,Todd Lamb,REP,610027,6,10,415,431,
Pittsburg,Superintendent of Public Instruction,John Cox,DEM,610027,3,8,201,212,
Pittsburg,Superintendent of Public Instruction,Joy Hofmeister,REP,610027,4,7,347,358,
Pittsburg,Commissioner of Labor,Mike Workman,DEM,610027,1,8,185,194,
Pittsburg,Commissioner of Labor,Mark Costello,REP,610027,6,6,356,368,
Pittsburg,U.S. Senate,Matt Silverstein,DEM,610027,1,4,124,129,
Pittsburg,U.S. Senate,Jim Inhofe,REP,610027,6,10,401,417,
Pittsburg,U.S. Senate,Aaron Delozier,IND,610027,0,0,6,6,
Pittsburg,U.S. Senate,Ray Woods,IND,610027,0,0,6,6,
Pittsburg,U.S. Senate,Joan Farr,IND,610027,0,1,11,12,
Pittsburg,U.S. Senate,Connie Johnson,DEM,610027,1,4,130,135,
Pittsburg,U.S. Senate,James Lankford,REP,610027,6,10,396,412,
Pittsburg,U.S. Senate,Mark Beard,IND,610027,0,1,21,22,
Pittsburg,U.S. House,Earl Everett,DEM,610027,1,4,103,108,02
Pittsburg,U.S. House,Markwayne Mullin,REP,610027,5,10,423,438,02
Pittsburg,U.S. House,Jon Douthitt,IND,610027,1,1,22,24,02
Pittsburg,Governor,Joe Dorman,DEM,610028,0,0,49,49,
Pittsburg,Governor,Mary Fallin,REP,610028,0,2,62,64,
Pittsburg,Governor,Kimberly Willis,IND,610028,0,0,5,5,
Pittsburg,Governor,Richard Prawdzienski,IND,610028,0,0,1,1,
Pittsburg,Lieutenant Governor,Cathy Cummings,DEM,610028,0,1,32,33,
Pittsburg,Lieutenant Governor,Todd Lamb,REP,610028,0,1,84,85,
Pittsburg,Superintendent of Public Instruction,John Cox,DEM,610028,0,1,62,63,
Pittsburg,Superintendent of Public Instruction,Joy Hofmeister,REP,610028,0,1,56,57,
Pittsburg,Commissioner of Labor,Mike Workman,DEM,610028,0,1,49,50,
Pittsburg,Commissioner of Labor,Mark Costello,REP,610028,0,1,66,67,
Pittsburg,U.S. Senate,Matt Silverstein,DEM,610028,0,0,25,25,
Pittsburg,U.S. Senate,Jim Inhofe,REP,610028,0,2,89,91,
Pittsburg,U.S. Senate,Aaron Delozier,IND,610028,0,0,0,0,
Pittsburg,U.S. Senate,Ray Woods,IND,610028,0,0,2,2,
Pittsburg,U.S. Senate,Joan Farr,IND,610028,0,0,0,0,
Pittsburg,U.S. Senate,Connie Johnson,DEM,610028,0,1,36,37,
Pittsburg,U.S. Senate,James Lankford,REP,610028,0,1,77,78,
Pittsburg,U.S. Senate,Mark Beard,IND,610028,0,0,3,3,
Pittsburg,U.S. House,Earl Everett,DEM,610028,0,0,26,26,02
Pittsburg,U.S. House,Markwayne Mullin,REP,610028,0,2,88,90,02
Pittsburg,U.S. House,Jon Douthitt,IND,610028,0,0,2,2,02
Pittsburg,Governor,Joe Dorman,DEM,610029,1,5,69,75,
Pittsburg,Governor,Mary Fallin,REP,610029,0,1,91,92,
Pittsburg,Governor,Kimberly Willis,IND,610029,0,0,5,5,
Pittsburg,Governor,Richard Prawdzienski,IND,610029,0,0,2,2,
Pittsburg,Lieutenant Governor,Cathy Cummings,DEM,610029,1,5,41,47,
Pittsburg,Lieutenant Governor,Todd Lamb,REP,610029,0,1,125,126,
Pittsburg,Superintendent of Public Instruction,John Cox,DEM,610029,1,5,92,98,
Pittsburg,Superintendent of Public Instruction,Joy Hofmeister,REP,610029,0,1,72,73,
Pittsburg,Commissioner of Labor,Mike Workman,DEM,610029,1,4,71,76,
Pittsburg,Commissioner of Labor,Mark Costello,REP,610029,0,2,90,92,
Pittsburg,U.S. Senate,Matt Silverstein,DEM,610029,1,3,38,42,
Pittsburg,U.S. Senate,Jim Inhofe,REP,610029,0,3,122,125,
Pittsburg,U.S. Senate,Aaron Delozier,IND,610029,0,0,0,0,
Pittsburg,U.S. Senate,Ray Woods,IND,610029,0,0,2,2,
Pittsburg,U.S. Senate,Joan Farr,IND,610029,0,0,3,3,
Pittsburg,U.S. Senate,Connie Johnson,DEM,610029,1,4,39,44,
Pittsburg,U.S. Senate,James Lankford,REP,610029,0,2,119,121,
Pittsburg,U.S. Senate,Mark Beard,IND,610029,0,0,7,7,
Pittsburg,U.S. House,Earl Everett,DEM,610029,1,2,36,39,02
Pittsburg,U.S. House,Markwayne Mullin,REP,610029,0,4,125,129,02
Pittsburg,U.S. House,Jon Douthitt,IND,610029,0,0,5,5,02
Pittsburg,State House,Brian Renegar,DEM,610029,1,4,102,107,17
Pittsburg,State House,Micah Thompson,REP,610029,0,1,65,66,17
Pittsburg,Governor,Joe Dorman,DEM,610030,0,2,60,62,
Pittsburg,Governor,Mary Fallin,REP,610030,2,3,65,70,
Pittsburg,Governor,Kimberly Willis,IND,610030,0,0,3,3,
Pittsburg,Governor,Richard Prawdzienski,IND,610030,0,0,2,2,
Pittsburg,Lieutenant Governor,Cathy Cummings,DEM,610030,0,1,47,48,
Pittsburg,Lieutenant Governor,Todd Lamb,REP,610030,2,4,83,89,
Pittsburg,Superintendent of Public Instruction,John Cox,DEM,610030,0,2,69,71,
Pittsburg,Superintendent of Public Instruction,Joy Hofmeister,REP,610030,2,3,60,65,
Pittsburg,Commissioner of Labor,Mike Workman,DEM,610030,0,1,56,57,
Pittsburg,Commissioner of Labor,Mark Costello,REP,610030,2,3,72,77,
Pittsburg,U.S. Senate,Matt Silverstein,DEM,610030,0,1,32,33,
Pittsburg,U.S. Senate,Jim Inhofe,REP,610030,1,4,93,98,
Pittsburg,U.S. Senate,Aaron Delozier,IND,610030,0,0,0,0,
Pittsburg,U.S. Senate,Ray Woods,IND,610030,0,0,2,2,
Pittsburg,U.S. Senate,Joan Farr,IND,610030,0,0,3,3,
Pittsburg,U.S. Senate,Connie Johnson,DEM,610030,0,1,42,43,
Pittsburg,U.S. Senate,James Lankford,REP,610030,2,4,85,91,
Pittsburg,U.S. Senate,Mark Beard,IND,610030,0,0,3,3,
Pittsburg,U.S. House,Earl Everett,DEM,610030,0,1,37,38,02
Pittsburg,U.S. House,Markwayne Mullin,REP,610030,2,4,86,92,02
Pittsburg,U.S. House,Jon Douthitt,IND,610030,0,0,6,6,02
Pittsburg,State House,Brian Renegar,DEM,610030,1,2,71,74,17
Pittsburg,State House,Micah Thompson,REP,610030,1,2,59,62,17
Pittsburg,Governor,Joe Dorman,DEM,610031,0,0,58,58,
Pittsburg,Governor,Mary Fallin,REP,610031,3,10,174,187,
Pittsburg,Governor,Kimberly Willis,IND,610031,0,0,3,3,
Pittsburg,Governor,Richard Prawdzienski,IND,610031,0,0,1,1,
Pittsburg,Lieutenant Governor,Cathy Cummings,DEM,610031,0,0,50,50,
Pittsburg,Lieutenant Governor,Todd Lamb,REP,610031,3,10,187,200,
Pittsburg,Superintendent of Public Instruction,John Cox,DEM,610031,0,0,82,82,
Pittsburg,Superintendent of Public Instruction,Joy Hofmeister,REP,610031,3,10,152,165,
Pittsburg,Commissioner of Labor,Mike Workman,DEM,610031,0,0,78,78,
Pittsburg,Commissioner of Labor,Mark Costello,REP,610031,3,9,155,167,
Pittsburg,U.S. Senate,Matt Silverstein,DEM,610031,0,0,39,39,
Pittsburg,U.S. Senate,Jim Inhofe,REP,610031,3,9,185,197,
Pittsburg,U.S. Senate,Aaron Delozier,IND,610031,0,0,1,1,
Pittsburg,U.S. Senate,Ray Woods,IND,610031,0,0,6,6,
Pittsburg,U.S. Senate,Joan Farr,IND,610031,0,0,5,5,
Pittsburg,U.S. Senate,Connie Johnson,DEM,610031,0,0,52,52,
Pittsburg,U.S. Senate,James Lankford,REP,610031,3,9,177,189,
Pittsburg,U.S. Senate,Mark Beard,IND,610031,0,0,8,8,
Pittsburg,U.S. House,Earl Everett,DEM,610031,0,0,37,37,02
Pittsburg,U.S. House,Markwayne Mullin,REP,610031,3,9,187,199,02
Pittsburg,U.S. House,Jon Douthitt,IND,610031,0,0,13,13,02
Pittsburg,State House,Brian Renegar,DEM,610031,1,2,108,111,17
Pittsburg,State House,Micah Thompson,REP,610031,2,8,128,138,17
Pittsburg,Governor,Joe Dorman,DEM,610032,7,41,203,251,
Pittsburg,Governor,Mary Fallin,REP,610032,5,42,321,368,
Pittsburg,Governor,Kimberly Willis,IND,610032,0,2,10,12,
Pittsburg,Governor,Richard Prawdzienski,IND,610032,0,0,5,5,
Pittsburg,Lieutenant Governor,Cathy Cummings,DEM,610032,5,27,140,172,
Pittsburg,Lieutenant Governor,Todd Lamb,REP,610032,7,58,391,456,
Pittsburg,Superintendent of Public Instruction,John Cox,DEM,610032,7,46,257,310,
Pittsburg,Superintendent of Public Instruction,Joy Hofmeister,REP,610032,5,39,276,320,
Pittsburg,Commissioner of Labor,Mike Workman,DEM,610032,5,37,179,221,
Pittsburg,Commissioner of Labor,Mark Costello,REP,610032,7,46,340,393,
Pittsburg,U.S. Senate,Matt Silverstein,DEM,610032,7,23,106,136,
Pittsburg,U.S. Senate,Jim Inhofe,REP,610032,5,60,418,483,
Pittsburg,U.S. Senate,Aaron Delozier,IND,610032,0,1,2,3,
Pittsburg,U.S. Senate,Ray Woods,IND,610032,0,0,7,7,
Pittsburg,U.S. Senate,Joan Farr,IND,610032,0,1,3,4,
Pittsburg,U.S. Senate,Connie Johnson,DEM,610032,5,26,124,155,
Pittsburg,U.S. Senate,James Lankford,REP,610032,7,56,393,456,
Pittsburg,U.S. Senate,Mark Beard,IND,610032,0,3,18,21,
Pittsburg,U.S. House,Earl Everett,DEM,610032,5,25,100,130,02
Pittsburg,U.S. House,Markwayne Mullin,REP,610032,7,58,416,481,02
Pittsburg,U.S. House,Jon Douthitt,IND,610032,0,2,22,24,02
Pittsburg,State House,Brian Renegar,DEM,610032,9,66,359,434,17
Pittsburg,State House,Micah Thompson,REP,610032,3,19,179,201,17
Pittsburg,Governor,Joe Dorman,DEM,610033,0,3,116,119,
Pittsburg,Governor,Mary Fallin,REP,610033,0,3,108,111,
Pittsburg,Governor,Kimberly Willis,IND,610033,0,0,7,7,
Pittsburg,Governor,Richard Prawdzienski,IND,610033,0,0,3,3,
Pittsburg,Lieutenant Governor,Cathy Cummings,DEM,610033,0,3,90,93,
Pittsburg,Lieutenant Governor,Todd Lamb,REP,610033,0,3,142,145,
Pittsburg,Superintendent of Public Instruction,John Cox,DEM,610033,0,3,135,138,
Pittsburg,Superintendent of Public Instruction,Joy Hofmeister,REP,610033,0,3,97,100,
Pittsburg,Commissioner of Labor,Mike Workman,DEM,610033,0,2,112,114,
Pittsburg,Commissioner of Labor,Mark Costello,REP,610033,0,4,117,121,
Pittsburg,U.S. Senate,Matt Silverstein,DEM,610033,0,2,67,69,
Pittsburg,U.S. Senate,Jim Inhofe,REP,610033,0,4,158,162,
Pittsburg,U.S. Senate,Aaron Delozier,IND,610033,0,0,3,3,
Pittsburg,U.S. Senate,Ray Woods,IND,610033,0,0,3,3,
Pittsburg,U.S. Senate,Joan Farr,IND,610033,0,0,2,2,
Pittsburg,U.S. Senate,Connie Johnson,DEM,610033,0,2,77,79,
Pittsburg,U.S. Senate,James Lankford,REP,610033,0,4,144,148,
Pittsburg,U.S. Senate,Mark Beard,IND,610033,0,0,9,9,
Pittsburg,U.S. House,Earl Everett,DEM,610033,0,3,70,73,02
Pittsburg,U.S. House,Markwayne Mullin,REP,610033,0,3,150,153,02
Pittsburg,U.S. House,Jon Douthitt,IND,610033,0,0,10,10,02
Pittsburg,State House,Brian Renegar,DEM,610033,0,3,157,160,17
Pittsburg,State House,Micah Thompson,REP,610033,0,3,74,77,17
Pittsburg,Governor,Joe Dorman,DEM,610034,5,4,202,211,
Pittsburg,Governor,Mary Fallin,REP,610034,0,4,136,140,
Pittsburg,Governor,Kimberly Willis,IND,610034,0,0,9,9,
Pittsburg,Governor,Richard Prawdzienski,IND,610034,0,1,3,4,
Pittsburg,Lieutenant Governor,Cathy Cummings,DEM,610034,5,4,149,158,
Pittsburg,Lieutenant Governor,Todd Lamb,REP,610034,0,5,197,202,
Pittsburg,Superintendent of Public Instruction,John Cox,DEM,610034,5,6,212,223,
Pittsburg,Superintendent of Public Instruction,Joy Hofmeister,REP,610034,0,3,135,138,
Pittsburg,Commissioner of Labor,Mike Workman,DEM,610034,5,6,198,209,
Pittsburg,Commissioner of Labor,Mark Costello,REP,610034,0,3,150,153,
Pittsburg,U.S. Senate,Matt Silverstein,DEM,610034,5,4,123,132,
Pittsburg,U.S. Senate,Jim Inhofe,REP,610034,0,5,216,221,
Pittsburg,U.S. Senate,Aaron Delozier,IND,610034,0,0,0,0,
Pittsburg,U.S. Senate,Ray Woods,IND,610034,0,0,8,8,
Pittsburg,U.S. Senate,Joan Farr,IND,610034,0,0,1,1,
Pittsburg,U.S. Senate,Connie Johnson,DEM,610034,5,4,133,142,
Pittsburg,U.S. Senate,James Lankford,REP,610034,0,4,192,196,
Pittsburg,U.S. Senate,Mark Beard,IND,610034,0,1,17,18,
Pittsburg,U.S. House,Earl Everett,DEM,610034,5,4,113,122,02
Pittsburg,U.S. House,Markwayne Mullin,REP,610034,0,4,220,224,02
Pittsburg,U.S. House,Jon Douthitt,IND,610034,0,1,12,13,02
Pittsburg,State House,Brian Renegar,DEM,610034,5,6,245,256,17
Pittsburg,State House,Micah Thompson,REP,610034,0,3,104,107,17
Pittsburg,Governor,Joe Dorman,DEM,610035,4,4,138,146,
Pittsburg,Governor,Mary Fallin,REP,610035,1,5,80,86,
Pittsburg,Governor,Kimberly Willis,IND,610035,0,1,8,9,
Pittsburg,Governor,Richard Prawdzienski,IND,610035,0,0,0,0,
Pittsburg,Lieutenant Governor,Cathy Cummings,DEM,610035,4,4,105,113,
Pittsburg,Lieutenant Governor,Todd Lamb,REP,610035,1,6,118,125,
Pittsburg,Superintendent of Public Instruction,John Cox,DEM,610035,4,5,155,164,
Pittsburg,Superintendent of Public Instruction,Joy Hofmeister,REP,610035,0,5,71,76,
Pittsburg,Commissioner of Labor,Mike Workman,DEM,610035,4,5,139,148,
Pittsburg,Commissioner of Labor,Mark Costello,REP,610035,0,4,80,84,
Pittsburg,U.S. Senate,Matt Silverstein,DEM,610035,4,4,94,102,
Pittsburg,U.S. Senate,Jim Inhofe,REP,610035,0,5,121,126,
Pittsburg,U.S. Senate,Aaron Delozier,IND,610035,0,0,2,2,
Pittsburg,U.S. Senate,Ray Woods,IND,610035,0,0,2,2,
Pittsburg,U.S. Senate,Joan Farr,IND,610035,0,0,3,3,
Pittsburg,U.S. Senate,Connie Johnson,DEM,610035,4,4,95,103,
Pittsburg,U.S. Senate,James Lankford,REP,610035,0,5,119,124,
Pittsburg,U.S. Senate,Mark Beard,IND,610035,0,1,9,10,
Pittsburg,U.S. House,Earl Everett,DEM,610035,4,4,86,94,02
Pittsburg,U.S. House,Markwayne Mullin,REP,610035,0,6,121,127,02
Pittsburg,U.S. House,Jon Douthitt,IND,610035,0,0,16,16,02
Pittsburg,State House,Brian Renegar,DEM,610035,4,7,172,183,17
Pittsburg,State House,Micah Thompson,REP,610035,0,2,53,55,17
Pittsburg,Governor,Joe Dorman,DEM,610036,5,5,40,50,
Pittsburg,Governor,Mary Fallin,REP,610036,1,5,47,53,
Pittsburg,Governor,Kimberly Willis,IND,610036,0,0,3,3,
Pittsburg,Governor,Richard Prawdzienski,IND,610036,0,0,1,1,
Pittsburg,Lieutenant Governor,Cathy Cummings,DEM,610036,5,5,29,39,
Pittsburg,Lieutenant Governor,Todd Lamb,REP,610036,1,5,61,67,
Pittsburg,Superintendent of Public Instruction,John Cox,DEM,610036,5,7,54,66,
Pittsburg,Superintendent of Public Instruction,Joy Hofmeister,REP,610036,1,3,37,41,
Pittsburg,Commissioner of Labor,Mike Workman,DEM,610036,5,7,41,53,
Pittsburg,Commissioner of Labor,Mark Costello,REP,610036,1,2,49,52,
Pittsburg,U.S. Senate,Matt Silverstein,DEM,610036,5,3,19,27,
Pittsburg,U.S. Senate,Jim Inhofe,REP,610036,1,6,69,76,
Pittsburg,U.S. Senate,Aaron Delozier,IND,610036,0,0,1,1,
Pittsburg,U.S. Senate,Ray Woods,IND,610036,0,0,1,1,
Pittsburg,U.S. Senate,Joan Farr,IND,610036,0,0,1,1,
Pittsburg,U.S. Senate,Connie Johnson,DEM,610036,5,6,27,38,
Pittsburg,U.S. Senate,James Lankford,REP,610036,1,4,56,61,
Pittsburg,U.S. Senate,Mark Beard,IND,610036,0,0,8,8,
Pittsburg,U.S. House,Earl Everett,DEM,610036,5,4,18,27,02
Pittsburg,U.S. House,Markwayne Mullin,REP,610036,1,5,67,73,02
Pittsburg,U.S. House,Jon Douthitt,IND,610036,0,0,6,6,02
Pittsburg,Governor,Joe Dorman,DEM,610037,0,13,181,194,
Pittsburg,Governor,Mary Fallin,REP,610037,10,13,224,247,
Pittsburg,Governor,Kimberly Willis,IND,610037,0,1,7,8,
Pittsburg,Governor,Richard Prawdzienski,IND,610037,0,0,4,4,
Pittsburg,Lieutenant Governor,Cathy Cummings,DEM,610037,0,10,111,121,
Pittsburg,Lieutenant Governor,Todd Lamb,REP,610037,10,16,304,330,
Pittsburg,Superintendent of Public Instruction,John Cox,DEM,610037,3,14,216,233,
Pittsburg,Superintendent of Public Instruction,Joy Hofmeister,REP,610037,7,13,198,218,
Pittsburg,Commissioner of Labor,Mike Workman,DEM,610037,3,14,179,196,
Pittsburg,Commissioner of Labor,Mark Costello,REP,610037,7,11,226,244,
Pittsburg,U.S. Senate,Matt Silverstein,DEM,610037,0,4,80,84,
Pittsburg,U.S. Senate,Jim Inhofe,REP,610037,10,22,330,362,
Pittsburg,U.S. Senate,Aaron Delozier,IND,610037,0,0,3,3,
Pittsburg,U.S. Senate,Ray Woods,IND,610037,0,0,1,1,
Pittsburg,U.S. Senate,Joan Farr,IND,610037,0,1,3,4,
Pittsburg,U.S. Senate,Connie Johnson,DEM,610037,0,9,108,117,
Pittsburg,U.S. Senate,James Lankford,REP,610037,9,17,289,315,
Pittsburg,U.S. Senate,Mark Beard,IND,610037,1,1,14,16,
Pittsburg,U.S. House,Earl Everett,DEM,610037,0,4,91,95,02
Pittsburg,U.S. House,Markwayne Mullin,REP,610037,10,23,304,337,02
Pittsburg,U.S. House,Jon Douthitt,IND,610037,0,0,18,18,02
Pittsburg,Governor,Joe Dorman,DEM,610038,0,0,10,10,
Pittsburg,Governor,Mary Fallin,REP,610038,0,0,19,19,
Pittsburg,Governor,Kimberly Willis,IND,610038,0,0,1,1,
Pittsburg,Governor,Richard Prawdzienski,IND,610038,0,0,0,0,
Pittsburg,Lieutenant Governor,Cathy Cummings,DEM,610038,0,0,7,7,
Pittsburg,Lieutenant Governor,Todd Lamb,REP,610038,0,0,23,23,
Pittsburg,Superintendent of Public Instruction,John Cox,DEM,610038,0,0,11,11,
Pittsburg,Superintendent of Public Instruction,Joy Hofmeister,REP,610038,0,0,19,19,
Pittsburg,Commissioner of Labor,Mike Workman,DEM,610038,0,0,8,8,
Pittsburg,Commissioner of Labor,Mark Costello,REP,610038,0,0,22,22,
Pittsburg,U.S. Senate,Matt Silverstein,DEM,610038,0,0,9,9,
Pittsburg,U.S. Senate,Jim Inhofe,REP,610038,0,0,21,21,
Pittsburg,U.S. Senate,Aaron Delozier,IND,610038,0,0,0,0,
Pittsburg,U.S. Senate,Ray Woods,IND,610038,0,0,0,0,
Pittsburg,U.S. Senate,Joan Farr,IND,610038,0,0,0,0,
Pittsburg,U.S. Senate,Connie Johnson,DEM,610038,0,0,7,7,
Pittsburg,U.S. Senate,James Lankford,REP,610038,0,0,23,23,
Pittsburg,U.S. Senate,Mark Beard,IND,610038,0,0,0,0,
Pittsburg,U.S. House,Earl Everett,DEM,610038,0,0,7,7,02
Pittsburg,U.S. House,Markwayne Mullin,REP,610038,0,0,22,22,02
Pittsburg,U.S. House,Jon Douthitt,IND,610038,0,0,1,1,02
Pittsburg,State House,Brian Renegar,DEM,610038,0,0,12,12,17
Pittsburg,State House,Micah Thompson,REP,610038,0,0,18,18,17
Pittsburg,Governor,Joe Dorman,DEM,610039,0,2,106,108,
Pittsburg,Governor,Mary Fallin,REP,610039,0,1,127,128,
Pittsburg,Governor,Kimberly Willis,IND,610039,0,0,10,10,
Pittsburg,Governor,Richard Prawdzienski,IND,610039,0,0,6,6,
Pittsburg,Lieutenant Governor,Cathy Cummings,DEM,610039,0,2,67,69,
Pittsburg,Lieutenant Governor,Todd Lamb,REP,610039,0,1,181,182,
Pittsburg,Superintendent of Public Instruction,John Cox,DEM,610039,0,2,146,148,
Pittsburg,Superintendent of Public Instruction,Joy Hofmeister,REP,610039,0,1,104,105,
Pittsburg,Commissioner of Labor,Mike Workman,DEM,610039,0,2,111,113,
Pittsburg,Commissioner of Labor,Mark Costello,REP,610039,0,1,134,135,
Pittsburg,U.S. Senate,Matt Silverstein,DEM,610039,0,2,61,63,
Pittsburg,U.S. Senate,Jim Inhofe,REP,610039,0,1,183,184,
Pittsburg,U.S. Senate,Aaron Delozier,IND,610039,0,0,0,0,
Pittsburg,U.S. Senate,Ray Woods,IND,610039,0,0,3,3,
Pittsburg,U.S. Senate,Joan Farr,IND,610039,0,0,4,4,
Pittsburg,U.S. Senate,Connie Johnson,DEM,610039,0,2,66,68,
Pittsburg,U.S. Senate,James Lankford,REP,610039,0,1,172,173,
Pittsburg,U.S. Senate,Mark Beard,IND,610039,0,0,11,11,
Pittsburg,U.S. House,Earl Everett,DEM,610039,0,2,53,55,02
Pittsburg,U.S. House,Markwayne Mullin,REP,610039,0,1,183,184,02
Pittsburg,U.S. House,Jon Douthitt,IND,610039,0,0,13,13,02
Pittsburg,Governor,Joe Dorman,DEM,610040,1,9,103,113,
Pittsburg,Governor,Mary Fallin,REP,610040,1,8,105,114,
Pittsburg,Governor,Kimberly Willis,IND,610040,0,1,6,7,
Pittsburg,Governor,Richard Prawdzienski,IND,610040,0,0,1,1,
Pittsburg,Lieutenant Governor,Cathy Cummings,DEM,610040,1,6,65,72,
Pittsburg,Lieutenant Governor,Todd Lamb,REP,610040,1,11,150,162,
Pittsburg,Superintendent of Public Instruction,John Cox,DEM,610040,2,11,121,134,
Pittsburg,Superintendent of Public Instruction,Joy Hofmeister,REP,610040,0,7,94,101,
Pittsburg,Commissioner of Labor,Mike Workman,DEM,610040,1,10,96,107,
Pittsburg,Commissioner of Labor,Mark Costello,REP,610040,1,8,112,121,
Pittsburg,U.S. Senate,Matt Silverstein,DEM,610040,1,5,43,49,
Pittsburg,U.S. Senate,Jim Inhofe,REP,610040,1,13,169,183,
Pittsburg,U.S. Senate,Aaron Delozier,IND,610040,0,0,1,1,
Pittsburg,U.S. Senate,Ray Woods,IND,610040,0,0,1,1,
Pittsburg,U.S. Senate,Joan Farr,IND,610040,0,0,2,2,
Pittsburg,U.S. Senate,Connie Johnson,DEM,610040,1,6,60,67,
Pittsburg,U.S. Senate,James Lankford,REP,610040,1,12,143,156,
Pittsburg,U.S. Senate,Mark Beard,IND,610040,0,0,10,10,
Pittsburg,U.S. House,Earl Everett,DEM,610040,1,5,41,47,02
Pittsburg,U.S. House,Markwayne Mullin,REP,610040,1,13,172,186,02
Pittsburg,U.S. House,Jon Douthitt,IND,610040,0,0,2,2,02
Pittsburg,State House,Brian Renegar,DEM,610040,2,13,145,160,17
Pittsburg,State House,Micah Thompson,REP,610040,0,5,70,75,17
Pittsburg,Governor,Joe Dorman,DEM,610041,0,6,192,198,
Pittsburg,Governor,Mary Fallin,REP,610041,3,9,204,216,
Pittsburg,Governor,Kimberly Willis,IND,610041,0,1,26,27,
Pittsburg,Governor,Richard Prawdzienski,IND,610041,0,0,10,10,
Pittsburg,Lieutenant Governor,Cathy Cummings,DEM,610041,0,5,159,164,
Pittsburg,Lieutenant Governor,Todd Lamb,REP,610041,3,11,269,283,
Pittsburg,Superintendent of Public Instruction,John Cox,DEM,610041,0,7,246,253,
Pittsburg,Superintendent of Public Instruction,Joy Hofmeister,REP,610041,3,9,181,193,
Pittsburg,Commissioner of Labor,Mike Workman,DEM,610041,0,6,215,221,
Pittsburg,Commissioner of Labor,Mark Costello,REP,610041,3,10,208,221,
Pittsburg,U.S. Senate,Matt Silverstein,DEM,610041,0,5,126,131,
Pittsburg,U.S. Senate,Jim Inhofe,REP,610041,3,11,279,293,
Pittsburg,U.S. Senate,Aaron Delozier,IND,610041,0,0,6,6,
Pittsburg,U.S. Senate,Ray Woods,IND,610041,0,0,10,10,
Pittsburg,U.S. Senate,Joan Farr,IND,610041,0,0,9,9,
Pittsburg,U.S. Senate,Connie Johnson,DEM,610041,0,4,150,154,
Pittsburg,U.S. Senate,James Lankford,REP,610041,3,12,253,268,
Pittsburg,U.S. Senate,Mark Beard,IND,610041,0,0,27,27,
Pittsburg,U.S. House,Earl Everett,DEM,610041,0,4,118,122,02
Pittsburg,U.S. House,Markwayne Mullin,REP,610041,3,12,279,294,02
Pittsburg,U.S. House,Jon Douthitt,IND,610041,0,0,32,32,02
Pittsburg,State House,Brian Renegar,DEM,610041,1,8,302,311,17
Pittsburg,State House,Micah Thompson,REP,610041,2,8,130,140,17
Pittsburg,Governor,Joe Dorman,DEM,610042,0,24,137,161,
Pittsburg,Governor,Mary Fallin,REP,610042,0,15,140,155,
Pittsburg,Governor,Kimberly Willis,IND,610042,0,0,9,9,
Pittsburg,Governor,Richard Prawdzienski,IND,610042,0,0,2,2,
Pittsburg,Lieutenant Governor,Cathy Cummings,DEM,610042,0,20,103,123,
Pittsburg,Lieutenant Governor,Todd Lamb,REP,610042,0,19,183,202,
Pittsburg,Superintendent of Public Instruction,John Cox,DEM,610042,0,23,161,184,
Pittsburg,Superintendent of Public Instruction,Joy Hofmeister,REP,610042,0,15,123,138,
Pittsburg,Commissioner of Labor,Mike Workman,DEM,610042,0,22,136,158,
Pittsburg,Commissioner of Labor,Mark Costello,REP,610042,0,15,143,158,
Pittsburg,U.S. Senate,Matt Silverstein,DEM,610042,0,16,82,98,
Pittsburg,U.S. Senate,Jim Inhofe,REP,610042,0,21,199,220,
Pittsburg,U.S. Senate,Aaron Delozier,IND,610042,0,1,4,5,
Pittsburg,U.S. Senate,Ray Woods,IND,610042,0,0,2,2,
Pittsburg,U.S. Senate,Joan Farr,IND,610042,0,0,1,1,
Pittsburg,U.S. Senate,Connie Johnson,DEM,610042,0,18,100,118,
Pittsburg,U.S. Senate,James Lankford,REP,610042,0,18,179,197,
Pittsburg,U.S. Senate,Mark Beard,IND,610042,0,2,6,8,
Pittsburg,U.S. House,Earl Everett,DEM,610042,0,17,75,92,02
Pittsburg,U.S. House,Markwayne Mullin,REP,610042,0,20,197,217,02
Pittsburg,U.S. House,Jon Douthitt,IND,610042,0,1,14,15,02
Pittsburg,State House,Brian Renegar,DEM,610042,0,27,205,232,17
Pittsburg,State House,Micah Thompson,REP,610042,0,11,82,93,17
Pittsburg,Governor,Joe Dorman,DEM,610043,0,4,85,89,
Pittsburg,Governor,Mary Fallin,REP,610043,0,3,94,97,
Pittsburg,Governor,Kimberly Willis,IND,610043,0,0,7,7,
Pittsburg,Governor,Richard Prawdzienski,IND,610043,0,0,6,6,
Pittsburg,Lieutenant Governor,Cathy Cummings,DEM,610043,0,4,75,79,
Pittsburg,Lieutenant Governor,Todd Lamb,REP,610043,0,3,113,116,
Pittsburg,Superintendent of Public Instruction,John Cox,DEM,610043,0,5,123,128,
Pittsburg,Superintendent of Public Instruction,Joy Hofmeister,REP,610043,0,2,68,70,
Pittsburg,Commissioner of Labor,Mike Workman,DEM,610043,0,4,91,95,
Pittsburg,Commissioner of Labor,Mark Costello,REP,610043,0,3,88,91,
Pittsburg,U.S. Senate,Matt Silverstein,DEM,610043,0,3,50,53,
Pittsburg,U.S. Senate,Jim Inhofe,REP,610043,0,4,136,140,
Pittsburg,U.S. Senate,Aaron Delozier,IND,610043,0,0,0,0,
Pittsburg,U.S. Senate,Ray Woods,IND,610043,0,0,3,3,
Pittsburg,U.S. Senate,Joan Farr,IND,610043,0,0,2,2,
Pittsburg,U.S. Senate,Connie Johnson,DEM,610043,0,4,66,70,
Pittsburg,U.S. Senate,James Lankford,REP,610043,0,3,110,113,
Pittsburg,U.S. Senate,Mark Beard,IND,610043,0,0,11,11,
Pittsburg,U.S. House,Earl Everett,DEM,610043,0,3,58,61,02
Pittsburg,U.S. House,Markwayne Mullin,REP,610043,0,4,121,125,02
Pittsburg,U.S. House,Jon Douthitt,IND,610043,0,0,9,9,02
Pittsburg,State House,Brian Renegar,DEM,610043,0,5,125,130,17
Pittsburg,State House,Micah Thompson,REP,610043,0,2,68,70,17
Pittsburg,Governor,Joe Dorman,DEM,610044,4,3,154,161,
Pittsburg,Governor,Mary Fallin,REP,610044,2,0,98,100,
Pittsburg,Governor,Kimberly Willis,IND,610044,0,0,6,6,
Pittsburg,Governor,Richard Prawdzienski,IND,610044,0,0,5,5,
Pittsburg,Lieutenant Governor,Cathy Cummings,DEM,610044,4,1,98,103,
Pittsburg,Lieutenant Governor,Todd Lamb,REP,610044,2,1,162,165,
Pittsburg,Superintendent of Public Instruction,John Cox,DEM,610044,4,3,181,188,
Pittsburg,Superintendent of Public Instruction,Joy Hofmeister,REP,610044,2,0,78,80,
Pittsburg,Commissioner of Labor,Mike Workman,DEM,610044,4,1,140,145,
Pittsburg,Commissioner of Labor,Mark Costello,REP,610044,2,1,121,124,
Pittsburg,U.S. Senate,Matt Silverstein,DEM,610044,4,2,98,104,
Pittsburg,U.S. Senate,Jim Inhofe,REP,610044,2,1,153,156,
Pittsburg,U.S. Senate,Aaron Delozier,IND,610044,0,0,0,0,
Pittsburg,U.S. Senate,Ray Woods,IND,610044,0,0,8,8,
Pittsburg,U.S. Senate,Joan Farr,IND,610044,0,0,2,2,
Pittsburg,U.S. Senate,Connie Johnson,DEM,610044,4,2,95,101,
Pittsburg,U.S. Senate,James Lankford,REP,610044,2,1,158,161,
Pittsburg,U.S. Senate,Mark Beard,IND,610044,0,0,8,8,
Pittsburg,U.S. House,Earl Everett,DEM,610044,4,2,84,90,02
Pittsburg,U.S. House,Markwayne Mullin,REP,610044,2,1,168,171,02
Pittsburg,U.S. House,Jon Douthitt,IND,610044,0,0,10,10,02
Pittsburg,State House,Brian Renegar,DEM,610044,4,2,175,181,17
Pittsburg,State House,Micah Thompson,REP,610044,2,1,88,91,17
Pittsburg,Governor,Joe Dorman,DEM,610045,0,0,5,5,
Pittsburg,Governor,Mary Fallin,REP,610045,0,0,1,1,
Pittsburg,Governor,Kimberly Willis,IND,610045,0,0,0,0,
Pittsburg,Governor,Richard Prawdzienski,IND,610045,0,0,0,0,
Pittsburg,Lieutenant Governor,Cathy Cummings,DEM,610045,0,0,3,3,
Pittsburg,Lieutenant Governor,Todd Lamb,REP,610045,0,0,3,3,
Pittsburg,Superintendent of Public Instruction,John Cox,DEM,610045,0,0,6,6,
Pittsburg,Superintendent of Public Instruction,Joy Hofmeister,REP,610045,0,0,0,0,
Pittsburg,Commissioner of Labor,Mike Workman,DEM,610045,0,0,4,4,
Pittsburg,Commissioner of Labor,Mark Costello,REP,610045,0,0,2,2,
Pittsburg,U.S. Senate,Matt Silverstein,DEM,610045,0,0,2,2,
Pittsburg,U.S. Senate,Jim Inhofe,REP,610045,0,0,4,4,
Pittsburg,U.S. Senate,Aaron Delozier,IND,610045,0,0,0,0,
Pittsburg,U.S. Senate,Ray Woods,IND,610045,0,0,0,0,
Pittsburg,U.S. Senate,Joan Farr,IND,610045,0,0,0,0,
Pittsburg,U.S. Senate,Connie Johnson,DEM,610045,0,0,3,3,
Pittsburg,U.S. Senate,James Lankford,REP,610045,0,0,2,2,
Pittsburg,U.S. Senate,Mark Beard,IND,610045,0,0,1,1,
Pittsburg,U.S. House,Earl Everett,DEM,610045,0,0,0,0,02
Pittsburg,U.S. House,Markwayne Mullin,REP,610045,0,0,6,6,02
Pittsburg,U.S. House,Jon Douthitt,IND,610045,0,0,0,0,02
Pittsburg,State House,Brian Renegar,DEM,610045,0,0,6,6,17
Pittsburg,State House,Micah Thompson,REP,610045,0,0,0,0,17
Pittsburg,Governor,Joe Dorman,DEM,610046,0,6,52,58,
Pittsburg,Governor,Mary Fallin,REP,610046,0,7,88,95,
Pittsburg,Governor,Kimberly Willis,IND,610046,0,0,5,5,
Pittsburg,Governor,Richard Prawdzienski,IND,610046,0,0,1,1,
Pittsburg,Lieutenant Governor,Cathy Cummings,DEM,610046,0,5,40,45,
Pittsburg,Lieutenant Governor,Todd Lamb,REP,610046,0,8,103,111,
Pittsburg,Superintendent of Public Instruction,John Cox,DEM,610046,0,7,71,78,
Pittsburg,Superintendent of Public Instruction,Joy Hofmeister,REP,610046,0,6,73,79,
Pittsburg,Commissioner of Labor,Mike Workman,DEM,610046,0,4,52,56,
Pittsburg,Commissioner of Labor,Mark Costello,REP,610046,0,8,90,98,
Pittsburg,U.S. Senate,Matt Silverstein,DEM,610046,0,3,34,37,
Pittsburg,U.S. Senate,Jim Inhofe,REP,610046,0,9,108,117,
Pittsburg,U.S. Senate,Aaron Delozier,IND,610046,0,0,0,0,
Pittsburg,U.S. Senate,Ray Woods,IND,610046,0,1,1,2,
Pittsburg,U.S. Senate,Joan Farr,IND,610046,0,0,3,3,
Pittsburg,U.S. Senate,Connie Johnson,DEM,610046,0,7,36,43,
Pittsburg,U.S. Senate,James Lankford,REP,610046,0,6,101,107,
Pittsburg,U.S. Senate,Mark Beard,IND,610046,0,0,7,7,
Pittsburg,U.S. House,Earl Everett,DEM,610046,0,3,30,33,02
Pittsburg,U.S. House,Markwayne Mullin,REP,610046,0,9,110,119,02
Pittsburg,U.S. House,Jon Douthitt,IND,610046,0,1,5,6,02
Pittsburg,Governor,Joe Dorman,DEM,610047,0,7,145,152,
Pittsburg,Governor,Mary Fallin,REP,610047,0,2,100,102,
Pittsburg,Governor,Kimberly Willis,IND,610047,0,0,7,7,
Pittsburg,Governor,Richard Prawdzienski,IND,610047,0,1,5,6,
Pittsburg,Lieutenant Governor,Cathy Cummings,DEM,610047,0,4,104,108,
Pittsburg,Lieutenant Governor,Todd Lamb,REP,610047,0,6,150,156,
Pittsburg,Superintendent of Public Instruction,John Cox,DEM,610047,0,8,178,186,
Pittsburg,Superintendent of Public Instruction,Joy Hofmeister,REP,610047,0,2,78,80,
Pittsburg,Commissioner of Labor,Mike Workman,DEM,610047,0,5,141,146,
Pittsburg,Commissioner of Labor,Mark Costello,REP,610047,0,3,112,115,
Pittsburg,U.S. Senate,Matt Silverstein,DEM,610047,0,2,76,78,
Pittsburg,U.S. Senate,Jim Inhofe,REP,610047,0,8,170,178,
Pittsburg,U.S. Senate,Aaron Delozier,IND,610047,0,0,2,2,
Pittsburg,U.S. Senate,Ray Woods,IND,610047,0,0,2,2,
Pittsburg,U.S. Senate,Joan Farr,IND,610047,0,0,6,6,
Pittsburg,U.S. Senate,Connie Johnson,DEM,610047,0,2,93,95,
Pittsburg,U.S. Senate,James Lankford,REP,610047,0,8,146,154,
Pittsburg,U.S. Senate,Mark Beard,IND,610047,0,0,15,15,
Pittsburg,U.S. House,Earl Everett,DEM,610047,0,3,64,67,02
Pittsburg,U.S. House,Markwayne Mullin,REP,610047,0,6,172,178,02
Pittsburg,U.S. House,Jon Douthitt,IND,610047,0,0,17,17,02
Pittsburg,State House,Brian Renegar,DEM,610047,0,7,198,205,17
Pittsburg,State House,Micah Thompson,REP,610047,0,3,60,63,17
Pittsburg,Governor,Joe Dorman,DEM,610048,0,2,28,30,
Pittsburg,Governor,Mary Fallin,REP,610048,0,2,42,44,
Pittsburg,Governor,Kimberly Willis,IND,610048,0,0,0,0,
Pittsburg,Governor,Richard Prawdzienski,IND,610048,0,0,0,0,
Pittsburg,Lieutenant Governor,Cathy Cummings,DEM,610048,0,1,21,22,
Pittsburg,Lieutenant Governor,Todd Lamb,REP,610048,0,2,47,49,
Pittsburg,Superintendent of Public Instruction,John Cox,DEM,610048,0,2,39,41,
Pittsburg,Superintendent of Public Instruction,Joy Hofmeister,REP,610048,0,2,31,33,
Pittsburg,Commissioner of Labor,Mike Workman,DEM,610048,0,1,29,30,
Pittsburg,Commissioner of Labor,Mark Costello,REP,610048,0,3,39,42,
Pittsburg,U.S. Senate,Matt Silverstein,DEM,610048,0,1,23,24,
Pittsburg,U.S. Senate,Jim Inhofe,REP,610048,0,3,47,50,
Pittsburg,U.S. Senate,Aaron Delozier,IND,610048,0,0,0,0,
Pittsburg,U.S. Senate,Ray Woods,IND,610048,0,0,0,0,
Pittsburg,U.S. Senate,Joan Farr,IND,610048,0,0,0,0,
Pittsburg,U.S. Senate,Connie Johnson,DEM,610048,0,1,20,21,
Pittsburg,U.S. Senate,James Lankford,REP,610048,0,2,49,51,
Pittsburg,U.S. Senate,Mark Beard,IND,610048,0,1,1,2,
Pittsburg,U.S. House,Earl Everett,DEM,610048,0,1,19,20,02
Pittsburg,U.S. House,Markwayne Mullin,REP,610048,0,3,51,54,02
Pittsburg,U.S. House,Jon Douthitt,IND,610048,0,0,0,0,02
Pittsburg,Governor,Joe Dorman,DEM,610049,1,7,123,131,
Pittsburg,Governor,Mary Fallin,REP,610049,1,11,145,157,
Pittsburg,Governor,Kimberly Willis,IND,610049,0,2,7,9,
Pittsburg,Governor,Richard Prawdzienski,IND,610049,0,0,6,6,
Pittsburg,Lieutenant Governor,Cathy Cummings,DEM,610049,1,4,86,91,
Pittsburg,Lieutenant Governor,Todd Lamb,REP,610049,1,16,192,209,
Pittsburg,Superintendent of Public Instruction,John Cox,DEM,610049,1,13,168,182,
Pittsburg,Superintendent of Public Instruction,Joy Hofmeister,REP,610049,1,8,111,120,
Pittsburg,Commissioner of Labor,Mike Workman,DEM,610049,1,7,138,146,
Pittsburg,Commissioner of Labor,Mark Costello,REP,610049,1,12,134,147,
Pittsburg,U.S. Senate,Matt Silverstein,DEM,610049,1,5,71,77,
Pittsburg,U.S. Senate,Jim Inhofe,REP,610049,1,16,198,215,
Pittsburg,U.S. Senate,Aaron Delozier,IND,610049,0,0,0,0,
Pittsburg,U.S. Senate,Ray Woods,IND,610049,0,0,4,4,
Pittsburg,U.S. Senate,Joan Farr,IND,610049,0,0,6,6,
Pittsburg,U.S. Senate,Connie Johnson,DEM,610049,1,4,92,97,
Pittsburg,U.S. Senate,James Lankford,REP,610049,1,15,180,196,
Pittsburg,U.S. Senate,Mark Beard,IND,610049,0,2,8,10,
Pittsburg,U.S. House,Earl Everett,DEM,610049,1,5,61,67,02
Pittsburg,U.S. House,Markwayne Mullin,REP,610049,1,15,206,222,02
Pittsburg,U.S. House,Jon Douthitt,IND,610049,0,1,13,14,02
Pittsburg,Governor,Joe Dorman,DEM,610051,3,2,52,57,
Pittsburg,Governor,Mary Fallin,REP,610051,0,2,74,76,
Pittsburg,Governor,Kimberly Willis,IND,610051,0,0,2,2,
Pittsburg,Governor,Richard Prawdzienski,IND,610051,0,0,7,7,
Pittsburg,Lieutenant Governor,Cathy Cummings,DEM,610051,2,1,43,46,
Pittsburg,Lieutenant Governor,Todd Lamb,REP,610051,1,3,91,95,
Pittsburg,Superintendent of Public Instruction,John Cox,DEM,610051,3,0,66,69,
Pittsburg,Superintendent of Public Instruction,Joy Hofmeister,REP,610051,0,4,66,70,
Pittsburg,Commissioner of Labor,Mike Workman,DEM,610051,3,2,55,60,
Pittsburg,Commissioner of Labor,Mark Costello,REP,610051,0,2,75,77,
Pittsburg,U.S. Senate,Matt Silverstein,DEM,610051,2,1,31,34,
Pittsburg,U.S. Senate,Jim Inhofe,REP,610051,1,3,98,102,
Pittsburg,U.S. Senate,Aaron Delozier,IND,610051,0,0,0,0,
Pittsburg,U.S. Senate,Ray Woods,IND,610051,0,0,5,5,
Pittsburg,U.S. Senate,Joan Farr,IND,610051,0,0,1,1,
Pittsburg,U.S. Senate,Connie Johnson,DEM,610051,2,0,38,40,
Pittsburg,U.S. Senate,James Lankford,REP,610051,1,4,90,95,
Pittsburg,U.S. Senate,Mark Beard,IND,610051,0,0,6,6,
Pittsburg,U.S. House,Earl Everett,DEM,610051,2,0,31,33,02
Pittsburg,U.S. House,Markwayne Mullin,REP,610051,1,4,96,101,02
Pittsburg,U.S. House,Jon Douthitt,IND,610051,0,0,7,7,02
Pittsburg,State House,Brian Renegar,DEM,610051,3,2,90,95,17
Pittsburg,State House,Micah Thompson,REP,610051,0,2,44,46,17
Pittsburg,Governor,Joe Dorman,DEM,610052,0,0,3,3,
Pittsburg,Governor,Mary Fallin,REP,610052,0,0,9,9,
Pittsburg,Governor,Kimberly Willis,IND,610052,0,0,0,0,
Pittsburg,Governor,Richard Prawdzienski,IND,610052,0,0,0,0,
Pittsburg,Lieutenant Governor,Cathy Cummings,DEM,610052,0,0,2,2,
Pittsburg,Lieutenant Governor,Todd Lamb,REP,610052,0,0,10,10,
Pittsburg,Superintendent of Public Instruction,John Cox,DEM,610052,0,0,4,4,
Pittsburg,Superintendent of Public Instruction,Joy Hofmeister,REP,610052,0,0,8,8,
Pittsburg,Commissioner of Labor,Mike Workman,DEM,610052,0,0,3,3,
Pittsburg,Commissioner of Labor,Mark Costello,REP,610052,0,0,9,9,
Pittsburg,U.S. Senate,Matt Silverstein,DEM,610052,0,0,2,2,
Pittsburg,U.S. Senate,Jim Inhofe,REP,610052,0,0,10,10,
Pittsburg,U.S. Senate,Aaron Delozier,IND,610052,0,0,0,0,
Pittsburg,U.S. Senate,Ray Woods,IND,610052,0,0,0,0,
Pittsburg,U.S. Senate,Joan Farr,IND,610052,0,0,0,0,
Pittsburg,U.S. Senate,Connie Johnson,DEM,610052,0,0,2,2,
Pittsburg,U.S. Senate,James Lankford,REP,610052,0,0,10,10,
Pittsburg,U.S. Senate,Mark Beard,IND,610052,0,0,0,0,
Pittsburg,U.S. House,Earl Everett,DEM,610052,0,0,1,1,02
Pittsburg,U.S. House,Markwayne Mullin,REP,610052,0,0,9,9,02
Pittsburg,U.S. House,Jon Douthitt,IND,610052,0,0,2,2,02
Pittsburg,Governor,Joe Dorman,DEM,610053,0,1,18,19,
Pittsburg,Governor,Mary Fallin,REP,610053,0,0,21,21,
Pittsburg,Governor,Kimberly Willis,IND,610053,0,0,0,0,
Pittsburg,Governor,Richard Prawdzienski,IND,610053,0,0,1,1,
Pittsburg,Lieutenant Governor,Cathy Cummings,DEM,610053,0,1,13,14,
Pittsburg,Lieutenant Governor,Todd Lamb,REP,610053,0,0,26,26,
Pittsburg,Superintendent of Public Instruction,John Cox,DEM,610053,0,1,24,25,
Pittsburg,Superintendent of Public Instruction,Joy Hofmeister,REP,610053,0,0,16,16,
Pittsburg,Commissioner of Labor,Mike Workman,DEM,610053,0,1,23,24,
Pittsburg,Commissioner of Labor,Mark Costello,REP,610053,0,0,16,16,
Pittsburg,U.S. Senate,Matt Silverstein,DEM,610053,0,0,10,10,
Pittsburg,U.S. Senate,Jim Inhofe,REP,610053,0,1,26,27,
Pittsburg,U.S. Senate,Aaron Delozier,IND,610053,0,0,1,1,
Pittsburg,U.S. Senate,Ray Woods,IND,610053,0,0,2,2,
Pittsburg,U.S. Senate,Joan Farr,IND,610053,0,0,1,1,
Pittsburg,U.S. Senate,Connie Johnson,DEM,610053,0,1,11,12,
Pittsburg,U.S. Senate,James Lankford,REP,610053,0,0,25,25,
Pittsburg,U.S. Senate,Mark Beard,IND,610053,0,0,4,4,
Pittsburg,U.S. House,Earl Everett,DEM,610053,0,0,11,11,02
Pittsburg,U.S. House,Markwayne Mullin,REP,610053,0,1,24,25,02
Pittsburg,U.S. House,Jon Douthitt,IND,610053,0,0,5,5,02
Pontotoc,Governor,Joe Dorman,DEM,620013,6,29,272,307,
Pontotoc,Governor,Mary Fallin,REP,620013,7,25,253,285,
Pontotoc,Governor,Kimberly Willis,IND,620013,0,1,5,6,
Pontotoc,Governor,Richard Prawdzienski,IND,620013,0,0,4,4,
Pontotoc,Lieutenant Governor,Cathy Cummings,DEM,620013,6,22,187,215,
Pontotoc,Lieutenant Governor,Todd Lamb,REP,620013,7,32,353,392,
Pontotoc,Superintendent of Public Instruction,John Cox,DEM,620013,8,26,264,298,
Pontotoc,Superintendent of Public Instruction,Joy Hofmeister,REP,620013,5,28,275,308,
Pontotoc,Commissioner of Labor,Mike Workman,DEM,620013,5,27,224,256,
Pontotoc,Commissioner of Labor,Mark Costello,REP,620013,7,26,302,335,
Pontotoc,U.S. Senate,Matt Silverstein,DEM,620013,5,19,158,182,
Pontotoc,U.S. Senate,Jim Inhofe,REP,620013,8,34,369,411,
Pontotoc,U.S. Senate,Aaron Delozier,IND,620013,0,0,2,2,
Pontotoc,U.S. Senate,Ray Woods,IND,620013,0,0,4,4,
Pontotoc,U.S. Senate,Joan Farr,IND,620013,0,2,7,9,
Pontotoc,U.S. Senate,Connie Johnson,DEM,620013,6,22,159,187,
Pontotoc,U.S. Senate,James Lankford,REP,620013,7,31,360,398,
Pontotoc,U.S. Senate,Mark Beard,IND,620013,0,1,19,20,
Pontotoc,U.S. House,Bert Smith,DEM,620013,4,14,130,148,04
Pontotoc,U.S. House,Tom Cole,REP,620013,9,39,397,445,04
Pontotoc,U.S. House,Dennis Johnson,IND,620013,0,2,11,13,04
Pontotoc,Governor,Joe Dorman,DEM,620016,11,40,343,394,
Pontotoc,Governor,Mary Fallin,REP,620016,14,47,313,374,
Pontotoc,Governor,Kimberly Willis,IND,620016,1,0,16,17,
Pontotoc,Governor,Richard Prawdzienski,IND,620016,0,0,7,7,
Pontotoc,Lieutenant Governor,Cathy Cummings,DEM,620016,10,23,211,244,
Pontotoc,Lieutenant Governor,Todd Lamb,REP,620016,15,62,469,546,
Pontotoc,Superintendent of Public Instruction,John Cox,DEM,620016,12,38,331,381,
Pontotoc,Superintendent of Public Instruction,Joy Hofmeister,REP,620016,14,45,345,404,
Pontotoc,Commissioner of Labor,Mike Workman,DEM,620016,12,31,275,318,
Pontotoc,Commissioner of Labor,Mark Costello,REP,620016,14,50,388,452,
Pontotoc,U.S. Senate,Matt Silverstein,DEM,620016,8,20,168,196,
Pontotoc,U.S. Senate,Jim Inhofe,REP,620016,17,64,487,568,
Pontotoc,U.S. Senate,Aaron Delozier,IND,620016,0,0,8,8,
Pontotoc,U.S. Senate,Ray Woods,IND,620016,0,2,8,10,
Pontotoc,U.S. Senate,Joan Farr,IND,620016,1,0,6,7,
Pontotoc,U.S. Senate,Connie Johnson,DEM,620016,10,20,170,200,
Pontotoc,U.S. Senate,James Lankford,REP,620016,14,66,487,567,
Pontotoc,U.S. Senate,Mark Beard,IND,620016,2,1,21,24,
Pontotoc,U.S. House,Bert Smith,DEM,620016,6,18,145,169,04
Pontotoc,U.S. House,Tom Cole,REP,620016,18,66,518,602,04
Pontotoc,U.S. House,Dennis Johnson,IND,620016,2,2,19,23,04
Pontotoc,Governor,Joe Dorman,DEM,620022,11,13,228,252,
Pontotoc,Governor,Mary Fallin,REP,620022,6,15,187,208,
Pontotoc,Governor,Kimberly Willis,IND,620022,0,0,9,9,
Pontotoc,Governor,Richard Prawdzienski,IND,620022,0,0,7,7,
Pontotoc,Lieutenant Governor,Cathy Cummings,DEM,620022,7,4,146,157,
Pontotoc,Lieutenant Governor,Todd Lamb,REP,620022,10,23,284,317,
Pontotoc,Superintendent of Public Instruction,John Cox,DEM,620022,7,7,219,233,
Pontotoc,Superintendent of Public Instruction,Joy Hofmeister,REP,620022,9,21,208,238,
Pontotoc,Commissioner of Labor,Mike Workman,DEM,620022,7,9,179,195,
Pontotoc,Commissioner of Labor,Mark Costello,REP,620022,8,18,238,264,
Pontotoc,U.S. Senate,Matt Silverstein,DEM,620022,7,3,130,140,
Pontotoc,U.S. Senate,Jim Inhofe,REP,620022,10,24,285,319,
Pontotoc,U.S. Senate,Aaron Delozier,IND,620022,0,1,8,9,
Pontotoc,U.S. Senate,Ray Woods,IND,620022,0,0,2,2,
Pontotoc,U.S. Senate,Joan Farr,IND,620022,0,0,2,2,
Pontotoc,U.S. Senate,Connie Johnson,DEM,620022,6,3,134,143,
Pontotoc,U.S. Senate,James Lankford,REP,620022,9,25,283,317,
Pontotoc,U.S. Senate,Mark Beard,IND,620022,1,0,11,12,
Pontotoc,U.S. House,Bert Smith,DEM,620022,5,3,102,110,04
Pontotoc,U.S. House,Tom Cole,REP,620022,12,25,309,346,04
Pontotoc,U.S. House,Dennis Johnson,IND,620022,0,0,17,17,04
Pontotoc,Governor,Joe Dorman,DEM,620025,2,27,325,354,
Pontotoc,Governor,Mary Fallin,REP,620025,11,23,298,332,
Pontotoc,Governor,Kimberly Willis,IND,620025,1,1,21,23,
Pontotoc,Governor,Richard Prawdzienski,IND,620025,0,0,5,5,
Pontotoc,Lieutenant Governor,Cathy Cummings,DEM,620025,5,16,194,215,
Pontotoc,Lieutenant Governor,Todd Lamb,REP,620025,9,35,452,496,
Pontotoc,Superintendent of Public Instruction,John Cox,DEM,620025,6,26,321,353,
Pontotoc,Superintendent of Public Instruction,Joy Hofmeister,REP,620025,8,25,327,360,
Pontotoc,Commissioner of Labor,Mike Workman,DEM,620025,5,18,265,288,
Pontotoc,Commissioner of Labor,Mark Costello,REP,620025,9,30,370,409,
Pontotoc,U.S. Senate,Matt Silverstein,DEM,620025,2,16,145,163,
Pontotoc,U.S. Senate,Jim Inhofe,REP,620025,11,32,480,523,
Pontotoc,U.S. Senate,Aaron Delozier,IND,620025,0,0,9,9,
Pontotoc,U.S. Senate,Ray Woods,IND,620025,0,1,5,6,
Pontotoc,U.S. Senate,Joan Farr,IND,620025,1,2,8,11,
Pontotoc,U.S. Senate,Connie Johnson,DEM,620025,4,12,163,179,
Pontotoc,U.S. Senate,James Lankford,REP,620025,10,38,463,511,
Pontotoc,U.S. Senate,Mark Beard,IND,620025,0,1,24,25,
Pontotoc,U.S. House,Bert Smith,DEM,620025,3,12,122,137,04
Pontotoc,U.S. House,Tom Cole,REP,620025,10,31,507,548,04
Pontotoc,U.S. House,Dennis Johnson,IND,620025,1,6,17,24,04
Pontotoc,Governor,Joe Dorman,DEM,620031,13,28,280,321,
Pontotoc,Governor,Mary Fallin,REP,620031,5,18,184,207,
Pontotoc,Governor,Kimberly Willis,IND,620031,0,0,12,12,
Pontotoc,Governor,Richard Prawdzienski,IND,620031,0,0,9,9,
Pontotoc,Lieutenant Governor,Cathy Cummings,DEM,620031,12,26,204,242,
Pontotoc,Lieutenant Governor,Todd Lamb,REP,620031,6,20,275,301,
Pontotoc,Superintendent of Public Instruction,John Cox,DEM,620031,12,32,270,314,
Pontotoc,Superintendent of Public Instruction,Joy Hofmeister,REP,620031,6,16,208,230,
Pontotoc,Commissioner of Labor,Mike Workman,DEM,620031,13,28,247,288,
Pontotoc,Commissioner of Labor,Mark Costello,REP,620031,4,19,218,241,
Pontotoc,U.S. Senate,Matt Silverstein,DEM,620031,10,18,158,186,
Pontotoc,U.S. Senate,Jim Inhofe,REP,620031,6,27,289,322,
Pontotoc,U.S. Senate,Aaron Delozier,IND,620031,0,0,9,9,
Pontotoc,U.S. Senate,Ray Woods,IND,620031,0,1,12,13,
Pontotoc,U.S. Senate,Joan Farr,IND,620031,1,1,12,14,
Pontotoc,U.S. Senate,Connie Johnson,DEM,620031,12,21,169,202,
Pontotoc,U.S. Senate,James Lankford,REP,620031,6,24,274,304,
Pontotoc,U.S. Senate,Mark Beard,IND,620031,0,1,33,34,
Pontotoc,U.S. House,Bert Smith,DEM,620031,10,16,146,172,04
Pontotoc,U.S. House,Tom Cole,REP,620031,8,29,311,348,04
Pontotoc,U.S. House,Dennis Johnson,IND,620031,0,2,25,27,04
Pontotoc,Governor,Joe Dorman,DEM,620051,4,1,96,101,
Pontotoc,Governor,Mary Fallin,REP,620051,1,3,123,127,
Pontotoc,Governor,Kimberly Willis,IND,620051,0,0,11,11,
Pontotoc,Governor,Richard Prawdzienski,IND,620051,0,0,2,2,
Pontotoc,Lieutenant Governor,Cathy Cummings,DEM,620051,4,2,62,68,
Pontotoc,Lieutenant Governor,Todd Lamb,REP,620051,1,2,165,168,
Pontotoc,Superintendent of Public Instruction,John Cox,DEM,620051,4,2,109,115,
Pontotoc,Superintendent of Public Instruction,Joy Hofmeister,REP,620051,1,2,120,123,
Pontotoc,Commissioner of Labor,Mike Workman,DEM,620051,4,2,98,104,
Pontotoc,Commissioner of Labor,Mark Costello,REP,620051,1,2,125,128,
Pontotoc,U.S. Senate,Matt Silverstein,DEM,620051,3,1,50,54,
Pontotoc,U.S. Senate,Jim Inhofe,REP,620051,2,3,172,177,
Pontotoc,U.S. Senate,Aaron Delozier,IND,620051,0,0,2,2,
Pontotoc,U.S. Senate,Ray Woods,IND,620051,0,0,1,1,
Pontotoc,U.S. Senate,Joan Farr,IND,620051,0,0,5,5,
Pontotoc,U.S. Senate,Connie Johnson,DEM,620051,4,1,57,62,
Pontotoc,U.S. Senate,James Lankford,REP,620051,1,3,155,159,
Pontotoc,U.S. Senate,Mark Beard,IND,620051,0,0,16,16,
Pontotoc,U.S. House,Bert Smith,DEM,620051,4,1,43,48,04
Pontotoc,U.S. House,Tom Cole,REP,620051,1,3,176,180,04
Pontotoc,U.S. House,Dennis Johnson,IND,620051,0,0,11,11,04
Pontotoc,Governor,Joe Dorman,DEM,620052,2,15,160,177,
Pontotoc,Governor,Mary Fallin,REP,620052,5,9,95,109,
Pontotoc,Governor,Kimberly Willis,IND,620052,2,2,3,7,
Pontotoc,Governor,Richard Prawdzienski,IND,620052,0,0,2,2,
Pontotoc,Lieutenant Governor,Cathy Cummings,DEM,620052,1,13,99,113,
Pontotoc,Lieutenant Governor,Todd Lamb,REP,620052,8,12,159,179,
Pontotoc,Superintendent of Public Instruction,John Cox,DEM,620052,2,14,141,157,
Pontotoc,Superintendent of Public Instruction,Joy Hofmeister,REP,620052,7,10,115,132,
Pontotoc,Commissioner of Labor,Mike Workman,DEM,620052,1,16,124,141,
Pontotoc,Commissioner of Labor,Mark Costello,REP,620052,8,9,129,146,
Pontotoc,U.S. Senate,Matt Silverstein,DEM,620052,2,11,93,106,
Pontotoc,U.S. Senate,Jim Inhofe,REP,620052,7,12,155,174,
Pontotoc,U.S. Senate,Aaron Delozier,IND,620052,0,1,4,5,
Pontotoc,U.S. Senate,Ray Woods,IND,620052,0,1,4,5,
Pontotoc,U.S. Senate,Joan Farr,IND,620052,0,0,2,2,
Pontotoc,U.S. Senate,Connie Johnson,DEM,620052,1,11,90,102,
Pontotoc,U.S. Senate,James Lankford,REP,620052,8,12,156,176,
Pontotoc,U.S. Senate,Mark Beard,IND,620052,0,2,11,13,
Pontotoc,U.S. House,Bert Smith,DEM,620052,1,7,78,86,04
Pontotoc,U.S. House,Tom Cole,REP,620052,6,15,175,196,04
Pontotoc,U.S. House,Dennis Johnson,IND,620052,2,4,6,12,04
Pontotoc,Governor,Joe Dorman,DEM,620053,11,46,346,403,
Pontotoc,Governor,Mary Fallin,REP,620053,13,60,355,428,
Pontotoc,Governor,Kimberly Willis,IND,620053,0,0,17,17,
Pontotoc,Governor,Richard Prawdzienski,IND,620053,0,0,5,5,
Pontotoc,Lieutenant Governor,Cathy Cummings,DEM,620053,7,33,215,255,
Pontotoc,Lieutenant Governor,Todd Lamb,REP,620053,13,71,504,588,
Pontotoc,Superintendent of Public Instruction,John Cox,DEM,620053,10,46,303,359,
Pontotoc,Superintendent of Public Instruction,Joy Hofmeister,REP,620053,10,57,418,485,
Pontotoc,Commissioner of Labor,Mike Workman,DEM,620053,9,44,255,308,
Pontotoc,Commissioner of Labor,Mark Costello,REP,620053,11,56,445,512,
Pontotoc,U.S. Senate,Matt Silverstein,DEM,620053,8,27,169,204,
Pontotoc,U.S. Senate,Jim Inhofe,REP,620053,14,74,536,624,
Pontotoc,U.S. Senate,Aaron Delozier,IND,620053,1,0,3,4,
Pontotoc,U.S. Senate,Ray Woods,IND,620053,0,3,2,5,
Pontotoc,U.S. Senate,Joan Farr,IND,620053,0,1,7,8,
Pontotoc,U.S. Senate,Connie Johnson,DEM,620053,6,33,174,213,
Pontotoc,U.S. Senate,James Lankford,REP,620053,16,66,532,614,
Pontotoc,U.S. Senate,Mark Beard,IND,620053,1,4,18,23,
Pontotoc,U.S. House,Bert Smith,DEM,620053,3,21,138,162,04
Pontotoc,U.S. House,Tom Cole,REP,620053,20,82,571,673,04
Pontotoc,U.S. House,Dennis Johnson,IND,620053,1,1,16,18,04
Pontotoc,Governor,Joe Dorman,DEM,620054,1,0,32,33,
Pontotoc,Governor,Mary Fallin,REP,620054,0,2,53,55,
Pontotoc,Governor,Kimberly Willis,IND,620054,0,0,1,1,
Pontotoc,Governor,Richard Prawdzienski,IND,620054,0,0,0,0,
Pontotoc,Lieutenant Governor,Cathy Cummings,DEM,620054,1,0,18,19,
Pontotoc,Lieutenant Governor,Todd Lamb,REP,620054,0,2,68,70,
Pontotoc,Superintendent of Public Instruction,John Cox,DEM,620054,1,0,31,32,
Pontotoc,Superintendent of Public Instruction,Joy Hofmeister,REP,620054,0,2,54,56,
Pontotoc,Commissioner of Labor,Mike Workman,DEM,620054,0,0,25,25,
Pontotoc,Commissioner of Labor,Mark Costello,REP,620054,1,2,59,62,
Pontotoc,U.S. Senate,Matt Silverstein,DEM,620054,0,0,11,11,
Pontotoc,U.S. Senate,Jim Inhofe,REP,620054,0,2,68,70,
Pontotoc,U.S. Senate,Aaron Delozier,IND,620054,0,0,1,1,
Pontotoc,U.S. Senate,Ray Woods,IND,620054,1,0,1,2,
Pontotoc,U.S. Senate,Joan Farr,IND,620054,0,0,4,4,
Pontotoc,U.S. Senate,Connie Johnson,DEM,620054,0,0,16,16,
Pontotoc,U.S. Senate,James Lankford,REP,620054,1,2,63,66,
Pontotoc,U.S. Senate,Mark Beard,IND,620054,0,0,6,6,
Pontotoc,U.S. House,Bert Smith,DEM,620054,0,0,14,14,04
Pontotoc,U.S. House,Tom Cole,REP,620054,1,2,69,72,04
Pontotoc,U.S. House,Dennis Johnson,IND,620054,0,0,3,3,04
Pontotoc,Governor,Joe Dorman,DEM,620055,3,11,59,73,
Pontotoc,Governor,Mary Fallin,REP,620055,2,6,51,59,
Pontotoc,Governor,Kimberly Willis,IND,620055,0,0,1,1,
Pontotoc,Governor,Richard Prawdzienski,IND,620055,0,0,0,0,
Pontotoc,Lieutenant Governor,Cathy Cummings,DEM,620055,2,8,40,50,
Pontotoc,Lieutenant Governor,Todd Lamb,REP,620055,3,9,71,83,
Pontotoc,Superintendent of Public Instruction,John Cox,DEM,620055,2,8,64,74,
Pontotoc,Superintendent of Public Instruction,Joy Hofmeister,REP,620055,3,9,46,58,
Pontotoc,Commissioner of Labor,Mike Workman,DEM,620055,2,8,57,67,
Pontotoc,Commissioner of Labor,Mark Costello,REP,620055,3,9,52,64,
Pontotoc,U.S. Senate,Matt Silverstein,DEM,620055,0,6,34,40,
Pontotoc,U.S. Senate,Jim Inhofe,REP,620055,5,11,74,90,
Pontotoc,U.S. Senate,Aaron Delozier,IND,620055,0,0,2,2,
Pontotoc,U.S. Senate,Ray Woods,IND,620055,0,0,0,0,
Pontotoc,U.S. Senate,Joan Farr,IND,620055,0,0,1,1,
Pontotoc,U.S. Senate,Connie Johnson,DEM,620055,2,7,35,44,
Pontotoc,U.S. Senate,James Lankford,REP,620055,1,10,74,85,
Pontotoc,U.S. Senate,Mark Beard,IND,620055,2,0,2,4,
Pontotoc,U.S. House,Bert Smith,DEM,620055,0,6,35,41,04
Pontotoc,U.S. House,Tom Cole,REP,620055,5,11,73,89,04
Pontotoc,U.S. House,Dennis Johnson,IND,620055,0,0,3,3,04
Pontotoc,Governor,Joe Dorman,DEM,620056,2,2,93,97,
Pontotoc,Governor,Mary Fallin,REP,620056,0,4,66,70,
Pontotoc,Governor,Kimberly Willis,IND,620056,0,0,2,2,
Pontotoc,Governor,Richard Prawdzienski,IND,620056,0,0,2,2,
Pontotoc,Lieutenant Governor,Cathy Cummings,DEM,620056,1,2,71,74,
Pontotoc,Lieutenant Governor,Todd Lamb,REP,620056,1,4,91,96,
Pontotoc,Superintendent of Public Instruction,John Cox,DEM,620056,1,3,87,91,
Pontotoc,Superintendent of Public Instruction,Joy Hofmeister,REP,620056,1,3,76,80,
Pontotoc,Commissioner of Labor,Mike Workman,DEM,620056,0,2,82,84,
Pontotoc,Commissioner of Labor,Mark Costello,REP,620056,2,4,78,84,
Pontotoc,U.S. Senate,Matt Silverstein,DEM,620056,0,0,57,57,
Pontotoc,U.S. Senate,Jim Inhofe,REP,620056,2,6,102,110,
Pontotoc,U.S. Senate,Aaron Delozier,IND,620056,0,0,1,1,
Pontotoc,U.S. Senate,Ray Woods,IND,620056,0,0,2,2,
Pontotoc,U.S. Senate,Joan Farr,IND,620056,0,0,2,2,
Pontotoc,U.S. Senate,Connie Johnson,DEM,620056,1,1,60,62,
Pontotoc,U.S. Senate,James Lankford,REP,620056,1,5,99,105,
Pontotoc,U.S. Senate,Mark Beard,IND,620056,0,0,6,6,
Pontotoc,U.S. House,Bert Smith,DEM,620056,0,1,50,51,04
Pontotoc,U.S. House,Tom Cole,REP,620056,2,5,111,118,04
Pontotoc,U.S. House,Dennis Johnson,IND,620056,0,0,3,3,04
Pontotoc,Governor,Joe Dorman,DEM,620058,3,18,230,251,
Pontotoc,Governor,Mary Fallin,REP,620058,1,20,190,211,
Pontotoc,Governor,Kimberly Willis,IND,620058,0,0,11,11,
Pontotoc,Governor,Richard Prawdzienski,IND,620058,0,0,7,7,
Pontotoc,Lieutenant Governor,Cathy Cummings,DEM,620058,2,11,134,147,
Pontotoc,Lieutenant Governor,Todd Lamb,REP,620058,2,27,304,333,
Pontotoc,Superintendent of Public Instruction,John Cox,DEM,620058,3,22,215,240,
Pontotoc,Superintendent of Public Instruction,Joy Hofmeister,REP,620058,1,16,225,242,
Pontotoc,Commissioner of Labor,Mike Workman,DEM,620058,1,18,186,205,
Pontotoc,Commissioner of Labor,Mark Costello,REP,620058,3,20,245,268,
Pontotoc,U.S. Senate,Matt Silverstein,DEM,620058,3,9,86,98,
Pontotoc,U.S. Senate,Jim Inhofe,REP,620058,1,27,336,364,
Pontotoc,U.S. Senate,Aaron Delozier,IND,620058,0,0,3,3,
Pontotoc,U.S. Senate,Ray Woods,IND,620058,0,0,9,9,
Pontotoc,U.S. Senate,Joan Farr,IND,620058,0,0,6,6,
Pontotoc,U.S. Senate,Connie Johnson,DEM,620058,3,10,104,117,
Pontotoc,U.S. Senate,James Lankford,REP,620058,1,28,311,340,
Pontotoc,U.S. Senate,Mark Beard,IND,620058,0,0,22,22,
Pontotoc,U.S. House,Bert Smith,DEM,620058,1,9,80,90,04
Pontotoc,U.S. House,Tom Cole,REP,620058,3,29,345,377,04
Pontotoc,U.S. House,Dennis Johnson,IND,620058,0,0,14,14,04
Pontotoc,Governor,Joe Dorman,DEM,620059,0,9,154,163,
Pontotoc,Governor,Mary Fallin,REP,620059,3,2,140,145,
Pontotoc,Governor,Kimberly Willis,IND,620059,0,0,6,6,
Pontotoc,Governor,Richard Prawdzienski,IND,620059,0,0,6,6,
Pontotoc,Lieutenant Governor,Cathy Cummings,DEM,620059,0,5,86,91,
Pontotoc,Lieutenant Governor,Todd Lamb,REP,620059,3,6,214,223,
Pontotoc,Superintendent of Public Instruction,John Cox,DEM,620059,0,8,151,159,
Pontotoc,Superintendent of Public Instruction,Joy Hofmeister,REP,620059,3,3,154,160,
Pontotoc,Commissioner of Labor,Mike Workman,DEM,620059,0,7,128,135,
Pontotoc,Commissioner of Labor,Mark Costello,REP,620059,3,4,171,178,
Pontotoc,U.S. Senate,Matt Silverstein,DEM,620059,0,3,72,75,
Pontotoc,U.S. Senate,Jim Inhofe,REP,620059,3,8,213,224,
Pontotoc,U.S. Senate,Aaron Delozier,IND,620059,0,0,4,4,
Pontotoc,U.S. Senate,Ray Woods,IND,620059,0,0,6,6,
Pontotoc,U.S. Senate,Joan Farr,IND,620059,0,0,7,7,
Pontotoc,U.S. Senate,Connie Johnson,DEM,620059,0,3,80,83,
Pontotoc,U.S. Senate,James Lankford,REP,620059,3,7,215,225,
Pontotoc,U.S. Senate,Mark Beard,IND,620059,0,1,7,8,
Pontotoc,U.S. House,Bert Smith,DEM,620059,0,4,65,69,04
Pontotoc,U.S. House,Tom Cole,REP,620059,3,6,229,238,04
Pontotoc,U.S. House,Dennis Johnson,IND,620059,0,1,6,7,04
Pontotoc,Governor,Joe Dorman,DEM,620060,5,15,253,273,
Pontotoc,Governor,Mary Fallin,REP,620060,2,17,145,164,
Pontotoc,Governor,Kimberly Willis,IND,620060,0,0,11,11,
Pontotoc,Governor,Richard Prawdzienski,IND,620060,0,1,5,6,
Pontotoc,Lieutenant Governor,Cathy Cummings,DEM,620060,5,7,161,173,
Pontotoc,Lieutenant Governor,Todd Lamb,REP,620060,2,26,250,278,
Pontotoc,Superintendent of Public Instruction,John Cox,DEM,620060,4,15,236,255,
Pontotoc,Superintendent of Public Instruction,Joy Hofmeister,REP,620060,3,18,178,199,
Pontotoc,Commissioner of Labor,Mike Workman,DEM,620060,4,11,210,225,
Pontotoc,Commissioner of Labor,Mark Costello,REP,620060,3,22,193,218,
Pontotoc,U.S. Senate,Matt Silverstein,DEM,620060,5,6,120,131,
Pontotoc,U.S. Senate,Jim Inhofe,REP,620060,2,26,276,304,
Pontotoc,U.S. Senate,Aaron Delozier,IND,620060,0,1,4,5,
Pontotoc,U.S. Senate,Ray Woods,IND,620060,0,0,7,7,
Pontotoc,U.S. Senate,Joan Farr,IND,620060,0,0,4,4,
Pontotoc,U.S. Senate,Connie Johnson,DEM,620060,4,5,120,129,
Pontotoc,U.S. Senate,James Lankford,REP,620060,3,24,272,299,
Pontotoc,U.S. Senate,Mark Beard,IND,620060,0,4,19,23,
Pontotoc,U.S. House,Bert Smith,DEM,620060,4,2,106,112,04
Pontotoc,U.S. House,Tom Cole,REP,620060,3,29,290,322,04
Pontotoc,U.S. House,Dennis Johnson,IND,620060,0,2,16,18,04
Pontotoc,Governor,Joe Dorman,DEM,620061,0,6,68,74,
Pontotoc,Governor,Mary Fallin,REP,620061,0,5,52,57,
Pontotoc,Governor,Kimberly Willis,IND,620061,0,0,1,1,
Pontotoc,Governor,Richard Prawdzienski,IND,620061,0,0,1,1,
Pontotoc,Lieutenant Governor,Cathy Cummings,DEM,620061,0,2,37,39,
Pontotoc,Lieutenant Governor,Todd Lamb,REP,620061,0,9,81,90,
Pontotoc,Superintendent of Public Instruction,John Cox,DEM,620061,0,7,67,74,
Pontotoc,Superintendent of Public Instruction,Joy Hofmeister,REP,620061,0,4,55,59,
Pontotoc,Commissioner of Labor,Mike Workman,DEM,620061,0,6,50,56,
Pontotoc,Commissioner of Labor,Mark Costello,REP,620061,0,5,67,72,
Pontotoc,U.S. Senate,Matt Silverstein,DEM,620061,0,1,31,32,
Pontotoc,U.S. Senate,Jim Inhofe,REP,620061,0,10,87,97,
Pontotoc,U.S. Senate,Aaron Delozier,IND,620061,0,0,1,1,
Pontotoc,U.S. Senate,Ray Woods,IND,620061,0,0,0,0,
Pontotoc,U.S. Senate,Joan Farr,IND,620061,0,0,0,0,
Pontotoc,U.S. Senate,Connie Johnson,DEM,620061,0,1,30,31,
Pontotoc,U.S. Senate,James Lankford,REP,620061,0,10,81,91,
Pontotoc,U.S. Senate,Mark Beard,IND,620061,0,0,6,6,
Pontotoc,U.S. House,Bert Smith,DEM,620061,0,1,25,26,04
Pontotoc,U.S. House,Tom Cole,REP,620061,0,10,97,107,04
Pontotoc,U.S. House,Dennis Johnson,IND,620061,0,0,0,0,04
Pontotoc,Governor,Joe Dorman,DEM,620062,3,8,152,163,
Pontotoc,Governor,Mary Fallin,REP,620062,1,13,173,187,
Pontotoc,Governor,Kimberly Willis,IND,620062,0,0,12,12,
Pontotoc,Governor,Richard Prawdzienski,IND,620062,0,0,2,2,
Pontotoc,Lieutenant Governor,Cathy Cummings,DEM,620062,3,8,100,111,
Pontotoc,Lieutenant Governor,Todd Lamb,REP,620062,1,13,240,254,
Pontotoc,Superintendent of Public Instruction,John Cox,DEM,620062,3,10,149,162,
Pontotoc,Superintendent of Public Instruction,Joy Hofmeister,REP,620062,1,11,189,201,
Pontotoc,Commissioner of Labor,Mike Workman,DEM,620062,3,8,130,141,
Pontotoc,Commissioner of Labor,Mark Costello,REP,620062,1,13,205,219,
Pontotoc,U.S. Senate,Matt Silverstein,DEM,620062,1,7,80,88,
Pontotoc,U.S. Senate,Jim Inhofe,REP,620062,3,14,248,265,
Pontotoc,U.S. Senate,Aaron Delozier,IND,620062,0,0,0,0,
Pontotoc,U.S. Senate,Ray Woods,IND,620062,0,0,5,5,
Pontotoc,U.S. Senate,Joan Farr,IND,620062,0,0,6,6,
Pontotoc,U.S. Senate,Connie Johnson,DEM,620062,1,6,83,90,
Pontotoc,U.S. Senate,James Lankford,REP,620062,3,14,242,259,
Pontotoc,U.S. Senate,Mark Beard,IND,620062,0,1,13,14,
Pontotoc,U.S. House,Bert Smith,DEM,620062,0,4,82,86,04
Pontotoc,U.S. House,Tom Cole,REP,620062,4,16,253,273,04
Pontotoc,U.S. House,Dennis Johnson,IND,620062,0,1,2,3,04
Pontotoc,Governor,Joe Dorman,DEM,620063,0,2,122,124,
Pontotoc,Governor,Mary Fallin,REP,620063,3,6,88,97,
Pontotoc,Governor,Kimberly Willis,IND,620063,0,1,5,6,
Pontotoc,Governor,Richard Prawdzienski,IND,620063,0,0,2,2,
Pontotoc,Lieutenant Governor,Cathy Cummings,DEM,620063,0,0,86,86,
Pontotoc,Lieutenant Governor,Todd Lamb,REP,620063,3,9,127,139,
Pontotoc,Superintendent of Public Instruction,John Cox,DEM,620063,0,2,123,125,
Pontotoc,Superintendent of Public Instruction,Joy Hofmeister,REP,620063,3,7,91,101,
Pontotoc,Commissioner of Labor,Mike Workman,DEM,620063,1,1,103,105,
Pontotoc,Commissioner of Labor,Mark Costello,REP,620063,2,8,99,109,
Pontotoc,U.S. Senate,Matt Silverstein,DEM,620063,0,0,66,66,
Pontotoc,U.S. Senate,Jim Inhofe,REP,620063,3,9,142,154,
Pontotoc,U.S. Senate,Aaron Delozier,IND,620063,0,0,3,3,
Pontotoc,U.S. Senate,Ray Woods,IND,620063,0,0,0,0,
Pontotoc,U.S. Senate,Joan Farr,IND,620063,0,0,4,4,
Pontotoc,U.S. Senate,Connie Johnson,DEM,620063,0,2,66,68,
Pontotoc,U.S. Senate,James Lankford,REP,620063,3,7,137,147,
Pontotoc,U.S. Senate,Mark Beard,IND,620063,0,0,10,10,
Pontotoc,U.S. House,Bert Smith,DEM,620063,0,1,61,62,04
Pontotoc,U.S. House,Tom Cole,REP,620063,3,7,149,159,04
Pontotoc,U.S. House,Dennis Johnson,IND,620063,0,0,7,7,04
Pontotoc,Governor,Joe Dorman,DEM,620064,0,8,156,164,
Pontotoc,Governor,Mary Fallin,REP,620064,2,3,148,153,
Pontotoc,Governor,Kimberly Willis,IND,620064,0,1,4,5,
Pontotoc,Governor,Richard Prawdzienski,IND,620064,0,0,5,5,
Pontotoc,Lieutenant Governor,Cathy Cummings,DEM,620064,0,5,93,98,
Pontotoc,Lieutenant Governor,Todd Lamb,REP,620064,2,7,219,228,
Pontotoc,Superintendent of Public Instruction,John Cox,DEM,620064,1,9,159,169,
Pontotoc,Superintendent of Public Instruction,Joy Hofmeister,REP,620064,1,3,155,159,
Pontotoc,Commissioner of Labor,Mike Workman,DEM,620064,1,6,121,128,
Pontotoc,Commissioner of Labor,Mark Costello,REP,620064,1,6,187,194,
Pontotoc,U.S. Senate,Matt Silverstein,DEM,620064,0,3,76,79,
Pontotoc,U.S. Senate,Jim Inhofe,REP,620064,2,8,222,232,
Pontotoc,U.S. Senate,Aaron Delozier,IND,620064,0,1,3,4,
Pontotoc,U.S. Senate,Ray Woods,IND,620064,0,0,7,7,
Pontotoc,U.S. Senate,Joan Farr,IND,620064,0,0,5,5,
Pontotoc,U.S. Senate,Connie Johnson,DEM,620064,1,4,84,89,
Pontotoc,U.S. Senate,James Lankford,REP,620064,1,7,216,224,
Pontotoc,U.S. Senate,Mark Beard,IND,620064,0,1,12,13,
Pontotoc,U.S. House,Bert Smith,DEM,620064,0,2,63,65,04
Pontotoc,U.S. House,Tom Cole,REP,620064,2,9,236,247,04
Pontotoc,U.S. House,Dennis Johnson,IND,620064,0,1,15,16,04
Pontotoc,Governor,Joe Dorman,DEM,620065,3,6,101,110,
Pontotoc,Governor,Mary Fallin,REP,620065,5,7,120,132,
Pontotoc,Governor,Kimberly Willis,IND,620065,0,0,6,6,
Pontotoc,Governor,Richard Prawdzienski,IND,620065,0,0,3,3,
Pontotoc,Lieutenant Governor,Cathy Cummings,DEM,620065,1,2,73,76,
Pontotoc,Lieutenant Governor,Todd Lamb,REP,620065,7,12,157,176,
Pontotoc,Superintendent of Public Instruction,John Cox,DEM,620065,4,7,106,117,
Pontotoc,Superintendent of Public Instruction,Joy Hofmeister,REP,620065,4,7,123,134,
Pontotoc,Commissioner of Labor,Mike Workman,DEM,620065,1,2,94,97,
Pontotoc,Commissioner of Labor,Mark Costello,REP,620065,7,12,135,154,
Pontotoc,U.S. Senate,Matt Silverstein,DEM,620065,1,3,56,60,
Pontotoc,U.S. Senate,Jim Inhofe,REP,620065,6,11,167,184,
Pontotoc,U.S. Senate,Aaron Delozier,IND,620065,0,0,3,3,
Pontotoc,U.S. Senate,Ray Woods,IND,620065,1,0,3,4,
Pontotoc,U.S. Senate,Joan Farr,IND,620065,0,0,0,0,
Pontotoc,U.S. Senate,Connie Johnson,DEM,620065,0,2,64,66,
Pontotoc,U.S. Senate,James Lankford,REP,620065,7,12,162,181,
Pontotoc,U.S. Senate,Mark Beard,IND,620065,1,0,4,5,
Pontotoc,U.S. House,Bert Smith,DEM,620065,1,2,47,50,04
Pontotoc,U.S. House,Tom Cole,REP,620065,6,11,176,193,04
Pontotoc,U.S. House,Dennis Johnson,IND,620065,1,1,7,9,04
Pontotoc,Governor,Joe Dorman,DEM,620066,1,3,131,135,
Pontotoc,Governor,Mary Fallin,REP,620066,1,11,130,142,
Pontotoc,Governor,Kimberly Willis,IND,620066,0,0,8,8,
Pontotoc,Governor,Richard Prawdzienski,IND,620066,0,0,1,1,
Pontotoc,Lieutenant Governor,Cathy Cummings,DEM,620066,1,5,67,73,
Pontotoc,Lieutenant Governor,Todd Lamb,REP,620066,1,10,202,213,
Pontotoc,Superintendent of Public Instruction,John Cox,DEM,620066,1,5,118,124,
Pontotoc,Superintendent of Public Instruction,Joy Hofmeister,REP,620066,1,10,148,159,
Pontotoc,Commissioner of Labor,Mike Workman,DEM,620066,1,7,93,101,
Pontotoc,Commissioner of Labor,Mark Costello,REP,620066,1,7,172,180,
Pontotoc,U.S. Senate,Matt Silverstein,DEM,620066,1,3,57,61,
Pontotoc,U.S. Senate,Jim Inhofe,REP,620066,1,12,202,215,
Pontotoc,U.S. Senate,Aaron Delozier,IND,620066,0,0,3,3,
Pontotoc,U.S. Senate,Ray Woods,IND,620066,0,0,6,6,
Pontotoc,U.S. Senate,Joan Farr,IND,620066,0,0,1,1,
Pontotoc,U.S. Senate,Connie Johnson,DEM,620066,1,1,60,62,
Pontotoc,U.S. Senate,James Lankford,REP,620066,1,13,196,210,
Pontotoc,U.S. Senate,Mark Beard,IND,620066,0,1,13,14,
Pontotoc,U.S. House,Bert Smith,DEM,620066,0,2,42,44,04
Pontotoc,U.S. House,Tom Cole,REP,620066,2,12,219,233,04
Pontotoc,U.S. House,Dennis Johnson,IND,620066,0,1,8,9,04
Pontotoc,Governor,Joe Dorman,DEM,620067,0,3,79,82,
Pontotoc,Governor,Mary Fallin,REP,620067,3,3,116,122,
Pontotoc,Governor,Kimberly Willis,IND,620067,0,0,5,5,
Pontotoc,Governor,Richard Prawdzienski,IND,620067,0,0,4,4,
Pontotoc,Lieutenant Governor,Cathy Cummings,DEM,620067,0,2,46,48,
Pontotoc,Lieutenant Governor,Todd Lamb,REP,620067,3,4,157,164,
Pontotoc,Superintendent of Public Instruction,John Cox,DEM,620067,1,6,89,96,
Pontotoc,Superintendent of Public Instruction,Joy Hofmeister,REP,620067,2,0,113,115,
Pontotoc,Commissioner of Labor,Mike Workman,DEM,620067,0,4,61,65,
Pontotoc,Commissioner of Labor,Mark Costello,REP,620067,3,2,138,143,
Pontotoc,U.S. Senate,Matt Silverstein,DEM,620067,0,3,37,40,
Pontotoc,U.S. Senate,Jim Inhofe,REP,620067,3,3,158,164,
Pontotoc,U.S. Senate,Aaron Delozier,IND,620067,0,0,0,0,
Pontotoc,U.S. Senate,Ray Woods,IND,620067,0,0,5,5,
Pontotoc,U.S. Senate,Joan Farr,IND,620067,0,0,2,2,
Pontotoc,U.S. Senate,Connie Johnson,DEM,620067,0,3,30,33,
Pontotoc,U.S. Senate,James Lankford,REP,620067,3,1,165,169,
Pontotoc,U.S. Senate,Mark Beard,IND,620067,0,2,7,9,
Pontotoc,U.S. House,Bert Smith,DEM,620067,0,2,34,36,04
Pontotoc,U.S. House,Tom Cole,REP,620067,3,4,160,167,04
Pontotoc,U.S. House,Dennis Johnson,IND,620067,0,0,8,8,04
Pottawatomie,Governor,Joe Dorman,DEM,630001,1,6,77,84,
Pottawatomie,Governor,Mary Fallin,REP,630001,1,10,168,179,
Pottawatomie,Governor,Kimberly Willis,IND,630001,0,0,6,6,
Pottawatomie,Governor,Richard Prawdzienski,IND,630001,0,0,2,2,
Pottawatomie,Lieutenant Governor,Cathy Cummings,DEM,630001,1,4,58,63,
Pottawatomie,Lieutenant Governor,Todd Lamb,REP,630001,1,12,195,208,
Pottawatomie,Superintendent of Public Instruction,John Cox,DEM,630001,1,9,93,103,
Pottawatomie,Superintendent of Public Instruction,Joy Hofmeister,REP,630001,1,7,159,167,
Pottawatomie,Commissioner of Labor,Mike Workman,DEM,630001,2,6,71,79,
Pottawatomie,Commissioner of Labor,Mark Costello,REP,630001,0,10,178,188,
Pottawatomie,U.S. Senate,Matt Silverstein,DEM,630001,1,3,45,49,
Pottawatomie,U.S. Senate,Jim Inhofe,REP,630001,1,13,200,214,
Pottawatomie,U.S. Senate,Aaron Delozier,IND,630001,0,0,0,0,
Pottawatomie,U.S. Senate,Ray Woods,IND,630001,0,0,4,4,
Pottawatomie,U.S. Senate,Joan Farr,IND,630001,0,0,1,1,
Pottawatomie,U.S. Senate,Connie Johnson,DEM,630001,1,4,49,54,
Pottawatomie,U.S. Senate,James Lankford,REP,630001,0,11,201,212,
Pottawatomie,U.S. Senate,Mark Beard,IND,630001,0,1,4,5,
Pottawatomie,U.S. House,Al Mcaffrey,DEM,630001,1,2,53,56,05
Pottawatomie,U.S. House,Steve Russell,REP,630001,1,12,188,201,05
Pottawatomie,U.S. House,Buddy Ray,IND,630001,0,1,1,2,05
Pottawatomie,U.S. House,Tom Boggs,IND,630001,0,1,7,8,05
Pottawatomie,U.S. House,Robert Murphy,IND,630001,0,0,3,3,05
Pottawatomie,State Senate,Marilyn Rainwater,DEM,630001,1,7,62,70,28
Pottawatomie,State Senate,Jason Smalley,REP,630001,1,9,188,198,28
Pottawatomie,State House,Pamela Snider Stephens,DEM,630001,1,3,63,67,26
Pottawatomie,State House,Justin Freeland Wood,REP,630001,1,13,188,202,26
Pottawatomie,Governor,Joe Dorman,DEM,630002,5,2,121,128,
Pottawatomie,Governor,Mary Fallin,REP,630002,3,4,162,169,
Pottawatomie,Governor,Kimberly Willis,IND,630002,0,0,11,11,
Pottawatomie,Governor,Richard Prawdzienski,IND,630002,0,0,4,4,
Pottawatomie,Lieutenant Governor,Cathy Cummings,DEM,630002,5,3,110,118,
Pottawatomie,Lieutenant Governor,Todd Lamb,REP,630002,3,3,186,192,
Pottawatomie,Superintendent of Public Instruction,John Cox,DEM,630002,5,4,132,141,
Pottawatomie,Superintendent of Public Instruction,Joy Hofmeister,REP,630002,3,2,163,168,
Pottawatomie,Commissioner of Labor,Mike Workman,DEM,630002,5,4,118,127,
Pottawatomie,Commissioner of Labor,Mark Costello,REP,630002,3,2,171,176,
Pottawatomie,U.S. Senate,Matt Silverstein,DEM,630002,4,1,82,87,
Pottawatomie,U.S. Senate,Jim Inhofe,REP,630002,4,5,196,205,
Pottawatomie,U.S. Senate,Aaron Delozier,IND,630002,0,0,3,3,
Pottawatomie,U.S. Senate,Ray Woods,IND,630002,0,0,13,13,
Pottawatomie,U.S. Senate,Joan Farr,IND,630002,0,0,3,3,
Pottawatomie,U.S. Senate,Connie Johnson,DEM,630002,4,1,88,93,
Pottawatomie,U.S. Senate,James Lankford,REP,630002,4,5,196,205,
Pottawatomie,U.S. Senate,Mark Beard,IND,630002,0,0,14,14,
Pottawatomie,U.S. House,Al Mcaffrey,DEM,630002,5,2,81,88,05
Pottawatomie,U.S. House,Steve Russell,REP,630002,3,4,195,202,05
Pottawatomie,U.S. House,Buddy Ray,IND,630002,0,0,7,7,05
Pottawatomie,U.S. House,Tom Boggs,IND,630002,0,0,7,7,05
Pottawatomie,U.S. House,Robert Murphy,IND,630002,0,0,5,5,05
Pottawatomie,State House,Pamela Snider Stephens,DEM,630002,5,2,97,104,26
Pottawatomie,State House,Justin Freeland Wood,REP,630002,3,4,198,205,26
Pottawatomie,Governor,Joe Dorman,DEM,630003,11,11,252,274,
Pottawatomie,Governor,Mary Fallin,REP,630003,6,12,268,286,
Pottawatomie,Governor,Kimberly Willis,IND,630003,0,0,13,13,
Pottawatomie,Governor,Richard Prawdzienski,IND,630003,0,0,11,11,
Pottawatomie,Lieutenant Governor,Cathy Cummings,DEM,630003,10,10,220,240,
Pottawatomie,Lieutenant Governor,Todd Lamb,REP,630003,7,14,322,343,
Pottawatomie,Superintendent of Public Instruction,John Cox,DEM,630003,13,13,263,289,
Pottawatomie,Superintendent of Public Instruction,Joy Hofmeister,REP,630003,4,9,276,289,
Pottawatomie,Commissioner of Labor,Mike Workman,DEM,630003,11,9,258,278,
Pottawatomie,Commissioner of Labor,Mark Costello,REP,630003,6,13,276,295,
Pottawatomie,U.S. Senate,Matt Silverstein,DEM,630003,11,9,188,208,
Pottawatomie,U.S. Senate,Jim Inhofe,REP,630003,6,13,313,332,
Pottawatomie,U.S. Senate,Aaron Delozier,IND,630003,0,1,3,4,
Pottawatomie,U.S. Senate,Ray Woods,IND,630003,0,0,23,23,
Pottawatomie,U.S. Senate,Joan Farr,IND,630003,0,0,12,12,
Pottawatomie,U.S. Senate,Connie Johnson,DEM,630003,9,9,205,223,
Pottawatomie,U.S. Senate,James Lankford,REP,630003,7,15,325,347,
Pottawatomie,U.S. Senate,Mark Beard,IND,630003,1,0,14,15,
Pottawatomie,U.S. House,Al Mcaffrey,DEM,630003,10,9,192,211,05
Pottawatomie,U.S. House,Steve Russell,REP,630003,6,12,320,338,05
Pottawatomie,U.S. House,Buddy Ray,IND,630003,0,1,10,11,05
Pottawatomie,U.S. House,Tom Boggs,IND,630003,1,0,8,9,05
Pottawatomie,U.S. House,Robert Murphy,IND,630003,0,0,10,10,05
Pottawatomie,State House,Pamela Snider Stephens,DEM,630003,9,9,207,225,26
Pottawatomie,State House,Justin Freeland Wood,REP,630003,8,15,331,354,26
Pottawatomie,Governor,Joe Dorman,DEM,630006,4,11,175,190,
Pottawatomie,Governor,Mary Fallin,REP,630006,10,7,207,224,
Pottawatomie,Governor,Kimberly Willis,IND,630006,0,0,13,13,
Pottawatomie,Governor,Richard Prawdzienski,IND,630006,0,0,8,8,
Pottawatomie,Lieutenant Governor,Cathy Cummings,DEM,630006,4,7,126,137,
Pottawatomie,Lieutenant Governor,Todd Lamb,REP,630006,10,11,274,295,
Pottawatomie,Superintendent of Public Instruction,John Cox,DEM,630006,5,11,178,194,
Pottawatomie,Superintendent of Public Instruction,Joy Hofmeister,REP,630006,8,7,223,238,
Pottawatomie,Commissioner of Labor,Mike Workman,DEM,630006,3,9,153,165,
Pottawatomie,Commissioner of Labor,Mark Costello,REP,630006,8,9,244,261,
Pottawatomie,U.S. Senate,Matt Silverstein,DEM,630006,3,8,114,125,
Pottawatomie,U.S. Senate,Jim Inhofe,REP,630006,10,10,261,281,
Pottawatomie,U.S. Senate,Aaron Delozier,IND,630006,0,0,2,2,
Pottawatomie,U.S. Senate,Ray Woods,IND,630006,0,0,15,15,
Pottawatomie,U.S. Senate,Joan Farr,IND,630006,1,0,9,10,
Pottawatomie,U.S. Senate,Connie Johnson,DEM,630006,3,7,120,130,
Pottawatomie,U.S. Senate,James Lankford,REP,630006,10,11,269,290,
Pottawatomie,U.S. Senate,Mark Beard,IND,630006,1,0,14,15,
Pottawatomie,U.S. House,Al Mcaffrey,DEM,630006,3,8,118,129,05
Pottawatomie,U.S. House,Steve Russell,REP,630006,8,9,258,275,05
Pottawatomie,U.S. House,Buddy Ray,IND,630006,0,0,4,4,05
Pottawatomie,U.S. House,Tom Boggs,IND,630006,0,1,14,15,05
Pottawatomie,U.S. House,Robert Murphy,IND,630006,0,0,6,6,05
Pottawatomie,State House,Pamela Snider Stephens,DEM,630006,6,6,135,147,26
Pottawatomie,State House,Justin Freeland Wood,REP,630006,8,12,264,284,26
Pottawatomie,Governor,Joe Dorman,DEM,630007,7,16,223,246,
Pottawatomie,Governor,Mary Fallin,REP,630007,5,28,286,319,
Pottawatomie,Governor,Kimberly Willis,IND,630007,0,0,15,15,
Pottawatomie,Governor,Richard Prawdzienski,IND,630007,0,0,6,6,
Pottawatomie,Lieutenant Governor,Cathy Cummings,DEM,630007,6,13,158,177,
Pottawatomie,Lieutenant Governor,Todd Lamb,REP,630007,6,31,367,404,
Pottawatomie,Superintendent of Public Instruction,John Cox,DEM,630007,7,13,240,260,
Pottawatomie,Superintendent of Public Instruction,Joy Hofmeister,REP,630007,5,31,286,322,
Pottawatomie,Commissioner of Labor,Mike Workman,DEM,630007,3,13,208,224,
Pottawatomie,Commissioner of Labor,Mark Costello,REP,630007,9,29,303,341,
Pottawatomie,U.S. Senate,Matt Silverstein,DEM,630007,5,12,146,163,
Pottawatomie,U.S. Senate,Jim Inhofe,REP,630007,7,31,356,394,
Pottawatomie,U.S. Senate,Aaron Delozier,IND,630007,0,1,6,7,
Pottawatomie,U.S. Senate,Ray Woods,IND,630007,0,0,10,10,
Pottawatomie,U.S. Senate,Joan Farr,IND,630007,0,0,6,6,
Pottawatomie,U.S. Senate,Connie Johnson,DEM,630007,3,8,135,146,
Pottawatomie,U.S. Senate,James Lankford,REP,630007,9,36,376,421,
Pottawatomie,U.S. Senate,Mark Beard,IND,630007,0,0,17,17,
Pottawatomie,U.S. House,Al Mcaffrey,DEM,630007,5,10,157,172,05
Pottawatomie,U.S. House,Steve Russell,REP,630007,7,34,349,390,05
Pottawatomie,U.S. House,Buddy Ray,IND,630007,0,0,5,5,05
Pottawatomie,U.S. House,Tom Boggs,IND,630007,0,0,3,3,05
Pottawatomie,U.S. House,Robert Murphy,IND,630007,0,0,7,7,05
Pottawatomie,State House,Pamela Snider Stephens,DEM,630007,3,9,153,165,26
Pottawatomie,State House,Justin Freeland Wood,REP,630007,9,35,371,415,26
Pottawatomie,Governor,Joe Dorman,DEM,630009,12,13,241,266,
Pottawatomie,Governor,Mary Fallin,REP,630009,11,55,419,485,
Pottawatomie,Governor,Kimberly Willis,IND,630009,1,0,10,11,
Pottawatomie,Governor,Richard Prawdzienski,IND,630009,0,0,5,5,
Pottawatomie,Lieutenant Governor,Cathy Cummings,DEM,630009,8,9,171,188,
Pottawatomie,Lieutenant Governor,Todd Lamb,REP,630009,16,60,502,578,
Pottawatomie,Superintendent of Public Instruction,John Cox,DEM,630009,10,17,284,311,
Pottawatomie,Superintendent of Public Instruction,Joy Hofmeister,REP,630009,14,52,387,453,
Pottawatomie,Commissioner of Labor,Mike Workman,DEM,630009,9,10,201,220,
Pottawatomie,Commissioner of Labor,Mark Costello,REP,630009,15,58,455,528,
Pottawatomie,U.S. Senate,Matt Silverstein,DEM,630009,8,8,133,149,
Pottawatomie,U.S. Senate,Jim Inhofe,REP,630009,16,58,513,587,
Pottawatomie,U.S. Senate,Aaron Delozier,IND,630009,0,0,5,5,
Pottawatomie,U.S. Senate,Ray Woods,IND,630009,0,0,11,11,
Pottawatomie,U.S. Senate,Joan Farr,IND,630009,0,1,9,10,
Pottawatomie,U.S. Senate,Connie Johnson,DEM,630009,7,9,137,153,
Pottawatomie,U.S. Senate,James Lankford,REP,630009,16,59,522,597,
Pottawatomie,U.S. Senate,Mark Beard,IND,630009,0,0,17,17,
Pottawatomie,U.S. House,Al Mcaffrey,DEM,630009,5,9,146,160,05
Pottawatomie,U.S. House,Steve Russell,REP,630009,15,58,487,560,05
Pottawatomie,U.S. House,Buddy Ray,IND,630009,2,0,8,10,05
Pottawatomie,U.S. House,Tom Boggs,IND,630009,0,0,13,13,05
Pottawatomie,U.S. House,Robert Murphy,IND,630009,1,1,12,14,05
Pottawatomie,State House,Pamela Snider Stephens,DEM,630009,5,13,162,180,26
Pottawatomie,State House,Justin Freeland Wood,REP,630009,18,56,505,579,26
Pottawatomie,Governor,Joe Dorman,DEM,630011,6,22,314,342,
Pottawatomie,Governor,Mary Fallin,REP,630011,20,38,604,662,
Pottawatomie,Governor,Kimberly Willis,IND,630011,0,1,16,17,
Pottawatomie,Governor,Richard Prawdzienski,IND,630011,1,0,9,10,
Pottawatomie,Lieutenant Governor,Cathy Cummings,DEM,630011,3,24,231,258,
Pottawatomie,Lieutenant Governor,Todd Lamb,REP,630011,23,37,714,774,
Pottawatomie,Superintendent of Public Instruction,John Cox,DEM,630011,9,27,408,444,
Pottawatomie,Superintendent of Public Instruction,Joy Hofmeister,REP,630011,18,34,533,585,
Pottawatomie,Commissioner of Labor,Mike Workman,DEM,630011,6,24,301,331,
Pottawatomie,Commissioner of Labor,Mark Costello,REP,630011,20,36,615,671,
Pottawatomie,U.S. Senate,Matt Silverstein,DEM,630011,4,17,207,228,
Pottawatomie,U.S. Senate,Jim Inhofe,REP,630011,21,41,705,767,
Pottawatomie,U.S. Senate,Aaron Delozier,IND,630011,1,0,8,9,
Pottawatomie,U.S. Senate,Ray Woods,IND,630011,1,2,19,22,
Pottawatomie,U.S. Senate,Joan Farr,IND,630011,0,1,4,5,
Pottawatomie,U.S. Senate,Connie Johnson,DEM,630011,5,19,204,228,
Pottawatomie,U.S. Senate,James Lankford,REP,630011,21,42,723,786,
Pottawatomie,U.S. Senate,Mark Beard,IND,630011,1,0,22,23,
Pottawatomie,U.S. House,Al Mcaffrey,DEM,630011,5,19,231,255,05
Pottawatomie,U.S. House,Steve Russell,REP,630011,20,40,673,733,05
Pottawatomie,U.S. House,Buddy Ray,IND,630011,1,0,5,6,05
Pottawatomie,U.S. House,Tom Boggs,IND,630011,0,2,16,18,05
Pottawatomie,U.S. House,Robert Murphy,IND,630011,1,0,12,13,05
Pottawatomie,State House,Pamela Snider Stephens,DEM,630011,6,22,221,249,26
Pottawatomie,State House,Justin Freeland Wood,REP,630011,20,39,721,780,26
Pottawatomie,Governor,Joe Dorman,DEM,630012,9,14,249,272,
Pottawatomie,Governor,Mary Fallin,REP,630012,5,19,320,344,
Pottawatomie,Governor,Kimberly Willis,IND,630012,0,0,5,5,
Pottawatomie,Governor,Richard Prawdzienski,IND,630012,0,0,6,6,
Pottawatomie,Lieutenant Governor,Cathy Cummings,DEM,630012,9,11,182,202,
Pottawatomie,Lieutenant Governor,Todd Lamb,REP,630012,5,22,395,422,
Pottawatomie,Superintendent of Public Instruction,John Cox,DEM,630012,8,13,267,288,
Pottawatomie,Superintendent of Public Instruction,Joy Hofmeister,REP,630012,6,19,312,337,
Pottawatomie,Commissioner of Labor,Mike Workman,DEM,630012,9,12,213,234,
Pottawatomie,Commissioner of Labor,Mark Costello,REP,630012,5,20,354,379,
Pottawatomie,U.S. Senate,Matt Silverstein,DEM,630012,10,13,161,184,
Pottawatomie,U.S. Senate,Jim Inhofe,REP,630012,4,20,397,421,
Pottawatomie,U.S. Senate,Aaron Delozier,IND,630012,0,0,4,4,
Pottawatomie,U.S. Senate,Ray Woods,IND,630012,0,0,9,9,
Pottawatomie,U.S. Senate,Joan Farr,IND,630012,0,0,6,6,
Pottawatomie,U.S. Senate,Connie Johnson,DEM,630012,10,12,152,174,
Pottawatomie,U.S. Senate,James Lankford,REP,630012,4,21,414,439,
Pottawatomie,U.S. Senate,Mark Beard,IND,630012,0,0,14,14,
Pottawatomie,U.S. House,Al Mcaffrey,DEM,630012,9,11,182,202,05
Pottawatomie,U.S. House,Steve Russell,REP,630012,5,21,379,405,05
Pottawatomie,U.S. House,Buddy Ray,IND,630012,0,0,2,2,05
Pottawatomie,U.S. House,Tom Boggs,IND,630012,0,0,5,5,05
Pottawatomie,U.S. House,Robert Murphy,IND,630012,0,0,9,9,05
Pottawatomie,State House,Pamela Snider Stephens,DEM,630012,8,13,164,185,26
Pottawatomie,State House,Justin Freeland Wood,REP,630012,6,19,417,442,26
Pottawatomie,Governor,Joe Dorman,DEM,630013,4,21,328,353,
Pottawatomie,Governor,Mary Fallin,REP,630013,15,31,527,573,
Pottawatomie,Governor,Kimberly Willis,IND,630013,0,0,9,9,
Pottawatomie,Governor,Richard Prawdzienski,IND,630013,0,0,1,1,
Pottawatomie,Lieutenant Governor,Cathy Cummings,DEM,630013,3,16,256,275,
Pottawatomie,Lieutenant Governor,Todd Lamb,REP,630013,16,35,605,656,
Pottawatomie,Superintendent of Public Instruction,John Cox,DEM,630013,5,25,382,412,
Pottawatomie,Superintendent of Public Instruction,Joy Hofmeister,REP,630013,13,26,475,514,
Pottawatomie,Commissioner of Labor,Mike Workman,DEM,630013,4,20,301,325,
Pottawatomie,Commissioner of Labor,Mark Costello,REP,630013,14,29,538,581,
Pottawatomie,U.S. Senate,Matt Silverstein,DEM,630013,4,18,229,251,
Pottawatomie,U.S. Senate,Jim Inhofe,REP,630013,14,32,607,653,
Pottawatomie,U.S. Senate,Aaron Delozier,IND,630013,0,0,3,3,
Pottawatomie,U.S. Senate,Ray Woods,IND,630013,0,0,10,10,
Pottawatomie,U.S. Senate,Joan Farr,IND,630013,1,0,11,12,
Pottawatomie,U.S. Senate,Connie Johnson,DEM,630013,3,15,215,233,
Pottawatomie,U.S. Senate,James Lankford,REP,630013,15,36,628,679,
Pottawatomie,U.S. Senate,Mark Beard,IND,630013,1,1,21,23,
Pottawatomie,U.S. House,Al Mcaffrey,DEM,630013,5,16,241,262,05
Pottawatomie,U.S. House,Steve Russell,REP,630013,13,34,591,638,05
Pottawatomie,U.S. House,Buddy Ray,IND,630013,0,1,4,5,05
Pottawatomie,U.S. House,Tom Boggs,IND,630013,1,0,9,10,05
Pottawatomie,U.S. House,Robert Murphy,IND,630013,0,0,13,13,05
Pottawatomie,State House,Pamela Snider Stephens,DEM,630013,1,13,240,254,26
Pottawatomie,State House,Justin Freeland Wood,REP,630013,18,38,618,674,26
Pottawatomie,Governor,Joe Dorman,DEM,630015,4,17,252,273,
Pottawatomie,Governor,Mary Fallin,REP,630015,12,24,363,399,
Pottawatomie,Governor,Kimberly Willis,IND,630015,0,1,26,27,
Pottawatomie,Governor,Richard Prawdzienski,IND,630015,0,0,9,9,
Pottawatomie,Lieutenant Governor,Cathy Cummings,DEM,630015,5,12,203,220,
Pottawatomie,Lieutenant Governor,Todd Lamb,REP,630015,10,30,444,484,
Pottawatomie,Superintendent of Public Instruction,John Cox,DEM,630015,7,21,279,307,
Pottawatomie,Superintendent of Public Instruction,Joy Hofmeister,REP,630015,9,21,367,397,
Pottawatomie,Commissioner of Labor,Mike Workman,DEM,630015,5,19,261,285,
Pottawatomie,Commissioner of Labor,Mark Costello,REP,630015,10,22,368,400,
Pottawatomie,U.S. Senate,Matt Silverstein,DEM,630015,4,10,176,190,
Pottawatomie,U.S. Senate,Jim Inhofe,REP,630015,12,32,444,488,
Pottawatomie,U.S. Senate,Aaron Delozier,IND,630015,0,0,8,8,
Pottawatomie,U.S. Senate,Ray Woods,IND,630015,0,0,12,12,
Pottawatomie,U.S. Senate,Joan Farr,IND,630015,0,0,5,5,
Pottawatomie,U.S. Senate,Connie Johnson,DEM,630015,4,9,186,199,
Pottawatomie,U.S. Senate,James Lankford,REP,630015,11,32,440,483,
Pottawatomie,U.S. Senate,Mark Beard,IND,630015,1,1,22,24,
Pottawatomie,U.S. House,Al Mcaffrey,DEM,630015,5,8,199,212,05
Pottawatomie,U.S. House,Steve Russell,REP,630015,11,33,409,453,05
Pottawatomie,U.S. House,Buddy Ray,IND,630015,0,0,8,8,05
Pottawatomie,U.S. House,Tom Boggs,IND,630015,0,0,17,17,05
Pottawatomie,U.S. House,Robert Murphy,IND,630015,0,1,13,14,05
Pottawatomie,State House,Pamela Snider Stephens,DEM,630015,5,13,201,219,26
Pottawatomie,State House,Justin Freeland Wood,REP,630015,10,29,446,485,26
Pottawatomie,Governor,Joe Dorman,DEM,630018,4,19,222,245,
Pottawatomie,Governor,Mary Fallin,REP,630018,14,19,357,390,
Pottawatomie,Governor,Kimberly Willis,IND,630018,0,3,22,25,
Pottawatomie,Governor,Richard Prawdzienski,IND,630018,0,0,7,7,
Pottawatomie,Lieutenant Governor,Cathy Cummings,DEM,630018,4,16,174,194,
Pottawatomie,Lieutenant Governor,Todd Lamb,REP,630018,14,24,427,465,
Pottawatomie,Superintendent of Public Instruction,John Cox,DEM,630018,7,20,243,270,
Pottawatomie,Superintendent of Public Instruction,Joy Hofmeister,REP,630018,11,20,361,392,
Pottawatomie,Commissioner of Labor,Mike Workman,DEM,630018,4,17,210,231,
Pottawatomie,Commissioner of Labor,Mark Costello,REP,630018,14,24,382,420,
Pottawatomie,U.S. Senate,Matt Silverstein,DEM,630018,4,14,146,164,
Pottawatomie,U.S. Senate,Jim Inhofe,REP,630018,12,25,433,470,
Pottawatomie,U.S. Senate,Aaron Delozier,IND,630018,2,0,5,7,
Pottawatomie,U.S. Senate,Ray Woods,IND,630018,0,1,12,13,
Pottawatomie,U.S. Senate,Joan Farr,IND,630018,0,0,7,7,
Pottawatomie,U.S. Senate,Connie Johnson,DEM,630018,4,13,158,175,
Pottawatomie,U.S. Senate,James Lankford,REP,630018,14,28,431,473,
Pottawatomie,U.S. Senate,Mark Beard,IND,630018,0,0,15,15,
Pottawatomie,U.S. House,Al Mcaffrey,DEM,630018,4,14,168,186,05
Pottawatomie,U.S. House,Steve Russell,REP,630018,13,25,403,441,05
Pottawatomie,U.S. House,Buddy Ray,IND,630018,0,2,8,10,05
Pottawatomie,U.S. House,Tom Boggs,IND,630018,0,0,10,10,05
Pottawatomie,U.S. House,Robert Murphy,IND,630018,1,0,12,13,05
Pottawatomie,State House,Pamela Snider Stephens,DEM,630018,6,11,165,182,26
Pottawatomie,State House,Justin Freeland Wood,REP,630018,12,30,435,477,26
Pottawatomie,Governor,Joe Dorman,DEM,630021,1,4,95,100,
Pottawatomie,Governor,Mary Fallin,REP,630021,5,8,252,265,
Pottawatomie,Governor,Kimberly Willis,IND,630021,0,0,4,4,
Pottawatomie,Governor,Richard Prawdzienski,IND,630021,0,0,2,2,
Pottawatomie,Lieutenant Governor,Cathy Cummings,DEM,630021,2,4,72,78,
Pottawatomie,Lieutenant Governor,Todd Lamb,REP,630021,4,8,278,290,
Pottawatomie,Superintendent of Public Instruction,John Cox,DEM,630021,2,4,125,131,
Pottawatomie,Superintendent of Public Instruction,Joy Hofmeister,REP,630021,4,8,226,238,
Pottawatomie,Commissioner of Labor,Mike Workman,DEM,630021,1,3,97,101,
Pottawatomie,Commissioner of Labor,Mark Costello,REP,630021,5,8,248,261,
Pottawatomie,U.S. Senate,Matt Silverstein,DEM,630021,1,2,68,71,
Pottawatomie,U.S. Senate,Jim Inhofe,REP,630021,5,8,272,285,
Pottawatomie,U.S. Senate,Aaron Delozier,IND,630021,0,1,1,2,
Pottawatomie,U.S. Senate,Ray Woods,IND,630021,0,0,2,2,
Pottawatomie,U.S. Senate,Joan Farr,IND,630021,0,0,3,3,
Pottawatomie,U.S. Senate,Connie Johnson,DEM,630021,1,2,64,67,
Pottawatomie,U.S. Senate,James Lankford,REP,630021,5,10,282,297,
Pottawatomie,U.S. Senate,Mark Beard,IND,630021,0,0,6,6,
Pottawatomie,U.S. House,Al Mcaffrey,DEM,630021,1,4,68,73,05
Pottawatomie,U.S. House,Steve Russell,REP,630021,5,7,268,280,05
Pottawatomie,U.S. House,Buddy Ray,IND,630021,0,0,3,3,05
Pottawatomie,U.S. House,Tom Boggs,IND,630021,0,0,4,4,05
Pottawatomie,U.S. House,Robert Murphy,IND,630021,0,1,3,4,05
Pottawatomie,State Senate,Marilyn Rainwater,DEM,630021,1,3,84,88,28
Pottawatomie,State Senate,Jason Smalley,REP,630021,5,9,261,275,28
Pottawatomie,State House,Pamela Snider Stephens,DEM,630021,1,2,68,71,26
Pottawatomie,State House,Justin Freeland Wood,REP,630021,4,10,281,295,26
Pottawatomie,Governor,Joe Dorman,DEM,630022,12,26,214,252,
Pottawatomie,Governor,Mary Fallin,REP,630022,5,29,497,531,
Pottawatomie,Governor,Kimberly Willis,IND,630022,0,0,15,15,
Pottawatomie,Governor,Richard Prawdzienski,IND,630022,0,1,7,8,
Pottawatomie,Lieutenant Governor,Cathy Cummings,DEM,630022,12,17,147,176,
Pottawatomie,Lieutenant Governor,Todd Lamb,REP,630022,4,38,588,630,
Pottawatomie,Superintendent of Public Instruction,John Cox,DEM,630022,11,30,259,300,
Pottawatomie,Superintendent of Public Instruction,Joy Hofmeister,REP,630022,4,25,475,504,
Pottawatomie,Commissioner of Labor,Mike Workman,DEM,630022,12,24,198,234,
Pottawatomie,Commissioner of Labor,Mark Costello,REP,630022,4,31,526,561,
Pottawatomie,U.S. Senate,Matt Silverstein,DEM,630022,12,18,126,156,
Pottawatomie,U.S. Senate,Jim Inhofe,REP,630022,6,37,570,613,
Pottawatomie,U.S. Senate,Aaron Delozier,IND,630022,0,0,7,7,
Pottawatomie,U.S. Senate,Ray Woods,IND,630022,0,0,16,16,
Pottawatomie,U.S. Senate,Joan Farr,IND,630022,0,0,10,10,
Pottawatomie,U.S. Senate,Connie Johnson,DEM,630022,12,17,117,146,
Pottawatomie,U.S. Senate,James Lankford,REP,630022,6,38,598,642,
Pottawatomie,U.S. Senate,Mark Beard,IND,630022,0,1,20,21,
Pottawatomie,U.S. House,Al Mcaffrey,DEM,630022,11,15,132,158,05
Pottawatomie,U.S. House,Steve Russell,REP,630022,6,39,574,619,05
Pottawatomie,U.S. House,Buddy Ray,IND,630022,0,0,8,8,05
Pottawatomie,U.S. House,Tom Boggs,IND,630022,0,1,12,13,05
Pottawatomie,U.S. House,Robert Murphy,IND,630022,1,0,8,9,05
Pottawatomie,State Senate,Marilyn Rainwater,DEM,630022,12,26,178,216,28
Pottawatomie,State Senate,Jason Smalley,REP,630022,4,29,553,586,28
Pottawatomie,Governor,Joe Dorman,DEM,630024,4,6,200,210,
Pottawatomie,Governor,Mary Fallin,REP,630024,21,23,500,544,
Pottawatomie,Governor,Kimberly Willis,IND,630024,0,0,20,20,
Pottawatomie,Governor,Richard Prawdzienski,IND,630024,0,0,10,10,
Pottawatomie,Lieutenant Governor,Cathy Cummings,DEM,630024,2,6,148,156,
Pottawatomie,Lieutenant Governor,Todd Lamb,REP,630024,23,23,580,626,
Pottawatomie,Superintendent of Public Instruction,John Cox,DEM,630024,8,7,263,278,
Pottawatomie,Superintendent of Public Instruction,Joy Hofmeister,REP,630024,17,22,463,502,
Pottawatomie,Commissioner of Labor,Mike Workman,DEM,630024,8,5,192,205,
Pottawatomie,Commissioner of Labor,Mark Costello,REP,630024,16,24,521,561,
Pottawatomie,U.S. Senate,Matt Silverstein,DEM,630024,3,5,130,138,
Pottawatomie,U.S. Senate,Jim Inhofe,REP,630024,22,23,571,616,
Pottawatomie,U.S. Senate,Aaron Delozier,IND,630024,0,1,2,3,
Pottawatomie,U.S. Senate,Ray Woods,IND,630024,0,0,16,16,
Pottawatomie,U.S. Senate,Joan Farr,IND,630024,0,0,9,9,
Pottawatomie,U.S. Senate,Connie Johnson,DEM,630024,1,5,118,124,
Pottawatomie,U.S. Senate,James Lankford,REP,630024,24,22,586,632,
Pottawatomie,U.S. Senate,Mark Beard,IND,630024,0,2,21,23,
Pottawatomie,U.S. House,Al Mcaffrey,DEM,630024,3,5,139,147,05
Pottawatomie,U.S. House,Steve Russell,REP,630024,18,24,555,597,05
Pottawatomie,U.S. House,Buddy Ray,IND,630024,0,0,8,8,05
Pottawatomie,U.S. House,Tom Boggs,IND,630024,2,0,14,16,05
Pottawatomie,U.S. House,Robert Murphy,IND,630024,0,0,5,5,05
Pottawatomie,State Senate,Marilyn Rainwater,DEM,630024,4,5,167,176,28
Pottawatomie,State Senate,Jason Smalley,REP,630024,20,24,555,599,28
Pottawatomie,State House,Jason Leonard,DEM,630024,4,5,154,163,28
Pottawatomie,State House,Tom Newell,REP,630024,21,24,565,610,28
Pottawatomie,Governor,Joe Dorman,DEM,630025,5,2,155,162,
Pottawatomie,Governor,Mary Fallin,REP,630025,9,9,281,299,
Pottawatomie,Governor,Kimberly Willis,IND,630025,0,0,8,8,
Pottawatomie,Governor,Richard Prawdzienski,IND,630025,0,0,7,7,
Pottawatomie,Lieutenant Governor,Cathy Cummings,DEM,630025,7,1,120,128,
Pottawatomie,Lieutenant Governor,Todd Lamb,REP,630025,7,10,330,347,
Pottawatomie,Superintendent of Public Instruction,John Cox,DEM,630025,9,2,182,193,
Pottawatomie,Superintendent of Public Instruction,Joy Hofmeister,REP,630025,5,9,267,281,
Pottawatomie,Commissioner of Labor,Mike Workman,DEM,630025,7,1,156,164,
Pottawatomie,Commissioner of Labor,Mark Costello,REP,630025,7,10,284,301,
Pottawatomie,U.S. Senate,Matt Silverstein,DEM,630025,6,1,99,106,
Pottawatomie,U.S. Senate,Jim Inhofe,REP,630025,8,10,328,346,
Pottawatomie,U.S. Senate,Aaron Delozier,IND,630025,0,0,9,9,
Pottawatomie,U.S. Senate,Ray Woods,IND,630025,0,0,7,7,
Pottawatomie,U.S. Senate,Joan Farr,IND,630025,0,0,6,6,
Pottawatomie,U.S. Senate,Connie Johnson,DEM,630025,6,0,107,113,
Pottawatomie,U.S. Senate,James Lankford,REP,630025,8,9,332,349,
Pottawatomie,U.S. Senate,Mark Beard,IND,630025,0,2,13,15,
Pottawatomie,U.S. House,Al Mcaffrey,DEM,630025,7,0,99,106,05
Pottawatomie,U.S. House,Steve Russell,REP,630025,7,10,327,344,05
Pottawatomie,U.S. House,Buddy Ray,IND,630025,0,1,8,9,05
Pottawatomie,U.S. House,Tom Boggs,IND,630025,0,0,8,8,05
Pottawatomie,U.S. House,Robert Murphy,IND,630025,0,0,6,6,05
Pottawatomie,State Senate,Marilyn Rainwater,DEM,630025,7,1,146,154,28
Pottawatomie,State Senate,Jason Smalley,REP,630025,7,10,295,312,28
Pottawatomie,State House,Jason Leonard,DEM,630025,7,1,131,139,28
Pottawatomie,State House,Tom Newell,REP,630025,7,10,308,325,28
Pottawatomie,Governor,Joe Dorman,DEM,630026,7,9,127,143,
Pottawatomie,Governor,Mary Fallin,REP,630026,13,27,306,346,
Pottawatomie,Governor,Kimberly Willis,IND,630026,0,1,10,11,
Pottawatomie,Governor,Richard Prawdzienski,IND,630026,0,0,6,6,
Pottawatomie,Lieutenant Governor,Cathy Cummings,DEM,630026,6,9,88,103,
Pottawatomie,Lieutenant Governor,Todd Lamb,REP,630026,14,27,358,399,
Pottawatomie,Superintendent of Public Instruction,John Cox,DEM,630026,7,13,164,184,
Pottawatomie,Superintendent of Public Instruction,Joy Hofmeister,REP,630026,13,23,282,318,
Pottawatomie,Commissioner of Labor,Mike Workman,DEM,630026,4,7,109,120,
Pottawatomie,Commissioner of Labor,Mark Costello,REP,630026,16,27,322,365,
Pottawatomie,U.S. Senate,Matt Silverstein,DEM,630026,4,7,70,81,
Pottawatomie,U.S. Senate,Jim Inhofe,REP,630026,15,30,360,405,
Pottawatomie,U.S. Senate,Aaron Delozier,IND,630026,0,0,3,3,
Pottawatomie,U.S. Senate,Ray Woods,IND,630026,0,0,6,6,
Pottawatomie,U.S. Senate,Joan Farr,IND,630026,1,0,7,8,
Pottawatomie,U.S. Senate,Connie Johnson,DEM,630026,4,6,64,74,
Pottawatomie,U.S. Senate,James Lankford,REP,630026,15,30,372,417,
Pottawatomie,U.S. Senate,Mark Beard,IND,630026,1,0,10,11,
Pottawatomie,U.S. House,Al Mcaffrey,DEM,630026,6,6,82,94,05
Pottawatomie,U.S. House,Steve Russell,REP,630026,14,30,346,390,05
Pottawatomie,U.S. House,Buddy Ray,IND,630026,0,0,6,6,05
Pottawatomie,U.S. House,Tom Boggs,IND,630026,0,0,7,7,05
Pottawatomie,U.S. House,Robert Murphy,IND,630026,0,0,2,2,05
Pottawatomie,State Senate,Marilyn Rainwater,DEM,630026,5,7,105,117,28
Pottawatomie,State Senate,Jason Smalley,REP,630026,15,30,335,380,28
Pottawatomie,State House,Pamela Snider Stephens,DEM,630026,5,5,86,96,26
Pottawatomie,State House,Justin Freeland Wood,REP,630026,15,32,356,403,26
Pottawatomie,Governor,Joe Dorman,DEM,630027,4,2,137,143,
Pottawatomie,Governor,Mary Fallin,REP,630027,1,6,259,266,
Pottawatomie,Governor,Kimberly Willis,IND,630027,0,0,12,12,
Pottawatomie,Governor,Richard Prawdzienski,IND,630027,0,0,9,9,
Pottawatomie,Lieutenant Governor,Cathy Cummings,DEM,630027,4,0,107,111,
Pottawatomie,Lieutenant Governor,Todd Lamb,REP,630027,1,8,309,318,
Pottawatomie,Superintendent of Public Instruction,John Cox,DEM,630027,4,1,170,175,
Pottawatomie,Superintendent of Public Instruction,Joy Hofmeister,REP,630027,1,7,245,253,
Pottawatomie,Commissioner of Labor,Mike Workman,DEM,630027,4,0,145,149,
Pottawatomie,Commissioner of Labor,Mark Costello,REP,630027,1,8,264,273,
Pottawatomie,U.S. Senate,Matt Silverstein,DEM,630027,3,0,92,95,
Pottawatomie,U.S. Senate,Jim Inhofe,REP,630027,2,8,299,309,
Pottawatomie,U.S. Senate,Aaron Delozier,IND,630027,0,0,2,2,
Pottawatomie,U.S. Senate,Ray Woods,IND,630027,0,0,15,15,
Pottawatomie,U.S. Senate,Joan Farr,IND,630027,0,0,7,7,
Pottawatomie,U.S. Senate,Connie Johnson,DEM,630027,4,0,89,93,
Pottawatomie,U.S. Senate,James Lankford,REP,630027,1,8,306,315,
Pottawatomie,U.S. Senate,Mark Beard,IND,630027,0,0,22,22,
Pottawatomie,U.S. House,Al Mcaffrey,DEM,630027,3,0,93,96,05
Pottawatomie,U.S. House,Steve Russell,REP,630027,2,7,293,302,05
Pottawatomie,U.S. House,Buddy Ray,IND,630027,0,0,9,9,05
Pottawatomie,U.S. House,Tom Boggs,IND,630027,0,0,8,8,05
Pottawatomie,U.S. House,Robert Murphy,IND,630027,0,1,11,12,05
Pottawatomie,State Senate,Marilyn Rainwater,DEM,630027,3,3,139,145,28
Pottawatomie,State Senate,Jason Smalley,REP,630027,2,4,274,280,28
Pottawatomie,Governor,Joe Dorman,DEM,630029,3,14,262,279,
Pottawatomie,Governor,Mary Fallin,REP,630029,7,30,399,436,
Pottawatomie,Governor,Kimberly Willis,IND,630029,0,0,8,8,
Pottawatomie,Governor,Richard Prawdzienski,IND,630029,0,0,9,9,
Pottawatomie,Lieutenant Governor,Cathy Cummings,DEM,630029,2,13,201,216,
Pottawatomie,Lieutenant Governor,Todd Lamb,REP,630029,8,31,469,508,
Pottawatomie,Superintendent of Public Instruction,John Cox,DEM,630029,4,17,298,319,
Pottawatomie,Superintendent of Public Instruction,Joy Hofmeister,REP,630029,6,27,366,399,
Pottawatomie,Commissioner of Labor,Mike Workman,DEM,630029,4,17,241,262,
Pottawatomie,Commissioner of Labor,Mark Costello,REP,630029,6,27,402,435,
Pottawatomie,U.S. Senate,Matt Silverstein,DEM,630029,3,12,162,177,
Pottawatomie,U.S. Senate,Jim Inhofe,REP,630029,6,31,487,524,
Pottawatomie,U.S. Senate,Aaron Delozier,IND,630029,1,0,4,5,
Pottawatomie,U.S. Senate,Ray Woods,IND,630029,0,0,9,9,
Pottawatomie,U.S. Senate,Joan Farr,IND,630029,0,0,6,6,
Pottawatomie,U.S. Senate,Connie Johnson,DEM,630029,4,10,161,175,
Pottawatomie,U.S. Senate,James Lankford,REP,630029,5,33,494,532,
Pottawatomie,U.S. Senate,Mark Beard,IND,630029,1,1,20,22,
Pottawatomie,U.S. House,Al Mcaffrey,DEM,630029,4,9,175,188,05
Pottawatomie,U.S. House,Steve Russell,REP,630029,5,35,450,490,05
Pottawatomie,U.S. House,Buddy Ray,IND,630029,0,0,13,13,05
Pottawatomie,U.S. House,Tom Boggs,IND,630029,1,0,12,13,05
Pottawatomie,U.S. House,Robert Murphy,IND,630029,0,0,13,13,05
Pottawatomie,State Senate,Marilyn Rainwater,DEM,630029,4,14,222,240,28
Pottawatomie,State Senate,Jason Smalley,REP,630029,6,30,427,463,28
Pottawatomie,Governor,Joe Dorman,DEM,630030,8,7,312,327,
Pottawatomie,Governor,Mary Fallin,REP,630030,16,19,536,571,
Pottawatomie,Governor,Kimberly Willis,IND,630030,0,0,24,24,
Pottawatomie,Governor,Richard Prawdzienski,IND,630030,1,0,8,9,
Pottawatomie,Lieutenant Governor,Cathy Cummings,DEM,630030,9,6,233,248,
Pottawatomie,Lieutenant Governor,Todd Lamb,REP,630030,16,20,646,682,
Pottawatomie,Superintendent of Public Instruction,John Cox,DEM,630030,11,8,369,388,
Pottawatomie,Superintendent of Public Instruction,Joy Hofmeister,REP,630030,13,18,511,542,
Pottawatomie,Commissioner of Labor,Mike Workman,DEM,630030,9,5,307,321,
Pottawatomie,Commissioner of Labor,Mark Costello,REP,630030,15,19,560,594,
Pottawatomie,U.S. Senate,Matt Silverstein,DEM,630030,4,3,211,218,
Pottawatomie,U.S. Senate,Jim Inhofe,REP,630030,19,23,641,683,
Pottawatomie,U.S. Senate,Aaron Delozier,IND,630030,1,0,14,15,
Pottawatomie,U.S. Senate,Ray Woods,IND,630030,0,0,8,8,
Pottawatomie,U.S. Senate,Joan Farr,IND,630030,1,0,6,7,
Pottawatomie,U.S. Senate,Connie Johnson,DEM,630030,3,4,200,207,
Pottawatomie,U.S. Senate,James Lankford,REP,630030,20,22,661,703,
Pottawatomie,U.S. Senate,Mark Beard,IND,630030,2,0,17,19,
Pottawatomie,U.S. House,Al Mcaffrey,DEM,630030,9,5,209,223,05
Pottawatomie,U.S. House,Steve Russell,REP,630030,12,19,643,674,05
Pottawatomie,U.S. House,Buddy Ray,IND,630030,0,1,6,7,05
Pottawatomie,U.S. House,Tom Boggs,IND,630030,1,1,7,9,05
Pottawatomie,U.S. House,Robert Murphy,IND,630030,3,0,13,16,05
Pottawatomie,State Senate,Marilyn Rainwater,DEM,630030,8,4,265,277,28
Pottawatomie,State Senate,Jason Smalley,REP,630030,16,22,610,648,28
Pottawatomie,Governor,Joe Dorman,DEM,630031,8,20,407,435,
Pottawatomie,Governor,Mary Fallin,REP,630031,14,26,685,725,
Pottawatomie,Governor,Kimberly Willis,IND,630031,0,1,16,17,
Pottawatomie,Governor,Richard Prawdzienski,IND,630031,0,2,14,16,
Pottawatomie,Lieutenant Governor,Cathy Cummings,DEM,630031,6,14,282,302,
Pottawatomie,Lieutenant Governor,Todd Lamb,REP,630031,16,34,840,890,
Pottawatomie,Superintendent of Public Instruction,John Cox,DEM,630031,8,24,457,489,
Pottawatomie,Superintendent of Public Instruction,Joy Hofmeister,REP,630031,14,25,655,694,
Pottawatomie,Commissioner of Labor,Mike Workman,DEM,630031,6,17,375,398,
Pottawatomie,Commissioner of Labor,Mark Costello,REP,630031,16,31,727,774,
Pottawatomie,U.S. Senate,Matt Silverstein,DEM,630031,4,13,256,273,
Pottawatomie,U.S. Senate,Jim Inhofe,REP,630031,18,33,827,878,
Pottawatomie,U.S. Senate,Aaron Delozier,IND,630031,0,0,7,7,
Pottawatomie,U.S. Senate,Ray Woods,IND,630031,0,2,16,18,
Pottawatomie,U.S. Senate,Joan Farr,IND,630031,0,0,11,11,
Pottawatomie,U.S. Senate,Connie Johnson,DEM,630031,5,12,233,250,
Pottawatomie,U.S. Senate,James Lankford,REP,630031,17,35,850,902,
Pottawatomie,U.S. Senate,Mark Beard,IND,630031,0,2,41,43,
Pottawatomie,U.S. House,Al Mcaffrey,DEM,630031,5,17,256,278,05
Pottawatomie,U.S. House,Steve Russell,REP,630031,17,31,816,864,05
Pottawatomie,U.S. House,Buddy Ray,IND,630031,0,0,10,10,05
Pottawatomie,U.S. House,Tom Boggs,IND,630031,0,0,13,13,05
Pottawatomie,U.S. House,Robert Murphy,IND,630031,0,0,18,18,05
Pottawatomie,State House,Jason Leonard,DEM,630031,4,13,297,314,28
Pottawatomie,State House,Tom Newell,REP,630031,18,35,815,868,28
Pottawatomie,Governor,Joe Dorman,DEM,630033,3,2,98,103,
Pottawatomie,Governor,Mary Fallin,REP,630033,3,2,156,161,
Pottawatomie,Governor,Kimberly Willis,IND,630033,0,0,5,5,
Pottawatomie,Governor,Richard Prawdzienski,IND,630033,0,0,4,4,
Pottawatomie,Lieutenant Governor,Cathy Cummings,DEM,630033,2,1,78,81,
Pottawatomie,Lieutenant Governor,Todd Lamb,REP,630033,4,3,183,190,
Pottawatomie,Superintendent of Public Instruction,John Cox,DEM,630033,3,3,125,131,
Pottawatomie,Superintendent of Public Instruction,Joy Hofmeister,REP,630033,3,1,133,137,
Pottawatomie,Commissioner of Labor,Mike Workman,DEM,630033,3,1,98,102,
Pottawatomie,Commissioner of Labor,Mark Costello,REP,630033,3,3,160,166,
Pottawatomie,U.S. Senate,Matt Silverstein,DEM,630033,2,0,64,66,
Pottawatomie,U.S. Senate,Jim Inhofe,REP,630033,3,4,180,187,
Pottawatomie,U.S. Senate,Aaron Delozier,IND,630033,0,0,6,6,
Pottawatomie,U.S. Senate,Ray Woods,IND,630033,0,0,4,4,
Pottawatomie,U.S. Senate,Joan Farr,IND,630033,1,0,5,6,
Pottawatomie,U.S. Senate,Connie Johnson,DEM,630033,2,0,60,62,
Pottawatomie,U.S. Senate,James Lankford,REP,630033,3,4,190,197,
Pottawatomie,U.S. Senate,Mark Beard,IND,630033,1,0,11,12,
Pottawatomie,U.S. House,Al Mcaffrey,DEM,630033,2,0,72,74,05
Pottawatomie,U.S. House,Steve Russell,REP,630033,4,4,170,178,05
Pottawatomie,U.S. House,Buddy Ray,IND,630033,0,0,1,1,05
Pottawatomie,U.S. House,Tom Boggs,IND,630033,0,0,6,6,05
Pottawatomie,U.S. House,Robert Murphy,IND,630033,0,0,7,7,05
Pottawatomie,State Senate,Marilyn Rainwater,DEM,630033,4,0,92,96,28
Pottawatomie,State Senate,Jason Smalley,REP,630033,2,4,167,173,28
Pottawatomie,Governor,Joe Dorman,DEM,630037,1,0,76,77,
Pottawatomie,Governor,Mary Fallin,REP,630037,5,3,188,196,
Pottawatomie,Governor,Kimberly Willis,IND,630037,0,0,13,13,
Pottawatomie,Governor,Richard Prawdzienski,IND,630037,0,0,2,2,
Pottawatomie,Lieutenant Governor,Cathy Cummings,DEM,630037,1,0,60,61,
Pottawatomie,Lieutenant Governor,Todd Lamb,REP,630037,5,3,220,228,
Pottawatomie,Superintendent of Public Instruction,John Cox,DEM,630037,3,0,95,98,
Pottawatomie,Superintendent of Public Instruction,Joy Hofmeister,REP,630037,4,3,185,192,
Pottawatomie,Commissioner of Labor,Mike Workman,DEM,630037,1,0,81,82,
Pottawatomie,Commissioner of Labor,Mark Costello,REP,630037,5,3,198,206,
Pottawatomie,U.S. Senate,Matt Silverstein,DEM,630037,1,0,56,57,
Pottawatomie,U.S. Senate,Jim Inhofe,REP,630037,3,3,210,216,
Pottawatomie,U.S. Senate,Aaron Delozier,IND,630037,0,0,0,0,
Pottawatomie,U.S. Senate,Ray Woods,IND,630037,2,0,10,12,
Pottawatomie,U.S. Senate,Joan Farr,IND,630037,0,0,4,4,
Pottawatomie,U.S. Senate,Connie Johnson,DEM,630037,2,0,60,62,
Pottawatomie,U.S. Senate,James Lankford,REP,630037,2,3,209,214,
Pottawatomie,U.S. Senate,Mark Beard,IND,630037,3,0,11,14,
Pottawatomie,U.S. House,Al Mcaffrey,DEM,630037,2,0,52,54,05
Pottawatomie,U.S. House,Steve Russell,REP,630037,5,3,215,223,05
Pottawatomie,U.S. House,Buddy Ray,IND,630037,0,0,5,5,05
Pottawatomie,U.S. House,Tom Boggs,IND,630037,0,0,2,2,05
Pottawatomie,U.S. House,Robert Murphy,IND,630037,0,0,5,5,05
Pottawatomie,Governor,Joe Dorman,DEM,630038,3,2,80,85,
Pottawatomie,Governor,Mary Fallin,REP,630038,6,9,112,127,
Pottawatomie,Governor,Kimberly Willis,IND,630038,0,0,8,8,
Pottawatomie,Governor,Richard Prawdzienski,IND,630038,0,1,10,11,
Pottawatomie,Lieutenant Governor,Cathy Cummings,DEM,630038,3,2,62,67,
Pottawatomie,Lieutenant Governor,Todd Lamb,REP,630038,6,10,145,161,
Pottawatomie,Superintendent of Public Instruction,John Cox,DEM,630038,3,3,87,93,
Pottawatomie,Superintendent of Public Instruction,Joy Hofmeister,REP,630038,6,9,122,137,
Pottawatomie,Commissioner of Labor,Mike Workman,DEM,630038,3,3,90,96,
Pottawatomie,Commissioner of Labor,Mark Costello,REP,630038,6,9,114,129,
Pottawatomie,U.S. Senate,Matt Silverstein,DEM,630038,4,2,49,55,
Pottawatomie,U.S. Senate,Jim Inhofe,REP,630038,5,10,146,161,
Pottawatomie,U.S. Senate,Aaron Delozier,IND,630038,0,0,0,0,
Pottawatomie,U.S. Senate,Ray Woods,IND,630038,0,0,11,11,
Pottawatomie,U.S. Senate,Joan Farr,IND,630038,0,0,4,4,
Pottawatomie,U.S. Senate,Connie Johnson,DEM,630038,4,2,49,55,
Pottawatomie,U.S. Senate,James Lankford,REP,630038,5,9,155,169,
Pottawatomie,U.S. Senate,Mark Beard,IND,630038,0,1,5,6,
Pottawatomie,U.S. House,Al Mcaffrey,DEM,630038,3,2,56,61,05
Pottawatomie,U.S. House,Steve Russell,REP,630038,6,10,136,152,05
Pottawatomie,U.S. House,Buddy Ray,IND,630038,0,0,5,5,05
Pottawatomie,U.S. House,Tom Boggs,IND,630038,0,0,6,6,05
Pottawatomie,U.S. House,Robert Murphy,IND,630038,0,0,5,5,05
Pottawatomie,Governor,Joe Dorman,DEM,630040,2,2,68,72,
Pottawatomie,Governor,Mary Fallin,REP,630040,2,7,131,140,
Pottawatomie,Governor,Kimberly Willis,IND,630040,0,0,3,3,
Pottawatomie,Governor,Richard Prawdzienski,IND,630040,0,0,0,0,
Pottawatomie,Lieutenant Governor,Cathy Cummings,DEM,630040,2,2,47,51,
Pottawatomie,Lieutenant Governor,Todd Lamb,REP,630040,2,7,155,164,
Pottawatomie,Superintendent of Public Instruction,John Cox,DEM,630040,2,4,90,96,
Pottawatomie,Superintendent of Public Instruction,Joy Hofmeister,REP,630040,2,5,112,119,
Pottawatomie,Commissioner of Labor,Mike Workman,DEM,630040,2,2,79,83,
Pottawatomie,Commissioner of Labor,Mark Costello,REP,630040,2,7,115,124,
Pottawatomie,U.S. Senate,Matt Silverstein,DEM,630040,2,1,41,44,
Pottawatomie,U.S. Senate,Jim Inhofe,REP,630040,2,8,155,165,
Pottawatomie,U.S. Senate,Aaron Delozier,IND,630040,0,0,3,3,
Pottawatomie,U.S. Senate,Ray Woods,IND,630040,0,0,2,2,
Pottawatomie,U.S. Senate,Joan Farr,IND,630040,0,0,0,0,
Pottawatomie,U.S. Senate,Connie Johnson,DEM,630040,2,1,39,42,
Pottawatomie,U.S. Senate,James Lankford,REP,630040,2,8,160,170,
Pottawatomie,U.S. Senate,Mark Beard,IND,630040,0,0,3,3,
Pottawatomie,U.S. House,Al Mcaffrey,DEM,630040,2,2,49,53,05
Pottawatomie,U.S. House,Steve Russell,REP,630040,2,7,137,146,05
Pottawatomie,U.S. House,Buddy Ray,IND,630040,0,0,2,2,05
Pottawatomie,U.S. House,Tom Boggs,IND,630040,0,0,9,9,05
Pottawatomie,U.S. House,Robert Murphy,IND,630040,0,0,3,3,05
Pottawatomie,Governor,Joe Dorman,DEM,630041,0,0,108,108,
Pottawatomie,Governor,Mary Fallin,REP,630041,2,3,158,163,
Pottawatomie,Governor,Kimberly Willis,IND,630041,0,0,5,5,
Pottawatomie,Governor,Richard Prawdzienski,IND,630041,0,0,5,5,
Pottawatomie,Lieutenant Governor,Cathy Cummings,DEM,630041,0,0,63,63,
Pottawatomie,Lieutenant Governor,Todd Lamb,REP,630041,2,3,208,213,
Pottawatomie,Superintendent of Public Instruction,John Cox,DEM,630041,0,0,114,114,
Pottawatomie,Superintendent of Public Instruction,Joy Hofmeister,REP,630041,2,3,157,162,
Pottawatomie,Commissioner of Labor,Mike Workman,DEM,630041,0,1,93,94,
Pottawatomie,Commissioner of Labor,Mark Costello,REP,630041,2,2,169,173,
Pottawatomie,U.S. Senate,Matt Silverstein,DEM,630041,0,0,52,52,
Pottawatomie,U.S. Senate,Jim Inhofe,REP,630041,2,3,221,226,
Pottawatomie,U.S. Senate,Aaron Delozier,IND,630041,0,0,0,0,
Pottawatomie,U.S. Senate,Ray Woods,IND,630041,0,0,0,0,
Pottawatomie,U.S. Senate,Joan Farr,IND,630041,0,0,2,2,
Pottawatomie,U.S. Senate,Connie Johnson,DEM,630041,0,0,47,47,
Pottawatomie,U.S. Senate,James Lankford,REP,630041,2,3,218,223,
Pottawatomie,U.S. Senate,Mark Beard,IND,630041,0,0,10,10,
Pottawatomie,U.S. House,Al Mcaffrey,DEM,630041,0,0,61,61,05
Pottawatomie,U.S. House,Steve Russell,REP,630041,2,3,197,202,05
Pottawatomie,U.S. House,Buddy Ray,IND,630041,0,0,3,3,05
Pottawatomie,U.S. House,Tom Boggs,IND,630041,0,0,7,7,05
Pottawatomie,U.S. House,Robert Murphy,IND,630041,0,0,4,4,05
Pottawatomie,Governor,Joe Dorman,DEM,630042,0,0,68,68,
Pottawatomie,Governor,Mary Fallin,REP,630042,6,3,100,109,
Pottawatomie,Governor,Kimberly Willis,IND,630042,0,0,0,0,
Pottawatomie,Governor,Richard Prawdzienski,IND,630042,0,0,3,3,
Pottawatomie,Lieutenant Governor,Cathy Cummings,DEM,630042,1,0,46,47,
Pottawatomie,Lieutenant Governor,Todd Lamb,REP,630042,5,3,124,132,
Pottawatomie,Superintendent of Public Instruction,John Cox,DEM,630042,1,1,62,64,
Pottawatomie,Superintendent of Public Instruction,Joy Hofmeister,REP,630042,4,2,108,114,
Pottawatomie,Commissioner of Labor,Mike Workman,DEM,630042,1,0,60,61,
Pottawatomie,Commissioner of Labor,Mark Costello,REP,630042,4,3,109,116,
Pottawatomie,U.S. Senate,Matt Silverstein,DEM,630042,0,0,33,33,
Pottawatomie,U.S. Senate,Jim Inhofe,REP,630042,5,3,130,138,
Pottawatomie,U.S. Senate,Aaron Delozier,IND,630042,0,0,2,2,
Pottawatomie,U.S. Senate,Ray Woods,IND,630042,0,0,4,4,
Pottawatomie,U.S. Senate,Joan Farr,IND,630042,1,0,0,1,
Pottawatomie,U.S. Senate,Connie Johnson,DEM,630042,0,0,36,36,
Pottawatomie,U.S. Senate,James Lankford,REP,630042,6,3,132,141,
Pottawatomie,U.S. Senate,Mark Beard,IND,630042,0,0,3,3,
Pottawatomie,U.S. House,Al Mcaffrey,DEM,630042,0,0,46,46,05
Pottawatomie,U.S. House,Steve Russell,REP,630042,6,3,115,124,05
Pottawatomie,U.S. House,Buddy Ray,IND,630042,0,0,5,5,05
Pottawatomie,U.S. House,Tom Boggs,IND,630042,0,0,3,3,05
Pottawatomie,U.S. House,Robert Murphy,IND,630042,0,0,1,1,05
Pottawatomie,State House,Joni Johnson,DEM,630042,2,0,55,57,20
Pottawatomie,State House,Bobby Cleveland,REP,630042,4,3,114,121,20
Pushmataha,Governor,Joe Dorman,DEM,640001,3,2,86,91,
Pushmataha,Governor,Mary Fallin,REP,640001,2,11,82,95,
Pushmataha,Governor,Kimberly Willis,IND,640001,0,0,9,9,
Pushmataha,Governor,Richard Prawdzienski,IND,640001,0,2,3,5,
Pushmataha,Lieutenant Governor,Cathy Cummings,DEM,640001,1,2,64,67,
Pushmataha,Lieutenant Governor,Todd Lamb,REP,640001,4,12,113,129,
Pushmataha,Superintendent of Public Instruction,John Cox,DEM,640001,2,6,109,117,
Pushmataha,Superintendent of Public Instruction,Joy Hofmeister,REP,640001,3,7,71,81,
Pushmataha,Commissioner of Labor,Mike Workman,DEM,640001,1,4,72,77,
Pushmataha,Commissioner of Labor,Mark Costello,REP,640001,3,8,104,115,
Pushmataha,U.S. Senate,Matt Silverstein,DEM,640001,1,1,41,43,
Pushmataha,U.S. Senate,Jim Inhofe,REP,640001,4,12,124,140,
Pushmataha,U.S. Senate,Aaron Delozier,IND,640001,0,0,3,3,
Pushmataha,U.S. Senate,Ray Woods,IND,640001,0,0,6,6,
Pushmataha,U.S. Senate,Joan Farr,IND,640001,0,0,4,4,
Pushmataha,U.S. Senate,Connie Johnson,DEM,640001,1,2,44,47,
Pushmataha,U.S. Senate,James Lankford,REP,640001,4,11,118,133,
Pushmataha,U.S. Senate,Mark Beard,IND,640001,0,0,15,15,
Pushmataha,U.S. House,Earl Everett,DEM,640001,1,1,36,38,02
Pushmataha,U.S. House,Markwayne Mullin,REP,640001,4,13,131,148,02
Pushmataha,U.S. House,Jon Douthitt,IND,640001,0,0,10,10,02
Pushmataha,State Senate,Curtis Mcdaniel,DEM,640001,1,6,81,88,5
Pushmataha,State Senate,Joseph Silk,REP,640001,4,9,97,110,5
Pushmataha,Governor,Joe Dorman,DEM,640002,0,13,172,185,
Pushmataha,Governor,Mary Fallin,REP,640002,0,12,196,208,
Pushmataha,Governor,Kimberly Willis,IND,640002,0,0,8,8,
Pushmataha,Governor,Richard Prawdzienski,IND,640002,0,0,11,11,
Pushmataha,Lieutenant Governor,Cathy Cummings,DEM,640002,0,10,139,149,
Pushmataha,Lieutenant Governor,Todd Lamb,REP,640002,0,17,244,261,
Pushmataha,Superintendent of Public Instruction,John Cox,DEM,640002,0,18,228,246,
Pushmataha,Superintendent of Public Instruction,Joy Hofmeister,REP,640002,0,8,160,168,
Pushmataha,Commissioner of Labor,Mike Workman,DEM,640002,0,13,162,175,
Pushmataha,Commissioner of Labor,Mark Costello,REP,640002,0,13,221,234,
Pushmataha,U.S. Senate,Matt Silverstein,DEM,640002,0,9,93,102,
Pushmataha,U.S. Senate,Jim Inhofe,REP,640002,0,18,278,296,
Pushmataha,U.S. Senate,Aaron Delozier,IND,640002,0,0,3,3,
Pushmataha,U.S. Senate,Ray Woods,IND,640002,0,0,8,8,
Pushmataha,U.S. Senate,Joan Farr,IND,640002,0,0,5,5,
Pushmataha,U.S. Senate,Connie Johnson,DEM,640002,0,9,107,116,
Pushmataha,U.S. Senate,James Lankford,REP,640002,0,17,256,273,
Pushmataha,U.S. Senate,Mark Beard,IND,640002,0,0,22,22,
Pushmataha,U.S. House,Earl Everett,DEM,640002,0,6,92,98,02
Pushmataha,U.S. House,Markwayne Mullin,REP,640002,0,21,289,310,02
Pushmataha,U.S. House,Jon Douthitt,IND,640002,0,0,9,9,02
Pushmataha,State Senate,Curtis Mcdaniel,DEM,640002,0,13,189,202,5
Pushmataha,State Senate,Joseph Silk,REP,640002,0,13,200,213,5
Pushmataha,Governor,Joe Dorman,DEM,640003,1,3,77,81,
Pushmataha,Governor,Mary Fallin,REP,640003,2,3,101,106,
Pushmataha,Governor,Kimberly Willis,IND,640003,0,0,11,11,
Pushmataha,Governor,Richard Prawdzienski,IND,640003,0,0,2,2,
Pushmataha,Lieutenant Governor,Cathy Cummings,DEM,640003,1,2,61,64,
Pushmataha,Lieutenant Governor,Todd Lamb,REP,640003,2,4,129,135,
Pushmataha,Superintendent of Public Instruction,John Cox,DEM,640003,1,3,98,102,
Pushmataha,Superintendent of Public Instruction,Joy Hofmeister,REP,640003,2,3,95,100,
Pushmataha,Commissioner of Labor,Mike Workman,DEM,640003,1,2,68,71,
Pushmataha,Commissioner of Labor,Mark Costello,REP,640003,2,4,120,126,
Pushmataha,U.S. Senate,Matt Silverstein,DEM,640003,1,2,47,50,
Pushmataha,U.S. Senate,Jim Inhofe,REP,640003,2,4,138,144,
Pushmataha,U.S. Senate,Aaron Delozier,IND,640003,0,0,1,1,
Pushmataha,U.S. Senate,Ray Woods,IND,640003,0,0,2,2,
Pushmataha,U.S. Senate,Joan Farr,IND,640003,0,0,3,3,
Pushmataha,U.S. Senate,Connie Johnson,DEM,640003,1,2,51,54,
Pushmataha,U.S. Senate,James Lankford,REP,640003,2,4,130,136,
Pushmataha,U.S. Senate,Mark Beard,IND,640003,0,0,8,8,
Pushmataha,U.S. House,Earl Everett,DEM,640003,1,2,41,44,02
Pushmataha,U.S. House,Markwayne Mullin,REP,640003,2,4,145,151,02
Pushmataha,U.S. House,Jon Douthitt,IND,640003,0,0,4,4,02
Pushmataha,State Senate,Curtis Mcdaniel,DEM,640003,1,2,78,81,5
Pushmataha,State Senate,Joseph Silk,REP,640003,2,4,114,120,5
Pushmataha,Governor,Joe Dorman,DEM,640004,1,10,103,114,
Pushmataha,Governor,Mary Fallin,REP,640004,5,14,164,183,
Pushmataha,Governor,Kimberly Willis,IND,640004,1,0,9,10,
Pushmataha,Governor,Richard Prawdzienski,IND,640004,0,0,1,1,
Pushmataha,Lieutenant Governor,Cathy Cummings,DEM,640004,0,7,78,85,
Pushmataha,Lieutenant Governor,Todd Lamb,REP,640004,7,17,194,218,
Pushmataha,Superintendent of Public Instruction,John Cox,DEM,640004,2,9,137,148,
Pushmataha,Superintendent of Public Instruction,Joy Hofmeister,REP,640004,4,15,136,155,
Pushmataha,Commissioner of Labor,Mike Workman,DEM,640004,0,8,98,106,
Pushmataha,Commissioner of Labor,Mark Costello,REP,640004,5,14,170,189,
Pushmataha,U.S. Senate,Matt Silverstein,DEM,640004,0,6,59,65,
Pushmataha,U.S. Senate,Jim Inhofe,REP,640004,6,18,213,237,
Pushmataha,U.S. Senate,Aaron Delozier,IND,640004,1,0,0,1,
Pushmataha,U.S. Senate,Ray Woods,IND,640004,0,0,0,0,
Pushmataha,U.S. Senate,Joan Farr,IND,640004,0,0,4,4,
Pushmataha,U.S. Senate,Connie Johnson,DEM,640004,0,7,71,78,
Pushmataha,U.S. Senate,James Lankford,REP,640004,7,17,194,218,
Pushmataha,U.S. Senate,Mark Beard,IND,640004,0,0,8,8,
Pushmataha,U.S. House,Earl Everett,DEM,640004,0,6,57,63,02
Pushmataha,U.S. House,Markwayne Mullin,REP,640004,7,17,214,238,02
Pushmataha,U.S. House,Jon Douthitt,IND,640004,0,1,5,6,02
Pushmataha,State Senate,Curtis Mcdaniel,DEM,640004,2,12,117,131,5
Pushmataha,State Senate,Joseph Silk,REP,640004,4,12,159,175,5
Pushmataha,Governor,Joe Dorman,DEM,640005,0,2,11,13,
Pushmataha,Governor,Mary Fallin,REP,640005,0,4,32,36,
Pushmataha,Governor,Kimberly Willis,IND,640005,0,0,1,1,
Pushmataha,Governor,Richard Prawdzienski,IND,640005,0,0,0,0,
Pushmataha,Lieutenant Governor,Cathy Cummings,DEM,640005,0,1,10,11,
Pushmataha,Lieutenant Governor,Todd Lamb,REP,640005,0,5,34,39,
Pushmataha,Superintendent of Public Instruction,John Cox,DEM,640005,0,5,23,28,
Pushmataha,Superintendent of Public Instruction,Joy Hofmeister,REP,640005,0,1,21,22,
Pushmataha,Commissioner of Labor,Mike Workman,DEM,640005,0,3,11,14,
Pushmataha,Commissioner of Labor,Mark Costello,REP,640005,0,3,32,35,
Pushmataha,U.S. Senate,Matt Silverstein,DEM,640005,0,1,6,7,
Pushmataha,U.S. Senate,Jim Inhofe,REP,640005,0,5,36,41,
Pushmataha,U.S. Senate,Aaron Delozier,IND,640005,0,0,0,0,
Pushmataha,U.S. Senate,Ray Woods,IND,640005,0,0,2,2,
Pushmataha,U.S. Senate,Joan Farr,IND,640005,0,0,0,0,
Pushmataha,U.S. Senate,Connie Johnson,DEM,640005,0,0,8,8,
Pushmataha,U.S. Senate,James Lankford,REP,640005,0,5,34,39,
Pushmataha,U.S. Senate,Mark Beard,IND,640005,0,1,1,2,
Pushmataha,U.S. House,Earl Everett,DEM,640005,0,0,6,6,02
Pushmataha,U.S. House,Markwayne Mullin,REP,640005,0,5,37,42,02
Pushmataha,U.S. House,Jon Douthitt,IND,640005,0,0,1,1,02
Pushmataha,State Senate,Curtis Mcdaniel,DEM,640005,0,1,16,17,5
Pushmataha,State Senate,Joseph Silk,REP,640005,0,5,28,33,5
Pushmataha,Governor,Joe Dorman,DEM,640007,0,1,51,52,
Pushmataha,Governor,Mary Fallin,REP,640007,0,2,47,49,
Pushmataha,Governor,Kimberly Willis,IND,640007,0,0,2,2,
Pushmataha,Governor,Richard Prawdzienski,IND,640007,0,0,2,2,
Pushmataha,Lieutenant Governor,Cathy Cummings,DEM,640007,0,1,44,45,
Pushmataha,Lieutenant Governor,Todd Lamb,REP,640007,0,2,56,58,
Pushmataha,Superintendent of Public Instruction,John Cox,DEM,640007,0,1,71,72,
Pushmataha,Superintendent of Public Instruction,Joy Hofmeister,REP,640007,0,2,33,35,
Pushmataha,Commissioner of Labor,Mike Workman,DEM,640007,0,1,49,50,
Pushmataha,Commissioner of Labor,Mark Costello,REP,640007,0,2,49,51,
Pushmataha,U.S. Senate,Matt Silverstein,DEM,640007,0,1,34,35,
Pushmataha,U.S. Senate,Jim Inhofe,REP,640007,0,2,66,68,
Pushmataha,U.S. Senate,Aaron Delozier,IND,640007,0,0,3,3,
Pushmataha,U.S. Senate,Ray Woods,IND,640007,0,0,1,1,
Pushmataha,U.S. Senate,Joan Farr,IND,640007,0,0,1,1,
Pushmataha,U.S. Senate,Connie Johnson,DEM,640007,0,1,39,40,
Pushmataha,U.S. Senate,James Lankford,REP,640007,0,2,60,62,
Pushmataha,U.S. Senate,Mark Beard,IND,640007,0,0,3,3,
Pushmataha,U.S. House,Earl Everett,DEM,640007,0,1,31,32,02
Pushmataha,U.S. House,Markwayne Mullin,REP,640007,0,2,69,71,02
Pushmataha,U.S. House,Jon Douthitt,IND,640007,0,0,5,5,02
Pushmataha,State Senate,Curtis Mcdaniel,DEM,640007,0,1,68,69,5
Pushmataha,State Senate,Joseph Silk,REP,640007,0,2,37,39,5
Pushmataha,Governor,Joe Dorman,DEM,640008,0,0,49,49,
Pushmataha,Governor,Mary Fallin,REP,640008,0,3,54,57,
Pushmataha,Governor,Kimberly Willis,IND,640008,0,0,0,0,
Pushmataha,Governor,Richard Prawdzienski,IND,640008,0,0,4,4,
Pushmataha,Lieutenant Governor,Cathy Cummings,DEM,640008,0,0,33,33,
Pushmataha,Lieutenant Governor,Todd Lamb,REP,640008,0,3,71,74,
Pushmataha,Superintendent of Public Instruction,John Cox,DEM,640008,0,0,64,64,
Pushmataha,Superintendent of Public Instruction,Joy Hofmeister,REP,640008,0,2,41,43,
Pushmataha,Commissioner of Labor,Mike Workman,DEM,640008,0,0,47,47,
Pushmataha,Commissioner of Labor,Mark Costello,REP,640008,0,3,54,57,
Pushmataha,U.S. Senate,Matt Silverstein,DEM,640008,0,0,29,29,
Pushmataha,U.S. Senate,Jim Inhofe,REP,640008,0,3,69,72,
Pushmataha,U.S. Senate,Aaron Delozier,IND,640008,0,0,3,3,
Pushmataha,U.S. Senate,Ray Woods,IND,640008,0,0,3,3,
Pushmataha,U.S. Senate,Joan Farr,IND,640008,0,0,1,1,
Pushmataha,U.S. Senate,Connie Johnson,DEM,640008,0,0,33,33,
Pushmataha,U.S. Senate,James Lankford,REP,640008,0,3,65,68,
Pushmataha,U.S. Senate,Mark Beard,IND,640008,0,0,4,4,
Pushmataha,U.S. House,Earl Everett,DEM,640008,0,0,18,18,02
Pushmataha,U.S. House,Markwayne Mullin,REP,640008,0,3,84,87,02
Pushmataha,U.S. House,Jon Douthitt,IND,640008,0,0,2,2,02
Pushmataha,State Senate,Curtis Mcdaniel,DEM,640008,0,1,59,60,5
Pushmataha,State Senate,Joseph Silk,REP,640008,0,2,47,49,5
Pushmataha,Governor,Joe Dorman,DEM,640009,0,0,58,58,
Pushmataha,Governor,Mary Fallin,REP,640009,4,0,52,56,
Pushmataha,Governor,Kimberly Willis,IND,640009,0,0,4,4,
Pushmataha,Governor,Richard Prawdzienski,IND,640009,0,0,5,5,
Pushmataha,Lieutenant Governor,Cathy Cummings,DEM,640009,0,0,47,47,
Pushmataha,Lieutenant Governor,Todd Lamb,REP,640009,4,0,64,68,
Pushmataha,Superintendent of Public Instruction,John Cox,DEM,640009,0,0,70,70,
Pushmataha,Superintendent of Public Instruction,Joy Hofmeister,REP,640009,4,0,47,51,
Pushmataha,Commissioner of Labor,Mike Workman,DEM,640009,0,0,57,57,
Pushmataha,Commissioner of Labor,Mark Costello,REP,640009,4,0,54,58,
Pushmataha,U.S. Senate,Matt Silverstein,DEM,640009,0,0,50,50,
Pushmataha,U.S. Senate,Jim Inhofe,REP,640009,4,0,66,70,
Pushmataha,U.S. Senate,Aaron Delozier,IND,640009,0,0,0,0,
Pushmataha,U.S. Senate,Ray Woods,IND,640009,0,0,1,1,
Pushmataha,U.S. Senate,Joan Farr,IND,640009,0,0,0,0,
Pushmataha,U.S. Senate,Connie Johnson,DEM,640009,0,0,51,51,
Pushmataha,U.S. Senate,James Lankford,REP,640009,4,0,56,60,
Pushmataha,U.S. Senate,Mark Beard,IND,640009,0,0,8,8,
Pushmataha,U.S. House,Earl Everett,DEM,640009,0,0,49,49,02
Pushmataha,U.S. House,Markwayne Mullin,REP,640009,4,0,64,68,02
Pushmataha,U.S. House,Jon Douthitt,IND,640009,0,0,3,3,02
Pushmataha,State Senate,Curtis Mcdaniel,DEM,640009,0,0,67,67,5
Pushmataha,State Senate,Joseph Silk,REP,640009,4,0,50,54,5
Pushmataha,Governor,Joe Dorman,DEM,640010,0,1,18,19,
Pushmataha,Governor,Mary Fallin,REP,640010,0,0,45,45,
Pushmataha,Governor,Kimberly Willis,IND,640010,0,0,0,0,
Pushmataha,Governor,Richard Prawdzienski,IND,640010,0,0,2,2,
Pushmataha,Lieutenant Governor,Cathy Cummings,DEM,640010,0,1,14,15,
Pushmataha,Lieutenant Governor,Todd Lamb,REP,640010,0,0,50,50,
Pushmataha,Superintendent of Public Instruction,John Cox,DEM,640010,0,1,25,26,
Pushmataha,Superintendent of Public Instruction,Joy Hofmeister,REP,640010,0,0,38,38,
Pushmataha,Commissioner of Labor,Mike Workman,DEM,640010,0,1,20,21,
Pushmataha,Commissioner of Labor,Mark Costello,REP,640010,0,0,42,42,
Pushmataha,U.S. Senate,Matt Silverstein,DEM,640010,0,1,13,14,
Pushmataha,U.S. Senate,Jim Inhofe,REP,640010,0,0,53,53,
Pushmataha,U.S. Senate,Aaron Delozier,IND,640010,0,0,0,0,
Pushmataha,U.S. Senate,Ray Woods,IND,640010,0,0,0,0,
Pushmataha,U.S. Senate,Joan Farr,IND,640010,0,0,0,0,
Pushmataha,U.S. Senate,Connie Johnson,DEM,640010,0,1,14,15,
Pushmataha,U.S. Senate,James Lankford,REP,640010,0,0,49,49,
Pushmataha,U.S. Senate,Mark Beard,IND,640010,0,0,1,1,
Pushmataha,U.S. House,Earl Everett,DEM,640010,0,0,8,8,02
Pushmataha,U.S. House,Markwayne Mullin,REP,640010,0,1,56,57,02
Pushmataha,U.S. House,Jon Douthitt,IND,640010,0,0,1,1,02
Pushmataha,State Senate,Curtis Mcdaniel,DEM,640010,0,1,22,23,5
Pushmataha,State Senate,Joseph Silk,REP,640010,0,0,43,43,5
Pushmataha,Governor,Joe Dorman,DEM,640011,3,5,153,161,
Pushmataha,Governor,Mary Fallin,REP,640011,3,5,133,141,
Pushmataha,Governor,Kimberly Willis,IND,640011,0,0,4,4,
Pushmataha,Governor,Richard Prawdzienski,IND,640011,0,0,3,3,
Pushmataha,Lieutenant Governor,Cathy Cummings,DEM,640011,3,4,100,107,
Pushmataha,Lieutenant Governor,Todd Lamb,REP,640011,3,6,183,192,
Pushmataha,Superintendent of Public Instruction,John Cox,DEM,640011,3,6,190,199,
Pushmataha,Superintendent of Public Instruction,Joy Hofmeister,REP,640011,3,4,100,107,
Pushmataha,Commissioner of Labor,Mike Workman,DEM,640011,3,4,121,128,
Pushmataha,Commissioner of Labor,Mark Costello,REP,640011,3,6,158,167,
Pushmataha,U.S. Senate,Matt Silverstein,DEM,640011,3,3,73,79,
Pushmataha,U.S. Senate,Jim Inhofe,REP,640011,3,7,207,217,
Pushmataha,U.S. Senate,Aaron Delozier,IND,640011,0,0,5,5,
Pushmataha,U.S. Senate,Ray Woods,IND,640011,0,0,2,2,
Pushmataha,U.S. Senate,Joan Farr,IND,640011,0,0,3,3,
Pushmataha,U.S. Senate,Connie Johnson,DEM,640011,3,3,74,80,
Pushmataha,U.S. Senate,James Lankford,REP,640011,3,7,201,211,
Pushmataha,U.S. Senate,Mark Beard,IND,640011,0,0,13,13,
Pushmataha,U.S. House,Earl Everett,DEM,640011,3,3,60,66,02
Pushmataha,U.S. House,Markwayne Mullin,REP,640011,3,6,217,226,02
Pushmataha,U.S. House,Jon Douthitt,IND,640011,0,0,11,11,02
Pushmataha,State Senate,Curtis Mcdaniel,DEM,640011,3,6,163,172,5
Pushmataha,State Senate,Joseph Silk,REP,640011,3,3,129,135,5
Pushmataha,Governor,Joe Dorman,DEM,640012,0,0,31,31,
Pushmataha,Governor,Mary Fallin,REP,640012,0,3,22,25,
Pushmataha,Governor,Kimberly Willis,IND,640012,0,0,4,4,
Pushmataha,Governor,Richard Prawdzienski,IND,640012,0,0,1,1,
Pushmataha,Lieutenant Governor,Cathy Cummings,DEM,640012,0,0,21,21,
Pushmataha,Lieutenant Governor,Todd Lamb,REP,640012,0,3,35,38,
Pushmataha,Superintendent of Public Instruction,John Cox,DEM,640012,0,0,35,35,
Pushmataha,Superintendent of Public Instruction,Joy Hofmeister,REP,640012,0,3,23,26,
Pushmataha,Commissioner of Labor,Mike Workman,DEM,640012,0,0,26,26,
Pushmataha,Commissioner of Labor,Mark Costello,REP,640012,0,3,32,35,
Pushmataha,U.S. Senate,Matt Silverstein,DEM,640012,0,0,14,14,
Pushmataha,U.S. Senate,Jim Inhofe,REP,640012,0,3,39,42,
Pushmataha,U.S. Senate,Aaron Delozier,IND,640012,0,0,3,3,
Pushmataha,U.S. Senate,Ray Woods,IND,640012,0,0,2,2,
Pushmataha,U.S. Senate,Joan Farr,IND,640012,0,0,0,0,
Pushmataha,U.S. Senate,Connie Johnson,DEM,640012,0,0,22,22,
Pushmataha,U.S. Senate,James Lankford,REP,640012,0,3,32,35,
Pushmataha,U.S. Senate,Mark Beard,IND,640012,0,0,4,4,
Pushmataha,U.S. House,Earl Everett,DEM,640012,0,0,18,18,02
Pushmataha,U.S. House,Markwayne Mullin,REP,640012,0,3,37,40,02
Pushmataha,U.S. House,Jon Douthitt,IND,640012,0,0,3,3,02
Pushmataha,State Senate,Curtis Mcdaniel,DEM,640012,0,0,30,30,5
Pushmataha,State Senate,Joseph Silk,REP,640012,0,3,28,31,5
Pushmataha,Governor,Joe Dorman,DEM,640013,0,0,15,15,
Pushmataha,Governor,Mary Fallin,REP,640013,0,0,21,21,
Pushmataha,Governor,Kimberly Willis,IND,640013,0,0,2,2,
Pushmataha,Governor,Richard Prawdzienski,IND,640013,0,0,4,4,
Pushmataha,Lieutenant Governor,Cathy Cummings,DEM,640013,0,0,12,12,
Pushmataha,Lieutenant Governor,Todd Lamb,REP,640013,0,0,29,29,
Pushmataha,Superintendent of Public Instruction,John Cox,DEM,640013,0,0,13,13,
Pushmataha,Superintendent of Public Instruction,Joy Hofmeister,REP,640013,0,0,29,29,
Pushmataha,Commissioner of Labor,Mike Workman,DEM,640013,0,0,13,13,
Pushmataha,Commissioner of Labor,Mark Costello,REP,640013,0,0,27,27,
Pushmataha,U.S. Senate,Matt Silverstein,DEM,640013,0,0,11,11,
Pushmataha,U.S. Senate,Jim Inhofe,REP,640013,0,0,25,25,
Pushmataha,U.S. Senate,Aaron Delozier,IND,640013,0,0,1,1,
Pushmataha,U.S. Senate,Ray Woods,IND,640013,0,0,1,1,
Pushmataha,U.S. Senate,Joan Farr,IND,640013,0,0,3,3,
Pushmataha,U.S. Senate,Connie Johnson,DEM,640013,0,0,12,12,
Pushmataha,U.S. Senate,James Lankford,REP,640013,0,0,25,25,
Pushmataha,U.S. Senate,Mark Beard,IND,640013,0,0,4,4,
Pushmataha,U.S. House,Earl Everett,DEM,640013,0,0,9,9,02
Pushmataha,U.S. House,Markwayne Mullin,REP,640013,0,0,28,28,02
Pushmataha,U.S. House,Jon Douthitt,IND,640013,0,0,3,3,02
Pushmataha,State Senate,Curtis Mcdaniel,DEM,640013,0,0,19,19,5
Pushmataha,State Senate,Joseph Silk,REP,640013,0,0,23,23,5
Pushmataha,Governor,Joe Dorman,DEM,640014,0,0,14,14,
Pushmataha,Governor,Mary Fallin,REP,640014,0,0,44,44,
Pushmataha,Governor,Kimberly Willis,IND,640014,0,0,3,3,
Pushmataha,Governor,Richard Prawdzienski,IND,640014,0,0,0,0,
Pushmataha,Lieutenant Governor,Cathy Cummings,DEM,640014,0,0,11,11,
Pushmataha,Lieutenant Governor,Todd Lamb,REP,640014,0,0,50,50,
Pushmataha,Superintendent of Public Instruction,John Cox,DEM,640014,0,0,23,23,
Pushmataha,Superintendent of Public Instruction,Joy Hofmeister,REP,640014,0,0,37,37,
Pushmataha,Commissioner of Labor,Mike Workman,DEM,640014,0,0,15,15,
Pushmataha,Commissioner of Labor,Mark Costello,REP,640014,0,0,45,45,
Pushmataha,U.S. Senate,Matt Silverstein,DEM,640014,0,0,5,5,
Pushmataha,U.S. Senate,Jim Inhofe,REP,640014,0,0,51,51,
Pushmataha,U.S. Senate,Aaron Delozier,IND,640014,0,0,1,1,
Pushmataha,U.S. Senate,Ray Woods,IND,640014,0,0,2,2,
Pushmataha,U.S. Senate,Joan Farr,IND,640014,0,0,2,2,
Pushmataha,U.S. Senate,Connie Johnson,DEM,640014,0,0,7,7,
Pushmataha,U.S. Senate,James Lankford,REP,640014,0,0,54,54,
Pushmataha,U.S. Senate,Mark Beard,IND,640014,0,0,0,0,
Pushmataha,U.S. House,Earl Everett,DEM,640014,0,0,5,5,02
Pushmataha,U.S. House,Markwayne Mullin,REP,640014,0,0,54,54,02
Pushmataha,U.S. House,Jon Douthitt,IND,640014,0,0,3,3,02
Pushmataha,State Senate,Curtis Mcdaniel,DEM,640014,0,0,26,26,5
Pushmataha,State Senate,Joseph Silk,REP,640014,0,0,35,35,5
Pushmataha,Governor,Joe Dorman,DEM,640015,4,1,161,166,
Pushmataha,Governor,Mary Fallin,REP,640015,1,0,143,144,
Pushmataha,Governor,Kimberly Willis,IND,640015,0,0,3,3,
Pushmataha,Governor,Richard Prawdzienski,IND,640015,0,0,2,2,
Pushmataha,Lieutenant Governor,Cathy Cummings,DEM,640015,4,1,119,124,
Pushmataha,Lieutenant Governor,Todd Lamb,REP,640015,1,0,188,189,
Pushmataha,Superintendent of Public Instruction,John Cox,DEM,640015,5,1,190,196,
Pushmataha,Superintendent of Public Instruction,Joy Hofmeister,REP,640015,0,0,119,119,
Pushmataha,Commissioner of Labor,Mike Workman,DEM,640015,4,1,134,139,
Pushmataha,Commissioner of Labor,Mark Costello,REP,640015,1,0,169,170,
Pushmataha,U.S. Senate,Matt Silverstein,DEM,640015,1,0,87,88,
Pushmataha,U.S. Senate,Jim Inhofe,REP,640015,4,1,216,221,
Pushmataha,U.S. Senate,Aaron Delozier,IND,640015,0,0,0,0,
Pushmataha,U.S. Senate,Ray Woods,IND,640015,0,0,5,5,
Pushmataha,U.S. Senate,Joan Farr,IND,640015,0,0,1,1,
Pushmataha,U.S. Senate,Connie Johnson,DEM,640015,4,0,105,109,
Pushmataha,U.S. Senate,James Lankford,REP,640015,1,0,185,186,
Pushmataha,U.S. Senate,Mark Beard,IND,640015,0,1,14,15,
Pushmataha,U.S. House,Earl Everett,DEM,640015,4,0,83,87,02
Pushmataha,U.S. House,Markwayne Mullin,REP,640015,1,1,215,217,02
Pushmataha,U.S. House,Jon Douthitt,IND,640015,0,0,10,10,02
Pushmataha,State Senate,Curtis Mcdaniel,DEM,640015,4,1,150,155,5
Pushmataha,State Senate,Joseph Silk,REP,640015,1,0,158,159,5
Pushmataha,Governor,Joe Dorman,DEM,640016,1,0,41,42,
Pushmataha,Governor,Mary Fallin,REP,640016,2,0,44,46,
Pushmataha,Governor,Kimberly Willis,IND,640016,0,0,7,7,
Pushmataha,Governor,Richard Prawdzienski,IND,640016,0,0,3,3,
Pushmataha,Lieutenant Governor,Cathy Cummings,DEM,640016,1,0,29,30,
Pushmataha,Lieutenant Governor,Todd Lamb,REP,640016,2,0,65,67,
Pushmataha,Superintendent of Public Instruction,John Cox,DEM,640016,1,0,45,46,
Pushmataha,Superintendent of Public Instruction,Joy Hofmeister,REP,640016,2,0,50,52,
Pushmataha,Commissioner of Labor,Mike Workman,DEM,640016,1,0,37,38,
Pushmataha,Commissioner of Labor,Mark Costello,REP,640016,2,0,55,57,
Pushmataha,U.S. Senate,Matt Silverstein,DEM,640016,0,0,24,24,
Pushmataha,U.S. Senate,Jim Inhofe,REP,640016,3,0,68,71,
Pushmataha,U.S. Senate,Aaron Delozier,IND,640016,0,0,1,1,
Pushmataha,U.S. Senate,Ray Woods,IND,640016,0,0,0,0,
Pushmataha,U.S. Senate,Joan Farr,IND,640016,0,0,2,2,
Pushmataha,U.S. Senate,Connie Johnson,DEM,640016,1,0,23,24,
Pushmataha,U.S. Senate,James Lankford,REP,640016,2,0,64,66,
Pushmataha,U.S. Senate,Mark Beard,IND,640016,0,0,6,6,
Pushmataha,U.S. House,Earl Everett,DEM,640016,0,0,23,23,02
Pushmataha,U.S. House,Markwayne Mullin,REP,640016,3,0,67,70,02
Pushmataha,U.S. House,Jon Douthitt,IND,640016,0,0,5,5,02
Pushmataha,State Senate,Curtis Mcdaniel,DEM,640016,1,0,44,45,5
Pushmataha,State Senate,Joseph Silk,REP,640016,2,0,50,52,5
Pushmataha,Governor,Joe Dorman,DEM,640017,0,0,45,45,
Pushmataha,Governor,Mary Fallin,REP,640017,1,0,62,63,
Pushmataha,Governor,Kimberly Willis,IND,640017,0,0,5,5,
Pushmataha,Governor,Richard Prawdzienski,IND,640017,0,0,2,2,
Pushmataha,Lieutenant Governor,Cathy Cummings,DEM,640017,0,0,40,40,
Pushmataha,Lieutenant Governor,Todd Lamb,REP,640017,1,0,74,75,
Pushmataha,Superintendent of Public Instruction,John Cox,DEM,640017,0,0,56,56,
Pushmataha,Superintendent of Public Instruction,Joy Hofmeister,REP,640017,1,0,58,59,
Pushmataha,Commissioner of Labor,Mike Workman,DEM,640017,0,0,44,44,
Pushmataha,Commissioner of Labor,Mark Costello,REP,640017,1,0,68,69,
Pushmataha,U.S. Senate,Matt Silverstein,DEM,640017,0,0,32,32,
Pushmataha,U.S. Senate,Jim Inhofe,REP,640017,1,0,76,77,
Pushmataha,U.S. Senate,Aaron Delozier,IND,640017,0,0,0,0,
Pushmataha,U.S. Senate,Ray Woods,IND,640017,0,0,4,4,
Pushmataha,U.S. Senate,Joan Farr,IND,640017,0,0,1,1,
Pushmataha,U.S. Senate,Connie Johnson,DEM,640017,0,0,33,33,
Pushmataha,U.S. Senate,James Lankford,REP,640017,1,0,71,72,
Pushmataha,U.S. Senate,Mark Beard,IND,640017,0,0,7,7,
Pushmataha,U.S. House,Earl Everett,DEM,640017,0,0,32,32,02
Pushmataha,U.S. House,Markwayne Mullin,REP,640017,1,0,78,79,02
Pushmataha,U.S. House,Jon Douthitt,IND,640017,0,0,3,3,02
Pushmataha,State Senate,Curtis Mcdaniel,DEM,640017,0,0,46,46,5
Pushmataha,State Senate,Joseph Silk,REP,640017,1,0,65,66,5
Roger Mills,Governor,Joe Dorman,DEM,650101,1,6,28,35,
Roger Mills,Governor,Mary Fallin,REP,650101,3,4,79,86,
Roger Mills,Governor,Kimberly Willis,IND,650101,0,0,2,2,
Roger Mills,Governor,Richard Prawdzienski,IND,650101,0,0,0,0,
Roger Mills,Lieutenant Governor,Cathy Cummings,DEM,650101,1,1,15,17,
Roger Mills,Lieutenant Governor,Todd Lamb,REP,650101,3,9,94,106,
Roger Mills,Superintendent of Public Instruction,John Cox,DEM,650101,1,4,40,45,
Roger Mills,Superintendent of Public Instruction,Joy Hofmeister,REP,650101,3,6,67,76,
Roger Mills,Commissioner of Labor,Mike Workman,DEM,650101,1,3,27,31,
Roger Mills,Commissioner of Labor,Mark Costello,REP,650101,3,7,79,89,
Roger Mills,U.S. Senate,Matt Silverstein,DEM,650101,1,0,9,10,
Roger Mills,U.S. Senate,Jim Inhofe,REP,650101,3,10,96,109,
Roger Mills,U.S. Senate,Aaron Delozier,IND,650101,0,0,0,0,
Roger Mills,U.S. Senate,Ray Woods,IND,650101,0,0,2,2,
Roger Mills,U.S. Senate,Joan Farr,IND,650101,0,0,2,2,
Roger Mills,U.S. Senate,Connie Johnson,DEM,650101,1,2,9,12,
Roger Mills,U.S. Senate,James Lankford,REP,650101,3,8,98,109,
Roger Mills,U.S. Senate,Mark Beard,IND,650101,0,0,2,2,
Roger Mills,U.S. House,Frankie Robbins,DEM,650101,1,2,8,11,03
Roger Mills,U.S. House,Frank Lucas,REP,650101,3,8,101,112,03
Roger Mills,State Senate,Kevin Black,DEM,650101,1,4,32,37,26
Roger Mills,State Senate,Darcy Jech,REP,650101,3,6,77,86,26
Roger Mills,Governor,Joe Dorman,DEM,650102,2,2,31,35,
Roger Mills,Governor,Mary Fallin,REP,650102,3,10,58,71,
Roger Mills,Governor,Kimberly Willis,IND,650102,0,0,3,3,
Roger Mills,Governor,Richard Prawdzienski,IND,650102,0,0,0,0,
Roger Mills,Lieutenant Governor,Cathy Cummings,DEM,650102,0,2,14,16,
Roger Mills,Lieutenant Governor,Todd Lamb,REP,650102,5,10,78,93,
Roger Mills,Superintendent of Public Instruction,John Cox,DEM,650102,3,5,36,44,
Roger Mills,Superintendent of Public Instruction,Joy Hofmeister,REP,650102,2,7,56,65,
Roger Mills,Commissioner of Labor,Mike Workman,DEM,650102,0,2,27,29,
Roger Mills,Commissioner of Labor,Mark Costello,REP,650102,3,10,63,76,
Roger Mills,U.S. Senate,Matt Silverstein,DEM,650102,0,1,10,11,
Roger Mills,U.S. Senate,Jim Inhofe,REP,650102,5,11,78,94,
Roger Mills,U.S. Senate,Aaron Delozier,IND,650102,0,0,2,2,
Roger Mills,U.S. Senate,Ray Woods,IND,650102,0,0,2,2,
Roger Mills,U.S. Senate,Joan Farr,IND,650102,0,0,0,0,
Roger Mills,U.S. Senate,Connie Johnson,DEM,650102,0,1,14,15,
Roger Mills,U.S. Senate,James Lankford,REP,650102,5,11,77,93,
Roger Mills,U.S. Senate,Mark Beard,IND,650102,0,0,2,2,
Roger Mills,U.S. House,Frankie Robbins,DEM,650102,1,0,12,13,03
Roger Mills,U.S. House,Frank Lucas,REP,650102,4,12,81,97,03
Roger Mills,State Senate,Kevin Black,DEM,650102,2,5,42,49,26
Roger Mills,State Senate,Darcy Jech,REP,650102,3,7,50,60,26
Roger Mills,Governor,Joe Dorman,DEM,650103,2,7,43,52,
Roger Mills,Governor,Mary Fallin,REP,650103,3,14,99,116,
Roger Mills,Governor,Kimberly Willis,IND,650103,0,0,6,6,
Roger Mills,Governor,Richard Prawdzienski,IND,650103,0,0,3,3,
Roger Mills,Lieutenant Governor,Cathy Cummings,DEM,650103,2,2,29,33,
Roger Mills,Lieutenant Governor,Todd Lamb,REP,650103,3,19,121,143,
Roger Mills,Superintendent of Public Instruction,John Cox,DEM,650103,2,5,57,64,
Roger Mills,Superintendent of Public Instruction,Joy Hofmeister,REP,650103,2,16,93,111,
Roger Mills,Commissioner of Labor,Mike Workman,DEM,650103,3,6,47,56,
Roger Mills,Commissioner of Labor,Mark Costello,REP,650103,2,14,95,111,
Roger Mills,U.S. Senate,Matt Silverstein,DEM,650103,2,2,21,25,
Roger Mills,U.S. Senate,Jim Inhofe,REP,650103,3,17,121,141,
Roger Mills,U.S. Senate,Aaron Delozier,IND,650103,0,0,2,2,
Roger Mills,U.S. Senate,Ray Woods,IND,650103,0,0,2,2,
Roger Mills,U.S. Senate,Joan Farr,IND,650103,0,0,2,2,
Roger Mills,U.S. Senate,Connie Johnson,DEM,650103,2,3,26,31,
Roger Mills,U.S. Senate,James Lankford,REP,650103,3,18,123,144,
Roger Mills,U.S. Senate,Mark Beard,IND,650103,0,0,2,2,
Roger Mills,U.S. House,Frankie Robbins,DEM,650103,1,1,20,22,03
Roger Mills,U.S. House,Frank Lucas,REP,650103,4,20,133,157,03
Roger Mills,State Senate,Kevin Black,DEM,650103,2,5,71,78,26
Roger Mills,State Senate,Darcy Jech,REP,650103,3,15,81,99,26
Roger Mills,Governor,Joe Dorman,DEM,650201,5,2,91,98,
Roger Mills,Governor,Mary Fallin,REP,650201,4,8,142,154,
Roger Mills,Governor,Kimberly Willis,IND,650201,0,0,3,3,
Roger Mills,Governor,Richard Prawdzienski,IND,650201,0,0,2,2,
Roger Mills,Lieutenant Governor,Cathy Cummings,DEM,650201,4,1,48,53,
Roger Mills,Lieutenant Governor,Todd Lamb,REP,650201,5,9,191,205,
Roger Mills,Superintendent of Public Instruction,John Cox,DEM,650201,6,3,110,119,
Roger Mills,Superintendent of Public Instruction,Joy Hofmeister,REP,650201,3,7,130,140,
Roger Mills,Commissioner of Labor,Mike Workman,DEM,650201,4,2,88,94,
Roger Mills,Commissioner of Labor,Mark Costello,REP,650201,4,8,147,159,
Roger Mills,U.S. Senate,Matt Silverstein,DEM,650201,4,0,33,37,
Roger Mills,U.S. Senate,Jim Inhofe,REP,650201,5,10,199,214,
Roger Mills,U.S. Senate,Aaron Delozier,IND,650201,0,0,3,3,
Roger Mills,U.S. Senate,Ray Woods,IND,650201,0,0,0,0,
Roger Mills,U.S. Senate,Joan Farr,IND,650201,0,0,1,1,
Roger Mills,U.S. Senate,Connie Johnson,DEM,650201,4,0,44,48,
Roger Mills,U.S. Senate,James Lankford,REP,650201,5,10,191,206,
Roger Mills,U.S. Senate,Mark Beard,IND,650201,0,0,5,5,
Roger Mills,U.S. House,Frankie Robbins,DEM,650201,4,0,32,36,03
Roger Mills,U.S. House,Frank Lucas,REP,650201,5,10,209,224,03
Roger Mills,State Senate,Kevin Black,DEM,650201,6,4,120,130,26
Roger Mills,State Senate,Darcy Jech,REP,650201,3,6,120,129,26
Roger Mills,Governor,Joe Dorman,DEM,650202,0,6,21,27,
Roger Mills,Governor,Mary Fallin,REP,650202,1,9,34,44,
Roger Mills,Governor,Kimberly Willis,IND,650202,0,0,0,0,
Roger Mills,Governor,Richard Prawdzienski,IND,650202,0,0,0,0,
Roger Mills,Lieutenant Governor,Cathy Cummings,DEM,650202,0,2,4,6,
Roger Mills,Lieutenant Governor,Todd Lamb,REP,650202,1,14,52,67,
Roger Mills,Superintendent of Public Instruction,John Cox,DEM,650202,1,9,29,39,
Roger Mills,Superintendent of Public Instruction,Joy Hofmeister,REP,650202,0,7,27,34,
Roger Mills,Commissioner of Labor,Mike Workman,DEM,650202,1,5,13,19,
Roger Mills,Commissioner of Labor,Mark Costello,REP,650202,0,9,42,51,
Roger Mills,U.S. Senate,Matt Silverstein,DEM,650202,0,1,1,2,
Roger Mills,U.S. Senate,Jim Inhofe,REP,650202,1,14,53,68,
Roger Mills,U.S. Senate,Aaron Delozier,IND,650202,0,0,1,1,
Roger Mills,U.S. Senate,Ray Woods,IND,650202,0,1,1,2,
Roger Mills,U.S. Senate,Joan Farr,IND,650202,0,0,0,0,
Roger Mills,U.S. Senate,Connie Johnson,DEM,650202,0,2,4,6,
Roger Mills,U.S. Senate,James Lankford,REP,650202,1,13,48,62,
Roger Mills,U.S. Senate,Mark Beard,IND,650202,0,1,2,3,
Roger Mills,U.S. House,Frankie Robbins,DEM,650202,0,1,3,4,03
Roger Mills,U.S. House,Frank Lucas,REP,650202,1,15,53,69,03
Roger Mills,State Senate,Kevin Black,DEM,650202,1,7,20,28,26
Roger Mills,State Senate,Darcy Jech,REP,650202,0,9,36,45,26
Roger Mills,Governor,Joe Dorman,DEM,650203,3,3,21,27,
Roger Mills,Governor,Mary Fallin,REP,650203,2,0,44,46,
Roger Mills,Governor,Kimberly Willis,IND,650203,0,0,3,3,
Roger Mills,Governor,Richard Prawdzienski,IND,650203,0,0,2,2,
Roger Mills,Lieutenant Governor,Cathy Cummings,DEM,650203,1,3,4,8,
Roger Mills,Lieutenant Governor,Todd Lamb,REP,650203,4,0,67,71,
Roger Mills,Superintendent of Public Instruction,John Cox,DEM,650203,3,3,40,46,
Roger Mills,Superintendent of Public Instruction,Joy Hofmeister,REP,650203,2,0,31,33,
Roger Mills,Commissioner of Labor,Mike Workman,DEM,650203,3,3,16,22,
Roger Mills,Commissioner of Labor,Mark Costello,REP,650203,2,0,50,52,
Roger Mills,U.S. Senate,Matt Silverstein,DEM,650203,3,3,8,14,
Roger Mills,U.S. Senate,Jim Inhofe,REP,650203,2,0,61,63,
Roger Mills,U.S. Senate,Aaron Delozier,IND,650203,0,0,1,1,
Roger Mills,U.S. Senate,Ray Woods,IND,650203,0,0,0,0,
Roger Mills,U.S. Senate,Joan Farr,IND,650203,0,0,0,0,
Roger Mills,U.S. Senate,Connie Johnson,DEM,650203,1,2,10,13,
Roger Mills,U.S. Senate,James Lankford,REP,650203,4,1,58,63,
Roger Mills,U.S. Senate,Mark Beard,IND,650203,0,0,2,2,
Roger Mills,U.S. House,Frankie Robbins,DEM,650203,1,2,8,11,03
Roger Mills,U.S. House,Frank Lucas,REP,650203,4,1,63,68,03
Roger Mills,State Senate,Kevin Black,DEM,650203,3,3,24,30,26
Roger Mills,State Senate,Darcy Jech,REP,650203,2,0,45,47,26
Roger Mills,Governor,Joe Dorman,DEM,650301,0,3,36,39,
Roger Mills,Governor,Mary Fallin,REP,650301,2,3,68,73,
Roger Mills,Governor,Kimberly Willis,IND,650301,0,0,1,1,
Roger Mills,Governor,Richard Prawdzienski,IND,650301,0,0,2,2,
Roger Mills,Lieutenant Governor,Cathy Cummings,DEM,650301,0,3,26,29,
Roger Mills,Lieutenant Governor,Todd Lamb,REP,650301,2,3,81,86,
Roger Mills,Superintendent of Public Instruction,John Cox,DEM,650301,1,2,41,44,
Roger Mills,Superintendent of Public Instruction,Joy Hofmeister,REP,650301,1,4,64,69,
Roger Mills,Commissioner of Labor,Mike Workman,DEM,650301,0,2,28,30,
Roger Mills,Commissioner of Labor,Mark Costello,REP,650301,2,4,73,79,
Roger Mills,U.S. Senate,Matt Silverstein,DEM,650301,0,1,16,17,
Roger Mills,U.S. Senate,Jim Inhofe,REP,650301,3,5,84,92,
Roger Mills,U.S. Senate,Aaron Delozier,IND,650301,0,0,2,2,
Roger Mills,U.S. Senate,Ray Woods,IND,650301,0,0,0,0,
Roger Mills,U.S. Senate,Joan Farr,IND,650301,0,0,0,0,
Roger Mills,U.S. Senate,Connie Johnson,DEM,650301,0,1,23,24,
Roger Mills,U.S. Senate,James Lankford,REP,650301,3,5,81,89,
Roger Mills,U.S. Senate,Mark Beard,IND,650301,0,0,2,2,
Roger Mills,U.S. House,Frankie Robbins,DEM,650301,0,0,13,13,03
Roger Mills,U.S. House,Frank Lucas,REP,650301,3,6,94,103,03
Roger Mills,State Senate,Kevin Black,DEM,650301,1,4,43,48,26
Roger Mills,State Senate,Darcy Jech,REP,650301,1,2,61,64,26
Roger Mills,Governor,Joe Dorman,DEM,650302,2,2,30,34,
Roger Mills,Governor,Mary Fallin,REP,650302,2,3,82,87,
Roger Mills,Governor,Kimberly Willis,IND,650302,0,1,1,2,
Roger Mills,Governor,Richard Prawdzienski,IND,650302,0,0,0,0,
Roger Mills,Lieutenant Governor,Cathy Cummings,DEM,650302,2,1,16,19,
Roger Mills,Lieutenant Governor,Todd Lamb,REP,650302,2,5,99,106,
Roger Mills,Superintendent of Public Instruction,John Cox,DEM,650302,3,4,40,47,
Roger Mills,Superintendent of Public Instruction,Joy Hofmeister,REP,650302,1,2,74,77,
Roger Mills,Commissioner of Labor,Mike Workman,DEM,650302,2,3,32,37,
Roger Mills,Commissioner of Labor,Mark Costello,REP,650302,2,3,81,86,
Roger Mills,U.S. Senate,Matt Silverstein,DEM,650302,2,1,10,13,
Roger Mills,U.S. Senate,Jim Inhofe,REP,650302,2,5,101,108,
Roger Mills,U.S. Senate,Aaron Delozier,IND,650302,0,0,0,0,
Roger Mills,U.S. Senate,Ray Woods,IND,650302,0,0,2,2,
Roger Mills,U.S. Senate,Joan Farr,IND,650302,0,0,0,0,
Roger Mills,U.S. Senate,Connie Johnson,DEM,650302,2,1,15,18,
Roger Mills,U.S. Senate,James Lankford,REP,650302,2,5,100,107,
Roger Mills,U.S. Senate,Mark Beard,IND,650302,0,0,1,1,
Roger Mills,U.S. House,Frankie Robbins,DEM,650302,2,1,8,11,03
Roger Mills,U.S. House,Frank Lucas,REP,650302,2,5,107,114,03
Roger Mills,State Senate,Kevin Black,DEM,650302,2,1,37,40,26
Roger Mills,State Senate,Darcy Jech,REP,650302,2,5,75,82,26
Roger Mills,Governor,Joe Dorman,DEM,650303,0,4,58,62,
Roger Mills,Governor,Mary Fallin,REP,650303,2,17,82,101,
Roger Mills,Governor,Kimberly Willis,IND,650303,0,1,1,2,
Roger Mills,Governor,Richard Prawdzienski,IND,650303,0,0,1,1,
Roger Mills,Lieutenant Governor,Cathy Cummings,DEM,650303,0,3,27,30,
Roger Mills,Lieutenant Governor,Todd Lamb,REP,650303,2,19,114,135,
Roger Mills,Superintendent of Public Instruction,John Cox,DEM,650303,0,4,52,56,
Roger Mills,Superintendent of Public Instruction,Joy Hofmeister,REP,650303,2,16,90,108,
Roger Mills,Commissioner of Labor,Mike Workman,DEM,650303,0,3,38,41,
Roger Mills,Commissioner of Labor,Mark Costello,REP,650303,2,17,96,115,
Roger Mills,U.S. Senate,Matt Silverstein,DEM,650303,0,3,15,18,
Roger Mills,U.S. Senate,Jim Inhofe,REP,650303,2,19,120,141,
Roger Mills,U.S. Senate,Aaron Delozier,IND,650303,0,0,1,1,
Roger Mills,U.S. Senate,Ray Woods,IND,650303,0,0,3,3,
Roger Mills,U.S. Senate,Joan Farr,IND,650303,0,0,2,2,
Roger Mills,U.S. Senate,Connie Johnson,DEM,650303,0,3,24,27,
Roger Mills,U.S. Senate,James Lankford,REP,650303,2,19,112,133,
Roger Mills,U.S. Senate,Mark Beard,IND,650303,0,0,3,3,
Roger Mills,U.S. House,Frankie Robbins,DEM,650303,0,4,16,20,03
Roger Mills,U.S. House,Frank Lucas,REP,650303,2,18,125,145,03
Roger Mills,State Senate,Kevin Black,DEM,650303,0,4,62,66,26
Roger Mills,State Senate,Darcy Jech,REP,650303,2,18,79,99,26
Rogers,Governor,Joe Dorman,DEM,660001,10,46,271,327,
Rogers,Governor,Mary Fallin,REP,660001,11,62,403,476,
Rogers,Governor,Kimberly Willis,IND,660001,0,3,22,25,
Rogers,Governor,Richard Prawdzienski,IND,660001,0,0,15,15,
Rogers,Lieutenant Governor,Cathy Cummings,DEM,660001,12,29,204,245,
Rogers,Lieutenant Governor,Todd Lamb,REP,660001,9,83,503,595,
Rogers,Superintendent of Public Instruction,John Cox,DEM,660001,12,49,324,385,
Rogers,Superintendent of Public Instruction,Joy Hofmeister,REP,660001,9,63,381,453,
Rogers,Commissioner of Labor,Mike Workman,DEM,660001,13,42,259,314,
Rogers,Commissioner of Labor,Mark Costello,REP,660001,8,67,430,505,
Rogers,U.S. Senate,Matt Silverstein,DEM,660001,11,32,218,261,
Rogers,U.S. Senate,Jim Inhofe,REP,660001,10,78,456,544,
Rogers,U.S. Senate,Aaron Delozier,IND,660001,0,0,24,24,
Rogers,U.S. Senate,Ray Woods,IND,660001,0,1,2,3,
Rogers,U.S. Senate,Joan Farr,IND,660001,0,0,8,8,
Rogers,U.S. Senate,Connie Johnson,DEM,660001,11,29,205,245,
Rogers,U.S. Senate,James Lankford,REP,660001,10,83,477,570,
Rogers,U.S. Senate,Mark Beard,IND,660001,0,0,27,27,
Rogers,U.S. House,Earl Everett,DEM,660001,8,21,142,171,02
Rogers,U.S. House,Markwayne Mullin,REP,660001,12,84,494,590,02
Rogers,U.S. House,Jon Douthitt,IND,660001,1,7,73,81,02
Rogers,Governor,Joe Dorman,DEM,660002,3,29,107,139,
Rogers,Governor,Mary Fallin,REP,660002,9,44,159,212,
Rogers,Governor,Kimberly Willis,IND,660002,2,1,7,10,
Rogers,Governor,Richard Prawdzienski,IND,660002,1,1,8,10,
Rogers,Lieutenant Governor,Cathy Cummings,DEM,660002,2,18,93,113,
Rogers,Lieutenant Governor,Todd Lamb,REP,660002,12,56,187,255,
Rogers,Superintendent of Public Instruction,John Cox,DEM,660002,3,40,134,177,
Rogers,Superintendent of Public Instruction,Joy Hofmeister,REP,660002,11,35,145,191,
Rogers,Commissioner of Labor,Mike Workman,DEM,660002,3,24,107,134,
Rogers,Commissioner of Labor,Mark Costello,REP,660002,11,47,168,226,
Rogers,U.S. Senate,Matt Silverstein,DEM,660002,2,22,74,98,
Rogers,U.S. Senate,Jim Inhofe,REP,660002,11,50,189,250,
Rogers,U.S. Senate,Aaron Delozier,IND,660002,0,3,10,13,
Rogers,U.S. Senate,Ray Woods,IND,660002,2,0,5,7,
Rogers,U.S. Senate,Joan Farr,IND,660002,0,0,4,4,
Rogers,U.S. Senate,Connie Johnson,DEM,660002,2,21,73,96,
Rogers,U.S. Senate,James Lankford,REP,660002,12,51,190,253,
Rogers,U.S. Senate,Mark Beard,IND,660002,1,2,18,21,
Rogers,U.S. House,Earl Everett,DEM,660002,1,12,52,65,02
Rogers,U.S. House,Markwayne Mullin,REP,660002,11,59,192,262,02
Rogers,U.S. House,Jon Douthitt,IND,660002,3,2,34,39,02
Rogers,Governor,Joe Dorman,DEM,660003,6,21,144,171,
Rogers,Governor,Mary Fallin,REP,660003,3,28,270,301,
Rogers,Governor,Kimberly Willis,IND,660003,0,0,16,16,
Rogers,Governor,Richard Prawdzienski,IND,660003,0,0,10,10,
Rogers,Lieutenant Governor,Cathy Cummings,DEM,660003,6,13,97,116,
Rogers,Lieutenant Governor,Todd Lamb,REP,660003,3,36,340,379,
Rogers,Superintendent of Public Instruction,John Cox,DEM,660003,5,24,169,198,
Rogers,Superintendent of Public Instruction,Joy Hofmeister,REP,660003,4,25,266,295,
Rogers,Commissioner of Labor,Mike Workman,DEM,660003,6,18,120,144,
Rogers,Commissioner of Labor,Mark Costello,REP,660003,3,31,307,341,
Rogers,U.S. Senate,Matt Silverstein,DEM,660003,6,14,87,107,
Rogers,U.S. Senate,Jim Inhofe,REP,660003,3,31,321,355,
Rogers,U.S. Senate,Aaron Delozier,IND,660003,0,1,18,19,
Rogers,U.S. Senate,Ray Woods,IND,660003,0,0,5,5,
Rogers,U.S. Senate,Joan Farr,IND,660003,0,2,5,7,
Rogers,U.S. Senate,Connie Johnson,DEM,660003,6,12,75,93,
Rogers,U.S. Senate,James Lankford,REP,660003,3,35,337,375,
Rogers,U.S. Senate,Mark Beard,IND,660003,0,2,23,25,
Rogers,U.S. House,Earl Everett,DEM,660003,6,9,51,66,02
Rogers,U.S. House,Markwayne Mullin,REP,660003,3,34,340,377,02
Rogers,U.S. House,Jon Douthitt,IND,660003,0,6,44,50,02
Rogers,Governor,Joe Dorman,DEM,660004,5,55,292,352,
Rogers,Governor,Mary Fallin,REP,660004,8,63,480,551,
Rogers,Governor,Kimberly Willis,IND,660004,2,2,13,17,
Rogers,Governor,Richard Prawdzienski,IND,660004,0,2,14,16,
Rogers,Lieutenant Governor,Cathy Cummings,DEM,660004,6,38,183,227,
Rogers,Lieutenant Governor,Todd Lamb,REP,660004,8,84,610,702,
Rogers,Superintendent of Public Instruction,John Cox,DEM,660004,6,55,331,392,
Rogers,Superintendent of Public Instruction,Joy Hofmeister,REP,660004,8,66,459,533,
Rogers,Commissioner of Labor,Mike Workman,DEM,660004,6,51,266,323,
Rogers,Commissioner of Labor,Mark Costello,REP,660004,8,65,508,581,
Rogers,U.S. Senate,Matt Silverstein,DEM,660004,5,44,200,249,
Rogers,U.S. Senate,Jim Inhofe,REP,660004,7,68,557,632,
Rogers,U.S. Senate,Aaron Delozier,IND,660004,1,5,20,26,
Rogers,U.S. Senate,Ray Woods,IND,660004,1,1,10,12,
Rogers,U.S. Senate,Joan Farr,IND,660004,1,1,9,11,
Rogers,U.S. Senate,Connie Johnson,DEM,660004,5,40,172,217,
Rogers,U.S. Senate,James Lankford,REP,660004,8,77,587,672,
Rogers,U.S. Senate,Mark Beard,IND,660004,2,5,39,46,
Rogers,U.S. House,Earl Everett,DEM,660004,4,24,117,145,02
Rogers,U.S. House,Markwayne Mullin,REP,660004,9,79,577,665,02
Rogers,U.S. House,Jon Douthitt,IND,660004,2,19,100,121,02
Rogers,Governor,Joe Dorman,DEM,660005,4,27,125,156,
Rogers,Governor,Mary Fallin,REP,660005,6,53,288,347,
Rogers,Governor,Kimberly Willis,IND,660005,0,1,3,4,
Rogers,Governor,Richard Prawdzienski,IND,660005,0,1,5,6,
Rogers,Lieutenant Governor,Cathy Cummings,DEM,660005,2,17,87,106,
Rogers,Lieutenant Governor,Todd Lamb,REP,660005,8,65,332,405,
Rogers,Superintendent of Public Instruction,John Cox,DEM,660005,1,33,139,173,
Rogers,Superintendent of Public Instruction,Joy Hofmeister,REP,660005,9,49,281,339,
Rogers,Commissioner of Labor,Mike Workman,DEM,660005,2,23,116,141,
Rogers,Commissioner of Labor,Mark Costello,REP,660005,6,53,299,358,
Rogers,U.S. Senate,Matt Silverstein,DEM,660005,2,16,81,99,
Rogers,U.S. Senate,Jim Inhofe,REP,660005,8,65,325,398,
Rogers,U.S. Senate,Aaron Delozier,IND,660005,0,1,9,10,
Rogers,U.S. Senate,Ray Woods,IND,660005,0,0,1,1,
Rogers,U.S. Senate,Joan Farr,IND,660005,0,0,6,6,
Rogers,U.S. Senate,Connie Johnson,DEM,660005,0,17,76,93,
Rogers,U.S. Senate,James Lankford,REP,660005,9,62,327,398,
Rogers,U.S. Senate,Mark Beard,IND,660005,1,3,16,20,
Rogers,U.S. House,Earl Everett,DEM,660005,1,10,53,64,02
Rogers,U.S. House,Markwayne Mullin,REP,660005,8,61,321,390,02
Rogers,U.S. House,Jon Douthitt,IND,660005,1,11,48,60,02
Rogers,Governor,Joe Dorman,DEM,660006,8,3,144,155,
Rogers,Governor,Mary Fallin,REP,660006,20,26,314,360,
Rogers,Governor,Kimberly Willis,IND,660006,0,0,7,7,
Rogers,Governor,Richard Prawdzienski,IND,660006,0,0,8,8,
Rogers,Lieutenant Governor,Cathy Cummings,DEM,660006,6,3,101,110,
Rogers,Lieutenant Governor,Todd Lamb,REP,660006,20,26,371,417,
Rogers,Superintendent of Public Instruction,John Cox,DEM,660006,10,6,138,154,
Rogers,Superintendent of Public Instruction,Joy Hofmeister,REP,660006,17,23,335,375,
Rogers,Commissioner of Labor,Mike Workman,DEM,660006,7,4,116,127,
Rogers,Commissioner of Labor,Mark Costello,REP,660006,20,25,351,396,
Rogers,U.S. Senate,Matt Silverstein,DEM,660006,7,3,100,110,
Rogers,U.S. Senate,Jim Inhofe,REP,660006,20,26,357,403,
Rogers,U.S. Senate,Aaron Delozier,IND,660006,1,0,5,6,
Rogers,U.S. Senate,Ray Woods,IND,660006,0,0,2,2,
Rogers,U.S. Senate,Joan Farr,IND,660006,0,0,8,8,
Rogers,U.S. Senate,Connie Johnson,DEM,660006,6,3,91,100,
Rogers,U.S. Senate,James Lankford,REP,660006,21,25,368,414,
Rogers,U.S. Senate,Mark Beard,IND,660006,0,1,13,14,
Rogers,Governor,Joe Dorman,DEM,660007,2,26,239,267,
Rogers,Governor,Mary Fallin,REP,660007,7,51,329,387,
Rogers,Governor,Kimberly Willis,IND,660007,0,1,24,25,
Rogers,Governor,Richard Prawdzienski,IND,660007,0,0,8,8,
Rogers,Lieutenant Governor,Cathy Cummings,DEM,660007,0,17,147,164,
Rogers,Lieutenant Governor,Todd Lamb,REP,660007,9,62,454,525,
Rogers,Superintendent of Public Instruction,John Cox,DEM,660007,3,27,259,289,
Rogers,Superintendent of Public Instruction,Joy Hofmeister,REP,660007,5,53,339,397,
Rogers,Commissioner of Labor,Mike Workman,DEM,660007,2,20,208,230,
Rogers,Commissioner of Labor,Mark Costello,REP,660007,6,56,383,445,
Rogers,U.S. Senate,Matt Silverstein,DEM,660007,0,16,156,172,
Rogers,U.S. Senate,Jim Inhofe,REP,660007,7,61,422,490,
Rogers,U.S. Senate,Aaron Delozier,IND,660007,0,1,14,15,
Rogers,U.S. Senate,Ray Woods,IND,660007,2,0,5,7,
Rogers,U.S. Senate,Joan Farr,IND,660007,0,1,3,4,
Rogers,U.S. Senate,Connie Johnson,DEM,660007,0,14,137,151,
Rogers,U.S. Senate,James Lankford,REP,660007,7,61,444,512,
Rogers,U.S. Senate,Mark Beard,IND,660007,2,4,23,29,
Rogers,U.S. House,Earl Everett,DEM,660007,0,10,112,122,02
Rogers,U.S. House,Markwayne Mullin,REP,660007,7,64,432,503,02
Rogers,U.S. House,Jon Douthitt,IND,660007,2,5,58,65,02
Rogers,Governor,Joe Dorman,DEM,660008,9,27,191,227,
Rogers,Governor,Mary Fallin,REP,660008,19,48,298,365,
Rogers,Governor,Kimberly Willis,IND,660008,0,0,11,11,
Rogers,Governor,Richard Prawdzienski,IND,660008,1,0,8,9,
Rogers,Lieutenant Governor,Cathy Cummings,DEM,660008,10,19,136,165,
Rogers,Lieutenant Governor,Todd Lamb,REP,660008,18,54,369,441,
Rogers,Superintendent of Public Instruction,John Cox,DEM,660008,12,29,210,251,
Rogers,Superintendent of Public Instruction,Joy Hofmeister,REP,660008,15,44,298,357,
Rogers,Commissioner of Labor,Mike Workman,DEM,660008,11,22,166,199,
Rogers,Commissioner of Labor,Mark Costello,REP,660008,17,50,330,397,
Rogers,U.S. Senate,Matt Silverstein,DEM,660008,10,20,130,160,
Rogers,U.S. Senate,Jim Inhofe,REP,660008,19,54,345,418,
Rogers,U.S. Senate,Aaron Delozier,IND,660008,0,1,14,15,
Rogers,U.S. Senate,Ray Woods,IND,660008,0,0,5,5,
Rogers,U.S. Senate,Joan Farr,IND,660008,0,0,7,7,
Rogers,U.S. Senate,Connie Johnson,DEM,660008,11,19,113,143,
Rogers,U.S. Senate,James Lankford,REP,660008,16,55,372,443,
Rogers,U.S. Senate,Mark Beard,IND,660008,1,1,20,22,
Rogers,U.S. House,Earl Everett,DEM,660008,9,11,92,112,02
Rogers,U.S. House,Markwayne Mullin,REP,660008,17,55,363,435,02
Rogers,U.S. House,Jon Douthitt,IND,660008,2,8,50,60,02
Rogers,Governor,Joe Dorman,DEM,660009,0,18,88,106,
Rogers,Governor,Mary Fallin,REP,660009,9,20,200,229,
Rogers,Governor,Kimberly Willis,IND,660009,0,1,9,10,
Rogers,Governor,Richard Prawdzienski,IND,660009,0,0,3,3,
Rogers,Lieutenant Governor,Cathy Cummings,DEM,660009,1,10,54,65,
Rogers,Lieutenant Governor,Todd Lamb,REP,660009,8,32,246,286,
Rogers,Superintendent of Public Instruction,John Cox,DEM,660009,0,22,108,130,
Rogers,Superintendent of Public Instruction,Joy Hofmeister,REP,660009,9,20,190,219,
Rogers,Commissioner of Labor,Mike Workman,DEM,660009,0,14,68,82,
Rogers,Commissioner of Labor,Mark Costello,REP,660009,9,25,228,262,
Rogers,U.S. Senate,Matt Silverstein,DEM,660009,0,14,55,69,
Rogers,U.S. Senate,Jim Inhofe,REP,660009,9,25,234,268,
Rogers,U.S. Senate,Aaron Delozier,IND,660009,0,0,5,5,
Rogers,U.S. Senate,Ray Woods,IND,660009,0,1,1,2,
Rogers,U.S. Senate,Joan Farr,IND,660009,0,1,3,4,
Rogers,U.S. Senate,Connie Johnson,DEM,660009,1,11,47,59,
Rogers,U.S. Senate,James Lankford,REP,660009,8,29,245,282,
Rogers,U.S. Senate,Mark Beard,IND,660009,0,1,7,8,
Rogers,U.S. House,Earl Everett,DEM,660009,0,8,37,45,02
Rogers,U.S. House,Markwayne Mullin,REP,660009,9,30,250,289,02
Rogers,U.S. House,Jon Douthitt,IND,660009,0,3,14,17,02
Rogers,Governor,Joe Dorman,DEM,660010,12,5,258,275,
Rogers,Governor,Mary Fallin,REP,660010,30,23,624,677,
Rogers,Governor,Kimberly Willis,IND,660010,0,0,21,21,
Rogers,Governor,Richard Prawdzienski,IND,660010,0,0,12,12,
Rogers,Lieutenant Governor,Cathy Cummings,DEM,660010,6,5,209,220,
Rogers,Lieutenant Governor,Todd Lamb,REP,660010,35,23,703,761,
Rogers,Superintendent of Public Instruction,John Cox,DEM,660010,15,5,299,319,
Rogers,Superintendent of Public Instruction,Joy Hofmeister,REP,660010,27,23,609,659,
Rogers,Commissioner of Labor,Mike Workman,DEM,660010,11,5,252,268,
Rogers,Commissioner of Labor,Mark Costello,REP,660010,30,23,647,700,
Rogers,U.S. Senate,Matt Silverstein,DEM,660010,7,5,205,217,
Rogers,U.S. Senate,Jim Inhofe,REP,660010,35,23,686,744,
Rogers,U.S. Senate,Aaron Delozier,IND,660010,0,0,13,13,
Rogers,U.S. Senate,Ray Woods,IND,660010,0,0,5,5,
Rogers,U.S. Senate,Joan Farr,IND,660010,1,0,9,10,
Rogers,U.S. Senate,Connie Johnson,DEM,660010,5,5,198,208,
Rogers,U.S. Senate,James Lankford,REP,660010,34,23,693,750,
Rogers,U.S. Senate,Mark Beard,IND,660010,3,0,24,27,
Rogers,Governor,Joe Dorman,DEM,660011,3,26,306,335,
Rogers,Governor,Mary Fallin,REP,660011,8,35,469,512,
Rogers,Governor,Kimberly Willis,IND,660011,1,2,21,24,
Rogers,Governor,Richard Prawdzienski,IND,660011,0,0,15,15,
Rogers,Lieutenant Governor,Cathy Cummings,DEM,660011,1,15,243,259,
Rogers,Lieutenant Governor,Todd Lamb,REP,660011,11,48,567,626,
Rogers,Superintendent of Public Instruction,John Cox,DEM,660011,3,24,351,378,
Rogers,Superintendent of Public Instruction,Joy Hofmeister,REP,660011,9,37,454,500,
Rogers,Commissioner of Labor,Mike Workman,DEM,660011,2,26,322,350,
Rogers,Commissioner of Labor,Mark Costello,REP,660011,10,35,473,518,
Rogers,U.S. Senate,Matt Silverstein,DEM,660011,2,18,216,236,
Rogers,U.S. Senate,Jim Inhofe,REP,660011,10,41,546,597,
Rogers,U.S. Senate,Aaron Delozier,IND,660011,0,3,36,39,
Rogers,U.S. Senate,Ray Woods,IND,660011,0,0,5,5,
Rogers,U.S. Senate,Joan Farr,IND,660011,0,1,9,10,
Rogers,U.S. Senate,Connie Johnson,DEM,660011,1,14,231,246,
Rogers,U.S. Senate,James Lankford,REP,660011,11,48,556,615,
Rogers,U.S. Senate,Mark Beard,IND,660011,0,1,24,25,
Rogers,U.S. House,Earl Everett,DEM,660011,1,13,172,186,02
Rogers,U.S. House,Markwayne Mullin,REP,660011,11,47,588,646,02
Rogers,U.S. House,Jon Douthitt,IND,660011,0,2,54,56,02
Rogers,State House,Chuck Hoskin,DEM,660011,2,35,402,439,6
Rogers,State House,Marshall Scott Mcguire,REP,660011,10,27,404,441,6
Rogers,Governor,Joe Dorman,DEM,660012,0,3,62,65,
Rogers,Governor,Mary Fallin,REP,660012,1,2,128,131,
Rogers,Governor,Kimberly Willis,IND,660012,0,0,7,7,
Rogers,Governor,Richard Prawdzienski,IND,660012,0,0,0,0,
Rogers,Lieutenant Governor,Cathy Cummings,DEM,660012,0,2,50,52,
Rogers,Lieutenant Governor,Todd Lamb,REP,660012,1,3,145,149,
Rogers,Superintendent of Public Instruction,John Cox,DEM,660012,0,4,77,81,
Rogers,Superintendent of Public Instruction,Joy Hofmeister,REP,660012,1,1,119,121,
Rogers,Commissioner of Labor,Mike Workman,DEM,660012,0,3,64,67,
Rogers,Commissioner of Labor,Mark Costello,REP,660012,1,2,128,131,
Rogers,U.S. Senate,Matt Silverstein,DEM,660012,0,2,43,45,
Rogers,U.S. Senate,Jim Inhofe,REP,660012,1,3,143,147,
Rogers,U.S. Senate,Aaron Delozier,IND,660012,0,0,7,7,
Rogers,U.S. Senate,Ray Woods,IND,660012,0,0,1,1,
Rogers,U.S. Senate,Joan Farr,IND,660012,0,0,2,2,
Rogers,U.S. Senate,Connie Johnson,DEM,660012,0,2,44,46,
Rogers,U.S. Senate,James Lankford,REP,660012,1,3,145,149,
Rogers,U.S. Senate,Mark Beard,IND,660012,0,0,7,7,
Rogers,U.S. House,Earl Everett,DEM,660012,0,2,30,32,02
Rogers,U.S. House,Markwayne Mullin,REP,660012,1,3,156,160,02
Rogers,U.S. House,Jon Douthitt,IND,660012,0,0,10,10,02
Rogers,Governor,Joe Dorman,DEM,660013,6,21,142,169,
Rogers,Governor,Mary Fallin,REP,660013,3,44,301,348,
Rogers,Governor,Kimberly Willis,IND,660013,0,0,6,6,
Rogers,Governor,Richard Prawdzienski,IND,660013,0,0,6,6,
Rogers,Lieutenant Governor,Cathy Cummings,DEM,660013,3,18,100,121,
Rogers,Lieutenant Governor,Todd Lamb,REP,660013,6,47,354,407,
Rogers,Superintendent of Public Instruction,John Cox,DEM,660013,1,25,179,205,
Rogers,Superintendent of Public Instruction,Joy Hofmeister,REP,660013,7,40,275,322,
Rogers,Commissioner of Labor,Mike Workman,DEM,660013,3,18,124,145,
Rogers,Commissioner of Labor,Mark Costello,REP,660013,5,47,323,375,
Rogers,U.S. Senate,Matt Silverstein,DEM,660013,3,16,94,113,
Rogers,U.S. Senate,Jim Inhofe,REP,660013,5,48,343,396,
Rogers,U.S. Senate,Aaron Delozier,IND,660013,0,0,8,8,
Rogers,U.S. Senate,Ray Woods,IND,660013,1,0,5,6,
Rogers,U.S. Senate,Joan Farr,IND,660013,0,0,7,7,
Rogers,U.S. Senate,Connie Johnson,DEM,660013,4,16,85,105,
Rogers,U.S. Senate,James Lankford,REP,660013,5,46,352,403,
Rogers,U.S. Senate,Mark Beard,IND,660013,0,2,17,19,
Rogers,U.S. House,Earl Everett,DEM,660013,2,10,58,70,02
Rogers,U.S. House,Markwayne Mullin,REP,660013,5,51,362,418,02
Rogers,U.S. House,Jon Douthitt,IND,660013,2,4,33,39,02
Rogers,Governor,Joe Dorman,DEM,660014,5,23,155,183,
Rogers,Governor,Mary Fallin,REP,660014,8,34,326,368,
Rogers,Governor,Kimberly Willis,IND,660014,0,1,7,8,
Rogers,Governor,Richard Prawdzienski,IND,660014,0,0,5,5,
Rogers,Lieutenant Governor,Cathy Cummings,DEM,660014,5,13,98,116,
Rogers,Lieutenant Governor,Todd Lamb,REP,660014,8,45,397,450,
Rogers,Superintendent of Public Instruction,John Cox,DEM,660014,5,22,182,209,
Rogers,Superintendent of Public Instruction,Joy Hofmeister,REP,660014,8,36,310,354,
Rogers,Commissioner of Labor,Mike Workman,DEM,660014,6,16,124,146,
Rogers,Commissioner of Labor,Mark Costello,REP,660014,7,41,361,409,
Rogers,U.S. Senate,Matt Silverstein,DEM,660014,4,10,106,120,
Rogers,U.S. Senate,Jim Inhofe,REP,660014,8,47,375,430,
Rogers,U.S. Senate,Aaron Delozier,IND,660014,1,1,8,10,
Rogers,U.S. Senate,Ray Woods,IND,660014,0,0,2,2,
Rogers,U.S. Senate,Joan Farr,IND,660014,0,0,4,4,
Rogers,U.S. Senate,Connie Johnson,DEM,660014,4,11,94,109,
Rogers,U.S. Senate,James Lankford,REP,660014,9,47,390,446,
Rogers,U.S. Senate,Mark Beard,IND,660014,0,0,9,9,
Rogers,U.S. House,Earl Everett,DEM,660014,2,6,79,87,02
Rogers,U.S. House,Markwayne Mullin,REP,660014,11,47,382,440,02
Rogers,U.S. House,Jon Douthitt,IND,660014,0,5,31,36,02
Rogers,Governor,Joe Dorman,DEM,660015,4,4,289,297,
Rogers,Governor,Mary Fallin,REP,660015,9,4,412,425,
Rogers,Governor,Kimberly Willis,IND,660015,0,1,9,10,
Rogers,Governor,Richard Prawdzienski,IND,660015,0,0,2,2,
Rogers,Lieutenant Governor,Cathy Cummings,DEM,660015,3,5,202,210,
Rogers,Lieutenant Governor,Todd Lamb,REP,660015,10,4,509,523,
Rogers,Superintendent of Public Instruction,John Cox,DEM,660015,5,4,309,318,
Rogers,Superintendent of Public Instruction,Joy Hofmeister,REP,660015,8,5,400,413,
Rogers,Commissioner of Labor,Mike Workman,DEM,660015,4,5,247,256,
Rogers,Commissioner of Labor,Mark Costello,REP,660015,8,4,457,469,
Rogers,U.S. Senate,Matt Silverstein,DEM,660015,1,7,207,215,
Rogers,U.S. Senate,Jim Inhofe,REP,660015,12,2,471,485,
Rogers,U.S. Senate,Aaron Delozier,IND,660015,0,0,19,19,
Rogers,U.S. Senate,Ray Woods,IND,660015,1,0,5,6,
Rogers,U.S. Senate,Joan Farr,IND,660015,0,0,7,7,
Rogers,U.S. Senate,Connie Johnson,DEM,660015,3,5,188,196,
Rogers,U.S. Senate,James Lankford,REP,660015,9,4,499,512,
Rogers,U.S. Senate,Mark Beard,IND,660015,1,0,19,20,
Rogers,U.S. House,Earl Everett,DEM,660015,2,4,145,151,02
Rogers,U.S. House,Markwayne Mullin,REP,660015,11,4,518,533,02
Rogers,U.S. House,Jon Douthitt,IND,660015,0,1,46,47,02
Rogers,State House,Chuck Hoskin,DEM,660015,8,5,353,366,6
Rogers,State House,Marshall Scott Mcguire,REP,660015,5,4,355,364,6
Rogers,Governor,Joe Dorman,DEM,660017,1,7,129,137,
Rogers,Governor,Mary Fallin,REP,660017,0,19,266,285,
Rogers,Governor,Kimberly Willis,IND,660017,0,1,11,12,
Rogers,Governor,Richard Prawdzienski,IND,660017,0,1,3,4,
Rogers,Lieutenant Governor,Cathy Cummings,DEM,660017,1,5,94,100,
Rogers,Lieutenant Governor,Todd Lamb,REP,660017,0,23,311,334,
Rogers,Superintendent of Public Instruction,John Cox,DEM,660017,1,9,159,169,
Rogers,Superintendent of Public Instruction,Joy Hofmeister,REP,660017,0,20,245,265,
Rogers,Commissioner of Labor,Mike Workman,DEM,660017,1,8,117,126,
Rogers,Commissioner of Labor,Mark Costello,REP,660017,0,20,281,301,
Rogers,U.S. Senate,Matt Silverstein,DEM,660017,1,6,93,100,
Rogers,U.S. Senate,Jim Inhofe,REP,660017,0,21,294,315,
Rogers,U.S. Senate,Aaron Delozier,IND,660017,0,1,10,11,
Rogers,U.S. Senate,Ray Woods,IND,660017,0,0,3,3,
Rogers,U.S. Senate,Joan Farr,IND,660017,0,1,6,7,
Rogers,U.S. Senate,Connie Johnson,DEM,660017,1,6,76,83,
Rogers,U.S. Senate,James Lankford,REP,660017,0,22,312,334,
Rogers,U.S. Senate,Mark Beard,IND,660017,0,0,16,16,
Rogers,U.S. House,Earl Everett,DEM,660017,1,4,56,61,02
Rogers,U.S. House,Markwayne Mullin,REP,660017,0,24,322,346,02
Rogers,U.S. House,Jon Douthitt,IND,660017,0,1,27,28,02
Rogers,Governor,Joe Dorman,DEM,660018,6,33,270,309,
Rogers,Governor,Mary Fallin,REP,660018,7,48,449,504,
Rogers,Governor,Kimberly Willis,IND,660018,0,0,14,14,
Rogers,Governor,Richard Prawdzienski,IND,660018,0,0,8,8,
Rogers,Lieutenant Governor,Cathy Cummings,DEM,660018,7,26,159,192,
Rogers,Lieutenant Governor,Todd Lamb,REP,660018,7,55,579,641,
Rogers,Superintendent of Public Instruction,John Cox,DEM,660018,7,42,305,354,
Rogers,Superintendent of Public Instruction,Joy Hofmeister,REP,660018,6,38,433,477,
Rogers,Commissioner of Labor,Mike Workman,DEM,660018,6,31,217,254,
Rogers,Commissioner of Labor,Mark Costello,REP,660018,7,49,512,568,
Rogers,U.S. Senate,Matt Silverstein,DEM,660018,5,24,165,194,
Rogers,U.S. Senate,Jim Inhofe,REP,660018,8,56,536,600,
Rogers,U.S. Senate,Aaron Delozier,IND,660018,0,0,17,17,
Rogers,U.S. Senate,Ray Woods,IND,660018,0,0,8,8,
Rogers,U.S. Senate,Joan Farr,IND,660018,0,0,7,7,
Rogers,U.S. Senate,Connie Johnson,DEM,660018,5,23,148,176,
Rogers,U.S. Senate,James Lankford,REP,660018,6,57,569,632,
Rogers,U.S. Senate,Mark Beard,IND,660018,0,1,20,21,
Rogers,U.S. House,Earl Everett,DEM,660018,3,15,106,124,02
Rogers,U.S. House,Markwayne Mullin,REP,660018,8,55,572,635,02
Rogers,U.S. House,Jon Douthitt,IND,660018,1,11,60,72,02
Rogers,Governor,Joe Dorman,DEM,660019,4,9,144,157,
Rogers,Governor,Mary Fallin,REP,660019,1,24,293,318,
Rogers,Governor,Kimberly Willis,IND,660019,0,1,12,13,
Rogers,Governor,Richard Prawdzienski,IND,660019,0,0,3,3,
Rogers,Lieutenant Governor,Cathy Cummings,DEM,660019,3,6,75,84,
Rogers,Lieutenant Governor,Todd Lamb,REP,660019,2,28,375,405,
Rogers,Superintendent of Public Instruction,John Cox,DEM,660019,4,18,168,190,
Rogers,Superintendent of Public Instruction,Joy Hofmeister,REP,660019,1,16,283,300,
Rogers,Commissioner of Labor,Mike Workman,DEM,660019,3,7,131,141,
Rogers,Commissioner of Labor,Mark Costello,REP,660019,1,25,311,337,
Rogers,U.S. Senate,Matt Silverstein,DEM,660019,3,6,89,98,
Rogers,U.S. Senate,Jim Inhofe,REP,660019,2,26,350,378,
Rogers,U.S. Senate,Aaron Delozier,IND,660019,0,0,7,7,
Rogers,U.S. Senate,Ray Woods,IND,660019,0,0,0,0,
Rogers,U.S. Senate,Joan Farr,IND,660019,0,0,3,3,
Rogers,U.S. Senate,Connie Johnson,DEM,660019,3,7,77,87,
Rogers,U.S. Senate,James Lankford,REP,660019,2,26,358,386,
Rogers,U.S. Senate,Mark Beard,IND,660019,0,0,14,14,
Rogers,U.S. House,Earl Everett,DEM,660019,3,4,61,68,02
Rogers,U.S. House,Markwayne Mullin,REP,660019,2,28,365,395,02
Rogers,U.S. House,Jon Douthitt,IND,660019,0,2,21,23,02
Rogers,Governor,Joe Dorman,DEM,660020,5,25,297,327,
Rogers,Governor,Mary Fallin,REP,660020,6,60,512,578,
Rogers,Governor,Kimberly Willis,IND,660020,0,0,23,23,
Rogers,Governor,Richard Prawdzienski,IND,660020,0,0,7,7,
Rogers,Lieutenant Governor,Cathy Cummings,DEM,660020,3,12,187,202,
Rogers,Lieutenant Governor,Todd Lamb,REP,660020,8,73,649,730,
Rogers,Superintendent of Public Instruction,John Cox,DEM,660020,3,28,325,356,
Rogers,Superintendent of Public Instruction,Joy Hofmeister,REP,660020,8,57,514,579,
Rogers,Commissioner of Labor,Mike Workman,DEM,660020,3,18,276,297,
Rogers,Commissioner of Labor,Mark Costello,REP,660020,8,64,548,620,
Rogers,U.S. Senate,Matt Silverstein,DEM,660020,3,15,199,217,
Rogers,U.S. Senate,Jim Inhofe,REP,660020,8,68,608,684,
Rogers,U.S. Senate,Aaron Delozier,IND,660020,0,1,9,10,
Rogers,U.S. Senate,Ray Woods,IND,660020,0,1,7,8,
Rogers,U.S. Senate,Joan Farr,IND,660020,0,0,13,13,
Rogers,U.S. Senate,Connie Johnson,DEM,660020,3,12,192,207,
Rogers,U.S. Senate,James Lankford,REP,660020,8,71,624,703,
Rogers,U.S. Senate,Mark Beard,IND,660020,0,1,21,22,
Rogers,U.S. House,Earl Everett,DEM,660020,3,6,129,138,02
Rogers,U.S. House,Markwayne Mullin,REP,660020,8,71,638,717,02
Rogers,U.S. House,Jon Douthitt,IND,660020,0,8,70,78,02
Rogers,Governor,Joe Dorman,DEM,660021,4,2,20,26,
Rogers,Governor,Mary Fallin,REP,660021,9,0,70,79,
Rogers,Governor,Kimberly Willis,IND,660021,0,0,2,2,
Rogers,Governor,Richard Prawdzienski,IND,660021,0,0,3,3,
Rogers,Lieutenant Governor,Cathy Cummings,DEM,660021,4,1,13,18,
Rogers,Lieutenant Governor,Todd Lamb,REP,660021,9,1,82,92,
Rogers,Superintendent of Public Instruction,John Cox,DEM,660021,3,2,24,29,
Rogers,Superintendent of Public Instruction,Joy Hofmeister,REP,660021,10,0,70,80,
Rogers,Commissioner of Labor,Mike Workman,DEM,660021,4,1,15,20,
Rogers,Commissioner of Labor,Mark Costello,REP,660021,9,1,80,90,
Rogers,U.S. Senate,Matt Silverstein,DEM,660021,3,2,12,17,
Rogers,U.S. Senate,Jim Inhofe,REP,660021,10,0,79,89,
Rogers,U.S. Senate,Aaron Delozier,IND,660021,0,0,0,0,
Rogers,U.S. Senate,Ray Woods,IND,660021,0,0,3,3,
Rogers,U.S. Senate,Joan Farr,IND,660021,0,0,1,1,
Rogers,U.S. Senate,Connie Johnson,DEM,660021,4,1,11,16,
Rogers,U.S. Senate,James Lankford,REP,660021,9,1,81,91,
Rogers,U.S. Senate,Mark Beard,IND,660021,0,0,3,3,
Rogers,Governor,Joe Dorman,DEM,660022,1,30,177,208,
Rogers,Governor,Mary Fallin,REP,660022,11,44,424,479,
Rogers,Governor,Kimberly Willis,IND,660022,0,5,21,26,
Rogers,Governor,Richard Prawdzienski,IND,660022,0,1,10,11,
Rogers,Lieutenant Governor,Cathy Cummings,DEM,660022,1,19,115,135,
Rogers,Lieutenant Governor,Todd Lamb,REP,660022,11,61,513,585,
Rogers,Superintendent of Public Instruction,John Cox,DEM,660022,2,36,248,286,
Rogers,Superintendent of Public Instruction,Joy Hofmeister,REP,660022,10,44,379,433,
Rogers,Commissioner of Labor,Mike Workman,DEM,660022,1,28,184,213,
Rogers,Commissioner of Labor,Mark Costello,REP,660022,11,52,439,502,
Rogers,U.S. Senate,Matt Silverstein,DEM,660022,0,21,117,138,
Rogers,U.S. Senate,Jim Inhofe,REP,660022,11,55,486,552,
Rogers,U.S. Senate,Aaron Delozier,IND,660022,1,1,18,20,
Rogers,U.S. Senate,Ray Woods,IND,660022,0,1,4,5,
Rogers,U.S. Senate,Joan Farr,IND,660022,0,2,6,8,
Rogers,U.S. Senate,Connie Johnson,DEM,660022,0,16,112,128,
Rogers,U.S. Senate,James Lankford,REP,660022,11,63,490,564,
Rogers,U.S. Senate,Mark Beard,IND,660022,1,1,28,30,
Rogers,U.S. House,Earl Everett,DEM,660022,0,16,78,94,02
Rogers,U.S. House,Markwayne Mullin,REP,660022,12,62,519,593,02
Rogers,U.S. House,Jon Douthitt,IND,660022,0,2,34,36,02
Rogers,State House,Chuck Hoskin,DEM,660022,1,36,266,303,6
Rogers,State House,Marshall Scott Mcguire,REP,660022,11,44,360,415,6
Rogers,Governor,Joe Dorman,DEM,660023,4,11,361,376,
Rogers,Governor,Mary Fallin,REP,660023,11,37,721,769,
Rogers,Governor,Kimberly Willis,IND,660023,1,0,20,21,
Rogers,Governor,Richard Prawdzienski,IND,660023,0,0,10,10,
Rogers,Lieutenant Governor,Cathy Cummings,DEM,660023,3,10,259,272,
Rogers,Lieutenant Governor,Todd Lamb,REP,660023,13,38,848,899,
Rogers,Superintendent of Public Instruction,John Cox,DEM,660023,6,19,517,542,
Rogers,Superintendent of Public Instruction,Joy Hofmeister,REP,660023,10,28,587,625,
Rogers,Commissioner of Labor,Mike Workman,DEM,660023,4,18,417,439,
Rogers,Commissioner of Labor,Mark Costello,REP,660023,12,27,670,709,
Rogers,U.S. Senate,Matt Silverstein,DEM,660023,4,11,239,254,
Rogers,U.S. Senate,Jim Inhofe,REP,660023,11,37,824,872,
Rogers,U.S. Senate,Aaron Delozier,IND,660023,0,0,38,38,
Rogers,U.S. Senate,Ray Woods,IND,660023,0,0,6,6,
Rogers,U.S. Senate,Joan Farr,IND,660023,1,0,3,4,
Rogers,U.S. Senate,Connie Johnson,DEM,660023,4,11,252,267,
Rogers,U.S. Senate,James Lankford,REP,660023,12,35,810,857,
Rogers,U.S. Senate,Mark Beard,IND,660023,0,1,40,41,
Rogers,U.S. House,Earl Everett,DEM,660023,3,5,185,193,02
Rogers,U.S. House,Markwayne Mullin,REP,660023,12,37,877,926,02
Rogers,U.S. House,Jon Douthitt,IND,660023,1,5,46,52,02
Rogers,State House,Chuck Hoskin,DEM,660023,9,22,659,690,6
Rogers,State House,Marshall Scott Mcguire,REP,660023,6,25,446,477,6
Rogers,Governor,Joe Dorman,DEM,660024,2,2,99,103,
Rogers,Governor,Mary Fallin,REP,660024,4,7,207,218,
Rogers,Governor,Kimberly Willis,IND,660024,0,0,6,6,
Rogers,Governor,Richard Prawdzienski,IND,660024,0,0,4,4,
Rogers,Lieutenant Governor,Cathy Cummings,DEM,660024,1,1,69,71,
Rogers,Lieutenant Governor,Todd Lamb,REP,660024,5,8,247,260,
Rogers,Superintendent of Public Instruction,John Cox,DEM,660024,2,3,129,134,
Rogers,Superintendent of Public Instruction,Joy Hofmeister,REP,660024,4,6,185,195,
Rogers,Commissioner of Labor,Mike Workman,DEM,660024,2,2,96,100,
Rogers,Commissioner of Labor,Mark Costello,REP,660024,4,7,212,223,
Rogers,U.S. Senate,Matt Silverstein,DEM,660024,1,1,64,66,
Rogers,U.S. Senate,Jim Inhofe,REP,660024,5,8,242,255,
Rogers,U.S. Senate,Aaron Delozier,IND,660024,0,0,6,6,
Rogers,U.S. Senate,Ray Woods,IND,660024,0,0,3,3,
Rogers,U.S. Senate,Joan Farr,IND,660024,0,0,2,2,
Rogers,U.S. Senate,Connie Johnson,DEM,660024,1,1,56,58,
Rogers,U.S. Senate,James Lankford,REP,660024,5,7,248,260,
Rogers,U.S. Senate,Mark Beard,IND,660024,0,0,13,13,
Rogers,U.S. House,Earl Everett,DEM,660024,1,1,47,49,02
Rogers,U.S. House,Markwayne Mullin,REP,660024,4,8,254,266,02
Rogers,U.S. House,Jon Douthitt,IND,660024,0,0,16,16,02
Rogers,State House,Chuck Hoskin,DEM,660024,3,4,146,153,6
Rogers,State House,Marshall Scott Mcguire,REP,660024,2,5,166,173,6
Rogers,Governor,Joe Dorman,DEM,660025,2,3,50,55,
Rogers,Governor,Mary Fallin,REP,660025,0,0,124,124,
Rogers,Governor,Kimberly Willis,IND,660025,0,0,2,2,
Rogers,Governor,Richard Prawdzienski,IND,660025,0,0,1,1,
Rogers,Lieutenant Governor,Cathy Cummings,DEM,660025,1,3,35,39,
Rogers,Lieutenant Governor,Todd Lamb,REP,660025,1,0,142,143,
Rogers,Superintendent of Public Instruction,John Cox,DEM,660025,2,3,58,63,
Rogers,Superintendent of Public Instruction,Joy Hofmeister,REP,660025,0,0,117,117,
Rogers,Commissioner of Labor,Mike Workman,DEM,660025,1,3,44,48,
Rogers,Commissioner of Labor,Mark Costello,REP,660025,0,0,128,128,
Rogers,U.S. Senate,Matt Silverstein,DEM,660025,2,3,36,41,
Rogers,U.S. Senate,Jim Inhofe,REP,660025,0,0,138,138,
Rogers,U.S. Senate,Aaron Delozier,IND,660025,0,0,0,0,
Rogers,U.S. Senate,Ray Woods,IND,660025,0,0,0,0,
Rogers,U.S. Senate,Joan Farr,IND,660025,0,0,1,1,
Rogers,U.S. Senate,Connie Johnson,DEM,660025,2,3,33,38,
Rogers,U.S. Senate,James Lankford,REP,660025,0,0,142,142,
Rogers,U.S. Senate,Mark Beard,IND,660025,0,0,2,2,
Rogers,Governor,Joe Dorman,DEM,660026,8,10,307,325,
Rogers,Governor,Mary Fallin,REP,660026,12,20,610,642,
Rogers,Governor,Kimberly Willis,IND,660026,1,1,13,15,
Rogers,Governor,Richard Prawdzienski,IND,660026,0,0,11,11,
Rogers,Lieutenant Governor,Cathy Cummings,DEM,660026,5,8,192,205,
Rogers,Lieutenant Governor,Todd Lamb,REP,660026,16,23,739,778,
Rogers,Superintendent of Public Instruction,John Cox,DEM,660026,7,14,388,409,
Rogers,Superintendent of Public Instruction,Joy Hofmeister,REP,660026,14,17,546,577,
Rogers,Commissioner of Labor,Mike Workman,DEM,660026,5,7,246,258,
Rogers,Commissioner of Labor,Mark Costello,REP,660026,15,24,667,706,
Rogers,U.S. Senate,Matt Silverstein,DEM,660026,7,7,178,192,
Rogers,U.S. Senate,Jim Inhofe,REP,660026,13,22,728,763,
Rogers,U.S. Senate,Aaron Delozier,IND,660026,1,0,15,16,
Rogers,U.S. Senate,Ray Woods,IND,660026,0,1,4,5,
Rogers,U.S. Senate,Joan Farr,IND,660026,0,1,7,8,
Rogers,U.S. Senate,Connie Johnson,DEM,660026,6,8,168,182,
Rogers,U.S. Senate,James Lankford,REP,660026,15,22,735,772,
Rogers,U.S. Senate,Mark Beard,IND,660026,0,1,30,31,
Rogers,U.S. House,Earl Everett,DEM,660026,5,4,128,137,02
Rogers,U.S. House,Markwayne Mullin,REP,660026,16,25,768,809,02
Rogers,U.S. House,Jon Douthitt,IND,660026,0,2,40,42,02
Rogers,Governor,Joe Dorman,DEM,660027,3,8,152,163,
Rogers,Governor,Mary Fallin,REP,660027,0,4,205,209,
Rogers,Governor,Kimberly Willis,IND,660027,0,0,11,11,
Rogers,Governor,Richard Prawdzienski,IND,660027,0,0,6,6,
Rogers,Lieutenant Governor,Cathy Cummings,DEM,660027,2,6,101,109,
Rogers,Lieutenant Governor,Todd Lamb,REP,660027,1,6,274,281,
Rogers,Superintendent of Public Instruction,John Cox,DEM,660027,3,7,176,186,
Rogers,Superintendent of Public Instruction,Joy Hofmeister,REP,660027,0,5,195,200,
Rogers,Commissioner of Labor,Mike Workman,DEM,660027,3,7,119,129,
Rogers,Commissioner of Labor,Mark Costello,REP,660027,0,5,240,245,
Rogers,U.S. Senate,Matt Silverstein,DEM,660027,2,6,94,102,
Rogers,U.S. Senate,Jim Inhofe,REP,660027,1,5,261,267,
Rogers,U.S. Senate,Aaron Delozier,IND,660027,0,0,10,10,
Rogers,U.S. Senate,Ray Woods,IND,660027,0,0,6,6,
Rogers,U.S. Senate,Joan Farr,IND,660027,0,1,2,3,
Rogers,U.S. Senate,Connie Johnson,DEM,660027,2,5,81,88,
Rogers,U.S. Senate,James Lankford,REP,660027,1,7,277,285,
Rogers,U.S. Senate,Mark Beard,IND,660027,0,0,14,14,
Rogers,U.S. House,Earl Everett,DEM,660027,2,7,60,69,02
Rogers,U.S. House,Markwayne Mullin,REP,660027,1,5,289,295,02
Rogers,U.S. House,Jon Douthitt,IND,660027,0,0,24,24,02
Rogers,Governor,Joe Dorman,DEM,660029,2,5,96,103,
Rogers,Governor,Mary Fallin,REP,660029,5,14,244,263,
Rogers,Governor,Kimberly Willis,IND,660029,0,0,4,4,
Rogers,Governor,Richard Prawdzienski,IND,660029,0,0,10,10,
Rogers,Lieutenant Governor,Cathy Cummings,DEM,660029,2,2,66,70,
Rogers,Lieutenant Governor,Todd Lamb,REP,660029,5,17,289,311,
Rogers,Superintendent of Public Instruction,John Cox,DEM,660029,4,5,112,121,
Rogers,Superintendent of Public Instruction,Joy Hofmeister,REP,660029,3,14,243,260,
Rogers,Commissioner of Labor,Mike Workman,DEM,660029,2,4,83,89,
Rogers,Commissioner of Labor,Mark Costello,REP,660029,5,15,266,286,
Rogers,U.S. Senate,Matt Silverstein,DEM,660029,2,3,66,71,
Rogers,U.S. Senate,Jim Inhofe,REP,660029,4,16,273,293,
Rogers,U.S. Senate,Aaron Delozier,IND,660029,0,0,7,7,
Rogers,U.S. Senate,Ray Woods,IND,660029,1,0,4,5,
Rogers,U.S. Senate,Joan Farr,IND,660029,0,0,3,3,
Rogers,U.S. Senate,Connie Johnson,DEM,660029,2,2,61,65,
Rogers,U.S. Senate,James Lankford,REP,660029,5,16,288,309,
Rogers,U.S. Senate,Mark Beard,IND,660029,0,1,4,5,
Rogers,U.S. House,Earl Everett,DEM,660029,2,3,45,50,02
Rogers,U.S. House,Markwayne Mullin,REP,660029,5,16,289,310,02
Rogers,U.S. House,Jon Douthitt,IND,660029,0,0,21,21,02
Rogers,Governor,Joe Dorman,DEM,660030,8,11,224,243,
Rogers,Governor,Mary Fallin,REP,660030,21,18,739,778,
Rogers,Governor,Kimberly Willis,IND,660030,1,0,14,15,
Rogers,Governor,Richard Prawdzienski,IND,660030,0,0,5,5,
Rogers,Lieutenant Governor,Cathy Cummings,DEM,660030,5,7,138,150,
Rogers,Lieutenant Governor,Todd Lamb,REP,660030,26,21,843,890,
Rogers,Superintendent of Public Instruction,John Cox,DEM,660030,7,11,238,256,
Rogers,Superintendent of Public Instruction,Joy Hofmeister,REP,660030,23,18,737,778,
Rogers,Commissioner of Labor,Mike Workman,DEM,660030,7,7,175,189,
Rogers,Commissioner of Labor,Mark Costello,REP,660030,23,20,791,834,
Rogers,U.S. Senate,Matt Silverstein,DEM,660030,7,7,133,147,
Rogers,U.S. Senate,Jim Inhofe,REP,660030,23,22,819,864,
Rogers,U.S. Senate,Aaron Delozier,IND,660030,0,0,11,11,
Rogers,U.S. Senate,Ray Woods,IND,660030,0,0,6,6,
Rogers,U.S. Senate,Joan Farr,IND,660030,1,0,10,11,
Rogers,U.S. Senate,Connie Johnson,DEM,660030,6,6,125,137,
Rogers,U.S. Senate,James Lankford,REP,660030,24,23,828,875,
Rogers,U.S. Senate,Mark Beard,IND,660030,1,0,28,29,
Rogers,U.S. House,Earl Everett,DEM,660030,7,4,89,100,02
Rogers,U.S. House,Markwayne Mullin,REP,660030,24,23,847,894,02
Rogers,U.S. House,Jon Douthitt,IND,660030,0,1,45,46,02
Rogers,Governor,Joe Dorman,DEM,660031,5,4,239,248,
Rogers,Governor,Mary Fallin,REP,660031,14,17,500,531,
Rogers,Governor,Kimberly Willis,IND,660031,0,0,14,14,
Rogers,Governor,Richard Prawdzienski,IND,660031,0,0,9,9,
Rogers,Lieutenant Governor,Cathy Cummings,DEM,660031,2,3,174,179,
Rogers,Lieutenant Governor,Todd Lamb,REP,660031,16,18,584,618,
Rogers,Superintendent of Public Instruction,John Cox,DEM,660031,6,10,260,276,
Rogers,Superintendent of Public Instruction,Joy Hofmeister,REP,660031,12,11,500,523,
Rogers,Commissioner of Labor,Mike Workman,DEM,660031,3,5,211,219,
Rogers,Commissioner of Labor,Mark Costello,REP,660031,15,16,533,564,
Rogers,U.S. Senate,Matt Silverstein,DEM,660031,4,4,170,178,
Rogers,U.S. Senate,Jim Inhofe,REP,660031,15,17,570,602,
Rogers,U.S. Senate,Aaron Delozier,IND,660031,0,0,8,8,
Rogers,U.S. Senate,Ray Woods,IND,660031,0,0,4,4,
Rogers,U.S. Senate,Joan Farr,IND,660031,0,0,9,9,
Rogers,U.S. Senate,Connie Johnson,DEM,660031,3,3,156,162,
Rogers,U.S. Senate,James Lankford,REP,660031,16,18,580,614,
Rogers,U.S. Senate,Mark Beard,IND,660031,0,0,21,21,
Rogers,Governor,Joe Dorman,DEM,660032,12,3,98,113,
Rogers,Governor,Mary Fallin,REP,660032,28,13,238,279,
Rogers,Governor,Kimberly Willis,IND,660032,2,1,11,14,
Rogers,Governor,Richard Prawdzienski,IND,660032,0,0,5,5,
Rogers,Lieutenant Governor,Cathy Cummings,DEM,660032,11,3,64,78,
Rogers,Lieutenant Governor,Todd Lamb,REP,660032,31,14,287,332,
Rogers,Superintendent of Public Instruction,John Cox,DEM,660032,14,6,116,136,
Rogers,Superintendent of Public Instruction,Joy Hofmeister,REP,660032,28,11,235,274,
Rogers,Commissioner of Labor,Mike Workman,DEM,660032,14,3,81,98,
Rogers,Commissioner of Labor,Mark Costello,REP,660032,27,14,265,306,
Rogers,U.S. Senate,Matt Silverstein,DEM,660032,11,3,67,81,
Rogers,U.S. Senate,Jim Inhofe,REP,660032,30,14,274,318,
Rogers,U.S. Senate,Aaron Delozier,IND,660032,0,0,2,2,
Rogers,U.S. Senate,Ray Woods,IND,660032,0,0,6,6,
Rogers,U.S. Senate,Joan Farr,IND,660032,1,0,2,3,
Rogers,U.S. Senate,Connie Johnson,DEM,660032,9,3,61,73,
Rogers,U.S. Senate,James Lankford,REP,660032,33,13,285,331,
Rogers,U.S. Senate,Mark Beard,IND,660032,0,1,6,7,
Rogers,U.S. House,Earl Everett,DEM,660032,7,3,53,63,02
Rogers,U.S. House,Markwayne Mullin,REP,660032,34,13,284,331,02
Rogers,U.S. House,Jon Douthitt,IND,660032,1,1,13,15,02
Rogers,Governor,Joe Dorman,DEM,660033,2,0,83,85,
Rogers,Governor,Mary Fallin,REP,660033,2,0,133,135,
Rogers,Governor,Kimberly Willis,IND,660033,0,0,2,2,
Rogers,Governor,Richard Prawdzienski,IND,660033,0,0,2,2,
Rogers,Lieutenant Governor,Cathy Cummings,DEM,660033,2,0,59,61,
Rogers,Lieutenant Governor,Todd Lamb,REP,660033,2,0,159,161,
Rogers,Superintendent of Public Instruction,John Cox,DEM,660033,2,0,91,93,
Rogers,Superintendent of Public Instruction,Joy Hofmeister,REP,660033,2,0,128,130,
Rogers,Commissioner of Labor,Mike Workman,DEM,660033,2,0,70,72,
Rogers,Commissioner of Labor,Mark Costello,REP,660033,2,0,145,147,
Rogers,U.S. Senate,Matt Silverstein,DEM,660033,2,0,55,57,
Rogers,U.S. Senate,Jim Inhofe,REP,660033,2,0,155,157,
Rogers,U.S. Senate,Aaron Delozier,IND,660033,0,0,3,3,
Rogers,U.S. Senate,Ray Woods,IND,660033,0,0,4,4,
Rogers,U.S. Senate,Joan Farr,IND,660033,0,0,1,1,
Rogers,U.S. Senate,Connie Johnson,DEM,660033,2,0,46,48,
Rogers,U.S. Senate,James Lankford,REP,660033,2,0,165,167,
Rogers,U.S. Senate,Mark Beard,IND,660033,0,0,9,9,
Rogers,U.S. House,Earl Everett,DEM,660033,2,0,36,38,02
Rogers,U.S. House,Markwayne Mullin,REP,660033,2,0,168,170,02
Rogers,U.S. House,Jon Douthitt,IND,660033,0,0,14,14,02
Rogers,State House,Chuck Hoskin,DEM,660033,2,0,95,97,6
Rogers,State House,Marshall Scott Mcguire,REP,660033,2,0,124,126,6
Rogers,Governor,Joe Dorman,DEM,660110,9,12,166,187,
Rogers,Governor,Mary Fallin,REP,660110,7,20,351,378,
Rogers,Governor,Kimberly Willis,IND,660110,0,0,13,13,
Rogers,Governor,Richard Prawdzienski,IND,660110,0,0,7,7,
Rogers,Lieutenant Governor,Cathy Cummings,DEM,660110,7,11,102,120,
Rogers,Lieutenant Governor,Todd Lamb,REP,660110,9,21,429,459,
Rogers,Superintendent of Public Instruction,John Cox,DEM,660110,7,13,196,216,
Rogers,Superintendent of Public Instruction,Joy Hofmeister,REP,660110,9,19,337,365,
Rogers,Commissioner of Labor,Mike Workman,DEM,660110,7,10,143,160,
Rogers,Commissioner of Labor,Mark Costello,REP,660110,9,22,379,410,
Rogers,U.S. Senate,Matt Silverstein,DEM,660110,8,10,103,121,
Rogers,U.S. Senate,Jim Inhofe,REP,660110,8,22,401,431,
Rogers,U.S. Senate,Aaron Delozier,IND,660110,0,0,11,11,
Rogers,U.S. Senate,Ray Woods,IND,660110,0,0,6,6,
Rogers,U.S. Senate,Joan Farr,IND,660110,0,0,7,7,
Rogers,U.S. Senate,Connie Johnson,DEM,660110,7,11,89,107,
Rogers,U.S. Senate,James Lankford,REP,660110,9,20,423,452,
Rogers,U.S. Senate,Mark Beard,IND,660110,0,1,21,22,
Rogers,U.S. House,Earl Everett,DEM,660110,5,7,77,89,02
Rogers,U.S. House,Markwayne Mullin,REP,660110,9,21,418,448,02
Rogers,U.S. House,Jon Douthitt,IND,660110,2,4,37,43,02
Rogers,Governor,Joe Dorman,DEM,660116,0,2,134,136,
Rogers,Governor,Mary Fallin,REP,660116,5,3,263,271,
Rogers,Governor,Kimberly Willis,IND,660116,0,0,8,8,
Rogers,Governor,Richard Prawdzienski,IND,660116,0,0,7,7,
Rogers,Lieutenant Governor,Cathy Cummings,DEM,660116,0,2,101,103,
Rogers,Lieutenant Governor,Todd Lamb,REP,660116,5,3,308,316,
Rogers,Superintendent of Public Instruction,John Cox,DEM,660116,0,4,159,163,
Rogers,Superintendent of Public Instruction,Joy Hofmeister,REP,660116,5,1,250,256,
Rogers,Commissioner of Labor,Mike Workman,DEM,660116,0,2,114,116,
Rogers,Commissioner of Labor,Mark Costello,REP,660116,5,3,285,293,
Rogers,U.S. Senate,Matt Silverstein,DEM,660116,0,2,80,82,
Rogers,U.S. Senate,Jim Inhofe,REP,660116,5,3,311,319,
Rogers,U.S. Senate,Aaron Delozier,IND,660116,0,0,10,10,
Rogers,U.S. Senate,Ray Woods,IND,660116,0,0,3,3,
Rogers,U.S. Senate,Joan Farr,IND,660116,0,0,7,7,
Rogers,U.S. Senate,Connie Johnson,DEM,660116,0,2,71,73,
Rogers,U.S. Senate,James Lankford,REP,660116,5,3,318,326,
Rogers,U.S. Senate,Mark Beard,IND,660116,0,0,21,21,
Rogers,U.S. House,Earl Everett,DEM,660116,0,2,63,65,02
Rogers,U.S. House,Markwayne Mullin,REP,660116,5,3,333,341,02
Rogers,U.S. House,Jon Douthitt,IND,660116,0,0,15,15,02
Rogers,State House,Chuck Hoskin,DEM,660116,0,2,153,155,6
Rogers,State House,Marshall Scott Mcguire,REP,660116,5,3,254,262,6
Rogers,Governor,Joe Dorman,DEM,660120,1,7,140,148,
Rogers,Governor,Mary Fallin,REP,660120,8,28,337,373,
Rogers,Governor,Kimberly Willis,IND,660120,1,1,8,10,
Rogers,Governor,Richard Prawdzienski,IND,660120,0,0,5,5,
Rogers,Lieutenant Governor,Cathy Cummings,DEM,660120,1,4,94,99,
Rogers,Lieutenant Governor,Todd Lamb,REP,660120,10,33,392,435,
Rogers,Superintendent of Public Instruction,John Cox,DEM,660120,3,7,173,183,
Rogers,Superintendent of Public Instruction,Joy Hofmeister,REP,660120,8,30,314,352,
Rogers,Commissioner of Labor,Mike Workman,DEM,660120,0,6,117,123,
Rogers,Commissioner of Labor,Mark Costello,REP,660120,11,30,363,404,
Rogers,U.S. Senate,Matt Silverstein,DEM,660120,1,6,89,96,
Rogers,U.S. Senate,Jim Inhofe,REP,660120,10,29,384,423,
Rogers,U.S. Senate,Aaron Delozier,IND,660120,0,1,6,7,
Rogers,U.S. Senate,Ray Woods,IND,660120,0,0,2,2,
Rogers,U.S. Senate,Joan Farr,IND,660120,0,1,5,6,
Rogers,U.S. Senate,Connie Johnson,DEM,660120,0,7,79,86,
Rogers,U.S. Senate,James Lankford,REP,660120,11,30,387,428,
Rogers,U.S. Senate,Mark Beard,IND,660120,0,0,21,21,
Rogers,U.S. House,Earl Everett,DEM,660120,1,5,76,82,02
Rogers,U.S. House,Markwayne Mullin,REP,660120,10,31,387,428,02
Rogers,U.S. House,Jon Douthitt,IND,660120,0,1,25,26,02
Rogers,Governor,Joe Dorman,DEM,660128,2,2,142,146,
Rogers,Governor,Mary Fallin,REP,660128,3,11,256,270,
Rogers,Governor,Kimberly Willis,IND,660128,0,0,10,10,
Rogers,Governor,Richard Prawdzienski,IND,660128,0,0,6,6,
Rogers,Lieutenant Governor,Cathy Cummings,DEM,660128,3,2,98,103,
Rogers,Lieutenant Governor,Todd Lamb,REP,660128,2,11,313,326,
Rogers,Superintendent of Public Instruction,John Cox,DEM,660128,3,2,146,151,
Rogers,Superintendent of Public Instruction,Joy Hofmeister,REP,660128,2,11,269,282,
Rogers,Commissioner of Labor,Mike Workman,DEM,660128,2,2,137,141,
Rogers,Commissioner of Labor,Mark Costello,REP,660128,3,11,268,282,
Rogers,U.S. Senate,Matt Silverstein,DEM,660128,2,2,96,100,
Rogers,U.S. Senate,Jim Inhofe,REP,660128,2,11,304,317,
Rogers,U.S. Senate,Aaron Delozier,IND,660128,0,0,5,5,
Rogers,U.S. Senate,Ray Woods,IND,660128,1,0,5,6,
Rogers,U.S. Senate,Joan Farr,IND,660128,0,0,6,6,
Rogers,U.S. Senate,Connie Johnson,DEM,660128,2,2,92,96,
Rogers,U.S. Senate,James Lankford,REP,660128,3,11,313,327,
Rogers,U.S. Senate,Mark Beard,IND,660128,0,0,10,10,
Rogers,U.S. House,Earl Everett,DEM,660128,1,2,65,68,02
Rogers,U.S. House,Markwayne Mullin,REP,660128,3,11,317,331,02
Rogers,U.S. House,Jon Douthitt,IND,660128,1,0,27,28,02
Rogers,Governor,Joe Dorman,DEM,660130,12,12,324,348,
Rogers,Governor,Mary Fallin,REP,660130,25,31,820,876,
Rogers,Governor,Kimberly Willis,IND,660130,1,0,28,29,
Rogers,Governor,Richard Prawdzienski,IND,660130,0,0,16,16,
Rogers,Lieutenant Governor,Cathy Cummings,DEM,660130,9,8,228,245,
Rogers,Lieutenant Governor,Todd Lamb,REP,660130,29,35,961,1025,
Rogers,Superintendent of Public Instruction,John Cox,DEM,660130,16,13,356,385,
Rogers,Superintendent of Public Instruction,Joy Hofmeister,REP,660130,22,30,830,882,
Rogers,Commissioner of Labor,Mike Workman,DEM,660130,8,9,286,303,
Rogers,Commissioner of Labor,Mark Costello,REP,660130,29,33,872,934,
Rogers,U.S. Senate,Matt Silverstein,DEM,660130,7,9,234,250,
Rogers,U.S. Senate,Jim Inhofe,REP,660130,29,33,917,979,
Rogers,U.S. Senate,Aaron Delozier,IND,660130,0,0,14,14,
Rogers,U.S. Senate,Ray Woods,IND,660130,0,0,5,5,
Rogers,U.S. Senate,Joan Farr,IND,660130,2,0,15,17,
Rogers,U.S. Senate,Connie Johnson,DEM,660130,7,10,202,219,
Rogers,U.S. Senate,James Lankford,REP,660130,30,33,949,1012,
Rogers,U.S. Senate,Mark Beard,IND,660130,1,0,33,34,
Seminole,Governor,Joe Dorman,DEM,670010,2,6,186,194,
Seminole,Governor,Mary Fallin,REP,670010,9,12,243,264,
Seminole,Governor,Kimberly Willis,IND,670010,1,0,9,10,
Seminole,Governor,Richard Prawdzienski,IND,670010,0,0,6,6,
Seminole,Lieutenant Governor,Cathy Cummings,DEM,670010,2,3,153,158,
Seminole,Lieutenant Governor,Todd Lamb,REP,670010,10,15,291,316,
Seminole,Superintendent of Public Instruction,John Cox,DEM,670010,2,9,213,224,
Seminole,Superintendent of Public Instruction,Joy Hofmeister,REP,670010,10,9,227,246,
Seminole,Commissioner of Labor,Mike Workman,DEM,670010,2,4,183,189,
Seminole,Commissioner of Labor,Mark Costello,REP,670010,10,14,253,277,
Seminole,U.S. Senate,Matt Silverstein,DEM,670010,3,3,123,129,
Seminole,U.S. Senate,Jim Inhofe,REP,670010,8,15,304,327,
Seminole,U.S. Senate,Aaron Delozier,IND,670010,1,0,8,9,
Seminole,U.S. Senate,Ray Woods,IND,670010,0,0,1,1,
Seminole,U.S. Senate,Joan Farr,IND,670010,0,0,7,7,
Seminole,U.S. Senate,Connie Johnson,DEM,670010,2,4,125,131,
Seminole,U.S. Senate,James Lankford,REP,670010,9,14,309,332,
Seminole,U.S. Senate,Mark Beard,IND,670010,1,0,9,10,
Seminole,U.S. House,Al Mcaffrey,DEM,670010,2,3,137,142,05
Seminole,U.S. House,Steve Russell,REP,670010,10,13,282,305,05
Seminole,U.S. House,Buddy Ray,IND,670010,0,1,4,5,05
Seminole,U.S. House,Tom Boggs,IND,670010,0,0,10,10,05
Seminole,U.S. House,Robert Murphy,IND,670010,0,1,8,9,05
Seminole,State Senate,Marilyn Rainwater,DEM,670010,2,5,193,200,28
Seminole,State Senate,Jason Smalley,REP,670010,9,13,246,268,28
Seminole,State House,Jason Leonard,DEM,670010,2,3,172,177,28
Seminole,State House,Tom Newell,REP,670010,9,15,269,293,28
Seminole,Governor,Joe Dorman,DEM,670012,0,0,32,32,
Seminole,Governor,Mary Fallin,REP,670012,4,0,33,37,
Seminole,Governor,Kimberly Willis,IND,670012,0,0,2,2,
Seminole,Governor,Richard Prawdzienski,IND,670012,0,0,2,2,
Seminole,Lieutenant Governor,Cathy Cummings,DEM,670012,0,0,24,24,
Seminole,Lieutenant Governor,Todd Lamb,REP,670012,4,0,44,48,
Seminole,Superintendent of Public Instruction,John Cox,DEM,670012,0,0,36,36,
Seminole,Superintendent of Public Instruction,Joy Hofmeister,REP,670012,4,0,32,36,
Seminole,Commissioner of Labor,Mike Workman,DEM,670012,0,0,33,33,
Seminole,Commissioner of Labor,Mark Costello,REP,670012,4,0,34,38,
Seminole,U.S. Senate,Matt Silverstein,DEM,670012,0,0,16,16,
Seminole,U.S. Senate,Jim Inhofe,REP,670012,4,0,48,52,
Seminole,U.S. Senate,Aaron Delozier,IND,670012,0,0,0,0,
Seminole,U.S. Senate,Ray Woods,IND,670012,0,0,3,3,
Seminole,U.S. Senate,Joan Farr,IND,670012,0,0,0,0,
Seminole,U.S. Senate,Connie Johnson,DEM,670012,0,0,21,21,
Seminole,U.S. Senate,James Lankford,REP,670012,4,0,44,48,
Seminole,U.S. Senate,Mark Beard,IND,670012,0,0,3,3,
Seminole,U.S. House,Al Mcaffrey,DEM,670012,0,0,21,21,05
Seminole,U.S. House,Steve Russell,REP,670012,4,0,44,48,05
Seminole,U.S. House,Buddy Ray,IND,670012,0,0,0,0,05
Seminole,U.S. House,Tom Boggs,IND,670012,0,0,1,1,05
Seminole,U.S. House,Robert Murphy,IND,670012,0,0,1,1,05
Seminole,State House,Jason Leonard,DEM,670012,0,0,26,26,28
Seminole,State House,Tom Newell,REP,670012,4,0,42,46,28
Seminole,Governor,Joe Dorman,DEM,670014,5,3,231,239,
Seminole,Governor,Mary Fallin,REP,670014,7,9,310,326,
Seminole,Governor,Kimberly Willis,IND,670014,0,0,15,15,
Seminole,Governor,Richard Prawdzienski,IND,670014,0,0,7,7,
Seminole,Lieutenant Governor,Cathy Cummings,DEM,670014,2,2,163,167,
Seminole,Lieutenant Governor,Todd Lamb,REP,670014,10,10,400,420,
Seminole,Superintendent of Public Instruction,John Cox,DEM,670014,5,4,285,294,
Seminole,Superintendent of Public Instruction,Joy Hofmeister,REP,670014,7,8,277,292,
Seminole,Commissioner of Labor,Mike Workman,DEM,670014,6,5,245,256,
Seminole,Commissioner of Labor,Mark Costello,REP,670014,6,7,299,312,
Seminole,U.S. Senate,Matt Silverstein,DEM,670014,3,0,135,138,
Seminole,U.S. Senate,Jim Inhofe,REP,670014,8,12,405,425,
Seminole,U.S. Senate,Aaron Delozier,IND,670014,0,0,7,7,
Seminole,U.S. Senate,Ray Woods,IND,670014,0,0,5,5,
Seminole,U.S. Senate,Joan Farr,IND,670014,0,0,8,8,
Seminole,U.S. Senate,Connie Johnson,DEM,670014,4,0,131,135,
Seminole,U.S. Senate,James Lankford,REP,670014,7,12,414,433,
Seminole,U.S. Senate,Mark Beard,IND,670014,0,0,18,18,
Seminole,U.S. House,Al Mcaffrey,DEM,670014,3,2,146,151,05
Seminole,U.S. House,Steve Russell,REP,670014,9,9,374,392,05
Seminole,U.S. House,Buddy Ray,IND,670014,0,0,11,11,05
Seminole,U.S. House,Tom Boggs,IND,670014,0,1,18,19,05
Seminole,U.S. House,Robert Murphy,IND,670014,0,0,11,11,05
Seminole,State House,Jason Leonard,DEM,670014,4,3,162,169,28
Seminole,State House,Tom Newell,REP,670014,6,9,393,408,28
Seminole,Governor,Joe Dorman,DEM,670015,5,6,104,115,
Seminole,Governor,Mary Fallin,REP,670015,4,10,119,133,
Seminole,Governor,Kimberly Willis,IND,670015,0,0,5,5,
Seminole,Governor,Richard Prawdzienski,IND,670015,0,0,5,5,
Seminole,Lieutenant Governor,Cathy Cummings,DEM,670015,4,1,84,89,
Seminole,Lieutenant Governor,Todd Lamb,REP,670015,5,15,148,168,
Seminole,Superintendent of Public Instruction,John Cox,DEM,670015,4,5,123,132,
Seminole,Superintendent of Public Instruction,Joy Hofmeister,REP,670015,5,11,108,124,
Seminole,Commissioner of Labor,Mike Workman,DEM,670015,4,1,111,116,
Seminole,Commissioner of Labor,Mark Costello,REP,670015,5,15,110,130,
Seminole,U.S. Senate,Matt Silverstein,DEM,670015,2,0,64,66,
Seminole,U.S. Senate,Jim Inhofe,REP,670015,7,14,157,178,
Seminole,U.S. Senate,Aaron Delozier,IND,670015,0,1,2,3,
Seminole,U.S. Senate,Ray Woods,IND,670015,0,0,5,5,
Seminole,U.S. Senate,Joan Farr,IND,670015,0,0,4,4,
Seminole,U.S. Senate,Connie Johnson,DEM,670015,4,1,73,78,
Seminole,U.S. Senate,James Lankford,REP,670015,5,14,150,169,
Seminole,U.S. Senate,Mark Beard,IND,670015,0,0,7,7,
Seminole,U.S. House,Al Mcaffrey,DEM,670015,3,2,72,77,05
Seminole,U.S. House,Steve Russell,REP,670015,6,13,137,156,05
Seminole,U.S. House,Buddy Ray,IND,670015,0,0,9,9,05
Seminole,U.S. House,Tom Boggs,IND,670015,0,0,7,7,05
Seminole,U.S. House,Robert Murphy,IND,670015,0,0,2,2,05
Seminole,State House,Jason Leonard,DEM,670015,3,1,82,86,28
Seminole,State House,Tom Newell,REP,670015,6,15,147,168,28
Seminole,Governor,Joe Dorman,DEM,670020,0,2,130,132,
Seminole,Governor,Mary Fallin,REP,670020,6,1,260,267,
Seminole,Governor,Kimberly Willis,IND,670020,0,0,12,12,
Seminole,Governor,Richard Prawdzienski,IND,670020,0,0,2,2,
Seminole,Lieutenant Governor,Cathy Cummings,DEM,670020,0,2,81,83,
Seminole,Lieutenant Governor,Todd Lamb,REP,670020,6,1,321,328,
Seminole,Superintendent of Public Instruction,John Cox,DEM,670020,1,3,167,171,
Seminole,Superintendent of Public Instruction,Joy Hofmeister,REP,670020,5,0,235,240,
Seminole,Commissioner of Labor,Mike Workman,DEM,670020,0,2,121,123,
Seminole,Commissioner of Labor,Mark Costello,REP,670020,6,1,277,284,
Seminole,U.S. Senate,Matt Silverstein,DEM,670020,0,2,72,74,
Seminole,U.S. Senate,Jim Inhofe,REP,670020,6,1,320,327,
Seminole,U.S. Senate,Aaron Delozier,IND,670020,0,0,3,3,
Seminole,U.S. Senate,Ray Woods,IND,670020,0,0,4,4,
Seminole,U.S. Senate,Joan Farr,IND,670020,0,0,2,2,
Seminole,U.S. Senate,Connie Johnson,DEM,670020,0,2,59,61,
Seminole,U.S. Senate,James Lankford,REP,670020,5,1,331,337,
Seminole,U.S. Senate,Mark Beard,IND,670020,0,0,13,13,
Seminole,U.S. House,Al Mcaffrey,DEM,670020,0,1,85,86,05
Seminole,U.S. House,Steve Russell,REP,670020,6,2,302,310,05
Seminole,U.S. House,Buddy Ray,IND,670020,0,0,1,1,05
Seminole,U.S. House,Tom Boggs,IND,670020,0,0,7,7,05
Seminole,U.S. House,Robert Murphy,IND,670020,0,0,6,6,05
Seminole,State Senate,Marilyn Rainwater,DEM,670020,0,3,124,127,28
Seminole,State Senate,Jason Smalley,REP,670020,6,0,277,283,28
Seminole,State House,Jason Leonard,DEM,670020,0,3,87,90,28
Seminole,State House,Tom Newell,REP,670020,6,0,311,317,28
Seminole,Governor,Joe Dorman,DEM,670022,5,7,175,187,
Seminole,Governor,Mary Fallin,REP,670022,11,2,241,254,
Seminole,Governor,Kimberly Willis,IND,670022,0,0,5,5,
Seminole,Governor,Richard Prawdzienski,IND,670022,1,0,5,6,
Seminole,Lieutenant Governor,Cathy Cummings,DEM,670022,4,4,137,145,
Seminole,Lieutenant Governor,Todd Lamb,REP,670022,13,5,286,304,
Seminole,Superintendent of Public Instruction,John Cox,DEM,670022,6,5,206,217,
Seminole,Superintendent of Public Instruction,Joy Hofmeister,REP,670022,11,4,219,234,
Seminole,Commissioner of Labor,Mike Workman,DEM,670022,4,7,177,188,
Seminole,Commissioner of Labor,Mark Costello,REP,670022,13,2,243,258,
Seminole,U.S. Senate,Matt Silverstein,DEM,670022,4,5,127,136,
Seminole,U.S. Senate,Jim Inhofe,REP,670022,12,4,282,298,
Seminole,U.S. Senate,Aaron Delozier,IND,670022,0,0,6,6,
Seminole,U.S. Senate,Ray Woods,IND,670022,1,0,6,7,
Seminole,U.S. Senate,Joan Farr,IND,670022,0,0,2,2,
Seminole,U.S. Senate,Connie Johnson,DEM,670022,4,4,124,132,
Seminole,U.S. Senate,James Lankford,REP,670022,12,4,283,299,
Seminole,U.S. Senate,Mark Beard,IND,670022,1,1,15,17,
Seminole,U.S. House,Al Mcaffrey,DEM,670022,4,4,139,147,05
Seminole,U.S. House,Steve Russell,REP,670022,12,5,270,287,05
Seminole,U.S. House,Buddy Ray,IND,670022,0,0,1,1,05
Seminole,U.S. House,Tom Boggs,IND,670022,1,0,5,6,05
Seminole,U.S. House,Robert Murphy,IND,670022,0,0,6,6,05
Seminole,State Senate,Marilyn Rainwater,DEM,670022,3,6,174,183,28
Seminole,State Senate,Jason Smalley,REP,670022,14,3,247,264,28
Seminole,State House,Jason Leonard,DEM,670022,5,6,141,152,28
Seminole,State House,Tom Newell,REP,670022,12,3,276,291,28
Seminole,Governor,Joe Dorman,DEM,670023,2,11,186,199,
Seminole,Governor,Mary Fallin,REP,670023,6,9,284,299,
Seminole,Governor,Kimberly Willis,IND,670023,1,0,4,5,
Seminole,Governor,Richard Prawdzienski,IND,670023,0,0,4,4,
Seminole,Lieutenant Governor,Cathy Cummings,DEM,670023,2,7,128,137,
Seminole,Lieutenant Governor,Todd Lamb,REP,670023,6,13,347,366,
Seminole,Superintendent of Public Instruction,John Cox,DEM,670023,2,11,230,243,
Seminole,Superintendent of Public Instruction,Joy Hofmeister,REP,670023,4,9,248,261,
Seminole,Commissioner of Labor,Mike Workman,DEM,670023,2,7,168,177,
Seminole,Commissioner of Labor,Mark Costello,REP,670023,3,12,302,317,
Seminole,U.S. Senate,Matt Silverstein,DEM,670023,3,5,105,113,
Seminole,U.S. Senate,Jim Inhofe,REP,670023,4,15,363,382,
Seminole,U.S. Senate,Aaron Delozier,IND,670023,1,0,4,5,
Seminole,U.S. Senate,Ray Woods,IND,670023,0,0,3,3,
Seminole,U.S. Senate,Joan Farr,IND,670023,0,0,5,5,
Seminole,U.S. Senate,Connie Johnson,DEM,670023,2,6,112,120,
Seminole,U.S. Senate,James Lankford,REP,670023,3,14,361,378,
Seminole,U.S. Senate,Mark Beard,IND,670023,2,0,6,8,
Seminole,U.S. House,Al Mcaffrey,DEM,670023,2,5,127,134,05
Seminole,U.S. House,Steve Russell,REP,670023,2,14,327,343,05
Seminole,U.S. House,Buddy Ray,IND,670023,0,0,4,4,05
Seminole,U.S. House,Tom Boggs,IND,670023,0,0,10,10,05
Seminole,U.S. House,Robert Murphy,IND,670023,1,0,8,9,05
Seminole,State Senate,Marilyn Rainwater,DEM,670023,3,9,171,183,28
Seminole,State Senate,Jason Smalley,REP,670023,5,10,308,323,28
Seminole,State House,Jason Leonard,DEM,670023,4,10,150,164,28
Seminole,State House,Tom Newell,REP,670023,4,10,323,337,28
Seminole,Governor,Joe Dorman,DEM,670024,0,5,111,116,
Seminole,Governor,Mary Fallin,REP,670024,2,2,197,201,
Seminole,Governor,Kimberly Willis,IND,670024,0,0,6,6,
Seminole,Governor,Richard Prawdzienski,IND,670024,0,0,8,8,
Seminole,Lieutenant Governor,Cathy Cummings,DEM,670024,0,4,86,90,
Seminole,Lieutenant Governor,Todd Lamb,REP,670024,2,3,235,240,
Seminole,Superintendent of Public Instruction,John Cox,DEM,670024,0,7,142,149,
Seminole,Superintendent of Public Instruction,Joy Hofmeister,REP,670024,2,0,180,182,
Seminole,Commissioner of Labor,Mike Workman,DEM,670024,1,4,127,132,
Seminole,Commissioner of Labor,Mark Costello,REP,670024,1,1,187,189,
Seminole,U.S. Senate,Matt Silverstein,DEM,670024,0,5,78,83,
Seminole,U.S. Senate,Jim Inhofe,REP,670024,2,2,234,238,
Seminole,U.S. Senate,Aaron Delozier,IND,670024,0,0,2,2,
Seminole,U.S. Senate,Ray Woods,IND,670024,0,0,4,4,
Seminole,U.S. Senate,Joan Farr,IND,670024,0,0,2,2,
Seminole,U.S. Senate,Connie Johnson,DEM,670024,0,3,75,78,
Seminole,U.S. Senate,James Lankford,REP,670024,2,4,241,247,
Seminole,U.S. Senate,Mark Beard,IND,670024,0,0,5,5,
Seminole,U.S. House,Al Mcaffrey,DEM,670024,0,5,83,88,05
Seminole,U.S. House,Steve Russell,REP,670024,2,2,222,226,05
Seminole,U.S. House,Buddy Ray,IND,670024,0,0,4,4,05
Seminole,U.S. House,Tom Boggs,IND,670024,0,0,6,6,05
Seminole,U.S. House,Robert Murphy,IND,670024,0,0,3,3,05
Seminole,State Senate,Marilyn Rainwater,DEM,670024,0,5,140,145,28
Seminole,State Senate,Jason Smalley,REP,670024,2,2,180,184,28
Seminole,State House,Jason Leonard,DEM,670024,0,5,98,103,28
Seminole,State House,Tom Newell,REP,670024,2,2,222,226,28
Seminole,Governor,Joe Dorman,DEM,670025,1,2,26,29,
Seminole,Governor,Mary Fallin,REP,670025,3,2,49,54,
Seminole,Governor,Kimberly Willis,IND,670025,0,0,3,3,
Seminole,Governor,Richard Prawdzienski,IND,670025,0,0,2,2,
Seminole,Lieutenant Governor,Cathy Cummings,DEM,670025,0,1,20,21,
Seminole,Lieutenant Governor,Todd Lamb,REP,670025,4,3,61,68,
Seminole,Superintendent of Public Instruction,John Cox,DEM,670025,1,2,31,34,
Seminole,Superintendent of Public Instruction,Joy Hofmeister,REP,670025,3,2,49,54,
Seminole,Commissioner of Labor,Mike Workman,DEM,670025,2,0,35,37,
Seminole,Commissioner of Labor,Mark Costello,REP,670025,2,4,46,52,
Seminole,U.S. Senate,Matt Silverstein,DEM,670025,0,0,18,18,
Seminole,U.S. Senate,Jim Inhofe,REP,670025,4,4,59,67,
Seminole,U.S. Senate,Aaron Delozier,IND,670025,0,0,0,0,
Seminole,U.S. Senate,Ray Woods,IND,670025,0,0,0,0,
Seminole,U.S. Senate,Joan Farr,IND,670025,0,0,2,2,
Seminole,U.S. Senate,Connie Johnson,DEM,670025,0,0,18,18,
Seminole,U.S. Senate,James Lankford,REP,670025,4,4,61,69,
Seminole,U.S. Senate,Mark Beard,IND,670025,0,0,2,2,
Seminole,U.S. House,Al Mcaffrey,DEM,670025,0,1,15,16,05
Seminole,U.S. House,Steve Russell,REP,670025,4,3,63,70,05
Seminole,U.S. House,Buddy Ray,IND,670025,0,0,0,0,05
Seminole,U.S. House,Tom Boggs,IND,670025,0,0,0,0,05
Seminole,U.S. House,Robert Murphy,IND,670025,0,0,2,2,05
Seminole,State House,Jason Leonard,DEM,670025,0,2,24,26,28
Seminole,State House,Tom Newell,REP,670025,4,2,57,63,28
Seminole,Governor,Joe Dorman,DEM,670030,0,0,64,64,
Seminole,Governor,Mary Fallin,REP,670030,1,2,109,112,
Seminole,Governor,Kimberly Willis,IND,670030,0,0,6,6,
Seminole,Governor,Richard Prawdzienski,IND,670030,0,0,2,2,
Seminole,Lieutenant Governor,Cathy Cummings,DEM,670030,0,1,52,53,
Seminole,Lieutenant Governor,Todd Lamb,REP,670030,1,1,123,125,
Seminole,Superintendent of Public Instruction,John Cox,DEM,670030,0,1,77,78,
Seminole,Superintendent of Public Instruction,Joy Hofmeister,REP,670030,1,1,99,101,
Seminole,Commissioner of Labor,Mike Workman,DEM,670030,0,0,69,69,
Seminole,Commissioner of Labor,Mark Costello,REP,670030,1,2,100,103,
Seminole,U.S. Senate,Matt Silverstein,DEM,670030,0,0,43,43,
Seminole,U.S. Senate,Jim Inhofe,REP,670030,1,2,129,132,
Seminole,U.S. Senate,Aaron Delozier,IND,670030,0,0,1,1,
Seminole,U.S. Senate,Ray Woods,IND,670030,0,0,1,1,
Seminole,U.S. Senate,Joan Farr,IND,670030,0,0,1,1,
Seminole,U.S. Senate,Connie Johnson,DEM,670030,0,0,41,41,
Seminole,U.S. Senate,James Lankford,REP,670030,0,2,129,131,
Seminole,U.S. Senate,Mark Beard,IND,670030,1,0,6,7,
Seminole,U.S. House,Al Mcaffrey,DEM,670030,0,1,47,48,05
Seminole,U.S. House,Steve Russell,REP,670030,0,1,120,121,05
Seminole,U.S. House,Buddy Ray,IND,670030,0,0,1,1,05
Seminole,U.S. House,Tom Boggs,IND,670030,1,0,5,6,05
Seminole,U.S. House,Robert Murphy,IND,670030,0,0,0,0,05
Seminole,State Senate,Marilyn Rainwater,DEM,670030,0,1,63,64,28
Seminole,State Senate,Jason Smalley,REP,670030,1,1,111,113,28
Seminole,State House,Jason Leonard,DEM,670030,0,0,47,47,28
Seminole,State House,Tom Newell,REP,670030,1,2,129,132,28
Seminole,Governor,Joe Dorman,DEM,670032,2,21,167,190,
Seminole,Governor,Mary Fallin,REP,670032,5,30,158,193,
Seminole,Governor,Kimberly Willis,IND,670032,0,0,5,5,
Seminole,Governor,Richard Prawdzienski,IND,670032,0,1,1,2,
Seminole,Lieutenant Governor,Cathy Cummings,DEM,670032,2,14,114,130,
Seminole,Lieutenant Governor,Todd Lamb,REP,670032,5,37,217,259,
Seminole,Superintendent of Public Instruction,John Cox,DEM,670032,3,31,188,222,
Seminole,Superintendent of Public Instruction,Joy Hofmeister,REP,670032,4,19,141,164,
Seminole,Commissioner of Labor,Mike Workman,DEM,670032,3,23,159,185,
Seminole,Commissioner of Labor,Mark Costello,REP,670032,4,25,164,193,
Seminole,U.S. Senate,Matt Silverstein,DEM,670032,2,15,108,125,
Seminole,U.S. Senate,Jim Inhofe,REP,670032,5,35,212,252,
Seminole,U.S. Senate,Aaron Delozier,IND,670032,0,1,2,3,
Seminole,U.S. Senate,Ray Woods,IND,670032,0,0,5,5,
Seminole,U.S. Senate,Joan Farr,IND,670032,0,0,3,3,
Seminole,U.S. Senate,Connie Johnson,DEM,670032,3,13,97,113,
Seminole,U.S. Senate,James Lankford,REP,670032,4,39,229,272,
Seminole,U.S. Senate,Mark Beard,IND,670032,0,0,7,7,
Seminole,U.S. House,Al Mcaffrey,DEM,670032,3,19,115,137,05
Seminole,U.S. House,Steve Russell,REP,670032,4,33,203,240,05
Seminole,U.S. House,Buddy Ray,IND,670032,0,0,2,2,05
Seminole,U.S. House,Tom Boggs,IND,670032,0,0,6,6,05
Seminole,U.S. House,Robert Murphy,IND,670032,0,0,2,2,05
Seminole,State Senate,Marilyn Rainwater,DEM,670032,3,22,157,182,28
Seminole,State Senate,Jason Smalley,REP,670032,4,30,174,208,28
Seminole,State House,Jason Leonard,DEM,670032,3,17,131,151,28
Seminole,State House,Tom Newell,REP,670032,4,35,198,237,28
Seminole,Governor,Joe Dorman,DEM,670033,2,0,17,19,
Seminole,Governor,Mary Fallin,REP,670033,0,2,35,37,
Seminole,Governor,Kimberly Willis,IND,670033,0,1,2,3,
Seminole,Governor,Richard Prawdzienski,IND,670033,0,0,0,0,
Seminole,Lieutenant Governor,Cathy Cummings,DEM,670033,2,0,13,15,
Seminole,Lieutenant Governor,Todd Lamb,REP,670033,0,3,41,44,
Seminole,Superintendent of Public Instruction,John Cox,DEM,670033,2,0,25,27,
Seminole,Superintendent of Public Instruction,Joy Hofmeister,REP,670033,0,2,29,31,
Seminole,Commissioner of Labor,Mike Workman,DEM,670033,2,0,19,21,
Seminole,Commissioner of Labor,Mark Costello,REP,670033,0,3,34,37,
Seminole,U.S. Senate,Matt Silverstein,DEM,670033,2,0,9,11,
Seminole,U.S. Senate,Jim Inhofe,REP,670033,0,2,45,47,
Seminole,U.S. Senate,Aaron Delozier,IND,670033,0,0,0,0,
Seminole,U.S. Senate,Ray Woods,IND,670033,0,1,0,1,
Seminole,U.S. Senate,Joan Farr,IND,670033,0,0,0,0,
Seminole,U.S. Senate,Connie Johnson,DEM,670033,2,0,8,10,
Seminole,U.S. Senate,James Lankford,REP,670033,0,2,46,48,
Seminole,U.S. Senate,Mark Beard,IND,670033,0,1,0,1,
Seminole,U.S. House,Al Mcaffrey,DEM,670033,1,0,17,18,05
Seminole,U.S. House,Steve Russell,REP,670033,0,2,36,38,05
Seminole,U.S. House,Buddy Ray,IND,670033,1,0,1,2,05
Seminole,U.S. House,Tom Boggs,IND,670033,0,1,0,1,05
Seminole,U.S. House,Robert Murphy,IND,670033,0,0,0,0,05
Seminole,State House,Jason Leonard,DEM,670033,2,0,13,15,28
Seminole,State House,Tom Newell,REP,670033,0,3,41,44,28
Seminole,Governor,Joe Dorman,DEM,670034,2,48,301,351,
Seminole,Governor,Mary Fallin,REP,670034,11,39,288,338,
Seminole,Governor,Kimberly Willis,IND,670034,0,3,9,12,
Seminole,Governor,Richard Prawdzienski,IND,670034,0,2,6,8,
Seminole,Lieutenant Governor,Cathy Cummings,DEM,670034,3,39,264,306,
Seminole,Lieutenant Governor,Todd Lamb,REP,670034,9,53,335,397,
Seminole,Superintendent of Public Instruction,John Cox,DEM,670034,7,58,353,418,
Seminole,Superintendent of Public Instruction,Joy Hofmeister,REP,670034,5,34,242,281,
Seminole,Commissioner of Labor,Mike Workman,DEM,670034,5,50,318,373,
Seminole,Commissioner of Labor,Mark Costello,REP,670034,7,37,271,315,
Seminole,U.S. Senate,Matt Silverstein,DEM,670034,2,38,218,258,
Seminole,U.S. Senate,Jim Inhofe,REP,670034,10,49,357,416,
Seminole,U.S. Senate,Aaron Delozier,IND,670034,0,1,6,7,
Seminole,U.S. Senate,Ray Woods,IND,670034,0,0,12,12,
Seminole,U.S. Senate,Joan Farr,IND,670034,0,2,5,7,
Seminole,U.S. Senate,Connie Johnson,DEM,670034,2,32,223,257,
Seminole,U.S. Senate,James Lankford,REP,670034,11,58,367,436,
Seminole,U.S. Senate,Mark Beard,IND,670034,0,2,12,14,
Seminole,U.S. House,Al Mcaffrey,DEM,670034,3,37,237,277,05
Seminole,U.S. House,Steve Russell,REP,670034,9,47,316,372,05
Seminole,U.S. House,Buddy Ray,IND,670034,1,0,7,8,05
Seminole,U.S. House,Tom Boggs,IND,670034,0,4,21,25,05
Seminole,U.S. House,Robert Murphy,IND,670034,0,2,14,16,05
Seminole,State Senate,Marilyn Rainwater,DEM,670034,7,58,333,398,28
Seminole,State Senate,Jason Smalley,REP,670034,6,34,265,305,28
Seminole,State House,Jason Leonard,DEM,670034,5,37,258,300,28
Seminole,State House,Tom Newell,REP,670034,8,54,336,398,28
Seminole,Governor,Joe Dorman,DEM,670035,2,10,76,88,
Seminole,Governor,Mary Fallin,REP,670035,2,9,137,148,
Seminole,Governor,Kimberly Willis,IND,670035,0,0,6,6,
Seminole,Governor,Richard Prawdzienski,IND,670035,0,0,2,2,
Seminole,Lieutenant Governor,Cathy Cummings,DEM,670035,1,7,51,59,
Seminole,Lieutenant Governor,Todd Lamb,REP,670035,3,13,171,187,
Seminole,Superintendent of Public Instruction,John Cox,DEM,670035,1,9,106,116,
Seminole,Superintendent of Public Instruction,Joy Hofmeister,REP,670035,3,10,115,128,
Seminole,Commissioner of Labor,Mike Workman,DEM,670035,1,9,79,89,
Seminole,Commissioner of Labor,Mark Costello,REP,670035,3,8,140,151,
Seminole,U.S. Senate,Matt Silverstein,DEM,670035,1,6,45,52,
Seminole,U.S. Senate,Jim Inhofe,REP,670035,3,12,171,186,
Seminole,U.S. Senate,Aaron Delozier,IND,670035,0,0,3,3,
Seminole,U.S. Senate,Ray Woods,IND,670035,0,0,2,2,
Seminole,U.S. Senate,Joan Farr,IND,670035,0,0,1,1,
Seminole,U.S. Senate,Connie Johnson,DEM,670035,2,8,43,53,
Seminole,U.S. Senate,James Lankford,REP,670035,2,12,171,185,
Seminole,U.S. Senate,Mark Beard,IND,670035,0,0,7,7,
Seminole,U.S. House,Al Mcaffrey,DEM,670035,1,8,48,57,05
Seminole,U.S. House,Steve Russell,REP,670035,3,9,159,171,05
Seminole,U.S. House,Buddy Ray,IND,670035,0,0,4,4,05
Seminole,U.S. House,Tom Boggs,IND,670035,0,0,3,3,05
Seminole,U.S. House,Robert Murphy,IND,670035,0,0,5,5,05
Seminole,State Senate,Marilyn Rainwater,DEM,670035,1,12,68,81,28
Seminole,State Senate,Jason Smalley,REP,670035,3,6,152,161,28
Seminole,State House,Jason Leonard,DEM,670035,1,8,53,62,28
Seminole,State House,Tom Newell,REP,670035,3,9,166,178,28
Sequoyah,Governor,Joe Dorman,DEM,680101,9,11,269,289,
Sequoyah,Governor,Mary Fallin,REP,680101,1,18,347,366,
Sequoyah,Governor,Kimberly Willis,IND,680101,0,2,17,19,
Sequoyah,Governor,Richard Prawdzienski,IND,680101,0,1,3,4,
Sequoyah,Lieutenant Governor,Cathy Cummings,DEM,680101,8,14,243,265,
Sequoyah,Lieutenant Governor,Todd Lamb,REP,680101,2,18,382,402,
Sequoyah,Superintendent of Public Instruction,John Cox,DEM,680101,7,20,353,380,
Sequoyah,Superintendent of Public Instruction,Joy Hofmeister,REP,680101,1,12,285,298,
Sequoyah,Commissioner of Labor,Mike Workman,DEM,680101,6,18,270,294,
Sequoyah,Commissioner of Labor,Mark Costello,REP,680101,2,13,346,361,
Sequoyah,U.S. Senate,Matt Silverstein,DEM,680101,6,8,196,210,
Sequoyah,U.S. Senate,Jim Inhofe,REP,680101,2,20,410,432,
Sequoyah,U.S. Senate,Aaron Delozier,IND,680101,0,1,8,9,
Sequoyah,U.S. Senate,Ray Woods,IND,680101,0,1,8,9,
Sequoyah,U.S. Senate,Joan Farr,IND,680101,0,1,9,10,
Sequoyah,U.S. Senate,Connie Johnson,DEM,680101,6,10,213,229,
Sequoyah,U.S. Senate,James Lankford,REP,680101,2,18,376,396,
Sequoyah,U.S. Senate,Mark Beard,IND,680101,0,2,26,28,
Sequoyah,U.S. House,Earl Everett,DEM,680101,5,7,192,204,02
Sequoyah,U.S. House,Markwayne Mullin,REP,680101,2,23,415,440,02
Sequoyah,U.S. House,Jon Douthitt,IND,680101,1,2,17,20,02
Sequoyah,State Senate,Ann Weaver,DEM,680101,10,20,366,396,4
Sequoyah,State Senate,Mark Allen,REP,680101,0,12,282,294,4
Sequoyah,Governor,Joe Dorman,DEM,680102,3,2,145,150,
Sequoyah,Governor,Mary Fallin,REP,680102,2,8,195,205,
Sequoyah,Governor,Kimberly Willis,IND,680102,0,0,11,11,
Sequoyah,Governor,Richard Prawdzienski,IND,680102,0,0,5,5,
Sequoyah,Lieutenant Governor,Cathy Cummings,DEM,680102,2,2,134,138,
Sequoyah,Lieutenant Governor,Todd Lamb,REP,680102,3,8,218,229,
Sequoyah,Superintendent of Public Instruction,John Cox,DEM,680102,3,3,195,201,
Sequoyah,Superintendent of Public Instruction,Joy Hofmeister,REP,680102,2,7,159,168,
Sequoyah,Commissioner of Labor,Mike Workman,DEM,680102,2,4,157,163,
Sequoyah,Commissioner of Labor,Mark Costello,REP,680102,3,6,192,201,
Sequoyah,U.S. Senate,Matt Silverstein,DEM,680102,1,2,118,121,
Sequoyah,U.S. Senate,Jim Inhofe,REP,680102,4,8,219,231,
Sequoyah,U.S. Senate,Aaron Delozier,IND,680102,0,0,8,8,
Sequoyah,U.S. Senate,Ray Woods,IND,680102,0,0,6,6,
Sequoyah,U.S. Senate,Joan Farr,IND,680102,0,0,2,2,
Sequoyah,U.S. Senate,Connie Johnson,DEM,680102,2,2,117,121,
Sequoyah,U.S. Senate,James Lankford,REP,680102,3,8,216,227,
Sequoyah,U.S. Senate,Mark Beard,IND,680102,0,0,17,17,
Sequoyah,U.S. House,Earl Everett,DEM,680102,2,2,111,115,02
Sequoyah,U.S. House,Markwayne Mullin,REP,680102,3,8,227,238,02
Sequoyah,U.S. House,Jon Douthitt,IND,680102,0,0,11,11,02
Sequoyah,State Senate,Ann Weaver,DEM,680102,3,5,180,188,4
Sequoyah,State Senate,Mark Allen,REP,680102,2,5,176,183,4
Sequoyah,Governor,Joe Dorman,DEM,680103,6,2,213,221,
Sequoyah,Governor,Mary Fallin,REP,680103,2,12,284,298,
Sequoyah,Governor,Kimberly Willis,IND,680103,0,0,7,7,
Sequoyah,Governor,Richard Prawdzienski,IND,680103,0,0,6,6,
Sequoyah,Lieutenant Governor,Cathy Cummings,DEM,680103,7,3,192,202,
Sequoyah,Lieutenant Governor,Todd Lamb,REP,680103,1,11,308,320,
Sequoyah,Superintendent of Public Instruction,John Cox,DEM,680103,7,5,271,283,
Sequoyah,Superintendent of Public Instruction,Joy Hofmeister,REP,680103,1,9,228,238,
Sequoyah,Commissioner of Labor,Mike Workman,DEM,680103,7,4,225,236,
Sequoyah,Commissioner of Labor,Mark Costello,REP,680103,1,10,267,278,
Sequoyah,U.S. Senate,Matt Silverstein,DEM,680103,6,2,170,178,
Sequoyah,U.S. Senate,Jim Inhofe,REP,680103,2,12,311,325,
Sequoyah,U.S. Senate,Aaron Delozier,IND,680103,0,0,8,8,
Sequoyah,U.S. Senate,Ray Woods,IND,680103,0,0,7,7,
Sequoyah,U.S. Senate,Joan Farr,IND,680103,0,0,8,8,
Sequoyah,U.S. Senate,Connie Johnson,DEM,680103,6,4,173,183,
Sequoyah,U.S. Senate,James Lankford,REP,680103,2,10,304,316,
Sequoyah,U.S. Senate,Mark Beard,IND,680103,0,0,27,27,
Sequoyah,U.S. House,Earl Everett,DEM,680103,6,1,155,162,02
Sequoyah,U.S. House,Markwayne Mullin,REP,680103,2,12,321,335,02
Sequoyah,U.S. House,Jon Douthitt,IND,680103,0,0,26,26,02
Sequoyah,State Senate,Ann Weaver,DEM,680103,6,5,298,309,4
Sequoyah,State Senate,Mark Allen,REP,680103,2,9,215,226,4
Sequoyah,Governor,Joe Dorman,DEM,680104,8,7,147,162,
Sequoyah,Governor,Mary Fallin,REP,680104,9,9,308,326,
Sequoyah,Governor,Kimberly Willis,IND,680104,1,1,10,12,
Sequoyah,Governor,Richard Prawdzienski,IND,680104,0,0,3,3,
Sequoyah,Lieutenant Governor,Cathy Cummings,DEM,680104,8,6,111,125,
Sequoyah,Lieutenant Governor,Todd Lamb,REP,680104,9,11,347,367,
Sequoyah,Superintendent of Public Instruction,John Cox,DEM,680104,10,10,204,224,
Sequoyah,Superintendent of Public Instruction,Joy Hofmeister,REP,680104,7,7,251,265,
Sequoyah,Commissioner of Labor,Mike Workman,DEM,680104,10,7,138,155,
Sequoyah,Commissioner of Labor,Mark Costello,REP,680104,7,10,309,326,
Sequoyah,U.S. Senate,Matt Silverstein,DEM,680104,5,5,101,111,
Sequoyah,U.S. Senate,Jim Inhofe,REP,680104,12,12,344,368,
Sequoyah,U.S. Senate,Aaron Delozier,IND,680104,0,0,4,4,
Sequoyah,U.S. Senate,Ray Woods,IND,680104,0,0,7,7,
Sequoyah,U.S. Senate,Joan Farr,IND,680104,1,0,6,7,
Sequoyah,U.S. Senate,Connie Johnson,DEM,680104,9,5,103,117,
Sequoyah,U.S. Senate,James Lankford,REP,680104,7,12,328,347,
Sequoyah,U.S. Senate,Mark Beard,IND,680104,2,0,20,22,
Sequoyah,U.S. House,Earl Everett,DEM,680104,6,6,98,110,02
Sequoyah,U.S. House,Markwayne Mullin,REP,680104,11,11,345,367,02
Sequoyah,U.S. House,Jon Douthitt,IND,680104,1,0,10,11,02
Sequoyah,State Senate,Ann Weaver,DEM,680104,10,8,156,174,4
Sequoyah,State Senate,Mark Allen,REP,680104,9,9,314,332,4
Sequoyah,Governor,Joe Dorman,DEM,680105,2,7,131,140,
Sequoyah,Governor,Mary Fallin,REP,680105,2,9,298,309,
Sequoyah,Governor,Kimberly Willis,IND,680105,0,1,6,7,
Sequoyah,Governor,Richard Prawdzienski,IND,680105,0,0,9,9,
Sequoyah,Lieutenant Governor,Cathy Cummings,DEM,680105,2,4,132,138,
Sequoyah,Lieutenant Governor,Todd Lamb,REP,680105,2,12,308,322,
Sequoyah,Superintendent of Public Instruction,John Cox,DEM,680105,2,8,184,194,
Sequoyah,Superintendent of Public Instruction,Joy Hofmeister,REP,680105,1,9,259,269,
Sequoyah,Commissioner of Labor,Mike Workman,DEM,680105,1,4,143,148,
Sequoyah,Commissioner of Labor,Mark Costello,REP,680105,3,11,293,307,
Sequoyah,U.S. Senate,Matt Silverstein,DEM,680105,2,1,106,109,
Sequoyah,U.S. Senate,Jim Inhofe,REP,680105,2,16,313,331,
Sequoyah,U.S. Senate,Aaron Delozier,IND,680105,0,1,4,5,
Sequoyah,U.S. Senate,Ray Woods,IND,680105,0,0,12,12,
Sequoyah,U.S. Senate,Joan Farr,IND,680105,0,0,4,4,
Sequoyah,U.S. Senate,Connie Johnson,DEM,680105,2,2,111,115,
Sequoyah,U.S. Senate,James Lankford,REP,680105,2,15,301,318,
Sequoyah,U.S. Senate,Mark Beard,IND,680105,0,1,24,25,
Sequoyah,U.S. House,Earl Everett,DEM,680105,2,2,102,106,02
Sequoyah,U.S. House,Markwayne Mullin,REP,680105,2,15,318,335,02
Sequoyah,U.S. House,Jon Douthitt,IND,680105,0,1,20,21,02
Sequoyah,State Senate,Ann Weaver,DEM,680105,2,4,146,152,4
Sequoyah,State Senate,Mark Allen,REP,680105,2,14,303,319,4
Sequoyah,Governor,Joe Dorman,DEM,680106,1,9,99,109,
Sequoyah,Governor,Mary Fallin,REP,680106,5,8,215,228,
Sequoyah,Governor,Kimberly Willis,IND,680106,0,0,7,7,
Sequoyah,Governor,Richard Prawdzienski,IND,680106,0,1,5,6,
Sequoyah,Lieutenant Governor,Cathy Cummings,DEM,680106,1,5,94,100,
Sequoyah,Lieutenant Governor,Todd Lamb,REP,680106,5,13,227,245,
Sequoyah,Superintendent of Public Instruction,John Cox,DEM,680106,3,9,143,155,
Sequoyah,Superintendent of Public Instruction,Joy Hofmeister,REP,680106,3,10,178,191,
Sequoyah,Commissioner of Labor,Mike Workman,DEM,680106,1,7,131,139,
Sequoyah,Commissioner of Labor,Mark Costello,REP,680106,5,11,189,205,
Sequoyah,U.S. Senate,Matt Silverstein,DEM,680106,1,3,90,94,
Sequoyah,U.S. Senate,Jim Inhofe,REP,680106,5,14,216,235,
Sequoyah,U.S. Senate,Aaron Delozier,IND,680106,0,1,4,5,
Sequoyah,U.S. Senate,Ray Woods,IND,680106,0,0,9,9,
Sequoyah,U.S. Senate,Joan Farr,IND,680106,0,0,7,7,
Sequoyah,U.S. Senate,Connie Johnson,DEM,680106,1,4,98,103,
Sequoyah,U.S. Senate,James Lankford,REP,680106,5,13,204,222,
Sequoyah,U.S. Senate,Mark Beard,IND,680106,0,1,19,20,
Sequoyah,U.S. House,Earl Everett,DEM,680106,1,3,91,95,02
Sequoyah,U.S. House,Markwayne Mullin,REP,680106,5,15,212,232,02
Sequoyah,U.S. House,Jon Douthitt,IND,680106,0,0,17,17,02
Sequoyah,State Senate,Ann Weaver,DEM,680106,1,10,108,119,4
Sequoyah,State Senate,Mark Allen,REP,680106,5,9,218,232,4
Sequoyah,Governor,Joe Dorman,DEM,680201,0,0,51,51,
Sequoyah,Governor,Mary Fallin,REP,680201,0,7,77,84,
Sequoyah,Governor,Kimberly Willis,IND,680201,0,0,5,5,
Sequoyah,Governor,Richard Prawdzienski,IND,680201,0,0,3,3,
Sequoyah,Lieutenant Governor,Cathy Cummings,DEM,680201,0,0,47,47,
Sequoyah,Lieutenant Governor,Todd Lamb,REP,680201,0,7,89,96,
Sequoyah,Superintendent of Public Instruction,John Cox,DEM,680201,0,0,56,56,
Sequoyah,Superintendent of Public Instruction,Joy Hofmeister,REP,680201,0,7,79,86,
Sequoyah,Commissioner of Labor,Mike Workman,DEM,680201,0,0,56,56,
Sequoyah,Commissioner of Labor,Mark Costello,REP,680201,0,7,75,82,
Sequoyah,U.S. Senate,Matt Silverstein,DEM,680201,0,0,34,34,
Sequoyah,U.S. Senate,Jim Inhofe,REP,680201,0,7,98,105,
Sequoyah,U.S. Senate,Aaron Delozier,IND,680201,0,0,1,1,
Sequoyah,U.S. Senate,Ray Woods,IND,680201,0,0,1,1,
Sequoyah,U.S. Senate,Joan Farr,IND,680201,0,0,2,2,
Sequoyah,U.S. Senate,Connie Johnson,DEM,680201,0,0,35,35,
Sequoyah,U.S. Senate,James Lankford,REP,680201,0,7,89,96,
Sequoyah,U.S. Senate,Mark Beard,IND,680201,0,0,12,12,
Sequoyah,U.S. House,Earl Everett,DEM,680201,0,0,33,33,02
Sequoyah,U.S. House,Markwayne Mullin,REP,680201,0,7,96,103,02
Sequoyah,U.S. House,Jon Douthitt,IND,680201,0,0,6,6,02
Sequoyah,State Senate,Ann Weaver,DEM,680201,0,1,44,45,4
Sequoyah,State Senate,Mark Allen,REP,680201,0,6,91,97,4
Sequoyah,Governor,Joe Dorman,DEM,680202,2,1,109,112,
Sequoyah,Governor,Mary Fallin,REP,680202,0,4,125,129,
Sequoyah,Governor,Kimberly Willis,IND,680202,1,0,8,9,
Sequoyah,Governor,Richard Prawdzienski,IND,680202,0,0,4,4,
Sequoyah,Lieutenant Governor,Cathy Cummings,DEM,680202,3,1,104,108,
Sequoyah,Lieutenant Governor,Todd Lamb,REP,680202,0,4,141,145,
Sequoyah,Superintendent of Public Instruction,John Cox,DEM,680202,2,1,132,135,
Sequoyah,Superintendent of Public Instruction,Joy Hofmeister,REP,680202,1,4,112,117,
Sequoyah,Commissioner of Labor,Mike Workman,DEM,680202,2,1,125,128,
Sequoyah,Commissioner of Labor,Mark Costello,REP,680202,0,4,117,121,
Sequoyah,U.S. Senate,Matt Silverstein,DEM,680202,2,1,84,87,
Sequoyah,U.S. Senate,Jim Inhofe,REP,680202,0,2,149,151,
Sequoyah,U.S. Senate,Aaron Delozier,IND,680202,0,2,2,4,
Sequoyah,U.S. Senate,Ray Woods,IND,680202,0,0,3,3,
Sequoyah,U.S. Senate,Joan Farr,IND,680202,1,0,6,7,
Sequoyah,U.S. Senate,Connie Johnson,DEM,680202,3,1,98,102,
Sequoyah,U.S. Senate,James Lankford,REP,680202,0,4,136,140,
Sequoyah,U.S. Senate,Mark Beard,IND,680202,0,0,11,11,
Sequoyah,U.S. House,Earl Everett,DEM,680202,2,1,75,78,02
Sequoyah,U.S. House,Markwayne Mullin,REP,680202,0,4,156,160,02
Sequoyah,U.S. House,Jon Douthitt,IND,680202,1,0,13,14,02
Sequoyah,State Senate,Ann Weaver,DEM,680202,3,3,114,120,4
Sequoyah,State Senate,Mark Allen,REP,680202,0,2,130,132,4
Sequoyah,Governor,Joe Dorman,DEM,680203,0,1,57,58,
Sequoyah,Governor,Mary Fallin,REP,680203,0,4,70,74,
Sequoyah,Governor,Kimberly Willis,IND,680203,0,0,2,2,
Sequoyah,Governor,Richard Prawdzienski,IND,680203,0,0,0,0,
Sequoyah,Lieutenant Governor,Cathy Cummings,DEM,680203,0,0,50,50,
Sequoyah,Lieutenant Governor,Todd Lamb,REP,680203,0,5,76,81,
Sequoyah,Superintendent of Public Instruction,John Cox,DEM,680203,0,1,72,73,
Sequoyah,Superintendent of Public Instruction,Joy Hofmeister,REP,680203,0,3,53,56,
Sequoyah,Commissioner of Labor,Mike Workman,DEM,680203,0,1,70,71,
Sequoyah,Commissioner of Labor,Mark Costello,REP,680203,0,3,50,53,
Sequoyah,U.S. Senate,Matt Silverstein,DEM,680203,0,0,37,37,
Sequoyah,U.S. Senate,Jim Inhofe,REP,680203,0,5,84,89,
Sequoyah,U.S. Senate,Aaron Delozier,IND,680203,0,0,1,1,
Sequoyah,U.S. Senate,Ray Woods,IND,680203,0,0,1,1,
Sequoyah,U.S. Senate,Joan Farr,IND,680203,0,0,3,3,
Sequoyah,U.S. Senate,Connie Johnson,DEM,680203,0,0,51,51,
Sequoyah,U.S. Senate,James Lankford,REP,680203,0,5,71,76,
Sequoyah,U.S. Senate,Mark Beard,IND,680203,0,0,1,1,
Sequoyah,U.S. House,Earl Everett,DEM,680203,0,0,31,31,02
Sequoyah,U.S. House,Markwayne Mullin,REP,680203,0,5,91,96,02
Sequoyah,U.S. House,Jon Douthitt,IND,680203,0,0,4,4,02
Sequoyah,State Senate,Ann Weaver,DEM,680203,0,1,60,61,4
Sequoyah,State Senate,Mark Allen,REP,680203,0,4,68,72,4
Sequoyah,Governor,Joe Dorman,DEM,680204,1,6,66,73,
Sequoyah,Governor,Mary Fallin,REP,680204,2,4,77,83,
Sequoyah,Governor,Kimberly Willis,IND,680204,0,2,6,8,
Sequoyah,Governor,Richard Prawdzienski,IND,680204,0,0,2,2,
Sequoyah,Lieutenant Governor,Cathy Cummings,DEM,680204,3,9,55,67,
Sequoyah,Lieutenant Governor,Todd Lamb,REP,680204,0,3,96,99,
Sequoyah,Superintendent of Public Instruction,John Cox,DEM,680204,3,9,75,87,
Sequoyah,Superintendent of Public Instruction,Joy Hofmeister,REP,680204,0,3,72,75,
Sequoyah,Commissioner of Labor,Mike Workman,DEM,680204,2,8,65,75,
Sequoyah,Commissioner of Labor,Mark Costello,REP,680204,1,2,82,85,
Sequoyah,U.S. Senate,Matt Silverstein,DEM,680204,1,4,40,45,
Sequoyah,U.S. Senate,Jim Inhofe,REP,680204,2,5,98,105,
Sequoyah,U.S. Senate,Aaron Delozier,IND,680204,0,0,3,3,
Sequoyah,U.S. Senate,Ray Woods,IND,680204,0,1,6,7,
Sequoyah,U.S. Senate,Joan Farr,IND,680204,0,2,3,5,
Sequoyah,U.S. Senate,Connie Johnson,DEM,680204,3,8,47,58,
Sequoyah,U.S. Senate,James Lankford,REP,680204,0,4,94,98,
Sequoyah,U.S. Senate,Mark Beard,IND,680204,0,0,7,7,
Sequoyah,U.S. House,Earl Everett,DEM,680204,2,7,35,44,02
Sequoyah,U.S. House,Markwayne Mullin,REP,680204,1,4,109,114,02
Sequoyah,U.S. House,Jon Douthitt,IND,680204,0,1,6,7,02
Sequoyah,State Senate,Ann Weaver,DEM,680204,3,9,67,79,4
Sequoyah,State Senate,Mark Allen,REP,680204,0,3,85,88,4
Sequoyah,Governor,Joe Dorman,DEM,680205,4,29,213,246,
Sequoyah,Governor,Mary Fallin,REP,680205,10,31,221,262,
Sequoyah,Governor,Kimberly Willis,IND,680205,1,1,10,12,
Sequoyah,Governor,Richard Prawdzienski,IND,680205,0,0,4,4,
Sequoyah,Lieutenant Governor,Cathy Cummings,DEM,680205,10,26,198,234,
Sequoyah,Lieutenant Governor,Todd Lamb,REP,680205,5,35,250,290,
Sequoyah,Superintendent of Public Instruction,John Cox,DEM,680205,7,35,231,273,
Sequoyah,Superintendent of Public Instruction,Joy Hofmeister,REP,680205,8,26,214,248,
Sequoyah,Commissioner of Labor,Mike Workman,DEM,680205,9,26,215,250,
Sequoyah,Commissioner of Labor,Mark Costello,REP,680205,6,35,225,266,
Sequoyah,U.S. Senate,Matt Silverstein,DEM,680205,3,26,163,192,
Sequoyah,U.S. Senate,Jim Inhofe,REP,680205,10,34,260,304,
Sequoyah,U.S. Senate,Aaron Delozier,IND,680205,1,0,6,7,
Sequoyah,U.S. Senate,Ray Woods,IND,680205,0,1,9,10,
Sequoyah,U.S. Senate,Joan Farr,IND,680205,1,0,6,7,
Sequoyah,U.S. Senate,Connie Johnson,DEM,680205,6,19,167,192,
Sequoyah,U.S. Senate,James Lankford,REP,680205,7,41,255,303,
Sequoyah,U.S. Senate,Mark Beard,IND,680205,1,1,21,23,
Sequoyah,U.S. House,Earl Everett,DEM,680205,2,17,146,165,02
Sequoyah,U.S. House,Markwayne Mullin,REP,680205,11,42,275,328,02
Sequoyah,U.S. House,Jon Douthitt,IND,680205,1,2,22,25,02
Sequoyah,State Senate,Ann Weaver,DEM,680205,9,32,209,250,4
Sequoyah,State Senate,Mark Allen,REP,680205,6,29,241,276,4
Sequoyah,Governor,Joe Dorman,DEM,680206,2,23,83,108,
Sequoyah,Governor,Mary Fallin,REP,680206,1,23,85,109,
Sequoyah,Governor,Kimberly Willis,IND,680206,0,0,6,6,
Sequoyah,Governor,Richard Prawdzienski,IND,680206,0,1,1,2,
Sequoyah,Lieutenant Governor,Cathy Cummings,DEM,680206,2,23,74,99,
Sequoyah,Lieutenant Governor,Todd Lamb,REP,680206,1,25,101,127,
Sequoyah,Superintendent of Public Instruction,John Cox,DEM,680206,3,26,113,142,
Sequoyah,Superintendent of Public Instruction,Joy Hofmeister,REP,680206,0,22,64,86,
Sequoyah,Commissioner of Labor,Mike Workman,DEM,680206,3,24,98,125,
Sequoyah,Commissioner of Labor,Mark Costello,REP,680206,0,24,76,100,
Sequoyah,U.S. Senate,Matt Silverstein,DEM,680206,2,19,65,86,
Sequoyah,U.S. Senate,Jim Inhofe,REP,680206,1,27,100,128,
Sequoyah,U.S. Senate,Aaron Delozier,IND,680206,0,1,0,1,
Sequoyah,U.S. Senate,Ray Woods,IND,680206,0,1,5,6,
Sequoyah,U.S. Senate,Joan Farr,IND,680206,0,0,4,4,
Sequoyah,U.S. Senate,Connie Johnson,DEM,680206,2,21,63,86,
Sequoyah,U.S. Senate,James Lankford,REP,680206,1,26,97,124,
Sequoyah,U.S. Senate,Mark Beard,IND,680206,0,1,13,14,
Sequoyah,U.S. House,Earl Everett,DEM,680206,3,19,54,76,02
Sequoyah,U.S. House,Markwayne Mullin,REP,680206,0,28,113,141,02
Sequoyah,U.S. House,Jon Douthitt,IND,680206,0,0,9,9,02
Sequoyah,State Senate,Ann Weaver,DEM,680206,3,26,85,114,4
Sequoyah,State Senate,Mark Allen,REP,680206,0,22,92,114,4
Sequoyah,Governor,Joe Dorman,DEM,680207,2,8,96,106,
Sequoyah,Governor,Mary Fallin,REP,680207,0,8,100,108,
Sequoyah,Governor,Kimberly Willis,IND,680207,0,0,2,2,
Sequoyah,Governor,Richard Prawdzienski,IND,680207,0,1,5,6,
Sequoyah,Lieutenant Governor,Cathy Cummings,DEM,680207,2,8,78,88,
Sequoyah,Lieutenant Governor,Todd Lamb,REP,680207,0,9,120,129,
Sequoyah,Superintendent of Public Instruction,John Cox,DEM,680207,2,11,113,126,
Sequoyah,Superintendent of Public Instruction,Joy Hofmeister,REP,680207,0,6,85,91,
Sequoyah,Commissioner of Labor,Mike Workman,DEM,680207,2,11,92,105,
Sequoyah,Commissioner of Labor,Mark Costello,REP,680207,0,6,103,109,
Sequoyah,U.S. Senate,Matt Silverstein,DEM,680207,2,9,70,81,
Sequoyah,U.S. Senate,Jim Inhofe,REP,680207,0,8,118,126,
Sequoyah,U.S. Senate,Aaron Delozier,IND,680207,0,0,3,3,
Sequoyah,U.S. Senate,Ray Woods,IND,680207,0,0,5,5,
Sequoyah,U.S. Senate,Joan Farr,IND,680207,0,0,3,3,
Sequoyah,U.S. Senate,Connie Johnson,DEM,680207,2,5,77,84,
Sequoyah,U.S. Senate,James Lankford,REP,680207,0,10,111,121,
Sequoyah,U.S. Senate,Mark Beard,IND,680207,0,2,12,14,
Sequoyah,U.S. House,Earl Everett,DEM,680207,2,5,59,66,02
Sequoyah,U.S. House,Markwayne Mullin,REP,680207,0,10,128,138,02
Sequoyah,U.S. House,Jon Douthitt,IND,680207,0,1,11,12,02
Sequoyah,State Senate,Ann Weaver,DEM,680207,2,9,95,106,4
Sequoyah,State Senate,Mark Allen,REP,680207,0,8,106,114,4
Sequoyah,Governor,Joe Dorman,DEM,680208,0,11,169,180,
Sequoyah,Governor,Mary Fallin,REP,680208,3,9,152,164,
Sequoyah,Governor,Kimberly Willis,IND,680208,1,0,6,7,
Sequoyah,Governor,Richard Prawdzienski,IND,680208,0,0,6,6,
Sequoyah,Lieutenant Governor,Cathy Cummings,DEM,680208,1,5,152,158,
Sequoyah,Lieutenant Governor,Todd Lamb,REP,680208,3,15,182,200,
Sequoyah,Superintendent of Public Instruction,John Cox,DEM,680208,2,13,198,213,
Sequoyah,Superintendent of Public Instruction,Joy Hofmeister,REP,680208,2,7,135,144,
Sequoyah,Commissioner of Labor,Mike Workman,DEM,680208,2,6,166,174,
Sequoyah,Commissioner of Labor,Mark Costello,REP,680208,2,14,161,177,
Sequoyah,U.S. Senate,Matt Silverstein,DEM,680208,0,6,135,141,
Sequoyah,U.S. Senate,Jim Inhofe,REP,680208,3,14,176,193,
Sequoyah,U.S. Senate,Aaron Delozier,IND,680208,0,0,4,4,
Sequoyah,U.S. Senate,Ray Woods,IND,680208,0,0,8,8,
Sequoyah,U.S. Senate,Joan Farr,IND,680208,1,0,8,9,
Sequoyah,U.S. Senate,Connie Johnson,DEM,680208,2,4,134,140,
Sequoyah,U.S. Senate,James Lankford,REP,680208,2,16,173,191,
Sequoyah,U.S. Senate,Mark Beard,IND,680208,0,0,24,24,
Sequoyah,U.S. House,Earl Everett,DEM,680208,0,4,123,127,02
Sequoyah,U.S. House,Markwayne Mullin,REP,680208,3,16,188,207,02
Sequoyah,U.S. House,Jon Douthitt,IND,680208,1,0,20,21,02
Sequoyah,State Senate,Ann Weaver,DEM,680208,3,6,164,173,4
Sequoyah,State Senate,Mark Allen,REP,680208,1,14,169,184,4
Sequoyah,Governor,Joe Dorman,DEM,680209,3,1,109,113,
Sequoyah,Governor,Mary Fallin,REP,680209,4,2,165,171,
Sequoyah,Governor,Kimberly Willis,IND,680209,0,0,1,1,
Sequoyah,Governor,Richard Prawdzienski,IND,680209,0,0,2,2,
Sequoyah,Lieutenant Governor,Cathy Cummings,DEM,680209,4,1,99,104,
Sequoyah,Lieutenant Governor,Todd Lamb,REP,680209,3,2,175,180,
Sequoyah,Superintendent of Public Instruction,John Cox,DEM,680209,4,1,157,162,
Sequoyah,Superintendent of Public Instruction,Joy Hofmeister,REP,680209,3,2,118,123,
Sequoyah,Commissioner of Labor,Mike Workman,DEM,680209,4,1,128,133,
Sequoyah,Commissioner of Labor,Mark Costello,REP,680209,3,2,145,150,
Sequoyah,U.S. Senate,Matt Silverstein,DEM,680209,3,1,78,82,
Sequoyah,U.S. Senate,Jim Inhofe,REP,680209,4,2,193,199,
Sequoyah,U.S. Senate,Aaron Delozier,IND,680209,0,0,0,0,
Sequoyah,U.S. Senate,Ray Woods,IND,680209,0,0,5,5,
Sequoyah,U.S. Senate,Joan Farr,IND,680209,0,0,0,0,
Sequoyah,U.S. Senate,Connie Johnson,DEM,680209,3,1,82,86,
Sequoyah,U.S. Senate,James Lankford,REP,680209,4,2,177,183,
Sequoyah,U.S. Senate,Mark Beard,IND,680209,0,0,15,15,
Sequoyah,U.S. House,Earl Everett,DEM,680209,2,1,69,72,02
Sequoyah,U.S. House,Markwayne Mullin,REP,680209,5,2,189,196,02
Sequoyah,U.S. House,Jon Douthitt,IND,680209,0,0,17,17,02
Sequoyah,State Senate,Ann Weaver,DEM,680209,3,1,118,122,4
Sequoyah,State Senate,Mark Allen,REP,680209,4,2,158,164,4
Sequoyah,Governor,Joe Dorman,DEM,680210,0,3,107,110,
Sequoyah,Governor,Mary Fallin,REP,680210,6,9,151,166,
Sequoyah,Governor,Kimberly Willis,IND,680210,0,0,7,7,
Sequoyah,Governor,Richard Prawdzienski,IND,680210,0,0,4,4,
Sequoyah,Lieutenant Governor,Cathy Cummings,DEM,680210,0,3,90,93,
Sequoyah,Lieutenant Governor,Todd Lamb,REP,680210,6,9,178,193,
Sequoyah,Superintendent of Public Instruction,John Cox,DEM,680210,3,3,127,133,
Sequoyah,Superintendent of Public Instruction,Joy Hofmeister,REP,680210,3,9,140,152,
Sequoyah,Commissioner of Labor,Mike Workman,DEM,680210,3,3,111,117,
Sequoyah,Commissioner of Labor,Mark Costello,REP,680210,3,9,150,162,
Sequoyah,U.S. Senate,Matt Silverstein,DEM,680210,0,3,79,82,
Sequoyah,U.S. Senate,Jim Inhofe,REP,680210,6,9,180,195,
Sequoyah,U.S. Senate,Aaron Delozier,IND,680210,0,0,1,1,
Sequoyah,U.S. Senate,Ray Woods,IND,680210,0,0,4,4,
Sequoyah,U.S. Senate,Joan Farr,IND,680210,0,0,3,3,
Sequoyah,U.S. Senate,Connie Johnson,DEM,680210,0,3,81,84,
Sequoyah,U.S. Senate,James Lankford,REP,680210,6,9,173,188,
Sequoyah,U.S. Senate,Mark Beard,IND,680210,0,0,13,13,
Sequoyah,U.S. House,Earl Everett,DEM,680210,0,3,67,70,02
Sequoyah,U.S. House,Markwayne Mullin,REP,680210,6,7,186,199,02
Sequoyah,U.S. House,Jon Douthitt,IND,680210,0,0,14,14,02
Sequoyah,State Senate,Ann Weaver,DEM,680210,1,3,101,105,4
Sequoyah,State Senate,Mark Allen,REP,680210,4,9,164,177,4
Sequoyah,Governor,Joe Dorman,DEM,680301,14,36,249,299,
Sequoyah,Governor,Mary Fallin,REP,680301,15,21,241,277,
Sequoyah,Governor,Kimberly Willis,IND,680301,0,1,16,17,
Sequoyah,Governor,Richard Prawdzienski,IND,680301,0,1,9,10,
Sequoyah,Lieutenant Governor,Cathy Cummings,DEM,680301,11,22,199,232,
Sequoyah,Lieutenant Governor,Todd Lamb,REP,680301,18,38,311,367,
Sequoyah,Superintendent of Public Instruction,John Cox,DEM,680301,16,41,272,329,
Sequoyah,Superintendent of Public Instruction,Joy Hofmeister,REP,680301,13,18,239,270,
Sequoyah,Commissioner of Labor,Mike Workman,DEM,680301,13,29,240,282,
Sequoyah,Commissioner of Labor,Mark Costello,REP,680301,15,27,259,301,
Sequoyah,U.S. Senate,Matt Silverstein,DEM,680301,11,18,154,183,
Sequoyah,U.S. Senate,Jim Inhofe,REP,680301,15,41,339,395,
Sequoyah,U.S. Senate,Aaron Delozier,IND,680301,1,0,2,3,
Sequoyah,U.S. Senate,Ray Woods,IND,680301,1,1,7,9,
Sequoyah,U.S. Senate,Joan Farr,IND,680301,1,0,7,8,
Sequoyah,U.S. Senate,Connie Johnson,DEM,680301,12,17,161,190,
Sequoyah,U.S. Senate,James Lankford,REP,680301,15,41,329,385,
Sequoyah,U.S. Senate,Mark Beard,IND,680301,2,2,18,22,
Sequoyah,U.S. House,Earl Everett,DEM,680301,11,18,144,173,02
Sequoyah,U.S. House,Markwayne Mullin,REP,680301,16,41,351,408,02
Sequoyah,U.S. House,Jon Douthitt,IND,680301,1,1,15,17,02
Sequoyah,State Senate,Ann Weaver,DEM,680301,17,36,273,326,4
Sequoyah,State Senate,Mark Allen,REP,680301,14,24,247,285,4
Sequoyah,Governor,Joe Dorman,DEM,680302,5,15,92,112,
Sequoyah,Governor,Mary Fallin,REP,680302,2,14,105,121,
Sequoyah,Governor,Kimberly Willis,IND,680302,0,0,4,4,
Sequoyah,Governor,Richard Prawdzienski,IND,680302,0,0,3,3,
Sequoyah,Lieutenant Governor,Cathy Cummings,DEM,680302,5,18,85,108,
Sequoyah,Lieutenant Governor,Todd Lamb,REP,680302,2,11,114,127,
Sequoyah,Superintendent of Public Instruction,John Cox,DEM,680302,5,21,115,141,
Sequoyah,Superintendent of Public Instruction,Joy Hofmeister,REP,680302,2,8,85,95,
Sequoyah,Commissioner of Labor,Mike Workman,DEM,680302,4,17,98,119,
Sequoyah,Commissioner of Labor,Mark Costello,REP,680302,3,12,101,116,
Sequoyah,U.S. Senate,Matt Silverstein,DEM,680302,4,16,67,87,
Sequoyah,U.S. Senate,Jim Inhofe,REP,680302,3,13,120,136,
Sequoyah,U.S. Senate,Aaron Delozier,IND,680302,0,0,1,1,
Sequoyah,U.S. Senate,Ray Woods,IND,680302,0,0,2,2,
Sequoyah,U.S. Senate,Joan Farr,IND,680302,0,0,7,7,
Sequoyah,U.S. Senate,Connie Johnson,DEM,680302,4,13,71,88,
Sequoyah,U.S. Senate,James Lankford,REP,680302,3,16,117,136,
Sequoyah,U.S. Senate,Mark Beard,IND,680302,0,0,10,10,
Sequoyah,U.S. House,Earl Everett,DEM,680302,4,15,57,76,02
Sequoyah,U.S. House,Markwayne Mullin,REP,680302,3,14,130,147,02
Sequoyah,U.S. House,Jon Douthitt,IND,680302,0,0,11,11,02
Sequoyah,State Senate,Ann Weaver,DEM,680302,4,16,88,108,4
Sequoyah,State Senate,Mark Allen,REP,680302,3,12,114,129,4
Sequoyah,Governor,Joe Dorman,DEM,680303,6,24,243,273,
Sequoyah,Governor,Mary Fallin,REP,680303,3,28,257,288,
Sequoyah,Governor,Kimberly Willis,IND,680303,0,0,12,12,
Sequoyah,Governor,Richard Prawdzienski,IND,680303,0,1,10,11,
Sequoyah,Lieutenant Governor,Cathy Cummings,DEM,680303,6,18,188,212,
Sequoyah,Lieutenant Governor,Todd Lamb,REP,680303,5,33,320,358,
Sequoyah,Superintendent of Public Instruction,John Cox,DEM,680303,6,31,286,323,
Sequoyah,Superintendent of Public Instruction,Joy Hofmeister,REP,680303,2,22,229,253,
Sequoyah,Commissioner of Labor,Mike Workman,DEM,680303,5,26,244,275,
Sequoyah,Commissioner of Labor,Mark Costello,REP,680303,4,25,255,284,
Sequoyah,U.S. Senate,Matt Silverstein,DEM,680303,4,17,171,192,
Sequoyah,U.S. Senate,Jim Inhofe,REP,680303,5,35,322,362,
Sequoyah,U.S. Senate,Aaron Delozier,IND,680303,0,0,3,3,
Sequoyah,U.S. Senate,Ray Woods,IND,680303,0,1,13,14,
Sequoyah,U.S. Senate,Joan Farr,IND,680303,0,0,7,7,
Sequoyah,U.S. Senate,Connie Johnson,DEM,680303,2,11,162,175,
Sequoyah,U.S. Senate,James Lankford,REP,680303,6,41,325,372,
Sequoyah,U.S. Senate,Mark Beard,IND,680303,0,1,22,23,
Sequoyah,U.S. House,Earl Everett,DEM,680303,4,13,137,154,02
Sequoyah,U.S. House,Markwayne Mullin,REP,680303,4,39,359,402,02
Sequoyah,U.S. House,Jon Douthitt,IND,680303,0,1,20,21,02
Sequoyah,State Senate,Ann Weaver,DEM,680303,7,28,274,309,4
Sequoyah,State Senate,Mark Allen,REP,680303,3,25,247,275,4
Sequoyah,Governor,Joe Dorman,DEM,680304,2,11,81,94,
Sequoyah,Governor,Mary Fallin,REP,680304,2,11,148,161,
Sequoyah,Governor,Kimberly Willis,IND,680304,0,0,4,4,
Sequoyah,Governor,Richard Prawdzienski,IND,680304,0,0,0,0,
Sequoyah,Lieutenant Governor,Cathy Cummings,DEM,680304,1,7,66,74,
Sequoyah,Lieutenant Governor,Todd Lamb,REP,680304,3,15,161,179,
Sequoyah,Superintendent of Public Instruction,John Cox,DEM,680304,2,12,102,116,
Sequoyah,Superintendent of Public Instruction,Joy Hofmeister,REP,680304,2,10,129,141,
Sequoyah,Commissioner of Labor,Mike Workman,DEM,680304,1,8,86,95,
Sequoyah,Commissioner of Labor,Mark Costello,REP,680304,3,13,140,156,
Sequoyah,U.S. Senate,Matt Silverstein,DEM,680304,1,9,55,65,
Sequoyah,U.S. Senate,Jim Inhofe,REP,680304,3,13,162,178,
Sequoyah,U.S. Senate,Aaron Delozier,IND,680304,0,0,3,3,
Sequoyah,U.S. Senate,Ray Woods,IND,680304,0,0,6,6,
Sequoyah,U.S. Senate,Joan Farr,IND,680304,0,0,6,6,
Sequoyah,U.S. Senate,Connie Johnson,DEM,680304,1,5,55,61,
Sequoyah,U.S. Senate,James Lankford,REP,680304,3,17,159,179,
Sequoyah,U.S. Senate,Mark Beard,IND,680304,0,0,15,15,
Sequoyah,U.S. House,Earl Everett,DEM,680304,1,6,46,53,02
Sequoyah,U.S. House,Markwayne Mullin,REP,680304,3,15,165,183,02
Sequoyah,U.S. House,Jon Douthitt,IND,680304,0,1,18,19,02
Sequoyah,State Senate,Ann Weaver,DEM,680304,2,9,82,93,4
Sequoyah,State Senate,Mark Allen,REP,680304,2,13,151,166,4
Sequoyah,Governor,Joe Dorman,DEM,680305,6,10,94,110,
Sequoyah,Governor,Mary Fallin,REP,680305,4,8,111,123,
Sequoyah,Governor,Kimberly Willis,IND,680305,0,1,6,7,
Sequoyah,Governor,Richard Prawdzienski,IND,680305,0,0,7,7,
Sequoyah,Lieutenant Governor,Cathy Cummings,DEM,680305,7,8,71,86,
Sequoyah,Lieutenant Governor,Todd Lamb,REP,680305,3,10,141,154,
Sequoyah,Superintendent of Public Instruction,John Cox,DEM,680305,8,10,112,130,
Sequoyah,Superintendent of Public Instruction,Joy Hofmeister,REP,680305,2,8,104,114,
Sequoyah,Commissioner of Labor,Mike Workman,DEM,680305,7,10,83,100,
Sequoyah,Commissioner of Labor,Mark Costello,REP,680305,3,8,126,137,
Sequoyah,U.S. Senate,Matt Silverstein,DEM,680305,9,5,65,79,
Sequoyah,U.S. Senate,Jim Inhofe,REP,680305,1,11,138,150,
Sequoyah,U.S. Senate,Aaron Delozier,IND,680305,0,1,2,3,
Sequoyah,U.S. Senate,Ray Woods,IND,680305,0,1,7,8,
Sequoyah,U.S. Senate,Joan Farr,IND,680305,0,0,3,3,
Sequoyah,U.S. Senate,Connie Johnson,DEM,680305,7,4,63,74,
Sequoyah,U.S. Senate,James Lankford,REP,680305,1,13,145,159,
Sequoyah,U.S. Senate,Mark Beard,IND,680305,2,1,7,10,
Sequoyah,U.S. House,Earl Everett,DEM,680305,7,5,53,65,02
Sequoyah,U.S. House,Markwayne Mullin,REP,680305,3,13,153,169,02
Sequoyah,U.S. House,Jon Douthitt,IND,680305,0,0,9,9,02
Sequoyah,State Senate,Ann Weaver,DEM,680305,9,13,92,114,4
Sequoyah,State Senate,Mark Allen,REP,680305,1,6,127,134,4
Sequoyah,Governor,Joe Dorman,DEM,680306,5,8,167,180,
Sequoyah,Governor,Mary Fallin,REP,680306,3,20,184,207,
Sequoyah,Governor,Kimberly Willis,IND,680306,0,0,11,11,
Sequoyah,Governor,Richard Prawdzienski,IND,680306,1,1,4,6,
Sequoyah,Lieutenant Governor,Cathy Cummings,DEM,680306,6,9,138,153,
Sequoyah,Lieutenant Governor,Todd Lamb,REP,680306,3,20,225,248,
Sequoyah,Superintendent of Public Instruction,John Cox,DEM,680306,6,10,216,232,
Sequoyah,Superintendent of Public Instruction,Joy Hofmeister,REP,680306,3,19,150,172,
Sequoyah,Commissioner of Labor,Mike Workman,DEM,680306,7,4,174,185,
Sequoyah,Commissioner of Labor,Mark Costello,REP,680306,2,24,186,212,
Sequoyah,U.S. Senate,Matt Silverstein,DEM,680306,5,5,120,130,
Sequoyah,U.S. Senate,Jim Inhofe,REP,680306,3,24,225,252,
Sequoyah,U.S. Senate,Aaron Delozier,IND,680306,0,0,5,5,
Sequoyah,U.S. Senate,Ray Woods,IND,680306,1,0,12,13,
Sequoyah,U.S. Senate,Joan Farr,IND,680306,0,0,5,5,
Sequoyah,U.S. Senate,Connie Johnson,DEM,680306,4,6,121,131,
Sequoyah,U.S. Senate,James Lankford,REP,680306,4,22,225,251,
Sequoyah,U.S. Senate,Mark Beard,IND,680306,1,0,17,18,
Sequoyah,U.S. House,Earl Everett,DEM,680306,3,4,121,128,02
Sequoyah,U.S. House,Markwayne Mullin,REP,680306,4,24,226,254,02
Sequoyah,U.S. House,Jon Douthitt,IND,680306,2,1,19,22,02
Sequoyah,State Senate,Ann Weaver,DEM,680306,7,9,185,201,4
Sequoyah,State Senate,Mark Allen,REP,680306,2,20,181,203,4
Sequoyah,Governor,Joe Dorman,DEM,680307,0,11,88,99,
Sequoyah,Governor,Mary Fallin,REP,680307,2,13,94,109,
Sequoyah,Governor,Kimberly Willis,IND,680307,0,0,7,7,
Sequoyah,Governor,Richard Prawdzienski,IND,680307,0,0,6,6,
Sequoyah,Lieutenant Governor,Cathy Cummings,DEM,680307,0,9,66,75,
Sequoyah,Lieutenant Governor,Todd Lamb,REP,680307,2,14,130,146,
Sequoyah,Superintendent of Public Instruction,John Cox,DEM,680307,2,16,110,128,
Sequoyah,Superintendent of Public Instruction,Joy Hofmeister,REP,680307,0,10,86,96,
Sequoyah,Commissioner of Labor,Mike Workman,DEM,680307,1,10,97,108,
Sequoyah,Commissioner of Labor,Mark Costello,REP,680307,1,12,97,110,
Sequoyah,U.S. Senate,Matt Silverstein,DEM,680307,0,9,68,77,
Sequoyah,U.S. Senate,Jim Inhofe,REP,680307,2,11,119,132,
Sequoyah,U.S. Senate,Aaron Delozier,IND,680307,0,1,3,4,
Sequoyah,U.S. Senate,Ray Woods,IND,680307,0,1,4,5,
Sequoyah,U.S. Senate,Joan Farr,IND,680307,0,1,3,4,
Sequoyah,U.S. Senate,Connie Johnson,DEM,680307,0,8,64,72,
Sequoyah,U.S. Senate,James Lankford,REP,680307,2,13,120,135,
Sequoyah,U.S. Senate,Mark Beard,IND,680307,0,2,11,13,
Sequoyah,U.S. House,Earl Everett,DEM,680307,0,9,49,58,02
Sequoyah,U.S. House,Markwayne Mullin,REP,680307,2,12,127,141,02
Sequoyah,U.S. House,Jon Douthitt,IND,680307,0,2,19,21,02
Sequoyah,State Senate,Ann Weaver,DEM,680307,0,12,89,101,4
Sequoyah,State Senate,Mark Allen,REP,680307,2,14,111,127,4
Sequoyah,Governor,Joe Dorman,DEM,680308,1,4,74,79,
Sequoyah,Governor,Mary Fallin,REP,680308,2,7,54,63,
Sequoyah,Governor,Kimberly Willis,IND,680308,0,0,2,2,
Sequoyah,Governor,Richard Prawdzienski,IND,680308,0,0,6,6,
Sequoyah,Lieutenant Governor,Cathy Cummings,DEM,680308,2,7,63,72,
Sequoyah,Lieutenant Governor,Todd Lamb,REP,680308,2,4,72,78,
Sequoyah,Superintendent of Public Instruction,John Cox,DEM,680308,3,6,81,90,
Sequoyah,Superintendent of Public Instruction,Joy Hofmeister,REP,680308,0,4,53,57,
Sequoyah,Commissioner of Labor,Mike Workman,DEM,680308,3,7,63,73,
Sequoyah,Commissioner of Labor,Mark Costello,REP,680308,1,4,67,72,
Sequoyah,U.S. Senate,Matt Silverstein,DEM,680308,1,7,46,54,
Sequoyah,U.S. Senate,Jim Inhofe,REP,680308,3,4,77,84,
Sequoyah,U.S. Senate,Aaron Delozier,IND,680308,0,0,2,2,
Sequoyah,U.S. Senate,Ray Woods,IND,680308,0,0,3,3,
Sequoyah,U.S. Senate,Joan Farr,IND,680308,0,0,6,6,
Sequoyah,U.S. Senate,Connie Johnson,DEM,680308,2,7,52,61,
Sequoyah,U.S. Senate,James Lankford,REP,680308,2,4,71,77,
Sequoyah,U.S. Senate,Mark Beard,IND,680308,0,0,10,10,
Sequoyah,U.S. House,Earl Everett,DEM,680308,0,7,47,54,02
Sequoyah,U.S. House,Markwayne Mullin,REP,680308,4,3,81,88,02
Sequoyah,U.S. House,Jon Douthitt,IND,680308,0,1,7,8,02
Sequoyah,State Senate,Ann Weaver,DEM,680308,2,6,68,76,4
Sequoyah,State Senate,Mark Allen,REP,680308,2,4,69,75,4
Sequoyah,Governor,Joe Dorman,DEM,680309,14,2,67,83,
Sequoyah,Governor,Mary Fallin,REP,680309,0,2,115,117,
Sequoyah,Governor,Kimberly Willis,IND,680309,0,0,3,3,
Sequoyah,Governor,Richard Prawdzienski,IND,680309,0,0,4,4,
Sequoyah,Lieutenant Governor,Cathy Cummings,DEM,680309,13,0,62,75,
Sequoyah,Lieutenant Governor,Todd Lamb,REP,680309,1,4,124,129,
Sequoyah,Superintendent of Public Instruction,John Cox,DEM,680309,14,0,101,115,
Sequoyah,Superintendent of Public Instruction,Joy Hofmeister,REP,680309,0,4,86,90,
Sequoyah,Commissioner of Labor,Mike Workman,DEM,680309,11,2,70,83,
Sequoyah,Commissioner of Labor,Mark Costello,REP,680309,0,2,114,116,
Sequoyah,U.S. Senate,Matt Silverstein,DEM,680309,4,2,47,53,
Sequoyah,U.S. Senate,Jim Inhofe,REP,680309,10,2,129,141,
Sequoyah,U.S. Senate,Aaron Delozier,IND,680309,0,0,3,3,
Sequoyah,U.S. Senate,Ray Woods,IND,680309,0,0,7,7,
Sequoyah,U.S. Senate,Joan Farr,IND,680309,0,0,2,2,
Sequoyah,U.S. Senate,Connie Johnson,DEM,680309,7,2,48,57,
Sequoyah,U.S. Senate,James Lankford,REP,680309,7,2,132,141,
Sequoyah,U.S. Senate,Mark Beard,IND,680309,0,0,7,7,
Sequoyah,U.S. House,Earl Everett,DEM,680309,4,0,45,49,02
Sequoyah,U.S. House,Markwayne Mullin,REP,680309,2,2,133,137,02
Sequoyah,U.S. House,Jon Douthitt,IND,680309,8,2,7,17,02
Sequoyah,State Senate,Ann Weaver,DEM,680309,14,2,89,105,4
Sequoyah,State Senate,Mark Allen,REP,680309,0,2,100,102,4
Sequoyah,Governor,Joe Dorman,DEM,680310,2,5,85,92,
Sequoyah,Governor,Mary Fallin,REP,680310,4,3,121,128,
Sequoyah,Governor,Kimberly Willis,IND,680310,0,0,4,4,
Sequoyah,Governor,Richard Prawdzienski,IND,680310,0,0,3,3,
Sequoyah,Lieutenant Governor,Cathy Cummings,DEM,680310,2,5,80,87,
Sequoyah,Lieutenant Governor,Todd Lamb,REP,680310,4,3,132,139,
Sequoyah,Superintendent of Public Instruction,John Cox,DEM,680310,0,4,101,105,
Sequoyah,Superintendent of Public Instruction,Joy Hofmeister,REP,680310,3,4,107,114,
Sequoyah,Commissioner of Labor,Mike Workman,DEM,680310,1,7,81,89,
Sequoyah,Commissioner of Labor,Mark Costello,REP,680310,3,1,129,133,
Sequoyah,U.S. Senate,Matt Silverstein,DEM,680310,0,4,62,66,
Sequoyah,U.S. Senate,Jim Inhofe,REP,680310,4,3,142,149,
Sequoyah,U.S. Senate,Aaron Delozier,IND,680310,0,0,1,1,
Sequoyah,U.S. Senate,Ray Woods,IND,680310,0,0,3,3,
Sequoyah,U.S. Senate,Joan Farr,IND,680310,0,1,3,4,
Sequoyah,U.S. Senate,Connie Johnson,DEM,680310,0,5,62,67,
Sequoyah,U.S. Senate,James Lankford,REP,680310,4,3,139,146,
Sequoyah,U.S. Senate,Mark Beard,IND,680310,0,0,8,8,
Sequoyah,U.S. House,Earl Everett,DEM,680310,0,5,62,67,02
Sequoyah,U.S. House,Markwayne Mullin,REP,680310,4,3,144,151,02
Sequoyah,U.S. House,Jon Douthitt,IND,680310,0,0,5,5,02
Sequoyah,State Senate,Ann Weaver,DEM,680310,2,5,77,84,4
Sequoyah,State Senate,Mark Allen,REP,680310,4,3,137,144,4
Stephens,Governor,Joe Dorman,DEM,690001,1,23,192,216,
Stephens,Governor,Mary Fallin,REP,690001,12,44,392,448,
Stephens,Governor,Kimberly Willis,IND,690001,0,3,10,13,
Stephens,Governor,Richard Prawdzienski,IND,690001,0,0,4,4,
Stephens,Lieutenant Governor,Cathy Cummings,DEM,690001,0,13,88,101,
Stephens,Lieutenant Governor,Todd Lamb,REP,690001,13,57,509,579,
Stephens,Superintendent of Public Instruction,John Cox,DEM,690001,1,21,167,189,
Stephens,Superintendent of Public Instruction,Joy Hofmeister,REP,690001,12,49,426,487,
Stephens,Commissioner of Labor,Mike Workman,DEM,690001,0,18,106,124,
Stephens,Commissioner of Labor,Mark Costello,REP,690001,13,51,481,545,
Stephens,U.S. Senate,Matt Silverstein,DEM,690001,0,13,85,98,
Stephens,U.S. Senate,Jim Inhofe,REP,690001,13,57,496,566,
Stephens,U.S. Senate,Aaron Delozier,IND,690001,0,0,3,3,
Stephens,U.S. Senate,Ray Woods,IND,690001,0,0,5,5,
Stephens,U.S. Senate,Joan Farr,IND,690001,0,0,6,6,
Stephens,U.S. Senate,Connie Johnson,DEM,690001,0,14,86,100,
Stephens,U.S. Senate,James Lankford,REP,690001,13,55,499,567,
Stephens,U.S. Senate,Mark Beard,IND,690001,0,1,9,10,
Stephens,U.S. House,Bert Smith,DEM,690001,0,11,74,85,04
Stephens,U.S. House,Tom Cole,REP,690001,13,56,492,561,04
Stephens,U.S. House,Dennis Johnson,IND,690001,0,3,31,34,04
Stephens,Governor,Joe Dorman,DEM,690003,4,10,178,192,
Stephens,Governor,Mary Fallin,REP,690003,5,30,306,341,
Stephens,Governor,Kimberly Willis,IND,690003,0,1,6,7,
Stephens,Governor,Richard Prawdzienski,IND,690003,1,0,4,5,
Stephens,Lieutenant Governor,Cathy Cummings,DEM,690003,4,8,87,99,
Stephens,Lieutenant Governor,Todd Lamb,REP,690003,6,33,411,450,
Stephens,Superintendent of Public Instruction,John Cox,DEM,690003,4,11,167,182,
Stephens,Superintendent of Public Instruction,Joy Hofmeister,REP,690003,6,30,330,366,
Stephens,Commissioner of Labor,Mike Workman,DEM,690003,4,6,108,118,
Stephens,Commissioner of Labor,Mark Costello,REP,690003,6,35,380,421,
Stephens,U.S. Senate,Matt Silverstein,DEM,690003,3,4,80,87,
Stephens,U.S. Senate,Jim Inhofe,REP,690003,7,36,406,449,
Stephens,U.S. Senate,Aaron Delozier,IND,690003,0,0,3,3,
Stephens,U.S. Senate,Ray Woods,IND,690003,0,1,3,4,
Stephens,U.S. Senate,Joan Farr,IND,690003,0,0,6,6,
Stephens,U.S. Senate,Connie Johnson,DEM,690003,2,6,90,98,
Stephens,U.S. Senate,James Lankford,REP,690003,8,33,399,440,
Stephens,U.S. Senate,Mark Beard,IND,690003,0,1,8,9,
Stephens,U.S. House,Bert Smith,DEM,690003,3,2,72,77,04
Stephens,U.S. House,Tom Cole,REP,690003,7,35,401,443,04
Stephens,U.S. House,Dennis Johnson,IND,690003,0,4,27,31,04
Stephens,Governor,Joe Dorman,DEM,690004,2,12,179,193,
Stephens,Governor,Mary Fallin,REP,690004,14,28,284,326,
Stephens,Governor,Kimberly Willis,IND,690004,0,0,15,15,
Stephens,Governor,Richard Prawdzienski,IND,690004,0,1,7,8,
Stephens,Lieutenant Governor,Cathy Cummings,DEM,690004,2,8,126,136,
Stephens,Lieutenant Governor,Todd Lamb,REP,690004,14,33,362,409,
Stephens,Superintendent of Public Instruction,John Cox,DEM,690004,2,17,166,185,
Stephens,Superintendent of Public Instruction,Joy Hofmeister,REP,690004,14,23,321,358,
Stephens,Commissioner of Labor,Mike Workman,DEM,690004,3,8,142,153,
Stephens,Commissioner of Labor,Mark Costello,REP,690004,13,32,337,382,
Stephens,U.S. Senate,Matt Silverstein,DEM,690004,2,8,109,119,
Stephens,U.S. Senate,Jim Inhofe,REP,690004,14,32,341,387,
Stephens,U.S. Senate,Aaron Delozier,IND,690004,0,0,8,8,
Stephens,U.S. Senate,Ray Woods,IND,690004,0,0,16,16,
Stephens,U.S. Senate,Joan Farr,IND,690004,0,0,9,9,
Stephens,U.S. Senate,Connie Johnson,DEM,690004,2,8,116,126,
Stephens,U.S. Senate,James Lankford,REP,690004,14,30,352,396,
Stephens,U.S. Senate,Mark Beard,IND,690004,0,2,16,18,
Stephens,U.S. House,Bert Smith,DEM,690004,2,5,91,98,04
Stephens,U.S. House,Tom Cole,REP,690004,13,35,351,399,04
Stephens,U.S. House,Dennis Johnson,IND,690004,1,1,46,48,04
Stephens,Governor,Joe Dorman,DEM,690008,4,16,185,205,
Stephens,Governor,Mary Fallin,REP,690008,3,28,151,182,
Stephens,Governor,Kimberly Willis,IND,690008,0,0,9,9,
Stephens,Governor,Richard Prawdzienski,IND,690008,0,0,10,10,
Stephens,Lieutenant Governor,Cathy Cummings,DEM,690008,4,12,157,173,
Stephens,Lieutenant Governor,Todd Lamb,REP,690008,2,32,197,231,
Stephens,Superintendent of Public Instruction,John Cox,DEM,690008,4,16,183,203,
Stephens,Superintendent of Public Instruction,Joy Hofmeister,REP,690008,2,28,171,201,
Stephens,Commissioner of Labor,Mike Workman,DEM,690008,4,14,179,197,
Stephens,Commissioner of Labor,Mark Costello,REP,690008,2,30,169,201,
Stephens,U.S. Senate,Matt Silverstein,DEM,690008,4,11,143,158,
Stephens,U.S. Senate,Jim Inhofe,REP,690008,3,31,179,213,
Stephens,U.S. Senate,Aaron Delozier,IND,690008,0,1,10,11,
Stephens,U.S. Senate,Ray Woods,IND,690008,0,0,10,10,
Stephens,U.S. Senate,Joan Farr,IND,690008,0,1,13,14,
Stephens,U.S. Senate,Connie Johnson,DEM,690008,4,11,160,175,
Stephens,U.S. Senate,James Lankford,REP,690008,3,32,173,208,
Stephens,U.S. Senate,Mark Beard,IND,690008,0,1,20,21,
Stephens,U.S. House,Bert Smith,DEM,690008,3,8,142,153,04
Stephens,U.S. House,Tom Cole,REP,690008,3,27,165,195,04
Stephens,U.S. House,Dennis Johnson,IND,690008,1,9,47,57,04
Stephens,Governor,Joe Dorman,DEM,690012,1,26,164,191,
Stephens,Governor,Mary Fallin,REP,690012,3,31,214,248,
Stephens,Governor,Kimberly Willis,IND,690012,0,1,16,17,
Stephens,Governor,Richard Prawdzienski,IND,690012,0,1,4,5,
Stephens,Lieutenant Governor,Cathy Cummings,DEM,690012,1,17,113,131,
Stephens,Lieutenant Governor,Todd Lamb,REP,690012,3,42,283,328,
Stephens,Superintendent of Public Instruction,John Cox,DEM,690012,1,21,137,159,
Stephens,Superintendent of Public Instruction,Joy Hofmeister,REP,690012,3,37,258,298,
Stephens,Commissioner of Labor,Mike Workman,DEM,690012,0,18,123,141,
Stephens,Commissioner of Labor,Mark Costello,REP,690012,4,38,264,306,
Stephens,U.S. Senate,Matt Silverstein,DEM,690012,1,15,102,118,
Stephens,U.S. Senate,Jim Inhofe,REP,690012,3,41,270,314,
Stephens,U.S. Senate,Aaron Delozier,IND,690012,0,1,6,7,
Stephens,U.S. Senate,Ray Woods,IND,690012,0,1,9,10,
Stephens,U.S. Senate,Joan Farr,IND,690012,0,0,8,8,
Stephens,U.S. Senate,Connie Johnson,DEM,690012,1,17,109,127,
Stephens,U.S. Senate,James Lankford,REP,690012,3,40,267,310,
Stephens,U.S. Senate,Mark Beard,IND,690012,0,2,19,21,
Stephens,U.S. House,Bert Smith,DEM,690012,1,12,86,99,04
Stephens,U.S. House,Tom Cole,REP,690012,3,41,264,308,04
Stephens,U.S. House,Dennis Johnson,IND,690012,0,6,46,52,04
Stephens,Governor,Joe Dorman,DEM,690013,11,3,77,91,
Stephens,Governor,Mary Fallin,REP,690013,4,3,70,77,
Stephens,Governor,Kimberly Willis,IND,690013,0,0,7,7,
Stephens,Governor,Richard Prawdzienski,IND,690013,1,0,1,2,
Stephens,Lieutenant Governor,Cathy Cummings,DEM,690013,10,0,67,77,
Stephens,Lieutenant Governor,Todd Lamb,REP,690013,6,6,89,101,
Stephens,Superintendent of Public Instruction,John Cox,DEM,690013,12,5,75,92,
Stephens,Superintendent of Public Instruction,Joy Hofmeister,REP,690013,4,1,80,85,
Stephens,Commissioner of Labor,Mike Workman,DEM,690013,10,1,81,92,
Stephens,Commissioner of Labor,Mark Costello,REP,690013,4,5,74,83,
Stephens,U.S. Senate,Matt Silverstein,DEM,690013,10,0,54,64,
Stephens,U.S. Senate,Jim Inhofe,REP,690013,4,6,90,100,
Stephens,U.S. Senate,Aaron Delozier,IND,690013,0,0,4,4,
Stephens,U.S. Senate,Ray Woods,IND,690013,0,0,1,1,
Stephens,U.S. Senate,Joan Farr,IND,690013,1,0,5,6,
Stephens,U.S. Senate,Connie Johnson,DEM,690013,10,1,66,77,
Stephens,U.S. Senate,James Lankford,REP,690013,4,5,81,90,
Stephens,U.S. Senate,Mark Beard,IND,690013,1,0,7,8,
Stephens,U.S. House,Bert Smith,DEM,690013,9,0,49,58,04
Stephens,U.S. House,Tom Cole,REP,690013,6,6,86,98,04
Stephens,U.S. House,Dennis Johnson,IND,690013,1,0,19,20,04
Stephens,Governor,Joe Dorman,DEM,690014,0,30,219,249,
Stephens,Governor,Mary Fallin,REP,690014,11,35,382,428,
Stephens,Governor,Kimberly Willis,IND,690014,0,0,15,15,
Stephens,Governor,Richard Prawdzienski,IND,690014,0,0,6,6,
Stephens,Lieutenant Governor,Cathy Cummings,DEM,690014,1,14,151,166,
Stephens,Lieutenant Governor,Todd Lamb,REP,690014,10,50,474,534,
Stephens,Superintendent of Public Instruction,John Cox,DEM,690014,2,33,222,257,
Stephens,Superintendent of Public Instruction,Joy Hofmeister,REP,690014,9,32,400,441,
Stephens,Commissioner of Labor,Mike Workman,DEM,690014,1,21,167,189,
Stephens,Commissioner of Labor,Mark Costello,REP,690014,10,39,447,496,
Stephens,U.S. Senate,Matt Silverstein,DEM,690014,0,15,125,140,
Stephens,U.S. Senate,Jim Inhofe,REP,690014,9,48,476,533,
Stephens,U.S. Senate,Aaron Delozier,IND,690014,2,0,4,6,
Stephens,U.S. Senate,Ray Woods,IND,690014,0,0,5,5,
Stephens,U.S. Senate,Joan Farr,IND,690014,0,0,8,8,
Stephens,U.S. Senate,Connie Johnson,DEM,690014,1,19,139,159,
Stephens,U.S. Senate,James Lankford,REP,690014,10,43,459,512,
Stephens,U.S. Senate,Mark Beard,IND,690014,0,1,24,25,
Stephens,U.S. House,Bert Smith,DEM,690014,0,10,106,116,04
Stephens,U.S. House,Tom Cole,REP,690014,9,46,464,519,04
Stephens,U.S. House,Dennis Johnson,IND,690014,2,8,52,62,04
Stephens,Governor,Joe Dorman,DEM,690015,2,8,54,64,
Stephens,Governor,Mary Fallin,REP,690015,0,6,78,84,
Stephens,Governor,Kimberly Willis,IND,690015,0,0,4,4,
Stephens,Governor,Richard Prawdzienski,IND,690015,0,0,0,0,
Stephens,Lieutenant Governor,Cathy Cummings,DEM,690015,2,4,29,35,
Stephens,Lieutenant Governor,Todd Lamb,REP,690015,0,10,104,114,
Stephens,Superintendent of Public Instruction,John Cox,DEM,690015,2,5,45,52,
Stephens,Superintendent of Public Instruction,Joy Hofmeister,REP,690015,0,7,90,97,
Stephens,Commissioner of Labor,Mike Workman,DEM,690015,2,5,46,53,
Stephens,Commissioner of Labor,Mark Costello,REP,690015,0,8,86,94,
Stephens,U.S. Senate,Matt Silverstein,DEM,690015,2,3,32,37,
Stephens,U.S. Senate,Jim Inhofe,REP,690015,0,9,97,106,
Stephens,U.S. Senate,Aaron Delozier,IND,690015,0,0,2,2,
Stephens,U.S. Senate,Ray Woods,IND,690015,0,1,3,4,
Stephens,U.S. Senate,Joan Farr,IND,690015,0,0,2,2,
Stephens,U.S. Senate,Connie Johnson,DEM,690015,2,5,34,41,
Stephens,U.S. Senate,James Lankford,REP,690015,0,8,95,103,
Stephens,U.S. Senate,Mark Beard,IND,690015,0,0,4,4,
Stephens,U.S. House,Bert Smith,DEM,690015,0,2,24,26,04
Stephens,U.S. House,Tom Cole,REP,690015,2,8,97,107,04
Stephens,U.S. House,Dennis Johnson,IND,690015,0,3,14,17,04
Stephens,Governor,Joe Dorman,DEM,690016,7,35,301,343,
Stephens,Governor,Mary Fallin,REP,690016,17,41,468,526,
Stephens,Governor,Kimberly Willis,IND,690016,1,0,18,19,
Stephens,Governor,Richard Prawdzienski,IND,690016,0,0,11,11,
Stephens,Lieutenant Governor,Cathy Cummings,DEM,690016,4,17,172,193,
Stephens,Lieutenant Governor,Todd Lamb,REP,690016,20,59,627,706,
Stephens,Superintendent of Public Instruction,John Cox,DEM,690016,4,32,286,322,
Stephens,Superintendent of Public Instruction,Joy Hofmeister,REP,690016,20,43,511,574,
Stephens,Commissioner of Labor,Mike Workman,DEM,690016,4,27,214,245,
Stephens,Commissioner of Labor,Mark Costello,REP,690016,20,48,567,635,
Stephens,U.S. Senate,Matt Silverstein,DEM,690016,4,18,161,183,
Stephens,U.S. Senate,Jim Inhofe,REP,690016,19,56,603,678,
Stephens,U.S. Senate,Aaron Delozier,IND,690016,0,0,4,4,
Stephens,U.S. Senate,Ray Woods,IND,690016,1,0,15,16,
Stephens,U.S. Senate,Joan Farr,IND,690016,1,0,13,14,
Stephens,U.S. Senate,Connie Johnson,DEM,690016,5,18,170,193,
Stephens,U.S. Senate,James Lankford,REP,690016,20,57,597,674,
Stephens,U.S. Senate,Mark Beard,IND,690016,0,0,28,28,
Stephens,U.S. House,Bert Smith,DEM,690016,3,15,122,140,04
Stephens,U.S. House,Tom Cole,REP,690016,19,56,601,676,04
Stephens,U.S. House,Dennis Johnson,IND,690016,3,4,76,83,04
Stephens,Governor,Joe Dorman,DEM,690019,7,21,299,327,
Stephens,Governor,Mary Fallin,REP,690019,13,53,469,535,
Stephens,Governor,Kimberly Willis,IND,690019,0,1,10,11,
Stephens,Governor,Richard Prawdzienski,IND,690019,0,0,5,5,
Stephens,Lieutenant Governor,Cathy Cummings,DEM,690019,2,11,148,161,
Stephens,Lieutenant Governor,Todd Lamb,REP,690019,18,66,636,720,
Stephens,Superintendent of Public Instruction,John Cox,DEM,690019,8,17,274,299,
Stephens,Superintendent of Public Instruction,Joy Hofmeister,REP,690019,12,60,502,574,
Stephens,Commissioner of Labor,Mike Workman,DEM,690019,5,12,215,232,
Stephens,Commissioner of Labor,Mark Costello,REP,690019,15,62,545,622,
Stephens,U.S. Senate,Matt Silverstein,DEM,690019,1,8,138,147,
Stephens,U.S. Senate,Jim Inhofe,REP,690019,18,63,621,702,
Stephens,U.S. Senate,Aaron Delozier,IND,690019,0,1,7,8,
Stephens,U.S. Senate,Ray Woods,IND,690019,0,2,5,7,
Stephens,U.S. Senate,Joan Farr,IND,690019,1,0,6,7,
Stephens,U.S. Senate,Connie Johnson,DEM,690019,1,11,139,151,
Stephens,U.S. Senate,James Lankford,REP,690019,18,65,628,711,
Stephens,U.S. Senate,Mark Beard,IND,690019,1,1,13,15,
Stephens,U.S. House,Bert Smith,DEM,690019,1,7,111,119,04
Stephens,U.S. House,Tom Cole,REP,690019,19,64,602,685,04
Stephens,U.S. House,Dennis Johnson,IND,690019,0,6,69,75,04
Stephens,Governor,Joe Dorman,DEM,690032,3,16,327,346,
Stephens,Governor,Mary Fallin,REP,690032,4,11,284,299,
Stephens,Governor,Kimberly Willis,IND,690032,0,0,14,14,
Stephens,Governor,Richard Prawdzienski,IND,690032,0,0,9,9,
Stephens,Lieutenant Governor,Cathy Cummings,DEM,690032,2,3,177,182,
Stephens,Lieutenant Governor,Todd Lamb,REP,690032,6,24,453,483,
Stephens,Superintendent of Public Instruction,John Cox,DEM,690032,2,14,273,289,
Stephens,Superintendent of Public Instruction,Joy Hofmeister,REP,690032,6,11,355,372,
Stephens,Commissioner of Labor,Mike Workman,DEM,690032,2,6,226,234,
Stephens,Commissioner of Labor,Mark Costello,REP,690032,6,18,392,416,
Stephens,U.S. Senate,Matt Silverstein,DEM,690032,2,2,131,135,
Stephens,U.S. Senate,Jim Inhofe,REP,690032,6,25,475,506,
Stephens,U.S. Senate,Aaron Delozier,IND,690032,0,0,3,3,
Stephens,U.S. Senate,Ray Woods,IND,690032,0,0,9,9,
Stephens,U.S. Senate,Joan Farr,IND,690032,0,0,11,11,
Stephens,U.S. Senate,Connie Johnson,DEM,690032,1,4,156,161,
Stephens,U.S. Senate,James Lankford,REP,690032,7,23,438,468,
Stephens,U.S. Senate,Mark Beard,IND,690032,0,0,34,34,
Stephens,U.S. House,Bert Smith,DEM,690032,2,1,118,121,04
Stephens,U.S. House,Tom Cole,REP,690032,4,26,486,516,04
Stephens,U.S. House,Dennis Johnson,IND,690032,0,0,26,26,04
Stephens,Governor,Joe Dorman,DEM,690033,12,26,378,416,
Stephens,Governor,Mary Fallin,REP,690033,13,20,385,418,
Stephens,Governor,Kimberly Willis,IND,690033,0,1,16,17,
Stephens,Governor,Richard Prawdzienski,IND,690033,0,0,6,6,
Stephens,Lieutenant Governor,Cathy Cummings,DEM,690033,5,15,167,187,
Stephens,Lieutenant Governor,Todd Lamb,REP,690033,19,32,613,664,
Stephens,Superintendent of Public Instruction,John Cox,DEM,690033,9,27,358,394,
Stephens,Superintendent of Public Instruction,Joy Hofmeister,REP,690033,15,20,423,458,
Stephens,Commissioner of Labor,Mike Workman,DEM,690033,9,21,246,276,
Stephens,Commissioner of Labor,Mark Costello,REP,690033,15,26,515,556,
Stephens,U.S. Senate,Matt Silverstein,DEM,690033,3,12,145,160,
Stephens,U.S. Senate,Jim Inhofe,REP,690033,22,31,604,657,
Stephens,U.S. Senate,Aaron Delozier,IND,690033,0,0,7,7,
Stephens,U.S. Senate,Ray Woods,IND,690033,0,2,14,16,
Stephens,U.S. Senate,Joan Farr,IND,690033,0,1,10,11,
Stephens,U.S. Senate,Connie Johnson,DEM,690033,3,14,161,178,
Stephens,U.S. Senate,James Lankford,REP,690033,21,29,581,631,
Stephens,U.S. Senate,Mark Beard,IND,690033,0,3,34,37,
Stephens,U.S. House,Bert Smith,DEM,690033,2,12,114,128,04
Stephens,U.S. House,Tom Cole,REP,690033,21,30,622,673,04
Stephens,U.S. House,Dennis Johnson,IND,690033,1,5,45,51,04
Stephens,Governor,Joe Dorman,DEM,690041,1,11,285,297,
Stephens,Governor,Mary Fallin,REP,690041,5,10,220,235,
Stephens,Governor,Kimberly Willis,IND,690041,0,0,13,13,
Stephens,Governor,Richard Prawdzienski,IND,690041,0,0,7,7,
Stephens,Lieutenant Governor,Cathy Cummings,DEM,690041,0,3,155,158,
Stephens,Lieutenant Governor,Todd Lamb,REP,690041,6,18,367,391,
Stephens,Superintendent of Public Instruction,John Cox,DEM,690041,1,9,236,246,
Stephens,Superintendent of Public Instruction,Joy Hofmeister,REP,690041,5,11,285,301,
Stephens,Commissioner of Labor,Mike Workman,DEM,690041,1,9,200,210,
Stephens,Commissioner of Labor,Mark Costello,REP,690041,5,11,311,327,
Stephens,U.S. Senate,Matt Silverstein,DEM,690041,1,5,140,146,
Stephens,U.S. Senate,Jim Inhofe,REP,690041,5,16,369,390,
Stephens,U.S. Senate,Aaron Delozier,IND,690041,0,0,3,3,
Stephens,U.S. Senate,Ray Woods,IND,690041,0,0,5,5,
Stephens,U.S. Senate,Joan Farr,IND,690041,0,0,6,6,
Stephens,U.S. Senate,Connie Johnson,DEM,690041,1,4,156,161,
Stephens,U.S. Senate,James Lankford,REP,690041,5,16,348,369,
Stephens,U.S. Senate,Mark Beard,IND,690041,0,1,17,18,
Stephens,U.S. House,Bert Smith,DEM,690041,0,3,114,117,04
Stephens,U.S. House,Tom Cole,REP,690041,6,15,374,395,04
Stephens,U.S. House,Dennis Johnson,IND,690041,0,3,33,36,04
Stephens,Governor,Joe Dorman,DEM,690049,1,2,34,37,
Stephens,Governor,Mary Fallin,REP,690049,0,5,56,61,
Stephens,Governor,Kimberly Willis,IND,690049,0,0,1,1,
Stephens,Governor,Richard Prawdzienski,IND,690049,0,0,0,0,
Stephens,Lieutenant Governor,Cathy Cummings,DEM,690049,1,2,16,19,
Stephens,Lieutenant Governor,Todd Lamb,REP,690049,0,5,74,79,
Stephens,Superintendent of Public Instruction,John Cox,DEM,690049,1,2,38,41,
Stephens,Superintendent of Public Instruction,Joy Hofmeister,REP,690049,0,5,52,57,
Stephens,Commissioner of Labor,Mike Workman,DEM,690049,1,2,24,27,
Stephens,Commissioner of Labor,Mark Costello,REP,690049,0,5,66,71,
Stephens,U.S. Senate,Matt Silverstein,DEM,690049,1,0,10,11,
Stephens,U.S. Senate,Jim Inhofe,REP,690049,0,7,78,85,
Stephens,U.S. Senate,Aaron Delozier,IND,690049,0,0,0,0,
Stephens,U.S. Senate,Ray Woods,IND,690049,0,0,1,1,
Stephens,U.S. Senate,Joan Farr,IND,690049,0,0,2,2,
Stephens,U.S. Senate,Connie Johnson,DEM,690049,1,1,12,14,
Stephens,U.S. Senate,James Lankford,REP,690049,0,6,74,80,
Stephens,U.S. Senate,Mark Beard,IND,690049,0,0,2,2,
Stephens,U.S. House,Bert Smith,DEM,690049,1,0,5,6,04
Stephens,U.S. House,Tom Cole,REP,690049,0,6,80,86,04
Stephens,U.S. House,Dennis Johnson,IND,690049,0,1,6,7,04
Stephens,Governor,Joe Dorman,DEM,690050,1,22,222,245,
Stephens,Governor,Mary Fallin,REP,690050,4,45,495,544,
Stephens,Governor,Kimberly Willis,IND,690050,0,0,12,12,
Stephens,Governor,Richard Prawdzienski,IND,690050,0,0,9,9,
Stephens,Lieutenant Governor,Cathy Cummings,DEM,690050,1,11,135,147,
Stephens,Lieutenant Governor,Todd Lamb,REP,690050,4,56,599,659,
Stephens,Superintendent of Public Instruction,John Cox,DEM,690050,1,21,210,232,
Stephens,Superintendent of Public Instruction,Joy Hofmeister,REP,690050,4,46,523,573,
Stephens,Commissioner of Labor,Mike Workman,DEM,690050,1,16,158,175,
Stephens,Commissioner of Labor,Mark Costello,REP,690050,4,50,566,620,
Stephens,U.S. Senate,Matt Silverstein,DEM,690050,1,14,113,128,
Stephens,U.S. Senate,Jim Inhofe,REP,690050,4,51,596,651,
Stephens,U.S. Senate,Aaron Delozier,IND,690050,0,0,8,8,
Stephens,U.S. Senate,Ray Woods,IND,690050,0,1,11,12,
Stephens,U.S. Senate,Joan Farr,IND,690050,0,1,6,7,
Stephens,U.S. Senate,Connie Johnson,DEM,690050,1,12,125,138,
Stephens,U.S. Senate,James Lankford,REP,690050,4,55,584,643,
Stephens,U.S. Senate,Mark Beard,IND,690050,0,0,24,24,
Stephens,U.S. House,Bert Smith,DEM,690050,1,14,85,100,04
Stephens,U.S. House,Tom Cole,REP,690050,4,49,586,639,04
Stephens,U.S. House,Dennis Johnson,IND,690050,0,4,65,69,04
Stephens,Governor,Joe Dorman,DEM,690051,1,10,120,131,
Stephens,Governor,Mary Fallin,REP,690051,4,9,128,141,
Stephens,Governor,Kimberly Willis,IND,690051,0,0,11,11,
Stephens,Governor,Richard Prawdzienski,IND,690051,0,0,10,10,
Stephens,Lieutenant Governor,Cathy Cummings,DEM,690051,1,4,61,66,
Stephens,Lieutenant Governor,Todd Lamb,REP,690051,4,15,209,228,
Stephens,Superintendent of Public Instruction,John Cox,DEM,690051,1,6,118,125,
Stephens,Superintendent of Public Instruction,Joy Hofmeister,REP,690051,4,13,149,166,
Stephens,Commissioner of Labor,Mike Workman,DEM,690051,1,6,83,90,
Stephens,Commissioner of Labor,Mark Costello,REP,690051,4,13,180,197,
Stephens,U.S. Senate,Matt Silverstein,DEM,690051,1,4,43,48,
Stephens,U.S. Senate,Jim Inhofe,REP,690051,4,15,209,228,
Stephens,U.S. Senate,Aaron Delozier,IND,690051,0,0,2,2,
Stephens,U.S. Senate,Ray Woods,IND,690051,0,0,10,10,
Stephens,U.S. Senate,Joan Farr,IND,690051,0,0,6,6,
Stephens,U.S. Senate,Connie Johnson,DEM,690051,1,6,51,58,
Stephens,U.S. Senate,James Lankford,REP,690051,4,13,201,218,
Stephens,U.S. Senate,Mark Beard,IND,690051,0,0,17,17,
Stephens,U.S. House,Bert Smith,DEM,690051,1,4,42,47,04
Stephens,U.S. House,Tom Cole,REP,690051,3,14,202,219,04
Stephens,U.S. House,Dennis Johnson,IND,690051,1,1,25,27,04
Stephens,State House,Toni Hasenbeck,DEM,690051,1,7,126,134,65
Stephens,State House,Scooter Park,REP,690051,4,12,137,153,65
Stephens,Governor,Joe Dorman,DEM,690052,0,1,32,33,
Stephens,Governor,Mary Fallin,REP,690052,1,19,45,65,
Stephens,Governor,Kimberly Willis,IND,690052,0,0,2,2,
Stephens,Governor,Richard Prawdzienski,IND,690052,0,0,1,1,
Stephens,Lieutenant Governor,Cathy Cummings,DEM,690052,0,1,19,20,
Stephens,Lieutenant Governor,Todd Lamb,REP,690052,1,19,61,81,
Stephens,Superintendent of Public Instruction,John Cox,DEM,690052,0,4,29,33,
Stephens,Superintendent of Public Instruction,Joy Hofmeister,REP,690052,1,16,51,68,
Stephens,Commissioner of Labor,Mike Workman,DEM,690052,0,2,18,20,
Stephens,Commissioner of Labor,Mark Costello,REP,690052,1,18,62,81,
Stephens,U.S. Senate,Matt Silverstein,DEM,690052,0,1,20,21,
Stephens,U.S. Senate,Jim Inhofe,REP,690052,1,19,57,77,
Stephens,U.S. Senate,Aaron Delozier,IND,690052,0,0,1,1,
Stephens,U.S. Senate,Ray Woods,IND,690052,0,0,1,1,
Stephens,U.S. Senate,Joan Farr,IND,690052,0,0,1,1,
Stephens,U.S. Senate,Connie Johnson,DEM,690052,0,1,20,21,
Stephens,U.S. Senate,James Lankford,REP,690052,1,18,58,77,
Stephens,U.S. Senate,Mark Beard,IND,690052,0,1,2,3,
Stephens,U.S. House,Bert Smith,DEM,690052,0,0,16,16,04
Stephens,U.S. House,Tom Cole,REP,690052,1,19,61,81,04
Stephens,U.S. House,Dennis Johnson,IND,690052,0,1,3,4,04
Stephens,Governor,Joe Dorman,DEM,690053,1,3,46,50,
Stephens,Governor,Mary Fallin,REP,690053,3,4,74,81,
Stephens,Governor,Kimberly Willis,IND,690053,0,0,2,2,
Stephens,Governor,Richard Prawdzienski,IND,690053,0,0,2,2,
Stephens,Lieutenant Governor,Cathy Cummings,DEM,690053,0,2,23,25,
Stephens,Lieutenant Governor,Todd Lamb,REP,690053,4,5,99,108,
Stephens,Superintendent of Public Instruction,John Cox,DEM,690053,1,3,36,40,
Stephens,Superintendent of Public Instruction,Joy Hofmeister,REP,690053,3,4,87,94,
Stephens,Commissioner of Labor,Mike Workman,DEM,690053,1,4,29,34,
Stephens,Commissioner of Labor,Mark Costello,REP,690053,3,3,91,97,
Stephens,U.S. Senate,Matt Silverstein,DEM,690053,0,2,20,22,
Stephens,U.S. Senate,Jim Inhofe,REP,690053,4,5,100,109,
Stephens,U.S. Senate,Aaron Delozier,IND,690053,0,0,0,0,
Stephens,U.S. Senate,Ray Woods,IND,690053,0,0,3,3,
Stephens,U.S. Senate,Joan Farr,IND,690053,0,0,0,0,
Stephens,U.S. Senate,Connie Johnson,DEM,690053,0,4,22,26,
Stephens,U.S. Senate,James Lankford,REP,690053,4,3,91,98,
Stephens,U.S. Senate,Mark Beard,IND,690053,0,0,10,10,
Stephens,U.S. House,Bert Smith,DEM,690053,0,3,15,18,04
Stephens,U.S. House,Tom Cole,REP,690053,4,3,94,101,04
Stephens,U.S. House,Dennis Johnson,IND,690053,0,1,13,14,04
Stephens,Governor,Joe Dorman,DEM,690054,1,2,73,76,
Stephens,Governor,Mary Fallin,REP,690054,1,5,82,88,
Stephens,Governor,Kimberly Willis,IND,690054,0,0,2,2,
Stephens,Governor,Richard Prawdzienski,IND,690054,0,0,4,4,
Stephens,Lieutenant Governor,Cathy Cummings,DEM,690054,1,1,45,47,
Stephens,Lieutenant Governor,Todd Lamb,REP,690054,1,6,115,122,
Stephens,Superintendent of Public Instruction,John Cox,DEM,690054,1,2,68,71,
Stephens,Superintendent of Public Instruction,Joy Hofmeister,REP,690054,1,5,91,97,
Stephens,Commissioner of Labor,Mike Workman,DEM,690054,1,1,67,69,
Stephens,Commissioner of Labor,Mark Costello,REP,690054,1,6,93,100,
Stephens,U.S. Senate,Matt Silverstein,DEM,690054,1,0,34,35,
Stephens,U.S. Senate,Jim Inhofe,REP,690054,1,7,116,124,
Stephens,U.S. Senate,Aaron Delozier,IND,690054,0,0,1,1,
Stephens,U.S. Senate,Ray Woods,IND,690054,0,0,4,4,
Stephens,U.S. Senate,Joan Farr,IND,690054,0,0,5,5,
Stephens,U.S. Senate,Connie Johnson,DEM,690054,1,1,47,49,
Stephens,U.S. Senate,James Lankford,REP,690054,1,6,104,111,
Stephens,U.S. Senate,Mark Beard,IND,690054,0,0,9,9,
Stephens,U.S. House,Bert Smith,DEM,690054,1,1,29,31,04
Stephens,U.S. House,Tom Cole,REP,690054,1,6,117,124,04
Stephens,U.S. House,Dennis Johnson,IND,690054,0,0,13,13,04
Stephens,Governor,Joe Dorman,DEM,690055,1,3,69,73,
Stephens,Governor,Mary Fallin,REP,690055,2,4,87,93,
Stephens,Governor,Kimberly Willis,IND,690055,0,0,9,9,
Stephens,Governor,Richard Prawdzienski,IND,690055,0,0,0,0,
Stephens,Lieutenant Governor,Cathy Cummings,DEM,690055,0,1,48,49,
Stephens,Lieutenant Governor,Todd Lamb,REP,690055,3,6,115,124,
Stephens,Superintendent of Public Instruction,John Cox,DEM,690055,2,2,71,75,
Stephens,Superintendent of Public Instruction,Joy Hofmeister,REP,690055,1,5,90,96,
Stephens,Commissioner of Labor,Mike Workman,DEM,690055,0,2,56,58,
Stephens,Commissioner of Labor,Mark Costello,REP,690055,3,5,100,108,
Stephens,U.S. Senate,Matt Silverstein,DEM,690055,0,1,37,38,
Stephens,U.S. Senate,Jim Inhofe,REP,690055,3,5,117,125,
Stephens,U.S. Senate,Aaron Delozier,IND,690055,0,0,3,3,
Stephens,U.S. Senate,Ray Woods,IND,690055,0,1,4,5,
Stephens,U.S. Senate,Joan Farr,IND,690055,0,0,2,2,
Stephens,U.S. Senate,Connie Johnson,DEM,690055,0,1,39,40,
Stephens,U.S. Senate,James Lankford,REP,690055,3,6,119,128,
Stephens,U.S. Senate,Mark Beard,IND,690055,0,0,5,5,
Stephens,U.S. House,Bert Smith,DEM,690055,0,1,31,32,04
Stephens,U.S. House,Tom Cole,REP,690055,3,5,126,134,04
Stephens,U.S. House,Dennis Johnson,IND,690055,0,1,6,7,04
Stephens,Governor,Joe Dorman,DEM,690056,0,2,91,93,
Stephens,Governor,Mary Fallin,REP,690056,0,3,137,140,
Stephens,Governor,Kimberly Willis,IND,690056,0,1,1,2,
Stephens,Governor,Richard Prawdzienski,IND,690056,0,0,2,2,
Stephens,Lieutenant Governor,Cathy Cummings,DEM,690056,0,1,38,39,
Stephens,Lieutenant Governor,Todd Lamb,REP,690056,0,4,193,197,
Stephens,Superintendent of Public Instruction,John Cox,DEM,690056,0,2,107,109,
Stephens,Superintendent of Public Instruction,Joy Hofmeister,REP,690056,0,3,122,125,
Stephens,Commissioner of Labor,Mike Workman,DEM,690056,0,2,52,54,
Stephens,Commissioner of Labor,Mark Costello,REP,690056,0,3,170,173,
Stephens,U.S. Senate,Matt Silverstein,DEM,690056,0,1,32,33,
Stephens,U.S. Senate,Jim Inhofe,REP,690056,0,4,189,193,
Stephens,U.S. Senate,Aaron Delozier,IND,690056,0,0,1,1,
Stephens,U.S. Senate,Ray Woods,IND,690056,0,0,4,4,
Stephens,U.S. Senate,Joan Farr,IND,690056,0,1,3,4,
Stephens,U.S. Senate,Connie Johnson,DEM,690056,0,2,41,43,
Stephens,U.S. Senate,James Lankford,REP,690056,0,3,183,186,
Stephens,U.S. Senate,Mark Beard,IND,690056,0,1,3,4,
Stephens,U.S. House,Bert Smith,DEM,690056,0,2,30,32,04
Stephens,U.S. House,Tom Cole,REP,690056,0,3,192,195,04
Stephens,U.S. House,Dennis Johnson,IND,690056,0,1,8,9,04
Stephens,Governor,Joe Dorman,DEM,690057,2,13,146,161,
Stephens,Governor,Mary Fallin,REP,690057,2,21,231,254,
Stephens,Governor,Kimberly Willis,IND,690057,0,1,10,11,
Stephens,Governor,Richard Prawdzienski,IND,690057,0,0,1,1,
Stephens,Lieutenant Governor,Cathy Cummings,DEM,690057,1,2,84,87,
Stephens,Lieutenant Governor,Todd Lamb,REP,690057,3,33,307,343,
Stephens,Superintendent of Public Instruction,John Cox,DEM,690057,1,13,155,169,
Stephens,Superintendent of Public Instruction,Joy Hofmeister,REP,690057,3,22,236,261,
Stephens,Commissioner of Labor,Mike Workman,DEM,690057,0,7,110,117,
Stephens,Commissioner of Labor,Mark Costello,REP,690057,4,27,273,304,
Stephens,U.S. Senate,Matt Silverstein,DEM,690057,0,1,63,64,
Stephens,U.S. Senate,Jim Inhofe,REP,690057,4,32,304,340,
Stephens,U.S. Senate,Aaron Delozier,IND,690057,0,1,4,5,
Stephens,U.S. Senate,Ray Woods,IND,690057,0,0,9,9,
Stephens,U.S. Senate,Joan Farr,IND,690057,0,0,9,9,
Stephens,U.S. Senate,Connie Johnson,DEM,690057,0,1,79,80,
Stephens,U.S. Senate,James Lankford,REP,690057,4,33,290,327,
Stephens,U.S. Senate,Mark Beard,IND,690057,0,1,20,21,
Stephens,U.S. House,Bert Smith,DEM,690057,0,2,50,52,04
Stephens,U.S. House,Tom Cole,REP,690057,4,29,283,316,04
Stephens,U.S. House,Dennis Johnson,IND,690057,0,4,58,62,04
Stephens,Governor,Joe Dorman,DEM,690058,0,1,98,99,
Stephens,Governor,Mary Fallin,REP,690058,0,6,123,129,
Stephens,Governor,Kimberly Willis,IND,690058,0,0,6,6,
Stephens,Governor,Richard Prawdzienski,IND,690058,0,0,1,1,
Stephens,Lieutenant Governor,Cathy Cummings,DEM,690058,0,0,51,51,
Stephens,Lieutenant Governor,Todd Lamb,REP,690058,0,7,176,183,
Stephens,Superintendent of Public Instruction,John Cox,DEM,690058,0,1,106,107,
Stephens,Superintendent of Public Instruction,Joy Hofmeister,REP,690058,0,6,121,127,
Stephens,Commissioner of Labor,Mike Workman,DEM,690058,0,0,71,71,
Stephens,Commissioner of Labor,Mark Costello,REP,690058,0,7,150,157,
Stephens,U.S. Senate,Matt Silverstein,DEM,690058,0,0,37,37,
Stephens,U.S. Senate,Jim Inhofe,REP,690058,0,7,186,193,
Stephens,U.S. Senate,Aaron Delozier,IND,690058,0,0,1,1,
Stephens,U.S. Senate,Ray Woods,IND,690058,0,0,1,1,
Stephens,U.S. Senate,Joan Farr,IND,690058,0,0,0,0,
Stephens,U.S. Senate,Connie Johnson,DEM,690058,0,1,45,46,
Stephens,U.S. Senate,James Lankford,REP,690058,0,6,174,180,
Stephens,U.S. Senate,Mark Beard,IND,690058,0,0,8,8,
Stephens,U.S. House,Bert Smith,DEM,690058,0,0,32,32,04
Stephens,U.S. House,Tom Cole,REP,690058,0,8,182,190,04
Stephens,U.S. House,Dennis Johnson,IND,690058,0,0,14,14,04
Stephens,Governor,Joe Dorman,DEM,690059,1,2,53,56,
Stephens,Governor,Mary Fallin,REP,690059,1,12,95,108,
Stephens,Governor,Kimberly Willis,IND,690059,0,0,1,1,
Stephens,Governor,Richard Prawdzienski,IND,690059,0,0,0,0,
Stephens,Lieutenant Governor,Cathy Cummings,DEM,690059,1,2,30,33,
Stephens,Lieutenant Governor,Todd Lamb,REP,690059,1,12,118,131,
Stephens,Superintendent of Public Instruction,John Cox,DEM,690059,1,2,64,67,
Stephens,Superintendent of Public Instruction,Joy Hofmeister,REP,690059,1,12,83,96,
Stephens,Commissioner of Labor,Mike Workman,DEM,690059,1,2,43,46,
Stephens,Commissioner of Labor,Mark Costello,REP,690059,1,12,102,115,
Stephens,U.S. Senate,Matt Silverstein,DEM,690059,1,3,24,28,
Stephens,U.S. Senate,Jim Inhofe,REP,690059,1,11,121,133,
Stephens,U.S. Senate,Aaron Delozier,IND,690059,0,0,0,0,
Stephens,U.S. Senate,Ray Woods,IND,690059,0,0,3,3,
Stephens,U.S. Senate,Joan Farr,IND,690059,0,0,1,1,
Stephens,U.S. Senate,Connie Johnson,DEM,690059,1,4,29,34,
Stephens,U.S. Senate,James Lankford,REP,690059,1,10,117,128,
Stephens,U.S. Senate,Mark Beard,IND,690059,0,0,1,1,
Stephens,U.S. House,Bert Smith,DEM,690059,1,3,23,27,04
Stephens,U.S. House,Tom Cole,REP,690059,1,11,123,135,04
Stephens,U.S. House,Dennis Johnson,IND,690059,0,0,2,2,04
Stephens,Governor,Joe Dorman,DEM,690060,0,0,3,3,
Stephens,Governor,Mary Fallin,REP,690060,0,4,7,11,
Stephens,Governor,Kimberly Willis,IND,690060,0,0,2,2,
Stephens,Governor,Richard Prawdzienski,IND,690060,0,0,0,0,
Stephens,Lieutenant Governor,Cathy Cummings,DEM,690060,0,0,1,1,
Stephens,Lieutenant Governor,Todd Lamb,REP,690060,0,4,11,15,
Stephens,Superintendent of Public Instruction,John Cox,DEM,690060,0,0,2,2,
Stephens,Superintendent of Public Instruction,Joy Hofmeister,REP,690060,0,4,10,14,
Stephens,Commissioner of Labor,Mike Workman,DEM,690060,0,0,2,2,
Stephens,Commissioner of Labor,Mark Costello,REP,690060,0,4,10,14,
Stephens,U.S. Senate,Matt Silverstein,DEM,690060,0,0,2,2,
Stephens,U.S. Senate,Jim Inhofe,REP,690060,0,4,9,13,
Stephens,U.S. Senate,Aaron Delozier,IND,690060,0,0,1,1,
Stephens,U.S. Senate,Ray Woods,IND,690060,0,0,0,0,
Stephens,U.S. Senate,Joan Farr,IND,690060,0,0,0,0,
Stephens,U.S. Senate,Connie Johnson,DEM,690060,0,0,2,2,
Stephens,U.S. Senate,James Lankford,REP,690060,0,4,10,14,
Stephens,U.S. Senate,Mark Beard,IND,690060,0,0,0,0,
Stephens,U.S. House,Bert Smith,DEM,690060,0,0,1,1,04
Stephens,U.S. House,Tom Cole,REP,690060,0,4,10,14,04
Stephens,U.S. House,Dennis Johnson,IND,690060,0,0,1,1,04
Stephens,State House,Toni Hasenbeck,DEM,690060,0,0,4,4,65
Stephens,State House,Scooter Park,REP,690060,0,4,8,12,65
Stephens,Governor,Joe Dorman,DEM,690061,2,10,166,178,
Stephens,Governor,Mary Fallin,REP,690061,4,12,215,231,
Stephens,Governor,Kimberly Willis,IND,690061,0,0,10,10,
Stephens,Governor,Richard Prawdzienski,IND,690061,0,0,5,5,
Stephens,Lieutenant Governor,Cathy Cummings,DEM,690061,1,7,94,102,
Stephens,Lieutenant Governor,Todd Lamb,REP,690061,5,15,296,316,
Stephens,Superintendent of Public Instruction,John Cox,DEM,690061,0,8,141,149,
Stephens,Superintendent of Public Instruction,Joy Hofmeister,REP,690061,6,14,249,269,
Stephens,Commissioner of Labor,Mike Workman,DEM,690061,2,10,122,134,
Stephens,Commissioner of Labor,Mark Costello,REP,690061,4,12,262,278,
Stephens,U.S. Senate,Matt Silverstein,DEM,690061,0,6,84,90,
Stephens,U.S. Senate,Jim Inhofe,REP,690061,5,14,297,316,
Stephens,U.S. Senate,Aaron Delozier,IND,690061,1,0,1,2,
Stephens,U.S. Senate,Ray Woods,IND,690061,0,1,8,9,
Stephens,U.S. Senate,Joan Farr,IND,690061,0,1,3,4,
Stephens,U.S. Senate,Connie Johnson,DEM,690061,2,5,83,90,
Stephens,U.S. Senate,James Lankford,REP,690061,4,17,289,310,
Stephens,U.S. Senate,Mark Beard,IND,690061,0,0,13,13,
Stephens,U.S. House,Bert Smith,DEM,690061,0,4,73,77,04
Stephens,U.S. House,Tom Cole,REP,690061,6,15,296,317,04
Stephens,U.S. House,Dennis Johnson,IND,690061,0,3,25,28,04
Stephens,Governor,Joe Dorman,DEM,690062,0,14,134,148,
Stephens,Governor,Mary Fallin,REP,690062,0,9,175,184,
Stephens,Governor,Kimberly Willis,IND,690062,0,0,8,8,
Stephens,Governor,Richard Prawdzienski,IND,690062,0,0,3,3,
Stephens,Lieutenant Governor,Cathy Cummings,DEM,690062,0,10,74,84,
Stephens,Lieutenant Governor,Todd Lamb,REP,690062,0,13,244,257,
Stephens,Superintendent of Public Instruction,John Cox,DEM,690062,0,13,111,124,
Stephens,Superintendent of Public Instruction,Joy Hofmeister,REP,690062,0,8,207,215,
Stephens,Commissioner of Labor,Mike Workman,DEM,690062,0,11,100,111,
Stephens,Commissioner of Labor,Mark Costello,REP,690062,0,11,209,220,
Stephens,U.S. Senate,Matt Silverstein,DEM,690062,0,8,66,74,
Stephens,U.S. Senate,Jim Inhofe,REP,690062,0,15,237,252,
Stephens,U.S. Senate,Aaron Delozier,IND,690062,0,0,3,3,
Stephens,U.S. Senate,Ray Woods,IND,690062,0,0,10,10,
Stephens,U.S. Senate,Joan Farr,IND,690062,0,0,2,2,
Stephens,U.S. Senate,Connie Johnson,DEM,690062,0,9,73,82,
Stephens,U.S. Senate,James Lankford,REP,690062,0,14,232,246,
Stephens,U.S. Senate,Mark Beard,IND,690062,0,0,11,11,
Stephens,U.S. House,Bert Smith,DEM,690062,0,4,58,62,04
Stephens,U.S. House,Tom Cole,REP,690062,0,16,236,252,04
Stephens,U.S. House,Dennis Johnson,IND,690062,0,3,24,27,04
Stephens,Governor,Joe Dorman,DEM,690063,3,11,86,100,
Stephens,Governor,Mary Fallin,REP,690063,1,5,110,116,
Stephens,Governor,Kimberly Willis,IND,690063,0,0,5,5,
Stephens,Governor,Richard Prawdzienski,IND,690063,0,0,1,1,
Stephens,Lieutenant Governor,Cathy Cummings,DEM,690063,0,5,57,62,
Stephens,Lieutenant Governor,Todd Lamb,REP,690063,4,11,143,158,
Stephens,Superintendent of Public Instruction,John Cox,DEM,690063,1,6,82,89,
Stephens,Superintendent of Public Instruction,Joy Hofmeister,REP,690063,3,10,120,133,
Stephens,Commissioner of Labor,Mike Workman,DEM,690063,0,7,61,68,
Stephens,Commissioner of Labor,Mark Costello,REP,690063,4,8,131,143,
Stephens,U.S. Senate,Matt Silverstein,DEM,690063,0,4,43,47,
Stephens,U.S. Senate,Jim Inhofe,REP,690063,4,12,150,166,
Stephens,U.S. Senate,Aaron Delozier,IND,690063,0,0,2,2,
Stephens,U.S. Senate,Ray Woods,IND,690063,0,0,1,1,
Stephens,U.S. Senate,Joan Farr,IND,690063,0,0,3,3,
Stephens,U.S. Senate,Connie Johnson,DEM,690063,0,6,49,55,
Stephens,U.S. Senate,James Lankford,REP,690063,4,10,144,158,
Stephens,U.S. Senate,Mark Beard,IND,690063,0,0,6,6,
Stephens,U.S. House,Bert Smith,DEM,690063,0,3,41,44,04
Stephens,U.S. House,Tom Cole,REP,690063,3,11,139,153,04
Stephens,U.S. House,Dennis Johnson,IND,690063,1,1,21,23,04
Stephens,State House,Toni Hasenbeck,DEM,690063,1,12,91,104,65
Stephens,State House,Scooter Park,REP,690063,3,4,109,116,65
Texas,Governor,Joe Dorman,DEM,700101,2,0,55,57,
Texas,Governor,Mary Fallin,REP,700101,21,8,364,393,
Texas,Governor,Kimberly Willis,IND,700101,1,0,10,11,
Texas,Governor,Richard Prawdzienski,IND,700101,0,0,9,9,
Texas,Lieutenant Governor,Cathy Cummings,DEM,700101,1,0,36,37,
Texas,Lieutenant Governor,Todd Lamb,REP,700101,23,8,399,430,
Texas,Superintendent of Public Instruction,John Cox,DEM,700101,4,0,133,137,
Texas,Superintendent of Public Instruction,Joy Hofmeister,REP,700101,19,8,304,331,
Texas,Commissioner of Labor,Mike Workman,DEM,700101,2,0,46,48,
Texas,Commissioner of Labor,Mark Costello,REP,700101,19,8,384,411,
Texas,U.S. Senate,Matt Silverstein,DEM,700101,1,0,22,23,
Texas,U.S. Senate,Jim Inhofe,REP,700101,22,8,397,427,
Texas,U.S. Senate,Aaron Delozier,IND,700101,0,0,8,8,
Texas,U.S. Senate,Ray Woods,IND,700101,0,0,6,6,
Texas,U.S. Senate,Joan Farr,IND,700101,1,0,4,5,
Texas,U.S. Senate,Connie Johnson,DEM,700101,2,0,34,36,
Texas,U.S. Senate,James Lankford,REP,700101,17,8,388,413,
Texas,U.S. Senate,Mark Beard,IND,700101,3,0,14,17,
Texas,U.S. House,Frankie Robbins,DEM,700101,1,0,30,31,03
Texas,U.S. House,Frank Lucas,REP,700101,23,8,408,439,03
Texas,Governor,Joe Dorman,DEM,700102,0,2,20,22,
Texas,Governor,Mary Fallin,REP,700102,3,11,96,110,
Texas,Governor,Kimberly Willis,IND,700102,0,1,5,6,
Texas,Governor,Richard Prawdzienski,IND,700102,0,0,1,1,
Texas,Lieutenant Governor,Cathy Cummings,DEM,700102,0,1,16,17,
Texas,Lieutenant Governor,Todd Lamb,REP,700102,3,13,106,122,
Texas,Superintendent of Public Instruction,John Cox,DEM,700102,0,3,30,33,
Texas,Superintendent of Public Instruction,Joy Hofmeister,REP,700102,3,11,92,106,
Texas,Commissioner of Labor,Mike Workman,DEM,700102,0,4,17,21,
Texas,Commissioner of Labor,Mark Costello,REP,700102,3,10,105,118,
Texas,U.S. Senate,Matt Silverstein,DEM,700102,0,2,12,14,
Texas,U.S. Senate,Jim Inhofe,REP,700102,3,10,107,120,
Texas,U.S. Senate,Aaron Delozier,IND,700102,0,2,0,2,
Texas,U.S. Senate,Ray Woods,IND,700102,0,0,1,1,
Texas,U.S. Senate,Joan Farr,IND,700102,0,0,2,2,
Texas,U.S. Senate,Connie Johnson,DEM,700102,0,1,13,14,
Texas,U.S. Senate,James Lankford,REP,700102,3,11,106,120,
Texas,U.S. Senate,Mark Beard,IND,700102,0,2,3,5,
Texas,U.S. House,Frankie Robbins,DEM,700102,0,1,11,12,03
Texas,U.S. House,Frank Lucas,REP,700102,3,13,111,127,03
Texas,Governor,Joe Dorman,DEM,700104,7,0,36,43,
Texas,Governor,Mary Fallin,REP,700104,10,4,184,198,
Texas,Governor,Kimberly Willis,IND,700104,0,0,8,8,
Texas,Governor,Richard Prawdzienski,IND,700104,0,0,7,7,
Texas,Lieutenant Governor,Cathy Cummings,DEM,700104,2,0,29,31,
Texas,Lieutenant Governor,Todd Lamb,REP,700104,15,4,204,223,
Texas,Superintendent of Public Instruction,John Cox,DEM,700104,9,2,73,84,
Texas,Superintendent of Public Instruction,Joy Hofmeister,REP,700104,8,2,160,170,
Texas,Commissioner of Labor,Mike Workman,DEM,700104,8,1,29,38,
Texas,Commissioner of Labor,Mark Costello,REP,700104,9,3,202,214,
Texas,U.S. Senate,Matt Silverstein,DEM,700104,4,0,18,22,
Texas,U.S. Senate,Jim Inhofe,REP,700104,13,4,197,214,
Texas,U.S. Senate,Aaron Delozier,IND,700104,0,0,4,4,
Texas,U.S. Senate,Ray Woods,IND,700104,0,0,9,9,
Texas,U.S. Senate,Joan Farr,IND,700104,0,0,7,7,
Texas,U.S. Senate,Connie Johnson,DEM,700104,2,0,22,24,
Texas,U.S. Senate,James Lankford,REP,700104,13,4,194,211,
Texas,U.S. Senate,Mark Beard,IND,700104,2,0,19,21,
Texas,U.S. House,Frankie Robbins,DEM,700104,3,0,31,34,03
Texas,U.S. House,Frank Lucas,REP,700104,14,4,203,221,03
Texas,Governor,Joe Dorman,DEM,700107,2,4,16,22,
Texas,Governor,Mary Fallin,REP,700107,6,2,65,73,
Texas,Governor,Kimberly Willis,IND,700107,0,0,4,4,
Texas,Governor,Richard Prawdzienski,IND,700107,0,0,1,1,
Texas,Lieutenant Governor,Cathy Cummings,DEM,700107,2,0,9,11,
Texas,Lieutenant Governor,Todd Lamb,REP,700107,6,6,77,89,
Texas,Superintendent of Public Instruction,John Cox,DEM,700107,3,4,32,39,
Texas,Superintendent of Public Instruction,Joy Hofmeister,REP,700107,5,2,54,61,
Texas,Commissioner of Labor,Mike Workman,DEM,700107,3,0,12,15,
Texas,Commissioner of Labor,Mark Costello,REP,700107,5,6,74,85,
Texas,U.S. Senate,Matt Silverstein,DEM,700107,2,0,4,6,
Texas,U.S. Senate,Jim Inhofe,REP,700107,6,6,79,91,
Texas,U.S. Senate,Aaron Delozier,IND,700107,0,0,1,1,
Texas,U.S. Senate,Ray Woods,IND,700107,0,0,0,0,
Texas,U.S. Senate,Joan Farr,IND,700107,0,0,2,2,
Texas,U.S. Senate,Connie Johnson,DEM,700107,2,0,6,8,
Texas,U.S. Senate,James Lankford,REP,700107,5,4,77,86,
Texas,U.S. Senate,Mark Beard,IND,700107,1,2,3,6,
Texas,U.S. House,Frankie Robbins,DEM,700107,1,2,8,11,03
Texas,U.S. House,Frank Lucas,REP,700107,7,4,78,89,03
Texas,Governor,Joe Dorman,DEM,700201,0,8,106,114,
Texas,Governor,Mary Fallin,REP,700201,7,36,337,380,
Texas,Governor,Kimberly Willis,IND,700201,0,1,8,9,
Texas,Governor,Richard Prawdzienski,IND,700201,0,0,3,3,
Texas,Lieutenant Governor,Cathy Cummings,DEM,700201,0,7,61,68,
Texas,Lieutenant Governor,Todd Lamb,REP,700201,7,37,392,436,
Texas,Superintendent of Public Instruction,John Cox,DEM,700201,2,13,118,133,
Texas,Superintendent of Public Instruction,Joy Hofmeister,REP,700201,5,32,332,369,
Texas,Commissioner of Labor,Mike Workman,DEM,700201,0,7,79,86,
Texas,Commissioner of Labor,Mark Costello,REP,700201,7,38,368,413,
Texas,U.S. Senate,Matt Silverstein,DEM,700201,0,6,44,50,
Texas,U.S. Senate,Jim Inhofe,REP,700201,7,36,394,437,
Texas,U.S. Senate,Aaron Delozier,IND,700201,0,0,2,2,
Texas,U.S. Senate,Ray Woods,IND,700201,0,1,7,8,
Texas,U.S. Senate,Joan Farr,IND,700201,0,1,8,9,
Texas,U.S. Senate,Connie Johnson,DEM,700201,0,3,45,48,
Texas,U.S. Senate,James Lankford,REP,700201,6,40,396,442,
Texas,U.S. Senate,Mark Beard,IND,700201,0,2,14,16,
Texas,U.S. House,Frankie Robbins,DEM,700201,0,1,50,51,03
Texas,U.S. House,Frank Lucas,REP,700201,7,44,403,454,03
Texas,Governor,Joe Dorman,DEM,700202,0,2,27,29,
Texas,Governor,Mary Fallin,REP,700202,2,20,118,140,
Texas,Governor,Kimberly Willis,IND,700202,0,1,2,3,
Texas,Governor,Richard Prawdzienski,IND,700202,0,1,0,1,
Texas,Lieutenant Governor,Cathy Cummings,DEM,700202,0,4,20,24,
Texas,Lieutenant Governor,Todd Lamb,REP,700202,2,20,126,148,
Texas,Superintendent of Public Instruction,John Cox,DEM,700202,0,2,35,37,
Texas,Superintendent of Public Instruction,Joy Hofmeister,REP,700202,2,22,112,136,
Texas,Commissioner of Labor,Mike Workman,DEM,700202,0,5,22,27,
Texas,Commissioner of Labor,Mark Costello,REP,700202,2,19,123,144,
Texas,U.S. Senate,Matt Silverstein,DEM,700202,0,1,18,19,
Texas,U.S. Senate,Jim Inhofe,REP,700202,2,23,123,148,
Texas,U.S. Senate,Aaron Delozier,IND,700202,0,0,2,2,
Texas,U.S. Senate,Ray Woods,IND,700202,0,0,2,2,
Texas,U.S. Senate,Joan Farr,IND,700202,0,0,2,2,
Texas,U.S. Senate,Connie Johnson,DEM,700202,0,1,19,20,
Texas,U.S. Senate,James Lankford,REP,700202,2,23,124,149,
Texas,U.S. Senate,Mark Beard,IND,700202,0,0,3,3,
Texas,U.S. House,Frankie Robbins,DEM,700202,0,1,21,22,03
Texas,U.S. House,Frank Lucas,REP,700202,2,23,126,151,03
Texas,Governor,Joe Dorman,DEM,700205,1,16,67,84,
Texas,Governor,Mary Fallin,REP,700205,7,55,304,366,
Texas,Governor,Kimberly Willis,IND,700205,0,0,12,12,
Texas,Governor,Richard Prawdzienski,IND,700205,0,0,2,2,
Texas,Lieutenant Governor,Cathy Cummings,DEM,700205,0,14,40,54,
Texas,Lieutenant Governor,Todd Lamb,REP,700205,8,57,343,408,
Texas,Superintendent of Public Instruction,John Cox,DEM,700205,1,16,81,98,
Texas,Superintendent of Public Instruction,Joy Hofmeister,REP,700205,7,55,302,364,
Texas,Commissioner of Labor,Mike Workman,DEM,700205,0,14,55,69,
Texas,Commissioner of Labor,Mark Costello,REP,700205,8,55,326,389,
Texas,U.S. Senate,Matt Silverstein,DEM,700205,0,14,26,40,
Texas,U.S. Senate,Jim Inhofe,REP,700205,7,57,345,409,
Texas,U.S. Senate,Aaron Delozier,IND,700205,0,0,2,2,
Texas,U.S. Senate,Ray Woods,IND,700205,0,0,2,2,
Texas,U.S. Senate,Joan Farr,IND,700205,1,0,9,10,
Texas,U.S. Senate,Connie Johnson,DEM,700205,0,13,28,41,
Texas,U.S. Senate,James Lankford,REP,700205,8,57,342,407,
Texas,U.S. Senate,Mark Beard,IND,700205,0,1,12,13,
Texas,U.S. House,Frankie Robbins,DEM,700205,1,13,33,47,03
Texas,U.S. House,Frank Lucas,REP,700205,7,58,350,415,03
Texas,Governor,Joe Dorman,DEM,700302,0,0,16,16,
Texas,Governor,Mary Fallin,REP,700302,2,8,73,83,
Texas,Governor,Kimberly Willis,IND,700302,0,1,5,6,
Texas,Governor,Richard Prawdzienski,IND,700302,0,0,1,1,
Texas,Lieutenant Governor,Cathy Cummings,DEM,700302,0,1,13,14,
Texas,Lieutenant Governor,Todd Lamb,REP,700302,2,8,83,93,
Texas,Superintendent of Public Instruction,John Cox,DEM,700302,0,0,29,29,
Texas,Superintendent of Public Instruction,Joy Hofmeister,REP,700302,2,9,67,78,
Texas,Commissioner of Labor,Mike Workman,DEM,700302,0,1,19,20,
Texas,Commissioner of Labor,Mark Costello,REP,700302,2,8,76,86,
Texas,U.S. Senate,Matt Silverstein,DEM,700302,0,1,9,10,
Texas,U.S. Senate,Jim Inhofe,REP,700302,0,8,82,90,
Texas,U.S. Senate,Aaron Delozier,IND,700302,0,0,2,2,
Texas,U.S. Senate,Ray Woods,IND,700302,0,0,2,2,
Texas,U.S. Senate,Joan Farr,IND,700302,2,0,1,3,
Texas,U.S. Senate,Connie Johnson,DEM,700302,0,1,10,11,
Texas,U.S. Senate,James Lankford,REP,700302,0,8,80,88,
Texas,U.S. Senate,Mark Beard,IND,700302,2,0,5,7,
Texas,U.S. House,Frankie Robbins,DEM,700302,0,1,10,11,03
Texas,U.S. House,Frank Lucas,REP,700302,2,8,86,96,03
Texas,Governor,Joe Dorman,DEM,700303,3,0,50,53,
Texas,Governor,Mary Fallin,REP,700303,6,7,182,195,
Texas,Governor,Kimberly Willis,IND,700303,0,0,6,6,
Texas,Governor,Richard Prawdzienski,IND,700303,0,0,5,5,
Texas,Lieutenant Governor,Cathy Cummings,DEM,700303,2,0,30,32,
Texas,Lieutenant Governor,Todd Lamb,REP,700303,7,7,214,228,
Texas,Superintendent of Public Instruction,John Cox,DEM,700303,2,1,99,102,
Texas,Superintendent of Public Instruction,Joy Hofmeister,REP,700303,7,6,143,156,
Texas,Commissioner of Labor,Mike Workman,DEM,700303,3,0,43,46,
Texas,Commissioner of Labor,Mark Costello,REP,700303,6,7,197,210,
Texas,U.S. Senate,Matt Silverstein,DEM,700303,2,0,32,34,
Texas,U.S. Senate,Jim Inhofe,REP,700303,6,7,207,220,
Texas,U.S. Senate,Aaron Delozier,IND,700303,0,0,0,0,
Texas,U.S. Senate,Ray Woods,IND,700303,1,0,3,4,
Texas,U.S. Senate,Joan Farr,IND,700303,0,0,3,3,
Texas,U.S. Senate,Connie Johnson,DEM,700303,2,0,26,28,
Texas,U.S. Senate,James Lankford,REP,700303,7,7,210,224,
Texas,U.S. Senate,Mark Beard,IND,700303,0,0,9,9,
Texas,U.S. House,Frankie Robbins,DEM,700303,1,0,24,25,03
Texas,U.S. House,Frank Lucas,REP,700303,8,7,220,235,03
Texas,Governor,Joe Dorman,DEM,700304,0,1,85,86,
Texas,Governor,Mary Fallin,REP,700304,7,8,126,141,
Texas,Governor,Kimberly Willis,IND,700304,0,0,5,5,
Texas,Governor,Richard Prawdzienski,IND,700304,0,0,2,2,
Texas,Lieutenant Governor,Cathy Cummings,DEM,700304,0,0,52,52,
Texas,Lieutenant Governor,Todd Lamb,REP,700304,7,9,167,183,
Texas,Superintendent of Public Instruction,John Cox,DEM,700304,2,2,96,100,
Texas,Superintendent of Public Instruction,Joy Hofmeister,REP,700304,5,7,122,134,
Texas,Commissioner of Labor,Mike Workman,DEM,700304,1,0,69,70,
Texas,Commissioner of Labor,Mark Costello,REP,700304,6,9,147,162,
Texas,U.S. Senate,Matt Silverstein,DEM,700304,1,0,45,46,
Texas,U.S. Senate,Jim Inhofe,REP,700304,6,9,162,177,
Texas,U.S. Senate,Aaron Delozier,IND,700304,0,0,3,3,
Texas,U.S. Senate,Ray Woods,IND,700304,0,0,5,5,
Texas,U.S. Senate,Joan Farr,IND,700304,0,0,4,4,
Texas,U.S. Senate,Connie Johnson,DEM,700304,0,0,43,43,
Texas,U.S. Senate,James Lankford,REP,700304,7,8,162,177,
Texas,U.S. Senate,Mark Beard,IND,700304,0,1,13,14,
Texas,U.S. House,Frankie Robbins,DEM,700304,1,1,38,40,03
Texas,U.S. House,Frank Lucas,REP,700304,6,8,178,192,03
Texas,Governor,Joe Dorman,DEM,700305,2,10,101,113,
Texas,Governor,Mary Fallin,REP,700305,5,40,342,387,
Texas,Governor,Kimberly Willis,IND,700305,0,2,9,11,
Texas,Governor,Richard Prawdzienski,IND,700305,0,2,8,10,
Texas,Lieutenant Governor,Cathy Cummings,DEM,700305,2,12,69,83,
Texas,Lieutenant Governor,Todd Lamb,REP,700305,5,42,391,438,
Texas,Superintendent of Public Instruction,John Cox,DEM,700305,2,13,122,137,
Texas,Superintendent of Public Instruction,Joy Hofmeister,REP,700305,5,41,339,385,
Texas,Commissioner of Labor,Mike Workman,DEM,700305,2,10,92,104,
Texas,Commissioner of Labor,Mark Costello,REP,700305,5,44,367,416,
Texas,U.S. Senate,Matt Silverstein,DEM,700305,1,8,53,62,
Texas,U.S. Senate,Jim Inhofe,REP,700305,5,44,395,444,
Texas,U.S. Senate,Aaron Delozier,IND,700305,1,0,1,2,
Texas,U.S. Senate,Ray Woods,IND,700305,0,1,5,6,
Texas,U.S. Senate,Joan Farr,IND,700305,0,1,6,7,
Texas,U.S. Senate,Connie Johnson,DEM,700305,1,10,64,75,
Texas,U.S. Senate,James Lankford,REP,700305,6,42,375,423,
Texas,U.S. Senate,Mark Beard,IND,700305,0,2,21,23,
Texas,U.S. House,Frankie Robbins,DEM,700305,2,9,52,63,03
Texas,U.S. House,Frank Lucas,REP,700305,5,45,407,457,03
Tillman,Governor,Joe Dorman,DEM,710001,5,27,107,139,
Tillman,Governor,Mary Fallin,REP,710001,4,31,192,227,
Tillman,Governor,Kimberly Willis,IND,710001,0,1,4,5,
Tillman,Governor,Richard Prawdzienski,IND,710001,0,0,5,5,
Tillman,Lieutenant Governor,Cathy Cummings,DEM,710001,2,16,63,81,
Tillman,Lieutenant Governor,Todd Lamb,REP,710001,7,43,241,291,
Tillman,Superintendent of Public Instruction,John Cox,DEM,710001,7,29,148,184,
Tillman,Superintendent of Public Instruction,Joy Hofmeister,REP,710001,2,29,158,189,
Tillman,Commissioner of Labor,Mike Workman,DEM,710001,4,19,90,113,
Tillman,Commissioner of Labor,Mark Costello,REP,710001,5,36,209,250,
Tillman,U.S. Senate,Matt Silverstein,DEM,710001,2,17,52,71,
Tillman,U.S. Senate,Jim Inhofe,REP,710001,6,42,246,294,
Tillman,U.S. Senate,Aaron Delozier,IND,710001,0,0,1,1,
Tillman,U.S. Senate,Ray Woods,IND,710001,1,0,3,4,
Tillman,U.S. Senate,Joan Farr,IND,710001,0,0,5,5,
Tillman,U.S. Senate,Connie Johnson,DEM,710001,3,15,62,80,
Tillman,U.S. Senate,James Lankford,REP,710001,6,43,237,286,
Tillman,U.S. Senate,Mark Beard,IND,710001,0,1,5,6,
Tillman,U.S. House,Bert Smith,DEM,710001,0,12,49,61,04
Tillman,U.S. House,Tom Cole,REP,710001,9,47,250,306,04
Tillman,U.S. House,Dennis Johnson,IND,710001,0,0,6,6,04
Tillman,State House,Juan Rodriguez,DEM,710001,4,23,93,120,63
Tillman,State House,Jeff Coody,REP,710001,5,36,213,254,63
Tillman,Governor,Joe Dorman,DEM,710002,0,11,67,78,
Tillman,Governor,Mary Fallin,REP,710002,1,3,98,102,
Tillman,Governor,Kimberly Willis,IND,710002,0,0,4,4,
Tillman,Governor,Richard Prawdzienski,IND,710002,0,0,5,5,
Tillman,Lieutenant Governor,Cathy Cummings,DEM,710002,0,3,41,44,
Tillman,Lieutenant Governor,Todd Lamb,REP,710002,1,11,131,143,
Tillman,Superintendent of Public Instruction,John Cox,DEM,710002,0,6,78,84,
Tillman,Superintendent of Public Instruction,Joy Hofmeister,REP,710002,1,7,95,103,
Tillman,Commissioner of Labor,Mike Workman,DEM,710002,0,10,65,75,
Tillman,Commissioner of Labor,Mark Costello,REP,710002,1,3,105,109,
Tillman,U.S. Senate,Matt Silverstein,DEM,710002,0,6,38,44,
Tillman,U.S. Senate,Jim Inhofe,REP,710002,1,8,126,135,
Tillman,U.S. Senate,Aaron Delozier,IND,710002,0,0,1,1,
Tillman,U.S. Senate,Ray Woods,IND,710002,0,0,4,4,
Tillman,U.S. Senate,Joan Farr,IND,710002,0,0,3,3,
Tillman,U.S. Senate,Connie Johnson,DEM,710002,0,5,46,51,
Tillman,U.S. Senate,James Lankford,REP,710002,1,9,123,133,
Tillman,U.S. Senate,Mark Beard,IND,710002,0,0,4,4,
Tillman,U.S. House,Bert Smith,DEM,710002,0,5,31,36,04
Tillman,U.S. House,Tom Cole,REP,710002,1,9,134,144,04
Tillman,U.S. House,Dennis Johnson,IND,710002,0,0,7,7,04
Tillman,State House,Juan Rodriguez,DEM,710002,0,7,67,74,63
Tillman,State House,Jeff Coody,REP,710002,1,7,106,114,63
Tillman,Governor,Joe Dorman,DEM,710003,1,7,33,41,
Tillman,Governor,Mary Fallin,REP,710003,0,14,38,52,
Tillman,Governor,Kimberly Willis,IND,710003,0,0,1,1,
Tillman,Governor,Richard Prawdzienski,IND,710003,0,0,3,3,
Tillman,Lieutenant Governor,Cathy Cummings,DEM,710003,1,4,27,32,
Tillman,Lieutenant Governor,Todd Lamb,REP,710003,0,17,47,64,
Tillman,Superintendent of Public Instruction,John Cox,DEM,710003,1,8,40,49,
Tillman,Superintendent of Public Instruction,Joy Hofmeister,REP,710003,0,13,35,48,
Tillman,Commissioner of Labor,Mike Workman,DEM,710003,1,6,29,36,
Tillman,Commissioner of Labor,Mark Costello,REP,710003,0,15,42,57,
Tillman,U.S. Senate,Matt Silverstein,DEM,710003,0,5,22,27,
Tillman,U.S. Senate,Jim Inhofe,REP,710003,1,16,51,68,
Tillman,U.S. Senate,Aaron Delozier,IND,710003,0,0,0,0,
Tillman,U.S. Senate,Ray Woods,IND,710003,0,0,1,1,
Tillman,U.S. Senate,Joan Farr,IND,710003,0,0,1,1,
Tillman,U.S. Senate,Connie Johnson,DEM,710003,1,3,23,27,
Tillman,U.S. Senate,James Lankford,REP,710003,0,18,52,70,
Tillman,U.S. Senate,Mark Beard,IND,710003,0,0,0,0,
Tillman,U.S. House,Bert Smith,DEM,710003,0,4,22,26,04
Tillman,U.S. House,Tom Cole,REP,710003,1,17,51,69,04
Tillman,U.S. House,Dennis Johnson,IND,710003,0,0,1,1,04
Tillman,State House,Juan Rodriguez,DEM,710003,1,8,42,51,63
Tillman,State House,Jeff Coody,REP,710003,0,12,33,45,63
Tillman,Governor,Joe Dorman,DEM,710004,2,1,57,60,
Tillman,Governor,Mary Fallin,REP,710004,1,5,63,69,
Tillman,Governor,Kimberly Willis,IND,710004,0,0,3,3,
Tillman,Governor,Richard Prawdzienski,IND,710004,0,0,1,1,
Tillman,Lieutenant Governor,Cathy Cummings,DEM,710004,2,0,49,51,
Tillman,Lieutenant Governor,Todd Lamb,REP,710004,0,6,75,81,
Tillman,Superintendent of Public Instruction,John Cox,DEM,710004,3,1,63,67,
Tillman,Superintendent of Public Instruction,Joy Hofmeister,REP,710004,0,5,61,66,
Tillman,Commissioner of Labor,Mike Workman,DEM,710004,2,1,56,59,
Tillman,Commissioner of Labor,Mark Costello,REP,710004,1,5,68,74,
Tillman,U.S. Senate,Matt Silverstein,DEM,710004,2,0,44,46,
Tillman,U.S. Senate,Jim Inhofe,REP,710004,1,6,74,81,
Tillman,U.S. Senate,Aaron Delozier,IND,710004,0,0,0,0,
Tillman,U.S. Senate,Ray Woods,IND,710004,0,0,4,4,
Tillman,U.S. Senate,Joan Farr,IND,710004,0,0,2,2,
Tillman,U.S. Senate,Connie Johnson,DEM,710004,3,0,50,53,
Tillman,U.S. Senate,James Lankford,REP,710004,0,6,72,78,
Tillman,U.S. Senate,Mark Beard,IND,710004,0,0,1,1,
Tillman,U.S. House,Bert Smith,DEM,710004,2,0,42,44,04
Tillman,U.S. House,Tom Cole,REP,710004,1,6,77,84,04
Tillman,U.S. House,Dennis Johnson,IND,710004,0,0,5,5,04
Tillman,State House,Juan Rodriguez,DEM,710004,3,1,60,64,63
Tillman,State House,Jeff Coody,REP,710004,0,5,63,68,63
Tillman,Governor,Joe Dorman,DEM,710006,2,5,46,53,
Tillman,Governor,Mary Fallin,REP,710006,2,2,62,66,
Tillman,Governor,Kimberly Willis,IND,710006,0,0,0,0,
Tillman,Governor,Richard Prawdzienski,IND,710006,0,0,0,0,
Tillman,Lieutenant Governor,Cathy Cummings,DEM,710006,0,3,24,27,
Tillman,Lieutenant Governor,Todd Lamb,REP,710006,4,4,84,92,
Tillman,Superintendent of Public Instruction,John Cox,DEM,710006,1,3,49,53,
Tillman,Superintendent of Public Instruction,Joy Hofmeister,REP,710006,3,4,59,66,
Tillman,Commissioner of Labor,Mike Workman,DEM,710006,1,5,38,44,
Tillman,Commissioner of Labor,Mark Costello,REP,710006,3,2,68,73,
Tillman,U.S. Senate,Matt Silverstein,DEM,710006,0,3,20,23,
Tillman,U.S. Senate,Jim Inhofe,REP,710006,4,4,88,96,
Tillman,U.S. Senate,Aaron Delozier,IND,710006,0,0,0,0,
Tillman,U.S. Senate,Ray Woods,IND,710006,0,0,0,0,
Tillman,U.S. Senate,Joan Farr,IND,710006,0,0,0,0,
Tillman,U.S. Senate,Connie Johnson,DEM,710006,0,4,23,27,
Tillman,U.S. Senate,James Lankford,REP,710006,4,3,85,92,
Tillman,U.S. Senate,Mark Beard,IND,710006,0,0,0,0,
Tillman,U.S. House,Bert Smith,DEM,710006,0,1,17,18,04
Tillman,U.S. House,Tom Cole,REP,710006,4,6,91,101,04
Tillman,U.S. House,Dennis Johnson,IND,710006,0,0,0,0,04
Tillman,State House,Juan Rodriguez,DEM,710006,2,2,54,58,63
Tillman,State House,Jeff Coody,REP,710006,2,5,54,61,63
Tillman,Governor,Joe Dorman,DEM,710007,0,2,93,95,
Tillman,Governor,Mary Fallin,REP,710007,1,1,202,204,
Tillman,Governor,Kimberly Willis,IND,710007,0,0,8,8,
Tillman,Governor,Richard Prawdzienski,IND,710007,0,0,3,3,
Tillman,Lieutenant Governor,Cathy Cummings,DEM,710007,0,0,74,74,
Tillman,Lieutenant Governor,Todd Lamb,REP,710007,1,3,229,233,
Tillman,Superintendent of Public Instruction,John Cox,DEM,710007,0,0,111,111,
Tillman,Superintendent of Public Instruction,Joy Hofmeister,REP,710007,1,3,186,190,
Tillman,Commissioner of Labor,Mike Workman,DEM,710007,0,1,100,101,
Tillman,Commissioner of Labor,Mark Costello,REP,710007,1,2,194,197,
Tillman,U.S. Senate,Matt Silverstein,DEM,710007,0,0,55,55,
Tillman,U.S. Senate,Jim Inhofe,REP,710007,1,3,236,240,
Tillman,U.S. Senate,Aaron Delozier,IND,710007,0,0,2,2,
Tillman,U.S. Senate,Ray Woods,IND,710007,0,0,6,6,
Tillman,U.S. Senate,Joan Farr,IND,710007,0,0,2,2,
Tillman,U.S. Senate,Connie Johnson,DEM,710007,0,0,67,67,
Tillman,U.S. Senate,James Lankford,REP,710007,1,3,223,227,
Tillman,U.S. Senate,Mark Beard,IND,710007,0,0,12,12,
Tillman,U.S. House,Bert Smith,DEM,710007,0,0,54,54,04
Tillman,U.S. House,Tom Cole,REP,710007,1,3,242,246,04
Tillman,U.S. House,Dennis Johnson,IND,710007,0,0,9,9,04
Tillman,State House,Juan Rodriguez,DEM,710007,0,0,59,59,63
Tillman,State House,Jeff Coody,REP,710007,1,3,249,253,63
Tillman,Governor,Joe Dorman,DEM,710009,0,5,43,48,
Tillman,Governor,Mary Fallin,REP,710009,1,5,51,57,
Tillman,Governor,Kimberly Willis,IND,710009,0,1,2,3,
Tillman,Governor,Richard Prawdzienski,IND,710009,0,0,2,2,
Tillman,Lieutenant Governor,Cathy Cummings,DEM,710009,0,4,36,40,
Tillman,Lieutenant Governor,Todd Lamb,REP,710009,1,7,61,69,
Tillman,Superintendent of Public Instruction,John Cox,DEM,710009,0,5,54,59,
Tillman,Superintendent of Public Instruction,Joy Hofmeister,REP,710009,1,6,43,50,
Tillman,Commissioner of Labor,Mike Workman,DEM,710009,0,3,45,48,
Tillman,Commissioner of Labor,Mark Costello,REP,710009,1,8,47,56,
Tillman,U.S. Senate,Matt Silverstein,DEM,710009,0,3,32,35,
Tillman,U.S. Senate,Jim Inhofe,REP,710009,1,7,63,71,
Tillman,U.S. Senate,Aaron Delozier,IND,710009,0,0,0,0,
Tillman,U.S. Senate,Ray Woods,IND,710009,0,0,2,2,
Tillman,U.S. Senate,Joan Farr,IND,710009,0,1,0,1,
Tillman,U.S. Senate,Connie Johnson,DEM,710009,0,4,34,38,
Tillman,U.S. Senate,James Lankford,REP,710009,1,7,56,64,
Tillman,U.S. Senate,Mark Beard,IND,710009,0,0,3,3,
Tillman,U.S. House,Bert Smith,DEM,710009,0,4,29,33,04
Tillman,U.S. House,Tom Cole,REP,710009,1,7,66,74,04
Tillman,U.S. House,Dennis Johnson,IND,710009,0,0,1,1,04
Tillman,State House,Juan Rodriguez,DEM,710009,1,4,48,53,63
Tillman,State House,Jeff Coody,REP,710009,0,7,50,57,63
Tillman,Governor,Joe Dorman,DEM,710010,2,2,93,97,
Tillman,Governor,Mary Fallin,REP,710010,7,7,160,174,
Tillman,Governor,Kimberly Willis,IND,710010,0,0,7,7,
Tillman,Governor,Richard Prawdzienski,IND,710010,0,0,5,5,
Tillman,Lieutenant Governor,Cathy Cummings,DEM,710010,1,3,57,61,
Tillman,Lieutenant Governor,Todd Lamb,REP,710010,7,6,208,221,
Tillman,Superintendent of Public Instruction,John Cox,DEM,710010,4,4,125,133,
Tillman,Superintendent of Public Instruction,Joy Hofmeister,REP,710010,4,5,140,149,
Tillman,Commissioner of Labor,Mike Workman,DEM,710010,2,3,89,94,
Tillman,Commissioner of Labor,Mark Costello,REP,710010,7,6,172,185,
Tillman,U.S. Senate,Matt Silverstein,DEM,710010,0,0,51,51,
Tillman,U.S. Senate,Jim Inhofe,REP,710010,9,9,209,227,
Tillman,U.S. Senate,Aaron Delozier,IND,710010,0,0,0,0,
Tillman,U.S. Senate,Ray Woods,IND,710010,0,0,4,4,
Tillman,U.S. Senate,Joan Farr,IND,710010,0,0,2,2,
Tillman,U.S. Senate,Connie Johnson,DEM,710010,0,0,60,60,
Tillman,U.S. Senate,James Lankford,REP,710010,7,9,198,214,
Tillman,U.S. Senate,Mark Beard,IND,710010,2,0,7,9,
Tillman,U.S. House,Bert Smith,DEM,710010,1,0,52,53,04
Tillman,U.S. House,Tom Cole,REP,710010,8,9,208,225,04
Tillman,U.S. House,Dennis Johnson,IND,710010,0,0,6,6,04
Tillman,State House,Juan Rodriguez,DEM,710010,2,2,84,88,63
Tillman,State House,Jeff Coody,REP,710010,7,7,185,199,63
Tillman,Governor,Joe Dorman,DEM,710012,1,4,28,33,
Tillman,Governor,Mary Fallin,REP,710012,0,3,37,40,
Tillman,Governor,Kimberly Willis,IND,710012,0,0,3,3,
Tillman,Governor,Richard Prawdzienski,IND,710012,0,0,0,0,
Tillman,Lieutenant Governor,Cathy Cummings,DEM,710012,1,1,12,14,
Tillman,Lieutenant Governor,Todd Lamb,REP,710012,0,6,56,62,
Tillman,Superintendent of Public Instruction,John Cox,DEM,710012,1,4,28,33,
Tillman,Superintendent of Public Instruction,Joy Hofmeister,REP,710012,0,3,39,42,
Tillman,Commissioner of Labor,Mike Workman,DEM,710012,1,1,22,24,
Tillman,Commissioner of Labor,Mark Costello,REP,710012,0,5,44,49,
Tillman,U.S. Senate,Matt Silverstein,DEM,710012,1,0,14,15,
Tillman,U.S. Senate,Jim Inhofe,REP,710012,0,6,53,59,
Tillman,U.S. Senate,Aaron Delozier,IND,710012,0,0,0,0,
Tillman,U.S. Senate,Ray Woods,IND,710012,0,0,0,0,
Tillman,U.S. Senate,Joan Farr,IND,710012,0,0,1,1,
Tillman,U.S. Senate,Connie Johnson,DEM,710012,1,0,19,20,
Tillman,U.S. Senate,James Lankford,REP,710012,0,7,48,55,
Tillman,U.S. Senate,Mark Beard,IND,710012,0,0,1,1,
Tillman,U.S. House,Bert Smith,DEM,710012,1,0,14,15,04
Tillman,U.S. House,Tom Cole,REP,710012,0,7,52,59,04
Tillman,U.S. House,Dennis Johnson,IND,710012,0,0,1,1,04
Tillman,State House,Juan Rodriguez,DEM,710012,1,5,24,30,63
Tillman,State House,Jeff Coody,REP,710012,0,2,44,46,63
Tulsa,Governor,Joe Dorman,DEM,720001,0,0,412,412,
Tulsa,Governor,Mary Fallin,REP,720001,0,0,23,23,
Tulsa,Governor,Kimberly Willis,IND,720001,0,0,5,5,
Tulsa,Governor,Richard Prawdzienski,IND,720001,0,0,1,1,
Tulsa,Lieutenant Governor,Cathy Cummings,DEM,720001,0,0,413,413,
Tulsa,Lieutenant Governor,Todd Lamb,REP,720001,0,0,28,28,
Tulsa,Superintendent of Public Instruction,John Cox,DEM,720001,0,0,407,407,
Tulsa,Superintendent of Public Instruction,Joy Hofmeister,REP,720001,0,0,34,34,
Tulsa,Commissioner of Labor,Mike Workman,DEM,720001,0,0,422,422,
Tulsa,Commissioner of Labor,Mark Costello,REP,720001,0,0,19,19,
Tulsa,U.S. Senate,Matt Silverstein,DEM,720001,0,0,391,391,
Tulsa,U.S. Senate,Jim Inhofe,REP,720001,0,0,33,33,
Tulsa,U.S. Senate,Aaron Delozier,IND,720001,0,0,4,4,
Tulsa,U.S. Senate,Ray Woods,IND,720001,0,0,7,7,
Tulsa,U.S. Senate,Joan Farr,IND,720001,0,0,5,5,
Tulsa,U.S. Senate,Connie Johnson,DEM,720001,0,0,409,409,
Tulsa,U.S. Senate,James Lankford,REP,720001,0,0,23,23,
Tulsa,U.S. Senate,Mark Beard,IND,720001,0,0,8,8,
Tulsa,Governor,Joe Dorman,DEM,720002,0,0,375,375,
Tulsa,Governor,Mary Fallin,REP,720002,0,0,37,37,
Tulsa,Governor,Kimberly Willis,IND,720002,0,0,8,8,
Tulsa,Governor,Richard Prawdzienski,IND,720002,0,0,3,3,
Tulsa,Lieutenant Governor,Cathy Cummings,DEM,720002,0,0,368,368,
Tulsa,Lieutenant Governor,Todd Lamb,REP,720002,0,0,56,56,
Tulsa,Superintendent of Public Instruction,John Cox,DEM,720002,0,0,377,377,
Tulsa,Superintendent of Public Instruction,Joy Hofmeister,REP,720002,0,0,48,48,
Tulsa,Commissioner of Labor,Mike Workman,DEM,720002,0,0,384,384,
Tulsa,Commissioner of Labor,Mark Costello,REP,720002,0,0,39,39,
Tulsa,U.S. Senate,Matt Silverstein,DEM,720002,0,0,365,365,
Tulsa,U.S. Senate,Jim Inhofe,REP,720002,0,0,47,47,
Tulsa,U.S. Senate,Aaron Delozier,IND,720002,0,0,4,4,
Tulsa,U.S. Senate,Ray Woods,IND,720002,0,0,0,0,
Tulsa,U.S. Senate,Joan Farr,IND,720002,0,0,7,7,
Tulsa,U.S. Senate,Connie Johnson,DEM,720002,0,0,371,371,
Tulsa,U.S. Senate,James Lankford,REP,720002,0,0,45,45,
Tulsa,U.S. Senate,Mark Beard,IND,720002,0,0,9,9,
Tulsa,Governor,Joe Dorman,DEM,720003,0,0,97,97,
Tulsa,Governor,Mary Fallin,REP,720003,0,0,73,73,
Tulsa,Governor,Kimberly Willis,IND,720003,0,0,10,10,
Tulsa,Governor,Richard Prawdzienski,IND,720003,0,0,6,6,
Tulsa,Lieutenant Governor,Cathy Cummings,DEM,720003,0,0,95,95,
Tulsa,Lieutenant Governor,Todd Lamb,REP,720003,0,0,90,90,
Tulsa,Superintendent of Public Instruction,John Cox,DEM,720003,0,0,114,114,
Tulsa,Superintendent of Public Instruction,Joy Hofmeister,REP,720003,0,0,70,70,
Tulsa,Commissioner of Labor,Mike Workman,DEM,720003,0,0,97,97,
Tulsa,Commissioner of Labor,Mark Costello,REP,720003,0,0,82,82,
Tulsa,U.S. Senate,Matt Silverstein,DEM,720003,0,0,92,92,
Tulsa,U.S. Senate,Jim Inhofe,REP,720003,0,0,81,81,
Tulsa,U.S. Senate,Aaron Delozier,IND,720003,0,0,4,4,
Tulsa,U.S. Senate,Ray Woods,IND,720003,0,0,4,4,
Tulsa,U.S. Senate,Joan Farr,IND,720003,0,0,5,5,
Tulsa,U.S. Senate,Connie Johnson,DEM,720003,0,0,97,97,
Tulsa,U.S. Senate,James Lankford,REP,720003,0,0,80,80,
Tulsa,U.S. Senate,Mark Beard,IND,720003,0,0,7,7,
Tulsa,Governor,Joe Dorman,DEM,720004,0,0,479,479,
Tulsa,Governor,Mary Fallin,REP,720004,0,0,25,25,
Tulsa,Governor,Kimberly Willis,IND,720004,0,0,4,4,
Tulsa,Governor,Richard Prawdzienski,IND,720004,0,0,1,1,
Tulsa,Lieutenant Governor,Cathy Cummings,DEM,720004,0,0,470,470,
Tulsa,Lieutenant Governor,Todd Lamb,REP,720004,0,0,37,37,
Tulsa,Superintendent of Public Instruction,John Cox,DEM,720004,0,0,467,467,
Tulsa,Superintendent of Public Instruction,Joy Hofmeister,REP,720004,0,0,41,41,
Tulsa,Commissioner of Labor,Mike Workman,DEM,720004,0,0,467,467,
Tulsa,Commissioner of Labor,Mark Costello,REP,720004,0,0,36,36,
Tulsa,U.S. Senate,Matt Silverstein,DEM,720004,0,0,456,456,
Tulsa,U.S. Senate,Jim Inhofe,REP,720004,0,0,36,36,
Tulsa,U.S. Senate,Aaron Delozier,IND,720004,0,0,2,2,
Tulsa,U.S. Senate,Ray Woods,IND,720004,0,0,7,7,
Tulsa,U.S. Senate,Joan Farr,IND,720004,0,0,6,6,
Tulsa,U.S. Senate,Connie Johnson,DEM,720004,0,0,476,476,
Tulsa,U.S. Senate,James Lankford,REP,720004,0,0,29,29,
Tulsa,U.S. Senate,Mark Beard,IND,720004,0,0,3,3,
Tulsa,Governor,Joe Dorman,DEM,720005,0,0,212,212,
Tulsa,Governor,Mary Fallin,REP,720005,0,0,18,18,
Tulsa,Governor,Kimberly Willis,IND,720005,0,0,2,2,
Tulsa,Governor,Richard Prawdzienski,IND,720005,0,0,4,4,
Tulsa,Lieutenant Governor,Cathy Cummings,DEM,720005,0,0,203,203,
Tulsa,Lieutenant Governor,Todd Lamb,REP,720005,0,0,29,29,
Tulsa,Superintendent of Public Instruction,John Cox,DEM,720005,0,0,210,210,
Tulsa,Superintendent of Public Instruction,Joy Hofmeister,REP,720005,0,0,25,25,
Tulsa,Commissioner of Labor,Mike Workman,DEM,720005,0,0,209,209,
Tulsa,Commissioner of Labor,Mark Costello,REP,720005,0,0,24,24,
Tulsa,U.S. Senate,Matt Silverstein,DEM,720005,0,0,199,199,
Tulsa,U.S. Senate,Jim Inhofe,REP,720005,0,0,26,26,
Tulsa,U.S. Senate,Aaron Delozier,IND,720005,0,0,3,3,
Tulsa,U.S. Senate,Ray Woods,IND,720005,0,0,2,2,
Tulsa,U.S. Senate,Joan Farr,IND,720005,0,0,3,3,
Tulsa,U.S. Senate,Connie Johnson,DEM,720005,0,0,205,205,
Tulsa,U.S. Senate,James Lankford,REP,720005,0,0,21,21,
Tulsa,U.S. Senate,Mark Beard,IND,720005,0,0,5,5,
Tulsa,Governor,Joe Dorman,DEM,720006,0,0,552,552,
Tulsa,Governor,Mary Fallin,REP,720006,0,0,19,19,
Tulsa,Governor,Kimberly Willis,IND,720006,0,0,11,11,
Tulsa,Governor,Richard Prawdzienski,IND,720006,0,0,4,4,
Tulsa,Lieutenant Governor,Cathy Cummings,DEM,720006,0,0,550,550,
Tulsa,Lieutenant Governor,Todd Lamb,REP,720006,0,0,36,36,
Tulsa,Superintendent of Public Instruction,John Cox,DEM,720006,0,0,546,546,
Tulsa,Superintendent of Public Instruction,Joy Hofmeister,REP,720006,0,0,38,38,
Tulsa,Commissioner of Labor,Mike Workman,DEM,720006,0,0,559,559,
Tulsa,Commissioner of Labor,Mark Costello,REP,720006,0,0,23,23,
Tulsa,U.S. Senate,Matt Silverstein,DEM,720006,0,0,533,533,
Tulsa,U.S. Senate,Jim Inhofe,REP,720006,0,0,36,36,
Tulsa,U.S. Senate,Aaron Delozier,IND,720006,0,0,3,3,
Tulsa,U.S. Senate,Ray Woods,IND,720006,0,0,7,7,
Tulsa,U.S. Senate,Joan Farr,IND,720006,0,0,5,5,
Tulsa,U.S. Senate,Connie Johnson,DEM,720006,0,0,561,561,
Tulsa,U.S. Senate,James Lankford,REP,720006,0,0,19,19,
Tulsa,U.S. Senate,Mark Beard,IND,720006,0,0,8,8,
Tulsa,Governor,Joe Dorman,DEM,720007,0,0,291,291,
Tulsa,Governor,Mary Fallin,REP,720007,0,0,24,24,
Tulsa,Governor,Kimberly Willis,IND,720007,0,0,3,3,
Tulsa,Governor,Richard Prawdzienski,IND,720007,0,0,3,3,
Tulsa,Lieutenant Governor,Cathy Cummings,DEM,720007,0,0,274,274,
Tulsa,Lieutenant Governor,Todd Lamb,REP,720007,0,0,43,43,
Tulsa,Superintendent of Public Instruction,John Cox,DEM,720007,0,0,279,279,
Tulsa,Superintendent of Public Instruction,Joy Hofmeister,REP,720007,0,0,36,36,
Tulsa,Commissioner of Labor,Mike Workman,DEM,720007,0,0,278,278,
Tulsa,Commissioner of Labor,Mark Costello,REP,720007,0,0,35,35,
Tulsa,U.S. Senate,Matt Silverstein,DEM,720007,0,0,271,271,
Tulsa,U.S. Senate,Jim Inhofe,REP,720007,0,0,33,33,
Tulsa,U.S. Senate,Aaron Delozier,IND,720007,0,0,5,5,
Tulsa,U.S. Senate,Ray Woods,IND,720007,0,0,4,4,
Tulsa,U.S. Senate,Joan Farr,IND,720007,0,0,4,4,
Tulsa,U.S. Senate,Connie Johnson,DEM,720007,0,0,278,278,
Tulsa,U.S. Senate,James Lankford,REP,720007,0,0,33,33,
Tulsa,U.S. Senate,Mark Beard,IND,720007,0,0,4,4,
Tulsa,Governor,Joe Dorman,DEM,720008,0,0,260,260,
Tulsa,Governor,Mary Fallin,REP,720008,0,0,35,35,
Tulsa,Governor,Kimberly Willis,IND,720008,0,0,10,10,
Tulsa,Governor,Richard Prawdzienski,IND,720008,0,0,3,3,
Tulsa,Lieutenant Governor,Cathy Cummings,DEM,720008,0,0,251,251,
Tulsa,Lieutenant Governor,Todd Lamb,REP,720008,0,0,55,55,
Tulsa,Superintendent of Public Instruction,John Cox,DEM,720008,0,0,260,260,
Tulsa,Superintendent of Public Instruction,Joy Hofmeister,REP,720008,0,0,47,47,
Tulsa,Commissioner of Labor,Mike Workman,DEM,720008,0,0,264,264,
Tulsa,Commissioner of Labor,Mark Costello,REP,720008,0,0,40,40,
Tulsa,U.S. Senate,Matt Silverstein,DEM,720008,0,0,254,254,
Tulsa,U.S. Senate,Jim Inhofe,REP,720008,0,0,42,42,
Tulsa,U.S. Senate,Aaron Delozier,IND,720008,0,0,4,4,
Tulsa,U.S. Senate,Ray Woods,IND,720008,0,0,3,3,
Tulsa,U.S. Senate,Joan Farr,IND,720008,0,0,5,5,
Tulsa,U.S. Senate,Connie Johnson,DEM,720008,0,0,260,260,
Tulsa,U.S. Senate,James Lankford,REP,720008,0,0,38,38,
Tulsa,U.S. Senate,Mark Beard,IND,720008,0,0,6,6,
Tulsa,Governor,Joe Dorman,DEM,720009,0,0,81,81,
Tulsa,Governor,Mary Fallin,REP,720009,0,0,12,12,
Tulsa,Governor,Kimberly Willis,IND,720009,0,0,2,2,
Tulsa,Governor,Richard Prawdzienski,IND,720009,0,0,0,0,
Tulsa,Lieutenant Governor,Cathy Cummings,DEM,720009,0,0,84,84,
Tulsa,Lieutenant Governor,Todd Lamb,REP,720009,0,0,11,11,
Tulsa,Superintendent of Public Instruction,John Cox,DEM,720009,0,0,83,83,
Tulsa,Superintendent of Public Instruction,Joy Hofmeister,REP,720009,0,0,11,11,
Tulsa,Commissioner of Labor,Mike Workman,DEM,720009,0,0,87,87,
Tulsa,Commissioner of Labor,Mark Costello,REP,720009,0,0,8,8,
Tulsa,U.S. Senate,Matt Silverstein,DEM,720009,0,0,75,75,
Tulsa,U.S. Senate,Jim Inhofe,REP,720009,0,0,13,13,
Tulsa,U.S. Senate,Aaron Delozier,IND,720009,0,0,0,0,
Tulsa,U.S. Senate,Ray Woods,IND,720009,0,0,2,2,
Tulsa,U.S. Senate,Joan Farr,IND,720009,0,0,3,3,
Tulsa,U.S. Senate,Connie Johnson,DEM,720009,0,0,84,84,
Tulsa,U.S. Senate,James Lankford,REP,720009,0,0,10,10,
Tulsa,U.S. Senate,Mark Beard,IND,720009,0,0,1,1,
Tulsa,Governor,Joe Dorman,DEM,720010,0,0,297,297,
Tulsa,Governor,Mary Fallin,REP,720010,0,0,20,20,
Tulsa,Governor,Kimberly Willis,IND,720010,0,0,9,9,
Tulsa,Governor,Richard Prawdzienski,IND,720010,0,0,0,0,
Tulsa,Lieutenant Governor,Cathy Cummings,DEM,720010,0,0,300,300,
Tulsa,Lieutenant Governor,Todd Lamb,REP,720010,0,0,24,24,
Tulsa,Superintendent of Public Instruction,John Cox,DEM,720010,0,0,298,298,
Tulsa,Superintendent of Public Instruction,Joy Hofmeister,REP,720010,0,0,27,27,
Tulsa,Commissioner of Labor,Mike Workman,DEM,720010,0,0,298,298,
Tulsa,Commissioner of Labor,Mark Costello,REP,720010,0,0,23,23,
Tulsa,U.S. Senate,Matt Silverstein,DEM,720010,0,0,289,289,
Tulsa,U.S. Senate,Jim Inhofe,REP,720010,0,0,29,29,
Tulsa,U.S. Senate,Aaron Delozier,IND,720010,0,0,1,1,
Tulsa,U.S. Senate,Ray Woods,IND,720010,0,0,4,4,
Tulsa,U.S. Senate,Joan Farr,IND,720010,0,0,3,3,
Tulsa,U.S. Senate,Connie Johnson,DEM,720010,0,0,296,296,
Tulsa,U.S. Senate,James Lankford,REP,720010,0,0,20,20,
Tulsa,U.S. Senate,Mark Beard,IND,720010,0,0,8,8,
Tulsa,Governor,Joe Dorman,DEM,720011,0,0,130,130,
Tulsa,Governor,Mary Fallin,REP,720011,0,0,81,81,
Tulsa,Governor,Kimberly Willis,IND,720011,0,0,8,8,
Tulsa,Governor,Richard Prawdzienski,IND,720011,0,0,6,6,
Tulsa,Lieutenant Governor,Cathy Cummings,DEM,720011,0,0,132,132,
Tulsa,Lieutenant Governor,Todd Lamb,REP,720011,0,0,93,93,
Tulsa,Superintendent of Public Instruction,John Cox,DEM,720011,0,0,147,147,
Tulsa,Superintendent of Public Instruction,Joy Hofmeister,REP,720011,0,0,76,76,
Tulsa,Commissioner of Labor,Mike Workman,DEM,720011,0,0,146,146,
Tulsa,Commissioner of Labor,Mark Costello,REP,720011,0,0,77,77,
Tulsa,U.S. Senate,Matt Silverstein,DEM,720011,0,0,118,118,
Tulsa,U.S. Senate,Jim Inhofe,REP,720011,0,0,95,95,
Tulsa,U.S. Senate,Aaron Delozier,IND,720011,0,0,6,6,
Tulsa,U.S. Senate,Ray Woods,IND,720011,0,0,2,2,
Tulsa,U.S. Senate,Joan Farr,IND,720011,0,0,4,4,
Tulsa,U.S. Senate,Connie Johnson,DEM,720011,0,0,127,127,
Tulsa,U.S. Senate,James Lankford,REP,720011,0,0,80,80,
Tulsa,U.S. Senate,Mark Beard,IND,720011,0,0,16,16,
Tulsa,Governor,Joe Dorman,DEM,720012,0,0,132,132,
Tulsa,Governor,Mary Fallin,REP,720012,0,0,67,67,
Tulsa,Governor,Kimberly Willis,IND,720012,0,0,7,7,
Tulsa,Governor,Richard Prawdzienski,IND,720012,0,0,5,5,
Tulsa,Lieutenant Governor,Cathy Cummings,DEM,720012,0,0,130,130,
Tulsa,Lieutenant Governor,Todd Lamb,REP,720012,0,0,81,81,
Tulsa,Superintendent of Public Instruction,John Cox,DEM,720012,0,0,145,145,
Tulsa,Superintendent of Public Instruction,Joy Hofmeister,REP,720012,0,0,66,66,
Tulsa,Commissioner of Labor,Mike Workman,DEM,720012,0,0,140,140,
Tulsa,Commissioner of Labor,Mark Costello,REP,720012,0,0,68,68,
Tulsa,U.S. Senate,Matt Silverstein,DEM,720012,0,0,121,121,
Tulsa,U.S. Senate,Jim Inhofe,REP,720012,0,0,77,77,
Tulsa,U.S. Senate,Aaron Delozier,IND,720012,0,0,4,4,
Tulsa,U.S. Senate,Ray Woods,IND,720012,0,0,2,2,
Tulsa,U.S. Senate,Joan Farr,IND,720012,0,0,5,5,
Tulsa,U.S. Senate,Connie Johnson,DEM,720012,0,0,127,127,
Tulsa,U.S. Senate,James Lankford,REP,720012,0,0,72,72,
Tulsa,U.S. Senate,Mark Beard,IND,720012,0,0,12,12,
Tulsa,Governor,Joe Dorman,DEM,720013,0,0,534,534,
Tulsa,Governor,Mary Fallin,REP,720013,0,0,23,23,
Tulsa,Governor,Kimberly Willis,IND,720013,0,0,9,9,
Tulsa,Governor,Richard Prawdzienski,IND,720013,0,0,3,3,
Tulsa,Lieutenant Governor,Cathy Cummings,DEM,720013,0,0,527,527,
Tulsa,Lieutenant Governor,Todd Lamb,REP,720013,0,0,41,41,
Tulsa,Superintendent of Public Instruction,John Cox,DEM,720013,0,0,534,534,
Tulsa,Superintendent of Public Instruction,Joy Hofmeister,REP,720013,0,0,32,32,
Tulsa,Commissioner of Labor,Mike Workman,DEM,720013,0,0,535,535,
Tulsa,Commissioner of Labor,Mark Costello,REP,720013,0,0,31,31,
Tulsa,U.S. Senate,Matt Silverstein,DEM,720013,0,0,509,509,
Tulsa,U.S. Senate,Jim Inhofe,REP,720013,0,0,38,38,
Tulsa,U.S. Senate,Aaron Delozier,IND,720013,0,0,4,4,
Tulsa,U.S. Senate,Ray Woods,IND,720013,0,0,8,8,
Tulsa,U.S. Senate,Joan Farr,IND,720013,0,0,9,9,
Tulsa,U.S. Senate,Connie Johnson,DEM,720013,0,0,535,535,
Tulsa,U.S. Senate,James Lankford,REP,720013,0,0,23,23,
Tulsa,U.S. Senate,Mark Beard,IND,720013,0,0,10,10,
Tulsa,Governor,Joe Dorman,DEM,720014,0,0,340,340,
Tulsa,Governor,Mary Fallin,REP,720014,0,0,30,30,
Tulsa,Governor,Kimberly Willis,IND,720014,0,0,8,8,
Tulsa,Governor,Richard Prawdzienski,IND,720014,0,0,3,3,
Tulsa,Lieutenant Governor,Cathy Cummings,DEM,720014,0,0,337,337,
Tulsa,Lieutenant Governor,Todd Lamb,REP,720014,0,0,41,41,
Tulsa,Superintendent of Public Instruction,John Cox,DEM,720014,0,0,333,333,
Tulsa,Superintendent of Public Instruction,Joy Hofmeister,REP,720014,0,0,46,46,
Tulsa,Commissioner of Labor,Mike Workman,DEM,720014,0,0,329,329,
Tulsa,Commissioner of Labor,Mark Costello,REP,720014,0,0,45,45,
Tulsa,U.S. Senate,Matt Silverstein,DEM,720014,0,0,310,310,
Tulsa,U.S. Senate,Jim Inhofe,REP,720014,0,0,50,50,
Tulsa,U.S. Senate,Aaron Delozier,IND,720014,0,0,4,4,
Tulsa,U.S. Senate,Ray Woods,IND,720014,0,0,8,8,
Tulsa,U.S. Senate,Joan Farr,IND,720014,0,0,8,8,
Tulsa,U.S. Senate,Connie Johnson,DEM,720014,0,0,332,332,
Tulsa,U.S. Senate,James Lankford,REP,720014,0,0,38,38,
Tulsa,U.S. Senate,Mark Beard,IND,720014,0,0,11,11,
Tulsa,Governor,Joe Dorman,DEM,720015,0,0,194,194,
Tulsa,Governor,Mary Fallin,REP,720015,0,0,31,31,
Tulsa,Governor,Kimberly Willis,IND,720015,0,0,6,6,
Tulsa,Governor,Richard Prawdzienski,IND,720015,0,0,3,3,
Tulsa,Lieutenant Governor,Cathy Cummings,DEM,720015,0,0,190,190,
Tulsa,Lieutenant Governor,Todd Lamb,REP,720015,0,0,41,41,
Tulsa,Superintendent of Public Instruction,John Cox,DEM,720015,0,0,199,199,
Tulsa,Superintendent of Public Instruction,Joy Hofmeister,REP,720015,0,0,31,31,
Tulsa,Commissioner of Labor,Mike Workman,DEM,720015,0,0,196,196,
Tulsa,Commissioner of Labor,Mark Costello,REP,720015,0,0,33,33,
Tulsa,U.S. Senate,Matt Silverstein,DEM,720015,0,0,182,182,
Tulsa,U.S. Senate,Jim Inhofe,REP,720015,0,0,41,41,
Tulsa,U.S. Senate,Aaron Delozier,IND,720015,0,0,2,2,
Tulsa,U.S. Senate,Ray Woods,IND,720015,0,0,2,2,
Tulsa,U.S. Senate,Joan Farr,IND,720015,0,0,7,7,
Tulsa,U.S. Senate,Connie Johnson,DEM,720015,0,0,192,192,
Tulsa,U.S. Senate,James Lankford,REP,720015,0,0,31,31,
Tulsa,U.S. Senate,Mark Beard,IND,720015,0,0,7,7,
Tulsa,Governor,Joe Dorman,DEM,720016,0,0,39,39,
Tulsa,Governor,Mary Fallin,REP,720016,0,0,45,45,
Tulsa,Governor,Kimberly Willis,IND,720016,0,0,5,5,
Tulsa,Governor,Richard Prawdzienski,IND,720016,0,0,1,1,
Tulsa,Lieutenant Governor,Cathy Cummings,DEM,720016,0,0,42,42,
Tulsa,Lieutenant Governor,Todd Lamb,REP,720016,0,0,46,46,
Tulsa,Superintendent of Public Instruction,John Cox,DEM,720016,0,0,44,44,
Tulsa,Superintendent of Public Instruction,Joy Hofmeister,REP,720016,0,0,43,43,
Tulsa,Commissioner of Labor,Mike Workman,DEM,720016,0,0,37,37,
Tulsa,Commissioner of Labor,Mark Costello,REP,720016,0,0,49,49,
Tulsa,U.S. Senate,Matt Silverstein,DEM,720016,0,0,31,31,
Tulsa,U.S. Senate,Jim Inhofe,REP,720016,0,0,49,49,
Tulsa,U.S. Senate,Aaron Delozier,IND,720016,0,0,5,5,
Tulsa,U.S. Senate,Ray Woods,IND,720016,0,0,2,2,
Tulsa,U.S. Senate,Joan Farr,IND,720016,0,0,3,3,
Tulsa,U.S. Senate,Connie Johnson,DEM,720016,0,0,39,39,
Tulsa,U.S. Senate,James Lankford,REP,720016,0,0,47,47,
Tulsa,U.S. Senate,Mark Beard,IND,720016,0,0,4,4,
Tulsa,Governor,Joe Dorman,DEM,720017,0,0,86,86,
Tulsa,Governor,Mary Fallin,REP,720017,0,0,42,42,
Tulsa,Governor,Kimberly Willis,IND,720017,0,0,5,5,
Tulsa,Governor,Richard Prawdzienski,IND,720017,0,0,0,0,
Tulsa,Lieutenant Governor,Cathy Cummings,DEM,720017,0,0,80,80,
Tulsa,Lieutenant Governor,Todd Lamb,REP,720017,0,0,54,54,
Tulsa,Superintendent of Public Instruction,John Cox,DEM,720017,0,0,83,83,
Tulsa,Superintendent of Public Instruction,Joy Hofmeister,REP,720017,0,0,48,48,
Tulsa,Commissioner of Labor,Mike Workman,DEM,720017,0,0,80,80,
Tulsa,Commissioner of Labor,Mark Costello,REP,720017,0,0,50,50,
Tulsa,U.S. Senate,Matt Silverstein,DEM,720017,0,0,72,72,
Tulsa,U.S. Senate,Jim Inhofe,REP,720017,0,0,55,55,
Tulsa,U.S. Senate,Aaron Delozier,IND,720017,0,0,3,3,
Tulsa,U.S. Senate,Ray Woods,IND,720017,0,0,2,2,
Tulsa,U.S. Senate,Joan Farr,IND,720017,0,0,2,2,
Tulsa,U.S. Senate,Connie Johnson,DEM,720017,0,0,71,71,
Tulsa,U.S. Senate,James Lankford,REP,720017,0,0,53,53,
Tulsa,U.S. Senate,Mark Beard,IND,720017,0,0,10,10,
Tulsa,Governor,Joe Dorman,DEM,720018,0,0,100,100,
Tulsa,Governor,Mary Fallin,REP,720018,0,0,85,85,
Tulsa,Governor,Kimberly Willis,IND,720018,0,0,5,5,
Tulsa,Governor,Richard Prawdzienski,IND,720018,0,0,8,8,
Tulsa,Lieutenant Governor,Cathy Cummings,DEM,720018,0,0,98,98,
Tulsa,Lieutenant Governor,Todd Lamb,REP,720018,0,0,99,99,
Tulsa,Superintendent of Public Instruction,John Cox,DEM,720018,0,0,102,102,
Tulsa,Superintendent of Public Instruction,Joy Hofmeister,REP,720018,0,0,95,95,
Tulsa,Commissioner of Labor,Mike Workman,DEM,720018,0,0,107,107,
Tulsa,Commissioner of Labor,Mark Costello,REP,720018,0,0,85,85,
Tulsa,U.S. Senate,Matt Silverstein,DEM,720018,0,0,89,89,
Tulsa,U.S. Senate,Jim Inhofe,REP,720018,0,0,97,97,
Tulsa,U.S. Senate,Aaron Delozier,IND,720018,0,0,5,5,
Tulsa,U.S. Senate,Ray Woods,IND,720018,0,0,3,3,
Tulsa,U.S. Senate,Joan Farr,IND,720018,0,0,3,3,
Tulsa,U.S. Senate,Connie Johnson,DEM,720018,0,0,95,95,
Tulsa,U.S. Senate,James Lankford,REP,720018,0,0,88,88,
Tulsa,U.S. Senate,Mark Beard,IND,720018,0,0,14,14,
Tulsa,Governor,Joe Dorman,DEM,720019,0,0,134,134,
Tulsa,Governor,Mary Fallin,REP,720019,0,0,107,107,
Tulsa,Governor,Kimberly Willis,IND,720019,0,0,7,7,
Tulsa,Governor,Richard Prawdzienski,IND,720019,0,0,1,1,
Tulsa,Lieutenant Governor,Cathy Cummings,DEM,720019,0,0,117,117,
Tulsa,Lieutenant Governor,Todd Lamb,REP,720019,0,0,130,130,
Tulsa,Superintendent of Public Instruction,John Cox,DEM,720019,0,0,122,122,
Tulsa,Superintendent of Public Instruction,Joy Hofmeister,REP,720019,0,0,123,123,
Tulsa,Commissioner of Labor,Mike Workman,DEM,720019,0,0,139,139,
Tulsa,Commissioner of Labor,Mark Costello,REP,720019,0,0,102,102,
Tulsa,U.S. Senate,Matt Silverstein,DEM,720019,0,0,107,107,
Tulsa,U.S. Senate,Jim Inhofe,REP,720019,0,0,128,128,
Tulsa,U.S. Senate,Aaron Delozier,IND,720019,0,0,2,2,
Tulsa,U.S. Senate,Ray Woods,IND,720019,0,0,5,5,
Tulsa,U.S. Senate,Joan Farr,IND,720019,0,0,4,4,
Tulsa,U.S. Senate,Connie Johnson,DEM,720019,0,0,109,109,
Tulsa,U.S. Senate,James Lankford,REP,720019,0,0,126,126,
Tulsa,U.S. Senate,Mark Beard,IND,720019,0,0,13,13,
Tulsa,Governor,Joe Dorman,DEM,720020,0,0,154,154,
Tulsa,Governor,Mary Fallin,REP,720020,0,0,95,95,
Tulsa,Governor,Kimberly Willis,IND,720020,0,0,6,6,
Tulsa,Governor,Richard Prawdzienski,IND,720020,0,0,6,6,
Tulsa,Lieutenant Governor,Cathy Cummings,DEM,720020,0,0,143,143,
Tulsa,Lieutenant Governor,Todd Lamb,REP,720020,0,0,117,117,
Tulsa,Superintendent of Public Instruction,John Cox,DEM,720020,0,0,155,155,
Tulsa,Superintendent of Public Instruction,Joy Hofmeister,REP,720020,0,0,107,107,
Tulsa,Commissioner of Labor,Mike Workman,DEM,720020,0,0,146,146,
Tulsa,Commissioner of Labor,Mark Costello,REP,720020,0,0,109,109,
Tulsa,U.S. Senate,Matt Silverstein,DEM,720020,0,0,137,137,
Tulsa,U.S. Senate,Jim Inhofe,REP,720020,0,0,112,112,
Tulsa,U.S. Senate,Aaron Delozier,IND,720020,0,0,4,4,
Tulsa,U.S. Senate,Ray Woods,IND,720020,0,0,4,4,
Tulsa,U.S. Senate,Joan Farr,IND,720020,0,0,2,2,
Tulsa,U.S. Senate,Connie Johnson,DEM,720020,0,0,133,133,
Tulsa,U.S. Senate,James Lankford,REP,720020,0,0,116,116,
Tulsa,U.S. Senate,Mark Beard,IND,720020,0,0,11,11,
Tulsa,Governor,Joe Dorman,DEM,720021,0,0,4,4,
Tulsa,Governor,Mary Fallin,REP,720021,0,0,24,24,
Tulsa,Governor,Kimberly Willis,IND,720021,0,0,1,1,
Tulsa,Governor,Richard Prawdzienski,IND,720021,0,0,0,0,
Tulsa,Lieutenant Governor,Cathy Cummings,DEM,720021,0,0,4,4,
Tulsa,Lieutenant Governor,Todd Lamb,REP,720021,0,0,25,25,
Tulsa,Superintendent of Public Instruction,John Cox,DEM,720021,0,0,6,6,
Tulsa,Superintendent of Public Instruction,Joy Hofmeister,REP,720021,0,0,23,23,
Tulsa,Commissioner of Labor,Mike Workman,DEM,720021,0,0,4,4,
Tulsa,Commissioner of Labor,Mark Costello,REP,720021,0,0,23,23,
Tulsa,U.S. Senate,Matt Silverstein,DEM,720021,0,0,4,4,
Tulsa,U.S. Senate,Jim Inhofe,REP,720021,0,0,25,25,
Tulsa,U.S. Senate,Aaron Delozier,IND,720021,0,0,0,0,
Tulsa,U.S. Senate,Ray Woods,IND,720021,0,0,0,0,
Tulsa,U.S. Senate,Joan Farr,IND,720021,0,0,0,0,
Tulsa,U.S. Senate,Connie Johnson,DEM,720021,0,0,4,4,
Tulsa,U.S. Senate,James Lankford,REP,720021,0,0,24,24,
Tulsa,U.S. Senate,Mark Beard,IND,720021,0,0,1,1,
Tulsa,Governor,Joe Dorman,DEM,720022,0,0,142,142,
Tulsa,Governor,Mary Fallin,REP,720022,0,0,165,165,
Tulsa,Governor,Kimberly Willis,IND,720022,0,0,8,8,
Tulsa,Governor,Richard Prawdzienski,IND,720022,0,0,6,6,
Tulsa,Lieutenant Governor,Cathy Cummings,DEM,720022,0,0,113,113,
Tulsa,Lieutenant Governor,Todd Lamb,REP,720022,0,0,210,210,
Tulsa,Superintendent of Public Instruction,John Cox,DEM,720022,0,0,144,144,
Tulsa,Superintendent of Public Instruction,Joy Hofmeister,REP,720022,0,0,178,178,
Tulsa,Commissioner of Labor,Mike Workman,DEM,720022,0,0,133,133,
Tulsa,Commissioner of Labor,Mark Costello,REP,720022,0,0,178,178,
Tulsa,U.S. Senate,Matt Silverstein,DEM,720022,0,0,127,127,
Tulsa,U.S. Senate,Jim Inhofe,REP,720022,0,0,185,185,
Tulsa,U.S. Senate,Aaron Delozier,IND,720022,0,0,5,5,
Tulsa,U.S. Senate,Ray Woods,IND,720022,0,0,2,2,
Tulsa,U.S. Senate,Joan Farr,IND,720022,0,0,1,1,
Tulsa,U.S. Senate,Connie Johnson,DEM,720022,0,0,109,109,
Tulsa,U.S. Senate,James Lankford,REP,720022,0,0,201,201,
Tulsa,U.S. Senate,Mark Beard,IND,720022,0,0,10,10,
Tulsa,Governor,Joe Dorman,DEM,720023,0,0,36,36,
Tulsa,Governor,Mary Fallin,REP,720023,0,0,103,103,
Tulsa,Governor,Kimberly Willis,IND,720023,0,0,4,4,
Tulsa,Governor,Richard Prawdzienski,IND,720023,0,0,1,1,
Tulsa,Lieutenant Governor,Cathy Cummings,DEM,720023,0,0,30,30,
Tulsa,Lieutenant Governor,Todd Lamb,REP,720023,0,0,114,114,
Tulsa,Superintendent of Public Instruction,John Cox,DEM,720023,0,0,40,40,
Tulsa,Superintendent of Public Instruction,Joy Hofmeister,REP,720023,0,0,103,103,
Tulsa,Commissioner of Labor,Mike Workman,DEM,720023,0,0,42,42,
Tulsa,Commissioner of Labor,Mark Costello,REP,720023,0,0,96,96,
Tulsa,U.S. Senate,Matt Silverstein,DEM,720023,0,0,31,31,
Tulsa,U.S. Senate,Jim Inhofe,REP,720023,0,0,107,107,
Tulsa,U.S. Senate,Aaron Delozier,IND,720023,0,0,1,1,
Tulsa,U.S. Senate,Ray Woods,IND,720023,0,0,1,1,
Tulsa,U.S. Senate,Joan Farr,IND,720023,0,0,2,2,
Tulsa,U.S. Senate,Connie Johnson,DEM,720023,0,0,28,28,
Tulsa,U.S. Senate,James Lankford,REP,720023,0,0,107,107,
Tulsa,U.S. Senate,Mark Beard,IND,720023,0,0,7,7,
Tulsa,Governor,Joe Dorman,DEM,720024,0,0,128,128,
Tulsa,Governor,Mary Fallin,REP,720024,0,0,144,144,
Tulsa,Governor,Kimberly Willis,IND,720024,0,0,6,6,
Tulsa,Governor,Richard Prawdzienski,IND,720024,0,0,5,5,
Tulsa,Lieutenant Governor,Cathy Cummings,DEM,720024,0,0,99,99,
Tulsa,Lieutenant Governor,Todd Lamb,REP,720024,0,0,179,179,
Tulsa,Superintendent of Public Instruction,John Cox,DEM,720024,0,0,126,126,
Tulsa,Superintendent of Public Instruction,Joy Hofmeister,REP,720024,0,0,155,155,
Tulsa,Commissioner of Labor,Mike Workman,DEM,720024,0,0,120,120,
Tulsa,Commissioner of Labor,Mark Costello,REP,720024,0,0,157,157,
Tulsa,U.S. Senate,Matt Silverstein,DEM,720024,0,0,89,89,
Tulsa,U.S. Senate,Jim Inhofe,REP,720024,0,0,183,183,
Tulsa,U.S. Senate,Aaron Delozier,IND,720024,0,0,2,2,
Tulsa,U.S. Senate,Ray Woods,IND,720024,0,0,4,4,
Tulsa,U.S. Senate,Joan Farr,IND,720024,0,0,4,4,
Tulsa,U.S. Senate,Connie Johnson,DEM,720024,0,0,102,102,
Tulsa,U.S. Senate,James Lankford,REP,720024,0,0,171,171,
Tulsa,U.S. Senate,Mark Beard,IND,720024,0,0,7,7,
Tulsa,Governor,Joe Dorman,DEM,720025,0,0,81,81,
Tulsa,Governor,Mary Fallin,REP,720025,0,0,83,83,
Tulsa,Governor,Kimberly Willis,IND,720025,0,0,3,3,
Tulsa,Governor,Richard Prawdzienski,IND,720025,0,0,4,4,
Tulsa,Lieutenant Governor,Cathy Cummings,DEM,720025,0,0,69,69,
Tulsa,Lieutenant Governor,Todd Lamb,REP,720025,0,0,101,101,
Tulsa,Superintendent of Public Instruction,John Cox,DEM,720025,0,0,86,86,
Tulsa,Superintendent of Public Instruction,Joy Hofmeister,REP,720025,0,0,83,83,
Tulsa,Commissioner of Labor,Mike Workman,DEM,720025,0,0,80,80,
Tulsa,Commissioner of Labor,Mark Costello,REP,720025,0,0,88,88,
Tulsa,U.S. Senate,Matt Silverstein,DEM,720025,0,0,70,70,
Tulsa,U.S. Senate,Jim Inhofe,REP,720025,0,0,96,96,
Tulsa,U.S. Senate,Aaron Delozier,IND,720025,0,0,3,3,
Tulsa,U.S. Senate,Ray Woods,IND,720025,0,0,1,1,
Tulsa,U.S. Senate,Joan Farr,IND,720025,0,0,1,1,
Tulsa,U.S. Senate,Connie Johnson,DEM,720025,0,0,62,62,
Tulsa,U.S. Senate,James Lankford,REP,720025,0,0,99,99,
Tulsa,U.S. Senate,Mark Beard,IND,720025,0,0,8,8,
Tulsa,Governor,Joe Dorman,DEM,720026,0,0,124,124,
Tulsa,Governor,Mary Fallin,REP,720026,0,0,107,107,
Tulsa,Governor,Kimberly Willis,IND,720026,0,0,11,11,
Tulsa,Governor,Richard Prawdzienski,IND,720026,0,0,2,2,
Tulsa,Lieutenant Governor,Cathy Cummings,DEM,720026,0,0,107,107,
Tulsa,Lieutenant Governor,Todd Lamb,REP,720026,0,0,134,134,
Tulsa,Superintendent of Public Instruction,John Cox,DEM,720026,0,0,125,125,
Tulsa,Superintendent of Public Instruction,Joy Hofmeister,REP,720026,0,0,116,116,
Tulsa,Commissioner of Labor,Mike Workman,DEM,720026,0,0,127,127,
Tulsa,Commissioner of Labor,Mark Costello,REP,720026,0,0,114,114,
Tulsa,U.S. Senate,Matt Silverstein,DEM,720026,0,0,109,109,
Tulsa,U.S. Senate,Jim Inhofe,REP,720026,0,0,117,117,
Tulsa,U.S. Senate,Aaron Delozier,IND,720026,0,0,4,4,
Tulsa,U.S. Senate,Ray Woods,IND,720026,0,0,6,6,
Tulsa,U.S. Senate,Joan Farr,IND,720026,0,0,6,6,
Tulsa,U.S. Senate,Connie Johnson,DEM,720026,0,0,104,104,
Tulsa,U.S. Senate,James Lankford,REP,720026,0,0,126,126,
Tulsa,U.S. Senate,Mark Beard,IND,720026,0,0,9,9,
Tulsa,Governor,Joe Dorman,DEM,720027,0,0,69,69,
Tulsa,Governor,Mary Fallin,REP,720027,0,0,118,118,
Tulsa,Governor,Kimberly Willis,IND,720027,0,0,11,11,
Tulsa,Governor,Richard Prawdzienski,IND,720027,0,0,3,3,
Tulsa,Lieutenant Governor,Cathy Cummings,DEM,720027,0,0,71,71,
Tulsa,Lieutenant Governor,Todd Lamb,REP,720027,0,0,129,129,
Tulsa,Superintendent of Public Instruction,John Cox,DEM,720027,0,0,86,86,
Tulsa,Superintendent of Public Instruction,Joy Hofmeister,REP,720027,0,0,112,112,
Tulsa,Commissioner of Labor,Mike Workman,DEM,720027,0,0,85,85,
Tulsa,Commissioner of Labor,Mark Costello,REP,720027,0,0,107,107,
Tulsa,U.S. Senate,Matt Silverstein,DEM,720027,0,0,63,63,
Tulsa,U.S. Senate,Jim Inhofe,REP,720027,0,0,126,126,
Tulsa,U.S. Senate,Aaron Delozier,IND,720027,0,0,1,1,
Tulsa,U.S. Senate,Ray Woods,IND,720027,0,0,4,4,
Tulsa,U.S. Senate,Joan Farr,IND,720027,0,0,3,3,
Tulsa,U.S. Senate,Connie Johnson,DEM,720027,0,0,62,62,
Tulsa,U.S. Senate,James Lankford,REP,720027,0,0,125,125,
Tulsa,U.S. Senate,Mark Beard,IND,720027,0,0,10,10,
Tulsa,Governor,Joe Dorman,DEM,720028,0,0,145,145,
Tulsa,Governor,Mary Fallin,REP,720028,0,0,146,146,
Tulsa,Governor,Kimberly Willis,IND,720028,0,0,16,16,
Tulsa,Governor,Richard Prawdzienski,IND,720028,0,0,6,6,
Tulsa,Lieutenant Governor,Cathy Cummings,DEM,720028,0,0,131,131,
Tulsa,Lieutenant Governor,Todd Lamb,REP,720028,0,0,182,182,
Tulsa,Superintendent of Public Instruction,John Cox,DEM,720028,0,0,162,162,
Tulsa,Superintendent of Public Instruction,Joy Hofmeister,REP,720028,0,0,150,150,
Tulsa,Commissioner of Labor,Mike Workman,DEM,720028,0,0,149,149,
Tulsa,Commissioner of Labor,Mark Costello,REP,720028,0,0,155,155,
Tulsa,U.S. Senate,Matt Silverstein,DEM,720028,0,0,122,122,
Tulsa,U.S. Senate,Jim Inhofe,REP,720028,0,0,173,173,
Tulsa,U.S. Senate,Aaron Delozier,IND,720028,0,0,5,5,
Tulsa,U.S. Senate,Ray Woods,IND,720028,0,0,8,8,
Tulsa,U.S. Senate,Joan Farr,IND,720028,0,0,6,6,
Tulsa,U.S. Senate,Connie Johnson,DEM,720028,0,0,120,120,
Tulsa,U.S. Senate,James Lankford,REP,720028,0,0,167,167,
Tulsa,U.S. Senate,Mark Beard,IND,720028,0,0,23,23,
Tulsa,Governor,Joe Dorman,DEM,720029,0,0,116,116,
Tulsa,Governor,Mary Fallin,REP,720029,0,0,143,143,
Tulsa,Governor,Kimberly Willis,IND,720029,0,0,12,12,
Tulsa,Governor,Richard Prawdzienski,IND,720029,0,0,2,2,
Tulsa,Lieutenant Governor,Cathy Cummings,DEM,720029,0,0,120,120,
Tulsa,Lieutenant Governor,Todd Lamb,REP,720029,0,0,151,151,
Tulsa,Superintendent of Public Instruction,John Cox,DEM,720029,0,0,127,127,
Tulsa,Superintendent of Public Instruction,Joy Hofmeister,REP,720029,0,0,141,141,
Tulsa,Commissioner of Labor,Mike Workman,DEM,720029,0,0,130,130,
Tulsa,Commissioner of Labor,Mark Costello,REP,720029,0,0,134,134,
Tulsa,U.S. Senate,Matt Silverstein,DEM,720029,0,0,103,103,
Tulsa,U.S. Senate,Jim Inhofe,REP,720029,0,0,152,152,
Tulsa,U.S. Senate,Aaron Delozier,IND,720029,0,0,1,1,
Tulsa,U.S. Senate,Ray Woods,IND,720029,0,0,6,6,
Tulsa,U.S. Senate,Joan Farr,IND,720029,0,0,5,5,
Tulsa,U.S. Senate,Connie Johnson,DEM,720029,0,0,107,107,
Tulsa,U.S. Senate,James Lankford,REP,720029,0,0,154,154,
Tulsa,U.S. Senate,Mark Beard,IND,720029,0,0,9,9,
Tulsa,Governor,Joe Dorman,DEM,720030,0,0,212,212,
Tulsa,Governor,Mary Fallin,REP,720030,0,0,92,92,
Tulsa,Governor,Kimberly Willis,IND,720030,0,0,6,6,
Tulsa,Governor,Richard Prawdzienski,IND,720030,0,0,4,4,
Tulsa,Lieutenant Governor,Cathy Cummings,DEM,720030,0,0,191,191,
Tulsa,Lieutenant Governor,Todd Lamb,REP,720030,0,0,117,117,
Tulsa,Superintendent of Public Instruction,John Cox,DEM,720030,0,0,188,188,
Tulsa,Superintendent of Public Instruction,Joy Hofmeister,REP,720030,0,0,123,123,
Tulsa,Commissioner of Labor,Mike Workman,DEM,720030,0,0,196,196,
Tulsa,Commissioner of Labor,Mark Costello,REP,720030,0,0,108,108,
Tulsa,U.S. Senate,Matt Silverstein,DEM,720030,0,0,197,197,
Tulsa,U.S. Senate,Jim Inhofe,REP,720030,0,0,104,104,
Tulsa,U.S. Senate,Aaron Delozier,IND,720030,0,0,2,2,
Tulsa,U.S. Senate,Ray Woods,IND,720030,0,0,4,4,
Tulsa,U.S. Senate,Joan Farr,IND,720030,0,0,5,5,
Tulsa,U.S. Senate,Connie Johnson,DEM,720030,0,0,185,185,
Tulsa,U.S. Senate,James Lankford,REP,720030,0,0,115,115,
Tulsa,U.S. Senate,Mark Beard,IND,720030,0,0,13,13,
Tulsa,Governor,Joe Dorman,DEM,720031,0,0,93,93,
Tulsa,Governor,Mary Fallin,REP,720031,0,0,60,60,
Tulsa,Governor,Kimberly Willis,IND,720031,0,0,4,4,
Tulsa,Governor,Richard Prawdzienski,IND,720031,0,0,1,1,
Tulsa,Lieutenant Governor,Cathy Cummings,DEM,720031,0,0,86,86,
Tulsa,Lieutenant Governor,Todd Lamb,REP,720031,0,0,71,71,
Tulsa,Superintendent of Public Instruction,John Cox,DEM,720031,0,0,90,90,
Tulsa,Superintendent of Public Instruction,Joy Hofmeister,REP,720031,0,0,66,66,
Tulsa,Commissioner of Labor,Mike Workman,DEM,720031,0,0,87,87,
Tulsa,Commissioner of Labor,Mark Costello,REP,720031,0,0,68,68,
Tulsa,U.S. Senate,Matt Silverstein,DEM,720031,0,0,86,86,
Tulsa,U.S. Senate,Jim Inhofe,REP,720031,0,0,66,66,
Tulsa,U.S. Senate,Aaron Delozier,IND,720031,0,0,1,1,
Tulsa,U.S. Senate,Ray Woods,IND,720031,0,0,1,1,
Tulsa,U.S. Senate,Joan Farr,IND,720031,0,0,3,3,
Tulsa,U.S. Senate,Connie Johnson,DEM,720031,0,0,78,78,
Tulsa,U.S. Senate,James Lankford,REP,720031,0,0,67,67,
Tulsa,U.S. Senate,Mark Beard,IND,720031,0,0,8,8,
Tulsa,Governor,Joe Dorman,DEM,720032,0,0,159,159,
Tulsa,Governor,Mary Fallin,REP,720032,0,0,70,70,
Tulsa,Governor,Kimberly Willis,IND,720032,0,0,3,3,
Tulsa,Governor,Richard Prawdzienski,IND,720032,0,0,1,1,
Tulsa,Lieutenant Governor,Cathy Cummings,DEM,720032,0,0,152,152,
Tulsa,Lieutenant Governor,Todd Lamb,REP,720032,0,0,81,81,
Tulsa,Superintendent of Public Instruction,John Cox,DEM,720032,0,0,149,149,
Tulsa,Superintendent of Public Instruction,Joy Hofmeister,REP,720032,0,0,84,84,
Tulsa,Commissioner of Labor,Mike Workman,DEM,720032,0,0,159,159,
Tulsa,Commissioner of Labor,Mark Costello,REP,720032,0,0,69,69,
Tulsa,U.S. Senate,Matt Silverstein,DEM,720032,0,0,144,144,
Tulsa,U.S. Senate,Jim Inhofe,REP,720032,0,0,81,81,
Tulsa,U.S. Senate,Aaron Delozier,IND,720032,0,0,3,3,
Tulsa,U.S. Senate,Ray Woods,IND,720032,0,0,1,1,
Tulsa,U.S. Senate,Joan Farr,IND,720032,0,0,2,2,
Tulsa,U.S. Senate,Connie Johnson,DEM,720032,0,0,147,147,
Tulsa,U.S. Senate,James Lankford,REP,720032,0,0,75,75,
Tulsa,U.S. Senate,Mark Beard,IND,720032,0,0,8,8,
Tulsa,Governor,Joe Dorman,DEM,720033,0,0,138,138,
Tulsa,Governor,Mary Fallin,REP,720033,0,0,60,60,
Tulsa,Governor,Kimberly Willis,IND,720033,0,0,6,6,
Tulsa,Governor,Richard Prawdzienski,IND,720033,0,0,3,3,
Tulsa,Lieutenant Governor,Cathy Cummings,DEM,720033,0,0,115,115,
Tulsa,Lieutenant Governor,Todd Lamb,REP,720033,0,0,90,90,
Tulsa,Superintendent of Public Instruction,John Cox,DEM,720033,0,0,120,120,
Tulsa,Superintendent of Public Instruction,Joy Hofmeister,REP,720033,0,0,83,83,
Tulsa,Commissioner of Labor,Mike Workman,DEM,720033,0,0,121,121,
Tulsa,Commissioner of Labor,Mark Costello,REP,720033,0,0,74,74,
Tulsa,U.S. Senate,Matt Silverstein,DEM,720033,0,0,116,116,
Tulsa,U.S. Senate,Jim Inhofe,REP,720033,0,0,78,78,
Tulsa,U.S. Senate,Aaron Delozier,IND,720033,0,0,8,8,
Tulsa,U.S. Senate,Ray Woods,IND,720033,0,0,1,1,
Tulsa,U.S. Senate,Joan Farr,IND,720033,0,0,3,3,
Tulsa,U.S. Senate,Connie Johnson,DEM,720033,0,0,111,111,
Tulsa,U.S. Senate,James Lankford,REP,720033,0,0,84,84,
Tulsa,U.S. Senate,Mark Beard,IND,720033,0,0,9,9,
Tulsa,Governor,Joe Dorman,DEM,720034,0,0,104,104,
Tulsa,Governor,Mary Fallin,REP,720034,0,0,69,69,
Tulsa,Governor,Kimberly Willis,IND,720034,0,0,3,3,
Tulsa,Governor,Richard Prawdzienski,IND,720034,0,0,0,0,
Tulsa,Lieutenant Governor,Cathy Cummings,DEM,720034,0,0,82,82,
Tulsa,Lieutenant Governor,Todd Lamb,REP,720034,0,0,91,91,
Tulsa,Superintendent of Public Instruction,John Cox,DEM,720034,0,0,93,93,
Tulsa,Superintendent of Public Instruction,Joy Hofmeister,REP,720034,0,0,81,81,
Tulsa,Commissioner of Labor,Mike Workman,DEM,720034,0,0,85,85,
Tulsa,Commissioner of Labor,Mark Costello,REP,720034,0,0,84,84,
Tulsa,U.S. Senate,Matt Silverstein,DEM,720034,0,0,92,92,
Tulsa,U.S. Senate,Jim Inhofe,REP,720034,0,0,80,80,
Tulsa,U.S. Senate,Aaron Delozier,IND,720034,0,0,0,0,
Tulsa,U.S. Senate,Ray Woods,IND,720034,0,0,1,1,
Tulsa,U.S. Senate,Joan Farr,IND,720034,0,0,4,4,
Tulsa,U.S. Senate,Connie Johnson,DEM,720034,0,0,82,82,
Tulsa,U.S. Senate,James Lankford,REP,720034,0,0,87,87,
Tulsa,U.S. Senate,Mark Beard,IND,720034,0,0,6,6,
Tulsa,Governor,Joe Dorman,DEM,720035,0,0,317,317,
Tulsa,Governor,Mary Fallin,REP,720035,0,0,250,250,
Tulsa,Governor,Kimberly Willis,IND,720035,0,0,19,19,
Tulsa,Governor,Richard Prawdzienski,IND,720035,0,0,11,11,
Tulsa,Lieutenant Governor,Cathy Cummings,DEM,720035,0,0,282,282,
Tulsa,Lieutenant Governor,Todd Lamb,REP,720035,0,0,311,311,
Tulsa,Superintendent of Public Instruction,John Cox,DEM,720035,0,0,306,306,
Tulsa,Superintendent of Public Instruction,Joy Hofmeister,REP,720035,0,0,289,289,
Tulsa,Commissioner of Labor,Mike Workman,DEM,720035,0,0,292,292,
Tulsa,Commissioner of Labor,Mark Costello,REP,720035,0,0,289,289,
Tulsa,U.S. Senate,Matt Silverstein,DEM,720035,0,0,270,270,
Tulsa,U.S. Senate,Jim Inhofe,REP,720035,0,0,289,289,
Tulsa,U.S. Senate,Aaron Delozier,IND,720035,0,0,11,11,
Tulsa,U.S. Senate,Ray Woods,IND,720035,0,0,17,17,
Tulsa,U.S. Senate,Joan Farr,IND,720035,0,0,6,6,
Tulsa,U.S. Senate,Connie Johnson,DEM,720035,0,0,269,269,
Tulsa,U.S. Senate,James Lankford,REP,720035,0,0,294,294,
Tulsa,U.S. Senate,Mark Beard,IND,720035,0,0,29,29,
Tulsa,Governor,Joe Dorman,DEM,720036,0,0,311,311,
Tulsa,Governor,Mary Fallin,REP,720036,0,0,260,260,
Tulsa,Governor,Kimberly Willis,IND,720036,0,0,10,10,
Tulsa,Governor,Richard Prawdzienski,IND,720036,0,0,11,11,
Tulsa,Lieutenant Governor,Cathy Cummings,DEM,720036,0,0,270,270,
Tulsa,Lieutenant Governor,Todd Lamb,REP,720036,0,0,318,318,
Tulsa,Superintendent of Public Instruction,John Cox,DEM,720036,0,0,291,291,
Tulsa,Superintendent of Public Instruction,Joy Hofmeister,REP,720036,0,0,296,296,
Tulsa,Commissioner of Labor,Mike Workman,DEM,720036,0,0,288,288,
Tulsa,Commissioner of Labor,Mark Costello,REP,720036,0,0,283,283,
Tulsa,U.S. Senate,Matt Silverstein,DEM,720036,0,0,272,272,
Tulsa,U.S. Senate,Jim Inhofe,REP,720036,0,0,298,298,
Tulsa,U.S. Senate,Aaron Delozier,IND,720036,0,0,6,6,
Tulsa,U.S. Senate,Ray Woods,IND,720036,0,0,6,6,
Tulsa,U.S. Senate,Joan Farr,IND,720036,0,0,5,5,
Tulsa,U.S. Senate,Connie Johnson,DEM,720036,0,0,258,258,
Tulsa,U.S. Senate,James Lankford,REP,720036,0,0,306,306,
Tulsa,U.S. Senate,Mark Beard,IND,720036,0,0,21,21,
Tulsa,Governor,Joe Dorman,DEM,720037,0,0,91,91,
Tulsa,Governor,Mary Fallin,REP,720037,0,0,36,36,
Tulsa,Governor,Kimberly Willis,IND,720037,0,0,1,1,
Tulsa,Governor,Richard Prawdzienski,IND,720037,0,0,0,0,
Tulsa,Lieutenant Governor,Cathy Cummings,DEM,720037,0,0,85,85,
Tulsa,Lieutenant Governor,Todd Lamb,REP,720037,0,0,43,43,
Tulsa,Superintendent of Public Instruction,John Cox,DEM,720037,0,0,81,81,
Tulsa,Superintendent of Public Instruction,Joy Hofmeister,REP,720037,0,0,45,45,
Tulsa,Commissioner of Labor,Mike Workman,DEM,720037,0,0,83,83,
Tulsa,Commissioner of Labor,Mark Costello,REP,720037,0,0,43,43,
Tulsa,U.S. Senate,Matt Silverstein,DEM,720037,0,0,81,81,
Tulsa,U.S. Senate,Jim Inhofe,REP,720037,0,0,38,38,
Tulsa,U.S. Senate,Aaron Delozier,IND,720037,0,0,2,2,
Tulsa,U.S. Senate,Ray Woods,IND,720037,0,0,4,4,
Tulsa,U.S. Senate,Joan Farr,IND,720037,0,0,1,1,
Tulsa,U.S. Senate,Connie Johnson,DEM,720037,0,0,81,81,
Tulsa,U.S. Senate,James Lankford,REP,720037,0,0,40,40,
Tulsa,U.S. Senate,Mark Beard,IND,720037,0,0,6,6,
Tulsa,Governor,Joe Dorman,DEM,720038,0,0,129,129,
Tulsa,Governor,Mary Fallin,REP,720038,0,0,139,139,
Tulsa,Governor,Kimberly Willis,IND,720038,0,0,7,7,
Tulsa,Governor,Richard Prawdzienski,IND,720038,0,0,2,2,
Tulsa,Lieutenant Governor,Cathy Cummings,DEM,720038,0,0,92,92,
Tulsa,Lieutenant Governor,Todd Lamb,REP,720038,0,0,185,185,
Tulsa,Superintendent of Public Instruction,John Cox,DEM,720038,0,0,125,125,
Tulsa,Superintendent of Public Instruction,Joy Hofmeister,REP,720038,0,0,151,151,
Tulsa,Commissioner of Labor,Mike Workman,DEM,720038,0,0,109,109,
Tulsa,Commissioner of Labor,Mark Costello,REP,720038,0,0,164,164,
Tulsa,U.S. Senate,Matt Silverstein,DEM,720038,0,0,91,91,
Tulsa,U.S. Senate,Jim Inhofe,REP,720038,0,0,172,172,
Tulsa,U.S. Senate,Aaron Delozier,IND,720038,0,0,1,1,
Tulsa,U.S. Senate,Ray Woods,IND,720038,0,0,5,5,
Tulsa,U.S. Senate,Joan Farr,IND,720038,0,0,8,8,
Tulsa,U.S. Senate,Connie Johnson,DEM,720038,0,0,82,82,
Tulsa,U.S. Senate,James Lankford,REP,720038,0,0,176,176,
Tulsa,U.S. Senate,Mark Beard,IND,720038,0,0,16,16,
Tulsa,Governor,Joe Dorman,DEM,720039,0,0,158,158,
Tulsa,Governor,Mary Fallin,REP,720039,0,0,197,197,
Tulsa,Governor,Kimberly Willis,IND,720039,0,0,12,12,
Tulsa,Governor,Richard Prawdzienski,IND,720039,0,0,2,2,
Tulsa,Lieutenant Governor,Cathy Cummings,DEM,720039,0,0,138,138,
Tulsa,Lieutenant Governor,Todd Lamb,REP,720039,0,0,230,230,
Tulsa,Superintendent of Public Instruction,John Cox,DEM,720039,0,0,170,170,
Tulsa,Superintendent of Public Instruction,Joy Hofmeister,REP,720039,0,0,198,198,
Tulsa,Commissioner of Labor,Mike Workman,DEM,720039,0,0,160,160,
Tulsa,Commissioner of Labor,Mark Costello,REP,720039,0,0,202,202,
Tulsa,U.S. Senate,Matt Silverstein,DEM,720039,0,0,135,135,
Tulsa,U.S. Senate,Jim Inhofe,REP,720039,0,0,216,216,
Tulsa,U.S. Senate,Aaron Delozier,IND,720039,0,0,5,5,
Tulsa,U.S. Senate,Ray Woods,IND,720039,0,0,4,4,
Tulsa,U.S. Senate,Joan Farr,IND,720039,0,0,9,9,
Tulsa,U.S. Senate,Connie Johnson,DEM,720039,0,0,135,135,
Tulsa,U.S. Senate,James Lankford,REP,720039,0,0,212,212,
Tulsa,U.S. Senate,Mark Beard,IND,720039,0,0,20,20,
Tulsa,Governor,Joe Dorman,DEM,720040,0,0,78,78,
Tulsa,Governor,Mary Fallin,REP,720040,0,0,50,50,
Tulsa,Governor,Kimberly Willis,IND,720040,0,0,3,3,
Tulsa,Governor,Richard Prawdzienski,IND,720040,0,0,5,5,
Tulsa,Lieutenant Governor,Cathy Cummings,DEM,720040,0,0,70,70,
Tulsa,Lieutenant Governor,Todd Lamb,REP,720040,0,0,66,66,
Tulsa,Superintendent of Public Instruction,John Cox,DEM,720040,0,0,79,79,
Tulsa,Superintendent of Public Instruction,Joy Hofmeister,REP,720040,0,0,57,57,
Tulsa,Commissioner of Labor,Mike Workman,DEM,720040,0,0,75,75,
Tulsa,Commissioner of Labor,Mark Costello,REP,720040,0,0,60,60,
Tulsa,U.S. Senate,Matt Silverstein,DEM,720040,0,0,63,63,
Tulsa,U.S. Senate,Jim Inhofe,REP,720040,0,0,65,65,
Tulsa,U.S. Senate,Aaron Delozier,IND,720040,0,0,1,1,
Tulsa,U.S. Senate,Ray Woods,IND,720040,0,0,3,3,
Tulsa,U.S. Senate,Joan Farr,IND,720040,0,0,4,4,
Tulsa,U.S. Senate,Connie Johnson,DEM,720040,0,0,63,63,
Tulsa,U.S. Senate,James Lankford,REP,720040,0,0,62,62,
Tulsa,U.S. Senate,Mark Beard,IND,720040,0,0,9,9,
Tulsa,Governor,Joe Dorman,DEM,720041,0,0,64,64,
Tulsa,Governor,Mary Fallin,REP,720041,0,0,108,108,
Tulsa,Governor,Kimberly Willis,IND,720041,0,0,5,5,
Tulsa,Governor,Richard Prawdzienski,IND,720041,0,0,4,4,
Tulsa,Lieutenant Governor,Cathy Cummings,DEM,720041,0,0,56,56,
Tulsa,Lieutenant Governor,Todd Lamb,REP,720041,0,0,126,126,
Tulsa,Superintendent of Public Instruction,John Cox,DEM,720041,0,0,69,69,
Tulsa,Superintendent of Public Instruction,Joy Hofmeister,REP,720041,0,0,110,110,
Tulsa,Commissioner of Labor,Mike Workman,DEM,720041,0,0,65,65,
Tulsa,Commissioner of Labor,Mark Costello,REP,720041,0,0,111,111,
Tulsa,U.S. Senate,Matt Silverstein,DEM,720041,0,0,51,51,
Tulsa,U.S. Senate,Jim Inhofe,REP,720041,0,0,122,122,
Tulsa,U.S. Senate,Aaron Delozier,IND,720041,0,0,4,4,
Tulsa,U.S. Senate,Ray Woods,IND,720041,0,0,4,4,
Tulsa,U.S. Senate,Joan Farr,IND,720041,0,0,1,1,
Tulsa,U.S. Senate,Connie Johnson,DEM,720041,0,0,51,51,
Tulsa,U.S. Senate,James Lankford,REP,720041,0,0,120,120,
Tulsa,U.S. Senate,Mark Beard,IND,720041,0,0,10,10,
Tulsa,Governor,Joe Dorman,DEM,720042,0,0,85,85,
Tulsa,Governor,Mary Fallin,REP,720042,0,0,146,146,
Tulsa,Governor,Kimberly Willis,IND,720042,0,0,7,7,
Tulsa,Governor,Richard Prawdzienski,IND,720042,0,0,2,2,
Tulsa,Lieutenant Governor,Cathy Cummings,DEM,720042,0,0,80,80,
Tulsa,Lieutenant Governor,Todd Lamb,REP,720042,0,0,160,160,
Tulsa,Superintendent of Public Instruction,John Cox,DEM,720042,0,0,84,84,
Tulsa,Superintendent of Public Instruction,Joy Hofmeister,REP,720042,0,0,152,152,
Tulsa,Commissioner of Labor,Mike Workman,DEM,720042,0,0,84,84,
Tulsa,Commissioner of Labor,Mark Costello,REP,720042,0,0,154,154,
Tulsa,U.S. Senate,Matt Silverstein,DEM,720042,0,0,73,73,
Tulsa,U.S. Senate,Jim Inhofe,REP,720042,0,0,154,154,
Tulsa,U.S. Senate,Aaron Delozier,IND,720042,0,0,3,3,
Tulsa,U.S. Senate,Ray Woods,IND,720042,0,0,7,7,
Tulsa,U.S. Senate,Joan Farr,IND,720042,0,0,2,2,
Tulsa,U.S. Senate,Connie Johnson,DEM,720042,0,0,64,64,
Tulsa,U.S. Senate,James Lankford,REP,720042,0,0,163,163,
Tulsa,U.S. Senate,Mark Beard,IND,720042,0,0,13,13,
Tulsa,Governor,Joe Dorman,DEM,720043,0,0,81,81,
Tulsa,Governor,Mary Fallin,REP,720043,0,0,191,191,
Tulsa,Governor,Kimberly Willis,IND,720043,0,0,8,8,
Tulsa,Governor,Richard Prawdzienski,IND,720043,0,0,3,3,
Tulsa,Lieutenant Governor,Cathy Cummings,DEM,720043,0,0,74,74,
Tulsa,Lieutenant Governor,Todd Lamb,REP,720043,0,0,209,209,
Tulsa,Superintendent of Public Instruction,John Cox,DEM,720043,0,0,97,97,
Tulsa,Superintendent of Public Instruction,Joy Hofmeister,REP,720043,0,0,185,185,
Tulsa,Commissioner of Labor,Mike Workman,DEM,720043,0,0,85,85,
Tulsa,Commissioner of Labor,Mark Costello,REP,720043,0,0,191,191,
Tulsa,U.S. Senate,Matt Silverstein,DEM,720043,0,0,65,65,
Tulsa,U.S. Senate,Jim Inhofe,REP,720043,0,0,210,210,
Tulsa,U.S. Senate,Aaron Delozier,IND,720043,0,0,2,2,
Tulsa,U.S. Senate,Ray Woods,IND,720043,0,0,4,4,
Tulsa,U.S. Senate,Joan Farr,IND,720043,0,0,2,2,
Tulsa,U.S. Senate,Connie Johnson,DEM,720043,0,0,65,65,
Tulsa,U.S. Senate,James Lankford,REP,720043,0,0,208,208,
Tulsa,U.S. Senate,Mark Beard,IND,720043,0,0,8,8,
Tulsa,Governor,Joe Dorman,DEM,720044,0,0,142,142,
Tulsa,Governor,Mary Fallin,REP,720044,0,0,264,264,
Tulsa,Governor,Kimberly Willis,IND,720044,0,0,11,11,
Tulsa,Governor,Richard Prawdzienski,IND,720044,0,0,5,5,
Tulsa,Lieutenant Governor,Cathy Cummings,DEM,720044,0,0,121,121,
Tulsa,Lieutenant Governor,Todd Lamb,REP,720044,0,0,297,297,
Tulsa,Superintendent of Public Instruction,John Cox,DEM,720044,0,0,163,163,
Tulsa,Superintendent of Public Instruction,Joy Hofmeister,REP,720044,0,0,255,255,
Tulsa,Commissioner of Labor,Mike Workman,DEM,720044,0,0,129,129,
Tulsa,Commissioner of Labor,Mark Costello,REP,720044,0,0,286,286,
Tulsa,U.S. Senate,Matt Silverstein,DEM,720044,0,0,117,117,
Tulsa,U.S. Senate,Jim Inhofe,REP,720044,0,0,291,291,
Tulsa,U.S. Senate,Aaron Delozier,IND,720044,0,0,4,4,
Tulsa,U.S. Senate,Ray Woods,IND,720044,0,0,4,4,
Tulsa,U.S. Senate,Joan Farr,IND,720044,0,0,5,5,
Tulsa,U.S. Senate,Connie Johnson,DEM,720044,0,0,109,109,
Tulsa,U.S. Senate,James Lankford,REP,720044,0,0,296,296,
Tulsa,U.S. Senate,Mark Beard,IND,720044,0,0,13,13,
Tulsa,Governor,Joe Dorman,DEM,720045,0,0,0,0,
Tulsa,Governor,Mary Fallin,REP,720045,0,0,0,0,
Tulsa,Governor,Kimberly Willis,IND,720045,0,0,0,0,
Tulsa,Governor,Richard Prawdzienski,IND,720045,0,0,0,0,
Tulsa,Lieutenant Governor,Cathy Cummings,DEM,720045,0,0,0,0,
Tulsa,Lieutenant Governor,Todd Lamb,REP,720045,0,0,0,0,
Tulsa,Superintendent of Public Instruction,John Cox,DEM,720045,0,0,0,0,
Tulsa,Superintendent of Public Instruction,Joy Hofmeister,REP,720045,0,0,0,0,
Tulsa,Commissioner of Labor,Mike Workman,DEM,720045,0,0,0,0,
Tulsa,Commissioner of Labor,Mark Costello,REP,720045,0,0,0,0,
Tulsa,U.S. Senate,Matt Silverstein,DEM,720045,0,0,0,0,
Tulsa,U.S. Senate,Jim Inhofe,REP,720045,0,0,0,0,
Tulsa,U.S. Senate,Aaron Delozier,IND,720045,0,0,0,0,
Tulsa,U.S. Senate,Ray Woods,IND,720045,0,0,0,0,
Tulsa,U.S. Senate,Joan Farr,IND,720045,0,0,0,0,
Tulsa,U.S. Senate,Connie Johnson,DEM,720045,0,0,0,0,
Tulsa,U.S. Senate,James Lankford,REP,720045,0,0,0,0,
Tulsa,U.S. Senate,Mark Beard,IND,720045,0,0,0,0,
Tulsa,Governor,Joe Dorman,DEM,720046,0,0,587,587,
Tulsa,Governor,Mary Fallin,REP,720046,0,0,249,249,
Tulsa,Governor,Kimberly Willis,IND,720046,0,0,12,12,
Tulsa,Governor,Richard Prawdzienski,IND,720046,0,0,19,19,
Tulsa,Lieutenant Governor,Cathy Cummings,DEM,720046,0,0,520,520,
Tulsa,Lieutenant Governor,Todd Lamb,REP,720046,0,0,340,340,
Tulsa,Superintendent of Public Instruction,John Cox,DEM,720046,0,0,504,504,
Tulsa,Superintendent of Public Instruction,Joy Hofmeister,REP,720046,0,0,358,358,
Tulsa,Commissioner of Labor,Mike Workman,DEM,720046,0,0,523,523,
Tulsa,Commissioner of Labor,Mark Costello,REP,720046,0,0,315,315,
Tulsa,U.S. Senate,Matt Silverstein,DEM,720046,0,0,522,522,
Tulsa,U.S. Senate,Jim Inhofe,REP,720046,0,0,308,308,
Tulsa,U.S. Senate,Aaron Delozier,IND,720046,0,0,10,10,
Tulsa,U.S. Senate,Ray Woods,IND,720046,0,0,5,5,
Tulsa,U.S. Senate,Joan Farr,IND,720046,0,0,17,17,
Tulsa,U.S. Senate,Connie Johnson,DEM,720046,0,0,502,502,
Tulsa,U.S. Senate,James Lankford,REP,720046,0,0,322,322,
Tulsa,U.S. Senate,Mark Beard,IND,720046,0,0,38,38,
Tulsa,Governor,Joe Dorman,DEM,720047,0,0,72,72,
Tulsa,Governor,Mary Fallin,REP,720047,0,0,26,26,
Tulsa,Governor,Kimberly Willis,IND,720047,0,0,3,3,
Tulsa,Governor,Richard Prawdzienski,IND,720047,0,0,0,0,
Tulsa,Lieutenant Governor,Cathy Cummings,DEM,720047,0,0,65,65,
Tulsa,Lieutenant Governor,Todd Lamb,REP,720047,0,0,35,35,
Tulsa,Superintendent of Public Instruction,John Cox,DEM,720047,0,0,67,67,
Tulsa,Superintendent of Public Instruction,Joy Hofmeister,REP,720047,0,0,30,30,
Tulsa,Commissioner of Labor,Mike Workman,DEM,720047,0,0,64,64,
Tulsa,Commissioner of Labor,Mark Costello,REP,720047,0,0,32,32,
Tulsa,U.S. Senate,Matt Silverstein,DEM,720047,0,0,66,66,
Tulsa,U.S. Senate,Jim Inhofe,REP,720047,0,0,33,33,
Tulsa,U.S. Senate,Aaron Delozier,IND,720047,0,0,1,1,
Tulsa,U.S. Senate,Ray Woods,IND,720047,0,0,0,0,
Tulsa,U.S. Senate,Joan Farr,IND,720047,0,0,0,0,
Tulsa,U.S. Senate,Connie Johnson,DEM,720047,0,0,59,59,
Tulsa,U.S. Senate,James Lankford,REP,720047,0,0,31,31,
Tulsa,U.S. Senate,Mark Beard,IND,720047,0,0,9,9,
Tulsa,Governor,Joe Dorman,DEM,720048,0,0,416,416,
Tulsa,Governor,Mary Fallin,REP,720048,0,0,186,186,
Tulsa,Governor,Kimberly Willis,IND,720048,0,0,10,10,
Tulsa,Governor,Richard Prawdzienski,IND,720048,0,0,4,4,
Tulsa,Lieutenant Governor,Cathy Cummings,DEM,720048,0,0,357,357,
Tulsa,Lieutenant Governor,Todd Lamb,REP,720048,0,0,249,249,
Tulsa,Superintendent of Public Instruction,John Cox,DEM,720048,0,0,352,352,
Tulsa,Superintendent of Public Instruction,Joy Hofmeister,REP,720048,0,0,260,260,
Tulsa,Commissioner of Labor,Mike Workman,DEM,720048,0,0,341,341,
Tulsa,Commissioner of Labor,Mark Costello,REP,720048,0,0,243,243,
Tulsa,U.S. Senate,Matt Silverstein,DEM,720048,0,0,366,366,
Tulsa,U.S. Senate,Jim Inhofe,REP,720048,0,0,228,228,
Tulsa,U.S. Senate,Aaron Delozier,IND,720048,0,0,4,4,
Tulsa,U.S. Senate,Ray Woods,IND,720048,0,0,8,8,
Tulsa,U.S. Senate,Joan Farr,IND,720048,0,0,9,9,
Tulsa,U.S. Senate,Connie Johnson,DEM,720048,0,0,347,347,
Tulsa,U.S. Senate,James Lankford,REP,720048,0,0,248,248,
Tulsa,U.S. Senate,Mark Beard,IND,720048,0,0,19,19,
Tulsa,Governor,Joe Dorman,DEM,720049,0,0,150,150,
Tulsa,Governor,Mary Fallin,REP,720049,0,0,59,59,
Tulsa,Governor,Kimberly Willis,IND,720049,0,0,8,8,
Tulsa,Governor,Richard Prawdzienski,IND,720049,0,0,4,4,
Tulsa,Lieutenant Governor,Cathy Cummings,DEM,720049,0,0,142,142,
Tulsa,Lieutenant Governor,Todd Lamb,REP,720049,0,0,79,79,
Tulsa,Superintendent of Public Instruction,John Cox,DEM,720049,0,0,134,134,
Tulsa,Superintendent of Public Instruction,Joy Hofmeister,REP,720049,0,0,84,84,
Tulsa,Commissioner of Labor,Mike Workman,DEM,720049,0,0,147,147,
Tulsa,Commissioner of Labor,Mark Costello,REP,720049,0,0,61,61,
Tulsa,U.S. Senate,Matt Silverstein,DEM,720049,0,0,145,145,
Tulsa,U.S. Senate,Jim Inhofe,REP,720049,0,0,69,69,
Tulsa,U.S. Senate,Aaron Delozier,IND,720049,0,0,1,1,
Tulsa,U.S. Senate,Ray Woods,IND,720049,0,0,2,2,
Tulsa,U.S. Senate,Joan Farr,IND,720049,0,0,4,4,
Tulsa,U.S. Senate,Connie Johnson,DEM,720049,0,0,136,136,
Tulsa,U.S. Senate,James Lankford,REP,720049,0,0,74,74,
Tulsa,U.S. Senate,Mark Beard,IND,720049,0,0,10,10,
Tulsa,Governor,Joe Dorman,DEM,720050,0,0,226,226,
Tulsa,Governor,Mary Fallin,REP,720050,0,0,110,110,
Tulsa,Governor,Kimberly Willis,IND,720050,0,0,7,7,
Tulsa,Governor,Richard Prawdzienski,IND,720050,0,0,2,2,
Tulsa,Lieutenant Governor,Cathy Cummings,DEM,720050,0,0,205,205,
Tulsa,Lieutenant Governor,Todd Lamb,REP,720050,0,0,134,134,
Tulsa,Superintendent of Public Instruction,John Cox,DEM,720050,0,0,211,211,
Tulsa,Superintendent of Public Instruction,Joy Hofmeister,REP,720050,0,0,131,131,
Tulsa,Commissioner of Labor,Mike Workman,DEM,720050,0,0,196,196,
Tulsa,Commissioner of Labor,Mark Costello,REP,720050,0,0,136,136,
Tulsa,U.S. Senate,Matt Silverstein,DEM,720050,0,0,204,204,
Tulsa,U.S. Senate,Jim Inhofe,REP,720050,0,0,123,123,
Tulsa,U.S. Senate,Aaron Delozier,IND,720050,0,0,7,7,
Tulsa,U.S. Senate,Ray Woods,IND,720050,0,0,4,4,
Tulsa,U.S. Senate,Joan Farr,IND,720050,0,0,3,3,
Tulsa,U.S. Senate,Connie Johnson,DEM,720050,0,0,194,194,
Tulsa,U.S. Senate,James Lankford,REP,720050,0,0,127,127,
Tulsa,U.S. Senate,Mark Beard,IND,720050,0,0,19,19,
Tulsa,Governor,Joe Dorman,DEM,720051,0,0,296,296,
Tulsa,Governor,Mary Fallin,REP,720051,0,0,137,137,
Tulsa,Governor,Kimberly Willis,IND,720051,0,0,6,6,
Tulsa,Governor,Richard Prawdzienski,IND,720051,0,0,3,3,
Tulsa,Lieutenant Governor,Cathy Cummings,DEM,720051,0,0,254,254,
Tulsa,Lieutenant Governor,Todd Lamb,REP,720051,0,0,187,187,
Tulsa,Superintendent of Public Instruction,John Cox,DEM,720051,0,0,262,262,
Tulsa,Superintendent of Public Instruction,Joy Hofmeister,REP,720051,0,0,178,178,
Tulsa,Commissioner of Labor,Mike Workman,DEM,720051,0,0,249,249,
Tulsa,Commissioner of Labor,Mark Costello,REP,720051,0,0,182,182,
Tulsa,U.S. Senate,Matt Silverstein,DEM,720051,0,0,251,251,
Tulsa,U.S. Senate,Jim Inhofe,REP,720051,0,0,179,179,
Tulsa,U.S. Senate,Aaron Delozier,IND,720051,0,0,4,4,
Tulsa,U.S. Senate,Ray Woods,IND,720051,0,0,1,1,
Tulsa,U.S. Senate,Joan Farr,IND,720051,0,0,5,5,
Tulsa,U.S. Senate,Connie Johnson,DEM,720051,0,0,244,244,
Tulsa,U.S. Senate,James Lankford,REP,720051,0,0,184,184,
Tulsa,U.S. Senate,Mark Beard,IND,720051,0,0,16,16,
Tulsa,Governor,Joe Dorman,DEM,720052,0,0,500,500,
Tulsa,Governor,Mary Fallin,REP,720052,0,0,326,326,
Tulsa,Governor,Kimberly Willis,IND,720052,0,0,13,13,
Tulsa,Governor,Richard Prawdzienski,IND,720052,0,0,6,6,
Tulsa,Lieutenant Governor,Cathy Cummings,DEM,720052,0,0,436,436,
Tulsa,Lieutenant Governor,Todd Lamb,REP,720052,0,0,403,403,
Tulsa,Superintendent of Public Instruction,John Cox,DEM,720052,0,0,421,421,
Tulsa,Superintendent of Public Instruction,Joy Hofmeister,REP,720052,0,0,418,418,
Tulsa,Commissioner of Labor,Mike Workman,DEM,720052,0,0,439,439,
Tulsa,Commissioner of Labor,Mark Costello,REP,720052,0,0,378,378,
Tulsa,U.S. Senate,Matt Silverstein,DEM,720052,0,0,440,440,
Tulsa,U.S. Senate,Jim Inhofe,REP,720052,0,0,369,369,
Tulsa,U.S. Senate,Aaron Delozier,IND,720052,0,0,12,12,
Tulsa,U.S. Senate,Ray Woods,IND,720052,0,0,5,5,
Tulsa,U.S. Senate,Joan Farr,IND,720052,0,0,13,13,
Tulsa,U.S. Senate,Connie Johnson,DEM,720052,0,0,416,416,
Tulsa,U.S. Senate,James Lankford,REP,720052,0,0,392,392,
Tulsa,U.S. Senate,Mark Beard,IND,720052,0,0,29,29,
Tulsa,Governor,Joe Dorman,DEM,720053,0,0,229,229,
Tulsa,Governor,Mary Fallin,REP,720053,0,0,316,316,
Tulsa,Governor,Kimberly Willis,IND,720053,0,0,18,18,
Tulsa,Governor,Richard Prawdzienski,IND,720053,0,0,5,5,
Tulsa,Lieutenant Governor,Cathy Cummings,DEM,720053,0,0,198,198,
Tulsa,Lieutenant Governor,Todd Lamb,REP,720053,0,0,367,367,
Tulsa,Superintendent of Public Instruction,John Cox,DEM,720053,0,0,240,240,
Tulsa,Superintendent of Public Instruction,Joy Hofmeister,REP,720053,0,0,326,326,
Tulsa,Commissioner of Labor,Mike Workman,DEM,720053,0,0,224,224,
Tulsa,Commissioner of Labor,Mark Costello,REP,720053,0,0,332,332,
Tulsa,U.S. Senate,Matt Silverstein,DEM,720053,0,0,193,193,
Tulsa,U.S. Senate,Jim Inhofe,REP,720053,0,0,346,346,
Tulsa,U.S. Senate,Aaron Delozier,IND,720053,0,0,8,8,
Tulsa,U.S. Senate,Ray Woods,IND,720053,0,0,4,4,
Tulsa,U.S. Senate,Joan Farr,IND,720053,0,0,14,14,
Tulsa,U.S. Senate,Connie Johnson,DEM,720053,0,0,202,202,
Tulsa,U.S. Senate,James Lankford,REP,720053,0,0,348,348,
Tulsa,U.S. Senate,Mark Beard,IND,720053,0,0,17,17,
Tulsa,Governor,Joe Dorman,DEM,720054,0,0,467,467,
Tulsa,Governor,Mary Fallin,REP,720054,0,0,327,327,
Tulsa,Governor,Kimberly Willis,IND,720054,0,0,12,12,
Tulsa,Governor,Richard Prawdzienski,IND,720054,0,0,4,4,
Tulsa,Lieutenant Governor,Cathy Cummings,DEM,720054,0,0,408,408,
Tulsa,Lieutenant Governor,Todd Lamb,REP,720054,0,0,397,397,
Tulsa,Superintendent of Public Instruction,John Cox,DEM,720054,0,0,417,417,
Tulsa,Superintendent of Public Instruction,Joy Hofmeister,REP,720054,0,0,388,388,
Tulsa,Commissioner of Labor,Mike Workman,DEM,720054,0,0,410,410,
Tulsa,Commissioner of Labor,Mark Costello,REP,720054,0,0,380,380,
Tulsa,U.S. Senate,Matt Silverstein,DEM,720054,0,0,398,398,
Tulsa,U.S. Senate,Jim Inhofe,REP,720054,0,0,367,367,
Tulsa,U.S. Senate,Aaron Delozier,IND,720054,0,0,13,13,
Tulsa,U.S. Senate,Ray Woods,IND,720054,0,0,7,7,
Tulsa,U.S. Senate,Joan Farr,IND,720054,0,0,20,20,
Tulsa,U.S. Senate,Connie Johnson,DEM,720054,0,0,393,393,
Tulsa,U.S. Senate,James Lankford,REP,720054,0,0,380,380,
Tulsa,U.S. Senate,Mark Beard,IND,720054,0,0,29,29,
Tulsa,Governor,Joe Dorman,DEM,720055,0,0,202,202,
Tulsa,Governor,Mary Fallin,REP,720055,0,0,183,183,
Tulsa,Governor,Kimberly Willis,IND,720055,0,0,12,12,
Tulsa,Governor,Richard Prawdzienski,IND,720055,0,0,3,3,
Tulsa,Lieutenant Governor,Cathy Cummings,DEM,720055,0,0,174,174,
Tulsa,Lieutenant Governor,Todd Lamb,REP,720055,0,0,222,222,
Tulsa,Superintendent of Public Instruction,John Cox,DEM,720055,0,0,193,193,
Tulsa,Superintendent of Public Instruction,Joy Hofmeister,REP,720055,0,0,205,205,
Tulsa,Commissioner of Labor,Mike Workman,DEM,720055,0,0,183,183,
Tulsa,Commissioner of Labor,Mark Costello,REP,720055,0,0,205,205,
Tulsa,U.S. Senate,Matt Silverstein,DEM,720055,0,0,172,172,
Tulsa,U.S. Senate,Jim Inhofe,REP,720055,0,0,218,218,
Tulsa,U.S. Senate,Aaron Delozier,IND,720055,0,0,4,4,
Tulsa,U.S. Senate,Ray Woods,IND,720055,0,0,1,1,
Tulsa,U.S. Senate,Joan Farr,IND,720055,0,0,3,3,
Tulsa,U.S. Senate,Connie Johnson,DEM,720055,0,0,158,158,
Tulsa,U.S. Senate,James Lankford,REP,720055,0,0,217,217,
Tulsa,U.S. Senate,Mark Beard,IND,720055,0,0,20,20,
Tulsa,Governor,Joe Dorman,DEM,720056,0,0,200,200,
Tulsa,Governor,Mary Fallin,REP,720056,0,0,277,277,
Tulsa,Governor,Kimberly Willis,IND,720056,0,0,12,12,
Tulsa,Governor,Richard Prawdzienski,IND,720056,0,0,11,11,
Tulsa,Lieutenant Governor,Cathy Cummings,DEM,720056,0,0,182,182,
Tulsa,Lieutenant Governor,Todd Lamb,REP,720056,0,0,314,314,
Tulsa,Superintendent of Public Instruction,John Cox,DEM,720056,0,0,203,203,
Tulsa,Superintendent of Public Instruction,Joy Hofmeister,REP,720056,0,0,291,291,
Tulsa,Commissioner of Labor,Mike Workman,DEM,720056,0,0,193,193,
Tulsa,Commissioner of Labor,Mark Costello,REP,720056,0,0,292,292,
Tulsa,U.S. Senate,Matt Silverstein,DEM,720056,0,0,176,176,
Tulsa,U.S. Senate,Jim Inhofe,REP,720056,0,0,307,307,
Tulsa,U.S. Senate,Aaron Delozier,IND,720056,0,0,3,3,
Tulsa,U.S. Senate,Ray Woods,IND,720056,0,0,6,6,
Tulsa,U.S. Senate,Joan Farr,IND,720056,0,0,5,5,
Tulsa,U.S. Senate,Connie Johnson,DEM,720056,0,0,176,176,
Tulsa,U.S. Senate,James Lankford,REP,720056,0,0,307,307,
Tulsa,U.S. Senate,Mark Beard,IND,720056,0,0,14,14,
Tulsa,Governor,Joe Dorman,DEM,720057,0,0,78,78,
Tulsa,Governor,Mary Fallin,REP,720057,0,0,94,94,
Tulsa,Governor,Kimberly Willis,IND,720057,0,0,3,3,
Tulsa,Governor,Richard Prawdzienski,IND,720057,0,0,4,4,
Tulsa,Lieutenant Governor,Cathy Cummings,DEM,720057,0,0,57,57,
Tulsa,Lieutenant Governor,Todd Lamb,REP,720057,0,0,123,123,
Tulsa,Superintendent of Public Instruction,John Cox,DEM,720057,0,0,73,73,
Tulsa,Superintendent of Public Instruction,Joy Hofmeister,REP,720057,0,0,108,108,
Tulsa,Commissioner of Labor,Mike Workman,DEM,720057,0,0,73,73,
Tulsa,Commissioner of Labor,Mark Costello,REP,720057,0,0,105,105,
Tulsa,U.S. Senate,Matt Silverstein,DEM,720057,0,0,60,60,
Tulsa,U.S. Senate,Jim Inhofe,REP,720057,0,0,114,114,
Tulsa,U.S. Senate,Aaron Delozier,IND,720057,0,0,2,2,
Tulsa,U.S. Senate,Ray Woods,IND,720057,0,0,1,1,
Tulsa,U.S. Senate,Joan Farr,IND,720057,0,0,3,3,
Tulsa,U.S. Senate,Connie Johnson,DEM,720057,0,0,60,60,
Tulsa,U.S. Senate,James Lankford,REP,720057,0,0,115,115,
Tulsa,U.S. Senate,Mark Beard,IND,720057,0,0,6,6,
Tulsa,Governor,Joe Dorman,DEM,720058,0,0,98,98,
Tulsa,Governor,Mary Fallin,REP,720058,0,0,169,169,
Tulsa,Governor,Kimberly Willis,IND,720058,0,0,4,4,
Tulsa,Governor,Richard Prawdzienski,IND,720058,0,0,2,2,
Tulsa,Lieutenant Governor,Cathy Cummings,DEM,720058,0,0,83,83,
Tulsa,Lieutenant Governor,Todd Lamb,REP,720058,0,0,187,187,
Tulsa,Superintendent of Public Instruction,John Cox,DEM,720058,0,0,100,100,
Tulsa,Superintendent of Public Instruction,Joy Hofmeister,REP,720058,0,0,170,170,
Tulsa,Commissioner of Labor,Mike Workman,DEM,720058,0,0,88,88,
Tulsa,Commissioner of Labor,Mark Costello,REP,720058,0,0,175,175,
Tulsa,U.S. Senate,Matt Silverstein,DEM,720058,0,0,78,78,
Tulsa,U.S. Senate,Jim Inhofe,REP,720058,0,0,188,188,
Tulsa,U.S. Senate,Aaron Delozier,IND,720058,0,0,3,3,
Tulsa,U.S. Senate,Ray Woods,IND,720058,0,0,0,0,
Tulsa,U.S. Senate,Joan Farr,IND,720058,0,0,2,2,
Tulsa,U.S. Senate,Connie Johnson,DEM,720058,0,0,69,69,
Tulsa,U.S. Senate,James Lankford,REP,720058,0,0,191,191,
Tulsa,U.S. Senate,Mark Beard,IND,720058,0,0,8,8,
Tulsa,Governor,Joe Dorman,DEM,720059,0,0,115,115,
Tulsa,Governor,Mary Fallin,REP,720059,0,0,151,151,
Tulsa,Governor,Kimberly Willis,IND,720059,0,0,4,4,
Tulsa,Governor,Richard Prawdzienski,IND,720059,0,0,2,2,
Tulsa,Lieutenant Governor,Cathy Cummings,DEM,720059,0,0,92,92,
Tulsa,Lieutenant Governor,Todd Lamb,REP,720059,0,0,179,179,
Tulsa,Superintendent of Public Instruction,John Cox,DEM,720059,0,0,128,128,
Tulsa,Superintendent of Public Instruction,Joy Hofmeister,REP,720059,0,0,146,146,
Tulsa,Commissioner of Labor,Mike Workman,DEM,720059,0,0,117,117,
Tulsa,Commissioner of Labor,Mark Costello,REP,720059,0,0,150,150,
Tulsa,U.S. Senate,Matt Silverstein,DEM,720059,0,0,99,99,
Tulsa,U.S. Senate,Jim Inhofe,REP,720059,0,0,168,168,
Tulsa,U.S. Senate,Aaron Delozier,IND,720059,0,0,3,3,
Tulsa,U.S. Senate,Ray Woods,IND,720059,0,0,3,3,
Tulsa,U.S. Senate,Joan Farr,IND,720059,0,0,0,0,
Tulsa,U.S. Senate,Connie Johnson,DEM,720059,0,0,95,95,
Tulsa,U.S. Senate,James Lankford,REP,720059,0,0,163,163,
Tulsa,U.S. Senate,Mark Beard,IND,720059,0,0,10,10,
Tulsa,Governor,Joe Dorman,DEM,720060,0,0,187,187,
Tulsa,Governor,Mary Fallin,REP,720060,0,0,171,171,
Tulsa,Governor,Kimberly Willis,IND,720060,0,0,11,11,
Tulsa,Governor,Richard Prawdzienski,IND,720060,0,0,7,7,
Tulsa,Lieutenant Governor,Cathy Cummings,DEM,720060,0,0,167,167,
Tulsa,Lieutenant Governor,Todd Lamb,REP,720060,0,0,207,207,
Tulsa,Superintendent of Public Instruction,John Cox,DEM,720060,0,0,182,182,
Tulsa,Superintendent of Public Instruction,Joy Hofmeister,REP,720060,0,0,192,192,
Tulsa,Commissioner of Labor,Mike Workman,DEM,720060,0,0,181,181,
Tulsa,Commissioner of Labor,Mark Costello,REP,720060,0,0,186,186,
Tulsa,U.S. Senate,Matt Silverstein,DEM,720060,0,0,157,157,
Tulsa,U.S. Senate,Jim Inhofe,REP,720060,0,0,198,198,
Tulsa,U.S. Senate,Aaron Delozier,IND,720060,0,0,4,4,
Tulsa,U.S. Senate,Ray Woods,IND,720060,0,0,6,6,
Tulsa,U.S. Senate,Joan Farr,IND,720060,0,0,11,11,
Tulsa,U.S. Senate,Connie Johnson,DEM,720060,0,0,155,155,
Tulsa,U.S. Senate,James Lankford,REP,720060,0,0,197,197,
Tulsa,U.S. Senate,Mark Beard,IND,720060,0,0,21,21,
Tulsa,Governor,Joe Dorman,DEM,720061,0,0,199,199,
Tulsa,Governor,Mary Fallin,REP,720061,0,0,231,231,
Tulsa,Governor,Kimberly Willis,IND,720061,0,0,15,15,
Tulsa,Governor,Richard Prawdzienski,IND,720061,0,0,7,7,
Tulsa,Lieutenant Governor,Cathy Cummings,DEM,720061,0,0,179,179,
Tulsa,Lieutenant Governor,Todd Lamb,REP,720061,0,0,267,267,
Tulsa,Superintendent of Public Instruction,John Cox,DEM,720061,0,0,215,215,
Tulsa,Superintendent of Public Instruction,Joy Hofmeister,REP,720061,0,0,231,231,
Tulsa,Commissioner of Labor,Mike Workman,DEM,720061,0,0,188,188,
Tulsa,Commissioner of Labor,Mark Costello,REP,720061,0,0,250,250,
Tulsa,U.S. Senate,Matt Silverstein,DEM,720061,0,0,172,172,
Tulsa,U.S. Senate,Jim Inhofe,REP,720061,0,0,263,263,
Tulsa,U.S. Senate,Aaron Delozier,IND,720061,0,0,3,3,
Tulsa,U.S. Senate,Ray Woods,IND,720061,0,0,4,4,
Tulsa,U.S. Senate,Joan Farr,IND,720061,0,0,7,7,
Tulsa,U.S. Senate,Connie Johnson,DEM,720061,0,0,169,169,
Tulsa,U.S. Senate,James Lankford,REP,720061,0,0,256,256,
Tulsa,U.S. Senate,Mark Beard,IND,720061,0,0,20,20,
Tulsa,Governor,Joe Dorman,DEM,720062,0,0,563,563,
Tulsa,Governor,Mary Fallin,REP,720062,0,0,478,478,
Tulsa,Governor,Kimberly Willis,IND,720062,0,0,11,11,
Tulsa,Governor,Richard Prawdzienski,IND,720062,0,0,6,6,
Tulsa,Lieutenant Governor,Cathy Cummings,DEM,720062,0,0,461,461,
Tulsa,Lieutenant Governor,Todd Lamb,REP,720062,0,0,583,583,
Tulsa,Superintendent of Public Instruction,John Cox,DEM,720062,0,0,408,408,
Tulsa,Superintendent of Public Instruction,Joy Hofmeister,REP,720062,0,0,640,640,
Tulsa,Commissioner of Labor,Mike Workman,DEM,720062,0,0,464,464,
Tulsa,Commissioner of Labor,Mark Costello,REP,720062,0,0,536,536,
Tulsa,U.S. Senate,Matt Silverstein,DEM,720062,0,0,503,503,
Tulsa,U.S. Senate,Jim Inhofe,REP,720062,0,0,533,533,
Tulsa,U.S. Senate,Aaron Delozier,IND,720062,0,0,8,8,
Tulsa,U.S. Senate,Ray Woods,IND,720062,0,0,2,2,
Tulsa,U.S. Senate,Joan Farr,IND,720062,0,0,9,9,
Tulsa,U.S. Senate,Connie Johnson,DEM,720062,0,0,438,438,
Tulsa,U.S. Senate,James Lankford,REP,720062,0,0,577,577,
Tulsa,U.S. Senate,Mark Beard,IND,720062,0,0,21,21,
Tulsa,Governor,Joe Dorman,DEM,720063,0,0,228,228,
Tulsa,Governor,Mary Fallin,REP,720063,0,0,124,124,
Tulsa,Governor,Kimberly Willis,IND,720063,0,0,6,6,
Tulsa,Governor,Richard Prawdzienski,IND,720063,0,0,4,4,
Tulsa,Lieutenant Governor,Cathy Cummings,DEM,720063,0,0,185,185,
Tulsa,Lieutenant Governor,Todd Lamb,REP,720063,0,0,171,171,
Tulsa,Superintendent of Public Instruction,John Cox,DEM,720063,0,0,193,193,
Tulsa,Superintendent of Public Instruction,Joy Hofmeister,REP,720063,0,0,162,162,
Tulsa,Commissioner of Labor,Mike Workman,DEM,720063,0,0,183,183,
Tulsa,Commissioner of Labor,Mark Costello,REP,720063,0,0,159,159,
Tulsa,U.S. Senate,Matt Silverstein,DEM,720063,0,0,185,185,
Tulsa,U.S. Senate,Jim Inhofe,REP,720063,0,0,150,150,
Tulsa,U.S. Senate,Aaron Delozier,IND,720063,0,0,7,7,
Tulsa,U.S. Senate,Ray Woods,IND,720063,0,0,3,3,
Tulsa,U.S. Senate,Joan Farr,IND,720063,0,0,14,14,
Tulsa,U.S. Senate,Connie Johnson,DEM,720063,0,0,173,173,
Tulsa,U.S. Senate,James Lankford,REP,720063,0,0,164,164,
Tulsa,U.S. Senate,Mark Beard,IND,720063,0,0,19,19,
Tulsa,Governor,Joe Dorman,DEM,720064,0,0,296,296,
Tulsa,Governor,Mary Fallin,REP,720064,0,0,175,175,
Tulsa,Governor,Kimberly Willis,IND,720064,0,0,17,17,
Tulsa,Governor,Richard Prawdzienski,IND,720064,0,0,5,5,
Tulsa,Lieutenant Governor,Cathy Cummings,DEM,720064,0,0,253,253,
Tulsa,Lieutenant Governor,Todd Lamb,REP,720064,0,0,235,235,
Tulsa,Superintendent of Public Instruction,John Cox,DEM,720064,0,0,256,256,
Tulsa,Superintendent of Public Instruction,Joy Hofmeister,REP,720064,0,0,231,231,
Tulsa,Commissioner of Labor,Mike Workman,DEM,720064,0,0,246,246,
Tulsa,Commissioner of Labor,Mark Costello,REP,720064,0,0,228,228,
Tulsa,U.S. Senate,Matt Silverstein,DEM,720064,0,0,247,247,
Tulsa,U.S. Senate,Jim Inhofe,REP,720064,0,0,214,214,
Tulsa,U.S. Senate,Aaron Delozier,IND,720064,0,0,11,11,
Tulsa,U.S. Senate,Ray Woods,IND,720064,0,0,7,7,
Tulsa,U.S. Senate,Joan Farr,IND,720064,0,0,9,9,
Tulsa,U.S. Senate,Connie Johnson,DEM,720064,0,0,229,229,
Tulsa,U.S. Senate,James Lankford,REP,720064,0,0,224,224,
Tulsa,U.S. Senate,Mark Beard,IND,720064,0,0,33,33,
Tulsa,Governor,Joe Dorman,DEM,720065,0,0,338,338,
Tulsa,Governor,Mary Fallin,REP,720065,0,0,367,367,
Tulsa,Governor,Kimberly Willis,IND,720065,0,0,12,12,
Tulsa,Governor,Richard Prawdzienski,IND,720065,0,0,2,2,
Tulsa,Lieutenant Governor,Cathy Cummings,DEM,720065,0,0,258,258,
Tulsa,Lieutenant Governor,Todd Lamb,REP,720065,0,0,447,447,
Tulsa,Superintendent of Public Instruction,John Cox,DEM,720065,0,0,239,239,
Tulsa,Superintendent of Public Instruction,Joy Hofmeister,REP,720065,0,0,475,475,
Tulsa,Commissioner of Labor,Mike Workman,DEM,720065,0,0,255,255,
Tulsa,Commissioner of Labor,Mark Costello,REP,720065,0,0,426,426,
Tulsa,U.S. Senate,Matt Silverstein,DEM,720065,0,0,280,280,
Tulsa,U.S. Senate,Jim Inhofe,REP,720065,0,0,417,417,
Tulsa,U.S. Senate,Aaron Delozier,IND,720065,0,0,5,5,
Tulsa,U.S. Senate,Ray Woods,IND,720065,0,0,3,3,
Tulsa,U.S. Senate,Joan Farr,IND,720065,0,0,8,8,
Tulsa,U.S. Senate,Connie Johnson,DEM,720065,0,0,245,245,
Tulsa,U.S. Senate,James Lankford,REP,720065,0,0,446,446,
Tulsa,U.S. Senate,Mark Beard,IND,720065,0,0,16,16,
Tulsa,Governor,Joe Dorman,DEM,720066,0,0,351,351,
Tulsa,Governor,Mary Fallin,REP,720066,0,0,313,313,
Tulsa,Governor,Kimberly Willis,IND,720066,0,0,9,9,
Tulsa,Governor,Richard Prawdzienski,IND,720066,0,0,1,1,
Tulsa,Lieutenant Governor,Cathy Cummings,DEM,720066,0,0,250,250,
Tulsa,Lieutenant Governor,Todd Lamb,REP,720066,0,0,416,416,
Tulsa,Superintendent of Public Instruction,John Cox,DEM,720066,0,0,252,252,
Tulsa,Superintendent of Public Instruction,Joy Hofmeister,REP,720066,0,0,425,425,
Tulsa,Commissioner of Labor,Mike Workman,DEM,720066,0,0,248,248,
Tulsa,Commissioner of Labor,Mark Costello,REP,720066,0,0,389,389,
Tulsa,U.S. Senate,Matt Silverstein,DEM,720066,0,0,274,274,
Tulsa,U.S. Senate,Jim Inhofe,REP,720066,0,0,386,386,
Tulsa,U.S. Senate,Aaron Delozier,IND,720066,0,0,3,3,
Tulsa,U.S. Senate,Ray Woods,IND,720066,0,0,0,0,
Tulsa,U.S. Senate,Joan Farr,IND,720066,0,0,6,6,
Tulsa,U.S. Senate,Connie Johnson,DEM,720066,0,0,240,240,
Tulsa,U.S. Senate,James Lankford,REP,720066,0,0,413,413,
Tulsa,U.S. Senate,Mark Beard,IND,720066,0,0,14,14,
Tulsa,Governor,Joe Dorman,DEM,720067,0,0,267,267,
Tulsa,Governor,Mary Fallin,REP,720067,0,0,267,267,
Tulsa,Governor,Kimberly Willis,IND,720067,0,0,9,9,
Tulsa,Governor,Richard Prawdzienski,IND,720067,0,0,3,3,
Tulsa,Lieutenant Governor,Cathy Cummings,DEM,720067,0,0,210,210,
Tulsa,Lieutenant Governor,Todd Lamb,REP,720067,0,0,328,328,
Tulsa,Superintendent of Public Instruction,John Cox,DEM,720067,0,0,213,213,
Tulsa,Superintendent of Public Instruction,Joy Hofmeister,REP,720067,0,0,332,332,
Tulsa,Commissioner of Labor,Mike Workman,DEM,720067,0,0,206,206,
Tulsa,Commissioner of Labor,Mark Costello,REP,720067,0,0,317,317,
Tulsa,U.S. Senate,Matt Silverstein,DEM,720067,0,0,222,222,
Tulsa,U.S. Senate,Jim Inhofe,REP,720067,0,0,313,313,
Tulsa,U.S. Senate,Aaron Delozier,IND,720067,0,0,2,2,
Tulsa,U.S. Senate,Ray Woods,IND,720067,0,0,4,4,
Tulsa,U.S. Senate,Joan Farr,IND,720067,0,0,2,2,
Tulsa,U.S. Senate,Connie Johnson,DEM,720067,0,0,194,194,
Tulsa,U.S. Senate,James Lankford,REP,720067,0,0,330,330,
Tulsa,U.S. Senate,Mark Beard,IND,720067,0,0,24,24,
Tulsa,Governor,Joe Dorman,DEM,720068,0,0,253,253,
Tulsa,Governor,Mary Fallin,REP,720068,0,0,174,174,
Tulsa,Governor,Kimberly Willis,IND,720068,0,0,9,9,
Tulsa,Governor,Richard Prawdzienski,IND,720068,0,0,7,7,
Tulsa,Lieutenant Governor,Cathy Cummings,DEM,720068,0,0,231,231,
Tulsa,Lieutenant Governor,Todd Lamb,REP,720068,0,0,211,211,
Tulsa,Superintendent of Public Instruction,John Cox,DEM,720068,0,0,232,232,
Tulsa,Superintendent of Public Instruction,Joy Hofmeister,REP,720068,0,0,206,206,
Tulsa,Commissioner of Labor,Mike Workman,DEM,720068,0,0,233,233,
Tulsa,Commissioner of Labor,Mark Costello,REP,720068,0,0,199,199,
Tulsa,U.S. Senate,Matt Silverstein,DEM,720068,0,0,216,216,
Tulsa,U.S. Senate,Jim Inhofe,REP,720068,0,0,204,204,
Tulsa,U.S. Senate,Aaron Delozier,IND,720068,0,0,7,7,
Tulsa,U.S. Senate,Ray Woods,IND,720068,0,0,8,8,
Tulsa,U.S. Senate,Joan Farr,IND,720068,0,0,8,8,
Tulsa,U.S. Senate,Connie Johnson,DEM,720068,0,0,213,213,
Tulsa,U.S. Senate,James Lankford,REP,720068,0,0,204,204,
Tulsa,U.S. Senate,Mark Beard,IND,720068,0,0,26,26,
Tulsa,Governor,Joe Dorman,DEM,720069,0,0,394,394,
Tulsa,Governor,Mary Fallin,REP,720069,0,0,397,397,
Tulsa,Governor,Kimberly Willis,IND,720069,0,0,10,10,
Tulsa,Governor,Richard Prawdzienski,IND,720069,0,0,8,8,
Tulsa,Lieutenant Governor,Cathy Cummings,DEM,720069,0,0,328,328,
Tulsa,Lieutenant Governor,Todd Lamb,REP,720069,0,0,481,481,
Tulsa,Superintendent of Public Instruction,John Cox,DEM,720069,0,0,316,316,
Tulsa,Superintendent of Public Instruction,Joy Hofmeister,REP,720069,0,0,488,488,
Tulsa,Commissioner of Labor,Mike Workman,DEM,720069,0,0,341,341,
Tulsa,Commissioner of Labor,Mark Costello,REP,720069,0,0,444,444,
Tulsa,U.S. Senate,Matt Silverstein,DEM,720069,0,0,345,345,
Tulsa,U.S. Senate,Jim Inhofe,REP,720069,0,0,444,444,
Tulsa,U.S. Senate,Aaron Delozier,IND,720069,0,0,8,8,
Tulsa,U.S. Senate,Ray Woods,IND,720069,0,0,4,4,
Tulsa,U.S. Senate,Joan Farr,IND,720069,0,0,9,9,
Tulsa,U.S. Senate,Connie Johnson,DEM,720069,0,0,320,320,
Tulsa,U.S. Senate,James Lankford,REP,720069,0,0,464,464,
Tulsa,U.S. Senate,Mark Beard,IND,720069,0,0,22,22,
Tulsa,Governor,Joe Dorman,DEM,720070,0,0,64,64,
Tulsa,Governor,Mary Fallin,REP,720070,0,0,86,86,
Tulsa,Governor,Kimberly Willis,IND,720070,0,0,5,5,
Tulsa,Governor,Richard Prawdzienski,IND,720070,0,0,2,2,
Tulsa,Lieutenant Governor,Cathy Cummings,DEM,720070,0,0,55,55,
Tulsa,Lieutenant Governor,Todd Lamb,REP,720070,0,0,102,102,
Tulsa,Superintendent of Public Instruction,John Cox,DEM,720070,0,0,65,65,
Tulsa,Superintendent of Public Instruction,Joy Hofmeister,REP,720070,0,0,91,91,
Tulsa,Commissioner of Labor,Mike Workman,DEM,720070,0,0,61,61,
Tulsa,Commissioner of Labor,Mark Costello,REP,720070,0,0,96,96,
Tulsa,U.S. Senate,Matt Silverstein,DEM,720070,0,0,53,53,
Tulsa,U.S. Senate,Jim Inhofe,REP,720070,0,0,98,98,
Tulsa,U.S. Senate,Aaron Delozier,IND,720070,0,0,2,2,
Tulsa,U.S. Senate,Ray Woods,IND,720070,0,0,2,2,
Tulsa,U.S. Senate,Joan Farr,IND,720070,0,0,3,3,
Tulsa,U.S. Senate,Connie Johnson,DEM,720070,0,0,56,56,
Tulsa,U.S. Senate,James Lankford,REP,720070,0,0,95,95,
Tulsa,U.S. Senate,Mark Beard,IND,720070,0,0,3,3,
Tulsa,Governor,Joe Dorman,DEM,720071,0,0,626,626,
Tulsa,Governor,Mary Fallin,REP,720071,0,0,641,641,
Tulsa,Governor,Kimberly Willis,IND,720071,0,0,13,13,
Tulsa,Governor,Richard Prawdzienski,IND,720071,0,0,1,1,
Tulsa,Lieutenant Governor,Cathy Cummings,DEM,720071,0,0,482,482,
Tulsa,Lieutenant Governor,Todd Lamb,REP,720071,0,0,786,786,
Tulsa,Superintendent of Public Instruction,John Cox,DEM,720071,0,0,455,455,
Tulsa,Superintendent of Public Instruction,Joy Hofmeister,REP,720071,0,0,812,812,
Tulsa,Commissioner of Labor,Mike Workman,DEM,720071,0,0,491,491,
Tulsa,Commissioner of Labor,Mark Costello,REP,720071,0,0,728,728,
Tulsa,U.S. Senate,Matt Silverstein,DEM,720071,0,0,515,515,
Tulsa,U.S. Senate,Jim Inhofe,REP,720071,0,0,727,727,
Tulsa,U.S. Senate,Aaron Delozier,IND,720071,0,0,6,6,
Tulsa,U.S. Senate,Ray Woods,IND,720071,0,0,6,6,
Tulsa,U.S. Senate,Joan Farr,IND,720071,0,0,15,15,
Tulsa,U.S. Senate,Connie Johnson,DEM,720071,0,0,466,466,
Tulsa,U.S. Senate,James Lankford,REP,720071,0,0,771,771,
Tulsa,U.S. Senate,Mark Beard,IND,720071,0,0,34,34,
Tulsa,Governor,Joe Dorman,DEM,720072,0,0,255,255,
Tulsa,Governor,Mary Fallin,REP,720072,0,0,251,251,
Tulsa,Governor,Kimberly Willis,IND,720072,0,0,5,5,
Tulsa,Governor,Richard Prawdzienski,IND,720072,0,0,1,1,
Tulsa,Lieutenant Governor,Cathy Cummings,DEM,720072,0,0,186,186,
Tulsa,Lieutenant Governor,Todd Lamb,REP,720072,0,0,323,323,
Tulsa,Superintendent of Public Instruction,John Cox,DEM,720072,0,0,182,182,
Tulsa,Superintendent of Public Instruction,Joy Hofmeister,REP,720072,0,0,331,331,
Tulsa,Commissioner of Labor,Mike Workman,DEM,720072,0,0,188,188,
Tulsa,Commissioner of Labor,Mark Costello,REP,720072,0,0,303,303,
Tulsa,U.S. Senate,Matt Silverstein,DEM,720072,0,0,208,208,
Tulsa,U.S. Senate,Jim Inhofe,REP,720072,0,0,284,284,
Tulsa,U.S. Senate,Aaron Delozier,IND,720072,0,0,4,4,
Tulsa,U.S. Senate,Ray Woods,IND,720072,0,0,4,4,
Tulsa,U.S. Senate,Joan Farr,IND,720072,0,0,8,8,
Tulsa,U.S. Senate,Connie Johnson,DEM,720072,0,0,180,180,
Tulsa,U.S. Senate,James Lankford,REP,720072,0,0,316,316,
Tulsa,U.S. Senate,Mark Beard,IND,720072,0,0,13,13,
Tulsa,Governor,Joe Dorman,DEM,720073,0,0,217,217,
Tulsa,Governor,Mary Fallin,REP,720073,0,0,301,301,
Tulsa,Governor,Kimberly Willis,IND,720073,0,0,8,8,
Tulsa,Governor,Richard Prawdzienski,IND,720073,0,0,6,6,
Tulsa,Lieutenant Governor,Cathy Cummings,DEM,720073,0,0,144,144,
Tulsa,Lieutenant Governor,Todd Lamb,REP,720073,0,0,383,383,
Tulsa,Superintendent of Public Instruction,John Cox,DEM,720073,0,0,141,141,
Tulsa,Superintendent of Public Instruction,Joy Hofmeister,REP,720073,0,0,390,390,
Tulsa,Commissioner of Labor,Mike Workman,DEM,720073,0,0,147,147,
Tulsa,Commissioner of Labor,Mark Costello,REP,720073,0,0,366,366,
Tulsa,U.S. Senate,Matt Silverstein,DEM,720073,0,0,178,178,
Tulsa,U.S. Senate,Jim Inhofe,REP,720073,0,0,337,337,
Tulsa,U.S. Senate,Aaron Delozier,IND,720073,0,0,2,2,
Tulsa,U.S. Senate,Ray Woods,IND,720073,0,0,2,2,
Tulsa,U.S. Senate,Joan Farr,IND,720073,0,0,7,7,
Tulsa,U.S. Senate,Connie Johnson,DEM,720073,0,0,149,149,
Tulsa,U.S. Senate,James Lankford,REP,720073,0,0,370,370,
Tulsa,U.S. Senate,Mark Beard,IND,720073,0,0,9,9,
Tulsa,Governor,Joe Dorman,DEM,720074,0,0,258,258,
Tulsa,Governor,Mary Fallin,REP,720074,0,0,404,404,
Tulsa,Governor,Kimberly Willis,IND,720074,0,0,5,5,
Tulsa,Governor,Richard Prawdzienski,IND,720074,0,0,6,6,
Tulsa,Lieutenant Governor,Cathy Cummings,DEM,720074,0,0,199,199,
Tulsa,Lieutenant Governor,Todd Lamb,REP,720074,0,0,472,472,
Tulsa,Superintendent of Public Instruction,John Cox,DEM,720074,0,0,202,202,
Tulsa,Superintendent of Public Instruction,Joy Hofmeister,REP,720074,0,0,471,471,
Tulsa,Commissioner of Labor,Mike Workman,DEM,720074,0,0,198,198,
Tulsa,Commissioner of Labor,Mark Costello,REP,720074,0,0,443,443,
Tulsa,U.S. Senate,Matt Silverstein,DEM,720074,0,0,217,217,
Tulsa,U.S. Senate,Jim Inhofe,REP,720074,0,0,436,436,
Tulsa,U.S. Senate,Aaron Delozier,IND,720074,0,0,4,4,
Tulsa,U.S. Senate,Ray Woods,IND,720074,0,0,1,1,
Tulsa,U.S. Senate,Joan Farr,IND,720074,0,0,7,7,
Tulsa,U.S. Senate,Connie Johnson,DEM,720074,0,0,185,185,
Tulsa,U.S. Senate,James Lankford,REP,720074,0,0,469,469,
Tulsa,U.S. Senate,Mark Beard,IND,720074,0,0,13,13,
Tulsa,Governor,Joe Dorman,DEM,720075,0,0,205,205,
Tulsa,Governor,Mary Fallin,REP,720075,0,0,148,148,
Tulsa,Governor,Kimberly Willis,IND,720075,0,0,7,7,
Tulsa,Governor,Richard Prawdzienski,IND,720075,0,0,4,4,
Tulsa,Lieutenant Governor,Cathy Cummings,DEM,720075,0,0,174,174,
Tulsa,Lieutenant Governor,Todd Lamb,REP,720075,0,0,188,188,
Tulsa,Superintendent of Public Instruction,John Cox,DEM,720075,0,0,188,188,
Tulsa,Superintendent of Public Instruction,Joy Hofmeister,REP,720075,0,0,176,176,
Tulsa,Commissioner of Labor,Mike Workman,DEM,720075,0,0,190,190,
Tulsa,Commissioner of Labor,Mark Costello,REP,720075,0,0,157,157,
Tulsa,U.S. Senate,Matt Silverstein,DEM,720075,0,0,180,180,
Tulsa,U.S. Senate,Jim Inhofe,REP,720075,0,0,167,167,
Tulsa,U.S. Senate,Aaron Delozier,IND,720075,0,0,5,5,
Tulsa,U.S. Senate,Ray Woods,IND,720075,0,0,3,3,
Tulsa,U.S. Senate,Joan Farr,IND,720075,0,0,8,8,
Tulsa,U.S. Senate,Connie Johnson,DEM,720075,0,0,163,163,
Tulsa,U.S. Senate,James Lankford,REP,720075,0,0,181,181,
Tulsa,U.S. Senate,Mark Beard,IND,720075,0,0,17,17,
Tulsa,Governor,Joe Dorman,DEM,720076,0,0,292,292,
Tulsa,Governor,Mary Fallin,REP,720076,0,0,213,213,
Tulsa,Governor,Kimberly Willis,IND,720076,0,0,15,15,
Tulsa,Governor,Richard Prawdzienski,IND,720076,0,0,6,6,
Tulsa,Lieutenant Governor,Cathy Cummings,DEM,720076,0,0,240,240,
Tulsa,Lieutenant Governor,Todd Lamb,REP,720076,0,0,283,283,
Tulsa,Superintendent of Public Instruction,John Cox,DEM,720076,0,0,254,254,
Tulsa,Superintendent of Public Instruction,Joy Hofmeister,REP,720076,0,0,270,270,
Tulsa,Commissioner of Labor,Mike Workman,DEM,720076,0,0,252,252,
Tulsa,Commissioner of Labor,Mark Costello,REP,720076,0,0,251,251,
Tulsa,U.S. Senate,Matt Silverstein,DEM,720076,0,0,248,248,
Tulsa,U.S. Senate,Jim Inhofe,REP,720076,0,0,255,255,
Tulsa,U.S. Senate,Aaron Delozier,IND,720076,0,0,6,6,
Tulsa,U.S. Senate,Ray Woods,IND,720076,0,0,8,8,
Tulsa,U.S. Senate,Joan Farr,IND,720076,0,0,8,8,
Tulsa,U.S. Senate,Connie Johnson,DEM,720076,0,0,228,228,
Tulsa,U.S. Senate,James Lankford,REP,720076,0,0,273,273,
Tulsa,U.S. Senate,Mark Beard,IND,720076,0,0,21,21,
Tulsa,Governor,Joe Dorman,DEM,720077,0,0,331,331,
Tulsa,Governor,Mary Fallin,REP,720077,0,0,277,277,
Tulsa,Governor,Kimberly Willis,IND,720077,0,0,8,8,
Tulsa,Governor,Richard Prawdzienski,IND,720077,0,0,5,5,
Tulsa,Lieutenant Governor,Cathy Cummings,DEM,720077,0,0,268,268,
Tulsa,Lieutenant Governor,Todd Lamb,REP,720077,0,0,353,353,
Tulsa,Superintendent of Public Instruction,John Cox,DEM,720077,0,0,293,293,
Tulsa,Superintendent of Public Instruction,Joy Hofmeister,REP,720077,0,0,322,322,
Tulsa,Commissioner of Labor,Mike Workman,DEM,720077,0,0,282,282,
Tulsa,Commissioner of Labor,Mark Costello,REP,720077,0,0,320,320,
Tulsa,U.S. Senate,Matt Silverstein,DEM,720077,0,0,274,274,
Tulsa,U.S. Senate,Jim Inhofe,REP,720077,0,0,331,331,
Tulsa,U.S. Senate,Aaron Delozier,IND,720077,0,0,1,1,
Tulsa,U.S. Senate,Ray Woods,IND,720077,0,0,8,8,
Tulsa,U.S. Senate,Joan Farr,IND,720077,0,0,7,7,
Tulsa,U.S. Senate,Connie Johnson,DEM,720077,0,0,251,251,
Tulsa,U.S. Senate,James Lankford,REP,720077,0,0,342,342,
Tulsa,U.S. Senate,Mark Beard,IND,720077,0,0,21,21,
Tulsa,Governor,Joe Dorman,DEM,720078,0,0,284,284,
Tulsa,Governor,Mary Fallin,REP,720078,0,0,353,353,
Tulsa,Governor,Kimberly Willis,IND,720078,0,0,19,19,
Tulsa,Governor,Richard Prawdzienski,IND,720078,0,0,10,10,
Tulsa,Lieutenant Governor,Cathy Cummings,DEM,720078,0,0,241,241,
Tulsa,Lieutenant Governor,Todd Lamb,REP,720078,0,0,423,423,
Tulsa,Superintendent of Public Instruction,John Cox,DEM,720078,0,0,285,285,
Tulsa,Superintendent of Public Instruction,Joy Hofmeister,REP,720078,0,0,382,382,
Tulsa,Commissioner of Labor,Mike Workman,DEM,720078,0,0,270,270,
Tulsa,Commissioner of Labor,Mark Costello,REP,720078,0,0,382,382,
Tulsa,U.S. Senate,Matt Silverstein,DEM,720078,0,0,238,238,
Tulsa,U.S. Senate,Jim Inhofe,REP,720078,0,0,406,406,
Tulsa,U.S. Senate,Aaron Delozier,IND,720078,0,0,8,8,
Tulsa,U.S. Senate,Ray Woods,IND,720078,0,0,6,6,
Tulsa,U.S. Senate,Joan Farr,IND,720078,0,0,7,7,
Tulsa,U.S. Senate,Connie Johnson,DEM,720078,0,0,228,228,
Tulsa,U.S. Senate,James Lankford,REP,720078,0,0,411,411,
Tulsa,U.S. Senate,Mark Beard,IND,720078,0,0,25,25,
Tulsa,Governor,Joe Dorman,DEM,720079,0,0,310,310,
Tulsa,Governor,Mary Fallin,REP,720079,0,0,283,283,
Tulsa,Governor,Kimberly Willis,IND,720079,0,0,14,14,
Tulsa,Governor,Richard Prawdzienski,IND,720079,0,0,8,8,
Tulsa,Lieutenant Governor,Cathy Cummings,DEM,720079,0,0,272,272,
Tulsa,Lieutenant Governor,Todd Lamb,REP,720079,0,0,340,340,
Tulsa,Superintendent of Public Instruction,John Cox,DEM,720079,0,0,302,302,
Tulsa,Superintendent of Public Instruction,Joy Hofmeister,REP,720079,0,0,311,311,
Tulsa,Commissioner of Labor,Mike Workman,DEM,720079,0,0,287,287,
Tulsa,Commissioner of Labor,Mark Costello,REP,720079,0,0,314,314,
Tulsa,U.S. Senate,Matt Silverstein,DEM,720079,0,0,275,275,
Tulsa,U.S. Senate,Jim Inhofe,REP,720079,0,0,328,328,
Tulsa,U.S. Senate,Aaron Delozier,IND,720079,0,0,4,4,
Tulsa,U.S. Senate,Ray Woods,IND,720079,0,0,3,3,
Tulsa,U.S. Senate,Joan Farr,IND,720079,0,0,4,4,
Tulsa,U.S. Senate,Connie Johnson,DEM,720079,0,0,274,274,
Tulsa,U.S. Senate,James Lankford,REP,720079,0,0,321,321,
Tulsa,U.S. Senate,Mark Beard,IND,720079,0,0,18,18,
Tulsa,Governor,Joe Dorman,DEM,720080,0,0,57,57,
Tulsa,Governor,Mary Fallin,REP,720080,0,0,67,67,
Tulsa,Governor,Kimberly Willis,IND,720080,0,0,4,4,
Tulsa,Governor,Richard Prawdzienski,IND,720080,0,0,3,3,
Tulsa,Lieutenant Governor,Cathy Cummings,DEM,720080,0,0,49,49,
Tulsa,Lieutenant Governor,Todd Lamb,REP,720080,0,0,83,83,
Tulsa,Superintendent of Public Instruction,John Cox,DEM,720080,0,0,56,56,
Tulsa,Superintendent of Public Instruction,Joy Hofmeister,REP,720080,0,0,75,75,
Tulsa,Commissioner of Labor,Mike Workman,DEM,720080,0,0,53,53,
Tulsa,Commissioner of Labor,Mark Costello,REP,720080,0,0,74,74,
Tulsa,U.S. Senate,Matt Silverstein,DEM,720080,0,0,48,48,
Tulsa,U.S. Senate,Jim Inhofe,REP,720080,0,0,76,76,
Tulsa,U.S. Senate,Aaron Delozier,IND,720080,0,0,2,2,
Tulsa,U.S. Senate,Ray Woods,IND,720080,0,0,4,4,
Tulsa,U.S. Senate,Joan Farr,IND,720080,0,0,1,1,
Tulsa,U.S. Senate,Connie Johnson,DEM,720080,0,0,41,41,
Tulsa,U.S. Senate,James Lankford,REP,720080,0,0,82,82,
Tulsa,U.S. Senate,Mark Beard,IND,720080,0,0,9,9,
Tulsa,Governor,Joe Dorman,DEM,720081,0,0,340,340,
Tulsa,Governor,Mary Fallin,REP,720081,0,0,397,397,
Tulsa,Governor,Kimberly Willis,IND,720081,0,0,22,22,
Tulsa,Governor,Richard Prawdzienski,IND,720081,0,0,6,6,
Tulsa,Lieutenant Governor,Cathy Cummings,DEM,720081,0,0,281,281,
Tulsa,Lieutenant Governor,Todd Lamb,REP,720081,0,0,477,477,
Tulsa,Superintendent of Public Instruction,John Cox,DEM,720081,0,0,313,313,
Tulsa,Superintendent of Public Instruction,Joy Hofmeister,REP,720081,0,0,441,441,
Tulsa,Commissioner of Labor,Mike Workman,DEM,720081,0,0,300,300,
Tulsa,Commissioner of Labor,Mark Costello,REP,720081,0,0,427,427,
Tulsa,U.S. Senate,Matt Silverstein,DEM,720081,0,0,274,274,
Tulsa,U.S. Senate,Jim Inhofe,REP,720081,0,0,458,458,
Tulsa,U.S. Senate,Aaron Delozier,IND,720081,0,0,4,4,
Tulsa,U.S. Senate,Ray Woods,IND,720081,0,0,5,5,
Tulsa,U.S. Senate,Joan Farr,IND,720081,0,0,18,18,
Tulsa,U.S. Senate,Connie Johnson,DEM,720081,0,0,262,262,
Tulsa,U.S. Senate,James Lankford,REP,720081,0,0,456,456,
Tulsa,U.S. Senate,Mark Beard,IND,720081,0,0,32,32,
Tulsa,Governor,Joe Dorman,DEM,720082,0,0,241,241,
Tulsa,Governor,Mary Fallin,REP,720082,0,0,258,258,
Tulsa,Governor,Kimberly Willis,IND,720082,0,0,5,5,
Tulsa,Governor,Richard Prawdzienski,IND,720082,0,0,3,3,
Tulsa,Lieutenant Governor,Cathy Cummings,DEM,720082,0,0,187,187,
Tulsa,Lieutenant Governor,Todd Lamb,REP,720082,0,0,312,312,
Tulsa,Superintendent of Public Instruction,John Cox,DEM,720082,0,0,214,214,
Tulsa,Superintendent of Public Instruction,Joy Hofmeister,REP,720082,0,0,288,288,
Tulsa,Commissioner of Labor,Mike Workman,DEM,720082,0,0,195,195,
Tulsa,Commissioner of Labor,Mark Costello,REP,720082,0,0,291,291,
Tulsa,U.S. Senate,Matt Silverstein,DEM,720082,0,0,196,196,
Tulsa,U.S. Senate,Jim Inhofe,REP,720082,0,0,295,295,
Tulsa,U.S. Senate,Aaron Delozier,IND,720082,0,0,4,4,
Tulsa,U.S. Senate,Ray Woods,IND,720082,0,0,2,2,
Tulsa,U.S. Senate,Joan Farr,IND,720082,0,0,5,5,
Tulsa,U.S. Senate,Connie Johnson,DEM,720082,0,0,169,169,
Tulsa,U.S. Senate,James Lankford,REP,720082,0,0,313,313,
Tulsa,U.S. Senate,Mark Beard,IND,720082,0,0,17,17,
Tulsa,Governor,Joe Dorman,DEM,720083,0,0,260,260,
Tulsa,Governor,Mary Fallin,REP,720083,0,0,189,189,
Tulsa,Governor,Kimberly Willis,IND,720083,0,0,7,7,
Tulsa,Governor,Richard Prawdzienski,IND,720083,0,0,6,6,
Tulsa,Lieutenant Governor,Cathy Cummings,DEM,720083,0,0,217,217,
Tulsa,Lieutenant Governor,Todd Lamb,REP,720083,0,0,240,240,
Tulsa,Superintendent of Public Instruction,John Cox,DEM,720083,0,0,230,230,
Tulsa,Superintendent of Public Instruction,Joy Hofmeister,REP,720083,0,0,229,229,
Tulsa,Commissioner of Labor,Mike Workman,DEM,720083,0,0,218,218,
Tulsa,Commissioner of Labor,Mark Costello,REP,720083,0,0,218,218,
Tulsa,U.S. Senate,Matt Silverstein,DEM,720083,0,0,228,228,
Tulsa,U.S. Senate,Jim Inhofe,REP,720083,0,0,220,220,
Tulsa,U.S. Senate,Aaron Delozier,IND,720083,0,0,2,2,
Tulsa,U.S. Senate,Ray Woods,IND,720083,0,0,4,4,
Tulsa,U.S. Senate,Joan Farr,IND,720083,0,0,6,6,
Tulsa,U.S. Senate,Connie Johnson,DEM,720083,0,0,204,204,
Tulsa,U.S. Senate,James Lankford,REP,720083,0,0,237,237,
Tulsa,U.S. Senate,Mark Beard,IND,720083,0,0,19,19,
Tulsa,Governor,Joe Dorman,DEM,720084,0,0,227,227,
Tulsa,Governor,Mary Fallin,REP,720084,0,0,246,246,
Tulsa,Governor,Kimberly Willis,IND,720084,0,0,3,3,
Tulsa,Governor,Richard Prawdzienski,IND,720084,0,0,4,4,
Tulsa,Lieutenant Governor,Cathy Cummings,DEM,720084,0,0,171,171,
Tulsa,Lieutenant Governor,Todd Lamb,REP,720084,0,0,304,304,
Tulsa,Superintendent of Public Instruction,John Cox,DEM,720084,0,0,190,190,
Tulsa,Superintendent of Public Instruction,Joy Hofmeister,REP,720084,0,0,288,288,
Tulsa,Commissioner of Labor,Mike Workman,DEM,720084,0,0,178,178,
Tulsa,Commissioner of Labor,Mark Costello,REP,720084,0,0,278,278,
Tulsa,U.S. Senate,Matt Silverstein,DEM,720084,0,0,185,185,
Tulsa,U.S. Senate,Jim Inhofe,REP,720084,0,0,285,285,
Tulsa,U.S. Senate,Aaron Delozier,IND,720084,0,0,4,4,
Tulsa,U.S. Senate,Ray Woods,IND,720084,0,0,2,2,
Tulsa,U.S. Senate,Joan Farr,IND,720084,0,0,5,5,
Tulsa,U.S. Senate,Connie Johnson,DEM,720084,0,0,162,162,
Tulsa,U.S. Senate,James Lankford,REP,720084,0,0,293,293,
Tulsa,U.S. Senate,Mark Beard,IND,720084,0,0,22,22,
Tulsa,Governor,Joe Dorman,DEM,720085,0,0,108,108,
Tulsa,Governor,Mary Fallin,REP,720085,0,0,82,82,
Tulsa,Governor,Kimberly Willis,IND,720085,0,0,5,5,
Tulsa,Governor,Richard Prawdzienski,IND,720085,0,0,3,3,
Tulsa,Lieutenant Governor,Cathy Cummings,DEM,720085,0,0,92,92,
Tulsa,Lieutenant Governor,Todd Lamb,REP,720085,0,0,107,107,
Tulsa,Superintendent of Public Instruction,John Cox,DEM,720085,0,0,97,97,
Tulsa,Superintendent of Public Instruction,Joy Hofmeister,REP,720085,0,0,102,102,
Tulsa,Commissioner of Labor,Mike Workman,DEM,720085,0,0,93,93,
Tulsa,Commissioner of Labor,Mark Costello,REP,720085,0,0,100,100,
Tulsa,U.S. Senate,Matt Silverstein,DEM,720085,0,0,87,87,
Tulsa,U.S. Senate,Jim Inhofe,REP,720085,0,0,103,103,
Tulsa,U.S. Senate,Aaron Delozier,IND,720085,0,0,5,5,
Tulsa,U.S. Senate,Ray Woods,IND,720085,0,0,3,3,
Tulsa,U.S. Senate,Joan Farr,IND,720085,0,0,1,1,
Tulsa,U.S. Senate,Connie Johnson,DEM,720085,0,0,85,85,
Tulsa,U.S. Senate,James Lankford,REP,720085,0,0,102,102,
Tulsa,U.S. Senate,Mark Beard,IND,720085,0,0,12,12,
Tulsa,Governor,Joe Dorman,DEM,720086,0,0,184,184,
Tulsa,Governor,Mary Fallin,REP,720086,0,0,294,294,
Tulsa,Governor,Kimberly Willis,IND,720086,0,0,8,8,
Tulsa,Governor,Richard Prawdzienski,IND,720086,0,0,5,5,
Tulsa,Lieutenant Governor,Cathy Cummings,DEM,720086,0,0,159,159,
Tulsa,Lieutenant Governor,Todd Lamb,REP,720086,0,0,331,331,
Tulsa,Superintendent of Public Instruction,John Cox,DEM,720086,0,0,162,162,
Tulsa,Superintendent of Public Instruction,Joy Hofmeister,REP,720086,0,0,323,323,
Tulsa,Commissioner of Labor,Mike Workman,DEM,720086,0,0,164,164,
Tulsa,Commissioner of Labor,Mark Costello,REP,720086,0,0,307,307,
Tulsa,U.S. Senate,Matt Silverstein,DEM,720086,0,0,146,146,
Tulsa,U.S. Senate,Jim Inhofe,REP,720086,0,0,333,333,
Tulsa,U.S. Senate,Aaron Delozier,IND,720086,0,0,1,1,
Tulsa,U.S. Senate,Ray Woods,IND,720086,0,0,5,5,
Tulsa,U.S. Senate,Joan Farr,IND,720086,0,0,2,2,
Tulsa,U.S. Senate,Connie Johnson,DEM,720086,0,0,135,135,
Tulsa,U.S. Senate,James Lankford,REP,720086,0,0,338,338,
Tulsa,U.S. Senate,Mark Beard,IND,720086,0,0,16,16,
Tulsa,Governor,Joe Dorman,DEM,720087,0,0,234,234,
Tulsa,Governor,Mary Fallin,REP,720087,0,0,312,312,
Tulsa,Governor,Kimberly Willis,IND,720087,0,0,14,14,
Tulsa,Governor,Richard Prawdzienski,IND,720087,0,0,1,1,
Tulsa,Lieutenant Governor,Cathy Cummings,DEM,720087,0,0,183,183,
Tulsa,Lieutenant Governor,Todd Lamb,REP,720087,0,0,378,378,
Tulsa,Superintendent of Public Instruction,John Cox,DEM,720087,0,0,213,213,
Tulsa,Superintendent of Public Instruction,Joy Hofmeister,REP,720087,0,0,345,345,
Tulsa,Commissioner of Labor,Mike Workman,DEM,720087,0,0,203,203,
Tulsa,Commissioner of Labor,Mark Costello,REP,720087,0,0,342,342,
Tulsa,U.S. Senate,Matt Silverstein,DEM,720087,0,0,190,190,
Tulsa,U.S. Senate,Jim Inhofe,REP,720087,0,0,348,348,
Tulsa,U.S. Senate,Aaron Delozier,IND,720087,0,0,6,6,
Tulsa,U.S. Senate,Ray Woods,IND,720087,0,0,3,3,
Tulsa,U.S. Senate,Joan Farr,IND,720087,0,0,11,11,
Tulsa,U.S. Senate,Connie Johnson,DEM,720087,0,0,181,181,
Tulsa,U.S. Senate,James Lankford,REP,720087,0,0,363,363,
Tulsa,U.S. Senate,Mark Beard,IND,720087,0,0,18,18,
Tulsa,Governor,Joe Dorman,DEM,720088,0,0,49,49,
Tulsa,Governor,Mary Fallin,REP,720088,0,0,70,70,
Tulsa,Governor,Kimberly Willis,IND,720088,0,0,2,2,
Tulsa,Governor,Richard Prawdzienski,IND,720088,0,0,0,0,
Tulsa,Lieutenant Governor,Cathy Cummings,DEM,720088,0,0,41,41,
Tulsa,Lieutenant Governor,Todd Lamb,REP,720088,0,0,79,79,
Tulsa,Superintendent of Public Instruction,John Cox,DEM,720088,0,0,48,48,
Tulsa,Superintendent of Public Instruction,Joy Hofmeister,REP,720088,0,0,73,73,
Tulsa,Commissioner of Labor,Mike Workman,DEM,720088,0,0,44,44,
Tulsa,Commissioner of Labor,Mark Costello,REP,720088,0,0,74,74,
Tulsa,U.S. Senate,Matt Silverstein,DEM,720088,0,0,40,40,
Tulsa,U.S. Senate,Jim Inhofe,REP,720088,0,0,77,77,
Tulsa,U.S. Senate,Aaron Delozier,IND,720088,0,0,1,1,
Tulsa,U.S. Senate,Ray Woods,IND,720088,0,0,1,1,
Tulsa,U.S. Senate,Joan Farr,IND,720088,0,0,2,2,
Tulsa,U.S. Senate,Connie Johnson,DEM,720088,0,0,39,39,
Tulsa,U.S. Senate,James Lankford,REP,720088,0,0,78,78,
Tulsa,U.S. Senate,Mark Beard,IND,720088,0,0,3,3,
Tulsa,Governor,Joe Dorman,DEM,720089,0,0,105,105,
Tulsa,Governor,Mary Fallin,REP,720089,0,0,111,111,
Tulsa,Governor,Kimberly Willis,IND,720089,0,0,6,6,
Tulsa,Governor,Richard Prawdzienski,IND,720089,0,0,3,3,
Tulsa,Lieutenant Governor,Cathy Cummings,DEM,720089,0,0,96,96,
Tulsa,Lieutenant Governor,Todd Lamb,REP,720089,0,0,128,128,
Tulsa,Superintendent of Public Instruction,John Cox,DEM,720089,0,0,103,103,
Tulsa,Superintendent of Public Instruction,Joy Hofmeister,REP,720089,0,0,118,118,
Tulsa,Commissioner of Labor,Mike Workman,DEM,720089,0,0,115,115,
Tulsa,Commissioner of Labor,Mark Costello,REP,720089,0,0,105,105,
Tulsa,U.S. Senate,Matt Silverstein,DEM,720089,0,0,97,97,
Tulsa,U.S. Senate,Jim Inhofe,REP,720089,0,0,122,122,
Tulsa,U.S. Senate,Aaron Delozier,IND,720089,0,0,1,1,
Tulsa,U.S. Senate,Ray Woods,IND,720089,0,0,3,3,
Tulsa,U.S. Senate,Joan Farr,IND,720089,0,0,2,2,
Tulsa,U.S. Senate,Connie Johnson,DEM,720089,0,0,97,97,
Tulsa,U.S. Senate,James Lankford,REP,720089,0,0,112,112,
Tulsa,U.S. Senate,Mark Beard,IND,720089,0,0,14,14,
Tulsa,Governor,Joe Dorman,DEM,720090,0,0,66,66,
Tulsa,Governor,Mary Fallin,REP,720090,0,0,75,75,
Tulsa,Governor,Kimberly Willis,IND,720090,0,0,3,3,
Tulsa,Governor,Richard Prawdzienski,IND,720090,0,0,3,3,
Tulsa,Lieutenant Governor,Cathy Cummings,DEM,720090,0,0,58,58,
Tulsa,Lieutenant Governor,Todd Lamb,REP,720090,0,0,90,90,
Tulsa,Superintendent of Public Instruction,John Cox,DEM,720090,0,0,66,66,
Tulsa,Superintendent of Public Instruction,Joy Hofmeister,REP,720090,0,0,82,82,
Tulsa,Commissioner of Labor,Mike Workman,DEM,720090,0,0,66,66,
Tulsa,Commissioner of Labor,Mark Costello,REP,720090,0,0,79,79,
Tulsa,U.S. Senate,Matt Silverstein,DEM,720090,0,0,59,59,
Tulsa,U.S. Senate,Jim Inhofe,REP,720090,0,0,84,84,
Tulsa,U.S. Senate,Aaron Delozier,IND,720090,0,0,1,1,
Tulsa,U.S. Senate,Ray Woods,IND,720090,0,0,3,3,
Tulsa,U.S. Senate,Joan Farr,IND,720090,0,0,1,1,
Tulsa,U.S. Senate,Connie Johnson,DEM,720090,0,0,57,57,
Tulsa,U.S. Senate,James Lankford,REP,720090,0,0,87,87,
Tulsa,U.S. Senate,Mark Beard,IND,720090,0,0,4,4,
Tulsa,Governor,Joe Dorman,DEM,720091,0,0,129,129,
Tulsa,Governor,Mary Fallin,REP,720091,0,0,138,138,
Tulsa,Governor,Kimberly Willis,IND,720091,0,0,6,6,
Tulsa,Governor,Richard Prawdzienski,IND,720091,0,0,2,2,
Tulsa,Lieutenant Governor,Cathy Cummings,DEM,720091,0,0,98,98,
Tulsa,Lieutenant Governor,Todd Lamb,REP,720091,0,0,174,174,
Tulsa,Superintendent of Public Instruction,John Cox,DEM,720091,0,0,133,133,
Tulsa,Superintendent of Public Instruction,Joy Hofmeister,REP,720091,0,0,141,141,
Tulsa,Commissioner of Labor,Mike Workman,DEM,720091,0,0,111,111,
Tulsa,Commissioner of Labor,Mark Costello,REP,720091,0,0,158,158,
Tulsa,U.S. Senate,Matt Silverstein,DEM,720091,0,0,108,108,
Tulsa,U.S. Senate,Jim Inhofe,REP,720091,0,0,155,155,
Tulsa,U.S. Senate,Aaron Delozier,IND,720091,0,0,5,5,
Tulsa,U.S. Senate,Ray Woods,IND,720091,0,0,0,0,
Tulsa,U.S. Senate,Joan Farr,IND,720091,0,0,3,3,
Tulsa,U.S. Senate,Connie Johnson,DEM,720091,0,0,96,96,
Tulsa,U.S. Senate,James Lankford,REP,720091,0,0,166,166,
Tulsa,U.S. Senate,Mark Beard,IND,720091,0,0,8,8,
Tulsa,Governor,Joe Dorman,DEM,720092,0,0,138,138,
Tulsa,Governor,Mary Fallin,REP,720092,0,0,141,141,
Tulsa,Governor,Kimberly Willis,IND,720092,0,0,2,2,
Tulsa,Governor,Richard Prawdzienski,IND,720092,0,0,9,9,
Tulsa,Lieutenant Governor,Cathy Cummings,DEM,720092,0,0,118,118,
Tulsa,Lieutenant Governor,Todd Lamb,REP,720092,0,0,170,170,
Tulsa,Superintendent of Public Instruction,John Cox,DEM,720092,0,0,136,136,
Tulsa,Superintendent of Public Instruction,Joy Hofmeister,REP,720092,0,0,151,151,
Tulsa,Commissioner of Labor,Mike Workman,DEM,720092,0,0,132,132,
Tulsa,Commissioner of Labor,Mark Costello,REP,720092,0,0,153,153,
Tulsa,U.S. Senate,Matt Silverstein,DEM,720092,0,0,116,116,
Tulsa,U.S. Senate,Jim Inhofe,REP,720092,0,0,162,162,
Tulsa,U.S. Senate,Aaron Delozier,IND,720092,0,0,4,4,
Tulsa,U.S. Senate,Ray Woods,IND,720092,0,0,6,6,
Tulsa,U.S. Senate,Joan Farr,IND,720092,0,0,2,2,
Tulsa,U.S. Senate,Connie Johnson,DEM,720092,0,0,112,112,
Tulsa,U.S. Senate,James Lankford,REP,720092,0,0,167,167,
Tulsa,U.S. Senate,Mark Beard,IND,720092,0,0,11,11,
Tulsa,Governor,Joe Dorman,DEM,720093,0,0,111,111,
Tulsa,Governor,Mary Fallin,REP,720093,0,0,172,172,
Tulsa,Governor,Kimberly Willis,IND,720093,0,0,8,8,
Tulsa,Governor,Richard Prawdzienski,IND,720093,0,0,3,3,
Tulsa,Lieutenant Governor,Cathy Cummings,DEM,720093,0,0,91,91,
Tulsa,Lieutenant Governor,Todd Lamb,REP,720093,0,0,205,205,
Tulsa,Superintendent of Public Instruction,John Cox,DEM,720093,0,0,109,109,
Tulsa,Superintendent of Public Instruction,Joy Hofmeister,REP,720093,0,0,185,185,
Tulsa,Commissioner of Labor,Mike Workman,DEM,720093,0,0,103,103,
Tulsa,Commissioner of Labor,Mark Costello,REP,720093,0,0,177,177,
Tulsa,U.S. Senate,Matt Silverstein,DEM,720093,0,0,92,92,
Tulsa,U.S. Senate,Jim Inhofe,REP,720093,0,0,198,198,
Tulsa,U.S. Senate,Aaron Delozier,IND,720093,0,0,1,1,
Tulsa,U.S. Senate,Ray Woods,IND,720093,0,0,1,1,
Tulsa,U.S. Senate,Joan Farr,IND,720093,0,0,3,3,
Tulsa,U.S. Senate,Connie Johnson,DEM,720093,0,0,82,82,
Tulsa,U.S. Senate,James Lankford,REP,720093,0,0,197,197,
Tulsa,U.S. Senate,Mark Beard,IND,720093,0,0,16,16,
Tulsa,Governor,Joe Dorman,DEM,720094,0,0,209,209,
Tulsa,Governor,Mary Fallin,REP,720094,0,0,293,293,
Tulsa,Governor,Kimberly Willis,IND,720094,0,0,9,9,
Tulsa,Governor,Richard Prawdzienski,IND,720094,0,0,6,6,
Tulsa,Lieutenant Governor,Cathy Cummings,DEM,720094,0,0,171,171,
Tulsa,Lieutenant Governor,Todd Lamb,REP,720094,0,0,342,342,
Tulsa,Superintendent of Public Instruction,John Cox,DEM,720094,0,0,212,212,
Tulsa,Superintendent of Public Instruction,Joy Hofmeister,REP,720094,0,0,302,302,
Tulsa,Commissioner of Labor,Mike Workman,DEM,720094,0,0,204,204,
Tulsa,Commissioner of Labor,Mark Costello,REP,720094,0,0,300,300,
Tulsa,U.S. Senate,Matt Silverstein,DEM,720094,0,0,179,179,
Tulsa,U.S. Senate,Jim Inhofe,REP,720094,0,0,325,325,
Tulsa,U.S. Senate,Aaron Delozier,IND,720094,0,0,2,2,
Tulsa,U.S. Senate,Ray Woods,IND,720094,0,0,3,3,
Tulsa,U.S. Senate,Joan Farr,IND,720094,0,0,7,7,
Tulsa,U.S. Senate,Connie Johnson,DEM,720094,0,0,166,166,
Tulsa,U.S. Senate,James Lankford,REP,720094,0,0,338,338,
Tulsa,U.S. Senate,Mark Beard,IND,720094,0,0,13,13,
Tulsa,Governor,Joe Dorman,DEM,720095,0,0,174,174,
Tulsa,Governor,Mary Fallin,REP,720095,0,0,291,291,
Tulsa,Governor,Kimberly Willis,IND,720095,0,0,9,9,
Tulsa,Governor,Richard Prawdzienski,IND,720095,0,0,2,2,
Tulsa,Lieutenant Governor,Cathy Cummings,DEM,720095,0,0,138,138,
Tulsa,Lieutenant Governor,Todd Lamb,REP,720095,0,0,331,331,
Tulsa,Superintendent of Public Instruction,John Cox,DEM,720095,0,0,162,162,
Tulsa,Superintendent of Public Instruction,Joy Hofmeister,REP,720095,0,0,310,310,
Tulsa,Commissioner of Labor,Mike Workman,DEM,720095,0,0,151,151,
Tulsa,Commissioner of Labor,Mark Costello,REP,720095,0,0,303,303,
Tulsa,U.S. Senate,Matt Silverstein,DEM,720095,0,0,145,145,
Tulsa,U.S. Senate,Jim Inhofe,REP,720095,0,0,320,320,
Tulsa,U.S. Senate,Aaron Delozier,IND,720095,0,0,0,0,
Tulsa,U.S. Senate,Ray Woods,IND,720095,0,0,2,2,
Tulsa,U.S. Senate,Joan Farr,IND,720095,0,0,6,6,
Tulsa,U.S. Senate,Connie Johnson,DEM,720095,0,0,130,130,
Tulsa,U.S. Senate,James Lankford,REP,720095,0,0,321,321,
Tulsa,U.S. Senate,Mark Beard,IND,720095,0,0,15,15,
Tulsa,Governor,Joe Dorman,DEM,720096,0,0,110,110,
Tulsa,Governor,Mary Fallin,REP,720096,0,0,145,145,
Tulsa,Governor,Kimberly Willis,IND,720096,0,0,7,7,
Tulsa,Governor,Richard Prawdzienski,IND,720096,0,0,4,4,
Tulsa,Lieutenant Governor,Cathy Cummings,DEM,720096,0,0,105,105,
Tulsa,Lieutenant Governor,Todd Lamb,REP,720096,0,0,162,162,
Tulsa,Superintendent of Public Instruction,John Cox,DEM,720096,0,0,102,102,
Tulsa,Superintendent of Public Instruction,Joy Hofmeister,REP,720096,0,0,164,164,
Tulsa,Commissioner of Labor,Mike Workman,DEM,720096,0,0,114,114,
Tulsa,Commissioner of Labor,Mark Costello,REP,720096,0,0,149,149,
Tulsa,U.S. Senate,Matt Silverstein,DEM,720096,0,0,90,90,
Tulsa,U.S. Senate,Jim Inhofe,REP,720096,0,0,166,166,
Tulsa,U.S. Senate,Aaron Delozier,IND,720096,0,0,3,3,
Tulsa,U.S. Senate,Ray Woods,IND,720096,0,0,3,3,
Tulsa,U.S. Senate,Joan Farr,IND,720096,0,0,4,4,
Tulsa,U.S. Senate,Connie Johnson,DEM,720096,0,0,92,92,
Tulsa,U.S. Senate,James Lankford,REP,720096,0,0,167,167,
Tulsa,U.S. Senate,Mark Beard,IND,720096,0,0,6,6,
Tulsa,Governor,Joe Dorman,DEM,720097,0,0,222,222,
Tulsa,Governor,Mary Fallin,REP,720097,0,0,244,244,
Tulsa,Governor,Kimberly Willis,IND,720097,0,0,12,12,
Tulsa,Governor,Richard Prawdzienski,IND,720097,0,0,2,2,
Tulsa,Lieutenant Governor,Cathy Cummings,DEM,720097,0,0,203,203,
Tulsa,Lieutenant Governor,Todd Lamb,REP,720097,0,0,276,276,
Tulsa,Superintendent of Public Instruction,John Cox,DEM,720097,0,0,209,209,
Tulsa,Superintendent of Public Instruction,Joy Hofmeister,REP,720097,0,0,266,266,
Tulsa,Commissioner of Labor,Mike Workman,DEM,720097,0,0,201,201,
Tulsa,Commissioner of Labor,Mark Costello,REP,720097,0,0,269,269,
Tulsa,U.S. Senate,Matt Silverstein,DEM,720097,0,0,186,186,
Tulsa,U.S. Senate,Jim Inhofe,REP,720097,0,0,277,277,
Tulsa,U.S. Senate,Aaron Delozier,IND,720097,0,0,5,5,
Tulsa,U.S. Senate,Ray Woods,IND,720097,0,0,1,1,
Tulsa,U.S. Senate,Joan Farr,IND,720097,0,0,7,7,
Tulsa,U.S. Senate,Connie Johnson,DEM,720097,0,0,189,189,
Tulsa,U.S. Senate,James Lankford,REP,720097,0,0,265,265,
Tulsa,U.S. Senate,Mark Beard,IND,720097,0,0,21,21,
Tulsa,Governor,Joe Dorman,DEM,720098,0,0,148,148,
Tulsa,Governor,Mary Fallin,REP,720098,0,0,181,181,
Tulsa,Governor,Kimberly Willis,IND,720098,0,0,11,11,
Tulsa,Governor,Richard Prawdzienski,IND,720098,0,0,8,8,
Tulsa,Lieutenant Governor,Cathy Cummings,DEM,720098,0,0,129,129,
Tulsa,Lieutenant Governor,Todd Lamb,REP,720098,0,0,219,219,
Tulsa,Superintendent of Public Instruction,John Cox,DEM,720098,0,0,165,165,
Tulsa,Superintendent of Public Instruction,Joy Hofmeister,REP,720098,0,0,181,181,
Tulsa,Commissioner of Labor,Mike Workman,DEM,720098,0,0,146,146,
Tulsa,Commissioner of Labor,Mark Costello,REP,720098,0,0,192,192,
Tulsa,U.S. Senate,Matt Silverstein,DEM,720098,0,0,128,128,
Tulsa,U.S. Senate,Jim Inhofe,REP,720098,0,0,209,209,
Tulsa,U.S. Senate,Aaron Delozier,IND,720098,0,0,2,2,
Tulsa,U.S. Senate,Ray Woods,IND,720098,0,0,6,6,
Tulsa,U.S. Senate,Joan Farr,IND,720098,0,0,2,2,
Tulsa,U.S. Senate,Connie Johnson,DEM,720098,0,0,124,124,
Tulsa,U.S. Senate,James Lankford,REP,720098,0,0,213,213,
Tulsa,U.S. Senate,Mark Beard,IND,720098,0,0,11,11,
Tulsa,Governor,Joe Dorman,DEM,720099,0,0,120,120,
Tulsa,Governor,Mary Fallin,REP,720099,0,0,139,139,
Tulsa,Governor,Kimberly Willis,IND,720099,0,0,5,5,
Tulsa,Governor,Richard Prawdzienski,IND,720099,0,0,4,4,
Tulsa,Lieutenant Governor,Cathy Cummings,DEM,720099,0,0,108,108,
Tulsa,Lieutenant Governor,Todd Lamb,REP,720099,0,0,158,158,
Tulsa,Superintendent of Public Instruction,John Cox,DEM,720099,0,0,122,122,
Tulsa,Superintendent of Public Instruction,Joy Hofmeister,REP,720099,0,0,145,145,
Tulsa,Commissioner of Labor,Mike Workman,DEM,720099,0,0,116,116,
Tulsa,Commissioner of Labor,Mark Costello,REP,720099,0,0,144,144,
Tulsa,U.S. Senate,Matt Silverstein,DEM,720099,0,0,102,102,
Tulsa,U.S. Senate,Jim Inhofe,REP,720099,0,0,151,151,
Tulsa,U.S. Senate,Aaron Delozier,IND,720099,0,0,4,4,
Tulsa,U.S. Senate,Ray Woods,IND,720099,0,0,6,6,
Tulsa,U.S. Senate,Joan Farr,IND,720099,0,0,3,3,
Tulsa,U.S. Senate,Connie Johnson,DEM,720099,0,0,95,95,
Tulsa,U.S. Senate,James Lankford,REP,720099,0,0,156,156,
Tulsa,U.S. Senate,Mark Beard,IND,720099,0,0,13,13,
Tulsa,Governor,Joe Dorman,DEM,720100,0,0,71,71,
Tulsa,Governor,Mary Fallin,REP,720100,0,0,106,106,
Tulsa,Governor,Kimberly Willis,IND,720100,0,0,6,6,
Tulsa,Governor,Richard Prawdzienski,IND,720100,0,0,1,1,
Tulsa,Lieutenant Governor,Cathy Cummings,DEM,720100,0,0,51,51,
Tulsa,Lieutenant Governor,Todd Lamb,REP,720100,0,0,131,131,
Tulsa,Superintendent of Public Instruction,John Cox,DEM,720100,0,0,60,60,
Tulsa,Superintendent of Public Instruction,Joy Hofmeister,REP,720100,0,0,123,123,
Tulsa,Commissioner of Labor,Mike Workman,DEM,720100,0,0,56,56,
Tulsa,Commissioner of Labor,Mark Costello,REP,720100,0,0,121,121,
Tulsa,U.S. Senate,Matt Silverstein,DEM,720100,0,0,52,52,
Tulsa,U.S. Senate,Jim Inhofe,REP,720100,0,0,124,124,
Tulsa,U.S. Senate,Aaron Delozier,IND,720100,0,0,2,2,
Tulsa,U.S. Senate,Ray Woods,IND,720100,0,0,3,3,
Tulsa,U.S. Senate,Joan Farr,IND,720100,0,0,2,2,
Tulsa,U.S. Senate,Connie Johnson,DEM,720100,0,0,52,52,
Tulsa,U.S. Senate,James Lankford,REP,720100,0,0,126,126,
Tulsa,U.S. Senate,Mark Beard,IND,720100,0,0,4,4,
Tulsa,Governor,Joe Dorman,DEM,720101,0,0,206,206,
Tulsa,Governor,Mary Fallin,REP,720101,0,0,260,260,
Tulsa,Governor,Kimberly Willis,IND,720101,0,0,13,13,
Tulsa,Governor,Richard Prawdzienski,IND,720101,0,0,6,6,
Tulsa,Lieutenant Governor,Cathy Cummings,DEM,720101,0,0,166,166,
Tulsa,Lieutenant Governor,Todd Lamb,REP,720101,0,0,316,316,
Tulsa,Superintendent of Public Instruction,John Cox,DEM,720101,0,0,210,210,
Tulsa,Superintendent of Public Instruction,Joy Hofmeister,REP,720101,0,0,274,274,
Tulsa,Commissioner of Labor,Mike Workman,DEM,720101,0,0,197,197,
Tulsa,Commissioner of Labor,Mark Costello,REP,720101,0,0,279,279,
Tulsa,U.S. Senate,Matt Silverstein,DEM,720101,0,0,163,163,
Tulsa,U.S. Senate,Jim Inhofe,REP,720101,0,0,300,300,
Tulsa,U.S. Senate,Aaron Delozier,IND,720101,0,0,5,5,
Tulsa,U.S. Senate,Ray Woods,IND,720101,0,0,7,7,
Tulsa,U.S. Senate,Joan Farr,IND,720101,0,0,8,8,
Tulsa,U.S. Senate,Connie Johnson,DEM,720101,0,0,156,156,
Tulsa,U.S. Senate,James Lankford,REP,720101,0,0,309,309,
Tulsa,U.S. Senate,Mark Beard,IND,720101,0,0,15,15,
Tulsa,Governor,Joe Dorman,DEM,720102,0,0,160,160,
Tulsa,Governor,Mary Fallin,REP,720102,0,0,256,256,
Tulsa,Governor,Kimberly Willis,IND,720102,0,0,12,12,
Tulsa,Governor,Richard Prawdzienski,IND,720102,0,0,5,5,
Tulsa,Lieutenant Governor,Cathy Cummings,DEM,720102,0,0,148,148,
Tulsa,Lieutenant Governor,Todd Lamb,REP,720102,0,0,284,284,
Tulsa,Superintendent of Public Instruction,John Cox,DEM,720102,0,0,177,177,
Tulsa,Superintendent of Public Instruction,Joy Hofmeister,REP,720102,0,0,254,254,
Tulsa,Commissioner of Labor,Mike Workman,DEM,720102,0,0,178,178,
Tulsa,Commissioner of Labor,Mark Costello,REP,720102,0,0,246,246,
Tulsa,U.S. Senate,Matt Silverstein,DEM,720102,0,0,136,136,
Tulsa,U.S. Senate,Jim Inhofe,REP,720102,0,0,278,278,
Tulsa,U.S. Senate,Aaron Delozier,IND,720102,0,0,7,7,
Tulsa,U.S. Senate,Ray Woods,IND,720102,0,0,6,6,
Tulsa,U.S. Senate,Joan Farr,IND,720102,0,0,5,5,
Tulsa,U.S. Senate,Connie Johnson,DEM,720102,0,0,144,144,
Tulsa,U.S. Senate,James Lankford,REP,720102,0,0,271,271,
Tulsa,U.S. Senate,Mark Beard,IND,720102,0,0,17,17,
Tulsa,Governor,Joe Dorman,DEM,720103,0,0,78,78,
Tulsa,Governor,Mary Fallin,REP,720103,0,0,120,120,
Tulsa,Governor,Kimberly Willis,IND,720103,0,0,4,4,
Tulsa,Governor,Richard Prawdzienski,IND,720103,0,0,2,2,
Tulsa,Lieutenant Governor,Cathy Cummings,DEM,720103,0,0,63,63,
Tulsa,Lieutenant Governor,Todd Lamb,REP,720103,0,0,141,141,
Tulsa,Superintendent of Public Instruction,John Cox,DEM,720103,0,0,87,87,
Tulsa,Superintendent of Public Instruction,Joy Hofmeister,REP,720103,0,0,117,117,
Tulsa,Commissioner of Labor,Mike Workman,DEM,720103,0,0,79,79,
Tulsa,Commissioner of Labor,Mark Costello,REP,720103,0,0,117,117,
Tulsa,U.S. Senate,Matt Silverstein,DEM,720103,0,0,69,69,
Tulsa,U.S. Senate,Jim Inhofe,REP,720103,0,0,128,128,
Tulsa,U.S. Senate,Aaron Delozier,IND,720103,0,0,5,5,
Tulsa,U.S. Senate,Ray Woods,IND,720103,0,0,0,0,
Tulsa,U.S. Senate,Joan Farr,IND,720103,0,0,2,2,
Tulsa,U.S. Senate,Connie Johnson,DEM,720103,0,0,64,64,
Tulsa,U.S. Senate,James Lankford,REP,720103,0,0,134,134,
Tulsa,U.S. Senate,Mark Beard,IND,720103,0,0,6,6,
Tulsa,Governor,Joe Dorman,DEM,720104,0,0,130,130,
Tulsa,Governor,Mary Fallin,REP,720104,0,0,170,170,
Tulsa,Governor,Kimberly Willis,IND,720104,0,0,8,8,
Tulsa,Governor,Richard Prawdzienski,IND,720104,0,0,5,5,
Tulsa,Lieutenant Governor,Cathy Cummings,DEM,720104,0,0,111,111,
Tulsa,Lieutenant Governor,Todd Lamb,REP,720104,0,0,198,198,
Tulsa,Superintendent of Public Instruction,John Cox,DEM,720104,0,0,122,122,
Tulsa,Superintendent of Public Instruction,Joy Hofmeister,REP,720104,0,0,189,189,
Tulsa,Commissioner of Labor,Mike Workman,DEM,720104,0,0,121,121,
Tulsa,Commissioner of Labor,Mark Costello,REP,720104,0,0,186,186,
Tulsa,U.S. Senate,Matt Silverstein,DEM,720104,0,0,108,108,
Tulsa,U.S. Senate,Jim Inhofe,REP,720104,0,0,196,196,
Tulsa,U.S. Senate,Aaron Delozier,IND,720104,0,0,2,2,
Tulsa,U.S. Senate,Ray Woods,IND,720104,0,0,1,1,
Tulsa,U.S. Senate,Joan Farr,IND,720104,0,0,5,5,
Tulsa,U.S. Senate,Connie Johnson,DEM,720104,0,0,101,101,
Tulsa,U.S. Senate,James Lankford,REP,720104,0,0,201,201,
Tulsa,U.S. Senate,Mark Beard,IND,720104,0,0,9,9,
Tulsa,Governor,Joe Dorman,DEM,720105,0,0,166,166,
Tulsa,Governor,Mary Fallin,REP,720105,0,0,199,199,
Tulsa,Governor,Kimberly Willis,IND,720105,0,0,11,11,
Tulsa,Governor,Richard Prawdzienski,IND,720105,0,0,5,5,
Tulsa,Lieutenant Governor,Cathy Cummings,DEM,720105,0,0,148,148,
Tulsa,Lieutenant Governor,Todd Lamb,REP,720105,0,0,230,230,
Tulsa,Superintendent of Public Instruction,John Cox,DEM,720105,0,0,168,168,
Tulsa,Superintendent of Public Instruction,Joy Hofmeister,REP,720105,0,0,212,212,
Tulsa,Commissioner of Labor,Mike Workman,DEM,720105,0,0,161,161,
Tulsa,Commissioner of Labor,Mark Costello,REP,720105,0,0,215,215,
Tulsa,U.S. Senate,Matt Silverstein,DEM,720105,0,0,139,139,
Tulsa,U.S. Senate,Jim Inhofe,REP,720105,0,0,228,228,
Tulsa,U.S. Senate,Aaron Delozier,IND,720105,0,0,1,1,
Tulsa,U.S. Senate,Ray Woods,IND,720105,0,0,1,1,
Tulsa,U.S. Senate,Joan Farr,IND,720105,0,0,10,10,
Tulsa,U.S. Senate,Connie Johnson,DEM,720105,0,0,143,143,
Tulsa,U.S. Senate,James Lankford,REP,720105,0,0,223,223,
Tulsa,U.S. Senate,Mark Beard,IND,720105,0,0,14,14,
Tulsa,Governor,Joe Dorman,DEM,720106,0,0,90,90,
Tulsa,Governor,Mary Fallin,REP,720106,0,0,125,125,
Tulsa,Governor,Kimberly Willis,IND,720106,0,0,4,4,
Tulsa,Governor,Richard Prawdzienski,IND,720106,0,0,0,0,
Tulsa,Lieutenant Governor,Cathy Cummings,DEM,720106,0,0,79,79,
Tulsa,Lieutenant Governor,Todd Lamb,REP,720106,0,0,139,139,
Tulsa,Superintendent of Public Instruction,John Cox,DEM,720106,0,0,76,76,
Tulsa,Superintendent of Public Instruction,Joy Hofmeister,REP,720106,0,0,140,140,
Tulsa,Commissioner of Labor,Mike Workman,DEM,720106,0,0,77,77,
Tulsa,Commissioner of Labor,Mark Costello,REP,720106,0,0,135,135,
Tulsa,U.S. Senate,Matt Silverstein,DEM,720106,0,0,74,74,
Tulsa,U.S. Senate,Jim Inhofe,REP,720106,0,0,137,137,
Tulsa,U.S. Senate,Aaron Delozier,IND,720106,0,0,3,3,
Tulsa,U.S. Senate,Ray Woods,IND,720106,0,0,2,2,
Tulsa,U.S. Senate,Joan Farr,IND,720106,0,0,2,2,
Tulsa,U.S. Senate,Connie Johnson,DEM,720106,0,0,72,72,
Tulsa,U.S. Senate,James Lankford,REP,720106,0,0,141,141,
Tulsa,U.S. Senate,Mark Beard,IND,720106,0,0,5,5,
Tulsa,Governor,Joe Dorman,DEM,720107,0,0,303,303,
Tulsa,Governor,Mary Fallin,REP,720107,0,0,321,321,
Tulsa,Governor,Kimberly Willis,IND,720107,0,0,9,9,
Tulsa,Governor,Richard Prawdzienski,IND,720107,0,0,4,4,
Tulsa,Lieutenant Governor,Cathy Cummings,DEM,720107,0,0,240,240,
Tulsa,Lieutenant Governor,Todd Lamb,REP,720107,0,0,394,394,
Tulsa,Superintendent of Public Instruction,John Cox,DEM,720107,0,0,263,263,
Tulsa,Superintendent of Public Instruction,Joy Hofmeister,REP,720107,0,0,368,368,
Tulsa,Commissioner of Labor,Mike Workman,DEM,720107,0,0,264,264,
Tulsa,Commissioner of Labor,Mark Costello,REP,720107,0,0,353,353,
Tulsa,U.S. Senate,Matt Silverstein,DEM,720107,0,0,252,252,
Tulsa,U.S. Senate,Jim Inhofe,REP,720107,0,0,368,368,
Tulsa,U.S. Senate,Aaron Delozier,IND,720107,0,0,6,6,
Tulsa,U.S. Senate,Ray Woods,IND,720107,0,0,3,3,
Tulsa,U.S. Senate,Joan Farr,IND,720107,0,0,6,6,
Tulsa,U.S. Senate,Connie Johnson,DEM,720107,0,0,236,236,
Tulsa,U.S. Senate,James Lankford,REP,720107,0,0,387,387,
Tulsa,U.S. Senate,Mark Beard,IND,720107,0,0,12,12,
Tulsa,Governor,Joe Dorman,DEM,720108,0,0,180,180,
Tulsa,Governor,Mary Fallin,REP,720108,0,0,196,196,
Tulsa,Governor,Kimberly Willis,IND,720108,0,0,8,8,
Tulsa,Governor,Richard Prawdzienski,IND,720108,0,0,8,8,
Tulsa,Lieutenant Governor,Cathy Cummings,DEM,720108,0,0,153,153,
Tulsa,Lieutenant Governor,Todd Lamb,REP,720108,0,0,233,233,
Tulsa,Superintendent of Public Instruction,John Cox,DEM,720108,0,0,170,170,
Tulsa,Superintendent of Public Instruction,Joy Hofmeister,REP,720108,0,0,218,218,
Tulsa,Commissioner of Labor,Mike Workman,DEM,720108,0,0,163,163,
Tulsa,Commissioner of Labor,Mark Costello,REP,720108,0,0,215,215,
Tulsa,U.S. Senate,Matt Silverstein,DEM,720108,0,0,154,154,
Tulsa,U.S. Senate,Jim Inhofe,REP,720108,0,0,217,217,
Tulsa,U.S. Senate,Aaron Delozier,IND,720108,0,0,5,5,
Tulsa,U.S. Senate,Ray Woods,IND,720108,0,0,2,2,
Tulsa,U.S. Senate,Joan Farr,IND,720108,0,0,10,10,
Tulsa,U.S. Senate,Connie Johnson,DEM,720108,0,0,138,138,
Tulsa,U.S. Senate,James Lankford,REP,720108,0,0,235,235,
Tulsa,U.S. Senate,Mark Beard,IND,720108,0,0,18,18,
Tulsa,Governor,Joe Dorman,DEM,720109,0,0,144,144,
Tulsa,Governor,Mary Fallin,REP,720109,0,0,118,118,
Tulsa,Governor,Kimberly Willis,IND,720109,0,0,8,8,
Tulsa,Governor,Richard Prawdzienski,IND,720109,0,0,0,0,
Tulsa,Lieutenant Governor,Cathy Cummings,DEM,720109,0,0,124,124,
Tulsa,Lieutenant Governor,Todd Lamb,REP,720109,0,0,146,146,
Tulsa,Superintendent of Public Instruction,John Cox,DEM,720109,0,0,126,126,
Tulsa,Superintendent of Public Instruction,Joy Hofmeister,REP,720109,0,0,143,143,
Tulsa,Commissioner of Labor,Mike Workman,DEM,720109,0,0,130,130,
Tulsa,Commissioner of Labor,Mark Costello,REP,720109,0,0,134,134,
Tulsa,U.S. Senate,Matt Silverstein,DEM,720109,0,0,119,119,
Tulsa,U.S. Senate,Jim Inhofe,REP,720109,0,0,139,139,
Tulsa,U.S. Senate,Aaron Delozier,IND,720109,0,0,3,3,
Tulsa,U.S. Senate,Ray Woods,IND,720109,0,0,3,3,
Tulsa,U.S. Senate,Joan Farr,IND,720109,0,0,5,5,
Tulsa,U.S. Senate,Connie Johnson,DEM,720109,0,0,117,117,
Tulsa,U.S. Senate,James Lankford,REP,720109,0,0,140,140,
Tulsa,U.S. Senate,Mark Beard,IND,720109,0,0,13,13,
Tulsa,Governor,Joe Dorman,DEM,720110,0,0,171,171,
Tulsa,Governor,Mary Fallin,REP,720110,0,0,204,204,
Tulsa,Governor,Kimberly Willis,IND,720110,0,0,10,10,
Tulsa,Governor,Richard Prawdzienski,IND,720110,0,0,3,3,
Tulsa,Lieutenant Governor,Cathy Cummings,DEM,720110,0,0,162,162,
Tulsa,Lieutenant Governor,Todd Lamb,REP,720110,0,0,225,225,
Tulsa,Superintendent of Public Instruction,John Cox,DEM,720110,0,0,173,173,
Tulsa,Superintendent of Public Instruction,Joy Hofmeister,REP,720110,0,0,213,213,
Tulsa,Commissioner of Labor,Mike Workman,DEM,720110,0,0,168,168,
Tulsa,Commissioner of Labor,Mark Costello,REP,720110,0,0,212,212,
Tulsa,U.S. Senate,Matt Silverstein,DEM,720110,0,0,154,154,
Tulsa,U.S. Senate,Jim Inhofe,REP,720110,0,0,213,213,
Tulsa,U.S. Senate,Aaron Delozier,IND,720110,0,0,4,4,
Tulsa,U.S. Senate,Ray Woods,IND,720110,0,0,4,4,
Tulsa,U.S. Senate,Joan Farr,IND,720110,0,0,10,10,
Tulsa,U.S. Senate,Connie Johnson,DEM,720110,0,0,152,152,
Tulsa,U.S. Senate,James Lankford,REP,720110,0,0,217,217,
Tulsa,U.S. Senate,Mark Beard,IND,720110,0,0,17,17,
Tulsa,Governor,Joe Dorman,DEM,720111,0,0,139,139,
Tulsa,Governor,Mary Fallin,REP,720111,0,0,159,159,
Tulsa,Governor,Kimberly Willis,IND,720111,0,0,5,5,
Tulsa,Governor,Richard Prawdzienski,IND,720111,0,0,4,4,
Tulsa,Lieutenant Governor,Cathy Cummings,DEM,720111,0,0,125,125,
Tulsa,Lieutenant Governor,Todd Lamb,REP,720111,0,0,182,182,
Tulsa,Superintendent of Public Instruction,John Cox,DEM,720111,0,0,129,129,
Tulsa,Superintendent of Public Instruction,Joy Hofmeister,REP,720111,0,0,178,178,
Tulsa,Commissioner of Labor,Mike Workman,DEM,720111,0,0,137,137,
Tulsa,Commissioner of Labor,Mark Costello,REP,720111,0,0,165,165,
Tulsa,U.S. Senate,Matt Silverstein,DEM,720111,0,0,125,125,
Tulsa,U.S. Senate,Jim Inhofe,REP,720111,0,0,170,170,
Tulsa,U.S. Senate,Aaron Delozier,IND,720111,0,0,3,3,
Tulsa,U.S. Senate,Ray Woods,IND,720111,0,0,2,2,
Tulsa,U.S. Senate,Joan Farr,IND,720111,0,0,7,7,
Tulsa,U.S. Senate,Connie Johnson,DEM,720111,0,0,129,129,
Tulsa,U.S. Senate,James Lankford,REP,720111,0,0,169,169,
Tulsa,U.S. Senate,Mark Beard,IND,720111,0,0,9,9,
Tulsa,Governor,Joe Dorman,DEM,720112,0,0,137,137,
Tulsa,Governor,Mary Fallin,REP,720112,0,0,155,155,
Tulsa,Governor,Kimberly Willis,IND,720112,0,0,6,6,
Tulsa,Governor,Richard Prawdzienski,IND,720112,0,0,4,4,
Tulsa,Lieutenant Governor,Cathy Cummings,DEM,720112,0,0,124,124,
Tulsa,Lieutenant Governor,Todd Lamb,REP,720112,0,0,174,174,
Tulsa,Superintendent of Public Instruction,John Cox,DEM,720112,0,0,128,128,
Tulsa,Superintendent of Public Instruction,Joy Hofmeister,REP,720112,0,0,174,174,
Tulsa,Commissioner of Labor,Mike Workman,DEM,720112,0,0,129,129,
Tulsa,Commissioner of Labor,Mark Costello,REP,720112,0,0,172,172,
Tulsa,U.S. Senate,Matt Silverstein,DEM,720112,0,0,118,118,
Tulsa,U.S. Senate,Jim Inhofe,REP,720112,0,0,172,172,
Tulsa,U.S. Senate,Aaron Delozier,IND,720112,0,0,5,5,
Tulsa,U.S. Senate,Ray Woods,IND,720112,0,0,1,1,
Tulsa,U.S. Senate,Joan Farr,IND,720112,0,0,6,6,
Tulsa,U.S. Senate,Connie Johnson,DEM,720112,0,0,112,112,
Tulsa,U.S. Senate,James Lankford,REP,720112,0,0,178,178,
Tulsa,U.S. Senate,Mark Beard,IND,720112,0,0,11,11,
Tulsa,Governor,Joe Dorman,DEM,720113,0,0,137,137,
Tulsa,Governor,Mary Fallin,REP,720113,0,0,227,227,
Tulsa,Governor,Kimberly Willis,IND,720113,0,0,7,7,
Tulsa,Governor,Richard Prawdzienski,IND,720113,0,0,3,3,
Tulsa,Lieutenant Governor,Cathy Cummings,DEM,720113,0,0,115,115,
Tulsa,Lieutenant Governor,Todd Lamb,REP,720113,0,0,253,253,
Tulsa,Superintendent of Public Instruction,John Cox,DEM,720113,0,0,127,127,
Tulsa,Superintendent of Public Instruction,Joy Hofmeister,REP,720113,0,0,244,244,
Tulsa,Commissioner of Labor,Mike Workman,DEM,720113,0,0,123,123,
Tulsa,Commissioner of Labor,Mark Costello,REP,720113,0,0,234,234,
Tulsa,U.S. Senate,Matt Silverstein,DEM,720113,0,0,117,117,
Tulsa,U.S. Senate,Jim Inhofe,REP,720113,0,0,248,248,
Tulsa,U.S. Senate,Aaron Delozier,IND,720113,0,0,1,1,
Tulsa,U.S. Senate,Ray Woods,IND,720113,0,0,3,3,
Tulsa,U.S. Senate,Joan Farr,IND,720113,0,0,3,3,
Tulsa,U.S. Senate,Connie Johnson,DEM,720113,0,0,109,109,
Tulsa,U.S. Senate,James Lankford,REP,720113,0,0,249,249,
Tulsa,U.S. Senate,Mark Beard,IND,720113,0,0,7,7,
Tulsa,Governor,Joe Dorman,DEM,720114,0,0,127,127,
Tulsa,Governor,Mary Fallin,REP,720114,0,0,165,165,
Tulsa,Governor,Kimberly Willis,IND,720114,0,0,3,3,
Tulsa,Governor,Richard Prawdzienski,IND,720114,0,0,2,2,
Tulsa,Lieutenant Governor,Cathy Cummings,DEM,720114,0,0,104,104,
Tulsa,Lieutenant Governor,Todd Lamb,REP,720114,0,0,188,188,
Tulsa,Superintendent of Public Instruction,John Cox,DEM,720114,0,0,112,112,
Tulsa,Superintendent of Public Instruction,Joy Hofmeister,REP,720114,0,0,183,183,
Tulsa,Commissioner of Labor,Mike Workman,DEM,720114,0,0,107,107,
Tulsa,Commissioner of Labor,Mark Costello,REP,720114,0,0,177,177,
Tulsa,U.S. Senate,Matt Silverstein,DEM,720114,0,0,106,106,
Tulsa,U.S. Senate,Jim Inhofe,REP,720114,0,0,182,182,
Tulsa,U.S. Senate,Aaron Delozier,IND,720114,0,0,1,1,
Tulsa,U.S. Senate,Ray Woods,IND,720114,0,0,0,0,
Tulsa,U.S. Senate,Joan Farr,IND,720114,0,0,4,4,
Tulsa,U.S. Senate,Connie Johnson,DEM,720114,0,0,100,100,
Tulsa,U.S. Senate,James Lankford,REP,720114,0,0,187,187,
Tulsa,U.S. Senate,Mark Beard,IND,720114,0,0,5,5,
Tulsa,Governor,Joe Dorman,DEM,720115,0,0,126,126,
Tulsa,Governor,Mary Fallin,REP,720115,0,0,282,282,
Tulsa,Governor,Kimberly Willis,IND,720115,0,0,4,4,
Tulsa,Governor,Richard Prawdzienski,IND,720115,0,0,1,1,
Tulsa,Lieutenant Governor,Cathy Cummings,DEM,720115,0,0,92,92,
Tulsa,Lieutenant Governor,Todd Lamb,REP,720115,0,0,317,317,
Tulsa,Superintendent of Public Instruction,John Cox,DEM,720115,0,0,95,95,
Tulsa,Superintendent of Public Instruction,Joy Hofmeister,REP,720115,0,0,315,315,
Tulsa,Commissioner of Labor,Mike Workman,DEM,720115,0,0,93,93,
Tulsa,Commissioner of Labor,Mark Costello,REP,720115,0,0,299,299,
Tulsa,U.S. Senate,Matt Silverstein,DEM,720115,0,0,102,102,
Tulsa,U.S. Senate,Jim Inhofe,REP,720115,0,0,303,303,
Tulsa,U.S. Senate,Aaron Delozier,IND,720115,0,0,0,0,
Tulsa,U.S. Senate,Ray Woods,IND,720115,0,0,2,2,
Tulsa,U.S. Senate,Joan Farr,IND,720115,0,0,4,4,
Tulsa,U.S. Senate,Connie Johnson,DEM,720115,0,0,88,88,
Tulsa,U.S. Senate,James Lankford,REP,720115,0,0,315,315,
Tulsa,U.S. Senate,Mark Beard,IND,720115,0,0,8,8,
Tulsa,Governor,Joe Dorman,DEM,720116,0,0,209,209,
Tulsa,Governor,Mary Fallin,REP,720116,0,0,414,414,
Tulsa,Governor,Kimberly Willis,IND,720116,0,0,6,6,
Tulsa,Governor,Richard Prawdzienski,IND,720116,0,0,2,2,
Tulsa,Lieutenant Governor,Cathy Cummings,DEM,720116,0,0,147,147,
Tulsa,Lieutenant Governor,Todd Lamb,REP,720116,0,0,482,482,
Tulsa,Superintendent of Public Instruction,John Cox,DEM,720116,0,0,182,182,
Tulsa,Superintendent of Public Instruction,Joy Hofmeister,REP,720116,0,0,448,448,
Tulsa,Commissioner of Labor,Mike Workman,DEM,720116,0,0,155,155,
Tulsa,Commissioner of Labor,Mark Costello,REP,720116,0,0,448,448,
Tulsa,U.S. Senate,Matt Silverstein,DEM,720116,0,0,168,168,
Tulsa,U.S. Senate,Jim Inhofe,REP,720116,0,0,448,448,
Tulsa,U.S. Senate,Aaron Delozier,IND,720116,0,0,2,2,
Tulsa,U.S. Senate,Ray Woods,IND,720116,0,0,1,1,
Tulsa,U.S. Senate,Joan Farr,IND,720116,0,0,9,9,
Tulsa,U.S. Senate,Connie Johnson,DEM,720116,0,0,133,133,
Tulsa,U.S. Senate,James Lankford,REP,720116,0,0,481,481,
Tulsa,U.S. Senate,Mark Beard,IND,720116,0,0,15,15,
Tulsa,Governor,Joe Dorman,DEM,720117,0,0,366,366,
Tulsa,Governor,Mary Fallin,REP,720117,0,0,692,692,
Tulsa,Governor,Kimberly Willis,IND,720117,0,0,16,16,
Tulsa,Governor,Richard Prawdzienski,IND,720117,0,0,17,17,
Tulsa,Lieutenant Governor,Cathy Cummings,DEM,720117,0,0,284,284,
Tulsa,Lieutenant Governor,Todd Lamb,REP,720117,0,0,794,794,
Tulsa,Superintendent of Public Instruction,John Cox,DEM,720117,0,0,300,300,
Tulsa,Superintendent of Public Instruction,Joy Hofmeister,REP,720117,0,0,774,774,
Tulsa,Commissioner of Labor,Mike Workman,DEM,720117,0,0,272,272,
Tulsa,Commissioner of Labor,Mark Costello,REP,720117,0,0,759,759,
Tulsa,U.S. Senate,Matt Silverstein,DEM,720117,0,0,305,305,
Tulsa,U.S. Senate,Jim Inhofe,REP,720117,0,0,749,749,
Tulsa,U.S. Senate,Aaron Delozier,IND,720117,0,0,8,8,
Tulsa,U.S. Senate,Ray Woods,IND,720117,0,0,6,6,
Tulsa,U.S. Senate,Joan Farr,IND,720117,0,0,12,12,
Tulsa,U.S. Senate,Connie Johnson,DEM,720117,0,0,262,262,
Tulsa,U.S. Senate,James Lankford,REP,720117,0,0,783,783,
Tulsa,U.S. Senate,Mark Beard,IND,720117,0,0,34,34,
Tulsa,Governor,Joe Dorman,DEM,720118,0,0,229,229,
Tulsa,Governor,Mary Fallin,REP,720118,0,0,606,606,
Tulsa,Governor,Kimberly Willis,IND,720118,0,0,8,8,
Tulsa,Governor,Richard Prawdzienski,IND,720118,0,0,6,6,
Tulsa,Lieutenant Governor,Cathy Cummings,DEM,720118,0,0,186,186,
Tulsa,Lieutenant Governor,Todd Lamb,REP,720118,0,0,661,661,
Tulsa,Superintendent of Public Instruction,John Cox,DEM,720118,0,0,189,189,
Tulsa,Superintendent of Public Instruction,Joy Hofmeister,REP,720118,0,0,655,655,
Tulsa,Commissioner of Labor,Mike Workman,DEM,720118,0,0,167,167,
Tulsa,Commissioner of Labor,Mark Costello,REP,720118,0,0,661,661,
Tulsa,U.S. Senate,Matt Silverstein,DEM,720118,0,0,174,174,
Tulsa,U.S. Senate,Jim Inhofe,REP,720118,0,0,654,654,
Tulsa,U.S. Senate,Aaron Delozier,IND,720118,0,0,5,5,
Tulsa,U.S. Senate,Ray Woods,IND,720118,0,0,3,3,
Tulsa,U.S. Senate,Joan Farr,IND,720118,0,0,11,11,
Tulsa,U.S. Senate,Connie Johnson,DEM,720118,0,0,166,166,
Tulsa,U.S. Senate,James Lankford,REP,720118,0,0,660,660,
Tulsa,U.S. Senate,Mark Beard,IND,720118,0,0,20,20,
Tulsa,Governor,Joe Dorman,DEM,720119,0,0,150,150,
Tulsa,Governor,Mary Fallin,REP,720119,0,0,422,422,
Tulsa,Governor,Kimberly Willis,IND,720119,0,0,11,11,
Tulsa,Governor,Richard Prawdzienski,IND,720119,0,0,4,4,
Tulsa,Lieutenant Governor,Cathy Cummings,DEM,720119,0,0,109,109,
Tulsa,Lieutenant Governor,Todd Lamb,REP,720119,0,0,478,478,
Tulsa,Superintendent of Public Instruction,John Cox,DEM,720119,0,0,116,116,
Tulsa,Superintendent of Public Instruction,Joy Hofmeister,REP,720119,0,0,469,469,
Tulsa,Commissioner of Labor,Mike Workman,DEM,720119,0,0,109,109,
Tulsa,Commissioner of Labor,Mark Costello,REP,720119,0,0,456,456,
Tulsa,U.S. Senate,Matt Silverstein,DEM,720119,0,0,119,119,
Tulsa,U.S. Senate,Jim Inhofe,REP,720119,0,0,457,457,
Tulsa,U.S. Senate,Aaron Delozier,IND,720119,0,0,0,0,
Tulsa,U.S. Senate,Ray Woods,IND,720119,0,0,3,3,
Tulsa,U.S. Senate,Joan Farr,IND,720119,0,0,8,8,
Tulsa,U.S. Senate,Connie Johnson,DEM,720119,0,0,101,101,
Tulsa,U.S. Senate,James Lankford,REP,720119,0,0,474,474,
Tulsa,U.S. Senate,Mark Beard,IND,720119,0,0,7,7,
Tulsa,Governor,Joe Dorman,DEM,720120,0,0,135,135,
Tulsa,Governor,Mary Fallin,REP,720120,0,0,207,207,
Tulsa,Governor,Kimberly Willis,IND,720120,0,0,9,9,
Tulsa,Governor,Richard Prawdzienski,IND,720120,0,0,4,4,
Tulsa,Lieutenant Governor,Cathy Cummings,DEM,720120,0,0,106,106,
Tulsa,Lieutenant Governor,Todd Lamb,REP,720120,0,0,244,244,
Tulsa,Superintendent of Public Instruction,John Cox,DEM,720120,0,0,123,123,
Tulsa,Superintendent of Public Instruction,Joy Hofmeister,REP,720120,0,0,229,229,
Tulsa,Commissioner of Labor,Mike Workman,DEM,720120,0,0,112,112,
Tulsa,Commissioner of Labor,Mark Costello,REP,720120,0,0,231,231,
Tulsa,U.S. Senate,Matt Silverstein,DEM,720120,0,0,104,104,
Tulsa,U.S. Senate,Jim Inhofe,REP,720120,0,0,240,240,
Tulsa,U.S. Senate,Aaron Delozier,IND,720120,0,0,5,5,
Tulsa,U.S. Senate,Ray Woods,IND,720120,0,0,4,4,
Tulsa,U.S. Senate,Joan Farr,IND,720120,0,0,3,3,
Tulsa,U.S. Senate,Connie Johnson,DEM,720120,0,0,98,98,
Tulsa,U.S. Senate,James Lankford,REP,720120,0,0,238,238,
Tulsa,U.S. Senate,Mark Beard,IND,720120,0,0,17,17,
Tulsa,Governor,Joe Dorman,DEM,720121,0,0,289,289,
Tulsa,Governor,Mary Fallin,REP,720121,0,0,307,307,
Tulsa,Governor,Kimberly Willis,IND,720121,0,0,9,9,
Tulsa,Governor,Richard Prawdzienski,IND,720121,0,0,6,6,
Tulsa,Lieutenant Governor,Cathy Cummings,DEM,720121,0,0,215,215,
Tulsa,Lieutenant Governor,Todd Lamb,REP,720121,0,0,388,388,
Tulsa,Superintendent of Public Instruction,John Cox,DEM,720121,0,0,228,228,
Tulsa,Superintendent of Public Instruction,Joy Hofmeister,REP,720121,0,0,376,376,
Tulsa,Commissioner of Labor,Mike Workman,DEM,720121,0,0,235,235,
Tulsa,Commissioner of Labor,Mark Costello,REP,720121,0,0,345,345,
Tulsa,U.S. Senate,Matt Silverstein,DEM,720121,0,0,240,240,
Tulsa,U.S. Senate,Jim Inhofe,REP,720121,0,0,356,356,
Tulsa,U.S. Senate,Aaron Delozier,IND,720121,0,0,4,4,
Tulsa,U.S. Senate,Ray Woods,IND,720121,0,0,5,5,
Tulsa,U.S. Senate,Joan Farr,IND,720121,0,0,3,3,
Tulsa,U.S. Senate,Connie Johnson,DEM,720121,0,0,213,213,
Tulsa,U.S. Senate,James Lankford,REP,720121,0,0,378,378,
Tulsa,U.S. Senate,Mark Beard,IND,720121,0,0,13,13,
Tulsa,Governor,Joe Dorman,DEM,720122,0,0,103,103,
Tulsa,Governor,Mary Fallin,REP,720122,0,0,165,165,
Tulsa,Governor,Kimberly Willis,IND,720122,0,0,3,3,
Tulsa,Governor,Richard Prawdzienski,IND,720122,0,0,1,1,
Tulsa,Lieutenant Governor,Cathy Cummings,DEM,720122,0,0,72,72,
Tulsa,Lieutenant Governor,Todd Lamb,REP,720122,0,0,200,200,
Tulsa,Superintendent of Public Instruction,John Cox,DEM,720122,0,0,83,83,
Tulsa,Superintendent of Public Instruction,Joy Hofmeister,REP,720122,0,0,188,188,
Tulsa,Commissioner of Labor,Mike Workman,DEM,720122,0,0,75,75,
Tulsa,Commissioner of Labor,Mark Costello,REP,720122,0,0,184,184,
Tulsa,U.S. Senate,Matt Silverstein,DEM,720122,0,0,83,83,
Tulsa,U.S. Senate,Jim Inhofe,REP,720122,0,0,182,182,
Tulsa,U.S. Senate,Aaron Delozier,IND,720122,0,0,1,1,
Tulsa,U.S. Senate,Ray Woods,IND,720122,0,0,0,0,
Tulsa,U.S. Senate,Joan Farr,IND,720122,0,0,4,4,
Tulsa,U.S. Senate,Connie Johnson,DEM,720122,0,0,65,65,
Tulsa,U.S. Senate,James Lankford,REP,720122,0,0,206,206,
Tulsa,U.S. Senate,Mark Beard,IND,720122,0,0,0,0,
Tulsa,Governor,Joe Dorman,DEM,720123,0,0,268,268,
Tulsa,Governor,Mary Fallin,REP,720123,0,0,466,466,
Tulsa,Governor,Kimberly Willis,IND,720123,0,0,15,15,
Tulsa,Governor,Richard Prawdzienski,IND,720123,0,0,5,5,
Tulsa,Lieutenant Governor,Cathy Cummings,DEM,720123,0,0,213,213,
Tulsa,Lieutenant Governor,Todd Lamb,REP,720123,0,0,538,538,
Tulsa,Superintendent of Public Instruction,John Cox,DEM,720123,0,0,226,226,
Tulsa,Superintendent of Public Instruction,Joy Hofmeister,REP,720123,0,0,523,523,
Tulsa,Commissioner of Labor,Mike Workman,DEM,720123,0,0,219,219,
Tulsa,Commissioner of Labor,Mark Costello,REP,720123,0,0,501,501,
Tulsa,U.S. Senate,Matt Silverstein,DEM,720123,0,0,216,216,
Tulsa,U.S. Senate,Jim Inhofe,REP,720123,0,0,508,508,
Tulsa,U.S. Senate,Aaron Delozier,IND,720123,0,0,8,8,
Tulsa,U.S. Senate,Ray Woods,IND,720123,0,0,5,5,
Tulsa,U.S. Senate,Joan Farr,IND,720123,0,0,10,10,
Tulsa,U.S. Senate,Connie Johnson,DEM,720123,0,0,209,209,
Tulsa,U.S. Senate,James Lankford,REP,720123,0,0,522,522,
Tulsa,U.S. Senate,Mark Beard,IND,720123,0,0,18,18,
Tulsa,Governor,Joe Dorman,DEM,720124,0,0,245,245,
Tulsa,Governor,Mary Fallin,REP,720124,0,0,437,437,
Tulsa,Governor,Kimberly Willis,IND,720124,0,0,8,8,
Tulsa,Governor,Richard Prawdzienski,IND,720124,0,0,7,7,
Tulsa,Lieutenant Governor,Cathy Cummings,DEM,720124,0,0,193,193,
Tulsa,Lieutenant Governor,Todd Lamb,REP,720124,0,0,504,504,
Tulsa,Superintendent of Public Instruction,John Cox,DEM,720124,0,0,195,195,
Tulsa,Superintendent of Public Instruction,Joy Hofmeister,REP,720124,0,0,498,498,
Tulsa,Commissioner of Labor,Mike Workman,DEM,720124,0,0,197,197,
Tulsa,Commissioner of Labor,Mark Costello,REP,720124,0,0,479,479,
Tulsa,U.S. Senate,Matt Silverstein,DEM,720124,0,0,203,203,
Tulsa,U.S. Senate,Jim Inhofe,REP,720124,0,0,472,472,
Tulsa,U.S. Senate,Aaron Delozier,IND,720124,0,0,7,7,
Tulsa,U.S. Senate,Ray Woods,IND,720124,0,0,2,2,
Tulsa,U.S. Senate,Joan Farr,IND,720124,0,0,8,8,
Tulsa,U.S. Senate,Connie Johnson,DEM,720124,0,0,184,184,
Tulsa,U.S. Senate,James Lankford,REP,720124,0,0,494,494,
Tulsa,U.S. Senate,Mark Beard,IND,720124,0,0,14,14,
Tulsa,Governor,Joe Dorman,DEM,720125,0,0,238,238,
Tulsa,Governor,Mary Fallin,REP,720125,0,0,367,367,
Tulsa,Governor,Kimberly Willis,IND,720125,0,0,10,10,
Tulsa,Governor,Richard Prawdzienski,IND,720125,0,0,6,6,
Tulsa,Lieutenant Governor,Cathy Cummings,DEM,720125,0,0,194,194,
Tulsa,Lieutenant Governor,Todd Lamb,REP,720125,0,0,419,419,
Tulsa,Superintendent of Public Instruction,John Cox,DEM,720125,0,0,198,198,
Tulsa,Superintendent of Public Instruction,Joy Hofmeister,REP,720125,0,0,417,417,
Tulsa,Commissioner of Labor,Mike Workman,DEM,720125,0,0,200,200,
Tulsa,Commissioner of Labor,Mark Costello,REP,720125,0,0,398,398,
Tulsa,U.S. Senate,Matt Silverstein,DEM,720125,0,0,189,189,
Tulsa,U.S. Senate,Jim Inhofe,REP,720125,0,0,417,417,
Tulsa,U.S. Senate,Aaron Delozier,IND,720125,0,0,4,4,
Tulsa,U.S. Senate,Ray Woods,IND,720125,0,0,3,3,
Tulsa,U.S. Senate,Joan Farr,IND,720125,0,0,5,5,
Tulsa,U.S. Senate,Connie Johnson,DEM,720125,0,0,174,174,
Tulsa,U.S. Senate,James Lankford,REP,720125,0,0,429,429,
Tulsa,U.S. Senate,Mark Beard,IND,720125,0,0,13,13,
Tulsa,Governor,Joe Dorman,DEM,720126,0,0,196,196,
Tulsa,Governor,Mary Fallin,REP,720126,0,0,364,364,
Tulsa,Governor,Kimberly Willis,IND,720126,0,0,7,7,
Tulsa,Governor,Richard Prawdzienski,IND,720126,0,0,2,2,
Tulsa,Lieutenant Governor,Cathy Cummings,DEM,720126,0,0,150,150,
Tulsa,Lieutenant Governor,Todd Lamb,REP,720126,0,0,415,415,
Tulsa,Superintendent of Public Instruction,John Cox,DEM,720126,0,0,168,168,
Tulsa,Superintendent of Public Instruction,Joy Hofmeister,REP,720126,0,0,401,401,
Tulsa,Commissioner of Labor,Mike Workman,DEM,720126,0,0,174,174,
Tulsa,Commissioner of Labor,Mark Costello,REP,720126,0,0,371,371,
Tulsa,U.S. Senate,Matt Silverstein,DEM,720126,0,0,157,157,
Tulsa,U.S. Senate,Jim Inhofe,REP,720126,0,0,400,400,
Tulsa,U.S. Senate,Aaron Delozier,IND,720126,0,0,4,4,
Tulsa,U.S. Senate,Ray Woods,IND,720126,0,0,1,1,
Tulsa,U.S. Senate,Joan Farr,IND,720126,0,0,5,5,
Tulsa,U.S. Senate,Connie Johnson,DEM,720126,0,0,147,147,
Tulsa,U.S. Senate,James Lankford,REP,720126,0,0,408,408,
Tulsa,U.S. Senate,Mark Beard,IND,720126,0,0,12,12,
Tulsa,Governor,Joe Dorman,DEM,720127,0,0,121,121,
Tulsa,Governor,Mary Fallin,REP,720127,0,0,220,220,
Tulsa,Governor,Kimberly Willis,IND,720127,0,0,6,6,
Tulsa,Governor,Richard Prawdzienski,IND,720127,0,0,4,4,
Tulsa,Lieutenant Governor,Cathy Cummings,DEM,720127,0,0,100,100,
Tulsa,Lieutenant Governor,Todd Lamb,REP,720127,0,0,249,249,
Tulsa,Superintendent of Public Instruction,John Cox,DEM,720127,0,0,101,101,
Tulsa,Superintendent of Public Instruction,Joy Hofmeister,REP,720127,0,0,250,250,
Tulsa,Commissioner of Labor,Mike Workman,DEM,720127,0,0,90,90,
Tulsa,Commissioner of Labor,Mark Costello,REP,720127,0,0,246,246,
Tulsa,U.S. Senate,Matt Silverstein,DEM,720127,0,0,92,92,
Tulsa,U.S. Senate,Jim Inhofe,REP,720127,0,0,247,247,
Tulsa,U.S. Senate,Aaron Delozier,IND,720127,0,0,4,4,
Tulsa,U.S. Senate,Ray Woods,IND,720127,0,0,3,3,
Tulsa,U.S. Senate,Joan Farr,IND,720127,0,0,3,3,
Tulsa,U.S. Senate,Connie Johnson,DEM,720127,0,0,95,95,
Tulsa,U.S. Senate,James Lankford,REP,720127,0,0,243,243,
Tulsa,U.S. Senate,Mark Beard,IND,720127,0,0,13,13,
Tulsa,Governor,Joe Dorman,DEM,720128,0,0,194,194,
Tulsa,Governor,Mary Fallin,REP,720128,0,0,327,327,
Tulsa,Governor,Kimberly Willis,IND,720128,0,0,10,10,
Tulsa,Governor,Richard Prawdzienski,IND,720128,0,0,10,10,
Tulsa,Lieutenant Governor,Cathy Cummings,DEM,720128,0,0,159,159,
Tulsa,Lieutenant Governor,Todd Lamb,REP,720128,0,0,379,379,
Tulsa,Superintendent of Public Instruction,John Cox,DEM,720128,0,0,173,173,
Tulsa,Superintendent of Public Instruction,Joy Hofmeister,REP,720128,0,0,365,365,
Tulsa,Commissioner of Labor,Mike Workman,DEM,720128,0,0,169,169,
Tulsa,Commissioner of Labor,Mark Costello,REP,720128,0,0,357,357,
Tulsa,U.S. Senate,Matt Silverstein,DEM,720128,0,0,157,157,
Tulsa,U.S. Senate,Jim Inhofe,REP,720128,0,0,362,362,
Tulsa,U.S. Senate,Aaron Delozier,IND,720128,0,0,4,4,
Tulsa,U.S. Senate,Ray Woods,IND,720128,0,0,3,3,
Tulsa,U.S. Senate,Joan Farr,IND,720128,0,0,11,11,
Tulsa,U.S. Senate,Connie Johnson,DEM,720128,0,0,153,153,
Tulsa,U.S. Senate,James Lankford,REP,720128,0,0,375,375,
Tulsa,U.S. Senate,Mark Beard,IND,720128,0,0,11,11,
Tulsa,Governor,Joe Dorman,DEM,720129,0,0,224,224,
Tulsa,Governor,Mary Fallin,REP,720129,0,0,352,352,
Tulsa,Governor,Kimberly Willis,IND,720129,0,0,6,6,
Tulsa,Governor,Richard Prawdzienski,IND,720129,0,0,2,2,
Tulsa,Lieutenant Governor,Cathy Cummings,DEM,720129,0,0,158,158,
Tulsa,Lieutenant Governor,Todd Lamb,REP,720129,0,0,422,422,
Tulsa,Superintendent of Public Instruction,John Cox,DEM,720129,0,0,186,186,
Tulsa,Superintendent of Public Instruction,Joy Hofmeister,REP,720129,0,0,396,396,
Tulsa,Commissioner of Labor,Mike Workman,DEM,720129,0,0,166,166,
Tulsa,Commissioner of Labor,Mark Costello,REP,720129,0,0,398,398,
Tulsa,U.S. Senate,Matt Silverstein,DEM,720129,0,0,172,172,
Tulsa,U.S. Senate,Jim Inhofe,REP,720129,0,0,407,407,
Tulsa,U.S. Senate,Aaron Delozier,IND,720129,0,0,3,3,
Tulsa,U.S. Senate,Ray Woods,IND,720129,0,0,1,1,
Tulsa,U.S. Senate,Joan Farr,IND,720129,0,0,2,2,
Tulsa,U.S. Senate,Connie Johnson,DEM,720129,0,0,157,157,
Tulsa,U.S. Senate,James Lankford,REP,720129,0,0,406,406,
Tulsa,U.S. Senate,Mark Beard,IND,720129,0,0,12,12,
Tulsa,Governor,Joe Dorman,DEM,720130,0,0,236,236,
Tulsa,Governor,Mary Fallin,REP,720130,0,0,346,346,
Tulsa,Governor,Kimberly Willis,IND,720130,0,0,10,10,
Tulsa,Governor,Richard Prawdzienski,IND,720130,0,0,7,7,
Tulsa,Lieutenant Governor,Cathy Cummings,DEM,720130,0,0,191,191,
Tulsa,Lieutenant Governor,Todd Lamb,REP,720130,0,0,403,403,
Tulsa,Superintendent of Public Instruction,John Cox,DEM,720130,0,0,215,215,
Tulsa,Superintendent of Public Instruction,Joy Hofmeister,REP,720130,0,0,379,379,
Tulsa,Commissioner of Labor,Mike Workman,DEM,720130,0,0,202,202,
Tulsa,Commissioner of Labor,Mark Costello,REP,720130,0,0,371,371,
Tulsa,U.S. Senate,Matt Silverstein,DEM,720130,0,0,195,195,
Tulsa,U.S. Senate,Jim Inhofe,REP,720130,0,0,376,376,
Tulsa,U.S. Senate,Aaron Delozier,IND,720130,0,0,6,6,
Tulsa,U.S. Senate,Ray Woods,IND,720130,0,0,5,5,
Tulsa,U.S. Senate,Joan Farr,IND,720130,0,0,10,10,
Tulsa,U.S. Senate,Connie Johnson,DEM,720130,0,0,179,179,
Tulsa,U.S. Senate,James Lankford,REP,720130,0,0,397,397,
Tulsa,U.S. Senate,Mark Beard,IND,720130,0,0,20,20,
Tulsa,Governor,Joe Dorman,DEM,720131,0,0,40,40,
Tulsa,Governor,Mary Fallin,REP,720131,0,0,26,26,
Tulsa,Governor,Kimberly Willis,IND,720131,0,0,3,3,
Tulsa,Governor,Richard Prawdzienski,IND,720131,0,0,1,1,
Tulsa,Lieutenant Governor,Cathy Cummings,DEM,720131,0,0,43,43,
Tulsa,Lieutenant Governor,Todd Lamb,REP,720131,0,0,27,27,
Tulsa,Superintendent of Public Instruction,John Cox,DEM,720131,0,0,45,45,
Tulsa,Superintendent of Public Instruction,Joy Hofmeister,REP,720131,0,0,25,25,
Tulsa,Commissioner of Labor,Mike Workman,DEM,720131,0,0,41,41,
Tulsa,Commissioner of Labor,Mark Costello,REP,720131,0,0,29,29,
Tulsa,U.S. Senate,Matt Silverstein,DEM,720131,0,0,38,38,
Tulsa,U.S. Senate,Jim Inhofe,REP,720131,0,0,30,30,
Tulsa,U.S. Senate,Aaron Delozier,IND,720131,0,0,1,1,
Tulsa,U.S. Senate,Ray Woods,IND,720131,0,0,1,1,
Tulsa,U.S. Senate,Joan Farr,IND,720131,0,0,0,0,
Tulsa,U.S. Senate,Connie Johnson,DEM,720131,0,0,39,39,
Tulsa,U.S. Senate,James Lankford,REP,720131,0,0,28,28,
Tulsa,U.S. Senate,Mark Beard,IND,720131,0,0,3,3,
Tulsa,Governor,Joe Dorman,DEM,720132,0,0,176,176,
Tulsa,Governor,Mary Fallin,REP,720132,0,0,368,368,
Tulsa,Governor,Kimberly Willis,IND,720132,0,0,12,12,
Tulsa,Governor,Richard Prawdzienski,IND,720132,0,0,6,6,
Tulsa,Lieutenant Governor,Cathy Cummings,DEM,720132,0,0,124,124,
Tulsa,Lieutenant Governor,Todd Lamb,REP,720132,0,0,435,435,
Tulsa,Superintendent of Public Instruction,John Cox,DEM,720132,0,0,166,166,
Tulsa,Superintendent of Public Instruction,Joy Hofmeister,REP,720132,0,0,394,394,
Tulsa,Commissioner of Labor,Mike Workman,DEM,720132,0,0,151,151,
Tulsa,Commissioner of Labor,Mark Costello,REP,720132,0,0,395,395,
Tulsa,U.S. Senate,Matt Silverstein,DEM,720132,0,0,144,144,
Tulsa,U.S. Senate,Jim Inhofe,REP,720132,0,0,409,409,
Tulsa,U.S. Senate,Aaron Delozier,IND,720132,0,0,2,2,
Tulsa,U.S. Senate,Ray Woods,IND,720132,0,0,5,5,
Tulsa,U.S. Senate,Joan Farr,IND,720132,0,0,3,3,
Tulsa,U.S. Senate,Connie Johnson,DEM,720132,0,0,121,121,
Tulsa,U.S. Senate,James Lankford,REP,720132,0,0,426,426,
Tulsa,U.S. Senate,Mark Beard,IND,720132,0,0,13,13,
Tulsa,Governor,Joe Dorman,DEM,720133,0,0,207,207,
Tulsa,Governor,Mary Fallin,REP,720133,0,0,357,357,
Tulsa,Governor,Kimberly Willis,IND,720133,0,0,8,8,
Tulsa,Governor,Richard Prawdzienski,IND,720133,0,0,5,5,
Tulsa,Lieutenant Governor,Cathy Cummings,DEM,720133,0,0,154,154,
Tulsa,Lieutenant Governor,Todd Lamb,REP,720133,0,0,423,423,
Tulsa,Superintendent of Public Instruction,John Cox,DEM,720133,0,0,211,211,
Tulsa,Superintendent of Public Instruction,Joy Hofmeister,REP,720133,0,0,363,363,
Tulsa,Commissioner of Labor,Mike Workman,DEM,720133,0,0,183,183,
Tulsa,Commissioner of Labor,Mark Costello,REP,720133,0,0,378,378,
Tulsa,U.S. Senate,Matt Silverstein,DEM,720133,0,0,174,174,
Tulsa,U.S. Senate,Jim Inhofe,REP,720133,0,0,385,385,
Tulsa,U.S. Senate,Aaron Delozier,IND,720133,0,0,7,7,
Tulsa,U.S. Senate,Ray Woods,IND,720133,0,0,5,5,
Tulsa,U.S. Senate,Joan Farr,IND,720133,0,0,4,4,
Tulsa,U.S. Senate,Connie Johnson,DEM,720133,0,0,152,152,
Tulsa,U.S. Senate,James Lankford,REP,720133,0,0,411,411,
Tulsa,U.S. Senate,Mark Beard,IND,720133,0,0,13,13,
Tulsa,Governor,Joe Dorman,DEM,720134,0,0,188,188,
Tulsa,Governor,Mary Fallin,REP,720134,0,0,394,394,
Tulsa,Governor,Kimberly Willis,IND,720134,0,0,13,13,
Tulsa,Governor,Richard Prawdzienski,IND,720134,0,0,4,4,
Tulsa,Lieutenant Governor,Cathy Cummings,DEM,720134,0,0,149,149,
Tulsa,Lieutenant Governor,Todd Lamb,REP,720134,0,0,445,445,
Tulsa,Superintendent of Public Instruction,John Cox,DEM,720134,0,0,186,186,
Tulsa,Superintendent of Public Instruction,Joy Hofmeister,REP,720134,0,0,408,408,
Tulsa,Commissioner of Labor,Mike Workman,DEM,720134,0,0,162,162,
Tulsa,Commissioner of Labor,Mark Costello,REP,720134,0,0,417,417,
Tulsa,U.S. Senate,Matt Silverstein,DEM,720134,0,0,158,158,
Tulsa,U.S. Senate,Jim Inhofe,REP,720134,0,0,419,419,
Tulsa,U.S. Senate,Aaron Delozier,IND,720134,0,0,7,7,
Tulsa,U.S. Senate,Ray Woods,IND,720134,0,0,5,5,
Tulsa,U.S. Senate,Joan Farr,IND,720134,0,0,6,6,
Tulsa,U.S. Senate,Connie Johnson,DEM,720134,0,0,145,145,
Tulsa,U.S. Senate,James Lankford,REP,720134,0,0,436,436,
Tulsa,U.S. Senate,Mark Beard,IND,720134,0,0,13,13,
Tulsa,Governor,Joe Dorman,DEM,720135,0,0,264,264,
Tulsa,Governor,Mary Fallin,REP,720135,0,0,480,480,
Tulsa,Governor,Kimberly Willis,IND,720135,0,0,6,6,
Tulsa,Governor,Richard Prawdzienski,IND,720135,0,0,3,3,
Tulsa,Lieutenant Governor,Cathy Cummings,DEM,720135,0,0,187,187,
Tulsa,Lieutenant Governor,Todd Lamb,REP,720135,0,0,561,561,
Tulsa,Superintendent of Public Instruction,John Cox,DEM,720135,0,0,239,239,
Tulsa,Superintendent of Public Instruction,Joy Hofmeister,REP,720135,0,0,507,507,
Tulsa,Commissioner of Labor,Mike Workman,DEM,720135,0,0,218,218,
Tulsa,Commissioner of Labor,Mark Costello,REP,720135,0,0,517,517,
Tulsa,U.S. Senate,Matt Silverstein,DEM,720135,0,0,199,199,
Tulsa,U.S. Senate,Jim Inhofe,REP,720135,0,0,531,531,
Tulsa,U.S. Senate,Aaron Delozier,IND,720135,0,0,5,5,
Tulsa,U.S. Senate,Ray Woods,IND,720135,0,0,6,6,
Tulsa,U.S. Senate,Joan Farr,IND,720135,0,0,7,7,
Tulsa,U.S. Senate,Connie Johnson,DEM,720135,0,0,178,178,
Tulsa,U.S. Senate,James Lankford,REP,720135,0,0,551,551,
Tulsa,U.S. Senate,Mark Beard,IND,720135,0,0,19,19,
Tulsa,Governor,Joe Dorman,DEM,720136,0,0,143,143,
Tulsa,Governor,Mary Fallin,REP,720136,0,0,384,384,
Tulsa,Governor,Kimberly Willis,IND,720136,0,0,5,5,
Tulsa,Governor,Richard Prawdzienski,IND,720136,0,0,4,4,
Tulsa,Lieutenant Governor,Cathy Cummings,DEM,720136,0,0,104,104,
Tulsa,Lieutenant Governor,Todd Lamb,REP,720136,0,0,431,431,
Tulsa,Superintendent of Public Instruction,John Cox,DEM,720136,0,0,127,127,
Tulsa,Superintendent of Public Instruction,Joy Hofmeister,REP,720136,0,0,412,412,
Tulsa,Commissioner of Labor,Mike Workman,DEM,720136,0,0,105,105,
Tulsa,Commissioner of Labor,Mark Costello,REP,720136,0,0,419,419,
Tulsa,U.S. Senate,Matt Silverstein,DEM,720136,0,0,102,102,
Tulsa,U.S. Senate,Jim Inhofe,REP,720136,0,0,421,421,
Tulsa,U.S. Senate,Aaron Delozier,IND,720136,0,0,5,5,
Tulsa,U.S. Senate,Ray Woods,IND,720136,0,0,3,3,
Tulsa,U.S. Senate,Joan Farr,IND,720136,0,0,4,4,
Tulsa,U.S. Senate,Connie Johnson,DEM,720136,0,0,97,97,
Tulsa,U.S. Senate,James Lankford,REP,720136,0,0,428,428,
Tulsa,U.S. Senate,Mark Beard,IND,720136,0,0,11,11,
Tulsa,Governor,Joe Dorman,DEM,720137,0,0,140,140,
Tulsa,Governor,Mary Fallin,REP,720137,0,0,151,151,
Tulsa,Governor,Kimberly Willis,IND,720137,0,0,6,6,
Tulsa,Governor,Richard Prawdzienski,IND,720137,0,0,4,4,
Tulsa,Lieutenant Governor,Cathy Cummings,DEM,720137,0,0,122,122,
Tulsa,Lieutenant Governor,Todd Lamb,REP,720137,0,0,181,181,
Tulsa,Superintendent of Public Instruction,John Cox,DEM,720137,0,0,139,139,
Tulsa,Superintendent of Public Instruction,Joy Hofmeister,REP,720137,0,0,162,162,
Tulsa,Commissioner of Labor,Mike Workman,DEM,720137,0,0,120,120,
Tulsa,Commissioner of Labor,Mark Costello,REP,720137,0,0,177,177,
Tulsa,U.S. Senate,Matt Silverstein,DEM,720137,0,0,123,123,
Tulsa,U.S. Senate,Jim Inhofe,REP,720137,0,0,171,171,
Tulsa,U.S. Senate,Aaron Delozier,IND,720137,0,0,1,1,
Tulsa,U.S. Senate,Ray Woods,IND,720137,0,0,3,3,
Tulsa,U.S. Senate,Joan Farr,IND,720137,0,0,4,4,
Tulsa,U.S. Senate,Connie Johnson,DEM,720137,0,0,117,117,
Tulsa,U.S. Senate,James Lankford,REP,720137,0,0,176,176,
Tulsa,U.S. Senate,Mark Beard,IND,720137,0,0,11,11,
Tulsa,Governor,Joe Dorman,DEM,720138,0,0,37,37,
Tulsa,Governor,Mary Fallin,REP,720138,0,0,43,43,
Tulsa,Governor,Kimberly Willis,IND,720138,0,0,1,1,
Tulsa,Governor,Richard Prawdzienski,IND,720138,0,0,1,1,
Tulsa,Lieutenant Governor,Cathy Cummings,DEM,720138,0,0,30,30,
Tulsa,Lieutenant Governor,Todd Lamb,REP,720138,0,0,52,52,
Tulsa,Superintendent of Public Instruction,John Cox,DEM,720138,0,0,36,36,
Tulsa,Superintendent of Public Instruction,Joy Hofmeister,REP,720138,0,0,46,46,
Tulsa,Commissioner of Labor,Mike Workman,DEM,720138,0,0,28,28,
Tulsa,Commissioner of Labor,Mark Costello,REP,720138,0,0,54,54,
Tulsa,U.S. Senate,Matt Silverstein,DEM,720138,0,0,32,32,
Tulsa,U.S. Senate,Jim Inhofe,REP,720138,0,0,49,49,
Tulsa,U.S. Senate,Aaron Delozier,IND,720138,0,0,1,1,
Tulsa,U.S. Senate,Ray Woods,IND,720138,0,0,0,0,
Tulsa,U.S. Senate,Joan Farr,IND,720138,0,0,0,0,
Tulsa,U.S. Senate,Connie Johnson,DEM,720138,0,0,29,29,
Tulsa,U.S. Senate,James Lankford,REP,720138,0,0,50,50,
Tulsa,U.S. Senate,Mark Beard,IND,720138,0,0,2,2,
Tulsa,Governor,Joe Dorman,DEM,720139,0,0,169,169,
Tulsa,Governor,Mary Fallin,REP,720139,0,0,78,78,
Tulsa,Governor,Kimberly Willis,IND,720139,0,0,9,9,
Tulsa,Governor,Richard Prawdzienski,IND,720139,0,0,4,4,
Tulsa,Lieutenant Governor,Cathy Cummings,DEM,720139,0,0,160,160,
Tulsa,Lieutenant Governor,Todd Lamb,REP,720139,0,0,99,99,
Tulsa,Superintendent of Public Instruction,John Cox,DEM,720139,0,0,167,167,
Tulsa,Superintendent of Public Instruction,Joy Hofmeister,REP,720139,0,0,90,90,
Tulsa,Commissioner of Labor,Mike Workman,DEM,720139,0,0,177,177,
Tulsa,Commissioner of Labor,Mark Costello,REP,720139,0,0,80,80,
Tulsa,U.S. Senate,Matt Silverstein,DEM,720139,0,0,156,156,
Tulsa,U.S. Senate,Jim Inhofe,REP,720139,0,0,86,86,
Tulsa,U.S. Senate,Aaron Delozier,IND,720139,0,0,7,7,
Tulsa,U.S. Senate,Ray Woods,IND,720139,0,0,3,3,
Tulsa,U.S. Senate,Joan Farr,IND,720139,0,0,6,6,
Tulsa,U.S. Senate,Connie Johnson,DEM,720139,0,0,160,160,
Tulsa,U.S. Senate,James Lankford,REP,720139,0,0,84,84,
Tulsa,U.S. Senate,Mark Beard,IND,720139,0,0,12,12,
Tulsa,Governor,Joe Dorman,DEM,720140,0,0,152,152,
Tulsa,Governor,Mary Fallin,REP,720140,0,0,52,52,
Tulsa,Governor,Kimberly Willis,IND,720140,0,0,7,7,
Tulsa,Governor,Richard Prawdzienski,IND,720140,0,0,4,4,
Tulsa,Lieutenant Governor,Cathy Cummings,DEM,720140,0,0,129,129,
Tulsa,Lieutenant Governor,Todd Lamb,REP,720140,0,0,79,79,
Tulsa,Superintendent of Public Instruction,John Cox,DEM,720140,0,0,135,135,
Tulsa,Superintendent of Public Instruction,Joy Hofmeister,REP,720140,0,0,74,74,
Tulsa,Commissioner of Labor,Mike Workman,DEM,720140,0,0,140,140,
Tulsa,Commissioner of Labor,Mark Costello,REP,720140,0,0,64,64,
Tulsa,U.S. Senate,Matt Silverstein,DEM,720140,0,0,130,130,
Tulsa,U.S. Senate,Jim Inhofe,REP,720140,0,0,71,71,
Tulsa,U.S. Senate,Aaron Delozier,IND,720140,0,0,4,4,
Tulsa,U.S. Senate,Ray Woods,IND,720140,0,0,5,5,
Tulsa,U.S. Senate,Joan Farr,IND,720140,0,0,5,5,
Tulsa,U.S. Senate,Connie Johnson,DEM,720140,0,0,128,128,
Tulsa,U.S. Senate,James Lankford,REP,720140,0,0,72,72,
Tulsa,U.S. Senate,Mark Beard,IND,720140,0,0,10,10,
Tulsa,Governor,Joe Dorman,DEM,720141,0,0,224,224,
Tulsa,Governor,Mary Fallin,REP,720141,0,0,349,349,
Tulsa,Governor,Kimberly Willis,IND,720141,0,0,19,19,
Tulsa,Governor,Richard Prawdzienski,IND,720141,0,0,8,8,
Tulsa,Lieutenant Governor,Cathy Cummings,DEM,720141,0,0,196,196,
Tulsa,Lieutenant Governor,Todd Lamb,REP,720141,0,0,400,400,
Tulsa,Superintendent of Public Instruction,John Cox,DEM,720141,0,0,239,239,
Tulsa,Superintendent of Public Instruction,Joy Hofmeister,REP,720141,0,0,353,353,
Tulsa,Commissioner of Labor,Mike Workman,DEM,720141,0,0,224,224,
Tulsa,Commissioner of Labor,Mark Costello,REP,720141,0,0,356,356,
Tulsa,U.S. Senate,Matt Silverstein,DEM,720141,0,0,187,187,
Tulsa,U.S. Senate,Jim Inhofe,REP,720141,0,0,387,387,
Tulsa,U.S. Senate,Aaron Delozier,IND,720141,0,0,11,11,
Tulsa,U.S. Senate,Ray Woods,IND,720141,0,0,5,5,
Tulsa,U.S. Senate,Joan Farr,IND,720141,0,0,9,9,
Tulsa,U.S. Senate,Connie Johnson,DEM,720141,0,0,179,179,
Tulsa,U.S. Senate,James Lankford,REP,720141,0,0,387,387,
Tulsa,U.S. Senate,Mark Beard,IND,720141,0,0,33,33,
Tulsa,Governor,Joe Dorman,DEM,720142,0,0,138,138,
Tulsa,Governor,Mary Fallin,REP,720142,0,0,236,236,
Tulsa,Governor,Kimberly Willis,IND,720142,0,0,12,12,
Tulsa,Governor,Richard Prawdzienski,IND,720142,0,0,3,3,
Tulsa,Lieutenant Governor,Cathy Cummings,DEM,720142,0,0,103,103,
Tulsa,Lieutenant Governor,Todd Lamb,REP,720142,0,0,286,286,
Tulsa,Superintendent of Public Instruction,John Cox,DEM,720142,0,0,137,137,
Tulsa,Superintendent of Public Instruction,Joy Hofmeister,REP,720142,0,0,253,253,
Tulsa,Commissioner of Labor,Mike Workman,DEM,720142,0,0,128,128,
Tulsa,Commissioner of Labor,Mark Costello,REP,720142,0,0,255,255,
Tulsa,U.S. Senate,Matt Silverstein,DEM,720142,0,0,98,98,
Tulsa,U.S. Senate,Jim Inhofe,REP,720142,0,0,282,282,
Tulsa,U.S. Senate,Aaron Delozier,IND,720142,0,0,4,4,
Tulsa,U.S. Senate,Ray Woods,IND,720142,0,0,6,6,
Tulsa,U.S. Senate,Joan Farr,IND,720142,0,0,0,0,
Tulsa,U.S. Senate,Connie Johnson,DEM,720142,0,0,80,80,
Tulsa,U.S. Senate,James Lankford,REP,720142,0,0,295,295,
Tulsa,U.S. Senate,Mark Beard,IND,720142,0,0,15,15,
Tulsa,Governor,Joe Dorman,DEM,720143,0,0,120,120,
Tulsa,Governor,Mary Fallin,REP,720143,0,0,201,201,
Tulsa,Governor,Kimberly Willis,IND,720143,0,0,15,15,
Tulsa,Governor,Richard Prawdzienski,IND,720143,0,0,3,3,
Tulsa,Lieutenant Governor,Cathy Cummings,DEM,720143,0,0,95,95,
Tulsa,Lieutenant Governor,Todd Lamb,REP,720143,0,0,245,245,
Tulsa,Superintendent of Public Instruction,John Cox,DEM,720143,0,0,122,122,
Tulsa,Superintendent of Public Instruction,Joy Hofmeister,REP,720143,0,0,215,215,
Tulsa,Commissioner of Labor,Mike Workman,DEM,720143,0,0,129,129,
Tulsa,Commissioner of Labor,Mark Costello,REP,720143,0,0,202,202,
Tulsa,U.S. Senate,Matt Silverstein,DEM,720143,0,0,84,84,
Tulsa,U.S. Senate,Jim Inhofe,REP,720143,0,0,239,239,
Tulsa,U.S. Senate,Aaron Delozier,IND,720143,0,0,7,7,
Tulsa,U.S. Senate,Ray Woods,IND,720143,0,0,5,5,
Tulsa,U.S. Senate,Joan Farr,IND,720143,0,0,4,4,
Tulsa,U.S. Senate,Connie Johnson,DEM,720143,0,0,81,81,
Tulsa,U.S. Senate,James Lankford,REP,720143,0,0,246,246,
Tulsa,U.S. Senate,Mark Beard,IND,720143,0,0,12,12,
Tulsa,Governor,Joe Dorman,DEM,720144,0,0,317,317,
Tulsa,Governor,Mary Fallin,REP,720144,0,0,331,331,
Tulsa,Governor,Kimberly Willis,IND,720144,0,0,20,20,
Tulsa,Governor,Richard Prawdzienski,IND,720144,0,0,8,8,
Tulsa,Lieutenant Governor,Cathy Cummings,DEM,720144,0,0,275,275,
Tulsa,Lieutenant Governor,Todd Lamb,REP,720144,0,0,397,397,
Tulsa,Superintendent of Public Instruction,John Cox,DEM,720144,0,0,303,303,
Tulsa,Superintendent of Public Instruction,Joy Hofmeister,REP,720144,0,0,364,364,
Tulsa,Commissioner of Labor,Mike Workman,DEM,720144,0,0,320,320,
Tulsa,Commissioner of Labor,Mark Costello,REP,720144,0,0,337,337,
Tulsa,U.S. Senate,Matt Silverstein,DEM,720144,0,0,256,256,
Tulsa,U.S. Senate,Jim Inhofe,REP,720144,0,0,398,398,
Tulsa,U.S. Senate,Aaron Delozier,IND,720144,0,0,7,7,
Tulsa,U.S. Senate,Ray Woods,IND,720144,0,0,4,4,
Tulsa,U.S. Senate,Joan Farr,IND,720144,0,0,9,9,
Tulsa,U.S. Senate,Connie Johnson,DEM,720144,0,0,251,251,
Tulsa,U.S. Senate,James Lankford,REP,720144,0,0,395,395,
Tulsa,U.S. Senate,Mark Beard,IND,720144,0,0,27,27,
Tulsa,Governor,Joe Dorman,DEM,720145,0,0,178,178,
Tulsa,Governor,Mary Fallin,REP,720145,0,0,463,463,
Tulsa,Governor,Kimberly Willis,IND,720145,0,0,8,8,
Tulsa,Governor,Richard Prawdzienski,IND,720145,0,0,6,6,
Tulsa,Lieutenant Governor,Cathy Cummings,DEM,720145,0,0,125,125,
Tulsa,Lieutenant Governor,Todd Lamb,REP,720145,0,0,520,520,
Tulsa,Superintendent of Public Instruction,John Cox,DEM,720145,0,0,156,156,
Tulsa,Superintendent of Public Instruction,Joy Hofmeister,REP,720145,0,0,489,489,
Tulsa,Commissioner of Labor,Mike Workman,DEM,720145,0,0,144,144,
Tulsa,Commissioner of Labor,Mark Costello,REP,720145,0,0,486,486,
Tulsa,U.S. Senate,Matt Silverstein,DEM,720145,0,0,113,113,
Tulsa,U.S. Senate,Jim Inhofe,REP,720145,0,0,517,517,
Tulsa,U.S. Senate,Aaron Delozier,IND,720145,0,0,1,1,
Tulsa,U.S. Senate,Ray Woods,IND,720145,0,0,9,9,
Tulsa,U.S. Senate,Joan Farr,IND,720145,0,0,7,7,
Tulsa,U.S. Senate,Connie Johnson,DEM,720145,0,0,118,118,
Tulsa,U.S. Senate,James Lankford,REP,720145,0,0,518,518,
Tulsa,U.S. Senate,Mark Beard,IND,720145,0,0,13,13,
Tulsa,Governor,Joe Dorman,DEM,720146,0,0,216,216,
Tulsa,Governor,Mary Fallin,REP,720146,0,0,382,382,
Tulsa,Governor,Kimberly Willis,IND,720146,0,0,9,9,
Tulsa,Governor,Richard Prawdzienski,IND,720146,0,0,3,3,
Tulsa,Lieutenant Governor,Cathy Cummings,DEM,720146,0,0,165,165,
Tulsa,Lieutenant Governor,Todd Lamb,REP,720146,0,0,441,441,
Tulsa,Superintendent of Public Instruction,John Cox,DEM,720146,0,0,200,200,
Tulsa,Superintendent of Public Instruction,Joy Hofmeister,REP,720146,0,0,399,399,
Tulsa,Commissioner of Labor,Mike Workman,DEM,720146,0,0,179,179,
Tulsa,Commissioner of Labor,Mark Costello,REP,720146,0,0,420,420,
Tulsa,U.S. Senate,Matt Silverstein,DEM,720146,0,0,162,162,
Tulsa,U.S. Senate,Jim Inhofe,REP,720146,0,0,439,439,
Tulsa,U.S. Senate,Aaron Delozier,IND,720146,0,0,2,2,
Tulsa,U.S. Senate,Ray Woods,IND,720146,0,0,0,0,
Tulsa,U.S. Senate,Joan Farr,IND,720146,0,0,8,8,
Tulsa,U.S. Senate,Connie Johnson,DEM,720146,0,0,147,147,
Tulsa,U.S. Senate,James Lankford,REP,720146,0,0,443,443,
Tulsa,U.S. Senate,Mark Beard,IND,720146,0,0,19,19,
Tulsa,Governor,Joe Dorman,DEM,720147,0,0,106,106,
Tulsa,Governor,Mary Fallin,REP,720147,0,0,52,52,
Tulsa,Governor,Kimberly Willis,IND,720147,0,0,1,1,
Tulsa,Governor,Richard Prawdzienski,IND,720147,0,0,0,0,
Tulsa,Lieutenant Governor,Cathy Cummings,DEM,720147,0,0,98,98,
Tulsa,Lieutenant Governor,Todd Lamb,REP,720147,0,0,60,60,
Tulsa,Superintendent of Public Instruction,John Cox,DEM,720147,0,0,100,100,
Tulsa,Superintendent of Public Instruction,Joy Hofmeister,REP,720147,0,0,57,57,
Tulsa,Commissioner of Labor,Mike Workman,DEM,720147,0,0,99,99,
Tulsa,Commissioner of Labor,Mark Costello,REP,720147,0,0,57,57,
Tulsa,U.S. Senate,Matt Silverstein,DEM,720147,0,0,89,89,
Tulsa,U.S. Senate,Jim Inhofe,REP,720147,0,0,59,59,
Tulsa,U.S. Senate,Aaron Delozier,IND,720147,0,0,1,1,
Tulsa,U.S. Senate,Ray Woods,IND,720147,0,0,3,3,
Tulsa,U.S. Senate,Joan Farr,IND,720147,0,0,6,6,
Tulsa,U.S. Senate,Connie Johnson,DEM,720147,0,0,97,97,
Tulsa,U.S. Senate,James Lankford,REP,720147,0,0,57,57,
Tulsa,U.S. Senate,Mark Beard,IND,720147,0,0,4,4,
Tulsa,Governor,Joe Dorman,DEM,720148,0,0,134,134,
Tulsa,Governor,Mary Fallin,REP,720148,0,0,170,170,
Tulsa,Governor,Kimberly Willis,IND,720148,0,0,11,11,
Tulsa,Governor,Richard Prawdzienski,IND,720148,0,0,1,1,
Tulsa,Lieutenant Governor,Cathy Cummings,DEM,720148,0,0,111,111,
Tulsa,Lieutenant Governor,Todd Lamb,REP,720148,0,0,206,206,
Tulsa,Superintendent of Public Instruction,John Cox,DEM,720148,0,0,134,134,
Tulsa,Superintendent of Public Instruction,Joy Hofmeister,REP,720148,0,0,181,181,
Tulsa,Commissioner of Labor,Mike Workman,DEM,720148,0,0,126,126,
Tulsa,Commissioner of Labor,Mark Costello,REP,720148,0,0,183,183,
Tulsa,U.S. Senate,Matt Silverstein,DEM,720148,0,0,110,110,
Tulsa,U.S. Senate,Jim Inhofe,REP,720148,0,0,197,197,
Tulsa,U.S. Senate,Aaron Delozier,IND,720148,0,0,4,4,
Tulsa,U.S. Senate,Ray Woods,IND,720148,0,0,1,1,
Tulsa,U.S. Senate,Joan Farr,IND,720148,0,0,5,5,
Tulsa,U.S. Senate,Connie Johnson,DEM,720148,0,0,112,112,
Tulsa,U.S. Senate,James Lankford,REP,720148,0,0,192,192,
Tulsa,U.S. Senate,Mark Beard,IND,720148,0,0,10,10,
Tulsa,Governor,Joe Dorman,DEM,720149,0,0,94,94,
Tulsa,Governor,Mary Fallin,REP,720149,0,0,144,144,
Tulsa,Governor,Kimberly Willis,IND,720149,0,0,11,11,
Tulsa,Governor,Richard Prawdzienski,IND,720149,0,0,8,8,
Tulsa,Lieutenant Governor,Cathy Cummings,DEM,720149,0,0,84,84,
Tulsa,Lieutenant Governor,Todd Lamb,REP,720149,0,0,174,174,
Tulsa,Superintendent of Public Instruction,John Cox,DEM,720149,0,0,102,102,
Tulsa,Superintendent of Public Instruction,Joy Hofmeister,REP,720149,0,0,153,153,
Tulsa,Commissioner of Labor,Mike Workman,DEM,720149,0,0,109,109,
Tulsa,Commissioner of Labor,Mark Costello,REP,720149,0,0,146,146,
Tulsa,U.S. Senate,Matt Silverstein,DEM,720149,0,0,75,75,
Tulsa,U.S. Senate,Jim Inhofe,REP,720149,0,0,169,169,
Tulsa,U.S. Senate,Aaron Delozier,IND,720149,0,0,3,3,
Tulsa,U.S. Senate,Ray Woods,IND,720149,0,0,6,6,
Tulsa,U.S. Senate,Joan Farr,IND,720149,0,0,4,4,
Tulsa,U.S. Senate,Connie Johnson,DEM,720149,0,0,76,76,
Tulsa,U.S. Senate,James Lankford,REP,720149,0,0,168,168,
Tulsa,U.S. Senate,Mark Beard,IND,720149,0,0,11,11,
Tulsa,Governor,Joe Dorman,DEM,720150,0,0,304,304,
Tulsa,Governor,Mary Fallin,REP,720150,0,0,723,723,
Tulsa,Governor,Kimberly Willis,IND,720150,0,0,12,12,
Tulsa,Governor,Richard Prawdzienski,IND,720150,0,0,7,7,
Tulsa,Lieutenant Governor,Cathy Cummings,DEM,720150,0,0,194,194,
Tulsa,Lieutenant Governor,Todd Lamb,REP,720150,0,0,844,844,
Tulsa,Superintendent of Public Instruction,John Cox,DEM,720150,0,0,264,264,
Tulsa,Superintendent of Public Instruction,Joy Hofmeister,REP,720150,0,0,776,776,
Tulsa,Commissioner of Labor,Mike Workman,DEM,720150,0,0,215,215,
Tulsa,Commissioner of Labor,Mark Costello,REP,720150,0,0,809,809,
Tulsa,U.S. Senate,Matt Silverstein,DEM,720150,0,0,202,202,
Tulsa,U.S. Senate,Jim Inhofe,REP,720150,0,0,820,820,
Tulsa,U.S. Senate,Aaron Delozier,IND,720150,0,0,7,7,
Tulsa,U.S. Senate,Ray Woods,IND,720150,0,0,4,4,
Tulsa,U.S. Senate,Joan Farr,IND,720150,0,0,6,6,
Tulsa,U.S. Senate,Connie Johnson,DEM,720150,0,0,188,188,
Tulsa,U.S. Senate,James Lankford,REP,720150,0,0,835,835,
Tulsa,U.S. Senate,Mark Beard,IND,720150,0,0,14,14,
Tulsa,Governor,Joe Dorman,DEM,720151,0,0,71,71,
Tulsa,Governor,Mary Fallin,REP,720151,0,0,142,142,
Tulsa,Governor,Kimberly Willis,IND,720151,0,0,3,3,
Tulsa,Governor,Richard Prawdzienski,IND,720151,0,0,1,1,
Tulsa,Lieutenant Governor,Cathy Cummings,DEM,720151,0,0,51,51,
Tulsa,Lieutenant Governor,Todd Lamb,REP,720151,0,0,161,161,
Tulsa,Superintendent of Public Instruction,John Cox,DEM,720151,0,0,64,64,
Tulsa,Superintendent of Public Instruction,Joy Hofmeister,REP,720151,0,0,151,151,
Tulsa,Commissioner of Labor,Mike Workman,DEM,720151,0,0,56,56,
Tulsa,Commissioner of Labor,Mark Costello,REP,720151,0,0,149,149,
Tulsa,U.S. Senate,Matt Silverstein,DEM,720151,0,0,54,54,
Tulsa,U.S. Senate,Jim Inhofe,REP,720151,0,0,156,156,
Tulsa,U.S. Senate,Aaron Delozier,IND,720151,0,0,3,3,
Tulsa,U.S. Senate,Ray Woods,IND,720151,0,0,1,1,
Tulsa,U.S. Senate,Joan Farr,IND,720151,0,0,2,2,
Tulsa,U.S. Senate,Connie Johnson,DEM,720151,0,0,55,55,
Tulsa,U.S. Senate,James Lankford,REP,720151,0,0,155,155,
Tulsa,U.S. Senate,Mark Beard,IND,720151,0,0,6,6,
Tulsa,Governor,Joe Dorman,DEM,720152,0,0,147,147,
Tulsa,Governor,Mary Fallin,REP,720152,0,0,274,274,
Tulsa,Governor,Kimberly Willis,IND,720152,0,0,6,6,
Tulsa,Governor,Richard Prawdzienski,IND,720152,0,0,7,7,
Tulsa,Lieutenant Governor,Cathy Cummings,DEM,720152,0,0,95,95,
Tulsa,Lieutenant Governor,Todd Lamb,REP,720152,0,0,335,335,
Tulsa,Superintendent of Public Instruction,John Cox,DEM,720152,0,0,140,140,
Tulsa,Superintendent of Public Instruction,Joy Hofmeister,REP,720152,0,0,291,291,
Tulsa,Commissioner of Labor,Mike Workman,DEM,720152,0,0,103,103,
Tulsa,Commissioner of Labor,Mark Costello,REP,720152,0,0,319,319,
Tulsa,U.S. Senate,Matt Silverstein,DEM,720152,0,0,92,92,
Tulsa,U.S. Senate,Jim Inhofe,REP,720152,0,0,322,322,
Tulsa,U.S. Senate,Aaron Delozier,IND,720152,0,0,4,4,
Tulsa,U.S. Senate,Ray Woods,IND,720152,0,0,7,7,
Tulsa,U.S. Senate,Joan Farr,IND,720152,0,0,2,2,
Tulsa,U.S. Senate,Connie Johnson,DEM,720152,0,0,90,90,
Tulsa,U.S. Senate,James Lankford,REP,720152,0,0,333,333,
Tulsa,U.S. Senate,Mark Beard,IND,720152,0,0,9,9,
Tulsa,Governor,Joe Dorman,DEM,720153,0,0,187,187,
Tulsa,Governor,Mary Fallin,REP,720153,0,0,394,394,
Tulsa,Governor,Kimberly Willis,IND,720153,0,0,9,9,
Tulsa,Governor,Richard Prawdzienski,IND,720153,0,0,5,5,
Tulsa,Lieutenant Governor,Cathy Cummings,DEM,720153,0,0,140,140,
Tulsa,Lieutenant Governor,Todd Lamb,REP,720153,0,0,451,451,
Tulsa,Superintendent of Public Instruction,John Cox,DEM,720153,0,0,171,171,
Tulsa,Superintendent of Public Instruction,Joy Hofmeister,REP,720153,0,0,421,421,
Tulsa,Commissioner of Labor,Mike Workman,DEM,720153,0,0,141,141,
Tulsa,Commissioner of Labor,Mark Costello,REP,720153,0,0,439,439,
Tulsa,U.S. Senate,Matt Silverstein,DEM,720153,0,0,150,150,
Tulsa,U.S. Senate,Jim Inhofe,REP,720153,0,0,430,430,
Tulsa,U.S. Senate,Aaron Delozier,IND,720153,0,0,4,4,
Tulsa,U.S. Senate,Ray Woods,IND,720153,0,0,2,2,
Tulsa,U.S. Senate,Joan Farr,IND,720153,0,0,7,7,
Tulsa,U.S. Senate,Connie Johnson,DEM,720153,0,0,132,132,
Tulsa,U.S. Senate,James Lankford,REP,720153,0,0,442,442,
Tulsa,U.S. Senate,Mark Beard,IND,720153,0,0,15,15,
Tulsa,Governor,Joe Dorman,DEM,720154,0,0,256,256,
Tulsa,Governor,Mary Fallin,REP,720154,0,0,511,511,
Tulsa,Governor,Kimberly Willis,IND,720154,0,0,15,15,
Tulsa,Governor,Richard Prawdzienski,IND,720154,0,0,7,7,
Tulsa,Lieutenant Governor,Cathy Cummings,DEM,720154,0,0,196,196,
Tulsa,Lieutenant Governor,Todd Lamb,REP,720154,0,0,588,588,
Tulsa,Superintendent of Public Instruction,John Cox,DEM,720154,0,0,227,227,
Tulsa,Superintendent of Public Instruction,Joy Hofmeister,REP,720154,0,0,557,557,
Tulsa,Commissioner of Labor,Mike Workman,DEM,720154,0,0,206,206,
Tulsa,Commissioner of Labor,Mark Costello,REP,720154,0,0,558,558,
Tulsa,U.S. Senate,Matt Silverstein,DEM,720154,0,0,193,193,
Tulsa,U.S. Senate,Jim Inhofe,REP,720154,0,0,571,571,
Tulsa,U.S. Senate,Aaron Delozier,IND,720154,0,0,5,5,
Tulsa,U.S. Senate,Ray Woods,IND,720154,0,0,3,3,
Tulsa,U.S. Senate,Joan Farr,IND,720154,0,0,10,10,
Tulsa,U.S. Senate,Connie Johnson,DEM,720154,0,0,167,167,
Tulsa,U.S. Senate,James Lankford,REP,720154,0,0,590,590,
Tulsa,U.S. Senate,Mark Beard,IND,720154,0,0,22,22,
Tulsa,Governor,Joe Dorman,DEM,720155,0,0,286,286,
Tulsa,Governor,Mary Fallin,REP,720155,0,0,898,898,
Tulsa,Governor,Kimberly Willis,IND,720155,0,0,10,10,
Tulsa,Governor,Richard Prawdzienski,IND,720155,0,0,2,2,
Tulsa,Lieutenant Governor,Cathy Cummings,DEM,720155,0,0,195,195,
Tulsa,Lieutenant Governor,Todd Lamb,REP,720155,0,0,1002,1002,
Tulsa,Superintendent of Public Instruction,John Cox,DEM,720155,0,0,206,206,
Tulsa,Superintendent of Public Instruction,Joy Hofmeister,REP,720155,0,0,993,993,
Tulsa,Commissioner of Labor,Mike Workman,DEM,720155,0,0,205,205,
Tulsa,Commissioner of Labor,Mark Costello,REP,720155,0,0,972,972,
Tulsa,U.S. Senate,Matt Silverstein,DEM,720155,0,0,214,214,
Tulsa,U.S. Senate,Jim Inhofe,REP,720155,0,0,974,974,
Tulsa,U.S. Senate,Aaron Delozier,IND,720155,0,0,6,6,
Tulsa,U.S. Senate,Ray Woods,IND,720155,0,0,1,1,
Tulsa,U.S. Senate,Joan Farr,IND,720155,0,0,5,5,
Tulsa,U.S. Senate,Connie Johnson,DEM,720155,0,0,176,176,
Tulsa,U.S. Senate,James Lankford,REP,720155,0,0,1003,1003,
Tulsa,U.S. Senate,Mark Beard,IND,720155,0,0,16,16,
Tulsa,Governor,Joe Dorman,DEM,720156,0,0,44,44,
Tulsa,Governor,Mary Fallin,REP,720156,0,0,63,63,
Tulsa,Governor,Kimberly Willis,IND,720156,0,0,3,3,
Tulsa,Governor,Richard Prawdzienski,IND,720156,0,0,0,0,
Tulsa,Lieutenant Governor,Cathy Cummings,DEM,720156,0,0,35,35,
Tulsa,Lieutenant Governor,Todd Lamb,REP,720156,0,0,73,73,
Tulsa,Superintendent of Public Instruction,John Cox,DEM,720156,0,0,37,37,
Tulsa,Superintendent of Public Instruction,Joy Hofmeister,REP,720156,0,0,72,72,
Tulsa,Commissioner of Labor,Mike Workman,DEM,720156,0,0,38,38,
Tulsa,Commissioner of Labor,Mark Costello,REP,720156,0,0,70,70,
Tulsa,U.S. Senate,Matt Silverstein,DEM,720156,0,0,43,43,
Tulsa,U.S. Senate,Jim Inhofe,REP,720156,0,0,63,63,
Tulsa,U.S. Senate,Aaron Delozier,IND,720156,0,0,1,1,
Tulsa,U.S. Senate,Ray Woods,IND,720156,0,0,2,2,
Tulsa,U.S. Senate,Joan Farr,IND,720156,0,0,1,1,
Tulsa,U.S. Senate,Connie Johnson,DEM,720156,0,0,35,35,
Tulsa,U.S. Senate,James Lankford,REP,720156,0,0,69,69,
Tulsa,U.S. Senate,Mark Beard,IND,720156,0,0,5,5,
Tulsa,Governor,Joe Dorman,DEM,720157,0,0,223,223,
Tulsa,Governor,Mary Fallin,REP,720157,0,0,809,809,
Tulsa,Governor,Kimberly Willis,IND,720157,0,0,17,17,
Tulsa,Governor,Richard Prawdzienski,IND,720157,0,0,10,10,
Tulsa,Lieutenant Governor,Cathy Cummings,DEM,720157,0,0,154,154,
Tulsa,Lieutenant Governor,Todd Lamb,REP,720157,0,0,900,900,
Tulsa,Superintendent of Public Instruction,John Cox,DEM,720157,0,0,164,164,
Tulsa,Superintendent of Public Instruction,Joy Hofmeister,REP,720157,0,0,881,881,
Tulsa,Commissioner of Labor,Mike Workman,DEM,720157,0,0,155,155,
Tulsa,Commissioner of Labor,Mark Costello,REP,720157,0,0,872,872,
Tulsa,U.S. Senate,Matt Silverstein,DEM,720157,0,0,164,164,
Tulsa,U.S. Senate,Jim Inhofe,REP,720157,0,0,863,863,
Tulsa,U.S. Senate,Aaron Delozier,IND,720157,0,0,8,8,
Tulsa,U.S. Senate,Ray Woods,IND,720157,0,0,8,8,
Tulsa,U.S. Senate,Joan Farr,IND,720157,0,0,12,12,
Tulsa,U.S. Senate,Connie Johnson,DEM,720157,0,0,134,134,
Tulsa,U.S. Senate,James Lankford,REP,720157,0,0,899,899,
Tulsa,U.S. Senate,Mark Beard,IND,720157,0,0,14,14,
Tulsa,Governor,Joe Dorman,DEM,720158,0,0,166,166,
Tulsa,Governor,Mary Fallin,REP,720158,0,0,373,373,
Tulsa,Governor,Kimberly Willis,IND,720158,0,0,11,11,
Tulsa,Governor,Richard Prawdzienski,IND,720158,0,0,6,6,
Tulsa,Lieutenant Governor,Cathy Cummings,DEM,720158,0,0,128,128,
Tulsa,Lieutenant Governor,Todd Lamb,REP,720158,0,0,427,427,
Tulsa,Superintendent of Public Instruction,John Cox,DEM,720158,0,0,129,129,
Tulsa,Superintendent of Public Instruction,Joy Hofmeister,REP,720158,0,0,428,428,
Tulsa,Commissioner of Labor,Mike Workman,DEM,720158,0,0,119,119,
Tulsa,Commissioner of Labor,Mark Costello,REP,720158,0,0,425,425,
Tulsa,U.S. Senate,Matt Silverstein,DEM,720158,0,0,105,105,
Tulsa,U.S. Senate,Jim Inhofe,REP,720158,0,0,435,435,
Tulsa,U.S. Senate,Aaron Delozier,IND,720158,0,0,10,10,
Tulsa,U.S. Senate,Ray Woods,IND,720158,0,0,5,5,
Tulsa,U.S. Senate,Joan Farr,IND,720158,0,0,6,6,
Tulsa,U.S. Senate,Connie Johnson,DEM,720158,0,0,113,113,
Tulsa,U.S. Senate,James Lankford,REP,720158,0,0,427,427,
Tulsa,U.S. Senate,Mark Beard,IND,720158,0,0,19,19,
Tulsa,Governor,Joe Dorman,DEM,720159,0,0,204,204,
Tulsa,Governor,Mary Fallin,REP,720159,0,0,437,437,
Tulsa,Governor,Kimberly Willis,IND,720159,0,0,7,7,
Tulsa,Governor,Richard Prawdzienski,IND,720159,0,0,3,3,
Tulsa,Lieutenant Governor,Cathy Cummings,DEM,720159,0,0,166,166,
Tulsa,Lieutenant Governor,Todd Lamb,REP,720159,0,0,488,488,
Tulsa,Superintendent of Public Instruction,John Cox,DEM,720159,0,0,179,179,
Tulsa,Superintendent of Public Instruction,Joy Hofmeister,REP,720159,0,0,476,476,
Tulsa,Commissioner of Labor,Mike Workman,DEM,720159,0,0,158,158,
Tulsa,Commissioner of Labor,Mark Costello,REP,720159,0,0,480,480,
Tulsa,U.S. Senate,Matt Silverstein,DEM,720159,0,0,173,173,
Tulsa,U.S. Senate,Jim Inhofe,REP,720159,0,0,468,468,
Tulsa,U.S. Senate,Aaron Delozier,IND,720159,0,0,7,7,
Tulsa,U.S. Senate,Ray Woods,IND,720159,0,0,1,1,
Tulsa,U.S. Senate,Joan Farr,IND,720159,0,0,6,6,
Tulsa,U.S. Senate,Connie Johnson,DEM,720159,0,0,149,149,
Tulsa,U.S. Senate,James Lankford,REP,720159,0,0,491,491,
Tulsa,U.S. Senate,Mark Beard,IND,720159,0,0,12,12,
Tulsa,Governor,Joe Dorman,DEM,720160,0,0,384,384,
Tulsa,Governor,Mary Fallin,REP,720160,0,0,405,405,
Tulsa,Governor,Kimberly Willis,IND,720160,0,0,12,12,
Tulsa,Governor,Richard Prawdzienski,IND,720160,0,0,8,8,
Tulsa,Lieutenant Governor,Cathy Cummings,DEM,720160,0,0,297,297,
Tulsa,Lieutenant Governor,Todd Lamb,REP,720160,0,0,509,509,
Tulsa,Superintendent of Public Instruction,John Cox,DEM,720160,0,0,308,308,
Tulsa,Superintendent of Public Instruction,Joy Hofmeister,REP,720160,0,0,495,495,
Tulsa,Commissioner of Labor,Mike Workman,DEM,720160,0,0,304,304,
Tulsa,Commissioner of Labor,Mark Costello,REP,720160,0,0,483,483,
Tulsa,U.S. Senate,Matt Silverstein,DEM,720160,0,0,305,305,
Tulsa,U.S. Senate,Jim Inhofe,REP,720160,0,0,472,472,
Tulsa,U.S. Senate,Aaron Delozier,IND,720160,0,0,13,13,
Tulsa,U.S. Senate,Ray Woods,IND,720160,0,0,5,5,
Tulsa,U.S. Senate,Joan Farr,IND,720160,0,0,11,11,
Tulsa,U.S. Senate,Connie Johnson,DEM,720160,0,0,286,286,
Tulsa,U.S. Senate,James Lankford,REP,720160,0,0,490,490,
Tulsa,U.S. Senate,Mark Beard,IND,720160,0,0,28,28,
Tulsa,Governor,Joe Dorman,DEM,720161,0,0,148,148,
Tulsa,Governor,Mary Fallin,REP,720161,0,0,95,95,
Tulsa,Governor,Kimberly Willis,IND,720161,0,0,3,3,
Tulsa,Governor,Richard Prawdzienski,IND,720161,0,0,2,2,
Tulsa,Lieutenant Governor,Cathy Cummings,DEM,720161,0,0,145,145,
Tulsa,Lieutenant Governor,Todd Lamb,REP,720161,0,0,103,103,
Tulsa,Superintendent of Public Instruction,John Cox,DEM,720161,0,0,147,147,
Tulsa,Superintendent of Public Instruction,Joy Hofmeister,REP,720161,0,0,100,100,
Tulsa,Commissioner of Labor,Mike Workman,DEM,720161,0,0,150,150,
Tulsa,Commissioner of Labor,Mark Costello,REP,720161,0,0,97,97,
Tulsa,U.S. Senate,Matt Silverstein,DEM,720161,0,0,135,135,
Tulsa,U.S. Senate,Jim Inhofe,REP,720161,0,0,104,104,
Tulsa,U.S. Senate,Aaron Delozier,IND,720161,0,0,2,2,
Tulsa,U.S. Senate,Ray Woods,IND,720161,0,0,1,1,
Tulsa,U.S. Senate,Joan Farr,IND,720161,0,0,6,6,
Tulsa,U.S. Senate,Connie Johnson,DEM,720161,0,0,141,141,
Tulsa,U.S. Senate,James Lankford,REP,720161,0,0,100,100,
Tulsa,U.S. Senate,Mark Beard,IND,720161,0,0,6,6,
Tulsa,Governor,Joe Dorman,DEM,720162,0,0,11,11,
Tulsa,Governor,Mary Fallin,REP,720162,0,0,35,35,
Tulsa,Governor,Kimberly Willis,IND,720162,0,0,0,0,
Tulsa,Governor,Richard Prawdzienski,IND,720162,0,0,0,0,
Tulsa,Lieutenant Governor,Cathy Cummings,DEM,720162,0,0,9,9,
Tulsa,Lieutenant Governor,Todd Lamb,REP,720162,0,0,35,35,
Tulsa,Superintendent of Public Instruction,John Cox,DEM,720162,0,0,9,9,
Tulsa,Superintendent of Public Instruction,Joy Hofmeister,REP,720162,0,0,37,37,
Tulsa,Commissioner of Labor,Mike Workman,DEM,720162,0,0,10,10,
Tulsa,Commissioner of Labor,Mark Costello,REP,720162,0,0,34,34,
Tulsa,U.S. Senate,Matt Silverstein,DEM,720162,0,0,8,8,
Tulsa,U.S. Senate,Jim Inhofe,REP,720162,0,0,36,36,
Tulsa,U.S. Senate,Aaron Delozier,IND,720162,0,0,0,0,
Tulsa,U.S. Senate,Ray Woods,IND,720162,0,0,0,0,
Tulsa,U.S. Senate,Joan Farr,IND,720162,0,0,0,0,
Tulsa,U.S. Senate,Connie Johnson,DEM,720162,0,0,6,6,
Tulsa,U.S. Senate,James Lankford,REP,720162,0,0,39,39,
Tulsa,U.S. Senate,Mark Beard,IND,720162,0,0,0,0,
Tulsa,Governor,Joe Dorman,DEM,720163,0,0,265,265,
Tulsa,Governor,Mary Fallin,REP,720163,0,0,373,373,
Tulsa,Governor,Kimberly Willis,IND,720163,0,0,12,12,
Tulsa,Governor,Richard Prawdzienski,IND,720163,0,0,6,6,
Tulsa,Lieutenant Governor,Cathy Cummings,DEM,720163,0,0,213,213,
Tulsa,Lieutenant Governor,Todd Lamb,REP,720163,0,0,441,441,
Tulsa,Superintendent of Public Instruction,John Cox,DEM,720163,0,0,216,216,
Tulsa,Superintendent of Public Instruction,Joy Hofmeister,REP,720163,0,0,438,438,
Tulsa,Commissioner of Labor,Mike Workman,DEM,720163,0,0,221,221,
Tulsa,Commissioner of Labor,Mark Costello,REP,720163,0,0,411,411,
Tulsa,U.S. Senate,Matt Silverstein,DEM,720163,0,0,219,219,
Tulsa,U.S. Senate,Jim Inhofe,REP,720163,0,0,415,415,
Tulsa,U.S. Senate,Aaron Delozier,IND,720163,0,0,6,6,
Tulsa,U.S. Senate,Ray Woods,IND,720163,0,0,2,2,
Tulsa,U.S. Senate,Joan Farr,IND,720163,0,0,8,8,
Tulsa,U.S. Senate,Connie Johnson,DEM,720163,0,0,208,208,
Tulsa,U.S. Senate,James Lankford,REP,720163,0,0,434,434,
Tulsa,U.S. Senate,Mark Beard,IND,720163,0,0,13,13,
Tulsa,Governor,Joe Dorman,DEM,720164,0,0,117,117,
Tulsa,Governor,Mary Fallin,REP,720164,0,0,174,174,
Tulsa,Governor,Kimberly Willis,IND,720164,0,0,5,5,
Tulsa,Governor,Richard Prawdzienski,IND,720164,0,0,3,3,
Tulsa,Lieutenant Governor,Cathy Cummings,DEM,720164,0,0,83,83,
Tulsa,Lieutenant Governor,Todd Lamb,REP,720164,0,0,212,212,
Tulsa,Superintendent of Public Instruction,John Cox,DEM,720164,0,0,92,92,
Tulsa,Superintendent of Public Instruction,Joy Hofmeister,REP,720164,0,0,203,203,
Tulsa,Commissioner of Labor,Mike Workman,DEM,720164,0,0,87,87,
Tulsa,Commissioner of Labor,Mark Costello,REP,720164,0,0,195,195,
Tulsa,U.S. Senate,Matt Silverstein,DEM,720164,0,0,93,93,
Tulsa,U.S. Senate,Jim Inhofe,REP,720164,0,0,192,192,
Tulsa,U.S. Senate,Aaron Delozier,IND,720164,0,0,1,1,
Tulsa,U.S. Senate,Ray Woods,IND,720164,0,0,4,4,
Tulsa,U.S. Senate,Joan Farr,IND,720164,0,0,4,4,
Tulsa,U.S. Senate,Connie Johnson,DEM,720164,0,0,80,80,
Tulsa,U.S. Senate,James Lankford,REP,720164,0,0,207,207,
Tulsa,U.S. Senate,Mark Beard,IND,720164,0,0,9,9,
Tulsa,Governor,Joe Dorman,DEM,720165,0,0,87,87,
Tulsa,Governor,Mary Fallin,REP,720165,0,0,219,219,
Tulsa,Governor,Kimberly Willis,IND,720165,0,0,4,4,
Tulsa,Governor,Richard Prawdzienski,IND,720165,0,0,4,4,
Tulsa,Lieutenant Governor,Cathy Cummings,DEM,720165,0,0,74,74,
Tulsa,Lieutenant Governor,Todd Lamb,REP,720165,0,0,240,240,
Tulsa,Superintendent of Public Instruction,John Cox,DEM,720165,0,0,84,84,
Tulsa,Superintendent of Public Instruction,Joy Hofmeister,REP,720165,0,0,229,229,
Tulsa,Commissioner of Labor,Mike Workman,DEM,720165,0,0,73,73,
Tulsa,Commissioner of Labor,Mark Costello,REP,720165,0,0,234,234,
Tulsa,U.S. Senate,Matt Silverstein,DEM,720165,0,0,77,77,
Tulsa,U.S. Senate,Jim Inhofe,REP,720165,0,0,230,230,
Tulsa,U.S. Senate,Aaron Delozier,IND,720165,0,0,0,0,
Tulsa,U.S. Senate,Ray Woods,IND,720165,0,0,0,0,
Tulsa,U.S. Senate,Joan Farr,IND,720165,0,0,6,6,
Tulsa,U.S. Senate,Connie Johnson,DEM,720165,0,0,71,71,
Tulsa,U.S. Senate,James Lankford,REP,720165,0,0,233,233,
Tulsa,U.S. Senate,Mark Beard,IND,720165,0,0,7,7,
Tulsa,Governor,Joe Dorman,DEM,720166,0,0,268,268,
Tulsa,Governor,Mary Fallin,REP,720166,0,0,571,571,
Tulsa,Governor,Kimberly Willis,IND,720166,0,0,18,18,
Tulsa,Governor,Richard Prawdzienski,IND,720166,0,0,4,4,
Tulsa,Lieutenant Governor,Cathy Cummings,DEM,720166,0,0,212,212,
Tulsa,Lieutenant Governor,Todd Lamb,REP,720166,0,0,647,647,
Tulsa,Superintendent of Public Instruction,John Cox,DEM,720166,0,0,226,226,
Tulsa,Superintendent of Public Instruction,Joy Hofmeister,REP,720166,0,0,631,631,
Tulsa,Commissioner of Labor,Mike Workman,DEM,720166,0,0,207,207,
Tulsa,Commissioner of Labor,Mark Costello,REP,720166,0,0,625,625,
Tulsa,U.S. Senate,Matt Silverstein,DEM,720166,0,0,206,206,
Tulsa,U.S. Senate,Jim Inhofe,REP,720166,0,0,625,625,
Tulsa,U.S. Senate,Aaron Delozier,IND,720166,0,0,12,12,
Tulsa,U.S. Senate,Ray Woods,IND,720166,0,0,4,4,
Tulsa,U.S. Senate,Joan Farr,IND,720166,0,0,9,9,
Tulsa,U.S. Senate,Connie Johnson,DEM,720166,0,0,198,198,
Tulsa,U.S. Senate,James Lankford,REP,720166,0,0,640,640,
Tulsa,U.S. Senate,Mark Beard,IND,720166,0,0,21,21,
Tulsa,Governor,Joe Dorman,DEM,720167,0,0,146,146,
Tulsa,Governor,Mary Fallin,REP,720167,0,0,534,534,
Tulsa,Governor,Kimberly Willis,IND,720167,0,0,10,10,
Tulsa,Governor,Richard Prawdzienski,IND,720167,0,0,9,9,
Tulsa,Lieutenant Governor,Cathy Cummings,DEM,720167,0,0,98,98,
Tulsa,Lieutenant Governor,Todd Lamb,REP,720167,0,0,600,600,
Tulsa,Superintendent of Public Instruction,John Cox,DEM,720167,0,0,139,139,
Tulsa,Superintendent of Public Instruction,Joy Hofmeister,REP,720167,0,0,557,557,
Tulsa,Commissioner of Labor,Mike Workman,DEM,720167,0,0,107,107,
Tulsa,Commissioner of Labor,Mark Costello,REP,720167,0,0,569,569,
Tulsa,U.S. Senate,Matt Silverstein,DEM,720167,0,0,111,111,
Tulsa,U.S. Senate,Jim Inhofe,REP,720167,0,0,567,567,
Tulsa,U.S. Senate,Aaron Delozier,IND,720167,0,0,6,6,
Tulsa,U.S. Senate,Ray Woods,IND,720167,0,0,4,4,
Tulsa,U.S. Senate,Joan Farr,IND,720167,0,0,6,6,
Tulsa,U.S. Senate,Connie Johnson,DEM,720167,0,0,99,99,
Tulsa,U.S. Senate,James Lankford,REP,720167,0,0,585,585,
Tulsa,U.S. Senate,Mark Beard,IND,720167,0,0,12,12,
Tulsa,Governor,Joe Dorman,DEM,720168,0,0,227,227,
Tulsa,Governor,Mary Fallin,REP,720168,0,0,395,395,
Tulsa,Governor,Kimberly Willis,IND,720168,0,0,5,5,
Tulsa,Governor,Richard Prawdzienski,IND,720168,0,0,2,2,
Tulsa,Lieutenant Governor,Cathy Cummings,DEM,720168,0,0,188,188,
Tulsa,Lieutenant Governor,Todd Lamb,REP,720168,0,0,438,438,
Tulsa,Superintendent of Public Instruction,John Cox,DEM,720168,0,0,201,201,
Tulsa,Superintendent of Public Instruction,Joy Hofmeister,REP,720168,0,0,427,427,
Tulsa,Commissioner of Labor,Mike Workman,DEM,720168,0,0,199,199,
Tulsa,Commissioner of Labor,Mark Costello,REP,720168,0,0,413,413,
Tulsa,U.S. Senate,Matt Silverstein,DEM,720168,0,0,184,184,
Tulsa,U.S. Senate,Jim Inhofe,REP,720168,0,0,432,432,
Tulsa,U.S. Senate,Aaron Delozier,IND,720168,0,0,1,1,
Tulsa,U.S. Senate,Ray Woods,IND,720168,0,0,2,2,
Tulsa,U.S. Senate,Joan Farr,IND,720168,0,0,7,7,
Tulsa,U.S. Senate,Connie Johnson,DEM,720168,0,0,165,165,
Tulsa,U.S. Senate,James Lankford,REP,720168,0,0,447,447,
Tulsa,U.S. Senate,Mark Beard,IND,720168,0,0,11,11,
Tulsa,Governor,Joe Dorman,DEM,720169,0,0,187,187,
Tulsa,Governor,Mary Fallin,REP,720169,0,0,280,280,
Tulsa,Governor,Kimberly Willis,IND,720169,0,0,6,6,
Tulsa,Governor,Richard Prawdzienski,IND,720169,0,0,5,5,
Tulsa,Lieutenant Governor,Cathy Cummings,DEM,720169,0,0,147,147,
Tulsa,Lieutenant Governor,Todd Lamb,REP,720169,0,0,325,325,
Tulsa,Superintendent of Public Instruction,John Cox,DEM,720169,0,0,178,178,
Tulsa,Superintendent of Public Instruction,Joy Hofmeister,REP,720169,0,0,296,296,
Tulsa,Commissioner of Labor,Mike Workman,DEM,720169,0,0,163,163,
Tulsa,Commissioner of Labor,Mark Costello,REP,720169,0,0,290,290,
Tulsa,U.S. Senate,Matt Silverstein,DEM,720169,0,0,153,153,
Tulsa,U.S. Senate,Jim Inhofe,REP,720169,0,0,301,301,
Tulsa,U.S. Senate,Aaron Delozier,IND,720169,0,0,6,6,
Tulsa,U.S. Senate,Ray Woods,IND,720169,0,0,6,6,
Tulsa,U.S. Senate,Joan Farr,IND,720169,0,0,9,9,
Tulsa,U.S. Senate,Connie Johnson,DEM,720169,0,0,149,149,
Tulsa,U.S. Senate,James Lankford,REP,720169,0,0,317,317,
Tulsa,U.S. Senate,Mark Beard,IND,720169,0,0,11,11,
Tulsa,Governor,Joe Dorman,DEM,720170,0,0,89,89,
Tulsa,Governor,Mary Fallin,REP,720170,0,0,364,364,
Tulsa,Governor,Kimberly Willis,IND,720170,0,0,4,4,
Tulsa,Governor,Richard Prawdzienski,IND,720170,0,0,6,6,
Tulsa,Lieutenant Governor,Cathy Cummings,DEM,720170,0,0,62,62,
Tulsa,Lieutenant Governor,Todd Lamb,REP,720170,0,0,398,398,
Tulsa,Superintendent of Public Instruction,John Cox,DEM,720170,0,0,75,75,
Tulsa,Superintendent of Public Instruction,Joy Hofmeister,REP,720170,0,0,385,385,
Tulsa,Commissioner of Labor,Mike Workman,DEM,720170,0,0,68,68,
Tulsa,Commissioner of Labor,Mark Costello,REP,720170,0,0,379,379,
Tulsa,U.S. Senate,Matt Silverstein,DEM,720170,0,0,69,69,
Tulsa,U.S. Senate,Jim Inhofe,REP,720170,0,0,387,387,
Tulsa,U.S. Senate,Aaron Delozier,IND,720170,0,0,1,1,
Tulsa,U.S. Senate,Ray Woods,IND,720170,0,0,1,1,
Tulsa,U.S. Senate,Joan Farr,IND,720170,0,0,2,2,
Tulsa,U.S. Senate,Connie Johnson,DEM,720170,0,0,57,57,
Tulsa,U.S. Senate,James Lankford,REP,720170,0,0,395,395,
Tulsa,U.S. Senate,Mark Beard,IND,720170,0,0,8,8,
Tulsa,Governor,Joe Dorman,DEM,720171,0,0,134,134,
Tulsa,Governor,Mary Fallin,REP,720171,0,0,238,238,
Tulsa,Governor,Kimberly Willis,IND,720171,0,0,4,4,
Tulsa,Governor,Richard Prawdzienski,IND,720171,0,0,2,2,
Tulsa,Lieutenant Governor,Cathy Cummings,DEM,720171,0,0,104,104,
Tulsa,Lieutenant Governor,Todd Lamb,REP,720171,0,0,272,272,
Tulsa,Superintendent of Public Instruction,John Cox,DEM,720171,0,0,115,115,
Tulsa,Superintendent of Public Instruction,Joy Hofmeister,REP,720171,0,0,261,261,
Tulsa,Commissioner of Labor,Mike Workman,DEM,720171,0,0,109,109,
Tulsa,Commissioner of Labor,Mark Costello,REP,720171,0,0,260,260,
Tulsa,U.S. Senate,Matt Silverstein,DEM,720171,0,0,108,108,
Tulsa,U.S. Senate,Jim Inhofe,REP,720171,0,0,258,258,
Tulsa,U.S. Senate,Aaron Delozier,IND,720171,0,0,5,5,
Tulsa,U.S. Senate,Ray Woods,IND,720171,0,0,2,2,
Tulsa,U.S. Senate,Joan Farr,IND,720171,0,0,3,3,
Tulsa,U.S. Senate,Connie Johnson,DEM,720171,0,0,102,102,
Tulsa,U.S. Senate,James Lankford,REP,720171,0,0,261,261,
Tulsa,U.S. Senate,Mark Beard,IND,720171,0,0,8,8,
Tulsa,Governor,Joe Dorman,DEM,720172,0,0,195,195,
Tulsa,Governor,Mary Fallin,REP,720172,0,0,318,318,
Tulsa,Governor,Kimberly Willis,IND,720172,0,0,12,12,
Tulsa,Governor,Richard Prawdzienski,IND,720172,0,0,2,2,
Tulsa,Lieutenant Governor,Cathy Cummings,DEM,720172,0,0,152,152,
Tulsa,Lieutenant Governor,Todd Lamb,REP,720172,0,0,379,379,
Tulsa,Superintendent of Public Instruction,John Cox,DEM,720172,0,0,178,178,
Tulsa,Superintendent of Public Instruction,Joy Hofmeister,REP,720172,0,0,348,348,
Tulsa,Commissioner of Labor,Mike Workman,DEM,720172,0,0,163,163,
Tulsa,Commissioner of Labor,Mark Costello,REP,720172,0,0,358,358,
Tulsa,U.S. Senate,Matt Silverstein,DEM,720172,0,0,137,137,
Tulsa,U.S. Senate,Jim Inhofe,REP,720172,0,0,374,374,
Tulsa,U.S. Senate,Aaron Delozier,IND,720172,0,0,7,7,
Tulsa,U.S. Senate,Ray Woods,IND,720172,0,0,1,1,
Tulsa,U.S. Senate,Joan Farr,IND,720172,0,0,7,7,
Tulsa,U.S. Senate,Connie Johnson,DEM,720172,0,0,139,139,
Tulsa,U.S. Senate,James Lankford,REP,720172,0,0,380,380,
Tulsa,U.S. Senate,Mark Beard,IND,720172,0,0,9,9,
Tulsa,Governor,Joe Dorman,DEM,720173,0,0,225,225,
Tulsa,Governor,Mary Fallin,REP,720173,0,0,470,470,
Tulsa,Governor,Kimberly Willis,IND,720173,0,0,6,6,
Tulsa,Governor,Richard Prawdzienski,IND,720173,0,0,5,5,
Tulsa,Lieutenant Governor,Cathy Cummings,DEM,720173,0,0,172,172,
Tulsa,Lieutenant Governor,Todd Lamb,REP,720173,0,0,530,530,
Tulsa,Superintendent of Public Instruction,John Cox,DEM,720173,0,0,200,200,
Tulsa,Superintendent of Public Instruction,Joy Hofmeister,REP,720173,0,0,503,503,
Tulsa,Commissioner of Labor,Mike Workman,DEM,720173,0,0,182,182,
Tulsa,Commissioner of Labor,Mark Costello,REP,720173,0,0,498,498,
Tulsa,U.S. Senate,Matt Silverstein,DEM,720173,0,0,184,184,
Tulsa,U.S. Senate,Jim Inhofe,REP,720173,0,0,509,509,
Tulsa,U.S. Senate,Aaron Delozier,IND,720173,0,0,4,4,
Tulsa,U.S. Senate,Ray Woods,IND,720173,0,0,2,2,
Tulsa,U.S. Senate,Joan Farr,IND,720173,0,0,4,4,
Tulsa,U.S. Senate,Connie Johnson,DEM,720173,0,0,163,163,
Tulsa,U.S. Senate,James Lankford,REP,720173,0,0,521,521,
Tulsa,U.S. Senate,Mark Beard,IND,720173,0,0,15,15,
Tulsa,Governor,Joe Dorman,DEM,720174,0,0,0,0,
Tulsa,Governor,Mary Fallin,REP,720174,0,0,0,0,
Tulsa,Governor,Kimberly Willis,IND,720174,0,0,0,0,
Tulsa,Governor,Richard Prawdzienski,IND,720174,0,0,0,0,
Tulsa,Lieutenant Governor,Cathy Cummings,DEM,720174,0,0,0,0,
Tulsa,Lieutenant Governor,Todd Lamb,REP,720174,0,0,0,0,
Tulsa,Superintendent of Public Instruction,John Cox,DEM,720174,0,0,0,0,
Tulsa,Superintendent of Public Instruction,Joy Hofmeister,REP,720174,0,0,0,0,
Tulsa,Commissioner of Labor,Mike Workman,DEM,720174,0,0,0,0,
Tulsa,Commissioner of Labor,Mark Costello,REP,720174,0,0,0,0,
Tulsa,U.S. Senate,Matt Silverstein,DEM,720174,0,0,0,0,
Tulsa,U.S. Senate,Jim Inhofe,REP,720174,0,0,0,0,
Tulsa,U.S. Senate,Aaron Delozier,IND,720174,0,0,0,0,
Tulsa,U.S. Senate,Ray Woods,IND,720174,0,0,0,0,
Tulsa,U.S. Senate,Joan Farr,IND,720174,0,0,0,0,
Tulsa,U.S. Senate,Connie Johnson,DEM,720174,0,0,0,0,
Tulsa,U.S. Senate,James Lankford,REP,720174,0,0,0,0,
Tulsa,U.S. Senate,Mark Beard,IND,720174,0,0,0,0,
Tulsa,Governor,Joe Dorman,DEM,720175,0,0,0,0,
Tulsa,Governor,Mary Fallin,REP,720175,0,0,0,0,
Tulsa,Governor,Kimberly Willis,IND,720175,0,0,0,0,
Tulsa,Governor,Richard Prawdzienski,IND,720175,0,0,0,0,
Tulsa,Lieutenant Governor,Cathy Cummings,DEM,720175,0,0,0,0,
Tulsa,Lieutenant Governor,Todd Lamb,REP,720175,0,0,0,0,
Tulsa,Superintendent of Public Instruction,John Cox,DEM,720175,0,0,0,0,
Tulsa,Superintendent of Public Instruction,Joy Hofmeister,REP,720175,0,0,0,0,
Tulsa,Commissioner of Labor,Mike Workman,DEM,720175,0,0,0,0,
Tulsa,Commissioner of Labor,Mark Costello,REP,720175,0,0,0,0,
Tulsa,U.S. Senate,Matt Silverstein,DEM,720175,0,0,0,0,
Tulsa,U.S. Senate,Jim Inhofe,REP,720175,0,0,0,0,
Tulsa,U.S. Senate,Aaron Delozier,IND,720175,0,0,0,0,
Tulsa,U.S. Senate,Ray Woods,IND,720175,0,0,0,0,
Tulsa,U.S. Senate,Joan Farr,IND,720175,0,0,0,0,
Tulsa,U.S. Senate,Connie Johnson,DEM,720175,0,0,0,0,
Tulsa,U.S. Senate,James Lankford,REP,720175,0,0,0,0,
Tulsa,U.S. Senate,Mark Beard,IND,720175,0,0,0,0,
Tulsa,Governor,Joe Dorman,DEM,720176,0,0,0,0,
Tulsa,Governor,Mary Fallin,REP,720176,0,0,0,0,
Tulsa,Governor,Kimberly Willis,IND,720176,0,0,0,0,
Tulsa,Governor,Richard Prawdzienski,IND,720176,0,0,0,0,
Tulsa,Lieutenant Governor,Cathy Cummings,DEM,720176,0,0,0,0,
Tulsa,Lieutenant Governor,Todd Lamb,REP,720176,0,0,0,0,
Tulsa,Superintendent of Public Instruction,John Cox,DEM,720176,0,0,0,0,
Tulsa,Superintendent of Public Instruction,Joy Hofmeister,REP,720176,0,0,0,0,
Tulsa,Commissioner of Labor,Mike Workman,DEM,720176,0,0,0,0,
Tulsa,Commissioner of Labor,Mark Costello,REP,720176,0,0,0,0,
Tulsa,U.S. Senate,Matt Silverstein,DEM,720176,0,0,0,0,
Tulsa,U.S. Senate,Jim Inhofe,REP,720176,0,0,0,0,
Tulsa,U.S. Senate,Aaron Delozier,IND,720176,0,0,0,0,
Tulsa,U.S. Senate,Ray Woods,IND,720176,0,0,0,0,
Tulsa,U.S. Senate,Joan Farr,IND,720176,0,0,0,0,
Tulsa,U.S. Senate,Connie Johnson,DEM,720176,0,0,0,0,
Tulsa,U.S. Senate,James Lankford,REP,720176,0,0,0,0,
Tulsa,U.S. Senate,Mark Beard,IND,720176,0,0,0,0,
Tulsa,Governor,Joe Dorman,DEM,720351,0,0,265,265,
Tulsa,Governor,Mary Fallin,REP,720351,0,0,594,594,
Tulsa,Governor,Kimberly Willis,IND,720351,0,0,15,15,
Tulsa,Governor,Richard Prawdzienski,IND,720351,0,0,15,15,
Tulsa,Lieutenant Governor,Cathy Cummings,DEM,720351,0,0,167,167,
Tulsa,Lieutenant Governor,Todd Lamb,REP,720351,0,0,718,718,
Tulsa,Superintendent of Public Instruction,John Cox,DEM,720351,0,0,277,277,
Tulsa,Superintendent of Public Instruction,Joy Hofmeister,REP,720351,0,0,609,609,
Tulsa,Commissioner of Labor,Mike Workman,DEM,720351,0,0,207,207,
Tulsa,Commissioner of Labor,Mark Costello,REP,720351,0,0,666,666,
Tulsa,U.S. Senate,Matt Silverstein,DEM,720351,0,0,187,187,
Tulsa,U.S. Senate,Jim Inhofe,REP,720351,0,0,662,662,
Tulsa,U.S. Senate,Aaron Delozier,IND,720351,0,0,13,13,
Tulsa,U.S. Senate,Ray Woods,IND,720351,0,0,10,10,
Tulsa,U.S. Senate,Joan Farr,IND,720351,0,0,14,14,
Tulsa,U.S. Senate,Connie Johnson,DEM,720351,0,0,159,159,
Tulsa,U.S. Senate,James Lankford,REP,720351,0,0,695,695,
Tulsa,U.S. Senate,Mark Beard,IND,720351,0,0,35,35,
Tulsa,Governor,Joe Dorman,DEM,720352,0,0,121,121,
Tulsa,Governor,Mary Fallin,REP,720352,0,0,364,364,
Tulsa,Governor,Kimberly Willis,IND,720352,0,0,10,10,
Tulsa,Governor,Richard Prawdzienski,IND,720352,0,0,0,0,
Tulsa,Lieutenant Governor,Cathy Cummings,DEM,720352,0,0,98,98,
Tulsa,Lieutenant Governor,Todd Lamb,REP,720352,0,0,395,395,
Tulsa,Superintendent of Public Instruction,John Cox,DEM,720352,0,0,118,118,
Tulsa,Superintendent of Public Instruction,Joy Hofmeister,REP,720352,0,0,372,372,
Tulsa,Commissioner of Labor,Mike Workman,DEM,720352,0,0,97,97,
Tulsa,Commissioner of Labor,Mark Costello,REP,720352,0,0,387,387,
Tulsa,U.S. Senate,Matt Silverstein,DEM,720352,0,0,86,86,
Tulsa,U.S. Senate,Jim Inhofe,REP,720352,0,0,400,400,
Tulsa,U.S. Senate,Aaron Delozier,IND,720352,0,0,1,1,
Tulsa,U.S. Senate,Ray Woods,IND,720352,0,0,5,5,
Tulsa,U.S. Senate,Joan Farr,IND,720352,0,0,3,3,
Tulsa,U.S. Senate,Connie Johnson,DEM,720352,0,0,81,81,
Tulsa,U.S. Senate,James Lankford,REP,720352,0,0,400,400,
Tulsa,U.S. Senate,Mark Beard,IND,720352,0,0,9,9,
Tulsa,Governor,Joe Dorman,DEM,720353,0,0,30,30,
Tulsa,Governor,Mary Fallin,REP,720353,0,0,89,89,
Tulsa,Governor,Kimberly Willis,IND,720353,0,0,1,1,
Tulsa,Governor,Richard Prawdzienski,IND,720353,0,0,2,2,
Tulsa,Lieutenant Governor,Cathy Cummings,DEM,720353,0,0,24,24,
Tulsa,Lieutenant Governor,Todd Lamb,REP,720353,0,0,97,97,
Tulsa,Superintendent of Public Instruction,John Cox,DEM,720353,0,0,31,31,
Tulsa,Superintendent of Public Instruction,Joy Hofmeister,REP,720353,0,0,89,89,
Tulsa,Commissioner of Labor,Mike Workman,DEM,720353,0,0,34,34,
Tulsa,Commissioner of Labor,Mark Costello,REP,720353,0,0,82,82,
Tulsa,U.S. Senate,Matt Silverstein,DEM,720353,0,0,22,22,
Tulsa,U.S. Senate,Jim Inhofe,REP,720353,0,0,95,95,
Tulsa,U.S. Senate,Aaron Delozier,IND,720353,0,0,1,1,
Tulsa,U.S. Senate,Ray Woods,IND,720353,0,0,1,1,
Tulsa,U.S. Senate,Joan Farr,IND,720353,0,0,2,2,
Tulsa,U.S. Senate,Connie Johnson,DEM,720353,0,0,21,21,
Tulsa,U.S. Senate,James Lankford,REP,720353,0,0,97,97,
Tulsa,U.S. Senate,Mark Beard,IND,720353,0,0,3,3,
Tulsa,State House,Jerry Shoemake,DEM,720353,0,0,36,36,16
Tulsa,State House,James Bo Delso,REP,720353,0,0,80,80,16
Tulsa,Governor,Joe Dorman,DEM,720354,0,0,30,30,
Tulsa,Governor,Mary Fallin,REP,720354,0,0,71,71,
Tulsa,Governor,Kimberly Willis,IND,720354,0,0,2,2,
Tulsa,Governor,Richard Prawdzienski,IND,720354,0,0,0,0,
Tulsa,Lieutenant Governor,Cathy Cummings,DEM,720354,0,0,21,21,
Tulsa,Lieutenant Governor,Todd Lamb,REP,720354,0,0,84,84,
Tulsa,Superintendent of Public Instruction,John Cox,DEM,720354,0,0,36,36,
Tulsa,Superintendent of Public Instruction,Joy Hofmeister,REP,720354,0,0,69,69,
Tulsa,Commissioner of Labor,Mike Workman,DEM,720354,0,0,28,28,
Tulsa,Commissioner of Labor,Mark Costello,REP,720354,0,0,76,76,
Tulsa,U.S. Senate,Matt Silverstein,DEM,720354,0,0,24,24,
Tulsa,U.S. Senate,Jim Inhofe,REP,720354,0,0,78,78,
Tulsa,U.S. Senate,Aaron Delozier,IND,720354,0,0,0,0,
Tulsa,U.S. Senate,Ray Woods,IND,720354,0,0,1,1,
Tulsa,U.S. Senate,Joan Farr,IND,720354,0,0,1,1,
Tulsa,U.S. Senate,Connie Johnson,DEM,720354,0,0,25,25,
Tulsa,U.S. Senate,James Lankford,REP,720354,0,0,80,80,
Tulsa,U.S. Senate,Mark Beard,IND,720354,0,0,0,0,
Tulsa,Governor,Joe Dorman,DEM,720355,0,0,41,41,
Tulsa,Governor,Mary Fallin,REP,720355,0,0,68,68,
Tulsa,Governor,Kimberly Willis,IND,720355,0,0,2,2,
Tulsa,Governor,Richard Prawdzienski,IND,720355,0,0,0,0,
Tulsa,Lieutenant Governor,Cathy Cummings,DEM,720355,0,0,28,28,
Tulsa,Lieutenant Governor,Todd Lamb,REP,720355,0,0,81,81,
Tulsa,Superintendent of Public Instruction,John Cox,DEM,720355,0,0,36,36,
Tulsa,Superintendent of Public Instruction,Joy Hofmeister,REP,720355,0,0,74,74,
Tulsa,Commissioner of Labor,Mike Workman,DEM,720355,0,0,35,35,
Tulsa,Commissioner of Labor,Mark Costello,REP,720355,0,0,74,74,
Tulsa,U.S. Senate,Matt Silverstein,DEM,720355,0,0,34,34,
Tulsa,U.S. Senate,Jim Inhofe,REP,720355,0,0,71,71,
Tulsa,U.S. Senate,Aaron Delozier,IND,720355,0,0,2,2,
Tulsa,U.S. Senate,Ray Woods,IND,720355,0,0,4,4,
Tulsa,U.S. Senate,Joan Farr,IND,720355,0,0,0,0,
Tulsa,U.S. Senate,Connie Johnson,DEM,720355,0,0,31,31,
Tulsa,U.S. Senate,James Lankford,REP,720355,0,0,77,77,
Tulsa,U.S. Senate,Mark Beard,IND,720355,0,0,3,3,
Tulsa,Governor,Joe Dorman,DEM,720356,0,0,29,29,
Tulsa,Governor,Mary Fallin,REP,720356,0,0,97,97,
Tulsa,Governor,Kimberly Willis,IND,720356,0,0,4,4,
Tulsa,Governor,Richard Prawdzienski,IND,720356,0,0,1,1,
Tulsa,Lieutenant Governor,Cathy Cummings,DEM,720356,0,0,13,13,
Tulsa,Lieutenant Governor,Todd Lamb,REP,720356,0,0,118,118,
Tulsa,Superintendent of Public Instruction,John Cox,DEM,720356,0,0,26,26,
Tulsa,Superintendent of Public Instruction,Joy Hofmeister,REP,720356,0,0,105,105,
Tulsa,Commissioner of Labor,Mike Workman,DEM,720356,0,0,16,16,
Tulsa,Commissioner of Labor,Mark Costello,REP,720356,0,0,111,111,
Tulsa,U.S. Senate,Matt Silverstein,DEM,720356,0,0,15,15,
Tulsa,U.S. Senate,Jim Inhofe,REP,720356,0,0,112,112,
Tulsa,U.S. Senate,Aaron Delozier,IND,720356,0,0,2,2,
Tulsa,U.S. Senate,Ray Woods,IND,720356,0,0,0,0,
Tulsa,U.S. Senate,Joan Farr,IND,720356,0,0,1,1,
Tulsa,U.S. Senate,Connie Johnson,DEM,720356,0,0,13,13,
Tulsa,U.S. Senate,James Lankford,REP,720356,0,0,116,116,
Tulsa,U.S. Senate,Mark Beard,IND,720356,0,0,2,2,
Tulsa,Governor,Joe Dorman,DEM,720400,0,0,177,177,
Tulsa,Governor,Mary Fallin,REP,720400,0,0,579,579,
Tulsa,Governor,Kimberly Willis,IND,720400,0,0,10,10,
Tulsa,Governor,Richard Prawdzienski,IND,720400,0,0,5,5,
Tulsa,Lieutenant Governor,Cathy Cummings,DEM,720400,0,0,123,123,
Tulsa,Lieutenant Governor,Todd Lamb,REP,720400,0,0,643,643,
Tulsa,Superintendent of Public Instruction,John Cox,DEM,720400,0,0,169,169,
Tulsa,Superintendent of Public Instruction,Joy Hofmeister,REP,720400,0,0,597,597,
Tulsa,Commissioner of Labor,Mike Workman,DEM,720400,0,0,136,136,
Tulsa,Commissioner of Labor,Mark Costello,REP,720400,0,0,616,616,
Tulsa,U.S. Senate,Matt Silverstein,DEM,720400,0,0,142,142,
Tulsa,U.S. Senate,Jim Inhofe,REP,720400,0,0,609,609,
Tulsa,U.S. Senate,Aaron Delozier,IND,720400,0,0,4,4,
Tulsa,U.S. Senate,Ray Woods,IND,720400,0,0,3,3,
Tulsa,U.S. Senate,Joan Farr,IND,720400,0,0,9,9,
Tulsa,U.S. Senate,Connie Johnson,DEM,720400,0,0,124,124,
Tulsa,U.S. Senate,James Lankford,REP,720400,0,0,632,632,
Tulsa,U.S. Senate,Mark Beard,IND,720400,0,0,11,11,
Tulsa,Governor,Joe Dorman,DEM,720401,0,0,190,190,
Tulsa,Governor,Mary Fallin,REP,720401,0,0,658,658,
Tulsa,Governor,Kimberly Willis,IND,720401,0,0,14,14,
Tulsa,Governor,Richard Prawdzienski,IND,720401,0,0,4,4,
Tulsa,Lieutenant Governor,Cathy Cummings,DEM,720401,0,0,127,127,
Tulsa,Lieutenant Governor,Todd Lamb,REP,720401,0,0,737,737,
Tulsa,Superintendent of Public Instruction,John Cox,DEM,720401,0,0,178,178,
Tulsa,Superintendent of Public Instruction,Joy Hofmeister,REP,720401,0,0,688,688,
Tulsa,Commissioner of Labor,Mike Workman,DEM,720401,0,0,145,145,
Tulsa,Commissioner of Labor,Mark Costello,REP,720401,0,0,700,700,
Tulsa,U.S. Senate,Matt Silverstein,DEM,720401,0,0,139,139,
Tulsa,U.S. Senate,Jim Inhofe,REP,720401,0,0,708,708,
Tulsa,U.S. Senate,Aaron Delozier,IND,720401,0,0,7,7,
Tulsa,U.S. Senate,Ray Woods,IND,720401,0,0,2,2,
Tulsa,U.S. Senate,Joan Farr,IND,720401,0,0,8,8,
Tulsa,U.S. Senate,Connie Johnson,DEM,720401,0,0,112,112,
Tulsa,U.S. Senate,James Lankford,REP,720401,0,0,729,729,
Tulsa,U.S. Senate,Mark Beard,IND,720401,0,0,23,23,
Tulsa,Governor,Joe Dorman,DEM,720402,0,0,102,102,
Tulsa,Governor,Mary Fallin,REP,720402,0,0,298,298,
Tulsa,Governor,Kimberly Willis,IND,720402,0,0,16,16,
Tulsa,Governor,Richard Prawdzienski,IND,720402,0,0,2,2,
Tulsa,Lieutenant Governor,Cathy Cummings,DEM,720402,0,0,80,80,
Tulsa,Lieutenant Governor,Todd Lamb,REP,720402,0,0,337,337,
Tulsa,Superintendent of Public Instruction,John Cox,DEM,720402,0,0,105,105,
Tulsa,Superintendent of Public Instruction,Joy Hofmeister,REP,720402,0,0,307,307,
Tulsa,Commissioner of Labor,Mike Workman,DEM,720402,0,0,94,94,
Tulsa,Commissioner of Labor,Mark Costello,REP,720402,0,0,314,314,
Tulsa,U.S. Senate,Matt Silverstein,DEM,720402,0,0,73,73,
Tulsa,U.S. Senate,Jim Inhofe,REP,720402,0,0,327,327,
Tulsa,U.S. Senate,Aaron Delozier,IND,720402,0,0,7,7,
Tulsa,U.S. Senate,Ray Woods,IND,720402,0,0,3,3,
Tulsa,U.S. Senate,Joan Farr,IND,720402,0,0,8,8,
Tulsa,U.S. Senate,Connie Johnson,DEM,720402,0,0,66,66,
Tulsa,U.S. Senate,James Lankford,REP,720402,0,0,331,331,
Tulsa,U.S. Senate,Mark Beard,IND,720402,0,0,19,19,
Tulsa,Governor,Joe Dorman,DEM,720403,0,0,297,297,
Tulsa,Governor,Mary Fallin,REP,720403,0,0,732,732,
Tulsa,Governor,Kimberly Willis,IND,720403,0,0,17,17,
Tulsa,Governor,Richard Prawdzienski,IND,720403,0,0,21,21,
Tulsa,Lieutenant Governor,Cathy Cummings,DEM,720403,0,0,232,232,
Tulsa,Lieutenant Governor,Todd Lamb,REP,720403,0,0,835,835,
Tulsa,Superintendent of Public Instruction,John Cox,DEM,720403,0,0,289,289,
Tulsa,Superintendent of Public Instruction,Joy Hofmeister,REP,720403,0,0,779,779,
Tulsa,Commissioner of Labor,Mike Workman,DEM,720403,0,0,258,258,
Tulsa,Commissioner of Labor,Mark Costello,REP,720403,0,0,801,801,
Tulsa,U.S. Senate,Matt Silverstein,DEM,720403,0,0,231,231,
Tulsa,U.S. Senate,Jim Inhofe,REP,720403,0,0,822,822,
Tulsa,U.S. Senate,Aaron Delozier,IND,720403,0,0,9,9,
Tulsa,U.S. Senate,Ray Woods,IND,720403,0,0,6,6,
Tulsa,U.S. Senate,Joan Farr,IND,720403,0,0,4,4,
Tulsa,U.S. Senate,Connie Johnson,DEM,720403,0,0,211,211,
Tulsa,U.S. Senate,James Lankford,REP,720403,0,0,838,838,
Tulsa,U.S. Senate,Mark Beard,IND,720403,0,0,21,21,
Tulsa,Governor,Joe Dorman,DEM,720404,0,0,153,153,
Tulsa,Governor,Mary Fallin,REP,720404,0,0,519,519,
Tulsa,Governor,Kimberly Willis,IND,720404,0,0,6,6,
Tulsa,Governor,Richard Prawdzienski,IND,720404,0,0,6,6,
Tulsa,Lieutenant Governor,Cathy Cummings,DEM,720404,0,0,110,110,
Tulsa,Lieutenant Governor,Todd Lamb,REP,720404,0,0,572,572,
Tulsa,Superintendent of Public Instruction,John Cox,DEM,720404,0,0,151,151,
Tulsa,Superintendent of Public Instruction,Joy Hofmeister,REP,720404,0,0,530,530,
Tulsa,Commissioner of Labor,Mike Workman,DEM,720404,0,0,131,131,
Tulsa,Commissioner of Labor,Mark Costello,REP,720404,0,0,546,546,
Tulsa,U.S. Senate,Matt Silverstein,DEM,720404,0,0,108,108,
Tulsa,U.S. Senate,Jim Inhofe,REP,720404,0,0,565,565,
Tulsa,U.S. Senate,Aaron Delozier,IND,720404,0,0,1,1,
Tulsa,U.S. Senate,Ray Woods,IND,720404,0,0,1,1,
Tulsa,U.S. Senate,Joan Farr,IND,720404,0,0,4,4,
Tulsa,U.S. Senate,Connie Johnson,DEM,720404,0,0,106,106,
Tulsa,U.S. Senate,James Lankford,REP,720404,0,0,563,563,
Tulsa,U.S. Senate,Mark Beard,IND,720404,0,0,11,11,
Tulsa,Governor,Joe Dorman,DEM,720405,0,0,20,20,
Tulsa,Governor,Mary Fallin,REP,720405,0,0,74,74,
Tulsa,Governor,Kimberly Willis,IND,720405,0,0,2,2,
Tulsa,Governor,Richard Prawdzienski,IND,720405,0,0,2,2,
Tulsa,Lieutenant Governor,Cathy Cummings,DEM,720405,0,0,11,11,
Tulsa,Lieutenant Governor,Todd Lamb,REP,720405,0,0,87,87,
Tulsa,Superintendent of Public Instruction,John Cox,DEM,720405,0,0,14,14,
Tulsa,Superintendent of Public Instruction,Joy Hofmeister,REP,720405,0,0,82,82,
Tulsa,Commissioner of Labor,Mike Workman,DEM,720405,0,0,15,15,
Tulsa,Commissioner of Labor,Mark Costello,REP,720405,0,0,81,81,
Tulsa,U.S. Senate,Matt Silverstein,DEM,720405,0,0,11,11,
Tulsa,U.S. Senate,Jim Inhofe,REP,720405,0,0,81,81,
Tulsa,U.S. Senate,Aaron Delozier,IND,720405,0,0,3,3,
Tulsa,U.S. Senate,Ray Woods,IND,720405,0,0,2,2,
Tulsa,U.S. Senate,Joan Farr,IND,720405,0,0,0,0,
Tulsa,U.S. Senate,Connie Johnson,DEM,720405,0,0,11,11,
Tulsa,U.S. Senate,James Lankford,REP,720405,0,0,84,84,
Tulsa,U.S. Senate,Mark Beard,IND,720405,0,0,2,2,
Tulsa,State Senate,Charles Arnall,DEM,720405,0,0,13,13,18
Tulsa,State Senate,Kim David,REP,720405,0,0,80,80,18
Tulsa,Governor,Joe Dorman,DEM,720406,0,0,199,199,
Tulsa,Governor,Mary Fallin,REP,720406,0,0,525,525,
Tulsa,Governor,Kimberly Willis,IND,720406,0,0,13,13,
Tulsa,Governor,Richard Prawdzienski,IND,720406,0,0,7,7,
Tulsa,Lieutenant Governor,Cathy Cummings,DEM,720406,0,0,140,140,
Tulsa,Lieutenant Governor,Todd Lamb,REP,720406,0,0,601,601,
Tulsa,Superintendent of Public Instruction,John Cox,DEM,720406,0,0,183,183,
Tulsa,Superintendent of Public Instruction,Joy Hofmeister,REP,720406,0,0,559,559,
Tulsa,Commissioner of Labor,Mike Workman,DEM,720406,0,0,154,154,
Tulsa,Commissioner of Labor,Mark Costello,REP,720406,0,0,563,563,
Tulsa,U.S. Senate,Matt Silverstein,DEM,720406,0,0,134,134,
Tulsa,U.S. Senate,Jim Inhofe,REP,720406,0,0,591,591,
Tulsa,U.S. Senate,Aaron Delozier,IND,720406,0,0,6,6,
Tulsa,U.S. Senate,Ray Woods,IND,720406,0,0,5,5,
Tulsa,U.S. Senate,Joan Farr,IND,720406,0,0,5,5,
Tulsa,U.S. Senate,Connie Johnson,DEM,720406,0,0,125,125,
Tulsa,U.S. Senate,James Lankford,REP,720406,0,0,602,602,
Tulsa,U.S. Senate,Mark Beard,IND,720406,0,0,13,13,
Tulsa,Governor,Joe Dorman,DEM,720407,0,0,175,175,
Tulsa,Governor,Mary Fallin,REP,720407,0,0,502,502,
Tulsa,Governor,Kimberly Willis,IND,720407,0,0,10,10,
Tulsa,Governor,Richard Prawdzienski,IND,720407,0,0,10,10,
Tulsa,Lieutenant Governor,Cathy Cummings,DEM,720407,0,0,124,124,
Tulsa,Lieutenant Governor,Todd Lamb,REP,720407,0,0,573,573,
Tulsa,Superintendent of Public Instruction,John Cox,DEM,720407,0,0,170,170,
Tulsa,Superintendent of Public Instruction,Joy Hofmeister,REP,720407,0,0,522,522,
Tulsa,Commissioner of Labor,Mike Workman,DEM,720407,0,0,130,130,
Tulsa,Commissioner of Labor,Mark Costello,REP,720407,0,0,551,551,
Tulsa,U.S. Senate,Matt Silverstein,DEM,720407,0,0,133,133,
Tulsa,U.S. Senate,Jim Inhofe,REP,720407,0,0,553,553,
Tulsa,U.S. Senate,Aaron Delozier,IND,720407,0,0,4,4,
Tulsa,U.S. Senate,Ray Woods,IND,720407,0,0,4,4,
Tulsa,U.S. Senate,Joan Farr,IND,720407,0,0,4,4,
Tulsa,U.S. Senate,Connie Johnson,DEM,720407,0,0,106,106,
Tulsa,U.S. Senate,James Lankford,REP,720407,0,0,577,577,
Tulsa,U.S. Senate,Mark Beard,IND,720407,0,0,12,12,
Tulsa,Governor,Joe Dorman,DEM,720408,0,0,169,169,
Tulsa,Governor,Mary Fallin,REP,720408,0,0,524,524,
Tulsa,Governor,Kimberly Willis,IND,720408,0,0,14,14,
Tulsa,Governor,Richard Prawdzienski,IND,720408,0,0,9,9,
Tulsa,Lieutenant Governor,Cathy Cummings,DEM,720408,0,0,111,111,
Tulsa,Lieutenant Governor,Todd Lamb,REP,720408,0,0,601,601,
Tulsa,Superintendent of Public Instruction,John Cox,DEM,720408,0,0,177,177,
Tulsa,Superintendent of Public Instruction,Joy Hofmeister,REP,720408,0,0,535,535,
Tulsa,Commissioner of Labor,Mike Workman,DEM,720408,0,0,134,134,
Tulsa,Commissioner of Labor,Mark Costello,REP,720408,0,0,572,572,
Tulsa,U.S. Senate,Matt Silverstein,DEM,720408,0,0,114,114,
Tulsa,U.S. Senate,Jim Inhofe,REP,720408,0,0,581,581,
Tulsa,U.S. Senate,Aaron Delozier,IND,720408,0,0,12,12,
Tulsa,U.S. Senate,Ray Woods,IND,720408,0,0,5,5,
Tulsa,U.S. Senate,Joan Farr,IND,720408,0,0,3,3,
Tulsa,U.S. Senate,Connie Johnson,DEM,720408,0,0,94,94,
Tulsa,U.S. Senate,James Lankford,REP,720408,0,0,607,607,
Tulsa,U.S. Senate,Mark Beard,IND,720408,0,0,13,13,
Tulsa,Governor,Joe Dorman,DEM,720409,0,0,213,213,
Tulsa,Governor,Mary Fallin,REP,720409,0,0,449,449,
Tulsa,Governor,Kimberly Willis,IND,720409,0,0,21,21,
Tulsa,Governor,Richard Prawdzienski,IND,720409,0,0,12,12,
Tulsa,Lieutenant Governor,Cathy Cummings,DEM,720409,0,0,129,129,
Tulsa,Lieutenant Governor,Todd Lamb,REP,720409,0,0,562,562,
Tulsa,Superintendent of Public Instruction,John Cox,DEM,720409,0,0,200,200,
Tulsa,Superintendent of Public Instruction,Joy Hofmeister,REP,720409,0,0,491,491,
Tulsa,Commissioner of Labor,Mike Workman,DEM,720409,0,0,129,129,
Tulsa,Commissioner of Labor,Mark Costello,REP,720409,0,0,545,545,
Tulsa,U.S. Senate,Matt Silverstein,DEM,720409,0,0,129,129,
Tulsa,U.S. Senate,Jim Inhofe,REP,720409,0,0,539,539,
Tulsa,U.S. Senate,Aaron Delozier,IND,720409,0,0,11,11,
Tulsa,U.S. Senate,Ray Woods,IND,720409,0,0,7,7,
Tulsa,U.S. Senate,Joan Farr,IND,720409,0,0,7,7,
Tulsa,U.S. Senate,Connie Johnson,DEM,720409,0,0,111,111,
Tulsa,U.S. Senate,James Lankford,REP,720409,0,0,555,555,
Tulsa,U.S. Senate,Mark Beard,IND,720409,0,0,26,26,
Tulsa,Governor,Joe Dorman,DEM,720410,0,0,83,83,
Tulsa,Governor,Mary Fallin,REP,720410,0,0,308,308,
Tulsa,Governor,Kimberly Willis,IND,720410,0,0,4,4,
Tulsa,Governor,Richard Prawdzienski,IND,720410,0,0,3,3,
Tulsa,Lieutenant Governor,Cathy Cummings,DEM,720410,0,0,50,50,
Tulsa,Lieutenant Governor,Todd Lamb,REP,720410,0,0,345,345,
Tulsa,Superintendent of Public Instruction,John Cox,DEM,720410,0,0,70,70,
Tulsa,Superintendent of Public Instruction,Joy Hofmeister,REP,720410,0,0,326,326,
Tulsa,Commissioner of Labor,Mike Workman,DEM,720410,0,0,59,59,
Tulsa,Commissioner of Labor,Mark Costello,REP,720410,0,0,335,335,
Tulsa,U.S. Senate,Matt Silverstein,DEM,720410,0,0,59,59,
Tulsa,U.S. Senate,Jim Inhofe,REP,720410,0,0,332,332,
Tulsa,U.S. Senate,Aaron Delozier,IND,720410,0,0,4,4,
Tulsa,U.S. Senate,Ray Woods,IND,720410,0,0,1,1,
Tulsa,U.S. Senate,Joan Farr,IND,720410,0,0,2,2,
Tulsa,U.S. Senate,Connie Johnson,DEM,720410,0,0,42,42,
Tulsa,U.S. Senate,James Lankford,REP,720410,0,0,345,345,
Tulsa,U.S. Senate,Mark Beard,IND,720410,0,0,8,8,
Tulsa,Governor,Joe Dorman,DEM,720411,0,0,90,90,
Tulsa,Governor,Mary Fallin,REP,720411,0,0,231,231,
Tulsa,Governor,Kimberly Willis,IND,720411,0,0,9,9,
Tulsa,Governor,Richard Prawdzienski,IND,720411,0,0,2,2,
Tulsa,Lieutenant Governor,Cathy Cummings,DEM,720411,0,0,62,62,
Tulsa,Lieutenant Governor,Todd Lamb,REP,720411,0,0,269,269,
Tulsa,Superintendent of Public Instruction,John Cox,DEM,720411,0,0,95,95,
Tulsa,Superintendent of Public Instruction,Joy Hofmeister,REP,720411,0,0,236,236,
Tulsa,Commissioner of Labor,Mike Workman,DEM,720411,0,0,78,78,
Tulsa,Commissioner of Labor,Mark Costello,REP,720411,0,0,253,253,
Tulsa,U.S. Senate,Matt Silverstein,DEM,720411,0,0,64,64,
Tulsa,U.S. Senate,Jim Inhofe,REP,720411,0,0,260,260,
Tulsa,U.S. Senate,Aaron Delozier,IND,720411,0,0,1,1,
Tulsa,U.S. Senate,Ray Woods,IND,720411,0,0,5,5,
Tulsa,U.S. Senate,Joan Farr,IND,720411,0,0,2,2,
Tulsa,U.S. Senate,Connie Johnson,DEM,720411,0,0,58,58,
Tulsa,U.S. Senate,James Lankford,REP,720411,0,0,267,267,
Tulsa,U.S. Senate,Mark Beard,IND,720411,0,0,6,6,
Tulsa,Governor,Joe Dorman,DEM,720451,0,0,137,137,
Tulsa,Governor,Mary Fallin,REP,720451,0,0,323,323,
Tulsa,Governor,Kimberly Willis,IND,720451,0,0,5,5,
Tulsa,Governor,Richard Prawdzienski,IND,720451,0,0,8,8,
Tulsa,Lieutenant Governor,Cathy Cummings,DEM,720451,0,0,124,124,
Tulsa,Lieutenant Governor,Todd Lamb,REP,720451,0,0,347,347,
Tulsa,Superintendent of Public Instruction,John Cox,DEM,720451,0,0,136,136,
Tulsa,Superintendent of Public Instruction,Joy Hofmeister,REP,720451,0,0,332,332,
Tulsa,Commissioner of Labor,Mike Workman,DEM,720451,0,0,127,127,
Tulsa,Commissioner of Labor,Mark Costello,REP,720451,0,0,342,342,
Tulsa,U.S. Senate,Matt Silverstein,DEM,720451,0,0,114,114,
Tulsa,U.S. Senate,Jim Inhofe,REP,720451,0,0,347,347,
Tulsa,U.S. Senate,Aaron Delozier,IND,720451,0,0,3,3,
Tulsa,U.S. Senate,Ray Woods,IND,720451,0,0,4,4,
Tulsa,U.S. Senate,Joan Farr,IND,720451,0,0,6,6,
Tulsa,U.S. Senate,Connie Johnson,DEM,720451,0,0,110,110,
Tulsa,U.S. Senate,James Lankford,REP,720451,0,0,341,341,
Tulsa,U.S. Senate,Mark Beard,IND,720451,0,0,18,18,
Tulsa,State House,Glenda Puett,DEM,720451,0,0,120,120,76
Tulsa,State House,David Brumbaugh,REP,720451,0,0,347,347,76
Tulsa,Governor,Joe Dorman,DEM,720452,0,0,287,287,
Tulsa,Governor,Mary Fallin,REP,720452,0,0,580,580,
Tulsa,Governor,Kimberly Willis,IND,720452,0,0,18,18,
Tulsa,Governor,Richard Prawdzienski,IND,720452,0,0,11,11,
Tulsa,Lieutenant Governor,Cathy Cummings,DEM,720452,0,0,235,235,
Tulsa,Lieutenant Governor,Todd Lamb,REP,720452,0,0,660,660,
Tulsa,Superintendent of Public Instruction,John Cox,DEM,720452,0,0,299,299,
Tulsa,Superintendent of Public Instruction,Joy Hofmeister,REP,720452,0,0,597,597,
Tulsa,Commissioner of Labor,Mike Workman,DEM,720452,0,0,269,269,
Tulsa,Commissioner of Labor,Mark Costello,REP,720452,0,0,613,613,
Tulsa,U.S. Senate,Matt Silverstein,DEM,720452,0,0,207,207,
Tulsa,U.S. Senate,Jim Inhofe,REP,720452,0,0,640,640,
Tulsa,U.S. Senate,Aaron Delozier,IND,720452,0,0,19,19,
Tulsa,U.S. Senate,Ray Woods,IND,720452,0,0,12,12,
Tulsa,U.S. Senate,Joan Farr,IND,720452,0,0,14,14,
Tulsa,U.S. Senate,Connie Johnson,DEM,720452,0,0,212,212,
Tulsa,U.S. Senate,James Lankford,REP,720452,0,0,650,650,
Tulsa,U.S. Senate,Mark Beard,IND,720452,0,0,30,30,
Tulsa,Governor,Joe Dorman,DEM,720453,0,0,185,185,
Tulsa,Governor,Mary Fallin,REP,720453,0,0,333,333,
Tulsa,Governor,Kimberly Willis,IND,720453,0,0,11,11,
Tulsa,Governor,Richard Prawdzienski,IND,720453,0,0,4,4,
Tulsa,Lieutenant Governor,Cathy Cummings,DEM,720453,0,0,126,126,
Tulsa,Lieutenant Governor,Todd Lamb,REP,720453,0,0,403,403,
Tulsa,Superintendent of Public Instruction,John Cox,DEM,720453,0,0,163,163,
Tulsa,Superintendent of Public Instruction,Joy Hofmeister,REP,720453,0,0,365,365,
Tulsa,Commissioner of Labor,Mike Workman,DEM,720453,0,0,137,137,
Tulsa,Commissioner of Labor,Mark Costello,REP,720453,0,0,381,381,
Tulsa,U.S. Senate,Matt Silverstein,DEM,720453,0,0,130,130,
Tulsa,U.S. Senate,Jim Inhofe,REP,720453,0,0,386,386,
Tulsa,U.S. Senate,Aaron Delozier,IND,720453,0,0,6,6,
Tulsa,U.S. Senate,Ray Woods,IND,720453,0,0,6,6,
Tulsa,U.S. Senate,Joan Farr,IND,720453,0,0,5,5,
Tulsa,U.S. Senate,Connie Johnson,DEM,720453,0,0,110,110,
Tulsa,U.S. Senate,James Lankford,REP,720453,0,0,409,409,
Tulsa,U.S. Senate,Mark Beard,IND,720453,0,0,12,12,
Tulsa,Governor,Joe Dorman,DEM,720454,0,0,297,297,
Tulsa,Governor,Mary Fallin,REP,720454,0,0,516,516,
Tulsa,Governor,Kimberly Willis,IND,720454,0,0,7,7,
Tulsa,Governor,Richard Prawdzienski,IND,720454,0,0,1,1,
Tulsa,Lieutenant Governor,Cathy Cummings,DEM,720454,0,0,214,214,
Tulsa,Lieutenant Governor,Todd Lamb,REP,720454,0,0,601,601,
Tulsa,Superintendent of Public Instruction,John Cox,DEM,720454,0,0,251,251,
Tulsa,Superintendent of Public Instruction,Joy Hofmeister,REP,720454,0,0,564,564,
Tulsa,Commissioner of Labor,Mike Workman,DEM,720454,0,0,234,234,
Tulsa,Commissioner of Labor,Mark Costello,REP,720454,0,0,569,569,
Tulsa,U.S. Senate,Matt Silverstein,DEM,720454,0,0,223,223,
Tulsa,U.S. Senate,Jim Inhofe,REP,720454,0,0,584,584,
Tulsa,U.S. Senate,Aaron Delozier,IND,720454,0,0,4,4,
Tulsa,U.S. Senate,Ray Woods,IND,720454,0,0,2,2,
Tulsa,U.S. Senate,Joan Farr,IND,720454,0,0,5,5,
Tulsa,U.S. Senate,Connie Johnson,DEM,720454,0,0,206,206,
Tulsa,U.S. Senate,James Lankford,REP,720454,0,0,596,596,
Tulsa,U.S. Senate,Mark Beard,IND,720454,0,0,11,11,
Tulsa,State House,Glenda Puett,DEM,720454,0,0,236,236,76
Tulsa,State House,David Brumbaugh,REP,720454,0,0,570,570,76
Tulsa,Governor,Joe Dorman,DEM,720455,0,0,124,124,
Tulsa,Governor,Mary Fallin,REP,720455,0,0,209,209,
Tulsa,Governor,Kimberly Willis,IND,720455,0,0,9,9,
Tulsa,Governor,Richard Prawdzienski,IND,720455,0,0,1,1,
Tulsa,Lieutenant Governor,Cathy Cummings,DEM,720455,0,0,100,100,
Tulsa,Lieutenant Governor,Todd Lamb,REP,720455,0,0,241,241,
Tulsa,Superintendent of Public Instruction,John Cox,DEM,720455,0,0,117,117,
Tulsa,Superintendent of Public Instruction,Joy Hofmeister,REP,720455,0,0,226,226,
Tulsa,Commissioner of Labor,Mike Workman,DEM,720455,0,0,107,107,
Tulsa,Commissioner of Labor,Mark Costello,REP,720455,0,0,228,228,
Tulsa,U.S. Senate,Matt Silverstein,DEM,720455,0,0,99,99,
Tulsa,U.S. Senate,Jim Inhofe,REP,720455,0,0,231,231,
Tulsa,U.S. Senate,Aaron Delozier,IND,720455,0,0,6,6,
Tulsa,U.S. Senate,Ray Woods,IND,720455,0,0,2,2,
Tulsa,U.S. Senate,Joan Farr,IND,720455,0,0,4,4,
Tulsa,U.S. Senate,Connie Johnson,DEM,720455,0,0,91,91,
Tulsa,U.S. Senate,James Lankford,REP,720455,0,0,243,243,
Tulsa,U.S. Senate,Mark Beard,IND,720455,0,0,10,10,
Tulsa,State House,Glenda Puett,DEM,720455,0,0,114,114,76
Tulsa,State House,David Brumbaugh,REP,720455,0,0,227,227,76
Tulsa,Governor,Joe Dorman,DEM,720456,0,0,165,165,
Tulsa,Governor,Mary Fallin,REP,720456,0,0,362,362,
Tulsa,Governor,Kimberly Willis,IND,720456,0,0,13,13,
Tulsa,Governor,Richard Prawdzienski,IND,720456,0,0,6,6,
Tulsa,Lieutenant Governor,Cathy Cummings,DEM,720456,0,0,124,124,
Tulsa,Lieutenant Governor,Todd Lamb,REP,720456,0,0,422,422,
Tulsa,Superintendent of Public Instruction,John Cox,DEM,720456,0,0,158,158,
Tulsa,Superintendent of Public Instruction,Joy Hofmeister,REP,720456,0,0,387,387,
Tulsa,Commissioner of Labor,Mike Workman,DEM,720456,0,0,139,139,
Tulsa,Commissioner of Labor,Mark Costello,REP,720456,0,0,399,399,
Tulsa,U.S. Senate,Matt Silverstein,DEM,720456,0,0,134,134,
Tulsa,U.S. Senate,Jim Inhofe,REP,720456,0,0,392,392,
Tulsa,U.S. Senate,Aaron Delozier,IND,720456,0,0,8,8,
Tulsa,U.S. Senate,Ray Woods,IND,720456,0,0,4,4,
Tulsa,U.S. Senate,Joan Farr,IND,720456,0,0,7,7,
Tulsa,U.S. Senate,Connie Johnson,DEM,720456,0,0,128,128,
Tulsa,U.S. Senate,James Lankford,REP,720456,0,0,407,407,
Tulsa,U.S. Senate,Mark Beard,IND,720456,0,0,11,11,
Tulsa,State House,Glenda Puett,DEM,720456,0,0,132,132,76
Tulsa,State House,David Brumbaugh,REP,720456,0,0,410,410,76
Tulsa,Governor,Joe Dorman,DEM,720457,0,0,0,0,
Tulsa,Governor,Mary Fallin,REP,720457,0,0,5,5,
Tulsa,Governor,Kimberly Willis,IND,720457,0,0,0,0,
Tulsa,Governor,Richard Prawdzienski,IND,720457,0,0,0,0,
Tulsa,Lieutenant Governor,Cathy Cummings,DEM,720457,0,0,0,0,
Tulsa,Lieutenant Governor,Todd Lamb,REP,720457,0,0,5,5,
Tulsa,Superintendent of Public Instruction,John Cox,DEM,720457,0,0,0,0,
Tulsa,Superintendent of Public Instruction,Joy Hofmeister,REP,720457,0,0,5,5,
Tulsa,Commissioner of Labor,Mike Workman,DEM,720457,0,0,0,0,
Tulsa,Commissioner of Labor,Mark Costello,REP,720457,0,0,5,5,
Tulsa,U.S. Senate,Matt Silverstein,DEM,720457,0,0,0,0,
Tulsa,U.S. Senate,Jim Inhofe,REP,720457,0,0,5,5,
Tulsa,U.S. Senate,Aaron Delozier,IND,720457,0,0,0,0,
Tulsa,U.S. Senate,Ray Woods,IND,720457,0,0,0,0,
Tulsa,U.S. Senate,Joan Farr,IND,720457,0,0,0,0,
Tulsa,U.S. Senate,Connie Johnson,DEM,720457,0,0,0,0,
Tulsa,U.S. Senate,James Lankford,REP,720457,0,0,5,5,
Tulsa,U.S. Senate,Mark Beard,IND,720457,0,0,0,0,
Tulsa,State Senate,Charles Arnall,DEM,720457,0,0,0,0,18
Tulsa,State Senate,Kim David,REP,720457,0,0,5,5,18
Tulsa,Governor,Joe Dorman,DEM,720458,0,0,345,345,
Tulsa,Governor,Mary Fallin,REP,720458,0,0,638,638,
Tulsa,Governor,Kimberly Willis,IND,720458,0,0,19,19,
Tulsa,Governor,Richard Prawdzienski,IND,720458,0,0,15,15,
Tulsa,Lieutenant Governor,Cathy Cummings,DEM,720458,0,0,270,270,
Tulsa,Lieutenant Governor,Todd Lamb,REP,720458,0,0,745,745,
Tulsa,Superintendent of Public Instruction,John Cox,DEM,720458,0,0,323,323,
Tulsa,Superintendent of Public Instruction,Joy Hofmeister,REP,720458,0,0,691,691,
Tulsa,Commissioner of Labor,Mike Workman,DEM,720458,0,0,279,279,
Tulsa,Commissioner of Labor,Mark Costello,REP,720458,0,0,721,721,
Tulsa,U.S. Senate,Matt Silverstein,DEM,720458,0,0,258,258,
Tulsa,U.S. Senate,Jim Inhofe,REP,720458,0,0,727,727,
Tulsa,U.S. Senate,Aaron Delozier,IND,720458,0,0,13,13,
Tulsa,U.S. Senate,Ray Woods,IND,720458,0,0,10,10,
Tulsa,U.S. Senate,Joan Farr,IND,720458,0,0,7,7,
Tulsa,U.S. Senate,Connie Johnson,DEM,720458,0,0,246,246,
Tulsa,U.S. Senate,James Lankford,REP,720458,0,0,724,724,
Tulsa,U.S. Senate,Mark Beard,IND,720458,0,0,41,41,
Tulsa,State House,Glenda Puett,DEM,720458,0,0,290,290,76
Tulsa,State House,David Brumbaugh,REP,720458,0,0,716,716,76
Tulsa,Governor,Joe Dorman,DEM,720459,0,0,101,101,
Tulsa,Governor,Mary Fallin,REP,720459,0,0,253,253,
Tulsa,Governor,Kimberly Willis,IND,720459,0,0,10,10,
Tulsa,Governor,Richard Prawdzienski,IND,720459,0,0,4,4,
Tulsa,Lieutenant Governor,Cathy Cummings,DEM,720459,0,0,83,83,
Tulsa,Lieutenant Governor,Todd Lamb,REP,720459,0,0,286,286,
Tulsa,Superintendent of Public Instruction,John Cox,DEM,720459,0,0,106,106,
Tulsa,Superintendent of Public Instruction,Joy Hofmeister,REP,720459,0,0,262,262,
Tulsa,Commissioner of Labor,Mike Workman,DEM,720459,0,0,89,89,
Tulsa,Commissioner of Labor,Mark Costello,REP,720459,0,0,274,274,
Tulsa,U.S. Senate,Matt Silverstein,DEM,720459,0,0,78,78,
Tulsa,U.S. Senate,Jim Inhofe,REP,720459,0,0,276,276,
Tulsa,U.S. Senate,Aaron Delozier,IND,720459,0,0,1,1,
Tulsa,U.S. Senate,Ray Woods,IND,720459,0,0,6,6,
Tulsa,U.S. Senate,Joan Farr,IND,720459,0,0,6,6,
Tulsa,U.S. Senate,Connie Johnson,DEM,720459,0,0,69,69,
Tulsa,U.S. Senate,James Lankford,REP,720459,0,0,291,291,
Tulsa,U.S. Senate,Mark Beard,IND,720459,0,0,6,6,
Tulsa,Governor,Joe Dorman,DEM,720460,0,0,128,128,
Tulsa,Governor,Mary Fallin,REP,720460,0,0,369,369,
Tulsa,Governor,Kimberly Willis,IND,720460,0,0,6,6,
Tulsa,Governor,Richard Prawdzienski,IND,720460,0,0,2,2,
Tulsa,Lieutenant Governor,Cathy Cummings,DEM,720460,0,0,74,74,
Tulsa,Lieutenant Governor,Todd Lamb,REP,720460,0,0,433,433,
Tulsa,Superintendent of Public Instruction,John Cox,DEM,720460,0,0,122,122,
Tulsa,Superintendent of Public Instruction,Joy Hofmeister,REP,720460,0,0,384,384,
Tulsa,Commissioner of Labor,Mike Workman,DEM,720460,0,0,76,76,
Tulsa,Commissioner of Labor,Mark Costello,REP,720460,0,0,427,427,
Tulsa,U.S. Senate,Matt Silverstein,DEM,720460,0,0,82,82,
Tulsa,U.S. Senate,Jim Inhofe,REP,720460,0,0,410,410,
Tulsa,U.S. Senate,Aaron Delozier,IND,720460,0,0,5,5,
Tulsa,U.S. Senate,Ray Woods,IND,720460,0,0,5,5,
Tulsa,U.S. Senate,Joan Farr,IND,720460,0,0,5,5,
Tulsa,U.S. Senate,Connie Johnson,DEM,720460,0,0,73,73,
Tulsa,U.S. Senate,James Lankford,REP,720460,0,0,421,421,
Tulsa,U.S. Senate,Mark Beard,IND,720460,0,0,14,14,
Tulsa,Governor,Joe Dorman,DEM,720461,0,0,167,167,
Tulsa,Governor,Mary Fallin,REP,720461,0,0,302,302,
Tulsa,Governor,Kimberly Willis,IND,720461,0,0,9,9,
Tulsa,Governor,Richard Prawdzienski,IND,720461,0,0,15,15,
Tulsa,Lieutenant Governor,Cathy Cummings,DEM,720461,0,0,126,126,
Tulsa,Lieutenant Governor,Todd Lamb,REP,720461,0,0,365,365,
Tulsa,Superintendent of Public Instruction,John Cox,DEM,720461,0,0,157,157,
Tulsa,Superintendent of Public Instruction,Joy Hofmeister,REP,720461,0,0,333,333,
Tulsa,Commissioner of Labor,Mike Workman,DEM,720461,0,0,142,142,
Tulsa,Commissioner of Labor,Mark Costello,REP,720461,0,0,344,344,
Tulsa,U.S. Senate,Matt Silverstein,DEM,720461,0,0,119,119,
Tulsa,U.S. Senate,Jim Inhofe,REP,720461,0,0,357,357,
Tulsa,U.S. Senate,Aaron Delozier,IND,720461,0,0,5,5,
Tulsa,U.S. Senate,Ray Woods,IND,720461,0,0,7,7,
Tulsa,U.S. Senate,Joan Farr,IND,720461,0,0,6,6,
Tulsa,U.S. Senate,Connie Johnson,DEM,720461,0,0,107,107,
Tulsa,U.S. Senate,James Lankford,REP,720461,0,0,370,370,
Tulsa,U.S. Senate,Mark Beard,IND,720461,0,0,16,16,
Tulsa,Governor,Joe Dorman,DEM,720462,0,0,219,219,
Tulsa,Governor,Mary Fallin,REP,720462,0,0,520,520,
Tulsa,Governor,Kimberly Willis,IND,720462,0,0,14,14,
Tulsa,Governor,Richard Prawdzienski,IND,720462,0,0,6,6,
Tulsa,Lieutenant Governor,Cathy Cummings,DEM,720462,0,0,173,173,
Tulsa,Lieutenant Governor,Todd Lamb,REP,720462,0,0,587,587,
Tulsa,Superintendent of Public Instruction,John Cox,DEM,720462,0,0,235,235,
Tulsa,Superintendent of Public Instruction,Joy Hofmeister,REP,720462,0,0,524,524,
Tulsa,Commissioner of Labor,Mike Workman,DEM,720462,0,0,187,187,
Tulsa,Commissioner of Labor,Mark Costello,REP,720462,0,0,555,555,
Tulsa,U.S. Senate,Matt Silverstein,DEM,720462,0,0,170,170,
Tulsa,U.S. Senate,Jim Inhofe,REP,720462,0,0,570,570,
Tulsa,U.S. Senate,Aaron Delozier,IND,720462,0,0,7,7,
Tulsa,U.S. Senate,Ray Woods,IND,720462,0,0,5,5,
Tulsa,U.S. Senate,Joan Farr,IND,720462,0,0,8,8,
Tulsa,U.S. Senate,Connie Johnson,DEM,720462,0,0,160,160,
Tulsa,U.S. Senate,James Lankford,REP,720462,0,0,582,582,
Tulsa,U.S. Senate,Mark Beard,IND,720462,0,0,19,19,
Tulsa,State House,Glenda Puett,DEM,720462,0,0,186,186,76
Tulsa,State House,David Brumbaugh,REP,720462,0,0,564,564,76
Tulsa,Governor,Joe Dorman,DEM,720463,0,0,129,129,
Tulsa,Governor,Mary Fallin,REP,720463,0,0,292,292,
Tulsa,Governor,Kimberly Willis,IND,720463,0,0,7,7,
Tulsa,Governor,Richard Prawdzienski,IND,720463,0,0,9,9,
Tulsa,Lieutenant Governor,Cathy Cummings,DEM,720463,0,0,99,99,
Tulsa,Lieutenant Governor,Todd Lamb,REP,720463,0,0,336,336,
Tulsa,Superintendent of Public Instruction,John Cox,DEM,720463,0,0,126,126,
Tulsa,Superintendent of Public Instruction,Joy Hofmeister,REP,720463,0,0,308,308,
Tulsa,Commissioner of Labor,Mike Workman,DEM,720463,0,0,116,116,
Tulsa,Commissioner of Labor,Mark Costello,REP,720463,0,0,315,315,
Tulsa,U.S. Senate,Matt Silverstein,DEM,720463,0,0,99,99,
Tulsa,U.S. Senate,Jim Inhofe,REP,720463,0,0,323,323,
Tulsa,U.S. Senate,Aaron Delozier,IND,720463,0,0,2,2,
Tulsa,U.S. Senate,Ray Woods,IND,720463,0,0,3,3,
Tulsa,U.S. Senate,Joan Farr,IND,720463,0,0,6,6,
Tulsa,U.S. Senate,Connie Johnson,DEM,720463,0,0,94,94,
Tulsa,U.S. Senate,James Lankford,REP,720463,0,0,328,328,
Tulsa,U.S. Senate,Mark Beard,IND,720463,0,0,14,14,
Tulsa,State House,Glenda Puett,DEM,720463,0,0,116,116,76
Tulsa,State House,David Brumbaugh,REP,720463,0,0,319,319,76
Tulsa,Governor,Joe Dorman,DEM,720464,0,0,294,294,
Tulsa,Governor,Mary Fallin,REP,720464,0,0,689,689,
Tulsa,Governor,Kimberly Willis,IND,720464,0,0,16,16,
Tulsa,Governor,Richard Prawdzienski,IND,720464,0,0,17,17,
Tulsa,Lieutenant Governor,Cathy Cummings,DEM,720464,0,0,218,218,
Tulsa,Lieutenant Governor,Todd Lamb,REP,720464,0,0,790,790,
Tulsa,Superintendent of Public Instruction,John Cox,DEM,720464,0,0,289,289,
Tulsa,Superintendent of Public Instruction,Joy Hofmeister,REP,720464,0,0,724,724,
Tulsa,Commissioner of Labor,Mike Workman,DEM,720464,0,0,232,232,
Tulsa,Commissioner of Labor,Mark Costello,REP,720464,0,0,761,761,
Tulsa,U.S. Senate,Matt Silverstein,DEM,720464,0,0,213,213,
Tulsa,U.S. Senate,Jim Inhofe,REP,720464,0,0,771,771,
Tulsa,U.S. Senate,Aaron Delozier,IND,720464,0,0,11,11,
Tulsa,U.S. Senate,Ray Woods,IND,720464,0,0,9,9,
Tulsa,U.S. Senate,Joan Farr,IND,720464,0,0,8,8,
Tulsa,U.S. Senate,Connie Johnson,DEM,720464,0,0,194,194,
Tulsa,U.S. Senate,James Lankford,REP,720464,0,0,781,781,
Tulsa,U.S. Senate,Mark Beard,IND,720464,0,0,29,29,
Tulsa,Governor,Joe Dorman,DEM,720465,0,0,305,305,
Tulsa,Governor,Mary Fallin,REP,720465,0,0,436,436,
Tulsa,Governor,Kimberly Willis,IND,720465,0,0,13,13,
Tulsa,Governor,Richard Prawdzienski,IND,720465,0,0,7,7,
Tulsa,Lieutenant Governor,Cathy Cummings,DEM,720465,0,0,249,249,
Tulsa,Lieutenant Governor,Todd Lamb,REP,720465,0,0,512,512,
Tulsa,Superintendent of Public Instruction,John Cox,DEM,720465,0,0,299,299,
Tulsa,Superintendent of Public Instruction,Joy Hofmeister,REP,720465,0,0,462,462,
Tulsa,Commissioner of Labor,Mike Workman,DEM,720465,0,0,265,265,
Tulsa,Commissioner of Labor,Mark Costello,REP,720465,0,0,479,479,
Tulsa,U.S. Senate,Matt Silverstein,DEM,720465,0,0,256,256,
Tulsa,U.S. Senate,Jim Inhofe,REP,720465,0,0,485,485,
Tulsa,U.S. Senate,Aaron Delozier,IND,720465,0,0,5,5,
Tulsa,U.S. Senate,Ray Woods,IND,720465,0,0,4,4,
Tulsa,U.S. Senate,Joan Farr,IND,720465,0,0,7,7,
Tulsa,U.S. Senate,Connie Johnson,DEM,720465,0,0,237,237,
Tulsa,U.S. Senate,James Lankford,REP,720465,0,0,502,502,
Tulsa,U.S. Senate,Mark Beard,IND,720465,0,0,20,20,
Tulsa,State House,Glenda Puett,DEM,720465,0,0,255,255,76
Tulsa,State House,David Brumbaugh,REP,720465,0,0,496,496,76
Tulsa,Governor,Joe Dorman,DEM,720466,0,0,219,219,
Tulsa,Governor,Mary Fallin,REP,720466,0,0,494,494,
Tulsa,Governor,Kimberly Willis,IND,720466,0,0,10,10,
Tulsa,Governor,Richard Prawdzienski,IND,720466,0,0,8,8,
Tulsa,Lieutenant Governor,Cathy Cummings,DEM,720466,0,0,159,159,
Tulsa,Lieutenant Governor,Todd Lamb,REP,720466,0,0,570,570,
Tulsa,Superintendent of Public Instruction,John Cox,DEM,720466,0,0,210,210,
Tulsa,Superintendent of Public Instruction,Joy Hofmeister,REP,720466,0,0,520,520,
Tulsa,Commissioner of Labor,Mike Workman,DEM,720466,0,0,203,203,
Tulsa,Commissioner of Labor,Mark Costello,REP,720466,0,0,511,511,
Tulsa,U.S. Senate,Matt Silverstein,DEM,720466,0,0,164,164,
Tulsa,U.S. Senate,Jim Inhofe,REP,720466,0,0,547,547,
Tulsa,U.S. Senate,Aaron Delozier,IND,720466,0,0,5,5,
Tulsa,U.S. Senate,Ray Woods,IND,720466,0,0,6,6,
Tulsa,U.S. Senate,Joan Farr,IND,720466,0,0,8,8,
Tulsa,U.S. Senate,Connie Johnson,DEM,720466,0,0,158,158,
Tulsa,U.S. Senate,James Lankford,REP,720466,0,0,551,551,
Tulsa,U.S. Senate,Mark Beard,IND,720466,0,0,18,18,
Tulsa,Governor,Joe Dorman,DEM,720467,0,0,22,22,
Tulsa,Governor,Mary Fallin,REP,720467,0,0,75,75,
Tulsa,Governor,Kimberly Willis,IND,720467,0,0,0,0,
Tulsa,Governor,Richard Prawdzienski,IND,720467,0,0,0,0,
Tulsa,Lieutenant Governor,Cathy Cummings,DEM,720467,0,0,16,16,
Tulsa,Lieutenant Governor,Todd Lamb,REP,720467,0,0,79,79,
Tulsa,Superintendent of Public Instruction,John Cox,DEM,720467,0,0,23,23,
Tulsa,Superintendent of Public Instruction,Joy Hofmeister,REP,720467,0,0,73,73,
Tulsa,Commissioner of Labor,Mike Workman,DEM,720467,0,0,21,21,
Tulsa,Commissioner of Labor,Mark Costello,REP,720467,0,0,73,73,
Tulsa,U.S. Senate,Matt Silverstein,DEM,720467,0,0,18,18,
Tulsa,U.S. Senate,Jim Inhofe,REP,720467,0,0,77,77,
Tulsa,U.S. Senate,Aaron Delozier,IND,720467,0,0,1,1,
Tulsa,U.S. Senate,Ray Woods,IND,720467,0,0,0,0,
Tulsa,U.S. Senate,Joan Farr,IND,720467,0,0,1,1,
Tulsa,U.S. Senate,Connie Johnson,DEM,720467,0,0,18,18,
Tulsa,U.S. Senate,James Lankford,REP,720467,0,0,77,77,
Tulsa,U.S. Senate,Mark Beard,IND,720467,0,0,1,1,
Tulsa,Governor,Joe Dorman,DEM,720468,0,0,256,256,
Tulsa,Governor,Mary Fallin,REP,720468,0,0,553,553,
Tulsa,Governor,Kimberly Willis,IND,720468,0,0,13,13,
Tulsa,Governor,Richard Prawdzienski,IND,720468,0,0,7,7,
Tulsa,Lieutenant Governor,Cathy Cummings,DEM,720468,0,0,182,182,
Tulsa,Lieutenant Governor,Todd Lamb,REP,720468,0,0,645,645,
Tulsa,Superintendent of Public Instruction,John Cox,DEM,720468,0,0,239,239,
Tulsa,Superintendent of Public Instruction,Joy Hofmeister,REP,720468,0,0,587,587,
Tulsa,Commissioner of Labor,Mike Workman,DEM,720468,0,0,199,199,
Tulsa,Commissioner of Labor,Mark Costello,REP,720468,0,0,606,606,
Tulsa,U.S. Senate,Matt Silverstein,DEM,720468,0,0,184,184,
Tulsa,U.S. Senate,Jim Inhofe,REP,720468,0,0,623,623,
Tulsa,U.S. Senate,Aaron Delozier,IND,720468,0,0,6,6,
Tulsa,U.S. Senate,Ray Woods,IND,720468,0,0,2,2,
Tulsa,U.S. Senate,Joan Farr,IND,720468,0,0,8,8,
Tulsa,U.S. Senate,Connie Johnson,DEM,720468,0,0,165,165,
Tulsa,U.S. Senate,James Lankford,REP,720468,0,0,637,637,
Tulsa,U.S. Senate,Mark Beard,IND,720468,0,0,21,21,
Tulsa,State House,Glenda Puett,DEM,720468,0,0,204,204,76
Tulsa,State House,David Brumbaugh,REP,720468,0,0,613,613,76
Tulsa,Governor,Joe Dorman,DEM,720469,0,0,75,75,
Tulsa,Governor,Mary Fallin,REP,720469,0,0,100,100,
Tulsa,Governor,Kimberly Willis,IND,720469,0,0,6,6,
Tulsa,Governor,Richard Prawdzienski,IND,720469,0,0,2,2,
Tulsa,Lieutenant Governor,Cathy Cummings,DEM,720469,0,0,57,57,
Tulsa,Lieutenant Governor,Todd Lamb,REP,720469,0,0,124,124,
Tulsa,Superintendent of Public Instruction,John Cox,DEM,720469,0,0,80,80,
Tulsa,Superintendent of Public Instruction,Joy Hofmeister,REP,720469,0,0,101,101,
Tulsa,Commissioner of Labor,Mike Workman,DEM,720469,0,0,71,71,
Tulsa,Commissioner of Labor,Mark Costello,REP,720469,0,0,105,105,
Tulsa,U.S. Senate,Matt Silverstein,DEM,720469,0,0,55,55,
Tulsa,U.S. Senate,Jim Inhofe,REP,720469,0,0,113,113,
Tulsa,U.S. Senate,Aaron Delozier,IND,720469,0,0,6,6,
Tulsa,U.S. Senate,Ray Woods,IND,720469,0,0,3,3,
Tulsa,U.S. Senate,Joan Farr,IND,720469,0,0,3,3,
Tulsa,U.S. Senate,Connie Johnson,DEM,720469,0,0,58,58,
Tulsa,U.S. Senate,James Lankford,REP,720469,0,0,117,117,
Tulsa,U.S. Senate,Mark Beard,IND,720469,0,0,6,6,
Tulsa,Governor,Joe Dorman,DEM,720470,0,0,277,277,
Tulsa,Governor,Mary Fallin,REP,720470,0,0,567,567,
Tulsa,Governor,Kimberly Willis,IND,720470,0,0,14,14,
Tulsa,Governor,Richard Prawdzienski,IND,720470,0,0,4,4,
Tulsa,Lieutenant Governor,Cathy Cummings,DEM,720470,0,0,221,221,
Tulsa,Lieutenant Governor,Todd Lamb,REP,720470,0,0,638,638,
Tulsa,Superintendent of Public Instruction,John Cox,DEM,720470,0,0,241,241,
Tulsa,Superintendent of Public Instruction,Joy Hofmeister,REP,720470,0,0,617,617,
Tulsa,Commissioner of Labor,Mike Workman,DEM,720470,0,0,238,238,
Tulsa,Commissioner of Labor,Mark Costello,REP,720470,0,0,601,601,
Tulsa,U.S. Senate,Matt Silverstein,DEM,720470,0,0,220,220,
Tulsa,U.S. Senate,Jim Inhofe,REP,720470,0,0,622,622,
Tulsa,U.S. Senate,Aaron Delozier,IND,720470,0,0,6,6,
Tulsa,U.S. Senate,Ray Woods,IND,720470,0,0,2,2,
Tulsa,U.S. Senate,Joan Farr,IND,720470,0,0,8,8,
Tulsa,U.S. Senate,Connie Johnson,DEM,720470,0,0,199,199,
Tulsa,U.S. Senate,James Lankford,REP,720470,0,0,637,637,
Tulsa,U.S. Senate,Mark Beard,IND,720470,0,0,23,23,
Tulsa,State House,Glenda Puett,DEM,720470,0,0,244,244,76
Tulsa,State House,David Brumbaugh,REP,720470,0,0,607,607,76
Tulsa,Governor,Joe Dorman,DEM,720471,0,0,111,111,
Tulsa,Governor,Mary Fallin,REP,720471,0,0,309,309,
Tulsa,Governor,Kimberly Willis,IND,720471,0,0,4,4,
Tulsa,Governor,Richard Prawdzienski,IND,720471,0,0,2,2,
Tulsa,Lieutenant Governor,Cathy Cummings,DEM,720471,0,0,76,76,
Tulsa,Lieutenant Governor,Todd Lamb,REP,720471,0,0,347,347,
Tulsa,Superintendent of Public Instruction,John Cox,DEM,720471,0,0,98,98,
Tulsa,Superintendent of Public Instruction,Joy Hofmeister,REP,720471,0,0,326,326,
Tulsa,Commissioner of Labor,Mike Workman,DEM,720471,0,0,83,83,
Tulsa,Commissioner of Labor,Mark Costello,REP,720471,0,0,329,329,
Tulsa,U.S. Senate,Matt Silverstein,DEM,720471,0,0,86,86,
Tulsa,U.S. Senate,Jim Inhofe,REP,720471,0,0,333,333,
Tulsa,U.S. Senate,Aaron Delozier,IND,720471,0,0,2,2,
Tulsa,U.S. Senate,Ray Woods,IND,720471,0,0,1,1,
Tulsa,U.S. Senate,Joan Farr,IND,720471,0,0,3,3,
Tulsa,U.S. Senate,Connie Johnson,DEM,720471,0,0,67,67,
Tulsa,U.S. Senate,James Lankford,REP,720471,0,0,349,349,
Tulsa,U.S. Senate,Mark Beard,IND,720471,0,0,7,7,
Tulsa,State House,Glenda Puett,DEM,720471,0,0,89,89,76
Tulsa,State House,David Brumbaugh,REP,720471,0,0,330,330,76
Tulsa,Governor,Joe Dorman,DEM,720472,0,0,96,96,
Tulsa,Governor,Mary Fallin,REP,720472,0,0,211,211,
Tulsa,Governor,Kimberly Willis,IND,720472,0,0,6,6,
Tulsa,Governor,Richard Prawdzienski,IND,720472,0,0,3,3,
Tulsa,Lieutenant Governor,Cathy Cummings,DEM,720472,0,0,62,62,
Tulsa,Lieutenant Governor,Todd Lamb,REP,720472,0,0,255,255,
Tulsa,Superintendent of Public Instruction,John Cox,DEM,720472,0,0,86,86,
Tulsa,Superintendent of Public Instruction,Joy Hofmeister,REP,720472,0,0,231,231,
Tulsa,Commissioner of Labor,Mike Workman,DEM,720472,0,0,69,69,
Tulsa,Commissioner of Labor,Mark Costello,REP,720472,0,0,239,239,
Tulsa,U.S. Senate,Matt Silverstein,DEM,720472,0,0,66,66,
Tulsa,U.S. Senate,Jim Inhofe,REP,720472,0,0,244,244,
Tulsa,U.S. Senate,Aaron Delozier,IND,720472,0,0,1,1,
Tulsa,U.S. Senate,Ray Woods,IND,720472,0,0,1,1,
Tulsa,U.S. Senate,Joan Farr,IND,720472,0,0,5,5,
Tulsa,U.S. Senate,Connie Johnson,DEM,720472,0,0,57,57,
Tulsa,U.S. Senate,James Lankford,REP,720472,0,0,252,252,
Tulsa,U.S. Senate,Mark Beard,IND,720472,0,0,8,8,
Tulsa,Governor,Joe Dorman,DEM,720473,0,0,131,131,
Tulsa,Governor,Mary Fallin,REP,720473,0,0,336,336,
Tulsa,Governor,Kimberly Willis,IND,720473,0,0,6,6,
Tulsa,Governor,Richard Prawdzienski,IND,720473,0,0,7,7,
Tulsa,Lieutenant Governor,Cathy Cummings,DEM,720473,0,0,93,93,
Tulsa,Lieutenant Governor,Todd Lamb,REP,720473,0,0,385,385,
Tulsa,Superintendent of Public Instruction,John Cox,DEM,720473,0,0,133,133,
Tulsa,Superintendent of Public Instruction,Joy Hofmeister,REP,720473,0,0,342,342,
Tulsa,Commissioner of Labor,Mike Workman,DEM,720473,0,0,103,103,
Tulsa,Commissioner of Labor,Mark Costello,REP,720473,0,0,367,367,
Tulsa,U.S. Senate,Matt Silverstein,DEM,720473,0,0,88,88,
Tulsa,U.S. Senate,Jim Inhofe,REP,720473,0,0,380,380,
Tulsa,U.S. Senate,Aaron Delozier,IND,720473,0,0,1,1,
Tulsa,U.S. Senate,Ray Woods,IND,720473,0,0,7,7,
Tulsa,U.S. Senate,Joan Farr,IND,720473,0,0,5,5,
Tulsa,U.S. Senate,Connie Johnson,DEM,720473,0,0,89,89,
Tulsa,U.S. Senate,James Lankford,REP,720473,0,0,374,374,
Tulsa,U.S. Senate,Mark Beard,IND,720473,0,0,17,17,
Tulsa,Governor,Joe Dorman,DEM,720474,0,0,300,300,
Tulsa,Governor,Mary Fallin,REP,720474,0,0,623,623,
Tulsa,Governor,Kimberly Willis,IND,720474,0,0,15,15,
Tulsa,Governor,Richard Prawdzienski,IND,720474,0,0,7,7,
Tulsa,Lieutenant Governor,Cathy Cummings,DEM,720474,0,0,239,239,
Tulsa,Lieutenant Governor,Todd Lamb,REP,720474,0,0,703,703,
Tulsa,Superintendent of Public Instruction,John Cox,DEM,720474,0,0,307,307,
Tulsa,Superintendent of Public Instruction,Joy Hofmeister,REP,720474,0,0,635,635,
Tulsa,Commissioner of Labor,Mike Workman,DEM,720474,0,0,259,259,
Tulsa,Commissioner of Labor,Mark Costello,REP,720474,0,0,668,668,
Tulsa,U.S. Senate,Matt Silverstein,DEM,720474,0,0,220,220,
Tulsa,U.S. Senate,Jim Inhofe,REP,720474,0,0,693,693,
Tulsa,U.S. Senate,Aaron Delozier,IND,720474,0,0,5,5,
Tulsa,U.S. Senate,Ray Woods,IND,720474,0,0,9,9,
Tulsa,U.S. Senate,Joan Farr,IND,720474,0,0,10,10,
Tulsa,U.S. Senate,Connie Johnson,DEM,720474,0,0,213,213,
Tulsa,U.S. Senate,James Lankford,REP,720474,0,0,703,703,
Tulsa,U.S. Senate,Mark Beard,IND,720474,0,0,25,25,
Tulsa,State House,Glenda Puett,DEM,720474,0,0,267,267,76
Tulsa,State House,David Brumbaugh,REP,720474,0,0,667,667,76
Tulsa,Governor,Joe Dorman,DEM,720475,0,0,269,269,
Tulsa,Governor,Mary Fallin,REP,720475,0,0,557,557,
Tulsa,Governor,Kimberly Willis,IND,720475,0,0,13,13,
Tulsa,Governor,Richard Prawdzienski,IND,720475,0,0,9,9,
Tulsa,Lieutenant Governor,Cathy Cummings,DEM,720475,0,0,181,181,
Tulsa,Lieutenant Governor,Todd Lamb,REP,720475,0,0,661,661,
Tulsa,Superintendent of Public Instruction,John Cox,DEM,720475,0,0,262,262,
Tulsa,Superintendent of Public Instruction,Joy Hofmeister,REP,720475,0,0,582,582,
Tulsa,Commissioner of Labor,Mike Workman,DEM,720475,0,0,203,203,
Tulsa,Commissioner of Labor,Mark Costello,REP,720475,0,0,619,619,
Tulsa,U.S. Senate,Matt Silverstein,DEM,720475,0,0,204,204,
Tulsa,U.S. Senate,Jim Inhofe,REP,720475,0,0,624,624,
Tulsa,U.S. Senate,Aaron Delozier,IND,720475,0,0,4,4,
Tulsa,U.S. Senate,Ray Woods,IND,720475,0,0,5,5,
Tulsa,U.S. Senate,Joan Farr,IND,720475,0,0,8,8,
Tulsa,U.S. Senate,Connie Johnson,DEM,720475,0,0,179,179,
Tulsa,U.S. Senate,James Lankford,REP,720475,0,0,656,656,
Tulsa,U.S. Senate,Mark Beard,IND,720475,0,0,11,11,
Tulsa,Governor,Joe Dorman,DEM,720476,0,0,87,87,
Tulsa,Governor,Mary Fallin,REP,720476,0,0,206,206,
Tulsa,Governor,Kimberly Willis,IND,720476,0,0,5,5,
Tulsa,Governor,Richard Prawdzienski,IND,720476,0,0,2,2,
Tulsa,Lieutenant Governor,Cathy Cummings,DEM,720476,0,0,51,51,
Tulsa,Lieutenant Governor,Todd Lamb,REP,720476,0,0,247,247,
Tulsa,Superintendent of Public Instruction,John Cox,DEM,720476,0,0,87,87,
Tulsa,Superintendent of Public Instruction,Joy Hofmeister,REP,720476,0,0,211,211,
Tulsa,Commissioner of Labor,Mike Workman,DEM,720476,0,0,57,57,
Tulsa,Commissioner of Labor,Mark Costello,REP,720476,0,0,237,237,
Tulsa,U.S. Senate,Matt Silverstein,DEM,720476,0,0,62,62,
Tulsa,U.S. Senate,Jim Inhofe,REP,720476,0,0,224,224,
Tulsa,U.S. Senate,Aaron Delozier,IND,720476,0,0,4,4,
Tulsa,U.S. Senate,Ray Woods,IND,720476,0,0,4,4,
Tulsa,U.S. Senate,Joan Farr,IND,720476,0,0,4,4,
Tulsa,U.S. Senate,Connie Johnson,DEM,720476,0,0,52,52,
Tulsa,U.S. Senate,James Lankford,REP,720476,0,0,241,241,
Tulsa,U.S. Senate,Mark Beard,IND,720476,0,0,6,6,
Tulsa,State Senate,Charles Arnall,DEM,720476,0,0,57,57,18
Tulsa,State Senate,Kim David,REP,720476,0,0,238,238,18
Tulsa,Governor,Joe Dorman,DEM,720501,0,0,118,118,
Tulsa,Governor,Mary Fallin,REP,720501,0,0,244,244,
Tulsa,Governor,Kimberly Willis,IND,720501,0,0,0,0,
Tulsa,Governor,Richard Prawdzienski,IND,720501,0,0,3,3,
Tulsa,Lieutenant Governor,Cathy Cummings,DEM,720501,0,0,70,70,
Tulsa,Lieutenant Governor,Todd Lamb,REP,720501,0,0,293,293,
Tulsa,Superintendent of Public Instruction,John Cox,DEM,720501,0,0,123,123,
Tulsa,Superintendent of Public Instruction,Joy Hofmeister,REP,720501,0,0,238,238,
Tulsa,Commissioner of Labor,Mike Workman,DEM,720501,0,0,86,86,
Tulsa,Commissioner of Labor,Mark Costello,REP,720501,0,0,269,269,
Tulsa,U.S. Senate,Matt Silverstein,DEM,720501,0,0,74,74,
Tulsa,U.S. Senate,Jim Inhofe,REP,720501,0,0,285,285,
Tulsa,U.S. Senate,Aaron Delozier,IND,720501,0,0,0,0,
Tulsa,U.S. Senate,Ray Woods,IND,720501,0,0,3,3,
Tulsa,U.S. Senate,Joan Farr,IND,720501,0,0,1,1,
Tulsa,U.S. Senate,Connie Johnson,DEM,720501,0,0,71,71,
Tulsa,U.S. Senate,James Lankford,REP,720501,0,0,285,285,
Tulsa,U.S. Senate,Mark Beard,IND,720501,0,0,8,8,
Tulsa,State House,Jim Massey,DEM,720501,0,0,94,94,36
Tulsa,State House,Sean Roberts,REP,720501,0,0,263,263,36
Tulsa,Governor,Joe Dorman,DEM,720502,0,0,235,235,
Tulsa,Governor,Mary Fallin,REP,720502,0,0,442,442,
Tulsa,Governor,Kimberly Willis,IND,720502,0,0,13,13,
Tulsa,Governor,Richard Prawdzienski,IND,720502,0,0,5,5,
Tulsa,Lieutenant Governor,Cathy Cummings,DEM,720502,0,0,187,187,
Tulsa,Lieutenant Governor,Todd Lamb,REP,720502,0,0,505,505,
Tulsa,Superintendent of Public Instruction,John Cox,DEM,720502,0,0,280,280,
Tulsa,Superintendent of Public Instruction,Joy Hofmeister,REP,720502,0,0,414,414,
Tulsa,Commissioner of Labor,Mike Workman,DEM,720502,0,0,228,228,
Tulsa,Commissioner of Labor,Mark Costello,REP,720502,0,0,445,445,
Tulsa,U.S. Senate,Matt Silverstein,DEM,720502,0,0,177,177,
Tulsa,U.S. Senate,Jim Inhofe,REP,720502,0,0,497,497,
Tulsa,U.S. Senate,Aaron Delozier,IND,720502,0,0,4,4,
Tulsa,U.S. Senate,Ray Woods,IND,720502,0,0,4,4,
Tulsa,U.S. Senate,Joan Farr,IND,720502,0,0,7,7,
Tulsa,U.S. Senate,Connie Johnson,DEM,720502,0,0,150,150,
Tulsa,U.S. Senate,James Lankford,REP,720502,0,0,515,515,
Tulsa,U.S. Senate,Mark Beard,IND,720502,0,0,27,27,
Tulsa,Governor,Joe Dorman,DEM,720503,0,0,149,149,
Tulsa,Governor,Mary Fallin,REP,720503,0,0,316,316,
Tulsa,Governor,Kimberly Willis,IND,720503,0,0,21,21,
Tulsa,Governor,Richard Prawdzienski,IND,720503,0,0,8,8,
Tulsa,Lieutenant Governor,Cathy Cummings,DEM,720503,0,0,115,115,
Tulsa,Lieutenant Governor,Todd Lamb,REP,720503,0,0,375,375,
Tulsa,Superintendent of Public Instruction,John Cox,DEM,720503,0,0,185,185,
Tulsa,Superintendent of Public Instruction,Joy Hofmeister,REP,720503,0,0,303,303,
Tulsa,Commissioner of Labor,Mike Workman,DEM,720503,0,0,144,144,
Tulsa,Commissioner of Labor,Mark Costello,REP,720503,0,0,335,335,
Tulsa,U.S. Senate,Matt Silverstein,DEM,720503,0,0,98,98,
Tulsa,U.S. Senate,Jim Inhofe,REP,720503,0,0,375,375,
Tulsa,U.S. Senate,Aaron Delozier,IND,720503,0,0,7,7,
Tulsa,U.S. Senate,Ray Woods,IND,720503,0,0,6,6,
Tulsa,U.S. Senate,Joan Farr,IND,720503,0,0,6,6,
Tulsa,U.S. Senate,Connie Johnson,DEM,720503,0,0,102,102,
Tulsa,U.S. Senate,James Lankford,REP,720503,0,0,367,367,
Tulsa,U.S. Senate,Mark Beard,IND,720503,0,0,21,21,
Tulsa,Governor,Joe Dorman,DEM,720504,0,0,215,215,
Tulsa,Governor,Mary Fallin,REP,720504,0,0,445,445,
Tulsa,Governor,Kimberly Willis,IND,720504,0,0,7,7,
Tulsa,Governor,Richard Prawdzienski,IND,720504,0,0,6,6,
Tulsa,Lieutenant Governor,Cathy Cummings,DEM,720504,0,0,156,156,
Tulsa,Lieutenant Governor,Todd Lamb,REP,720504,0,0,511,511,
Tulsa,Superintendent of Public Instruction,John Cox,DEM,720504,0,0,256,256,
Tulsa,Superintendent of Public Instruction,Joy Hofmeister,REP,720504,0,0,415,415,
Tulsa,Commissioner of Labor,Mike Workman,DEM,720504,0,0,190,190,
Tulsa,Commissioner of Labor,Mark Costello,REP,720504,0,0,473,473,
Tulsa,U.S. Senate,Matt Silverstein,DEM,720504,0,0,136,136,
Tulsa,U.S. Senate,Jim Inhofe,REP,720504,0,0,514,514,
Tulsa,U.S. Senate,Aaron Delozier,IND,720504,0,0,4,4,
Tulsa,U.S. Senate,Ray Woods,IND,720504,0,0,7,7,
Tulsa,U.S. Senate,Joan Farr,IND,720504,0,0,9,9,
Tulsa,U.S. Senate,Connie Johnson,DEM,720504,0,0,134,134,
Tulsa,U.S. Senate,James Lankford,REP,720504,0,0,509,509,
Tulsa,U.S. Senate,Mark Beard,IND,720504,0,0,24,24,
Tulsa,Governor,Joe Dorman,DEM,720551,0,0,68,68,
Tulsa,Governor,Mary Fallin,REP,720551,0,0,76,76,
Tulsa,Governor,Kimberly Willis,IND,720551,0,0,2,2,
Tulsa,Governor,Richard Prawdzienski,IND,720551,0,0,2,2,
Tulsa,Lieutenant Governor,Cathy Cummings,DEM,720551,0,0,54,54,
Tulsa,Lieutenant Governor,Todd Lamb,REP,720551,0,0,94,94,
Tulsa,Superintendent of Public Instruction,John Cox,DEM,720551,0,0,72,72,
Tulsa,Superintendent of Public Instruction,Joy Hofmeister,REP,720551,0,0,76,76,
Tulsa,Commissioner of Labor,Mike Workman,DEM,720551,0,0,59,59,
Tulsa,Commissioner of Labor,Mark Costello,REP,720551,0,0,86,86,
Tulsa,U.S. Senate,Matt Silverstein,DEM,720551,0,0,52,52,
Tulsa,U.S. Senate,Jim Inhofe,REP,720551,0,0,91,91,
Tulsa,U.S. Senate,Aaron Delozier,IND,720551,0,0,1,1,
Tulsa,U.S. Senate,Ray Woods,IND,720551,0,0,2,2,
Tulsa,U.S. Senate,Joan Farr,IND,720551,0,0,0,0,
Tulsa,U.S. Senate,Connie Johnson,DEM,720551,0,0,52,52,
Tulsa,U.S. Senate,James Lankford,REP,720551,0,0,91,91,
Tulsa,U.S. Senate,Mark Beard,IND,720551,0,0,4,4,
Tulsa,Governor,Joe Dorman,DEM,720552,0,0,116,116,
Tulsa,Governor,Mary Fallin,REP,720552,0,0,194,194,
Tulsa,Governor,Kimberly Willis,IND,720552,0,0,6,6,
Tulsa,Governor,Richard Prawdzienski,IND,720552,0,0,1,1,
Tulsa,Lieutenant Governor,Cathy Cummings,DEM,720552,0,0,85,85,
Tulsa,Lieutenant Governor,Todd Lamb,REP,720552,0,0,228,228,
Tulsa,Superintendent of Public Instruction,John Cox,DEM,720552,0,0,142,142,
Tulsa,Superintendent of Public Instruction,Joy Hofmeister,REP,720552,0,0,174,174,
Tulsa,Commissioner of Labor,Mike Workman,DEM,720552,0,0,118,118,
Tulsa,Commissioner of Labor,Mark Costello,REP,720552,0,0,185,185,
Tulsa,U.S. Senate,Matt Silverstein,DEM,720552,0,0,74,74,
Tulsa,U.S. Senate,Jim Inhofe,REP,720552,0,0,226,226,
Tulsa,U.S. Senate,Aaron Delozier,IND,720552,0,0,5,5,
Tulsa,U.S. Senate,Ray Woods,IND,720552,0,0,3,3,
Tulsa,U.S. Senate,Joan Farr,IND,720552,0,0,6,6,
Tulsa,U.S. Senate,Connie Johnson,DEM,720552,0,0,80,80,
Tulsa,U.S. Senate,James Lankford,REP,720552,0,0,219,219,
Tulsa,U.S. Senate,Mark Beard,IND,720552,0,0,16,16,
Tulsa,State House,Jim Massey,DEM,720552,0,0,124,124,36
Tulsa,State House,Sean Roberts,REP,720552,0,0,188,188,36
Tulsa,Governor,Joe Dorman,DEM,720553,0,0,66,66,
Tulsa,Governor,Mary Fallin,REP,720553,0,0,100,100,
Tulsa,Governor,Kimberly Willis,IND,720553,0,0,4,4,
Tulsa,Governor,Richard Prawdzienski,IND,720553,0,0,3,3,
Tulsa,Lieutenant Governor,Cathy Cummings,DEM,720553,0,0,56,56,
Tulsa,Lieutenant Governor,Todd Lamb,REP,720553,0,0,117,117,
Tulsa,Superintendent of Public Instruction,John Cox,DEM,720553,0,0,71,71,
Tulsa,Superintendent of Public Instruction,Joy Hofmeister,REP,720553,0,0,103,103,
Tulsa,Commissioner of Labor,Mike Workman,DEM,720553,0,0,70,70,
Tulsa,Commissioner of Labor,Mark Costello,REP,720553,0,0,101,101,
Tulsa,U.S. Senate,Matt Silverstein,DEM,720553,0,0,49,49,
Tulsa,U.S. Senate,Jim Inhofe,REP,720553,0,0,120,120,
Tulsa,U.S. Senate,Aaron Delozier,IND,720553,0,0,2,2,
Tulsa,U.S. Senate,Ray Woods,IND,720553,0,0,0,0,
Tulsa,U.S. Senate,Joan Farr,IND,720553,0,0,2,2,
Tulsa,U.S. Senate,Connie Johnson,DEM,720553,0,0,52,52,
Tulsa,U.S. Senate,James Lankford,REP,720553,0,0,114,114,
Tulsa,U.S. Senate,Mark Beard,IND,720553,0,0,7,7,
Tulsa,Governor,Joe Dorman,DEM,720700,0,0,233,233,
Tulsa,Governor,Mary Fallin,REP,720700,0,0,572,572,
Tulsa,Governor,Kimberly Willis,IND,720700,0,0,10,10,
Tulsa,Governor,Richard Prawdzienski,IND,720700,0,0,3,3,
Tulsa,Lieutenant Governor,Cathy Cummings,DEM,720700,0,0,144,144,
Tulsa,Lieutenant Governor,Todd Lamb,REP,720700,0,0,674,674,
Tulsa,Superintendent of Public Instruction,John Cox,DEM,720700,0,0,173,173,
Tulsa,Superintendent of Public Instruction,Joy Hofmeister,REP,720700,0,0,646,646,
Tulsa,Commissioner of Labor,Mike Workman,DEM,720700,0,0,165,165,
Tulsa,Commissioner of Labor,Mark Costello,REP,720700,0,0,628,628,
Tulsa,U.S. Senate,Matt Silverstein,DEM,720700,0,0,157,157,
Tulsa,U.S. Senate,Jim Inhofe,REP,720700,0,0,647,647,
Tulsa,U.S. Senate,Aaron Delozier,IND,720700,0,0,0,0,
Tulsa,U.S. Senate,Ray Woods,IND,720700,0,0,6,6,
Tulsa,U.S. Senate,Joan Farr,IND,720700,0,0,7,7,
Tulsa,U.S. Senate,Connie Johnson,DEM,720700,0,0,134,134,
Tulsa,U.S. Senate,James Lankford,REP,720700,0,0,665,665,
Tulsa,U.S. Senate,Mark Beard,IND,720700,0,0,16,16,
Tulsa,Governor,Joe Dorman,DEM,720701,0,0,307,307,
Tulsa,Governor,Mary Fallin,REP,720701,0,0,507,507,
Tulsa,Governor,Kimberly Willis,IND,720701,0,0,18,18,
Tulsa,Governor,Richard Prawdzienski,IND,720701,0,0,7,7,
Tulsa,Lieutenant Governor,Cathy Cummings,DEM,720701,0,0,210,210,
Tulsa,Lieutenant Governor,Todd Lamb,REP,720701,0,0,619,619,
Tulsa,Superintendent of Public Instruction,John Cox,DEM,720701,0,0,268,268,
Tulsa,Superintendent of Public Instruction,Joy Hofmeister,REP,720701,0,0,567,567,
Tulsa,Commissioner of Labor,Mike Workman,DEM,720701,0,0,226,226,
Tulsa,Commissioner of Labor,Mark Costello,REP,720701,0,0,591,591,
Tulsa,U.S. Senate,Matt Silverstein,DEM,720701,0,0,210,210,
Tulsa,U.S. Senate,Jim Inhofe,REP,720701,0,0,603,603,
Tulsa,U.S. Senate,Aaron Delozier,IND,720701,0,0,8,8,
Tulsa,U.S. Senate,Ray Woods,IND,720701,0,0,1,1,
Tulsa,U.S. Senate,Joan Farr,IND,720701,0,0,11,11,
Tulsa,U.S. Senate,Connie Johnson,DEM,720701,0,0,202,202,
Tulsa,U.S. Senate,James Lankford,REP,720701,0,0,611,611,
Tulsa,U.S. Senate,Mark Beard,IND,720701,0,0,17,17,
Tulsa,Governor,Joe Dorman,DEM,720702,0,0,201,201,
Tulsa,Governor,Mary Fallin,REP,720702,0,0,337,337,
Tulsa,Governor,Kimberly Willis,IND,720702,0,0,21,21,
Tulsa,Governor,Richard Prawdzienski,IND,720702,0,0,14,14,
Tulsa,Lieutenant Governor,Cathy Cummings,DEM,720702,0,0,153,153,
Tulsa,Lieutenant Governor,Todd Lamb,REP,720702,0,0,416,416,
Tulsa,Superintendent of Public Instruction,John Cox,DEM,720702,0,0,207,207,
Tulsa,Superintendent of Public Instruction,Joy Hofmeister,REP,720702,0,0,363,363,
Tulsa,Commissioner of Labor,Mike Workman,DEM,720702,0,0,176,176,
Tulsa,Commissioner of Labor,Mark Costello,REP,720702,0,0,380,380,
Tulsa,U.S. Senate,Matt Silverstein,DEM,720702,0,0,153,153,
Tulsa,U.S. Senate,Jim Inhofe,REP,720702,0,0,397,397,
Tulsa,U.S. Senate,Aaron Delozier,IND,720702,0,0,6,6,
Tulsa,U.S. Senate,Ray Woods,IND,720702,0,0,5,5,
Tulsa,U.S. Senate,Joan Farr,IND,720702,0,0,9,9,
Tulsa,U.S. Senate,Connie Johnson,DEM,720702,0,0,140,140,
Tulsa,U.S. Senate,James Lankford,REP,720702,0,0,412,412,
Tulsa,U.S. Senate,Mark Beard,IND,720702,0,0,19,19,
Tulsa,Governor,Joe Dorman,DEM,720703,0,0,274,274,
Tulsa,Governor,Mary Fallin,REP,720703,0,0,510,510,
Tulsa,Governor,Kimberly Willis,IND,720703,0,0,20,20,
Tulsa,Governor,Richard Prawdzienski,IND,720703,0,0,7,7,
Tulsa,Lieutenant Governor,Cathy Cummings,DEM,720703,0,0,204,204,
Tulsa,Lieutenant Governor,Todd Lamb,REP,720703,0,0,603,603,
Tulsa,Superintendent of Public Instruction,John Cox,DEM,720703,0,0,219,219,
Tulsa,Superintendent of Public Instruction,Joy Hofmeister,REP,720703,0,0,591,591,
Tulsa,Commissioner of Labor,Mike Workman,DEM,720703,0,0,225,225,
Tulsa,Commissioner of Labor,Mark Costello,REP,720703,0,0,569,569,
Tulsa,U.S. Senate,Matt Silverstein,DEM,720703,0,0,206,206,
Tulsa,U.S. Senate,Jim Inhofe,REP,720703,0,0,577,577,
Tulsa,U.S. Senate,Aaron Delozier,IND,720703,0,0,9,9,
Tulsa,U.S. Senate,Ray Woods,IND,720703,0,0,1,1,
Tulsa,U.S. Senate,Joan Farr,IND,720703,0,0,7,7,
Tulsa,U.S. Senate,Connie Johnson,DEM,720703,0,0,178,178,
Tulsa,U.S. Senate,James Lankford,REP,720703,0,0,604,604,
Tulsa,U.S. Senate,Mark Beard,IND,720703,0,0,26,26,
Tulsa,Governor,Joe Dorman,DEM,720704,0,0,181,181,
Tulsa,Governor,Mary Fallin,REP,720704,0,0,558,558,
Tulsa,Governor,Kimberly Willis,IND,720704,0,0,6,6,
Tulsa,Governor,Richard Prawdzienski,IND,720704,0,0,9,9,
Tulsa,Lieutenant Governor,Cathy Cummings,DEM,720704,0,0,110,110,
Tulsa,Lieutenant Governor,Todd Lamb,REP,720704,0,0,636,636,
Tulsa,Superintendent of Public Instruction,John Cox,DEM,720704,0,0,174,174,
Tulsa,Superintendent of Public Instruction,Joy Hofmeister,REP,720704,0,0,577,577,
Tulsa,Commissioner of Labor,Mike Workman,DEM,720704,0,0,121,121,
Tulsa,Commissioner of Labor,Mark Costello,REP,720704,0,0,610,610,
Tulsa,U.S. Senate,Matt Silverstein,DEM,720704,0,0,123,123,
Tulsa,U.S. Senate,Jim Inhofe,REP,720704,0,0,613,613,
Tulsa,U.S. Senate,Aaron Delozier,IND,720704,0,0,6,6,
Tulsa,U.S. Senate,Ray Woods,IND,720704,0,0,3,3,
Tulsa,U.S. Senate,Joan Farr,IND,720704,0,0,6,6,
Tulsa,U.S. Senate,Connie Johnson,DEM,720704,0,0,100,100,
Tulsa,U.S. Senate,James Lankford,REP,720704,0,0,637,637,
Tulsa,U.S. Senate,Mark Beard,IND,720704,0,0,9,9,
Tulsa,Governor,Joe Dorman,DEM,720705,0,0,184,184,
Tulsa,Governor,Mary Fallin,REP,720705,0,0,251,251,
Tulsa,Governor,Kimberly Willis,IND,720705,0,0,14,14,
Tulsa,Governor,Richard Prawdzienski,IND,720705,0,0,7,7,
Tulsa,Lieutenant Governor,Cathy Cummings,DEM,720705,0,0,124,124,
Tulsa,Lieutenant Governor,Todd Lamb,REP,720705,0,0,328,328,
Tulsa,Superintendent of Public Instruction,John Cox,DEM,720705,0,0,183,183,
Tulsa,Superintendent of Public Instruction,Joy Hofmeister,REP,720705,0,0,270,270,
Tulsa,Commissioner of Labor,Mike Workman,DEM,720705,0,0,149,149,
Tulsa,Commissioner of Labor,Mark Costello,REP,720705,0,0,294,294,
Tulsa,U.S. Senate,Matt Silverstein,DEM,720705,0,0,130,130,
Tulsa,U.S. Senate,Jim Inhofe,REP,720705,0,0,307,307,
Tulsa,U.S. Senate,Aaron Delozier,IND,720705,0,0,3,3,
Tulsa,U.S. Senate,Ray Woods,IND,720705,0,0,10,10,
Tulsa,U.S. Senate,Joan Farr,IND,720705,0,0,4,4,
Tulsa,U.S. Senate,Connie Johnson,DEM,720705,0,0,124,124,
Tulsa,U.S. Senate,James Lankford,REP,720705,0,0,314,314,
Tulsa,U.S. Senate,Mark Beard,IND,720705,0,0,14,14,
Tulsa,Governor,Joe Dorman,DEM,720706,0,0,283,283,
Tulsa,Governor,Mary Fallin,REP,720706,0,0,550,550,
Tulsa,Governor,Kimberly Willis,IND,720706,0,0,20,20,
Tulsa,Governor,Richard Prawdzienski,IND,720706,0,0,7,7,
Tulsa,Lieutenant Governor,Cathy Cummings,DEM,720706,0,0,207,207,
Tulsa,Lieutenant Governor,Todd Lamb,REP,720706,0,0,648,648,
Tulsa,Superintendent of Public Instruction,John Cox,DEM,720706,0,0,278,278,
Tulsa,Superintendent of Public Instruction,Joy Hofmeister,REP,720706,0,0,582,582,
Tulsa,Commissioner of Labor,Mike Workman,DEM,720706,0,0,238,238,
Tulsa,Commissioner of Labor,Mark Costello,REP,720706,0,0,602,602,
Tulsa,U.S. Senate,Matt Silverstein,DEM,720706,0,0,190,190,
Tulsa,U.S. Senate,Jim Inhofe,REP,720706,0,0,646,646,
Tulsa,U.S. Senate,Aaron Delozier,IND,720706,0,0,9,9,
Tulsa,U.S. Senate,Ray Woods,IND,720706,0,0,11,11,
Tulsa,U.S. Senate,Joan Farr,IND,720706,0,0,7,7,
Tulsa,U.S. Senate,Connie Johnson,DEM,720706,0,0,192,192,
Tulsa,U.S. Senate,James Lankford,REP,720706,0,0,652,652,
Tulsa,U.S. Senate,Mark Beard,IND,720706,0,0,18,18,
Tulsa,Governor,Joe Dorman,DEM,720707,0,0,136,136,
Tulsa,Governor,Mary Fallin,REP,720707,0,0,195,195,
Tulsa,Governor,Kimberly Willis,IND,720707,0,0,5,5,
Tulsa,Governor,Richard Prawdzienski,IND,720707,0,0,5,5,
Tulsa,Lieutenant Governor,Cathy Cummings,DEM,720707,0,0,95,95,
Tulsa,Lieutenant Governor,Todd Lamb,REP,720707,0,0,247,247,
Tulsa,Superintendent of Public Instruction,John Cox,DEM,720707,0,0,133,133,
Tulsa,Superintendent of Public Instruction,Joy Hofmeister,REP,720707,0,0,208,208,
Tulsa,Commissioner of Labor,Mike Workman,DEM,720707,0,0,106,106,
Tulsa,Commissioner of Labor,Mark Costello,REP,720707,0,0,228,228,
Tulsa,U.S. Senate,Matt Silverstein,DEM,720707,0,0,92,92,
Tulsa,U.S. Senate,Jim Inhofe,REP,720707,0,0,241,241,
Tulsa,U.S. Senate,Aaron Delozier,IND,720707,0,0,3,3,
Tulsa,U.S. Senate,Ray Woods,IND,720707,0,0,3,3,
Tulsa,U.S. Senate,Joan Farr,IND,720707,0,0,4,4,
Tulsa,U.S. Senate,Connie Johnson,DEM,720707,0,0,83,83,
Tulsa,U.S. Senate,James Lankford,REP,720707,0,0,242,242,
Tulsa,U.S. Senate,Mark Beard,IND,720707,0,0,14,14,
Tulsa,Governor,Joe Dorman,DEM,720708,0,0,184,184,
Tulsa,Governor,Mary Fallin,REP,720708,0,0,321,321,
Tulsa,Governor,Kimberly Willis,IND,720708,0,0,10,10,
Tulsa,Governor,Richard Prawdzienski,IND,720708,0,0,11,11,
Tulsa,Lieutenant Governor,Cathy Cummings,DEM,720708,0,0,139,139,
Tulsa,Lieutenant Governor,Todd Lamb,REP,720708,0,0,386,386,
Tulsa,Superintendent of Public Instruction,John Cox,DEM,720708,0,0,177,177,
Tulsa,Superintendent of Public Instruction,Joy Hofmeister,REP,720708,0,0,346,346,
Tulsa,Commissioner of Labor,Mike Workman,DEM,720708,0,0,142,142,
Tulsa,Commissioner of Labor,Mark Costello,REP,720708,0,0,371,371,
Tulsa,U.S. Senate,Matt Silverstein,DEM,720708,0,0,133,133,
Tulsa,U.S. Senate,Jim Inhofe,REP,720708,0,0,372,372,
Tulsa,U.S. Senate,Aaron Delozier,IND,720708,0,0,6,6,
Tulsa,U.S. Senate,Ray Woods,IND,720708,0,0,8,8,
Tulsa,U.S. Senate,Joan Farr,IND,720708,0,0,6,6,
Tulsa,U.S. Senate,Connie Johnson,DEM,720708,0,0,123,123,
Tulsa,U.S. Senate,James Lankford,REP,720708,0,0,382,382,
Tulsa,U.S. Senate,Mark Beard,IND,720708,0,0,19,19,
Tulsa,Governor,Joe Dorman,DEM,720709,0,0,197,197,
Tulsa,Governor,Mary Fallin,REP,720709,0,0,440,440,
Tulsa,Governor,Kimberly Willis,IND,720709,0,0,11,11,
Tulsa,Governor,Richard Prawdzienski,IND,720709,0,0,6,6,
Tulsa,Lieutenant Governor,Cathy Cummings,DEM,720709,0,0,145,145,
Tulsa,Lieutenant Governor,Todd Lamb,REP,720709,0,0,509,509,
Tulsa,Superintendent of Public Instruction,John Cox,DEM,720709,0,0,175,175,
Tulsa,Superintendent of Public Instruction,Joy Hofmeister,REP,720709,0,0,478,478,
Tulsa,Commissioner of Labor,Mike Workman,DEM,720709,0,0,164,164,
Tulsa,Commissioner of Labor,Mark Costello,REP,720709,0,0,470,470,
Tulsa,U.S. Senate,Matt Silverstein,DEM,720709,0,0,152,152,
Tulsa,U.S. Senate,Jim Inhofe,REP,720709,0,0,486,486,
Tulsa,U.S. Senate,Aaron Delozier,IND,720709,0,0,8,8,
Tulsa,U.S. Senate,Ray Woods,IND,720709,0,0,5,5,
Tulsa,U.S. Senate,Joan Farr,IND,720709,0,0,6,6,
Tulsa,U.S. Senate,Connie Johnson,DEM,720709,0,0,138,138,
Tulsa,U.S. Senate,James Lankford,REP,720709,0,0,506,506,
Tulsa,U.S. Senate,Mark Beard,IND,720709,0,0,13,13,
Tulsa,Governor,Joe Dorman,DEM,720710,0,0,44,44,
Tulsa,Governor,Mary Fallin,REP,720710,0,0,135,135,
Tulsa,Governor,Kimberly Willis,IND,720710,0,0,1,1,
Tulsa,Governor,Richard Prawdzienski,IND,720710,0,0,1,1,
Tulsa,Lieutenant Governor,Cathy Cummings,DEM,720710,0,0,29,29,
Tulsa,Lieutenant Governor,Todd Lamb,REP,720710,0,0,151,151,
Tulsa,Superintendent of Public Instruction,John Cox,DEM,720710,0,0,50,50,
Tulsa,Superintendent of Public Instruction,Joy Hofmeister,REP,720710,0,0,129,129,
Tulsa,Commissioner of Labor,Mike Workman,DEM,720710,0,0,31,31,
Tulsa,Commissioner of Labor,Mark Costello,REP,720710,0,0,144,144,
Tulsa,U.S. Senate,Matt Silverstein,DEM,720710,0,0,30,30,
Tulsa,U.S. Senate,Jim Inhofe,REP,720710,0,0,147,147,
Tulsa,U.S. Senate,Aaron Delozier,IND,720710,0,0,2,2,
Tulsa,U.S. Senate,Ray Woods,IND,720710,0,0,1,1,
Tulsa,U.S. Senate,Joan Farr,IND,720710,0,0,1,1,
Tulsa,U.S. Senate,Connie Johnson,DEM,720710,0,0,24,24,
Tulsa,U.S. Senate,James Lankford,REP,720710,0,0,150,150,
Tulsa,U.S. Senate,Mark Beard,IND,720710,0,0,6,6,
Tulsa,Governor,Joe Dorman,DEM,720750,0,0,191,191,
Tulsa,Governor,Mary Fallin,REP,720750,0,0,424,424,
Tulsa,Governor,Kimberly Willis,IND,720750,0,0,11,11,
Tulsa,Governor,Richard Prawdzienski,IND,720750,0,0,6,6,
Tulsa,Lieutenant Governor,Cathy Cummings,DEM,720750,0,0,141,141,
Tulsa,Lieutenant Governor,Todd Lamb,REP,720750,0,0,482,482,
Tulsa,Superintendent of Public Instruction,John Cox,DEM,720750,0,0,187,187,
Tulsa,Superintendent of Public Instruction,Joy Hofmeister,REP,720750,0,0,439,439,
Tulsa,Commissioner of Labor,Mike Workman,DEM,720750,0,0,177,177,
Tulsa,Commissioner of Labor,Mark Costello,REP,720750,0,0,431,431,
Tulsa,U.S. Senate,Matt Silverstein,DEM,720750,0,0,135,135,
Tulsa,U.S. Senate,Jim Inhofe,REP,720750,0,0,469,469,
Tulsa,U.S. Senate,Aaron Delozier,IND,720750,0,0,8,8,
Tulsa,U.S. Senate,Ray Woods,IND,720750,0,0,8,8,
Tulsa,U.S. Senate,Joan Farr,IND,720750,0,0,9,9,
Tulsa,U.S. Senate,Connie Johnson,DEM,720750,0,0,123,123,
Tulsa,U.S. Senate,James Lankford,REP,720750,0,0,480,480,
Tulsa,U.S. Senate,Mark Beard,IND,720750,0,0,23,23,
Tulsa,Governor,Joe Dorman,DEM,720751,0,0,267,267,
Tulsa,Governor,Mary Fallin,REP,720751,0,0,510,510,
Tulsa,Governor,Kimberly Willis,IND,720751,0,0,14,14,
Tulsa,Governor,Richard Prawdzienski,IND,720751,0,0,10,10,
Tulsa,Lieutenant Governor,Cathy Cummings,DEM,720751,0,0,201,201,
Tulsa,Lieutenant Governor,Todd Lamb,REP,720751,0,0,594,594,
Tulsa,Superintendent of Public Instruction,John Cox,DEM,720751,0,0,275,275,
Tulsa,Superintendent of Public Instruction,Joy Hofmeister,REP,720751,0,0,521,521,
Tulsa,Commissioner of Labor,Mike Workman,DEM,720751,0,0,220,220,
Tulsa,Commissioner of Labor,Mark Costello,REP,720751,0,0,568,568,
Tulsa,U.S. Senate,Matt Silverstein,DEM,720751,0,0,214,214,
Tulsa,U.S. Senate,Jim Inhofe,REP,720751,0,0,567,567,
Tulsa,U.S. Senate,Aaron Delozier,IND,720751,0,0,4,4,
Tulsa,U.S. Senate,Ray Woods,IND,720751,0,0,6,6,
Tulsa,U.S. Senate,Joan Farr,IND,720751,0,0,5,5,
Tulsa,U.S. Senate,Connie Johnson,DEM,720751,0,0,189,189,
Tulsa,U.S. Senate,James Lankford,REP,720751,0,0,588,588,
Tulsa,U.S. Senate,Mark Beard,IND,720751,0,0,22,22,
Tulsa,Governor,Joe Dorman,DEM,720752,0,0,188,188,
Tulsa,Governor,Mary Fallin,REP,720752,0,0,402,402,
Tulsa,Governor,Kimberly Willis,IND,720752,0,0,6,6,
Tulsa,Governor,Richard Prawdzienski,IND,720752,0,0,4,4,
Tulsa,Lieutenant Governor,Cathy Cummings,DEM,720752,0,0,130,130,
Tulsa,Lieutenant Governor,Todd Lamb,REP,720752,0,0,468,468,
Tulsa,Superintendent of Public Instruction,John Cox,DEM,720752,0,0,210,210,
Tulsa,Superintendent of Public Instruction,Joy Hofmeister,REP,720752,0,0,387,387,
Tulsa,Commissioner of Labor,Mike Workman,DEM,720752,0,0,167,167,
Tulsa,Commissioner of Labor,Mark Costello,REP,720752,0,0,416,416,
Tulsa,U.S. Senate,Matt Silverstein,DEM,720752,0,0,135,135,
Tulsa,U.S. Senate,Jim Inhofe,REP,720752,0,0,447,447,
Tulsa,U.S. Senate,Aaron Delozier,IND,720752,0,0,9,9,
Tulsa,U.S. Senate,Ray Woods,IND,720752,0,0,3,3,
Tulsa,U.S. Senate,Joan Farr,IND,720752,0,0,4,4,
Tulsa,U.S. Senate,Connie Johnson,DEM,720752,0,0,126,126,
Tulsa,U.S. Senate,James Lankford,REP,720752,0,0,460,460,
Tulsa,U.S. Senate,Mark Beard,IND,720752,0,0,10,10,
Tulsa,State House,Jim Massey,DEM,720752,0,0,158,158,36
Tulsa,State House,Sean Roberts,REP,720752,0,0,428,428,36
Tulsa,Governor,Joe Dorman,DEM,720753,0,0,165,165,
Tulsa,Governor,Mary Fallin,REP,720753,0,0,278,278,
Tulsa,Governor,Kimberly Willis,IND,720753,0,0,16,16,
Tulsa,Governor,Richard Prawdzienski,IND,720753,0,0,2,2,
Tulsa,Lieutenant Governor,Cathy Cummings,DEM,720753,0,0,133,133,
Tulsa,Lieutenant Governor,Todd Lamb,REP,720753,0,0,330,330,
Tulsa,Superintendent of Public Instruction,John Cox,DEM,720753,0,0,181,181,
Tulsa,Superintendent of Public Instruction,Joy Hofmeister,REP,720753,0,0,281,281,
Tulsa,Commissioner of Labor,Mike Workman,DEM,720753,0,0,150,150,
Tulsa,Commissioner of Labor,Mark Costello,REP,720753,0,0,300,300,
Tulsa,U.S. Senate,Matt Silverstein,DEM,720753,0,0,129,129,
Tulsa,U.S. Senate,Jim Inhofe,REP,720753,0,0,320,320,
Tulsa,U.S. Senate,Aaron Delozier,IND,720753,0,0,6,6,
Tulsa,U.S. Senate,Ray Woods,IND,720753,0,0,3,3,
Tulsa,U.S. Senate,Joan Farr,IND,720753,0,0,6,6,
Tulsa,U.S. Senate,Connie Johnson,DEM,720753,0,0,120,120,
Tulsa,U.S. Senate,James Lankford,REP,720753,0,0,321,321,
Tulsa,U.S. Senate,Mark Beard,IND,720753,0,0,18,18,
Tulsa,Governor,Joe Dorman,DEM,720754,0,0,324,324,
Tulsa,Governor,Mary Fallin,REP,720754,0,0,547,547,
Tulsa,Governor,Kimberly Willis,IND,720754,0,0,16,16,
Tulsa,Governor,Richard Prawdzienski,IND,720754,0,0,14,14,
Tulsa,Lieutenant Governor,Cathy Cummings,DEM,720754,0,0,233,233,
Tulsa,Lieutenant Governor,Todd Lamb,REP,720754,0,0,664,664,
Tulsa,Superintendent of Public Instruction,John Cox,DEM,720754,0,0,335,335,
Tulsa,Superintendent of Public Instruction,Joy Hofmeister,REP,720754,0,0,560,560,
Tulsa,Commissioner of Labor,Mike Workman,DEM,720754,0,0,264,264,
Tulsa,Commissioner of Labor,Mark Costello,REP,720754,0,0,613,613,
Tulsa,U.S. Senate,Matt Silverstein,DEM,720754,0,0,213,213,
Tulsa,U.S. Senate,Jim Inhofe,REP,720754,0,0,652,652,
Tulsa,U.S. Senate,Aaron Delozier,IND,720754,0,0,20,20,
Tulsa,U.S. Senate,Ray Woods,IND,720754,0,0,7,7,
Tulsa,U.S. Senate,Joan Farr,IND,720754,0,0,11,11,
Tulsa,U.S. Senate,Connie Johnson,DEM,720754,0,0,194,194,
Tulsa,U.S. Senate,James Lankford,REP,720754,0,0,675,675,
Tulsa,U.S. Senate,Mark Beard,IND,720754,0,0,31,31,
Tulsa,Governor,Joe Dorman,DEM,720755,0,0,357,357,
Tulsa,Governor,Mary Fallin,REP,720755,0,0,744,744,
Tulsa,Governor,Kimberly Willis,IND,720755,0,0,20,20,
Tulsa,Governor,Richard Prawdzienski,IND,720755,0,0,16,16,
Tulsa,Lieutenant Governor,Cathy Cummings,DEM,720755,0,0,261,261,
Tulsa,Lieutenant Governor,Todd Lamb,REP,720755,0,0,871,871,
Tulsa,Superintendent of Public Instruction,John Cox,DEM,720755,0,0,369,369,
Tulsa,Superintendent of Public Instruction,Joy Hofmeister,REP,720755,0,0,766,766,
Tulsa,Commissioner of Labor,Mike Workman,DEM,720755,0,0,281,281,
Tulsa,Commissioner of Labor,Mark Costello,REP,720755,0,0,832,832,
Tulsa,U.S. Senate,Matt Silverstein,DEM,720755,0,0,243,243,
Tulsa,U.S. Senate,Jim Inhofe,REP,720755,0,0,850,850,
Tulsa,U.S. Senate,Aaron Delozier,IND,720755,0,0,16,16,
Tulsa,U.S. Senate,Ray Woods,IND,720755,0,0,8,8,
Tulsa,U.S. Senate,Joan Farr,IND,720755,0,0,15,15,
Tulsa,U.S. Senate,Connie Johnson,DEM,720755,0,0,230,230,
Tulsa,U.S. Senate,James Lankford,REP,720755,0,0,862,862,
Tulsa,U.S. Senate,Mark Beard,IND,720755,0,0,39,39,
Tulsa,Governor,Joe Dorman,DEM,720756,0,0,12,12,
Tulsa,Governor,Mary Fallin,REP,720756,0,0,35,35,
Tulsa,Governor,Kimberly Willis,IND,720756,0,0,1,1,
Tulsa,Governor,Richard Prawdzienski,IND,720756,0,0,1,1,
Tulsa,Lieutenant Governor,Cathy Cummings,DEM,720756,0,0,10,10,
Tulsa,Lieutenant Governor,Todd Lamb,REP,720756,0,0,39,39,
Tulsa,Superintendent of Public Instruction,John Cox,DEM,720756,0,0,14,14,
Tulsa,Superintendent of Public Instruction,Joy Hofmeister,REP,720756,0,0,35,35,
Tulsa,Commissioner of Labor,Mike Workman,DEM,720756,0,0,14,14,
Tulsa,Commissioner of Labor,Mark Costello,REP,720756,0,0,35,35,
Tulsa,U.S. Senate,Matt Silverstein,DEM,720756,0,0,8,8,
Tulsa,U.S. Senate,Jim Inhofe,REP,720756,0,0,39,39,
Tulsa,U.S. Senate,Aaron Delozier,IND,720756,0,0,1,1,
Tulsa,U.S. Senate,Ray Woods,IND,720756,0,0,0,0,
Tulsa,U.S. Senate,Joan Farr,IND,720756,0,0,1,1,
Tulsa,U.S. Senate,Connie Johnson,DEM,720756,0,0,10,10,
Tulsa,U.S. Senate,James Lankford,REP,720756,0,0,36,36,
Tulsa,U.S. Senate,Mark Beard,IND,720756,0,0,2,2,
Tulsa,Governor,Joe Dorman,DEM,720757,0,0,344,344,
Tulsa,Governor,Mary Fallin,REP,720757,0,0,803,803,
Tulsa,Governor,Kimberly Willis,IND,720757,0,0,27,27,
Tulsa,Governor,Richard Prawdzienski,IND,720757,0,0,9,9,
Tulsa,Lieutenant Governor,Cathy Cummings,DEM,720757,0,0,228,228,
Tulsa,Lieutenant Governor,Todd Lamb,REP,720757,0,0,955,955,
Tulsa,Superintendent of Public Instruction,John Cox,DEM,720757,0,0,347,347,
Tulsa,Superintendent of Public Instruction,Joy Hofmeister,REP,720757,0,0,837,837,
Tulsa,Commissioner of Labor,Mike Workman,DEM,720757,0,0,266,266,
Tulsa,Commissioner of Labor,Mark Costello,REP,720757,0,0,902,902,
Tulsa,U.S. Senate,Matt Silverstein,DEM,720757,0,0,242,242,
Tulsa,U.S. Senate,Jim Inhofe,REP,720757,0,0,911,911,
Tulsa,U.S. Senate,Aaron Delozier,IND,720757,0,0,12,12,
Tulsa,U.S. Senate,Ray Woods,IND,720757,0,0,12,12,
Tulsa,U.S. Senate,Joan Farr,IND,720757,0,0,5,5,
Tulsa,U.S. Senate,Connie Johnson,DEM,720757,0,0,206,206,
Tulsa,U.S. Senate,James Lankford,REP,720757,0,0,944,944,
Tulsa,U.S. Senate,Mark Beard,IND,720757,0,0,29,29,
Tulsa,Governor,Joe Dorman,DEM,720758,0,0,81,81,
Tulsa,Governor,Mary Fallin,REP,720758,0,0,133,133,
Tulsa,Governor,Kimberly Willis,IND,720758,0,0,2,2,
Tulsa,Governor,Richard Prawdzienski,IND,720758,0,0,2,2,
Tulsa,Lieutenant Governor,Cathy Cummings,DEM,720758,0,0,58,58,
Tulsa,Lieutenant Governor,Todd Lamb,REP,720758,0,0,161,161,
Tulsa,Superintendent of Public Instruction,John Cox,DEM,720758,0,0,80,80,
Tulsa,Superintendent of Public Instruction,Joy Hofmeister,REP,720758,0,0,139,139,
Tulsa,Commissioner of Labor,Mike Workman,DEM,720758,0,0,67,67,
Tulsa,Commissioner of Labor,Mark Costello,REP,720758,0,0,147,147,
Tulsa,U.S. Senate,Matt Silverstein,DEM,720758,0,0,55,55,
Tulsa,U.S. Senate,Jim Inhofe,REP,720758,0,0,157,157,
Tulsa,U.S. Senate,Aaron Delozier,IND,720758,0,0,2,2,
Tulsa,U.S. Senate,Ray Woods,IND,720758,0,0,0,0,
Tulsa,U.S. Senate,Joan Farr,IND,720758,0,0,5,5,
Tulsa,U.S. Senate,Connie Johnson,DEM,720758,0,0,52,52,
Tulsa,U.S. Senate,James Lankford,REP,720758,0,0,159,159,
Tulsa,U.S. Senate,Mark Beard,IND,720758,0,0,6,6,
Tulsa,State House,Jim Massey,DEM,720758,0,0,70,70,36
Tulsa,State House,Sean Roberts,REP,720758,0,0,142,142,36
Tulsa,Governor,Joe Dorman,DEM,720759,0,0,244,244,
Tulsa,Governor,Mary Fallin,REP,720759,0,0,407,407,
Tulsa,Governor,Kimberly Willis,IND,720759,0,0,11,11,
Tulsa,Governor,Richard Prawdzienski,IND,720759,0,0,12,12,
Tulsa,Lieutenant Governor,Cathy Cummings,DEM,720759,0,0,183,183,
Tulsa,Lieutenant Governor,Todd Lamb,REP,720759,0,0,490,490,
Tulsa,Superintendent of Public Instruction,John Cox,DEM,720759,0,0,263,263,
Tulsa,Superintendent of Public Instruction,Joy Hofmeister,REP,720759,0,0,411,411,
Tulsa,Commissioner of Labor,Mike Workman,DEM,720759,0,0,200,200,
Tulsa,Commissioner of Labor,Mark Costello,REP,720759,0,0,458,458,
Tulsa,U.S. Senate,Matt Silverstein,DEM,720759,0,0,190,190,
Tulsa,U.S. Senate,Jim Inhofe,REP,720759,0,0,470,470,
Tulsa,U.S. Senate,Aaron Delozier,IND,720759,0,0,4,4,
Tulsa,U.S. Senate,Ray Woods,IND,720759,0,0,5,5,
Tulsa,U.S. Senate,Joan Farr,IND,720759,0,0,7,7,
Tulsa,U.S. Senate,Connie Johnson,DEM,720759,0,0,171,171,
Tulsa,U.S. Senate,James Lankford,REP,720759,0,0,484,484,
Tulsa,U.S. Senate,Mark Beard,IND,720759,0,0,19,19,
Tulsa,Governor,Joe Dorman,DEM,720760,0,0,193,193,
Tulsa,Governor,Mary Fallin,REP,720760,0,0,389,389,
Tulsa,Governor,Kimberly Willis,IND,720760,0,0,14,14,
Tulsa,Governor,Richard Prawdzienski,IND,720760,0,0,12,12,
Tulsa,Lieutenant Governor,Cathy Cummings,DEM,720760,0,0,133,133,
Tulsa,Lieutenant Governor,Todd Lamb,REP,720760,0,0,473,473,
Tulsa,Superintendent of Public Instruction,John Cox,DEM,720760,0,0,220,220,
Tulsa,Superintendent of Public Instruction,Joy Hofmeister,REP,720760,0,0,387,387,
Tulsa,Commissioner of Labor,Mike Workman,DEM,720760,0,0,155,155,
Tulsa,Commissioner of Labor,Mark Costello,REP,720760,0,0,441,441,
Tulsa,U.S. Senate,Matt Silverstein,DEM,720760,0,0,131,131,
Tulsa,U.S. Senate,Jim Inhofe,REP,720760,0,0,454,454,
Tulsa,U.S. Senate,Aaron Delozier,IND,720760,0,0,8,8,
Tulsa,U.S. Senate,Ray Woods,IND,720760,0,0,5,5,
Tulsa,U.S. Senate,Joan Farr,IND,720760,0,0,9,9,
Tulsa,U.S. Senate,Connie Johnson,DEM,720760,0,0,129,129,
Tulsa,U.S. Senate,James Lankford,REP,720760,0,0,458,458,
Tulsa,U.S. Senate,Mark Beard,IND,720760,0,0,20,20,
Tulsa,Governor,Joe Dorman,DEM,720801,0,0,176,176,
Tulsa,Governor,Mary Fallin,REP,720801,0,0,258,258,
Tulsa,Governor,Kimberly Willis,IND,720801,0,0,4,4,
Tulsa,Governor,Richard Prawdzienski,IND,720801,0,0,5,5,
Tulsa,Lieutenant Governor,Cathy Cummings,DEM,720801,0,0,110,110,
Tulsa,Lieutenant Governor,Todd Lamb,REP,720801,0,0,332,332,
Tulsa,Superintendent of Public Instruction,John Cox,DEM,720801,0,0,181,181,
Tulsa,Superintendent of Public Instruction,Joy Hofmeister,REP,720801,0,0,264,264,
Tulsa,Commissioner of Labor,Mike Workman,DEM,720801,0,0,126,126,
Tulsa,Commissioner of Labor,Mark Costello,REP,720801,0,0,306,306,
Tulsa,U.S. Senate,Matt Silverstein,DEM,720801,0,0,114,114,
Tulsa,U.S. Senate,Jim Inhofe,REP,720801,0,0,315,315,
Tulsa,U.S. Senate,Aaron Delozier,IND,720801,0,0,6,6,
Tulsa,U.S. Senate,Ray Woods,IND,720801,0,0,3,3,
Tulsa,U.S. Senate,Joan Farr,IND,720801,0,0,5,5,
Tulsa,U.S. Senate,Connie Johnson,DEM,720801,0,0,95,95,
Tulsa,U.S. Senate,James Lankford,REP,720801,0,0,340,340,
Tulsa,U.S. Senate,Mark Beard,IND,720801,0,0,7,7,
Tulsa,Governor,Joe Dorman,DEM,720802,0,0,94,94,
Tulsa,Governor,Mary Fallin,REP,720802,0,0,159,159,
Tulsa,Governor,Kimberly Willis,IND,720802,0,0,12,12,
Tulsa,Governor,Richard Prawdzienski,IND,720802,0,0,2,2,
Tulsa,Lieutenant Governor,Cathy Cummings,DEM,720802,0,0,70,70,
Tulsa,Lieutenant Governor,Todd Lamb,REP,720802,0,0,199,199,
Tulsa,Superintendent of Public Instruction,John Cox,DEM,720802,0,0,109,109,
Tulsa,Superintendent of Public Instruction,Joy Hofmeister,REP,720802,0,0,159,159,
Tulsa,Commissioner of Labor,Mike Workman,DEM,720802,0,0,98,98,
Tulsa,Commissioner of Labor,Mark Costello,REP,720802,0,0,168,168,
Tulsa,U.S. Senate,Matt Silverstein,DEM,720802,0,0,77,77,
Tulsa,U.S. Senate,Jim Inhofe,REP,720802,0,0,179,179,
Tulsa,U.S. Senate,Aaron Delozier,IND,720802,0,0,3,3,
Tulsa,U.S. Senate,Ray Woods,IND,720802,0,0,5,5,
Tulsa,U.S. Senate,Joan Farr,IND,720802,0,0,3,3,
Tulsa,U.S. Senate,Connie Johnson,DEM,720802,0,0,67,67,
Tulsa,U.S. Senate,James Lankford,REP,720802,0,0,186,186,
Tulsa,U.S. Senate,Mark Beard,IND,720802,0,0,14,14,
Tulsa,Governor,Joe Dorman,DEM,720851,0,0,235,235,
Tulsa,Governor,Mary Fallin,REP,720851,0,0,282,282,
Tulsa,Governor,Kimberly Willis,IND,720851,0,0,14,14,
Tulsa,Governor,Richard Prawdzienski,IND,720851,0,0,2,2,
Tulsa,Lieutenant Governor,Cathy Cummings,DEM,720851,0,0,176,176,
Tulsa,Lieutenant Governor,Todd Lamb,REP,720851,0,0,357,357,
Tulsa,Superintendent of Public Instruction,John Cox,DEM,720851,0,0,223,223,
Tulsa,Superintendent of Public Instruction,Joy Hofmeister,REP,720851,0,0,313,313,
Tulsa,Commissioner of Labor,Mike Workman,DEM,720851,0,0,186,186,
Tulsa,Commissioner of Labor,Mark Costello,REP,720851,0,0,333,333,
Tulsa,U.S. Senate,Matt Silverstein,DEM,720851,0,0,172,172,
Tulsa,U.S. Senate,Jim Inhofe,REP,720851,0,0,345,345,
Tulsa,U.S. Senate,Aaron Delozier,IND,720851,0,0,7,7,
Tulsa,U.S. Senate,Ray Woods,IND,720851,0,0,4,4,
Tulsa,U.S. Senate,Joan Farr,IND,720851,0,0,4,4,
Tulsa,U.S. Senate,Connie Johnson,DEM,720851,0,0,152,152,
Tulsa,U.S. Senate,James Lankford,REP,720851,0,0,362,362,
Tulsa,U.S. Senate,Mark Beard,IND,720851,0,0,17,17,
Tulsa,Governor,Joe Dorman,DEM,720852,0,0,170,170,
Tulsa,Governor,Mary Fallin,REP,720852,0,0,153,153,
Tulsa,Governor,Kimberly Willis,IND,720852,0,0,6,6,
Tulsa,Governor,Richard Prawdzienski,IND,720852,0,0,2,2,
Tulsa,Lieutenant Governor,Cathy Cummings,DEM,720852,0,0,120,120,
Tulsa,Lieutenant Governor,Todd Lamb,REP,720852,0,0,208,208,
Tulsa,Superintendent of Public Instruction,John Cox,DEM,720852,0,0,164,164,
Tulsa,Superintendent of Public Instruction,Joy Hofmeister,REP,720852,0,0,168,168,
Tulsa,Commissioner of Labor,Mike Workman,DEM,720852,0,0,141,141,
Tulsa,Commissioner of Labor,Mark Costello,REP,720852,0,0,179,179,
Tulsa,U.S. Senate,Matt Silverstein,DEM,720852,0,0,127,127,
Tulsa,U.S. Senate,Jim Inhofe,REP,720852,0,0,194,194,
Tulsa,U.S. Senate,Aaron Delozier,IND,720852,0,0,4,4,
Tulsa,U.S. Senate,Ray Woods,IND,720852,0,0,2,2,
Tulsa,U.S. Senate,Joan Farr,IND,720852,0,0,4,4,
Tulsa,U.S. Senate,Connie Johnson,DEM,720852,0,0,117,117,
Tulsa,U.S. Senate,James Lankford,REP,720852,0,0,200,200,
Tulsa,U.S. Senate,Mark Beard,IND,720852,0,0,13,13,
Tulsa,Governor,Joe Dorman,DEM,720853,0,0,142,142,
Tulsa,Governor,Mary Fallin,REP,720853,0,0,237,237,
Tulsa,Governor,Kimberly Willis,IND,720853,0,0,10,10,
Tulsa,Governor,Richard Prawdzienski,IND,720853,0,0,9,9,
Tulsa,Lieutenant Governor,Cathy Cummings,DEM,720853,0,0,97,97,
Tulsa,Lieutenant Governor,Todd Lamb,REP,720853,0,0,300,300,
Tulsa,Superintendent of Public Instruction,John Cox,DEM,720853,0,0,149,149,
Tulsa,Superintendent of Public Instruction,Joy Hofmeister,REP,720853,0,0,248,248,
Tulsa,Commissioner of Labor,Mike Workman,DEM,720853,0,0,122,122,
Tulsa,Commissioner of Labor,Mark Costello,REP,720853,0,0,265,265,
Tulsa,U.S. Senate,Matt Silverstein,DEM,720853,0,0,86,86,
Tulsa,U.S. Senate,Jim Inhofe,REP,720853,0,0,297,297,
Tulsa,U.S. Senate,Aaron Delozier,IND,720853,0,0,5,5,
Tulsa,U.S. Senate,Ray Woods,IND,720853,0,0,7,7,
Tulsa,U.S. Senate,Joan Farr,IND,720853,0,0,5,5,
Tulsa,U.S. Senate,Connie Johnson,DEM,720853,0,0,87,87,
Tulsa,U.S. Senate,James Lankford,REP,720853,0,0,296,296,
Tulsa,U.S. Senate,Mark Beard,IND,720853,0,0,13,13,
Tulsa,Governor,Joe Dorman,DEM,720854,0,0,369,369,
Tulsa,Governor,Mary Fallin,REP,720854,0,0,484,484,
Tulsa,Governor,Kimberly Willis,IND,720854,0,0,16,16,
Tulsa,Governor,Richard Prawdzienski,IND,720854,0,0,7,7,
Tulsa,Lieutenant Governor,Cathy Cummings,DEM,720854,0,0,222,222,
Tulsa,Lieutenant Governor,Todd Lamb,REP,720854,0,0,649,649,
Tulsa,Superintendent of Public Instruction,John Cox,DEM,720854,0,0,349,349,
Tulsa,Superintendent of Public Instruction,Joy Hofmeister,REP,720854,0,0,523,523,
Tulsa,Commissioner of Labor,Mike Workman,DEM,720854,0,0,254,254,
Tulsa,Commissioner of Labor,Mark Costello,REP,720854,0,0,589,589,
Tulsa,U.S. Senate,Matt Silverstein,DEM,720854,0,0,227,227,
Tulsa,U.S. Senate,Jim Inhofe,REP,720854,0,0,615,615,
Tulsa,U.S. Senate,Aaron Delozier,IND,720854,0,0,8,8,
Tulsa,U.S. Senate,Ray Woods,IND,720854,0,0,7,7,
Tulsa,U.S. Senate,Joan Farr,IND,720854,0,0,9,9,
Tulsa,U.S. Senate,Connie Johnson,DEM,720854,0,0,200,200,
Tulsa,U.S. Senate,James Lankford,REP,720854,0,0,648,648,
Tulsa,U.S. Senate,Mark Beard,IND,720854,0,0,22,22,
Tulsa,Governor,Joe Dorman,DEM,720855,0,0,276,276,
Tulsa,Governor,Mary Fallin,REP,720855,0,0,507,507,
Tulsa,Governor,Kimberly Willis,IND,720855,0,0,16,16,
Tulsa,Governor,Richard Prawdzienski,IND,720855,0,0,8,8,
Tulsa,Lieutenant Governor,Cathy Cummings,DEM,720855,0,0,185,185,
Tulsa,Lieutenant Governor,Todd Lamb,REP,720855,0,0,618,618,
Tulsa,Superintendent of Public Instruction,John Cox,DEM,720855,0,0,303,303,
Tulsa,Superintendent of Public Instruction,Joy Hofmeister,REP,720855,0,0,501,501,
Tulsa,Commissioner of Labor,Mike Workman,DEM,720855,0,0,235,235,
Tulsa,Commissioner of Labor,Mark Costello,REP,720855,0,0,552,552,
Tulsa,U.S. Senate,Matt Silverstein,DEM,720855,0,0,180,180,
Tulsa,U.S. Senate,Jim Inhofe,REP,720855,0,0,602,602,
Tulsa,U.S. Senate,Aaron Delozier,IND,720855,0,0,8,8,
Tulsa,U.S. Senate,Ray Woods,IND,720855,0,0,3,3,
Tulsa,U.S. Senate,Joan Farr,IND,720855,0,0,10,10,
Tulsa,U.S. Senate,Connie Johnson,DEM,720855,0,0,174,174,
Tulsa,U.S. Senate,James Lankford,REP,720855,0,0,603,603,
Tulsa,U.S. Senate,Mark Beard,IND,720855,0,0,25,25,
Tulsa,Governor,Joe Dorman,DEM,720856,0,0,331,331,
Tulsa,Governor,Mary Fallin,REP,720856,0,0,503,503,
Tulsa,Governor,Kimberly Willis,IND,720856,0,0,16,16,
Tulsa,Governor,Richard Prawdzienski,IND,720856,0,0,4,4,
Tulsa,Lieutenant Governor,Cathy Cummings,DEM,720856,0,0,196,196,
Tulsa,Lieutenant Governor,Todd Lamb,REP,720856,0,0,647,647,
Tulsa,Superintendent of Public Instruction,John Cox,DEM,720856,0,0,316,316,
Tulsa,Superintendent of Public Instruction,Joy Hofmeister,REP,720856,0,0,531,531,
Tulsa,Commissioner of Labor,Mike Workman,DEM,720856,0,0,233,233,
Tulsa,Commissioner of Labor,Mark Costello,REP,720856,0,0,593,593,
Tulsa,U.S. Senate,Matt Silverstein,DEM,720856,0,0,196,196,
Tulsa,U.S. Senate,Jim Inhofe,REP,720856,0,0,633,633,
Tulsa,U.S. Senate,Aaron Delozier,IND,720856,0,0,2,2,
Tulsa,U.S. Senate,Ray Woods,IND,720856,0,0,5,5,
Tulsa,U.S. Senate,Joan Farr,IND,720856,0,0,6,6,
Tulsa,U.S. Senate,Connie Johnson,DEM,720856,0,0,175,175,
Tulsa,U.S. Senate,James Lankford,REP,720856,0,0,646,646,
Tulsa,U.S. Senate,Mark Beard,IND,720856,0,0,20,20,
Tulsa,Governor,Joe Dorman,DEM,720857,0,0,215,215,
Tulsa,Governor,Mary Fallin,REP,720857,0,0,285,285,
Tulsa,Governor,Kimberly Willis,IND,720857,0,0,19,19,
Tulsa,Governor,Richard Prawdzienski,IND,720857,0,0,7,7,
Tulsa,Lieutenant Governor,Cathy Cummings,DEM,720857,0,0,186,186,
Tulsa,Lieutenant Governor,Todd Lamb,REP,720857,0,0,338,338,
Tulsa,Superintendent of Public Instruction,John Cox,DEM,720857,0,0,231,231,
Tulsa,Superintendent of Public Instruction,Joy Hofmeister,REP,720857,0,0,292,292,
Tulsa,Commissioner of Labor,Mike Workman,DEM,720857,0,0,205,205,
Tulsa,Commissioner of Labor,Mark Costello,REP,720857,0,0,314,314,
Tulsa,U.S. Senate,Matt Silverstein,DEM,720857,0,0,166,166,
Tulsa,U.S. Senate,Jim Inhofe,REP,720857,0,0,339,339,
Tulsa,U.S. Senate,Aaron Delozier,IND,720857,0,0,6,6,
Tulsa,U.S. Senate,Ray Woods,IND,720857,0,0,5,5,
Tulsa,U.S. Senate,Joan Farr,IND,720857,0,0,7,7,
Tulsa,U.S. Senate,Connie Johnson,DEM,720857,0,0,163,163,
Tulsa,U.S. Senate,James Lankford,REP,720857,0,0,346,346,
Tulsa,U.S. Senate,Mark Beard,IND,720857,0,0,16,16,
Tulsa,Governor,Joe Dorman,DEM,720858,0,0,102,102,
Tulsa,Governor,Mary Fallin,REP,720858,0,0,187,187,
Tulsa,Governor,Kimberly Willis,IND,720858,0,0,4,4,
Tulsa,Governor,Richard Prawdzienski,IND,720858,0,0,3,3,
Tulsa,Lieutenant Governor,Cathy Cummings,DEM,720858,0,0,73,73,
Tulsa,Lieutenant Governor,Todd Lamb,REP,720858,0,0,222,222,
Tulsa,Superintendent of Public Instruction,John Cox,DEM,720858,0,0,104,104,
Tulsa,Superintendent of Public Instruction,Joy Hofmeister,REP,720858,0,0,190,190,
Tulsa,Commissioner of Labor,Mike Workman,DEM,720858,0,0,84,84,
Tulsa,Commissioner of Labor,Mark Costello,REP,720858,0,0,203,203,
Tulsa,U.S. Senate,Matt Silverstein,DEM,720858,0,0,73,73,
Tulsa,U.S. Senate,Jim Inhofe,REP,720858,0,0,212,212,
Tulsa,U.S. Senate,Aaron Delozier,IND,720858,0,0,3,3,
Tulsa,U.S. Senate,Ray Woods,IND,720858,0,0,6,6,
Tulsa,U.S. Senate,Joan Farr,IND,720858,0,0,0,0,
Tulsa,U.S. Senate,Connie Johnson,DEM,720858,0,0,63,63,
Tulsa,U.S. Senate,James Lankford,REP,720858,0,0,222,222,
Tulsa,U.S. Senate,Mark Beard,IND,720858,0,0,10,10,
Tulsa,State House,Robert Bobby Talley,DEM,720858,0,0,80,80,29
Tulsa,State House,James Leewright,REP,720858,0,0,212,212,29
Tulsa,Governor,Joe Dorman,DEM,720880,0,0,208,208,
Tulsa,Governor,Mary Fallin,REP,720880,0,0,398,398,
Tulsa,Governor,Kimberly Willis,IND,720880,0,0,11,11,
Tulsa,Governor,Richard Prawdzienski,IND,720880,0,0,11,11,
Tulsa,Lieutenant Governor,Cathy Cummings,DEM,720880,0,0,164,164,
Tulsa,Lieutenant Governor,Todd Lamb,REP,720880,0,0,459,459,
Tulsa,Superintendent of Public Instruction,John Cox,DEM,720880,0,0,234,234,
Tulsa,Superintendent of Public Instruction,Joy Hofmeister,REP,720880,0,0,388,388,
Tulsa,Commissioner of Labor,Mike Workman,DEM,720880,0,0,204,204,
Tulsa,Commissioner of Labor,Mark Costello,REP,720880,0,0,410,410,
Tulsa,U.S. Senate,Matt Silverstein,DEM,720880,0,0,164,164,
Tulsa,U.S. Senate,Jim Inhofe,REP,720880,0,0,438,438,
Tulsa,U.S. Senate,Aaron Delozier,IND,720880,0,0,7,7,
Tulsa,U.S. Senate,Ray Woods,IND,720880,0,0,4,4,
Tulsa,U.S. Senate,Joan Farr,IND,720880,0,0,11,11,
Tulsa,U.S. Senate,Connie Johnson,DEM,720880,0,0,144,144,
Tulsa,U.S. Senate,James Lankford,REP,720880,0,0,457,457,
Tulsa,U.S. Senate,Mark Beard,IND,720880,0,0,23,23,
Tulsa,State House,Robert Bobby Talley,DEM,720880,0,0,183,183,29
Tulsa,State House,James Leewright,REP,720880,0,0,434,434,29
Tulsa,Governor,Joe Dorman,DEM,720881,0,0,174,174,
Tulsa,Governor,Mary Fallin,REP,720881,0,0,264,264,
Tulsa,Governor,Kimberly Willis,IND,720881,0,0,10,10,
Tulsa,Governor,Richard Prawdzienski,IND,720881,0,0,4,4,
Tulsa,Lieutenant Governor,Cathy Cummings,DEM,720881,0,0,126,126,
Tulsa,Lieutenant Governor,Todd Lamb,REP,720881,0,0,323,323,
Tulsa,Superintendent of Public Instruction,John Cox,DEM,720881,0,0,180,180,
Tulsa,Superintendent of Public Instruction,Joy Hofmeister,REP,720881,0,0,272,272,
Tulsa,Commissioner of Labor,Mike Workman,DEM,720881,0,0,163,163,
Tulsa,Commissioner of Labor,Mark Costello,REP,720881,0,0,276,276,
Tulsa,U.S. Senate,Matt Silverstein,DEM,720881,0,0,129,129,
Tulsa,U.S. Senate,Jim Inhofe,REP,720881,0,0,308,308,
Tulsa,U.S. Senate,Aaron Delozier,IND,720881,0,0,7,7,
Tulsa,U.S. Senate,Ray Woods,IND,720881,0,0,3,3,
Tulsa,U.S. Senate,Joan Farr,IND,720881,0,0,1,1,
Tulsa,U.S. Senate,Connie Johnson,DEM,720881,0,0,124,124,
Tulsa,U.S. Senate,James Lankford,REP,720881,0,0,317,317,
Tulsa,U.S. Senate,Mark Beard,IND,720881,0,0,8,8,
Tulsa,Governor,Joe Dorman,DEM,720900,0,0,183,183,
Tulsa,Governor,Mary Fallin,REP,720900,0,0,434,434,
Tulsa,Governor,Kimberly Willis,IND,720900,0,0,16,16,
Tulsa,Governor,Richard Prawdzienski,IND,720900,0,0,1,1,
Tulsa,Lieutenant Governor,Cathy Cummings,DEM,720900,0,0,125,125,
Tulsa,Lieutenant Governor,Todd Lamb,REP,720900,0,0,504,504,
Tulsa,Superintendent of Public Instruction,John Cox,DEM,720900,0,0,222,222,
Tulsa,Superintendent of Public Instruction,Joy Hofmeister,REP,720900,0,0,407,407,
Tulsa,Commissioner of Labor,Mike Workman,DEM,720900,0,0,170,170,
Tulsa,Commissioner of Labor,Mark Costello,REP,720900,0,0,453,453,
Tulsa,U.S. Senate,Matt Silverstein,DEM,720900,0,0,127,127,
Tulsa,U.S. Senate,Jim Inhofe,REP,720900,0,0,488,488,
Tulsa,U.S. Senate,Aaron Delozier,IND,720900,0,0,5,5,
Tulsa,U.S. Senate,Ray Woods,IND,720900,0,0,2,2,
Tulsa,U.S. Senate,Joan Farr,IND,720900,0,0,8,8,
Tulsa,U.S. Senate,Connie Johnson,DEM,720900,0,0,120,120,
Tulsa,U.S. Senate,James Lankford,REP,720900,0,0,501,501,
Tulsa,U.S. Senate,Mark Beard,IND,720900,0,0,12,12,
Tulsa,State House,Jim Massey,DEM,720900,0,0,169,169,36
Tulsa,State House,Sean Roberts,REP,720900,0,0,460,460,36
Tulsa,Governor,Joe Dorman,DEM,729999,1716,2341,0,4057,
Tulsa,Governor,Mary Fallin,REP,729999,2620,2154,0,4774,
Tulsa,Governor,Kimberly Willis,IND,729999,49,65,0,114,
Tulsa,Governor,Richard Prawdzienski,IND,729999,34,29,0,63,
Tulsa,Lieutenant Governor,Cathy Cummings,DEM,729999,1507,2024,0,3531,
Tulsa,Lieutenant Governor,Todd Lamb,REP,729999,2862,2549,0,5411,
Tulsa,Superintendent of Public Instruction,John Cox,DEM,729999,1603,2208,0,3811,
Tulsa,Superintendent of Public Instruction,Joy Hofmeister,REP,729999,2774,2355,0,5129,
Tulsa,Commissioner of Labor,Mike Workman,DEM,729999,1516,2077,0,3593,
Tulsa,Commissioner of Labor,Mark Costello,REP,729999,2730,2389,0,5119,
Tulsa,U.S. Senate,Matt Silverstein,DEM,729999,1455,2033,0,3488,
Tulsa,U.S. Senate,Jim Inhofe,REP,729999,2846,2415,0,5261,
Tulsa,U.S. Senate,Aaron Delozier,IND,729999,35,31,0,66,
Tulsa,U.S. Senate,Ray Woods,IND,729999,20,32,0,52,
Tulsa,U.S. Senate,Joan Farr,IND,729999,57,58,0,115,
Tulsa,U.S. Senate,Connie Johnson,DEM,729999,1426,1950,0,3376,
Tulsa,U.S. Senate,James Lankford,REP,729999,2873,2514,0,5387,
Tulsa,U.S. Senate,Mark Beard,IND,729999,90,103,0,193,
Tulsa,State Senate,Charles Arnall,DEM,729999,5,9,0,14,18
Tulsa,State Senate,Kim David,REP,729999,14,13,0,27,18
Tulsa,State House,Jerry Shoemake,DEM,729999,0,0,0,0,16
Tulsa,State House,James Bo Delso,REP,729999,1,1,0,2,16
Tulsa,State House,Robert Bobby Talley,DEM,729999,6,7,0,13,29
Tulsa,State House,James Leewright,REP,729999,17,16,0,33,29
Tulsa,State House,Jim Massey,DEM,729999,17,17,0,34,36
Tulsa,State House,Sean Roberts,REP,729999,35,19,0,54,36
Tulsa,State House,Glenda Puett,DEM,729999,54,70,0,124,76
Tulsa,State House,David Brumbaugh,REP,729999,123,127,0,250,76
Wagoner,Governor,Joe Dorman,DEM,730101,3,0,135,138,
Wagoner,Governor,Mary Fallin,REP,730101,6,4,213,223,
Wagoner,Governor,Kimberly Willis,IND,730101,0,0,14,14,
Wagoner,Governor,Richard Prawdzienski,IND,730101,0,0,8,8,
Wagoner,Lieutenant Governor,Cathy Cummings,DEM,730101,3,0,106,109,
Wagoner,Lieutenant Governor,Todd Lamb,REP,730101,6,4,264,274,
Wagoner,Superintendent of Public Instruction,John Cox,DEM,730101,4,0,145,149,
Wagoner,Superintendent of Public Instruction,Joy Hofmeister,REP,730101,5,3,224,232,
Wagoner,Commissioner of Labor,Mike Workman,DEM,730101,5,0,123,128,
Wagoner,Commissioner of Labor,Mark Costello,REP,730101,4,3,241,248,
Wagoner,U.S. Senate,Matt Silverstein,DEM,730101,3,0,100,103,
Wagoner,U.S. Senate,Jim Inhofe,REP,730101,6,4,252,262,
Wagoner,U.S. Senate,Aaron Delozier,IND,730101,0,0,2,2,
Wagoner,U.S. Senate,Ray Woods,IND,730101,0,0,5,5,
Wagoner,U.S. Senate,Joan Farr,IND,730101,0,0,10,10,
Wagoner,U.S. Senate,Connie Johnson,DEM,730101,2,0,100,102,
Wagoner,U.S. Senate,James Lankford,REP,730101,6,4,252,262,
Wagoner,U.S. Senate,Mark Beard,IND,730101,1,0,16,17,
Wagoner,State Senate,Charles Arnall,DEM,730101,3,0,113,116,18
Wagoner,State Senate,Kim David,REP,730101,6,4,252,262,18
Wagoner,Governor,Joe Dorman,DEM,730102,0,2,137,139,
Wagoner,Governor,Mary Fallin,REP,730102,4,1,338,343,
Wagoner,Governor,Kimberly Willis,IND,730102,0,0,14,14,
Wagoner,Governor,Richard Prawdzienski,IND,730102,0,0,2,2,
Wagoner,Lieutenant Governor,Cathy Cummings,DEM,730102,1,2,117,120,
Wagoner,Lieutenant Governor,Todd Lamb,REP,730102,3,1,372,376,
Wagoner,Superintendent of Public Instruction,John Cox,DEM,730102,1,2,157,160,
Wagoner,Superintendent of Public Instruction,Joy Hofmeister,REP,730102,2,1,332,335,
Wagoner,Commissioner of Labor,Mike Workman,DEM,730102,1,2,135,138,
Wagoner,Commissioner of Labor,Mark Costello,REP,730102,2,1,350,353,
Wagoner,U.S. Senate,Matt Silverstein,DEM,730102,1,2,105,108,
Wagoner,U.S. Senate,Jim Inhofe,REP,730102,3,1,371,375,
Wagoner,U.S. Senate,Aaron Delozier,IND,730102,0,0,6,6,
Wagoner,U.S. Senate,Ray Woods,IND,730102,0,0,5,5,
Wagoner,U.S. Senate,Joan Farr,IND,730102,0,0,5,5,
Wagoner,U.S. Senate,Connie Johnson,DEM,730102,0,2,103,105,
Wagoner,U.S. Senate,James Lankford,REP,730102,4,1,372,377,
Wagoner,U.S. Senate,Mark Beard,IND,730102,0,0,17,17,
Wagoner,State Senate,Charles Arnall,DEM,730102,1,2,117,120,18
Wagoner,State Senate,Kim David,REP,730102,2,1,369,372,18
Wagoner,Governor,Joe Dorman,DEM,730103,2,0,279,281,
Wagoner,Governor,Mary Fallin,REP,730103,7,8,582,597,
Wagoner,Governor,Kimberly Willis,IND,730103,0,0,22,22,
Wagoner,Governor,Richard Prawdzienski,IND,730103,0,0,15,15,
Wagoner,Lieutenant Governor,Cathy Cummings,DEM,730103,2,0,228,230,
Wagoner,Lieutenant Governor,Todd Lamb,REP,730103,7,8,665,680,
Wagoner,Superintendent of Public Instruction,John Cox,DEM,730103,2,0,296,298,
Wagoner,Superintendent of Public Instruction,Joy Hofmeister,REP,730103,7,8,599,614,
Wagoner,Commissioner of Labor,Mike Workman,DEM,730103,2,0,255,257,
Wagoner,Commissioner of Labor,Mark Costello,REP,730103,7,8,633,648,
Wagoner,U.S. Senate,Matt Silverstein,DEM,730103,2,0,224,226,
Wagoner,U.S. Senate,Jim Inhofe,REP,730103,7,8,642,657,
Wagoner,U.S. Senate,Aaron Delozier,IND,730103,0,0,17,17,
Wagoner,U.S. Senate,Ray Woods,IND,730103,0,0,4,4,
Wagoner,U.S. Senate,Joan Farr,IND,730103,0,0,10,10,
Wagoner,U.S. Senate,Connie Johnson,DEM,730103,2,0,207,209,
Wagoner,U.S. Senate,James Lankford,REP,730103,7,8,662,677,
Wagoner,U.S. Senate,Mark Beard,IND,730103,0,0,29,29,
Wagoner,State Senate,Charles Arnall,DEM,730103,2,0,231,233,18
Wagoner,State Senate,Kim David,REP,730103,7,8,657,672,18
Wagoner,Governor,Joe Dorman,DEM,730104,0,0,0,0,
Wagoner,Governor,Mary Fallin,REP,730104,0,0,0,0,
Wagoner,Governor,Kimberly Willis,IND,730104,0,0,0,0,
Wagoner,Governor,Richard Prawdzienski,IND,730104,0,0,0,0,
Wagoner,Lieutenant Governor,Cathy Cummings,DEM,730104,0,0,0,0,
Wagoner,Lieutenant Governor,Todd Lamb,REP,730104,0,0,0,0,
Wagoner,Superintendent of Public Instruction,John Cox,DEM,730104,0,0,0,0,
Wagoner,Superintendent of Public Instruction,Joy Hofmeister,REP,730104,0,0,0,0,
Wagoner,Commissioner of Labor,Mike Workman,DEM,730104,0,0,0,0,
Wagoner,Commissioner of Labor,Mark Costello,REP,730104,0,0,0,0,
Wagoner,U.S. Senate,Matt Silverstein,DEM,730104,0,0,0,0,
Wagoner,U.S. Senate,Jim Inhofe,REP,730104,0,0,0,0,
Wagoner,U.S. Senate,Aaron Delozier,IND,730104,0,0,0,0,
Wagoner,U.S. Senate,Ray Woods,IND,730104,0,0,0,0,
Wagoner,U.S. Senate,Joan Farr,IND,730104,0,0,0,0,
Wagoner,U.S. Senate,Connie Johnson,DEM,730104,0,0,0,0,
Wagoner,U.S. Senate,James Lankford,REP,730104,0,0,0,0,
Wagoner,U.S. Senate,Mark Beard,IND,730104,0,0,0,0,
Wagoner,State Senate,Charles Arnall,DEM,730104,0,0,0,0,18
Wagoner,State Senate,Kim David,REP,730104,0,0,0,0,18
Wagoner,State House,Wade Rousselot,DEM,730104,0,0,0,0,12
Wagoner,State House,David Tackett,REP,730104,0,0,0,0,12
Wagoner,Governor,Joe Dorman,DEM,730105,0,0,0,0,
Wagoner,Governor,Mary Fallin,REP,730105,0,0,4,4,
Wagoner,Governor,Kimberly Willis,IND,730105,0,0,0,0,
Wagoner,Governor,Richard Prawdzienski,IND,730105,0,0,0,0,
Wagoner,Lieutenant Governor,Cathy Cummings,DEM,730105,0,0,0,0,
Wagoner,Lieutenant Governor,Todd Lamb,REP,730105,0,0,4,4,
Wagoner,Superintendent of Public Instruction,John Cox,DEM,730105,0,0,0,0,
Wagoner,Superintendent of Public Instruction,Joy Hofmeister,REP,730105,0,0,4,4,
Wagoner,Commissioner of Labor,Mike Workman,DEM,730105,0,0,0,0,
Wagoner,Commissioner of Labor,Mark Costello,REP,730105,0,0,4,4,
Wagoner,U.S. Senate,Matt Silverstein,DEM,730105,0,0,0,0,
Wagoner,U.S. Senate,Jim Inhofe,REP,730105,0,0,4,4,
Wagoner,U.S. Senate,Aaron Delozier,IND,730105,0,0,0,0,
Wagoner,U.S. Senate,Ray Woods,IND,730105,0,0,0,0,
Wagoner,U.S. Senate,Joan Farr,IND,730105,0,0,0,0,
Wagoner,U.S. Senate,Connie Johnson,DEM,730105,0,0,0,0,
Wagoner,U.S. Senate,James Lankford,REP,730105,0,0,4,4,
Wagoner,U.S. Senate,Mark Beard,IND,730105,0,0,0,0,
Wagoner,Governor,Joe Dorman,DEM,730106,6,3,280,289,
Wagoner,Governor,Mary Fallin,REP,730106,22,10,601,633,
Wagoner,Governor,Kimberly Willis,IND,730106,0,0,20,20,
Wagoner,Governor,Richard Prawdzienski,IND,730106,1,0,12,13,
Wagoner,Lieutenant Governor,Cathy Cummings,DEM,730106,5,3,208,216,
Wagoner,Lieutenant Governor,Todd Lamb,REP,730106,25,10,700,735,
Wagoner,Superintendent of Public Instruction,John Cox,DEM,730106,5,3,286,294,
Wagoner,Superintendent of Public Instruction,Joy Hofmeister,REP,730106,24,10,621,655,
Wagoner,Commissioner of Labor,Mike Workman,DEM,730106,4,3,223,230,
Wagoner,Commissioner of Labor,Mark Costello,REP,730106,25,10,681,716,
Wagoner,U.S. Senate,Matt Silverstein,DEM,730106,4,3,206,213,
Wagoner,U.S. Senate,Jim Inhofe,REP,730106,26,10,681,717,
Wagoner,U.S. Senate,Aaron Delozier,IND,730106,0,0,6,6,
Wagoner,U.S. Senate,Ray Woods,IND,730106,0,0,7,7,
Wagoner,U.S. Senate,Joan Farr,IND,730106,0,0,11,11,
Wagoner,U.S. Senate,Connie Johnson,DEM,730106,5,3,195,203,
Wagoner,U.S. Senate,James Lankford,REP,730106,24,10,687,721,
Wagoner,U.S. Senate,Mark Beard,IND,730106,0,0,29,29,
Wagoner,Governor,Joe Dorman,DEM,730107,13,3,299,315,
Wagoner,Governor,Mary Fallin,REP,730107,29,7,601,637,
Wagoner,Governor,Kimberly Willis,IND,730107,0,0,21,21,
Wagoner,Governor,Richard Prawdzienski,IND,730107,0,0,10,10,
Wagoner,Lieutenant Governor,Cathy Cummings,DEM,730107,8,2,224,234,
Wagoner,Lieutenant Governor,Todd Lamb,REP,730107,34,8,703,745,
Wagoner,Superintendent of Public Instruction,John Cox,DEM,730107,13,4,291,308,
Wagoner,Superintendent of Public Instruction,Joy Hofmeister,REP,730107,29,6,637,672,
Wagoner,Commissioner of Labor,Mike Workman,DEM,730107,14,2,252,268,
Wagoner,Commissioner of Labor,Mark Costello,REP,730107,27,7,656,690,
Wagoner,U.S. Senate,Matt Silverstein,DEM,730107,12,2,208,222,
Wagoner,U.S. Senate,Jim Inhofe,REP,730107,30,8,692,730,
Wagoner,U.S. Senate,Aaron Delozier,IND,730107,0,0,8,8,
Wagoner,U.S. Senate,Ray Woods,IND,730107,0,0,12,12,
Wagoner,U.S. Senate,Joan Farr,IND,730107,0,0,9,9,
Wagoner,U.S. Senate,Connie Johnson,DEM,730107,9,2,197,208,
Wagoner,U.S. Senate,James Lankford,REP,730107,33,8,704,745,
Wagoner,U.S. Senate,Mark Beard,IND,730107,0,0,21,21,
Wagoner,Governor,Joe Dorman,DEM,730108,6,2,147,155,
Wagoner,Governor,Mary Fallin,REP,730108,9,5,343,357,
Wagoner,Governor,Kimberly Willis,IND,730108,2,0,10,12,
Wagoner,Governor,Richard Prawdzienski,IND,730108,0,0,7,7,
Wagoner,Lieutenant Governor,Cathy Cummings,DEM,730108,7,2,110,119,
Wagoner,Lieutenant Governor,Todd Lamb,REP,730108,10,5,396,411,
Wagoner,Superintendent of Public Instruction,John Cox,DEM,730108,5,2,145,152,
Wagoner,Superintendent of Public Instruction,Joy Hofmeister,REP,730108,12,5,355,372,
Wagoner,Commissioner of Labor,Mike Workman,DEM,730108,7,2,128,137,
Wagoner,Commissioner of Labor,Mark Costello,REP,730108,10,5,367,382,
Wagoner,U.S. Senate,Matt Silverstein,DEM,730108,5,2,112,119,
Wagoner,U.S. Senate,Jim Inhofe,REP,730108,10,5,379,394,
Wagoner,U.S. Senate,Aaron Delozier,IND,730108,1,0,5,6,
Wagoner,U.S. Senate,Ray Woods,IND,730108,0,0,4,4,
Wagoner,U.S. Senate,Joan Farr,IND,730108,1,0,5,6,
Wagoner,U.S. Senate,Connie Johnson,DEM,730108,7,2,99,108,
Wagoner,U.S. Senate,James Lankford,REP,730108,10,5,390,405,
Wagoner,U.S. Senate,Mark Beard,IND,730108,0,0,15,15,
Wagoner,State House,Wade Rousselot,DEM,730108,7,2,165,174,12
Wagoner,State House,David Tackett,REP,730108,10,5,340,355,12
Wagoner,Governor,Joe Dorman,DEM,730109,6,6,134,146,
Wagoner,Governor,Mary Fallin,REP,730109,15,12,415,442,
Wagoner,Governor,Kimberly Willis,IND,730109,0,1,10,11,
Wagoner,Governor,Richard Prawdzienski,IND,730109,0,0,5,5,
Wagoner,Lieutenant Governor,Cathy Cummings,DEM,730109,6,5,98,109,
Wagoner,Lieutenant Governor,Todd Lamb,REP,730109,15,14,465,494,
Wagoner,Superintendent of Public Instruction,John Cox,DEM,730109,8,11,160,179,
Wagoner,Superintendent of Public Instruction,Joy Hofmeister,REP,730109,13,7,401,421,
Wagoner,Commissioner of Labor,Mike Workman,DEM,730109,4,7,118,129,
Wagoner,Commissioner of Labor,Mark Costello,REP,730109,16,12,438,466,
Wagoner,U.S. Senate,Matt Silverstein,DEM,730109,6,3,108,117,
Wagoner,U.S. Senate,Jim Inhofe,REP,730109,13,15,442,470,
Wagoner,U.S. Senate,Aaron Delozier,IND,730109,1,0,5,6,
Wagoner,U.S. Senate,Ray Woods,IND,730109,1,1,2,4,
Wagoner,U.S. Senate,Joan Farr,IND,730109,0,0,3,3,
Wagoner,U.S. Senate,Connie Johnson,DEM,730109,3,4,93,100,
Wagoner,U.S. Senate,James Lankford,REP,730109,18,15,456,489,
Wagoner,U.S. Senate,Mark Beard,IND,730109,0,0,13,13,
Wagoner,State Senate,Charles Arnall,DEM,730109,5,5,101,111,18
Wagoner,State Senate,Kim David,REP,730109,16,14,456,486,18
Wagoner,State House,Wade Rousselot,DEM,730109,7,9,212,228,12
Wagoner,State House,David Tackett,REP,730109,14,10,348,372,12
Wagoner,Governor,Joe Dorman,DEM,730201,3,5,200,208,
Wagoner,Governor,Mary Fallin,REP,730201,18,13,381,412,
Wagoner,Governor,Kimberly Willis,IND,730201,0,0,21,21,
Wagoner,Governor,Richard Prawdzienski,IND,730201,0,0,6,6,
Wagoner,Lieutenant Governor,Cathy Cummings,DEM,730201,1,3,157,161,
Wagoner,Lieutenant Governor,Todd Lamb,REP,730201,20,15,448,483,
Wagoner,Superintendent of Public Instruction,John Cox,DEM,730201,1,4,227,232,
Wagoner,Superintendent of Public Instruction,Joy Hofmeister,REP,730201,20,14,377,411,
Wagoner,Commissioner of Labor,Mike Workman,DEM,730201,2,2,182,186,
Wagoner,Commissioner of Labor,Mark Costello,REP,730201,19,16,419,454,
Wagoner,U.S. Senate,Matt Silverstein,DEM,730201,1,2,141,144,
Wagoner,U.S. Senate,Jim Inhofe,REP,730201,20,16,441,477,
Wagoner,U.S. Senate,Aaron Delozier,IND,730201,0,0,4,4,
Wagoner,U.S. Senate,Ray Woods,IND,730201,0,0,8,8,
Wagoner,U.S. Senate,Joan Farr,IND,730201,0,0,12,12,
Wagoner,U.S. Senate,Connie Johnson,DEM,730201,1,2,135,138,
Wagoner,U.S. Senate,James Lankford,REP,730201,20,15,454,489,
Wagoner,U.S. Senate,Mark Beard,IND,730201,0,1,17,18,
Wagoner,State Senate,Charles Arnall,DEM,730201,1,2,160,163,18
Wagoner,State Senate,Kim David,REP,730201,20,16,441,477,18
Wagoner,State House,Wade Rousselot,DEM,730201,2,7,262,271,12
Wagoner,State House,David Tackett,REP,730201,19,10,344,373,12
Wagoner,Governor,Joe Dorman,DEM,730202,6,4,225,235,
Wagoner,Governor,Mary Fallin,REP,730202,7,5,485,497,
Wagoner,Governor,Kimberly Willis,IND,730202,1,1,18,20,
Wagoner,Governor,Richard Prawdzienski,IND,730202,1,0,6,7,
Wagoner,Lieutenant Governor,Cathy Cummings,DEM,730202,5,2,148,155,
Wagoner,Lieutenant Governor,Todd Lamb,REP,730202,10,8,585,603,
Wagoner,Superintendent of Public Instruction,John Cox,DEM,730202,8,4,262,274,
Wagoner,Superintendent of Public Instruction,Joy Hofmeister,REP,730202,7,6,473,486,
Wagoner,Commissioner of Labor,Mike Workman,DEM,730202,5,4,195,204,
Wagoner,Commissioner of Labor,Mark Costello,REP,730202,10,6,528,544,
Wagoner,U.S. Senate,Matt Silverstein,DEM,730202,6,4,148,158,
Wagoner,U.S. Senate,Jim Inhofe,REP,730202,7,6,562,575,
Wagoner,U.S. Senate,Aaron Delozier,IND,730202,2,0,5,7,
Wagoner,U.S. Senate,Ray Woods,IND,730202,0,0,4,4,
Wagoner,U.S. Senate,Joan Farr,IND,730202,0,0,12,12,
Wagoner,U.S. Senate,Connie Johnson,DEM,730202,5,3,129,137,
Wagoner,U.S. Senate,James Lankford,REP,730202,9,6,579,594,
Wagoner,U.S. Senate,Mark Beard,IND,730202,1,1,24,26,
Wagoner,State Senate,Charles Arnall,DEM,730202,5,3,164,172,18
Wagoner,State Senate,Kim David,REP,730202,10,7,563,580,18
Wagoner,State House,Wade Rousselot,DEM,730202,8,5,287,300,12
Wagoner,State House,David Tackett,REP,730202,7,5,443,455,12
Wagoner,Governor,Joe Dorman,DEM,730203,10,18,327,355,
Wagoner,Governor,Mary Fallin,REP,730203,12,34,449,495,
Wagoner,Governor,Kimberly Willis,IND,730203,0,0,25,25,
Wagoner,Governor,Richard Prawdzienski,IND,730203,0,0,6,6,
Wagoner,Lieutenant Governor,Cathy Cummings,DEM,730203,8,9,250,267,
Wagoner,Lieutenant Governor,Todd Lamb,REP,730203,14,42,553,609,
Wagoner,Superintendent of Public Instruction,John Cox,DEM,730203,9,23,414,446,
Wagoner,Superintendent of Public Instruction,Joy Hofmeister,REP,730203,13,28,393,434,
Wagoner,Commissioner of Labor,Mike Workman,DEM,730203,8,12,327,347,
Wagoner,Commissioner of Labor,Mark Costello,REP,730203,14,36,472,522,
Wagoner,U.S. Senate,Matt Silverstein,DEM,730203,8,12,214,234,
Wagoner,U.S. Senate,Jim Inhofe,REP,730203,14,40,566,620,
Wagoner,U.S. Senate,Aaron Delozier,IND,730203,0,0,8,8,
Wagoner,U.S. Senate,Ray Woods,IND,730203,0,0,9,9,
Wagoner,U.S. Senate,Joan Farr,IND,730203,0,0,9,9,
Wagoner,U.S. Senate,Connie Johnson,DEM,730203,6,8,228,242,
Wagoner,U.S. Senate,James Lankford,REP,730203,15,42,553,610,
Wagoner,U.S. Senate,Mark Beard,IND,730203,1,1,25,27,
Wagoner,State Senate,Charles Arnall,DEM,730203,10,10,242,262,18
Wagoner,State Senate,Kim David,REP,730203,12,42,563,617,18
Wagoner,State House,Wade Rousselot,DEM,730203,9,26,522,557,12
Wagoner,State House,David Tackett,REP,730203,13,26,284,323,12
Wagoner,Governor,Joe Dorman,DEM,730204,2,7,176,185,
Wagoner,Governor,Mary Fallin,REP,730204,4,6,273,283,
Wagoner,Governor,Kimberly Willis,IND,730204,0,0,16,16,
Wagoner,Governor,Richard Prawdzienski,IND,730204,0,0,3,3,
Wagoner,Lieutenant Governor,Cathy Cummings,DEM,730204,2,6,152,160,
Wagoner,Lieutenant Governor,Todd Lamb,REP,730204,4,7,312,323,
Wagoner,Superintendent of Public Instruction,John Cox,DEM,730204,3,7,210,220,
Wagoner,Superintendent of Public Instruction,Joy Hofmeister,REP,730204,3,6,256,265,
Wagoner,Commissioner of Labor,Mike Workman,DEM,730204,3,5,194,202,
Wagoner,Commissioner of Labor,Mark Costello,REP,730204,3,8,268,279,
Wagoner,U.S. Senate,Matt Silverstein,DEM,730204,2,7,139,148,
Wagoner,U.S. Senate,Jim Inhofe,REP,730204,4,6,299,309,
Wagoner,U.S. Senate,Aaron Delozier,IND,730204,0,0,12,12,
Wagoner,U.S. Senate,Ray Woods,IND,730204,0,0,7,7,
Wagoner,U.S. Senate,Joan Farr,IND,730204,0,0,7,7,
Wagoner,U.S. Senate,Connie Johnson,DEM,730204,2,4,143,149,
Wagoner,U.S. Senate,James Lankford,REP,730204,4,9,292,305,
Wagoner,U.S. Senate,Mark Beard,IND,730204,0,0,30,30,
Wagoner,State Senate,Charles Arnall,DEM,730204,3,2,160,165,18
Wagoner,State Senate,Kim David,REP,730204,3,11,304,318,18
Wagoner,State House,Wade Rousselot,DEM,730204,4,6,243,253,12
Wagoner,State House,David Tackett,REP,730204,2,7,222,231,12
Wagoner,Governor,Joe Dorman,DEM,730205,2,0,26,28,
Wagoner,Governor,Mary Fallin,REP,730205,3,0,65,68,
Wagoner,Governor,Kimberly Willis,IND,730205,0,0,3,3,
Wagoner,Governor,Richard Prawdzienski,IND,730205,0,0,0,0,
Wagoner,Lieutenant Governor,Cathy Cummings,DEM,730205,2,0,22,24,
Wagoner,Lieutenant Governor,Todd Lamb,REP,730205,3,0,70,73,
Wagoner,Superintendent of Public Instruction,John Cox,DEM,730205,3,0,28,31,
Wagoner,Superintendent of Public Instruction,Joy Hofmeister,REP,730205,1,0,65,66,
Wagoner,Commissioner of Labor,Mike Workman,DEM,730205,5,0,26,31,
Wagoner,Commissioner of Labor,Mark Costello,REP,730205,0,0,67,67,
Wagoner,U.S. Senate,Matt Silverstein,DEM,730205,2,0,20,22,
Wagoner,U.S. Senate,Jim Inhofe,REP,730205,3,0,70,73,
Wagoner,U.S. Senate,Aaron Delozier,IND,730205,0,0,1,1,
Wagoner,U.S. Senate,Ray Woods,IND,730205,0,0,2,2,
Wagoner,U.S. Senate,Joan Farr,IND,730205,0,0,0,0,
Wagoner,U.S. Senate,Connie Johnson,DEM,730205,2,0,18,20,
Wagoner,U.S. Senate,James Lankford,REP,730205,2,0,73,75,
Wagoner,U.S. Senate,Mark Beard,IND,730205,1,0,2,3,
Wagoner,State Senate,Charles Arnall,DEM,730205,2,0,23,25,18
Wagoner,State Senate,Kim David,REP,730205,3,0,70,73,18
Wagoner,State House,Wade Rousselot,DEM,730205,4,0,32,36,12
Wagoner,State House,David Tackett,REP,730205,1,0,62,63,12
Wagoner,Governor,Joe Dorman,DEM,730206,0,0,14,14,
Wagoner,Governor,Mary Fallin,REP,730206,0,2,14,16,
Wagoner,Governor,Kimberly Willis,IND,730206,0,0,2,2,
Wagoner,Governor,Richard Prawdzienski,IND,730206,0,0,1,1,
Wagoner,Lieutenant Governor,Cathy Cummings,DEM,730206,0,0,10,10,
Wagoner,Lieutenant Governor,Todd Lamb,REP,730206,0,2,21,23,
Wagoner,Superintendent of Public Instruction,John Cox,DEM,730206,0,0,17,17,
Wagoner,Superintendent of Public Instruction,Joy Hofmeister,REP,730206,0,2,14,16,
Wagoner,Commissioner of Labor,Mike Workman,DEM,730206,0,0,12,12,
Wagoner,Commissioner of Labor,Mark Costello,REP,730206,0,2,19,21,
Wagoner,U.S. Senate,Matt Silverstein,DEM,730206,0,0,9,9,
Wagoner,U.S. Senate,Jim Inhofe,REP,730206,0,2,20,22,
Wagoner,U.S. Senate,Aaron Delozier,IND,730206,0,0,1,1,
Wagoner,U.S. Senate,Ray Woods,IND,730206,0,0,0,0,
Wagoner,U.S. Senate,Joan Farr,IND,730206,0,0,1,1,
Wagoner,U.S. Senate,Connie Johnson,DEM,730206,0,0,10,10,
Wagoner,U.S. Senate,James Lankford,REP,730206,0,2,17,19,
Wagoner,U.S. Senate,Mark Beard,IND,730206,0,0,4,4,
Wagoner,State Senate,Charles Arnall,DEM,730206,0,0,11,11,18
Wagoner,State Senate,Kim David,REP,730206,0,2,20,22,18
Wagoner,State House,Wade Rousselot,DEM,730206,0,1,16,17,12
Wagoner,State House,David Tackett,REP,730206,0,1,15,16,12
Wagoner,Governor,Joe Dorman,DEM,730207,2,4,168,174,
Wagoner,Governor,Mary Fallin,REP,730207,1,3,65,69,
Wagoner,Governor,Kimberly Willis,IND,730207,0,0,8,8,
Wagoner,Governor,Richard Prawdzienski,IND,730207,0,0,2,2,
Wagoner,Lieutenant Governor,Cathy Cummings,DEM,730207,1,3,156,160,
Wagoner,Lieutenant Governor,Todd Lamb,REP,730207,2,4,87,93,
Wagoner,Superintendent of Public Instruction,John Cox,DEM,730207,3,3,181,187,
Wagoner,Superintendent of Public Instruction,Joy Hofmeister,REP,730207,0,4,61,65,
Wagoner,Commissioner of Labor,Mike Workman,DEM,730207,2,4,165,171,
Wagoner,Commissioner of Labor,Mark Costello,REP,730207,1,3,78,82,
Wagoner,U.S. Senate,Matt Silverstein,DEM,730207,1,2,142,145,
Wagoner,U.S. Senate,Jim Inhofe,REP,730207,2,5,92,99,
Wagoner,U.S. Senate,Aaron Delozier,IND,730207,0,0,1,1,
Wagoner,U.S. Senate,Ray Woods,IND,730207,0,0,3,3,
Wagoner,U.S. Senate,Joan Farr,IND,730207,0,0,4,4,
Wagoner,U.S. Senate,Connie Johnson,DEM,730207,1,3,143,147,
Wagoner,U.S. Senate,James Lankford,REP,730207,2,4,88,94,
Wagoner,U.S. Senate,Mark Beard,IND,730207,0,0,11,11,
Wagoner,State Senate,Charles Arnall,DEM,730207,1,3,146,150,18
Wagoner,State Senate,Kim David,REP,730207,2,4,97,103,18
Wagoner,State House,Wade Rousselot,DEM,730207,3,2,188,193,12
Wagoner,State House,David Tackett,REP,730207,0,4,55,59,12
Wagoner,Governor,Joe Dorman,DEM,730208,6,48,454,508,
Wagoner,Governor,Mary Fallin,REP,730208,17,50,475,542,
Wagoner,Governor,Kimberly Willis,IND,730208,0,0,30,30,
Wagoner,Governor,Richard Prawdzienski,IND,730208,0,0,16,16,
Wagoner,Lieutenant Governor,Cathy Cummings,DEM,730208,6,38,358,402,
Wagoner,Lieutenant Governor,Todd Lamb,REP,730208,17,59,614,690,
Wagoner,Superintendent of Public Instruction,John Cox,DEM,730208,8,53,538,599,
Wagoner,Superintendent of Public Instruction,Joy Hofmeister,REP,730208,14,44,432,490,
Wagoner,Commissioner of Labor,Mike Workman,DEM,730208,5,44,446,495,
Wagoner,Commissioner of Labor,Mark Costello,REP,730208,17,51,512,580,
Wagoner,U.S. Senate,Matt Silverstein,DEM,730208,3,38,334,375,
Wagoner,U.S. Senate,Jim Inhofe,REP,730208,19,56,596,671,
Wagoner,U.S. Senate,Aaron Delozier,IND,730208,0,1,9,10,
Wagoner,U.S. Senate,Ray Woods,IND,730208,1,0,21,22,
Wagoner,U.S. Senate,Joan Farr,IND,730208,0,2,11,13,
Wagoner,U.S. Senate,Connie Johnson,DEM,730208,4,37,327,368,
Wagoner,U.S. Senate,James Lankford,REP,730208,18,58,597,673,
Wagoner,U.S. Senate,Mark Beard,IND,730208,1,2,43,46,
Wagoner,State Senate,Charles Arnall,DEM,730208,5,37,355,397,18
Wagoner,State Senate,Kim David,REP,730208,18,60,617,695,18
Wagoner,State House,Wade Rousselot,DEM,730208,12,72,657,741,12
Wagoner,State House,David Tackett,REP,730208,11,24,319,354,12
Wagoner,Governor,Joe Dorman,DEM,730209,1,6,91,98,
Wagoner,Governor,Mary Fallin,REP,730209,4,10,141,155,
Wagoner,Governor,Kimberly Willis,IND,730209,0,0,6,6,
Wagoner,Governor,Richard Prawdzienski,IND,730209,0,0,2,2,
Wagoner,Lieutenant Governor,Cathy Cummings,DEM,730209,1,2,71,74,
Wagoner,Lieutenant Governor,Todd Lamb,REP,730209,4,14,168,186,
Wagoner,Superintendent of Public Instruction,John Cox,DEM,730209,1,5,109,115,
Wagoner,Superintendent of Public Instruction,Joy Hofmeister,REP,730209,4,11,129,144,
Wagoner,Commissioner of Labor,Mike Workman,DEM,730209,0,1,91,92,
Wagoner,Commissioner of Labor,Mark Costello,REP,730209,5,15,144,164,
Wagoner,U.S. Senate,Matt Silverstein,DEM,730209,1,2,68,71,
Wagoner,U.S. Senate,Jim Inhofe,REP,730209,4,14,165,183,
Wagoner,U.S. Senate,Aaron Delozier,IND,730209,0,0,1,1,
Wagoner,U.S. Senate,Ray Woods,IND,730209,0,0,2,2,
Wagoner,U.S. Senate,Joan Farr,IND,730209,0,0,3,3,
Wagoner,U.S. Senate,Connie Johnson,DEM,730209,0,3,67,70,
Wagoner,U.S. Senate,James Lankford,REP,730209,5,13,164,182,
Wagoner,U.S. Senate,Mark Beard,IND,730209,0,0,6,6,
Wagoner,State Senate,Charles Arnall,DEM,730209,1,0,79,80,18
Wagoner,State Senate,Kim David,REP,730209,4,16,160,180,18
Wagoner,State House,Wade Rousselot,DEM,730209,1,5,123,129,12
Wagoner,State House,David Tackett,REP,730209,4,11,117,132,12
Wagoner,Governor,Joe Dorman,DEM,730210,3,12,334,349,
Wagoner,Governor,Mary Fallin,REP,730210,11,8,402,421,
Wagoner,Governor,Kimberly Willis,IND,730210,0,0,16,16,
Wagoner,Governor,Richard Prawdzienski,IND,730210,0,0,9,9,
Wagoner,Lieutenant Governor,Cathy Cummings,DEM,730210,1,13,264,278,
Wagoner,Lieutenant Governor,Todd Lamb,REP,730210,13,7,492,512,
Wagoner,Superintendent of Public Instruction,John Cox,DEM,730210,4,16,404,424,
Wagoner,Superintendent of Public Instruction,Joy Hofmeister,REP,730210,10,4,350,364,
Wagoner,Commissioner of Labor,Mike Workman,DEM,730210,1,12,354,367,
Wagoner,Commissioner of Labor,Mark Costello,REP,730210,12,8,388,408,
Wagoner,U.S. Senate,Matt Silverstein,DEM,730210,1,11,228,240,
Wagoner,U.S. Senate,Jim Inhofe,REP,730210,12,8,500,520,
Wagoner,U.S. Senate,Aaron Delozier,IND,730210,0,0,9,9,
Wagoner,U.S. Senate,Ray Woods,IND,730210,0,1,8,9,
Wagoner,U.S. Senate,Joan Farr,IND,730210,0,0,12,12,
Wagoner,U.S. Senate,Connie Johnson,DEM,730210,0,9,252,261,
Wagoner,U.S. Senate,James Lankford,REP,730210,12,11,466,489,
Wagoner,U.S. Senate,Mark Beard,IND,730210,2,0,37,39,
Wagoner,State Senate,Charles Arnall,DEM,730210,2,7,260,269,18
Wagoner,State Senate,Kim David,REP,730210,11,13,497,521,18
Wagoner,State House,Wade Rousselot,DEM,730210,9,14,564,587,12
Wagoner,State House,David Tackett,REP,730210,4,6,201,211,12
Wagoner,Governor,Joe Dorman,DEM,730301,0,1,174,175,
Wagoner,Governor,Mary Fallin,REP,730301,20,7,481,508,
Wagoner,Governor,Kimberly Willis,IND,730301,0,0,4,4,
Wagoner,Governor,Richard Prawdzienski,IND,730301,0,0,3,3,
Wagoner,Lieutenant Governor,Cathy Cummings,DEM,730301,0,2,117,119,
Wagoner,Lieutenant Governor,Todd Lamb,REP,730301,20,6,543,569,
Wagoner,Superintendent of Public Instruction,John Cox,DEM,730301,0,1,177,178,
Wagoner,Superintendent of Public Instruction,Joy Hofmeister,REP,730301,20,7,481,508,
Wagoner,Commissioner of Labor,Mike Workman,DEM,730301,0,2,135,137,
Wagoner,Commissioner of Labor,Mark Costello,REP,730301,19,6,512,537,
Wagoner,U.S. Senate,Matt Silverstein,DEM,730301,0,1,120,121,
Wagoner,U.S. Senate,Jim Inhofe,REP,730301,20,6,529,555,
Wagoner,U.S. Senate,Aaron Delozier,IND,730301,0,0,3,3,
Wagoner,U.S. Senate,Ray Woods,IND,730301,1,0,3,4,
Wagoner,U.S. Senate,Joan Farr,IND,730301,0,1,6,7,
Wagoner,U.S. Senate,Connie Johnson,DEM,730301,0,1,113,114,
Wagoner,U.S. Senate,James Lankford,REP,730301,21,6,541,568,
Wagoner,U.S. Senate,Mark Beard,IND,730301,0,1,5,6,
Wagoner,Governor,Joe Dorman,DEM,730302,5,2,265,272,
Wagoner,Governor,Mary Fallin,REP,730302,17,7,822,846,
Wagoner,Governor,Kimberly Willis,IND,730302,1,0,14,15,
Wagoner,Governor,Richard Prawdzienski,IND,730302,0,0,3,3,
Wagoner,Lieutenant Governor,Cathy Cummings,DEM,730302,5,1,171,177,
Wagoner,Lieutenant Governor,Todd Lamb,REP,730302,19,8,931,958,
Wagoner,Superintendent of Public Instruction,John Cox,DEM,730302,7,2,259,268,
Wagoner,Superintendent of Public Instruction,Joy Hofmeister,REP,730302,17,7,842,866,
Wagoner,Commissioner of Labor,Mike Workman,DEM,730302,4,1,217,222,
Wagoner,Commissioner of Labor,Mark Costello,REP,730302,19,8,861,888,
Wagoner,U.S. Senate,Matt Silverstein,DEM,730302,5,1,183,189,
Wagoner,U.S. Senate,Jim Inhofe,REP,730302,18,8,891,917,
Wagoner,U.S. Senate,Aaron Delozier,IND,730302,0,0,7,7,
Wagoner,U.S. Senate,Ray Woods,IND,730302,1,0,6,7,
Wagoner,U.S. Senate,Joan Farr,IND,730302,0,0,11,11,
Wagoner,U.S. Senate,Connie Johnson,DEM,730302,5,1,160,166,
Wagoner,U.S. Senate,James Lankford,REP,730302,19,8,917,944,
Wagoner,U.S. Senate,Mark Beard,IND,730302,0,0,24,24,
Wagoner,Governor,Joe Dorman,DEM,730303,3,1,86,90,
Wagoner,Governor,Mary Fallin,REP,730303,2,4,242,248,
Wagoner,Governor,Kimberly Willis,IND,730303,0,0,4,4,
Wagoner,Governor,Richard Prawdzienski,IND,730303,0,0,4,4,
Wagoner,Lieutenant Governor,Cathy Cummings,DEM,730303,3,1,67,71,
Wagoner,Lieutenant Governor,Todd Lamb,REP,730303,2,4,268,274,
Wagoner,Superintendent of Public Instruction,John Cox,DEM,730303,3,1,89,93,
Wagoner,Superintendent of Public Instruction,Joy Hofmeister,REP,730303,2,4,243,249,
Wagoner,Commissioner of Labor,Mike Workman,DEM,730303,3,0,66,69,
Wagoner,Commissioner of Labor,Mark Costello,REP,730303,2,5,260,267,
Wagoner,U.S. Senate,Matt Silverstein,DEM,730303,3,1,62,66,
Wagoner,U.S. Senate,Jim Inhofe,REP,730303,2,4,262,268,
Wagoner,U.S. Senate,Aaron Delozier,IND,730303,0,0,4,4,
Wagoner,U.S. Senate,Ray Woods,IND,730303,0,0,2,2,
Wagoner,U.S. Senate,Joan Farr,IND,730303,0,0,2,2,
Wagoner,U.S. Senate,Connie Johnson,DEM,730303,3,1,57,61,
Wagoner,U.S. Senate,James Lankford,REP,730303,2,4,269,275,
Wagoner,U.S. Senate,Mark Beard,IND,730303,0,0,7,7,
Wagoner,State House,Wade Rousselot,DEM,730303,3,1,92,96,12
Wagoner,State House,David Tackett,REP,730303,2,4,241,247,12
Wagoner,Governor,Joe Dorman,DEM,730304,1,3,154,158,
Wagoner,Governor,Mary Fallin,REP,730304,6,2,367,375,
Wagoner,Governor,Kimberly Willis,IND,730304,0,0,7,7,
Wagoner,Governor,Richard Prawdzienski,IND,730304,0,0,6,6,
Wagoner,Lieutenant Governor,Cathy Cummings,DEM,730304,0,3,120,123,
Wagoner,Lieutenant Governor,Todd Lamb,REP,730304,7,2,414,423,
Wagoner,Superintendent of Public Instruction,John Cox,DEM,730304,0,2,171,173,
Wagoner,Superintendent of Public Instruction,Joy Hofmeister,REP,730304,7,3,364,374,
Wagoner,Commissioner of Labor,Mike Workman,DEM,730304,1,3,142,146,
Wagoner,Commissioner of Labor,Mark Costello,REP,730304,6,2,387,395,
Wagoner,U.S. Senate,Matt Silverstein,DEM,730304,1,2,120,123,
Wagoner,U.S. Senate,Jim Inhofe,REP,730304,6,3,400,409,
Wagoner,U.S. Senate,Aaron Delozier,IND,730304,0,0,5,5,
Wagoner,U.S. Senate,Ray Woods,IND,730304,0,0,6,6,
Wagoner,U.S. Senate,Joan Farr,IND,730304,0,0,4,4,
Wagoner,U.S. Senate,Connie Johnson,DEM,730304,0,2,108,110,
Wagoner,U.S. Senate,James Lankford,REP,730304,6,3,415,424,
Wagoner,U.S. Senate,Mark Beard,IND,730304,1,0,14,15,
Wagoner,State Senate,Charles Arnall,DEM,730304,0,3,125,128,18
Wagoner,State Senate,Kim David,REP,730304,7,2,409,418,18
Wagoner,Governor,Joe Dorman,DEM,730305,0,0,12,12,
Wagoner,Governor,Mary Fallin,REP,730305,2,0,36,38,
Wagoner,Governor,Kimberly Willis,IND,730305,0,0,2,2,
Wagoner,Governor,Richard Prawdzienski,IND,730305,0,0,0,0,
Wagoner,Lieutenant Governor,Cathy Cummings,DEM,730305,0,0,9,9,
Wagoner,Lieutenant Governor,Todd Lamb,REP,730305,2,0,42,44,
Wagoner,Superintendent of Public Instruction,John Cox,DEM,730305,0,0,14,14,
Wagoner,Superintendent of Public Instruction,Joy Hofmeister,REP,730305,2,0,37,39,
Wagoner,Commissioner of Labor,Mike Workman,DEM,730305,0,0,12,12,
Wagoner,Commissioner of Labor,Mark Costello,REP,730305,2,0,38,40,
Wagoner,U.S. Senate,Matt Silverstein,DEM,730305,0,0,7,7,
Wagoner,U.S. Senate,Jim Inhofe,REP,730305,2,0,41,43,
Wagoner,U.S. Senate,Aaron Delozier,IND,730305,0,0,2,2,
Wagoner,U.S. Senate,Ray Woods,IND,730305,0,0,0,0,
Wagoner,U.S. Senate,Joan Farr,IND,730305,0,0,1,1,
Wagoner,U.S. Senate,Connie Johnson,DEM,730305,0,0,7,7,
Wagoner,U.S. Senate,James Lankford,REP,730305,2,0,40,42,
Wagoner,U.S. Senate,Mark Beard,IND,730305,0,0,4,4,
Wagoner,State Senate,Charles Arnall,DEM,730305,0,0,9,9,18
Wagoner,State Senate,Kim David,REP,730305,2,0,42,44,18
Wagoner,State House,Wade Rousselot,DEM,730305,0,0,17,17,12
Wagoner,State House,David Tackett,REP,730305,2,0,33,35,12
Wagoner,Governor,Joe Dorman,DEM,730306,5,0,208,213,
Wagoner,Governor,Mary Fallin,REP,730306,17,1,623,641,
Wagoner,Governor,Kimberly Willis,IND,730306,0,0,29,29,
Wagoner,Governor,Richard Prawdzienski,IND,730306,0,0,11,11,
Wagoner,Lieutenant Governor,Cathy Cummings,DEM,730306,4,0,162,166,
Wagoner,Lieutenant Governor,Todd Lamb,REP,730306,19,1,704,724,
Wagoner,Superintendent of Public Instruction,John Cox,DEM,730306,5,0,222,227,
Wagoner,Superintendent of Public Instruction,Joy Hofmeister,REP,730306,18,1,643,662,
Wagoner,Commissioner of Labor,Mike Workman,DEM,730306,7,0,201,208,
Wagoner,Commissioner of Labor,Mark Costello,REP,730306,14,1,647,662,
Wagoner,U.S. Senate,Matt Silverstein,DEM,730306,4,0,168,172,
Wagoner,U.S. Senate,Jim Inhofe,REP,730306,18,1,673,692,
Wagoner,U.S. Senate,Aaron Delozier,IND,730306,0,0,13,13,
Wagoner,U.S. Senate,Ray Woods,IND,730306,0,0,6,6,
Wagoner,U.S. Senate,Joan Farr,IND,730306,1,0,4,5,
Wagoner,U.S. Senate,Connie Johnson,DEM,730306,3,0,146,149,
Wagoner,U.S. Senate,James Lankford,REP,730306,19,1,691,711,
Wagoner,U.S. Senate,Mark Beard,IND,730306,0,0,29,29,
Wagoner,State Senate,Charles Arnall,DEM,730306,7,0,165,172,18
Wagoner,State Senate,Kim David,REP,730306,16,1,692,709,18
Wagoner,Governor,Joe Dorman,DEM,730307,7,1,157,165,
Wagoner,Governor,Mary Fallin,REP,730307,15,5,458,478,
Wagoner,Governor,Kimberly Willis,IND,730307,0,0,11,11,
Wagoner,Governor,Richard Prawdzienski,IND,730307,0,0,5,5,
Wagoner,Lieutenant Governor,Cathy Cummings,DEM,730307,5,2,101,108,
Wagoner,Lieutenant Governor,Todd Lamb,REP,730307,17,4,523,544,
Wagoner,Superintendent of Public Instruction,John Cox,DEM,730307,7,2,166,175,
Wagoner,Superintendent of Public Instruction,Joy Hofmeister,REP,730307,15,4,462,481,
Wagoner,Commissioner of Labor,Mike Workman,DEM,730307,7,2,126,135,
Wagoner,Commissioner of Labor,Mark Costello,REP,730307,15,4,489,508,
Wagoner,U.S. Senate,Matt Silverstein,DEM,730307,6,2,112,120,
Wagoner,U.S. Senate,Jim Inhofe,REP,730307,16,2,496,514,
Wagoner,U.S. Senate,Aaron Delozier,IND,730307,0,0,3,3,
Wagoner,U.S. Senate,Ray Woods,IND,730307,0,0,9,9,
Wagoner,U.S. Senate,Joan Farr,IND,730307,0,1,8,9,
Wagoner,U.S. Senate,Connie Johnson,DEM,730307,5,2,89,96,
Wagoner,U.S. Senate,James Lankford,REP,730307,17,4,516,537,
Wagoner,U.S. Senate,Mark Beard,IND,730307,0,0,18,18,
Wagoner,State Senate,Charles Arnall,DEM,730307,7,1,108,116,18
Wagoner,State Senate,Kim David,REP,730307,15,3,513,531,18
Wagoner,State House,Jerry Shoemake,DEM,730307,9,3,185,197,16
Wagoner,State House,James Bo Delso,REP,730307,13,3,432,448,16
Wagoner,Governor,Joe Dorman,DEM,730308,5,6,129,140,
Wagoner,Governor,Mary Fallin,REP,730308,9,6,318,333,
Wagoner,Governor,Kimberly Willis,IND,730308,1,0,13,14,
Wagoner,Governor,Richard Prawdzienski,IND,730308,0,0,7,7,
Wagoner,Lieutenant Governor,Cathy Cummings,DEM,730308,5,4,103,112,
Wagoner,Lieutenant Governor,Todd Lamb,REP,730308,10,8,366,384,
Wagoner,Superintendent of Public Instruction,John Cox,DEM,730308,4,8,175,187,
Wagoner,Superintendent of Public Instruction,Joy Hofmeister,REP,730308,11,4,293,308,
Wagoner,Commissioner of Labor,Mike Workman,DEM,730308,6,4,146,156,
Wagoner,Commissioner of Labor,Mark Costello,REP,730308,9,8,319,336,
Wagoner,U.S. Senate,Matt Silverstein,DEM,730308,2,4,106,112,
Wagoner,U.S. Senate,Jim Inhofe,REP,730308,13,7,348,368,
Wagoner,U.S. Senate,Aaron Delozier,IND,730308,0,0,1,1,
Wagoner,U.S. Senate,Ray Woods,IND,730308,0,1,7,8,
Wagoner,U.S. Senate,Joan Farr,IND,730308,0,0,3,3,
Wagoner,U.S. Senate,Connie Johnson,DEM,730308,3,5,101,109,
Wagoner,U.S. Senate,James Lankford,REP,730308,9,7,354,370,
Wagoner,U.S. Senate,Mark Beard,IND,730308,2,0,12,14,
Wagoner,State Senate,Charles Arnall,DEM,730308,6,5,115,126,18
Wagoner,State Senate,Kim David,REP,730308,9,7,352,368,18
Wagoner,State House,Jerry Shoemake,DEM,730308,8,6,177,191,16
Wagoner,State House,James Bo Delso,REP,730308,7,6,283,296,16
Wagoner,Governor,Joe Dorman,DEM,730309,5,2,191,198,
Wagoner,Governor,Mary Fallin,REP,730309,8,3,365,376,
Wagoner,Governor,Kimberly Willis,IND,730309,0,0,16,16,
Wagoner,Governor,Richard Prawdzienski,IND,730309,1,0,9,10,
Wagoner,Lieutenant Governor,Cathy Cummings,DEM,730309,4,1,155,160,
Wagoner,Lieutenant Governor,Todd Lamb,REP,730309,11,4,425,440,
Wagoner,Superintendent of Public Instruction,John Cox,DEM,730309,6,2,224,232,
Wagoner,Superintendent of Public Instruction,Joy Hofmeister,REP,730309,9,3,356,368,
Wagoner,Commissioner of Labor,Mike Workman,DEM,730309,5,2,178,185,
Wagoner,Commissioner of Labor,Mark Costello,REP,730309,10,3,394,407,
Wagoner,U.S. Senate,Matt Silverstein,DEM,730309,1,2,135,138,
Wagoner,U.S. Senate,Jim Inhofe,REP,730309,13,3,427,443,
Wagoner,U.S. Senate,Aaron Delozier,IND,730309,0,0,4,4,
Wagoner,U.S. Senate,Ray Woods,IND,730309,0,0,3,3,
Wagoner,U.S. Senate,Joan Farr,IND,730309,1,0,11,12,
Wagoner,U.S. Senate,Connie Johnson,DEM,730309,4,2,141,147,
Wagoner,U.S. Senate,James Lankford,REP,730309,11,2,416,429,
Wagoner,U.S. Senate,Mark Beard,IND,730309,0,0,22,22,
Wagoner,State Senate,Charles Arnall,DEM,730309,4,1,156,161,18
Wagoner,State Senate,Kim David,REP,730309,11,4,419,434,18
Wagoner,State House,Wade Rousselot,DEM,730309,8,4,264,276,12
Wagoner,State House,David Tackett,REP,730309,6,1,317,324,12
Wagoner,Governor,Joe Dorman,DEM,730310,3,0,86,89,
Wagoner,Governor,Mary Fallin,REP,730310,2,4,170,176,
Wagoner,Governor,Kimberly Willis,IND,730310,0,0,11,11,
Wagoner,Governor,Richard Prawdzienski,IND,730310,0,0,3,3,
Wagoner,Lieutenant Governor,Cathy Cummings,DEM,730310,3,0,61,64,
Wagoner,Lieutenant Governor,Todd Lamb,REP,730310,2,4,209,215,
Wagoner,Superintendent of Public Instruction,John Cox,DEM,730310,3,0,90,93,
Wagoner,Superintendent of Public Instruction,Joy Hofmeister,REP,730310,3,4,180,187,
Wagoner,Commissioner of Labor,Mike Workman,DEM,730310,3,0,73,76,
Wagoner,Commissioner of Labor,Mark Costello,REP,730310,2,4,194,200,
Wagoner,U.S. Senate,Matt Silverstein,DEM,730310,3,0,54,57,
Wagoner,U.S. Senate,Jim Inhofe,REP,730310,2,4,211,217,
Wagoner,U.S. Senate,Aaron Delozier,IND,730310,0,0,1,1,
Wagoner,U.S. Senate,Ray Woods,IND,730310,0,0,1,1,
Wagoner,U.S. Senate,Joan Farr,IND,730310,0,0,3,3,
Wagoner,U.S. Senate,Connie Johnson,DEM,730310,3,0,59,62,
Wagoner,U.S. Senate,James Lankford,REP,730310,3,4,205,212,
Wagoner,U.S. Senate,Mark Beard,IND,730310,0,0,6,6,
Wagoner,State Senate,Charles Arnall,DEM,730310,3,0,66,69,18
Wagoner,State Senate,Kim David,REP,730310,2,4,202,208,18
Wagoner,State House,Jerry Shoemake,DEM,730310,3,0,106,109,16
Wagoner,State House,James Bo Delso,REP,730310,2,4,162,168,16
Wagoner,Governor,Joe Dorman,DEM,730311,2,0,59,61,
Wagoner,Governor,Mary Fallin,REP,730311,5,0,98,103,
Wagoner,Governor,Kimberly Willis,IND,730311,0,0,4,4,
Wagoner,Governor,Richard Prawdzienski,IND,730311,0,0,2,2,
Wagoner,Lieutenant Governor,Cathy Cummings,DEM,730311,2,0,41,43,
Wagoner,Lieutenant Governor,Todd Lamb,REP,730311,5,0,121,126,
Wagoner,Superintendent of Public Instruction,John Cox,DEM,730311,2,0,76,78,
Wagoner,Superintendent of Public Instruction,Joy Hofmeister,REP,730311,5,0,86,91,
Wagoner,Commissioner of Labor,Mike Workman,DEM,730311,2,0,55,57,
Wagoner,Commissioner of Labor,Mark Costello,REP,730311,5,0,107,112,
Wagoner,U.S. Senate,Matt Silverstein,DEM,730311,2,0,41,43,
Wagoner,U.S. Senate,Jim Inhofe,REP,730311,5,0,113,118,
Wagoner,U.S. Senate,Aaron Delozier,IND,730311,0,0,5,5,
Wagoner,U.S. Senate,Ray Woods,IND,730311,0,0,1,1,
Wagoner,U.S. Senate,Joan Farr,IND,730311,0,0,3,3,
Wagoner,U.S. Senate,Connie Johnson,DEM,730311,2,0,36,38,
Wagoner,U.S. Senate,James Lankford,REP,730311,5,0,122,127,
Wagoner,U.S. Senate,Mark Beard,IND,730311,0,0,4,4,
Wagoner,State Senate,Charles Arnall,DEM,730311,2,0,43,45,18
Wagoner,State Senate,Kim David,REP,730311,5,0,120,125,18
Wagoner,State House,Jerry Shoemake,DEM,730311,2,0,74,76,16
Wagoner,State House,James Bo Delso,REP,730311,5,0,86,91,16
Wagoner,Governor,Joe Dorman,DEM,730312,2,7,199,208,
Wagoner,Governor,Mary Fallin,REP,730312,1,10,244,255,
Wagoner,Governor,Kimberly Willis,IND,730312,0,1,10,11,
Wagoner,Governor,Richard Prawdzienski,IND,730312,0,0,1,1,
Wagoner,Lieutenant Governor,Cathy Cummings,DEM,730312,0,3,148,151,
Wagoner,Lieutenant Governor,Todd Lamb,REP,730312,3,15,302,320,
Wagoner,Superintendent of Public Instruction,John Cox,DEM,730312,2,9,245,256,
Wagoner,Superintendent of Public Instruction,Joy Hofmeister,REP,730312,1,8,209,218,
Wagoner,Commissioner of Labor,Mike Workman,DEM,730312,0,5,189,194,
Wagoner,Commissioner of Labor,Mark Costello,REP,730312,3,12,260,275,
Wagoner,U.S. Senate,Matt Silverstein,DEM,730312,0,3,147,150,
Wagoner,U.S. Senate,Jim Inhofe,REP,730312,3,14,295,312,
Wagoner,U.S. Senate,Aaron Delozier,IND,730312,0,1,3,4,
Wagoner,U.S. Senate,Ray Woods,IND,730312,0,0,4,4,
Wagoner,U.S. Senate,Joan Farr,IND,730312,0,0,5,5,
Wagoner,U.S. Senate,Connie Johnson,DEM,730312,0,1,138,139,
Wagoner,U.S. Senate,James Lankford,REP,730312,3,16,292,311,
Wagoner,U.S. Senate,Mark Beard,IND,730312,0,1,17,18,
Wagoner,State Senate,Charles Arnall,DEM,730312,2,3,142,147,18
Wagoner,State Senate,Kim David,REP,730312,1,15,307,323,18
Wagoner,State House,Wade Rousselot,DEM,730312,2,10,282,294,12
Wagoner,State House,David Tackett,REP,730312,1,8,175,184,12
Wagoner,Governor,Joe Dorman,DEM,730313,4,8,90,102,
Wagoner,Governor,Mary Fallin,REP,730313,0,10,94,104,
Wagoner,Governor,Kimberly Willis,IND,730313,0,0,8,8,
Wagoner,Governor,Richard Prawdzienski,IND,730313,0,0,2,2,
Wagoner,Lieutenant Governor,Cathy Cummings,DEM,730313,4,6,77,87,
Wagoner,Lieutenant Governor,Todd Lamb,REP,730313,0,12,112,124,
Wagoner,Superintendent of Public Instruction,John Cox,DEM,730313,4,8,112,124,
Wagoner,Superintendent of Public Instruction,Joy Hofmeister,REP,730313,0,9,78,87,
Wagoner,Commissioner of Labor,Mike Workman,DEM,730313,2,7,92,101,
Wagoner,Commissioner of Labor,Mark Costello,REP,730313,2,10,89,101,
Wagoner,U.S. Senate,Matt Silverstein,DEM,730313,2,6,73,81,
Wagoner,U.S. Senate,Jim Inhofe,REP,730313,2,12,111,125,
Wagoner,U.S. Senate,Aaron Delozier,IND,730313,0,0,2,2,
Wagoner,U.S. Senate,Ray Woods,IND,730313,0,0,5,5,
Wagoner,U.S. Senate,Joan Farr,IND,730313,0,0,0,0,
Wagoner,U.S. Senate,Connie Johnson,DEM,730313,2,5,65,72,
Wagoner,U.S. Senate,James Lankford,REP,730313,2,13,113,128,
Wagoner,U.S. Senate,Mark Beard,IND,730313,0,0,13,13,
Wagoner,State Senate,Charles Arnall,DEM,730313,2,6,64,72,18
Wagoner,State Senate,Kim David,REP,730313,2,12,125,139,18
Wagoner,State House,Wade Rousselot,DEM,730313,4,12,123,139,12
Wagoner,State House,David Tackett,REP,730313,0,6,69,75,12
Washington,Governor,Joe Dorman,DEM,740011,4,15,197,216,
Washington,Governor,Mary Fallin,REP,740011,10,17,375,402,
Washington,Governor,Kimberly Willis,IND,740011,0,0,14,14,
Washington,Governor,Richard Prawdzienski,IND,740011,0,0,12,12,
Washington,Lieutenant Governor,Cathy Cummings,DEM,740011,2,10,136,148,
Washington,Lieutenant Governor,Todd Lamb,REP,740011,12,22,462,496,
Washington,Superintendent of Public Instruction,John Cox,DEM,740011,5,14,188,207,
Washington,Superintendent of Public Instruction,Joy Hofmeister,REP,740011,8,17,402,427,
Washington,Commissioner of Labor,Mike Workman,DEM,740011,2,10,149,161,
Washington,Commissioner of Labor,Mark Costello,REP,740011,12,22,436,470,
Washington,U.S. Senate,Matt Silverstein,DEM,740011,2,11,145,158,
Washington,U.S. Senate,Jim Inhofe,REP,740011,12,21,432,465,
Washington,U.S. Senate,Aaron Delozier,IND,740011,0,0,8,8,
Washington,U.S. Senate,Ray Woods,IND,740011,0,0,5,5,
Washington,U.S. Senate,Joan Farr,IND,740011,0,0,6,6,
Washington,U.S. Senate,Connie Johnson,DEM,740011,2,9,131,142,
Washington,U.S. Senate,James Lankford,REP,740011,12,22,448,482,
Washington,U.S. Senate,Mark Beard,IND,740011,0,1,14,15,
Washington,Governor,Joe Dorman,DEM,740012,2,1,47,50,
Washington,Governor,Mary Fallin,REP,740012,2,12,100,114,
Washington,Governor,Kimberly Willis,IND,740012,0,1,5,6,
Washington,Governor,Richard Prawdzienski,IND,740012,0,0,0,0,
Washington,Lieutenant Governor,Cathy Cummings,DEM,740012,2,0,34,36,
Washington,Lieutenant Governor,Todd Lamb,REP,740012,2,14,117,133,
Washington,Superintendent of Public Instruction,John Cox,DEM,740012,2,1,49,52,
Washington,Superintendent of Public Instruction,Joy Hofmeister,REP,740012,2,13,98,113,
Washington,Commissioner of Labor,Mike Workman,DEM,740012,2,0,44,46,
Washington,Commissioner of Labor,Mark Costello,REP,740012,2,14,102,118,
Washington,U.S. Senate,Matt Silverstein,DEM,740012,2,1,38,41,
Washington,U.S. Senate,Jim Inhofe,REP,740012,2,13,102,117,
Washington,U.S. Senate,Aaron Delozier,IND,740012,0,0,1,1,
Washington,U.S. Senate,Ray Woods,IND,740012,0,0,3,3,
Washington,U.S. Senate,Joan Farr,IND,740012,0,0,5,5,
Washington,U.S. Senate,Connie Johnson,DEM,740012,2,0,35,37,
Washington,U.S. Senate,James Lankford,REP,740012,2,13,109,124,
Washington,U.S. Senate,Mark Beard,IND,740012,0,1,6,7,
Washington,Governor,Joe Dorman,DEM,740013,1,5,179,185,
Washington,Governor,Mary Fallin,REP,740013,5,13,389,407,
Washington,Governor,Kimberly Willis,IND,740013,2,0,17,19,
Washington,Governor,Richard Prawdzienski,IND,740013,0,0,6,6,
Washington,Lieutenant Governor,Cathy Cummings,DEM,740013,0,4,134,138,
Washington,Lieutenant Governor,Todd Lamb,REP,740013,7,14,457,478,
Washington,Superintendent of Public Instruction,John Cox,DEM,740013,3,8,203,214,
Washington,Superintendent of Public Instruction,Joy Hofmeister,REP,740013,5,10,387,402,
Washington,Commissioner of Labor,Mike Workman,DEM,740013,1,3,162,166,
Washington,Commissioner of Labor,Mark Costello,REP,740013,5,15,424,444,
Washington,U.S. Senate,Matt Silverstein,DEM,740013,0,4,127,131,
Washington,U.S. Senate,Jim Inhofe,REP,740013,7,14,448,469,
Washington,U.S. Senate,Aaron Delozier,IND,740013,1,0,7,8,
Washington,U.S. Senate,Ray Woods,IND,740013,0,0,6,6,
Washington,U.S. Senate,Joan Farr,IND,740013,0,0,4,4,
Washington,U.S. Senate,Connie Johnson,DEM,740013,1,2,119,122,
Washington,U.S. Senate,James Lankford,REP,740013,7,16,442,465,
Washington,U.S. Senate,Mark Beard,IND,740013,0,0,31,31,
Washington,State House,Anthony Tucker,DEM,740013,0,3,144,147,10
Washington,State House,Travis Dunlap,REP,740013,8,15,445,468,10
Washington,Governor,Joe Dorman,DEM,740015,2,6,167,175,
Washington,Governor,Mary Fallin,REP,740015,5,29,412,446,
Washington,Governor,Kimberly Willis,IND,740015,0,1,14,15,
Washington,Governor,Richard Prawdzienski,IND,740015,0,1,12,13,
Washington,Lieutenant Governor,Cathy Cummings,DEM,740015,2,2,115,119,
Washington,Lieutenant Governor,Todd Lamb,REP,740015,5,35,489,529,
Washington,Superintendent of Public Instruction,John Cox,DEM,740015,2,5,186,193,
Washington,Superintendent of Public Instruction,Joy Hofmeister,REP,740015,5,32,418,455,
Washington,Commissioner of Labor,Mike Workman,DEM,740015,2,5,141,148,
Washington,Commissioner of Labor,Mark Costello,REP,740015,5,32,453,490,
Washington,U.S. Senate,Matt Silverstein,DEM,740015,2,2,116,120,
Washington,U.S. Senate,Jim Inhofe,REP,740015,5,34,466,505,
Washington,U.S. Senate,Aaron Delozier,IND,740015,0,0,5,5,
Washington,U.S. Senate,Ray Woods,IND,740015,0,0,5,5,
Washington,U.S. Senate,Joan Farr,IND,740015,0,1,13,14,
Washington,U.S. Senate,Connie Johnson,DEM,740015,2,2,104,108,
Washington,U.S. Senate,James Lankford,REP,740015,5,34,477,516,
Washington,U.S. Senate,Mark Beard,IND,740015,0,1,22,23,
Washington,State House,Anthony Tucker,DEM,740015,2,5,117,124,10
Washington,State House,Travis Dunlap,REP,740015,5,31,487,523,10
Washington,Governor,Joe Dorman,DEM,740022,12,43,357,412,
Washington,Governor,Mary Fallin,REP,740022,39,86,1091,1216,
Washington,Governor,Kimberly Willis,IND,740022,1,2,15,18,
Washington,Governor,Richard Prawdzienski,IND,740022,0,0,14,14,
Washington,Lieutenant Governor,Cathy Cummings,DEM,740022,12,33,264,309,
Washington,Lieutenant Governor,Todd Lamb,REP,740022,40,97,1205,1342,
Washington,Superintendent of Public Instruction,John Cox,DEM,740022,12,39,374,425,
Washington,Superintendent of Public Instruction,Joy Hofmeister,REP,740022,40,89,1088,1217,
Washington,Commissioner of Labor,Mike Workman,DEM,740022,10,34,284,328,
Washington,Commissioner of Labor,Mark Costello,REP,740022,43,95,1155,1293,
Washington,U.S. Senate,Matt Silverstein,DEM,740022,10,34,264,308,
Washington,U.S. Senate,Jim Inhofe,REP,740022,42,96,1173,1311,
Washington,U.S. Senate,Aaron Delozier,IND,740022,0,2,9,11,
Washington,U.S. Senate,Ray Woods,IND,740022,1,0,11,12,
Washington,U.S. Senate,Joan Farr,IND,740022,0,0,13,13,
Washington,U.S. Senate,Connie Johnson,DEM,740022,10,36,226,272,
Washington,U.S. Senate,James Lankford,REP,740022,40,96,1206,1342,
Washington,U.S. Senate,Mark Beard,IND,740022,3,0,35,38,
Washington,Governor,Joe Dorman,DEM,740027,1,10,101,112,
Washington,Governor,Mary Fallin,REP,740027,0,12,194,206,
Washington,Governor,Kimberly Willis,IND,740027,1,0,8,9,
Washington,Governor,Richard Prawdzienski,IND,740027,0,0,3,3,
Washington,Lieutenant Governor,Cathy Cummings,DEM,740027,1,7,89,97,
Washington,Lieutenant Governor,Todd Lamb,REP,740027,1,14,214,229,
Washington,Superintendent of Public Instruction,John Cox,DEM,740027,1,8,106,115,
Washington,Superintendent of Public Instruction,Joy Hofmeister,REP,740027,1,14,197,212,
Washington,Commissioner of Labor,Mike Workman,DEM,740027,1,8,91,100,
Washington,Commissioner of Labor,Mark Costello,REP,740027,1,13,210,224,
Washington,U.S. Senate,Matt Silverstein,DEM,740027,0,8,92,100,
Washington,U.S. Senate,Jim Inhofe,REP,740027,1,14,206,221,
Washington,U.S. Senate,Aaron Delozier,IND,740027,0,0,1,1,
Washington,U.S. Senate,Ray Woods,IND,740027,0,0,3,3,
Washington,U.S. Senate,Joan Farr,IND,740027,0,0,3,3,
Washington,U.S. Senate,Connie Johnson,DEM,740027,1,7,78,86,
Washington,U.S. Senate,James Lankford,REP,740027,1,15,219,235,
Washington,U.S. Senate,Mark Beard,IND,740027,0,0,8,8,
Washington,State House,Anthony Tucker,DEM,740027,1,8,91,100,10
Washington,State House,Travis Dunlap,REP,740027,1,14,216,231,10
Washington,Governor,Joe Dorman,DEM,740028,6,27,339,372,
Washington,Governor,Mary Fallin,REP,740028,30,62,880,972,
Washington,Governor,Kimberly Willis,IND,740028,1,1,36,38,
Washington,Governor,Richard Prawdzienski,IND,740028,1,1,17,19,
Washington,Lieutenant Governor,Cathy Cummings,DEM,740028,5,20,238,263,
Washington,Lieutenant Governor,Todd Lamb,REP,740028,32,71,1037,1140,
Washington,Superintendent of Public Instruction,John Cox,DEM,740028,7,30,380,417,
Washington,Superintendent of Public Instruction,Joy Hofmeister,REP,740028,31,61,889,981,
Washington,Commissioner of Labor,Mike Workman,DEM,740028,4,22,287,313,
Washington,Commissioner of Labor,Mark Costello,REP,740028,33,67,960,1060,
Washington,U.S. Senate,Matt Silverstein,DEM,740028,1,22,248,271,
Washington,U.S. Senate,Jim Inhofe,REP,740028,36,66,984,1086,
Washington,U.S. Senate,Aaron Delozier,IND,740028,0,0,13,13,
Washington,U.S. Senate,Ray Woods,IND,740028,0,0,13,13,
Washington,U.S. Senate,Joan Farr,IND,740028,0,1,18,19,
Washington,U.S. Senate,Connie Johnson,DEM,740028,5,20,210,235,
Washington,U.S. Senate,James Lankford,REP,740028,33,71,1017,1121,
Washington,U.S. Senate,Mark Beard,IND,740028,0,0,42,42,
Washington,Governor,Joe Dorman,DEM,740031,11,21,416,448,
Washington,Governor,Mary Fallin,REP,740031,7,39,532,578,
Washington,Governor,Kimberly Willis,IND,740031,1,0,38,39,
Washington,Governor,Richard Prawdzienski,IND,740031,0,0,29,29,
Washington,Lieutenant Governor,Cathy Cummings,DEM,740031,13,19,351,383,
Washington,Lieutenant Governor,Todd Lamb,REP,740031,6,42,665,713,
Washington,Superintendent of Public Instruction,John Cox,DEM,740031,13,22,416,451,
Washington,Superintendent of Public Instruction,Joy Hofmeister,REP,740031,6,39,592,637,
Washington,Commissioner of Labor,Mike Workman,DEM,740031,12,18,348,378,
Washington,Commissioner of Labor,Mark Costello,REP,740031,6,42,659,707,
Washington,U.S. Senate,Matt Silverstein,DEM,740031,11,20,329,360,
Washington,U.S. Senate,Jim Inhofe,REP,740031,8,40,627,675,
Washington,U.S. Senate,Aaron Delozier,IND,740031,0,1,20,21,
Washington,U.S. Senate,Ray Woods,IND,740031,0,0,18,18,
Washington,U.S. Senate,Joan Farr,IND,740031,0,0,24,24,
Washington,U.S. Senate,Connie Johnson,DEM,740031,13,20,309,342,
Washington,U.S. Senate,James Lankford,REP,740031,6,39,638,683,
Washington,U.S. Senate,Mark Beard,IND,740031,0,1,64,65,
Washington,Governor,Joe Dorman,DEM,740033,1,4,108,113,
Washington,Governor,Mary Fallin,REP,740033,0,2,131,133,
Washington,Governor,Kimberly Willis,IND,740033,0,0,19,19,
Washington,Governor,Richard Prawdzienski,IND,740033,0,0,6,6,
Washington,Lieutenant Governor,Cathy Cummings,DEM,740033,1,4,110,115,
Washington,Lieutenant Governor,Todd Lamb,REP,740033,0,2,153,155,
Washington,Superintendent of Public Instruction,John Cox,DEM,740033,1,4,118,123,
Washington,Superintendent of Public Instruction,Joy Hofmeister,REP,740033,0,2,138,140,
Washington,Commissioner of Labor,Mike Workman,DEM,740033,1,4,126,131,
Washington,Commissioner of Labor,Mark Costello,REP,740033,0,2,135,137,
Washington,U.S. Senate,Matt Silverstein,DEM,740033,1,3,96,100,
Washington,U.S. Senate,Jim Inhofe,REP,740033,0,1,147,148,
Washington,U.S. Senate,Aaron Delozier,IND,740033,0,0,9,9,
Washington,U.S. Senate,Ray Woods,IND,740033,0,0,6,6,
Washington,U.S. Senate,Joan Farr,IND,740033,0,2,6,8,
Washington,U.S. Senate,Connie Johnson,DEM,740033,1,4,99,104,
Washington,U.S. Senate,James Lankford,REP,740033,0,2,146,148,
Washington,U.S. Senate,Mark Beard,IND,740033,0,0,17,17,
Washington,Governor,Joe Dorman,DEM,740046,0,3,100,103,
Washington,Governor,Mary Fallin,REP,740046,6,8,171,185,
Washington,Governor,Kimberly Willis,IND,740046,0,0,10,10,
Washington,Governor,Richard Prawdzienski,IND,740046,0,0,4,4,
Washington,Lieutenant Governor,Cathy Cummings,DEM,740046,0,4,78,82,
Washington,Lieutenant Governor,Todd Lamb,REP,740046,5,7,205,217,
Washington,Superintendent of Public Instruction,John Cox,DEM,740046,0,4,107,111,
Washington,Superintendent of Public Instruction,Joy Hofmeister,REP,740046,6,7,177,190,
Washington,Commissioner of Labor,Mike Workman,DEM,740046,1,2,104,107,
Washington,Commissioner of Labor,Mark Costello,REP,740046,5,9,178,192,
Washington,U.S. Senate,Matt Silverstein,DEM,740046,1,1,73,75,
Washington,U.S. Senate,Jim Inhofe,REP,740046,5,9,199,213,
Washington,U.S. Senate,Aaron Delozier,IND,740046,0,0,2,2,
Washington,U.S. Senate,Ray Woods,IND,740046,0,0,3,3,
Washington,U.S. Senate,Joan Farr,IND,740046,0,0,4,4,
Washington,U.S. Senate,Connie Johnson,DEM,740046,1,3,81,85,
Washington,U.S. Senate,James Lankford,REP,740046,5,8,192,205,
Washington,U.S. Senate,Mark Beard,IND,740046,0,0,13,13,
Washington,State House,Anthony Tucker,DEM,740046,1,4,89,94,10
Washington,State House,Travis Dunlap,REP,740046,5,7,194,206,10
Washington,Governor,Joe Dorman,DEM,740048,6,2,140,148,
Washington,Governor,Mary Fallin,REP,740048,11,16,272,299,
Washington,Governor,Kimberly Willis,IND,740048,0,1,18,19,
Washington,Governor,Richard Prawdzienski,IND,740048,0,0,8,8,
Washington,Lieutenant Governor,Cathy Cummings,DEM,740048,6,3,123,132,
Washington,Lieutenant Governor,Todd Lamb,REP,740048,11,16,310,337,
Washington,Superintendent of Public Instruction,John Cox,DEM,740048,5,4,172,181,
Washington,Superintendent of Public Instruction,Joy Hofmeister,REP,740048,11,15,260,286,
Washington,Commissioner of Labor,Mike Workman,DEM,740048,6,3,146,155,
Washington,Commissioner of Labor,Mark Costello,REP,740048,11,15,283,309,
Washington,U.S. Senate,Matt Silverstein,DEM,740048,6,3,116,125,
Washington,U.S. Senate,Jim Inhofe,REP,740048,10,15,296,321,
Washington,U.S. Senate,Aaron Delozier,IND,740048,0,0,5,5,
Washington,U.S. Senate,Ray Woods,IND,740048,0,0,6,6,
Washington,U.S. Senate,Joan Farr,IND,740048,1,0,13,14,
Washington,U.S. Senate,Connie Johnson,DEM,740048,5,3,113,121,
Washington,U.S. Senate,James Lankford,REP,740048,11,15,296,322,
Washington,U.S. Senate,Mark Beard,IND,740048,1,1,24,26,
Washington,State House,Anthony Tucker,DEM,740048,6,3,125,134,10
Washington,State House,Travis Dunlap,REP,740048,11,15,309,335,10
Washington,Governor,Joe Dorman,DEM,740051,2,16,215,233,
Washington,Governor,Mary Fallin,REP,740051,4,37,555,596,
Washington,Governor,Kimberly Willis,IND,740051,0,1,17,18,
Washington,Governor,Richard Prawdzienski,IND,740051,0,1,11,12,
Washington,Lieutenant Governor,Cathy Cummings,DEM,740051,2,11,135,148,
Washington,Lieutenant Governor,Todd Lamb,REP,740051,4,45,658,707,
Washington,Superintendent of Public Instruction,John Cox,DEM,740051,2,16,238,256,
Washington,Superintendent of Public Instruction,Joy Hofmeister,REP,740051,4,40,559,603,
Washington,Commissioner of Labor,Mike Workman,DEM,740051,2,11,154,167,
Washington,Commissioner of Labor,Mark Costello,REP,740051,4,45,627,676,
Washington,U.S. Senate,Matt Silverstein,DEM,740051,2,13,148,163,
Washington,U.S. Senate,Jim Inhofe,REP,740051,4,38,620,662,
Washington,U.S. Senate,Aaron Delozier,IND,740051,0,0,9,9,
Washington,U.S. Senate,Ray Woods,IND,740051,0,2,10,12,
Washington,U.S. Senate,Joan Farr,IND,740051,0,3,7,10,
Washington,U.S. Senate,Connie Johnson,DEM,740051,2,9,130,141,
Washington,U.S. Senate,James Lankford,REP,740051,4,44,643,691,
Washington,U.S. Senate,Mark Beard,IND,740051,0,3,22,25,
Washington,State House,Anthony Tucker,DEM,740051,2,11,149,162,10
Washington,State House,Travis Dunlap,REP,740051,4,44,646,694,10
Washington,Governor,Joe Dorman,DEM,740054,5,26,263,294,
Washington,Governor,Mary Fallin,REP,740054,22,26,662,710,
Washington,Governor,Kimberly Willis,IND,740054,0,2,16,18,
Washington,Governor,Richard Prawdzienski,IND,740054,0,0,11,11,
Washington,Lieutenant Governor,Cathy Cummings,DEM,740054,4,18,174,196,
Washington,Lieutenant Governor,Todd Lamb,REP,740054,22,36,774,832,
Washington,Superintendent of Public Instruction,John Cox,DEM,740054,7,22,290,319,
Washington,Superintendent of Public Instruction,Joy Hofmeister,REP,740054,19,32,658,709,
Washington,Commissioner of Labor,Mike Workman,DEM,740054,5,22,227,254,
Washington,Commissioner of Labor,Mark Costello,REP,740054,20,31,703,754,
Washington,U.S. Senate,Matt Silverstein,DEM,740054,5,20,201,226,
Washington,U.S. Senate,Jim Inhofe,REP,740054,20,33,727,780,
Washington,U.S. Senate,Aaron Delozier,IND,740054,0,1,9,10,
Washington,U.S. Senate,Ray Woods,IND,740054,0,0,5,5,
Washington,U.S. Senate,Joan Farr,IND,740054,0,0,8,8,
Washington,U.S. Senate,Connie Johnson,DEM,740054,4,17,183,204,
Washington,U.S. Senate,James Lankford,REP,740054,21,36,746,803,
Washington,U.S. Senate,Mark Beard,IND,740054,0,1,23,24,
Washington,Governor,Joe Dorman,DEM,740062,6,4,200,210,
Washington,Governor,Mary Fallin,REP,740062,5,17,409,431,
Washington,Governor,Kimberly Willis,IND,740062,0,0,25,25,
Washington,Governor,Richard Prawdzienski,IND,740062,0,0,9,9,
Washington,Lieutenant Governor,Cathy Cummings,DEM,740062,5,4,144,153,
Washington,Lieutenant Governor,Todd Lamb,REP,740062,6,17,499,522,
Washington,Superintendent of Public Instruction,John Cox,DEM,740062,6,7,222,235,
Washington,Superintendent of Public Instruction,Joy Hofmeister,REP,740062,5,14,421,440,
Washington,Commissioner of Labor,Mike Workman,DEM,740062,5,6,196,207,
Washington,Commissioner of Labor,Mark Costello,REP,740062,6,15,442,463,
Washington,U.S. Senate,Matt Silverstein,DEM,740062,5,4,142,151,
Washington,U.S. Senate,Jim Inhofe,REP,740062,6,17,474,497,
Washington,U.S. Senate,Aaron Delozier,IND,740062,0,0,8,8,
Washington,U.S. Senate,Ray Woods,IND,740062,0,0,8,8,
Washington,U.S. Senate,Joan Farr,IND,740062,0,0,10,10,
Washington,U.S. Senate,Connie Johnson,DEM,740062,5,3,139,147,
Washington,U.S. Senate,James Lankford,REP,740062,6,18,482,506,
Washington,U.S. Senate,Mark Beard,IND,740062,0,0,21,21,
Washington,State House,Anthony Tucker,DEM,740062,5,4,187,196,10
Washington,State House,Travis Dunlap,REP,740062,6,17,457,480,10
Washington,Governor,Joe Dorman,DEM,740071,1,1,150,152,
Washington,Governor,Mary Fallin,REP,740071,3,6,308,317,
Washington,Governor,Kimberly Willis,IND,740071,0,0,15,15,
Washington,Governor,Richard Prawdzienski,IND,740071,0,0,6,6,
Washington,Lieutenant Governor,Cathy Cummings,DEM,740071,1,0,107,108,
Washington,Lieutenant Governor,Todd Lamb,REP,740071,3,7,369,379,
Washington,Superintendent of Public Instruction,John Cox,DEM,740071,3,1,178,182,
Washington,Superintendent of Public Instruction,Joy Hofmeister,REP,740071,1,6,298,305,
Washington,Commissioner of Labor,Mike Workman,DEM,740071,1,1,143,145,
Washington,Commissioner of Labor,Mark Costello,REP,740071,3,6,330,339,
Washington,U.S. Senate,Matt Silverstein,DEM,740071,0,1,103,104,
Washington,U.S. Senate,Jim Inhofe,REP,740071,3,6,352,361,
Washington,U.S. Senate,Aaron Delozier,IND,740071,1,0,9,10,
Washington,U.S. Senate,Ray Woods,IND,740071,0,0,8,8,
Washington,U.S. Senate,Joan Farr,IND,740071,0,0,6,6,
Washington,U.S. Senate,Connie Johnson,DEM,740071,0,0,96,96,
Washington,U.S. Senate,James Lankford,REP,740071,3,7,351,361,
Washington,U.S. Senate,Mark Beard,IND,740071,1,0,29,30,
Washington,State House,Anthony Tucker,DEM,740071,0,1,109,110,10
Washington,State House,Travis Dunlap,REP,740071,4,6,365,375,10
Washington,Governor,Joe Dorman,DEM,740073,1,6,66,73,
Washington,Governor,Mary Fallin,REP,740073,1,11,225,237,
Washington,Governor,Kimberly Willis,IND,740073,0,2,4,6,
Washington,Governor,Richard Prawdzienski,IND,740073,0,0,1,1,
Washington,Lieutenant Governor,Cathy Cummings,DEM,740073,0,5,48,53,
Washington,Lieutenant Governor,Todd Lamb,REP,740073,2,14,250,266,
Washington,Superintendent of Public Instruction,John Cox,DEM,740073,0,6,89,95,
Washington,Superintendent of Public Instruction,Joy Hofmeister,REP,740073,2,13,208,223,
Washington,Commissioner of Labor,Mike Workman,DEM,740073,0,7,64,71,
Washington,Commissioner of Labor,Mark Costello,REP,740073,2,12,232,246,
Washington,U.S. Senate,Matt Silverstein,DEM,740073,1,5,45,51,
Washington,U.S. Senate,Jim Inhofe,REP,740073,1,14,245,260,
Washington,U.S. Senate,Aaron Delozier,IND,740073,0,0,3,3,
Washington,U.S. Senate,Ray Woods,IND,740073,0,0,3,3,
Washington,U.S. Senate,Joan Farr,IND,740073,0,0,0,0,
Washington,U.S. Senate,Connie Johnson,DEM,740073,1,5,41,47,
Washington,U.S. Senate,James Lankford,REP,740073,1,14,249,264,
Washington,U.S. Senate,Mark Beard,IND,740073,0,0,8,8,
Washington,State House,Anthony Tucker,DEM,740073,0,6,53,59,10
Washington,State House,Travis Dunlap,REP,740073,2,13,245,260,10
Washington,Governor,Joe Dorman,DEM,740074,0,0,46,46,
Washington,Governor,Mary Fallin,REP,740074,6,13,184,203,
Washington,Governor,Kimberly Willis,IND,740074,0,0,3,3,
Washington,Governor,Richard Prawdzienski,IND,740074,2,0,3,5,
Washington,Lieutenant Governor,Cathy Cummings,DEM,740074,0,1,35,36,
Washington,Lieutenant Governor,Todd Lamb,REP,740074,7,12,200,219,
Washington,Superintendent of Public Instruction,John Cox,DEM,740074,4,2,68,74,
Washington,Superintendent of Public Instruction,Joy Hofmeister,REP,740074,3,11,166,180,
Washington,Commissioner of Labor,Mike Workman,DEM,740074,3,1,55,59,
Washington,Commissioner of Labor,Mark Costello,REP,740074,4,12,179,195,
Washington,U.S. Senate,Matt Silverstein,DEM,740074,0,0,36,36,
Washington,U.S. Senate,Jim Inhofe,REP,740074,8,13,192,213,
Washington,U.S. Senate,Aaron Delozier,IND,740074,0,0,4,4,
Washington,U.S. Senate,Ray Woods,IND,740074,0,0,1,1,
Washington,U.S. Senate,Joan Farr,IND,740074,0,0,2,2,
Washington,U.S. Senate,Connie Johnson,DEM,740074,1,1,42,44,
Washington,U.S. Senate,James Lankford,REP,740074,4,12,185,201,
Washington,U.S. Senate,Mark Beard,IND,740074,2,0,9,11,
Washington,State House,Anthony Tucker,DEM,740074,2,1,50,53,10
Washington,State House,Travis Dunlap,REP,740074,5,12,184,201,10
Washington,Governor,Joe Dorman,DEM,740075,2,3,74,79,
Washington,Governor,Mary Fallin,REP,740075,5,10,317,332,
Washington,Governor,Kimberly Willis,IND,740075,0,0,14,14,
Washington,Governor,Richard Prawdzienski,IND,740075,0,1,1,2,
Washington,Lieutenant Governor,Cathy Cummings,DEM,740075,2,2,51,55,
Washington,Lieutenant Governor,Todd Lamb,REP,740075,5,12,356,373,
Washington,Superintendent of Public Instruction,John Cox,DEM,740075,2,4,109,115,
Washington,Superintendent of Public Instruction,Joy Hofmeister,REP,740075,5,10,295,310,
Washington,Commissioner of Labor,Mike Workman,DEM,740075,2,2,73,77,
Washington,Commissioner of Labor,Mark Costello,REP,740075,5,12,321,338,
Washington,U.S. Senate,Matt Silverstein,DEM,740075,2,3,55,60,
Washington,U.S. Senate,Jim Inhofe,REP,740075,5,11,337,353,
Washington,U.S. Senate,Aaron Delozier,IND,740075,0,0,5,5,
Washington,U.S. Senate,Ray Woods,IND,740075,0,0,2,2,
Washington,U.S. Senate,Joan Farr,IND,740075,0,0,7,7,
Washington,U.S. Senate,Connie Johnson,DEM,740075,2,2,53,57,
Washington,U.S. Senate,James Lankford,REP,740075,5,10,340,355,
Washington,U.S. Senate,Mark Beard,IND,740075,0,2,13,15,
Washington,Governor,Joe Dorman,DEM,740076,1,4,96,101,
Washington,Governor,Mary Fallin,REP,740076,2,8,172,182,
Washington,Governor,Kimberly Willis,IND,740076,1,0,7,8,
Washington,Governor,Richard Prawdzienski,IND,740076,0,0,5,5,
Washington,Lieutenant Governor,Cathy Cummings,DEM,740076,0,5,69,74,
Washington,Lieutenant Governor,Todd Lamb,REP,740076,4,7,210,221,
Washington,Superintendent of Public Instruction,John Cox,DEM,740076,3,5,119,127,
Washington,Superintendent of Public Instruction,Joy Hofmeister,REP,740076,1,7,159,167,
Washington,Commissioner of Labor,Mike Workman,DEM,740076,0,4,97,101,
Washington,Commissioner of Labor,Mark Costello,REP,740076,4,8,179,191,
Washington,U.S. Senate,Matt Silverstein,DEM,740076,1,3,75,79,
Washington,U.S. Senate,Jim Inhofe,REP,740076,2,9,200,211,
Washington,U.S. Senate,Aaron Delozier,IND,740076,1,0,3,4,
Washington,U.S. Senate,Ray Woods,IND,740076,0,0,1,1,
Washington,U.S. Senate,Joan Farr,IND,740076,0,0,1,1,
Washington,U.S. Senate,Connie Johnson,DEM,740076,0,5,68,73,
Washington,U.S. Senate,James Lankford,REP,740076,3,7,204,214,
Washington,U.S. Senate,Mark Beard,IND,740076,1,0,5,6,
Washington,Governor,Joe Dorman,DEM,740077,0,3,108,111,
Washington,Governor,Mary Fallin,REP,740077,4,1,293,298,
Washington,Governor,Kimberly Willis,IND,740077,0,0,9,9,
Washington,Governor,Richard Prawdzienski,IND,740077,0,0,3,3,
Washington,Lieutenant Governor,Cathy Cummings,DEM,740077,0,3,72,75,
Washington,Lieutenant Governor,Todd Lamb,REP,740077,4,1,342,347,
Washington,Superintendent of Public Instruction,John Cox,DEM,740077,0,4,134,138,
Washington,Superintendent of Public Instruction,Joy Hofmeister,REP,740077,4,0,279,283,
Washington,Commissioner of Labor,Mike Workman,DEM,740077,0,3,105,108,
Washington,Commissioner of Labor,Mark Costello,REP,740077,4,1,304,309,
Washington,U.S. Senate,Matt Silverstein,DEM,740077,0,3,71,74,
Washington,U.S. Senate,Jim Inhofe,REP,740077,4,1,332,337,
Washington,U.S. Senate,Aaron Delozier,IND,740077,0,0,5,5,
Washington,U.S. Senate,Ray Woods,IND,740077,0,0,3,3,
Washington,U.S. Senate,Joan Farr,IND,740077,0,0,2,2,
Washington,U.S. Senate,Connie Johnson,DEM,740077,0,3,69,72,
Washington,U.S. Senate,James Lankford,REP,740077,4,1,333,338,
Washington,U.S. Senate,Mark Beard,IND,740077,0,0,12,12,
Washington,Governor,Joe Dorman,DEM,740078,9,2,117,128,
Washington,Governor,Mary Fallin,REP,740078,1,2,186,189,
Washington,Governor,Kimberly Willis,IND,740078,0,0,13,13,
Washington,Governor,Richard Prawdzienski,IND,740078,0,0,4,4,
Washington,Lieutenant Governor,Cathy Cummings,DEM,740078,9,2,78,89,
Washington,Lieutenant Governor,Todd Lamb,REP,740078,1,2,244,247,
Washington,Superintendent of Public Instruction,John Cox,DEM,740078,10,2,131,143,
Washington,Superintendent of Public Instruction,Joy Hofmeister,REP,740078,0,2,190,192,
Washington,Commissioner of Labor,Mike Workman,DEM,740078,9,2,92,103,
Washington,Commissioner of Labor,Mark Costello,REP,740078,1,2,226,229,
Washington,U.S. Senate,Matt Silverstein,DEM,740078,9,2,75,86,
Washington,U.S. Senate,Jim Inhofe,REP,740078,1,2,235,238,
Washington,U.S. Senate,Aaron Delozier,IND,740078,0,0,8,8,
Washington,U.S. Senate,Ray Woods,IND,740078,0,0,3,3,
Washington,U.S. Senate,Joan Farr,IND,740078,0,0,0,0,
Washington,U.S. Senate,Connie Johnson,DEM,740078,9,2,66,77,
Washington,U.S. Senate,James Lankford,REP,740078,1,2,235,238,
Washington,U.S. Senate,Mark Beard,IND,740078,0,0,18,18,
Washington,State House,Anthony Tucker,DEM,740078,9,2,95,106,10
Washington,State House,Travis Dunlap,REP,740078,1,2,226,229,10
Washington,Governor,Joe Dorman,DEM,740079,2,1,126,129,
Washington,Governor,Mary Fallin,REP,740079,1,5,239,245,
Washington,Governor,Kimberly Willis,IND,740079,0,1,7,8,
Washington,Governor,Richard Prawdzienski,IND,740079,0,0,6,6,
Washington,Lieutenant Governor,Cathy Cummings,DEM,740079,2,2,90,94,
Washington,Lieutenant Governor,Todd Lamb,REP,740079,1,5,288,294,
Washington,Superintendent of Public Instruction,John Cox,DEM,740079,2,2,154,158,
Washington,Superintendent of Public Instruction,Joy Hofmeister,REP,740079,1,5,224,230,
Washington,Commissioner of Labor,Mike Workman,DEM,740079,2,2,121,125,
Washington,Commissioner of Labor,Mark Costello,REP,740079,1,5,249,255,
Washington,U.S. Senate,Matt Silverstein,DEM,740079,1,1,98,100,
Washington,U.S. Senate,Jim Inhofe,REP,740079,1,5,264,270,
Washington,U.S. Senate,Aaron Delozier,IND,740079,1,0,6,7,
Washington,U.S. Senate,Ray Woods,IND,740079,0,0,3,3,
Washington,U.S. Senate,Joan Farr,IND,740079,0,1,4,5,
Washington,U.S. Senate,Connie Johnson,DEM,740079,1,1,78,80,
Washington,U.S. Senate,James Lankford,REP,740079,1,5,284,290,
Washington,U.S. Senate,Mark Beard,IND,740079,1,1,14,16,
Washington,State House,Anthony Tucker,DEM,740079,2,2,107,111,10
Washington,State House,Travis Dunlap,REP,740079,1,5,269,275,10
Washington,Governor,Joe Dorman,DEM,740711,0,0,22,22,
Washington,Governor,Mary Fallin,REP,740711,2,10,85,97,
Washington,Governor,Kimberly Willis,IND,740711,0,0,4,4,
Washington,Governor,Richard Prawdzienski,IND,740711,0,0,3,3,
Washington,Lieutenant Governor,Cathy Cummings,DEM,740711,0,0,13,13,
Washington,Lieutenant Governor,Todd Lamb,REP,740711,2,10,99,111,
Washington,Superintendent of Public Instruction,John Cox,DEM,740711,0,1,22,23,
Washington,Superintendent of Public Instruction,Joy Hofmeister,REP,740711,2,9,88,99,
Washington,Commissioner of Labor,Mike Workman,DEM,740711,0,0,15,15,
Washington,Commissioner of Labor,Mark Costello,REP,740711,2,10,95,107,
Washington,U.S. Senate,Matt Silverstein,DEM,740711,0,0,16,16,
Washington,U.S. Senate,Jim Inhofe,REP,740711,2,9,93,104,
Washington,U.S. Senate,Aaron Delozier,IND,740711,0,0,0,0,
Washington,U.S. Senate,Ray Woods,IND,740711,0,0,2,2,
Washington,U.S. Senate,Joan Farr,IND,740711,0,1,2,3,
Washington,U.S. Senate,Connie Johnson,DEM,740711,0,0,13,13,
Washington,U.S. Senate,James Lankford,REP,740711,2,10,97,109,
Washington,U.S. Senate,Mark Beard,IND,740711,0,0,3,3,
Washington,State House,Anthony Tucker,DEM,740711,0,0,9,9,10
Washington,State House,Travis Dunlap,REP,740711,2,10,104,116,10
Washita,Governor,Joe Dorman,DEM,750003,6,2,22,30,
Washita,Governor,Mary Fallin,REP,750003,7,0,56,63,
Washita,Governor,Kimberly Willis,IND,750003,1,0,0,1,
Washita,Governor,Richard Prawdzienski,IND,750003,0,0,2,2,
Washita,Lieutenant Governor,Cathy Cummings,DEM,750003,5,0,10,15,
Washita,Lieutenant Governor,Todd Lamb,REP,750003,9,2,70,81,
Washita,Superintendent of Public Instruction,John Cox,DEM,750003,7,1,33,41,
Washita,Superintendent of Public Instruction,Joy Hofmeister,REP,750003,7,1,47,55,
Washita,Commissioner of Labor,Mike Workman,DEM,750003,8,0,23,31,
Washita,Commissioner of Labor,Mark Costello,REP,750003,6,1,53,60,
Washita,U.S. Senate,Matt Silverstein,DEM,750003,6,0,8,14,
Washita,U.S. Senate,Jim Inhofe,REP,750003,8,2,70,80,
Washita,U.S. Senate,Aaron Delozier,IND,750003,0,0,1,1,
Washita,U.S. Senate,Ray Woods,IND,750003,0,0,1,1,
Washita,U.S. Senate,Joan Farr,IND,750003,0,0,0,0,
Washita,U.S. Senate,Connie Johnson,DEM,750003,6,0,7,13,
Washita,U.S. Senate,James Lankford,REP,750003,7,2,72,81,
Washita,U.S. Senate,Mark Beard,IND,750003,1,0,1,2,
Washita,U.S. House,Frankie Robbins,DEM,750003,4,0,8,12,03
Washita,U.S. House,Frank Lucas,REP,750003,10,2,72,84,03
Washita,Governor,Joe Dorman,DEM,750004,2,35,202,239,
Washita,Governor,Mary Fallin,REP,750004,18,30,323,371,
Washita,Governor,Kimberly Willis,IND,750004,0,0,9,9,
Washita,Governor,Richard Prawdzienski,IND,750004,1,0,7,8,
Washita,Lieutenant Governor,Cathy Cummings,DEM,750004,4,13,107,124,
Washita,Lieutenant Governor,Todd Lamb,REP,750004,17,51,429,497,
Washita,Superintendent of Public Instruction,John Cox,DEM,750004,11,29,279,319,
Washita,Superintendent of Public Instruction,Joy Hofmeister,REP,750004,10,35,256,301,
Washita,Commissioner of Labor,Mike Workman,DEM,750004,8,26,205,239,
Washita,Commissioner of Labor,Mark Costello,REP,750004,12,35,316,363,
Washita,U.S. Senate,Matt Silverstein,DEM,750004,5,11,96,112,
Washita,U.S. Senate,Jim Inhofe,REP,750004,16,48,430,494,
Washita,U.S. Senate,Aaron Delozier,IND,750004,0,1,2,3,
Washita,U.S. Senate,Ray Woods,IND,750004,0,0,4,4,
Washita,U.S. Senate,Joan Farr,IND,750004,0,2,9,11,
Washita,U.S. Senate,Connie Johnson,DEM,750004,4,12,102,118,
Washita,U.S. Senate,James Lankford,REP,750004,18,49,424,491,
Washita,U.S. Senate,Mark Beard,IND,750004,0,1,14,15,
Washita,U.S. House,Frankie Robbins,DEM,750004,4,9,92,105,03
Washita,U.S. House,Frank Lucas,REP,750004,18,55,447,520,03
Washita,Governor,Joe Dorman,DEM,750007,0,1,39,40,
Washita,Governor,Mary Fallin,REP,750007,8,6,220,234,
Washita,Governor,Kimberly Willis,IND,750007,0,0,4,4,
Washita,Governor,Richard Prawdzienski,IND,750007,0,0,2,2,
Washita,Lieutenant Governor,Cathy Cummings,DEM,750007,0,0,19,19,
Washita,Lieutenant Governor,Todd Lamb,REP,750007,8,7,244,259,
Washita,Superintendent of Public Instruction,John Cox,DEM,750007,0,4,78,82,
Washita,Superintendent of Public Instruction,Joy Hofmeister,REP,750007,7,3,183,193,
Washita,Commissioner of Labor,Mike Workman,DEM,750007,1,1,37,39,
Washita,Commissioner of Labor,Mark Costello,REP,750007,7,4,212,223,
Washita,U.S. Senate,Matt Silverstein,DEM,750007,0,0,15,15,
Washita,U.S. Senate,Jim Inhofe,REP,750007,8,7,244,259,
Washita,U.S. Senate,Aaron Delozier,IND,750007,0,0,1,1,
Washita,U.S. Senate,Ray Woods,IND,750007,0,0,0,0,
Washita,U.S. Senate,Joan Farr,IND,750007,0,0,0,0,
Washita,U.S. Senate,Connie Johnson,DEM,750007,0,0,15,15,
Washita,U.S. Senate,James Lankford,REP,750007,8,7,243,258,
Washita,U.S. Senate,Mark Beard,IND,750007,0,0,5,5,
Washita,U.S. House,Frankie Robbins,DEM,750007,0,0,14,14,03
Washita,U.S. House,Frank Lucas,REP,750007,8,7,250,265,03
Washita,Governor,Joe Dorman,DEM,750009,5,4,43,52,
Washita,Governor,Mary Fallin,REP,750009,1,3,90,94,
Washita,Governor,Kimberly Willis,IND,750009,0,0,2,2,
Washita,Governor,Richard Prawdzienski,IND,750009,0,0,1,1,
Washita,Lieutenant Governor,Cathy Cummings,DEM,750009,5,1,25,31,
Washita,Lieutenant Governor,Todd Lamb,REP,750009,1,5,111,117,
Washita,Superintendent of Public Instruction,John Cox,DEM,750009,5,3,62,70,
Washita,Superintendent of Public Instruction,Joy Hofmeister,REP,750009,1,4,73,78,
Washita,Commissioner of Labor,Mike Workman,DEM,750009,5,2,39,46,
Washita,Commissioner of Labor,Mark Costello,REP,750009,1,3,92,96,
Washita,U.S. Senate,Matt Silverstein,DEM,750009,4,0,15,19,
Washita,U.S. Senate,Jim Inhofe,REP,750009,2,7,116,125,
Washita,U.S. Senate,Aaron Delozier,IND,750009,0,0,1,1,
Washita,U.S. Senate,Ray Woods,IND,750009,0,0,2,2,
Washita,U.S. Senate,Joan Farr,IND,750009,0,0,1,1,
Washita,U.S. Senate,Connie Johnson,DEM,750009,4,0,17,21,
Washita,U.S. Senate,James Lankford,REP,750009,2,7,115,124,
Washita,U.S. Senate,Mark Beard,IND,750009,0,0,4,4,
Washita,U.S. House,Frankie Robbins,DEM,750009,4,0,15,19,03
Washita,U.S. House,Frank Lucas,REP,750009,2,5,122,129,03
Washita,Governor,Joe Dorman,DEM,750012,0,1,65,66,
Washita,Governor,Mary Fallin,REP,750012,2,3,102,107,
Washita,Governor,Kimberly Willis,IND,750012,0,0,3,3,
Washita,Governor,Richard Prawdzienski,IND,750012,0,0,1,1,
Washita,Lieutenant Governor,Cathy Cummings,DEM,750012,0,1,29,30,
Washita,Lieutenant Governor,Todd Lamb,REP,750012,2,3,139,144,
Washita,Superintendent of Public Instruction,John Cox,DEM,750012,0,1,73,74,
Washita,Superintendent of Public Instruction,Joy Hofmeister,REP,750012,2,3,96,101,
Washita,Commissioner of Labor,Mike Workman,DEM,750012,0,1,55,56,
Washita,Commissioner of Labor,Mark Costello,REP,750012,2,3,110,115,
Washita,U.S. Senate,Matt Silverstein,DEM,750012,0,1,25,26,
Washita,U.S. Senate,Jim Inhofe,REP,750012,2,3,143,148,
Washita,U.S. Senate,Aaron Delozier,IND,750012,0,0,1,1,
Washita,U.S. Senate,Ray Woods,IND,750012,0,0,2,2,
Washita,U.S. Senate,Joan Farr,IND,750012,0,0,0,0,
Washita,U.S. Senate,Connie Johnson,DEM,750012,0,1,29,30,
Washita,U.S. Senate,James Lankford,REP,750012,2,3,139,144,
Washita,U.S. Senate,Mark Beard,IND,750012,0,0,3,3,
Washita,U.S. House,Frankie Robbins,DEM,750012,0,1,21,22,03
Washita,U.S. House,Frank Lucas,REP,750012,2,3,149,154,03
Washita,Governor,Joe Dorman,DEM,750014,1,0,112,113,
Washita,Governor,Mary Fallin,REP,750014,3,1,210,214,
Washita,Governor,Kimberly Willis,IND,750014,0,0,4,4,
Washita,Governor,Richard Prawdzienski,IND,750014,0,0,5,5,
Washita,Lieutenant Governor,Cathy Cummings,DEM,750014,1,1,60,62,
Washita,Lieutenant Governor,Todd Lamb,REP,750014,3,0,269,272,
Washita,Superintendent of Public Instruction,John Cox,DEM,750014,2,0,154,156,
Washita,Superintendent of Public Instruction,Joy Hofmeister,REP,750014,2,1,176,179,
Washita,Commissioner of Labor,Mike Workman,DEM,750014,1,0,102,103,
Washita,Commissioner of Labor,Mark Costello,REP,750014,3,1,215,219,
Washita,U.S. Senate,Matt Silverstein,DEM,750014,1,0,54,55,
Washita,U.S. Senate,Jim Inhofe,REP,750014,2,1,264,267,
Washita,U.S. Senate,Aaron Delozier,IND,750014,0,0,1,1,
Washita,U.S. Senate,Ray Woods,IND,750014,0,0,7,7,
Washita,U.S. Senate,Joan Farr,IND,750014,0,0,4,4,
Washita,U.S. Senate,Connie Johnson,DEM,750014,1,0,54,55,
Washita,U.S. Senate,James Lankford,REP,750014,3,1,266,270,
Washita,U.S. Senate,Mark Beard,IND,750014,0,0,10,10,
Washita,U.S. House,Frankie Robbins,DEM,750014,2,0,45,47,03
Washita,U.S. House,Frank Lucas,REP,750014,2,1,284,287,03
Washita,Governor,Joe Dorman,DEM,750016,2,3,105,110,
Washita,Governor,Mary Fallin,REP,750016,11,6,181,198,
Washita,Governor,Kimberly Willis,IND,750016,1,0,5,6,
Washita,Governor,Richard Prawdzienski,IND,750016,0,0,2,2,
Washita,Lieutenant Governor,Cathy Cummings,DEM,750016,1,2,69,72,
Washita,Lieutenant Governor,Todd Lamb,REP,750016,13,7,223,243,
Washita,Superintendent of Public Instruction,John Cox,DEM,750016,3,2,122,127,
Washita,Superintendent of Public Instruction,Joy Hofmeister,REP,750016,11,7,170,188,
Washita,Commissioner of Labor,Mike Workman,DEM,750016,3,3,99,105,
Washita,Commissioner of Labor,Mark Costello,REP,750016,11,6,185,202,
Washita,U.S. Senate,Matt Silverstein,DEM,750016,1,2,50,53,
Washita,U.S. Senate,Jim Inhofe,REP,750016,12,7,235,254,
Washita,U.S. Senate,Aaron Delozier,IND,750016,0,0,2,2,
Washita,U.S. Senate,Ray Woods,IND,750016,1,0,2,3,
Washita,U.S. Senate,Joan Farr,IND,750016,0,0,3,3,
Washita,U.S. Senate,Connie Johnson,DEM,750016,2,2,62,66,
Washita,U.S. Senate,James Lankford,REP,750016,11,7,225,243,
Washita,U.S. Senate,Mark Beard,IND,750016,1,0,6,7,
Washita,U.S. House,Frankie Robbins,DEM,750016,1,2,43,46,03
Washita,U.S. House,Frank Lucas,REP,750016,13,7,249,269,03
Washita,Governor,Joe Dorman,DEM,750017,0,3,54,57,
Washita,Governor,Mary Fallin,REP,750017,1,5,103,109,
Washita,Governor,Kimberly Willis,IND,750017,0,0,5,5,
Washita,Governor,Richard Prawdzienski,IND,750017,0,0,1,1,
Washita,Lieutenant Governor,Cathy Cummings,DEM,750017,0,1,27,28,
Washita,Lieutenant Governor,Todd Lamb,REP,750017,1,7,134,142,
Washita,Superintendent of Public Instruction,John Cox,DEM,750017,0,4,70,74,
Washita,Superintendent of Public Instruction,Joy Hofmeister,REP,750017,1,4,88,93,
Washita,Commissioner of Labor,Mike Workman,DEM,750017,0,2,41,43,
Washita,Commissioner of Labor,Mark Costello,REP,750017,1,6,112,119,
Washita,U.S. Senate,Matt Silverstein,DEM,750017,0,1,21,22,
Washita,U.S. Senate,Jim Inhofe,REP,750017,1,7,133,141,
Washita,U.S. Senate,Aaron Delozier,IND,750017,0,0,3,3,
Washita,U.S. Senate,Ray Woods,IND,750017,0,0,3,3,
Washita,U.S. Senate,Joan Farr,IND,750017,0,0,1,1,
Washita,U.S. Senate,Connie Johnson,DEM,750017,0,1,27,28,
Washita,U.S. Senate,James Lankford,REP,750017,0,7,132,139,
Washita,U.S. Senate,Mark Beard,IND,750017,1,0,3,4,
Washita,U.S. House,Frankie Robbins,DEM,750017,0,2,17,19,03
Washita,U.S. House,Frank Lucas,REP,750017,1,6,145,152,03
Washita,Governor,Joe Dorman,DEM,750018,0,6,65,71,
Washita,Governor,Mary Fallin,REP,750018,5,4,109,118,
Washita,Governor,Kimberly Willis,IND,750018,0,0,6,6,
Washita,Governor,Richard Prawdzienski,IND,750018,0,0,1,1,
Washita,Lieutenant Governor,Cathy Cummings,DEM,750018,0,5,30,35,
Washita,Lieutenant Governor,Todd Lamb,REP,750018,5,5,150,160,
Washita,Superintendent of Public Instruction,John Cox,DEM,750018,1,7,71,79,
Washita,Superintendent of Public Instruction,Joy Hofmeister,REP,750018,4,3,105,112,
Washita,Commissioner of Labor,Mike Workman,DEM,750018,0,7,52,59,
Washita,Commissioner of Labor,Mark Costello,REP,750018,5,3,121,129,
Washita,U.S. Senate,Matt Silverstein,DEM,750018,0,4,23,27,
Washita,U.S. Senate,Jim Inhofe,REP,750018,5,6,157,168,
Washita,U.S. Senate,Aaron Delozier,IND,750018,0,0,0,0,
Washita,U.S. Senate,Ray Woods,IND,750018,0,0,1,1,
Washita,U.S. Senate,Joan Farr,IND,750018,0,0,0,0,
Washita,U.S. Senate,Connie Johnson,DEM,750018,1,4,23,28,
Washita,U.S. Senate,James Lankford,REP,750018,4,6,152,162,
Washita,U.S. Senate,Mark Beard,IND,750018,0,0,6,6,
Washita,U.S. House,Frankie Robbins,DEM,750018,0,3,23,26,03
Washita,U.S. House,Frank Lucas,REP,750018,5,7,158,170,03
Washita,Governor,Joe Dorman,DEM,750019,1,3,99,103,
Washita,Governor,Mary Fallin,REP,750019,4,5,161,170,
Washita,Governor,Kimberly Willis,IND,750019,0,0,10,10,
Washita,Governor,Richard Prawdzienski,IND,750019,0,0,1,1,
Washita,Lieutenant Governor,Cathy Cummings,DEM,750019,2,3,45,50,
Washita,Lieutenant Governor,Todd Lamb,REP,750019,3,5,227,235,
Washita,Superintendent of Public Instruction,John Cox,DEM,750019,4,7,124,135,
Washita,Superintendent of Public Instruction,Joy Hofmeister,REP,750019,1,1,148,150,
Washita,Commissioner of Labor,Mike Workman,DEM,750019,1,3,100,104,
Washita,Commissioner of Labor,Mark Costello,REP,750019,3,5,165,173,
Washita,U.S. Senate,Matt Silverstein,DEM,750019,1,3,40,44,
Washita,U.S. Senate,Jim Inhofe,REP,750019,4,5,218,227,
Washita,U.S. Senate,Aaron Delozier,IND,750019,0,0,2,2,
Washita,U.S. Senate,Ray Woods,IND,750019,0,0,2,2,
Washita,U.S. Senate,Joan Farr,IND,750019,0,0,5,5,
Washita,U.S. Senate,Connie Johnson,DEM,750019,1,3,44,48,
Washita,U.S. Senate,James Lankford,REP,750019,3,5,224,232,
Washita,U.S. Senate,Mark Beard,IND,750019,0,0,3,3,
Washita,U.S. House,Frankie Robbins,DEM,750019,1,2,29,32,03
Washita,U.S. House,Frank Lucas,REP,750019,4,6,242,252,03
Washita,Governor,Joe Dorman,DEM,750020,4,3,50,57,
Washita,Governor,Mary Fallin,REP,750020,2,1,101,104,
Washita,Governor,Kimberly Willis,IND,750020,0,0,2,2,
Washita,Governor,Richard Prawdzienski,IND,750020,0,0,2,2,
Washita,Lieutenant Governor,Cathy Cummings,DEM,750020,3,3,32,38,
Washita,Lieutenant Governor,Todd Lamb,REP,750020,3,1,123,127,
Washita,Superintendent of Public Instruction,John Cox,DEM,750020,2,4,66,72,
Washita,Superintendent of Public Instruction,Joy Hofmeister,REP,750020,4,0,89,93,
Washita,Commissioner of Labor,Mike Workman,DEM,750020,4,4,59,67,
Washita,Commissioner of Labor,Mark Costello,REP,750020,2,0,93,95,
Washita,U.S. Senate,Matt Silverstein,DEM,750020,4,3,32,39,
Washita,U.S. Senate,Jim Inhofe,REP,750020,2,1,122,125,
Washita,U.S. Senate,Aaron Delozier,IND,750020,0,0,0,0,
Washita,U.S. Senate,Ray Woods,IND,750020,0,0,1,1,
Washita,U.S. Senate,Joan Farr,IND,750020,0,0,0,0,
Washita,U.S. Senate,Connie Johnson,DEM,750020,2,3,31,36,
Washita,U.S. Senate,James Lankford,REP,750020,4,1,117,122,
Washita,U.S. Senate,Mark Beard,IND,750020,0,0,4,4,
Washita,U.S. House,Frankie Robbins,DEM,750020,1,2,22,25,03
Washita,U.S. House,Frank Lucas,REP,750020,5,2,133,140,03
Washita,Governor,Joe Dorman,DEM,750030,1,5,95,101,
Washita,Governor,Mary Fallin,REP,750030,4,23,134,161,
Washita,Governor,Kimberly Willis,IND,750030,0,1,2,3,
Washita,Governor,Richard Prawdzienski,IND,750030,1,0,0,1,
Washita,Lieutenant Governor,Cathy Cummings,DEM,750030,1,3,51,55,
Washita,Lieutenant Governor,Todd Lamb,REP,750030,4,24,176,204,
Washita,Superintendent of Public Instruction,John Cox,DEM,750030,2,4,115,121,
Washita,Superintendent of Public Instruction,Joy Hofmeister,REP,750030,3,24,116,143,
Washita,Commissioner of Labor,Mike Workman,DEM,750030,1,6,95,102,
Washita,Commissioner of Labor,Mark Costello,REP,750030,4,21,122,147,
Washita,U.S. Senate,Matt Silverstein,DEM,750030,1,4,42,47,
Washita,U.S. Senate,Jim Inhofe,REP,750030,4,24,183,211,
Washita,U.S. Senate,Aaron Delozier,IND,750030,0,0,0,0,
Washita,U.S. Senate,Ray Woods,IND,750030,0,1,2,3,
Washita,U.S. Senate,Joan Farr,IND,750030,0,0,1,1,
Washita,U.S. Senate,Connie Johnson,DEM,750030,0,3,48,51,
Washita,U.S. Senate,James Lankford,REP,750030,5,27,176,208,
Washita,U.S. Senate,Mark Beard,IND,750030,0,0,4,4,
Washita,U.S. House,Frankie Robbins,DEM,750030,0,4,37,41,03
Washita,U.S. House,Frank Lucas,REP,750030,5,26,189,220,03
Woods,Governor,Joe Dorman,DEM,760001,3,35,253,291,
Woods,Governor,Mary Fallin,REP,760001,8,44,292,344,
Woods,Governor,Kimberly Willis,IND,760001,0,0,10,10,
Woods,Governor,Richard Prawdzienski,IND,760001,0,1,11,12,
Woods,Lieutenant Governor,Cathy Cummings,DEM,760001,2,24,111,137,
Woods,Lieutenant Governor,Todd Lamb,REP,760001,9,56,454,519,
Woods,Superintendent of Public Instruction,John Cox,DEM,760001,1,34,284,319,
Woods,Superintendent of Public Instruction,Joy Hofmeister,REP,760001,10,46,280,336,
Woods,Commissioner of Labor,Mike Workman,DEM,760001,4,31,175,210,
Woods,Commissioner of Labor,Mark Costello,REP,760001,7,46,383,436,
Woods,U.S. Senate,Matt Silverstein,DEM,760001,3,22,104,129,
Woods,U.S. Senate,Jim Inhofe,REP,760001,7,56,442,505,
Woods,U.S. Senate,Aaron Delozier,IND,760001,0,0,2,2,
Woods,U.S. Senate,Ray Woods,IND,760001,0,2,12,14,
Woods,U.S. Senate,Joan Farr,IND,760001,1,0,6,7,
Woods,U.S. Senate,Connie Johnson,DEM,760001,3,24,110,137,
Woods,U.S. Senate,James Lankford,REP,760001,7,54,438,499,
Woods,U.S. Senate,Mark Beard,IND,760001,1,2,15,18,
Woods,U.S. House,Frankie Robbins,DEM,760001,3,21,103,127,03
Woods,U.S. House,Frank Lucas,REP,760001,8,58,460,526,03
Woods,Governor,Joe Dorman,DEM,760002,2,2,130,134,
Woods,Governor,Mary Fallin,REP,760002,4,12,312,328,
Woods,Governor,Kimberly Willis,IND,760002,0,0,13,13,
Woods,Governor,Richard Prawdzienski,IND,760002,0,0,7,7,
Woods,Lieutenant Governor,Cathy Cummings,DEM,760002,2,2,66,70,
Woods,Lieutenant Governor,Todd Lamb,REP,760002,4,12,395,411,
Woods,Superintendent of Public Instruction,John Cox,DEM,760002,2,3,167,172,
Woods,Superintendent of Public Instruction,Joy Hofmeister,REP,760002,3,11,292,306,
Woods,Commissioner of Labor,Mike Workman,DEM,760002,2,2,112,116,
Woods,Commissioner of Labor,Mark Costello,REP,760002,4,12,340,356,
Woods,U.S. Senate,Matt Silverstein,DEM,760002,2,2,59,63,
Woods,U.S. Senate,Jim Inhofe,REP,760002,4,12,383,399,
Woods,U.S. Senate,Aaron Delozier,IND,760002,0,0,1,1,
Woods,U.S. Senate,Ray Woods,IND,760002,0,0,14,14,
Woods,U.S. Senate,Joan Farr,IND,760002,0,0,3,3,
Woods,U.S. Senate,Connie Johnson,DEM,760002,2,3,65,70,
Woods,U.S. Senate,James Lankford,REP,760002,4,11,391,406,
Woods,U.S. Senate,Mark Beard,IND,760002,0,0,5,5,
Woods,U.S. House,Frankie Robbins,DEM,760002,2,2,57,61,03
Woods,U.S. House,Frank Lucas,REP,760002,4,12,403,419,03
Woods,Governor,Joe Dorman,DEM,760003,6,11,104,121,
Woods,Governor,Mary Fallin,REP,760003,9,9,147,165,
Woods,Governor,Kimberly Willis,IND,760003,0,0,4,4,
Woods,Governor,Richard Prawdzienski,IND,760003,0,0,5,5,
Woods,Lieutenant Governor,Cathy Cummings,DEM,760003,6,8,42,56,
Woods,Lieutenant Governor,Todd Lamb,REP,760003,9,12,216,237,
Woods,Superintendent of Public Instruction,John Cox,DEM,760003,7,10,114,131,
Woods,Superintendent of Public Instruction,Joy Hofmeister,REP,760003,8,10,144,162,
Woods,Commissioner of Labor,Mike Workman,DEM,760003,7,15,55,77,
Woods,Commissioner of Labor,Mark Costello,REP,760003,8,5,197,210,
Woods,U.S. Senate,Matt Silverstein,DEM,760003,6,10,37,53,
Woods,U.S. Senate,Jim Inhofe,REP,760003,9,10,213,232,
Woods,U.S. Senate,Aaron Delozier,IND,760003,0,0,1,1,
Woods,U.S. Senate,Ray Woods,IND,760003,0,0,2,2,
Woods,U.S. Senate,Joan Farr,IND,760003,0,0,2,2,
Woods,U.S. Senate,Connie Johnson,DEM,760003,6,8,40,54,
Woods,U.S. Senate,James Lankford,REP,760003,9,12,211,232,
Woods,U.S. Senate,Mark Beard,IND,760003,0,0,8,8,
Woods,U.S. House,Frankie Robbins,DEM,760003,5,8,31,44,03
Woods,U.S. House,Frank Lucas,REP,760003,10,12,229,251,03
Woods,Governor,Joe Dorman,DEM,760004,0,3,23,26,
Woods,Governor,Mary Fallin,REP,760004,1,1,34,36,
Woods,Governor,Kimberly Willis,IND,760004,0,0,2,2,
Woods,Governor,Richard Prawdzienski,IND,760004,0,0,2,2,
Woods,Lieutenant Governor,Cathy Cummings,DEM,760004,1,2,13,16,
Woods,Lieutenant Governor,Todd Lamb,REP,760004,0,2,48,50,
Woods,Superintendent of Public Instruction,John Cox,DEM,760004,1,3,31,35,
Woods,Superintendent of Public Instruction,Joy Hofmeister,REP,760004,0,1,30,31,
Woods,Commissioner of Labor,Mike Workman,DEM,760004,1,3,20,24,
Woods,Commissioner of Labor,Mark Costello,REP,760004,0,1,39,40,
Woods,U.S. Senate,Matt Silverstein,DEM,760004,0,2,12,14,
Woods,U.S. Senate,Jim Inhofe,REP,760004,1,2,47,50,
Woods,U.S. Senate,Aaron Delozier,IND,760004,0,0,0,0,
Woods,U.S. Senate,Ray Woods,IND,760004,0,0,2,2,
Woods,U.S. Senate,Joan Farr,IND,760004,0,0,0,0,
Woods,U.S. Senate,Connie Johnson,DEM,760004,1,3,13,17,
Woods,U.S. Senate,James Lankford,REP,760004,0,1,45,46,
Woods,U.S. Senate,Mark Beard,IND,760004,0,0,3,3,
Woods,U.S. House,Frankie Robbins,DEM,760004,1,2,12,15,03
Woods,U.S. House,Frank Lucas,REP,760004,0,2,48,50,03
Woods,Governor,Joe Dorman,DEM,760005,6,29,245,280,
Woods,Governor,Mary Fallin,REP,760005,10,48,342,400,
Woods,Governor,Kimberly Willis,IND,760005,0,4,14,18,
Woods,Governor,Richard Prawdzienski,IND,760005,0,0,12,12,
Woods,Lieutenant Governor,Cathy Cummings,DEM,760005,6,21,112,139,
Woods,Lieutenant Governor,Todd Lamb,REP,760005,10,60,498,568,
Woods,Superintendent of Public Instruction,John Cox,DEM,760005,7,35,286,328,
Woods,Superintendent of Public Instruction,Joy Hofmeister,REP,760005,9,46,323,378,
Woods,Commissioner of Labor,Mike Workman,DEM,760005,6,23,156,185,
Woods,Commissioner of Labor,Mark Costello,REP,760005,9,58,445,512,
Woods,U.S. Senate,Matt Silverstein,DEM,760005,5,18,93,116,
Woods,U.S. Senate,Jim Inhofe,REP,760005,11,57,502,570,
Woods,U.S. Senate,Aaron Delozier,IND,760005,0,3,3,6,
Woods,U.S. Senate,Ray Woods,IND,760005,0,2,8,10,
Woods,U.S. Senate,Joan Farr,IND,760005,0,1,5,6,
Woods,U.S. Senate,Connie Johnson,DEM,760005,6,19,98,123,
Woods,U.S. Senate,James Lankford,REP,760005,10,58,490,558,
Woods,U.S. Senate,Mark Beard,IND,760005,0,3,23,26,
Woods,U.S. House,Frankie Robbins,DEM,760005,5,17,98,120,03
Woods,U.S. House,Frank Lucas,REP,760005,11,64,509,584,03
Woods,Governor,Joe Dorman,DEM,760007,0,2,26,28,
Woods,Governor,Mary Fallin,REP,760007,3,1,41,45,
Woods,Governor,Kimberly Willis,IND,760007,0,0,2,2,
Woods,Governor,Richard Prawdzienski,IND,760007,0,0,1,1,
Woods,Lieutenant Governor,Cathy Cummings,DEM,760007,1,0,8,9,
Woods,Lieutenant Governor,Todd Lamb,REP,760007,2,3,62,67,
Woods,Superintendent of Public Instruction,John Cox,DEM,760007,1,2,34,37,
Woods,Superintendent of Public Instruction,Joy Hofmeister,REP,760007,2,1,36,39,
Woods,Commissioner of Labor,Mike Workman,DEM,760007,2,1,19,22,
Woods,Commissioner of Labor,Mark Costello,REP,760007,1,2,47,50,
Woods,U.S. Senate,Matt Silverstein,DEM,760007,0,0,9,9,
Woods,U.S. Senate,Jim Inhofe,REP,760007,3,3,56,62,
Woods,U.S. Senate,Aaron Delozier,IND,760007,0,0,0,0,
Woods,U.S. Senate,Ray Woods,IND,760007,0,0,3,3,
Woods,U.S. Senate,Joan Farr,IND,760007,0,0,0,0,
Woods,U.S. Senate,Connie Johnson,DEM,760007,0,1,9,10,
Woods,U.S. Senate,James Lankford,REP,760007,2,1,57,60,
Woods,U.S. Senate,Mark Beard,IND,760007,1,1,4,6,
Woods,U.S. House,Frankie Robbins,DEM,760007,0,0,8,8,03
Woods,U.S. House,Frank Lucas,REP,760007,3,3,62,68,03
Woods,Governor,Joe Dorman,DEM,760008,0,0,36,36,
Woods,Governor,Mary Fallin,REP,760008,4,1,117,122,
Woods,Governor,Kimberly Willis,IND,760008,0,0,6,6,
Woods,Governor,Richard Prawdzienski,IND,760008,2,0,2,4,
Woods,Lieutenant Governor,Cathy Cummings,DEM,760008,0,0,14,14,
Woods,Lieutenant Governor,Todd Lamb,REP,760008,6,1,147,154,
Woods,Superintendent of Public Instruction,John Cox,DEM,760008,0,0,48,48,
Woods,Superintendent of Public Instruction,Joy Hofmeister,REP,760008,5,1,112,118,
Woods,Commissioner of Labor,Mike Workman,DEM,760008,2,0,25,27,
Woods,Commissioner of Labor,Mark Costello,REP,760008,3,1,136,140,
Woods,U.S. Senate,Matt Silverstein,DEM,760008,0,0,16,16,
Woods,U.S. Senate,Jim Inhofe,REP,760008,6,1,138,145,
Woods,U.S. Senate,Aaron Delozier,IND,760008,0,0,3,3,
Woods,U.S. Senate,Ray Woods,IND,760008,0,0,1,1,
Woods,U.S. Senate,Joan Farr,IND,760008,0,0,2,2,
Woods,U.S. Senate,Connie Johnson,DEM,760008,0,0,14,14,
Woods,U.S. Senate,James Lankford,REP,760008,5,1,140,146,
Woods,U.S. Senate,Mark Beard,IND,760008,0,0,6,6,
Woods,U.S. House,Frankie Robbins,DEM,760008,1,0,19,20,03
Woods,U.S. House,Frank Lucas,REP,760008,5,1,142,148,03
Woodward,Governor,Joe Dorman,DEM,770101,3,7,69,79,
Woodward,Governor,Mary Fallin,REP,770101,4,19,226,249,
Woodward,Governor,Kimberly Willis,IND,770101,0,0,13,13,
Woodward,Governor,Richard Prawdzienski,IND,770101,0,0,4,4,
Woodward,Lieutenant Governor,Cathy Cummings,DEM,770101,1,4,34,39,
Woodward,Lieutenant Governor,Todd Lamb,REP,770101,6,22,278,306,
Woodward,Superintendent of Public Instruction,John Cox,DEM,770101,3,10,85,98,
Woodward,Superintendent of Public Instruction,Joy Hofmeister,REP,770101,4,16,225,245,
Woodward,Commissioner of Labor,Mike Workman,DEM,770101,2,5,65,72,
Woodward,Commissioner of Labor,Mark Costello,REP,770101,5,20,240,265,
Woodward,U.S. Senate,Matt Silverstein,DEM,770101,1,4,32,37,
Woodward,U.S. Senate,Jim Inhofe,REP,770101,6,22,269,297,
Woodward,U.S. Senate,Aaron Delozier,IND,770101,0,0,4,4,
Woodward,U.S. Senate,Ray Woods,IND,770101,0,0,5,5,
Woodward,U.S. Senate,Joan Farr,IND,770101,0,0,2,2,
Woodward,U.S. Senate,Connie Johnson,DEM,770101,1,4,38,43,
Woodward,U.S. Senate,James Lankford,REP,770101,5,22,265,292,
Woodward,U.S. Senate,Mark Beard,IND,770101,1,0,9,10,
Woodward,U.S. House,Frankie Robbins,DEM,770101,1,2,32,35,03
Woodward,U.S. House,Frank Lucas,REP,770101,6,24,279,309,03
Woodward,Governor,Joe Dorman,DEM,770102,0,2,51,53,
Woodward,Governor,Mary Fallin,REP,770102,2,19,139,160,
Woodward,Governor,Kimberly Willis,IND,770102,0,0,9,9,
Woodward,Governor,Richard Prawdzienski,IND,770102,0,0,1,1,
Woodward,Lieutenant Governor,Cathy Cummings,DEM,770102,0,3,36,39,
Woodward,Lieutenant Governor,Todd Lamb,REP,770102,2,18,163,183,
Woodward,Superintendent of Public Instruction,John Cox,DEM,770102,1,2,58,61,
Woodward,Superintendent of Public Instruction,Joy Hofmeister,REP,770102,1,19,141,161,
Woodward,Commissioner of Labor,Mike Workman,DEM,770102,0,4,56,60,
Woodward,Commissioner of Labor,Mark Costello,REP,770102,2,17,140,159,
Woodward,U.S. Senate,Matt Silverstein,DEM,770102,0,1,28,29,
Woodward,U.S. Senate,Jim Inhofe,REP,770102,2,20,159,181,
Woodward,U.S. Senate,Aaron Delozier,IND,770102,0,0,1,1,
Woodward,U.S. Senate,Ray Woods,IND,770102,0,0,3,3,
Woodward,U.S. Senate,Joan Farr,IND,770102,0,0,8,8,
Woodward,U.S. Senate,Connie Johnson,DEM,770102,0,1,36,37,
Woodward,U.S. Senate,James Lankford,REP,770102,2,19,152,173,
Woodward,U.S. Senate,Mark Beard,IND,770102,0,1,10,11,
Woodward,U.S. House,Frankie Robbins,DEM,770102,0,1,29,30,03
Woodward,U.S. House,Frank Lucas,REP,770102,2,20,170,192,03
Woodward,Governor,Joe Dorman,DEM,770104,0,0,0,0,
Woodward,Governor,Mary Fallin,REP,770104,2,0,1,3,
Woodward,Governor,Kimberly Willis,IND,770104,0,0,0,0,
Woodward,Governor,Richard Prawdzienski,IND,770104,0,0,0,0,
Woodward,Lieutenant Governor,Cathy Cummings,DEM,770104,0,0,0,0,
Woodward,Lieutenant Governor,Todd Lamb,REP,770104,2,0,1,3,
Woodward,Superintendent of Public Instruction,John Cox,DEM,770104,0,0,0,0,
Woodward,Superintendent of Public Instruction,Joy Hofmeister,REP,770104,2,0,1,3,
Woodward,Commissioner of Labor,Mike Workman,DEM,770104,0,0,0,0,
Woodward,Commissioner of Labor,Mark Costello,REP,770104,2,0,1,3,
Woodward,U.S. Senate,Matt Silverstein,DEM,770104,0,0,0,0,
Woodward,U.S. Senate,Jim Inhofe,REP,770104,2,0,1,3,
Woodward,U.S. Senate,Aaron Delozier,IND,770104,0,0,0,0,
Woodward,U.S. Senate,Ray Woods,IND,770104,0,0,0,0,
Woodward,U.S. Senate,Joan Farr,IND,770104,0,0,0,0,
Woodward,U.S. Senate,Connie Johnson,DEM,770104,0,0,0,0,
Woodward,U.S. Senate,James Lankford,REP,770104,2,0,1,3,
Woodward,U.S. Senate,Mark Beard,IND,770104,0,0,0,0,
Woodward,U.S. House,Frankie Robbins,DEM,770104,0,0,0,0,03
Woodward,U.S. House,Frank Lucas,REP,770104,2,0,1,3,03
Woodward,Governor,Joe Dorman,DEM,770105,10,8,157,175,
Woodward,Governor,Mary Fallin,REP,770105,10,16,378,404,
Woodward,Governor,Kimberly Willis,IND,770105,0,0,12,12,
Woodward,Governor,Richard Prawdzienski,IND,770105,0,0,2,2,
Woodward,Lieutenant Governor,Cathy Cummings,DEM,770105,10,3,72,85,
Woodward,Lieutenant Governor,Todd Lamb,REP,770105,10,21,475,506,
Woodward,Superintendent of Public Instruction,John Cox,DEM,770105,11,10,200,221,
Woodward,Superintendent of Public Instruction,Joy Hofmeister,REP,770105,9,14,346,369,
Woodward,Commissioner of Labor,Mike Workman,DEM,770105,9,5,140,154,
Woodward,Commissioner of Labor,Mark Costello,REP,770105,11,19,398,428,
Woodward,U.S. Senate,Matt Silverstein,DEM,770105,8,2,56,66,
Woodward,U.S. Senate,Jim Inhofe,REP,770105,11,21,472,504,
Woodward,U.S. Senate,Aaron Delozier,IND,770105,0,1,4,5,
Woodward,U.S. Senate,Ray Woods,IND,770105,0,0,6,6,
Woodward,U.S. Senate,Joan Farr,IND,770105,0,0,6,6,
Woodward,U.S. Senate,Connie Johnson,DEM,770105,8,3,58,69,
Woodward,U.S. Senate,James Lankford,REP,770105,9,21,478,508,
Woodward,U.S. Senate,Mark Beard,IND,770105,2,0,11,13,
Woodward,U.S. House,Frankie Robbins,DEM,770105,6,3,56,65,03
Woodward,U.S. House,Frank Lucas,REP,770105,14,21,491,526,03
Woodward,Governor,Joe Dorman,DEM,770106,0,2,17,19,
Woodward,Governor,Mary Fallin,REP,770106,6,4,38,48,
Woodward,Governor,Kimberly Willis,IND,770106,0,0,0,0,
Woodward,Governor,Richard Prawdzienski,IND,770106,0,0,0,0,
Woodward,Lieutenant Governor,Cathy Cummings,DEM,770106,0,1,13,14,
Woodward,Lieutenant Governor,Todd Lamb,REP,770106,6,5,41,52,
Woodward,Superintendent of Public Instruction,John Cox,DEM,770106,2,3,24,29,
Woodward,Superintendent of Public Instruction,Joy Hofmeister,REP,770106,4,3,30,37,
Woodward,Commissioner of Labor,Mike Workman,DEM,770106,2,1,14,17,
Woodward,Commissioner of Labor,Mark Costello,REP,770106,4,5,39,48,
Woodward,U.S. Senate,Matt Silverstein,DEM,770106,0,1,12,13,
Woodward,U.S. Senate,Jim Inhofe,REP,770106,6,5,43,54,
Woodward,U.S. Senate,Aaron Delozier,IND,770106,0,0,0,0,
Woodward,U.S. Senate,Ray Woods,IND,770106,0,0,0,0,
Woodward,U.S. Senate,Joan Farr,IND,770106,0,0,0,0,
Woodward,U.S. Senate,Connie Johnson,DEM,770106,0,1,11,12,
Woodward,U.S. Senate,James Lankford,REP,770106,6,5,44,55,
Woodward,U.S. Senate,Mark Beard,IND,770106,0,0,0,0,
Woodward,U.S. House,Frankie Robbins,DEM,770106,0,1,10,11,03
Woodward,U.S. House,Frank Lucas,REP,770106,6,5,45,56,03
Woodward,Governor,Joe Dorman,DEM,770201,1,22,142,165,
Woodward,Governor,Mary Fallin,REP,770201,6,40,311,357,
Woodward,Governor,Kimberly Willis,IND,770201,0,1,5,6,
Woodward,Governor,Richard Prawdzienski,IND,770201,0,0,5,5,
Woodward,Lieutenant Governor,Cathy Cummings,DEM,770201,0,12,90,102,
Woodward,Lieutenant Governor,Todd Lamb,REP,770201,7,50,372,429,
Woodward,Superintendent of Public Instruction,John Cox,DEM,770201,2,26,176,204,
Woodward,Superintendent of Public Instruction,Joy Hofmeister,REP,770201,5,37,281,323,
Woodward,Commissioner of Labor,Mike Workman,DEM,770201,0,17,131,148,
Woodward,Commissioner of Labor,Mark Costello,REP,770201,7,45,321,373,
Woodward,U.S. Senate,Matt Silverstein,DEM,770201,0,11,82,93,
Woodward,U.S. Senate,Jim Inhofe,REP,770201,7,51,365,423,
Woodward,U.S. Senate,Aaron Delozier,IND,770201,0,1,1,2,
Woodward,U.S. Senate,Ray Woods,IND,770201,0,0,4,4,
Woodward,U.S. Senate,Joan Farr,IND,770201,0,0,9,9,
Woodward,U.S. Senate,Connie Johnson,DEM,770201,1,11,84,96,
Woodward,U.S. Senate,James Lankford,REP,770201,6,51,364,421,
Woodward,U.S. Senate,Mark Beard,IND,770201,0,0,14,14,
Woodward,U.S. House,Frankie Robbins,DEM,770201,0,10,78,88,03
Woodward,U.S. House,Frank Lucas,REP,770201,7,52,385,444,03
Woodward,Governor,Joe Dorman,DEM,770202,7,25,174,206,
Woodward,Governor,Mary Fallin,REP,770202,10,57,516,583,
Woodward,Governor,Kimberly Willis,IND,770202,0,0,17,17,
Woodward,Governor,Richard Prawdzienski,IND,770202,0,0,11,11,
Woodward,Lieutenant Governor,Cathy Cummings,DEM,770202,5,15,86,106,
Woodward,Lieutenant Governor,Todd Lamb,REP,770202,12,67,631,710,
Woodward,Superintendent of Public Instruction,John Cox,DEM,770202,9,24,241,274,
Woodward,Superintendent of Public Instruction,Joy Hofmeister,REP,770202,8,55,471,534,
Woodward,Commissioner of Labor,Mike Workman,DEM,770202,9,24,136,169,
Woodward,Commissioner of Labor,Mark Costello,REP,770202,8,56,556,620,
Woodward,U.S. Senate,Matt Silverstein,DEM,770202,6,16,79,101,
Woodward,U.S. Senate,Jim Inhofe,REP,770202,11,64,614,689,
Woodward,U.S. Senate,Aaron Delozier,IND,770202,0,0,5,5,
Woodward,U.S. Senate,Ray Woods,IND,770202,0,1,6,7,
Woodward,U.S. Senate,Joan Farr,IND,770202,0,0,11,11,
Woodward,U.S. Senate,Connie Johnson,DEM,770202,6,19,91,116,
Woodward,U.S. Senate,James Lankford,REP,770202,11,63,612,686,
Woodward,U.S. Senate,Mark Beard,IND,770202,0,0,14,14,
Woodward,U.S. House,Frankie Robbins,DEM,770202,4,13,71,88,03
Woodward,U.S. House,Frank Lucas,REP,770202,13,68,646,727,03
Woodward,Governor,Joe Dorman,DEM,770203,3,3,46,52,
Woodward,Governor,Mary Fallin,REP,770203,2,9,203,214,
Woodward,Governor,Kimberly Willis,IND,770203,0,0,7,7,
Woodward,Governor,Richard Prawdzienski,IND,770203,0,0,3,3,
Woodward,Lieutenant Governor,Cathy Cummings,DEM,770203,1,2,16,19,
Woodward,Lieutenant Governor,Todd Lamb,REP,770203,4,10,243,257,
Woodward,Superintendent of Public Instruction,John Cox,DEM,770203,1,3,77,81,
Woodward,Superintendent of Public Instruction,Joy Hofmeister,REP,770203,4,9,181,194,
Woodward,Commissioner of Labor,Mike Workman,DEM,770203,3,3,55,61,
Woodward,Commissioner of Labor,Mark Costello,REP,770203,2,8,199,209,
Woodward,U.S. Senate,Matt Silverstein,DEM,770203,1,0,17,18,
Woodward,U.S. Senate,Jim Inhofe,REP,770203,3,12,233,248,
Woodward,U.S. Senate,Aaron Delozier,IND,770203,0,0,2,2,
Woodward,U.S. Senate,Ray Woods,IND,770203,0,0,4,4,
Woodward,U.S. Senate,Joan Farr,IND,770203,0,0,2,2,
Woodward,U.S. Senate,Connie Johnson,DEM,770203,1,2,19,22,
Woodward,U.S. Senate,James Lankford,REP,770203,4,10,234,248,
Woodward,U.S. Senate,Mark Beard,IND,770203,0,0,5,5,
Woodward,U.S. House,Frankie Robbins,DEM,770203,4,0,18,22,03
Woodward,U.S. House,Frank Lucas,REP,770203,1,12,239,252,03
Woodward,Governor,Joe Dorman,DEM,770204,0,0,30,30,
Woodward,Governor,Mary Fallin,REP,770204,1,8,97,106,
Woodward,Governor,Kimberly Willis,IND,770204,0,0,1,1,
Woodward,Governor,Richard Prawdzienski,IND,770204,0,0,2,2,
Woodward,Lieutenant Governor,Cathy Cummings,DEM,770204,0,0,13,13,
Woodward,Lieutenant Governor,Todd Lamb,REP,770204,1,8,116,125,
Woodward,Superintendent of Public Instruction,John Cox,DEM,770204,0,1,55,56,
Woodward,Superintendent of Public Instruction,Joy Hofmeister,REP,770204,1,7,76,84,
Woodward,Commissioner of Labor,Mike Workman,DEM,770204,0,1,36,37,
Woodward,Commissioner of Labor,Mark Costello,REP,770204,1,6,88,95,
Woodward,U.S. Senate,Matt Silverstein,DEM,770204,0,0,18,18,
Woodward,U.S. Senate,Jim Inhofe,REP,770204,1,8,109,118,
Woodward,U.S. Senate,Aaron Delozier,IND,770204,0,0,0,0,
Woodward,U.S. Senate,Ray Woods,IND,770204,0,0,1,1,
Woodward,U.S. Senate,Joan Farr,IND,770204,0,0,1,1,
Woodward,U.S. Senate,Connie Johnson,DEM,770204,0,0,14,14,
Woodward,U.S. Senate,James Lankford,REP,770204,1,8,114,123,
Woodward,U.S. Senate,Mark Beard,IND,770204,0,0,2,2,
Woodward,U.S. House,Frankie Robbins,DEM,770204,0,0,16,16,03
Woodward,U.S. House,Frank Lucas,REP,770204,1,8,114,123,03
Woodward,Governor,Joe Dorman,DEM,770301,0,9,49,58,
Woodward,Governor,Mary Fallin,REP,770301,2,7,84,93,
Woodward,Governor,Kimberly Willis,IND,770301,0,0,3,3,
Woodward,Governor,Richard Prawdzienski,IND,770301,0,0,1,1,
Woodward,Lieutenant Governor,Cathy Cummings,DEM,770301,0,6,26,32,
Woodward,Lieutenant Governor,Todd Lamb,REP,770301,2,10,110,122,
Woodward,Superintendent of Public Instruction,John Cox,DEM,770301,0,7,52,59,
Woodward,Superintendent of Public Instruction,Joy Hofmeister,REP,770301,2,9,85,96,
Woodward,Commissioner of Labor,Mike Workman,DEM,770301,0,6,35,41,
Woodward,Commissioner of Labor,Mark Costello,REP,770301,2,10,101,113,
Woodward,U.S. Senate,Matt Silverstein,DEM,770301,0,8,24,32,
Woodward,U.S. Senate,Jim Inhofe,REP,770301,2,7,111,120,
Woodward,U.S. Senate,Aaron Delozier,IND,770301,0,0,0,0,
Woodward,U.S. Senate,Ray Woods,IND,770301,0,0,1,1,
Woodward,U.S. Senate,Joan Farr,IND,770301,0,0,1,1,
Woodward,U.S. Senate,Connie Johnson,DEM,770301,0,6,22,28,
Woodward,U.S. Senate,James Lankford,REP,770301,2,10,113,125,
Woodward,U.S. Senate,Mark Beard,IND,770301,0,0,2,2,
Woodward,U.S. House,Frankie Robbins,DEM,770301,0,5,19,24,03
Woodward,U.S. House,Frank Lucas,REP,770301,2,11,118,131,03
Woodward,Governor,Joe Dorman,DEM,770302,0,13,33,46,
Woodward,Governor,Mary Fallin,REP,770302,6,24,92,122,
Woodward,Governor,Kimberly Willis,IND,770302,0,0,3,3,
Woodward,Governor,Richard Prawdzienski,IND,770302,0,0,1,1,
Woodward,Lieutenant Governor,Cathy Cummings,DEM,770302,2,4,18,24,
Woodward,Lieutenant Governor,Todd Lamb,REP,770302,4,34,111,149,
Woodward,Superintendent of Public Instruction,John Cox,DEM,770302,0,9,47,56,
Woodward,Superintendent of Public Instruction,Joy Hofmeister,REP,770302,6,29,81,116,
Woodward,Commissioner of Labor,Mike Workman,DEM,770302,0,6,32,38,
Woodward,Commissioner of Labor,Mark Costello,REP,770302,6,31,96,133,
Woodward,U.S. Senate,Matt Silverstein,DEM,770302,0,5,16,21,
Woodward,U.S. Senate,Jim Inhofe,REP,770302,6,32,112,150,
Woodward,U.S. Senate,Aaron Delozier,IND,770302,0,0,0,0,
Woodward,U.S. Senate,Ray Woods,IND,770302,0,1,1,2,
Woodward,U.S. Senate,Joan Farr,IND,770302,0,0,0,0,
Woodward,U.S. Senate,Connie Johnson,DEM,770302,0,5,15,20,
Woodward,U.S. Senate,James Lankford,REP,770302,6,33,110,149,
Woodward,U.S. Senate,Mark Beard,IND,770302,0,0,3,3,
Woodward,U.S. House,Frankie Robbins,DEM,770302,0,1,20,21,03
Woodward,U.S. House,Frank Lucas,REP,770302,6,37,109,152,03
Woodward,Governor,Joe Dorman,DEM,770303,0,0,0,0,
Woodward,Governor,Mary Fallin,REP,770303,2,0,0,2,
Woodward,Governor,Kimberly Willis,IND,770303,0,0,0,0,
Woodward,Governor,Richard Prawdzienski,IND,770303,0,0,0,0,
Woodward,Lieutenant Governor,Cathy Cummings,DEM,770303,0,0,0,0,
Woodward,Lieutenant Governor,Todd Lamb,REP,770303,2,0,0,2,
Woodward,Superintendent of Public Instruction,John Cox,DEM,770303,1,0,0,1,
Woodward,Superintendent of Public Instruction,Joy Hofmeister,REP,770303,1,0,0,1,
Woodward,Commissioner of Labor,Mike Workman,DEM,770303,1,0,0,1,
Woodward,Commissioner of Labor,Mark Costello,REP,770303,1,0,0,1,
Woodward,U.S. Senate,Matt Silverstein,DEM,770303,1,0,0,1,
Woodward,U.S. Senate,Jim Inhofe,REP,770303,1,0,0,1,
Woodward,U.S. Senate,Aaron Delozier,IND,770303,0,0,0,0,
Woodward,U.S. Senate,Ray Woods,IND,770303,0,0,0,0,
Woodward,U.S. Senate,Joan Farr,IND,770303,0,0,0,0,
Woodward,U.S. Senate,Connie Johnson,DEM,770303,0,0,0,0,
Woodward,U.S. Senate,James Lankford,REP,770303,2,0,0,2,
Woodward,U.S. Senate,Mark Beard,IND,770303,0,0,0,0,
Woodward,U.S. House,Frankie Robbins,DEM,770303,0,0,0,0,03
Woodward,U.S. House,Frank Lucas,REP,770303,2,0,0,2,03
Woodward,Governor,Joe Dorman,DEM,770304,0,2,27,29,
Woodward,Governor,Mary Fallin,REP,770304,0,2,77,79,
Woodward,Governor,Kimberly Willis,IND,770304,0,0,1,1,
Woodward,Governor,Richard Prawdzienski,IND,770304,0,0,2,2,
Woodward,Lieutenant Governor,Cathy Cummings,DEM,770304,0,1,11,12,
Woodward,Lieutenant Governor,Todd Lamb,REP,770304,0,3,96,99,
Woodward,Superintendent of Public Instruction,John Cox,DEM,770304,0,2,33,35,
Woodward,Superintendent of Public Instruction,Joy Hofmeister,REP,770304,0,2,74,76,
Woodward,Commissioner of Labor,Mike Workman,DEM,770304,0,0,26,26,
Woodward,Commissioner of Labor,Mark Costello,REP,770304,0,3,78,81,
Woodward,U.S. Senate,Matt Silverstein,DEM,770304,0,0,11,11,
Woodward,U.S. Senate,Jim Inhofe,REP,770304,0,4,95,99,
Woodward,U.S. Senate,Aaron Delozier,IND,770304,0,0,0,0,
Woodward,U.S. Senate,Ray Woods,IND,770304,0,0,0,0,
Woodward,U.S. Senate,Joan Farr,IND,770304,0,0,1,1,
Woodward,U.S. Senate,Connie Johnson,DEM,770304,0,0,14,14,
Woodward,U.S. Senate,James Lankford,REP,770304,0,4,92,96,
Woodward,U.S. Senate,Mark Beard,IND,770304,0,0,2,2,
Woodward,U.S. House,Frankie Robbins,DEM,770304,0,0,11,11,03
Woodward,U.S. House,Frank Lucas,REP,770304,0,4,96,100,03
Woodward,Governor,Joe Dorman,DEM,770306,3,18,159,180,
Woodward,Governor,Mary Fallin,REP,770306,7,64,490,561,
Woodward,Governor,Kimberly Willis,IND,770306,0,2,8,10,
Woodward,Governor,Richard Prawdzienski,IND,770306,0,0,5,5,
Woodward,Lieutenant Governor,Cathy Cummings,DEM,770306,0,9,68,77,
Woodward,Lieutenant Governor,Todd Lamb,REP,770306,10,75,593,678,
Woodward,Superintendent of Public Instruction,John Cox,DEM,770306,3,21,202,226,
Woodward,Superintendent of Public Instruction,Joy Hofmeister,REP,770306,7,63,454,524,
Woodward,Commissioner of Labor,Mike Workman,DEM,770306,3,14,125,142,
Woodward,Commissioner of Labor,Mark Costello,REP,770306,6,67,527,600,
Woodward,U.S. Senate,Matt Silverstein,DEM,770306,1,10,59,70,
Woodward,U.S. Senate,Jim Inhofe,REP,770306,9,71,588,668,
Woodward,U.S. Senate,Aaron Delozier,IND,770306,0,0,5,5,
Woodward,U.S. Senate,Ray Woods,IND,770306,0,3,5,8,
Woodward,U.S. Senate,Joan Farr,IND,770306,0,0,5,5,
Woodward,U.S. Senate,Connie Johnson,DEM,770306,2,9,65,76,
Woodward,U.S. Senate,James Lankford,REP,770306,8,74,582,664,
Woodward,U.S. Senate,Mark Beard,IND,770306,0,1,14,15,
Woodward,U.S. House,Frankie Robbins,DEM,770306,2,12,58,72,03
Woodward,U.S. House,Frank Lucas,REP,770306,8,72,603,683,03
Woodward,Governor,Joe Dorman,DEM,770307,0,1,33,34,
Woodward,Governor,Mary Fallin,REP,770307,0,2,46,48,
Woodward,Governor,Kimberly Willis,IND,770307,0,0,6,6,
Woodward,Governor,Richard Prawdzienski,IND,770307,0,0,0,0,
Woodward,Lieutenant Governor,Cathy Cummings,DEM,770307,0,0,13,13,
Woodward,Lieutenant Governor,Todd Lamb,REP,770307,0,3,71,74,
Woodward,Superintendent of Public Instruction,John Cox,DEM,770307,0,2,39,41,
Woodward,Superintendent of Public Instruction,Joy Hofmeister,REP,770307,0,1,45,46,
Woodward,Commissioner of Labor,Mike Workman,DEM,770307,0,1,29,30,
Woodward,Commissioner of Labor,Mark Costello,REP,770307,0,2,53,55,
Woodward,U.S. Senate,Matt Silverstein,DEM,770307,0,0,11,11,
Woodward,U.S. Senate,Jim Inhofe,REP,770307,0,3,71,74,
Woodward,U.S. Senate,Aaron Delozier,IND,770307,0,0,0,0,
Woodward,U.S. Senate,Ray Woods,IND,770307,0,0,1,1,
Woodward,U.S. Senate,Joan Farr,IND,770307,0,0,1,1,
Woodward,U.S. Senate,Connie Johnson,DEM,770307,0,0,17,17,
Woodward,U.S. Senate,James Lankford,REP,770307,0,3,63,66,
Woodward,U.S. Senate,Mark Beard,IND,770307,0,0,5,5,
Woodward,U.S. House,Frankie Robbins,DEM,770307,0,0,11,11,03
Woodward,U.S. House,Frank Lucas,REP,770307,0,3,73,76,03
