county,office,candidate,party,precinct,mail_votes,early_votes,elec_day_votes,total_votes,district
Adair,Superintendent of Public Instruction,John Cox,DEM,10001,7,8,78,93,
Adair,Superintendent of Public Instruction,Jack Jr.,DEM,10001,2,0,8,10,
Adair,Superintendent of Public Instruction,Ivan Holmes,DEM,10001,3,2,2,7,
Adair,Superintendent of Public Instruction,Freda Deskin,DEM,10001,0,0,14,14,
Adair,U.S. Senate,Patrick Michael Hayes,DEM,10001,5,0,15,20,
Adair,U.S. Senate,Jim Rogers,DEM,10001,7,6,55,68,
Adair,U.S. Senate,Connie Johnson,DEM,10001,0,3,20,23,
Adair,U.S. House,Earl Everett,DEM,10001,8,5,47,60,02
Adair,U.S. House,Joshua Harris-Till,DEM,10001,1,4,40,45,02
Adair,Governor,Dax Ewbank,REP,10001,0,1,2,3,
Adair,Governor,Chad Moody,REP,10001,0,1,10,11,
Adair,Governor,Mary Fallin,REP,10001,0,0,39,39,
Adair,Superintendent of Public Instruction,Brian Kelly,REP,10001,0,0,16,16,
Adair,Superintendent of Public Instruction,Janet Costello Barresi,REP,10001,0,0,4,4,
Adair,Superintendent of Public Instruction,Joy Hofmeister,REP,10001,0,2,27,29,
Adair,Insurance Commissioner,Bill Viner,REP,10001,0,0,11,11,
Adair,Insurance Commissioner,John Doak,REP,10001,0,2,36,38,
Adair,Corporation Commissioner,Todd Hiett,REP,10001,0,1,24,25,
Adair,Corporation Commissioner,Cliff Branan,REP,10001,0,1,23,24,
Adair,U.S. Senate,Evelyn Rogers,REP,10001,0,0,2,2,
Adair,U.S. Senate,Rob Moye,REP,10001,0,0,0,0,
Adair,U.S. Senate,D. Jean Mcbride-Samuels,REP,10001,0,0,0,0,
Adair,U.S. Senate,Jim Inhofe,REP,10001,0,2,47,49,
Adair,U.S. Senate,Erick Paul Wyatt,REP,10001,0,0,1,1,
Adair,U.S. Senate,Andy Craig,REP,10001,0,0,0,0,
Adair,U.S. Senate,T. Shannon,REP,10001,0,2,24,26,
Adair,U.S. Senate,Randy Brogdon,REP,10001,0,0,1,1,
Adair,U.S. Senate,Eric Mccray,REP,10001,0,0,1,1,
Adair,U.S. Senate,Kevin Crow,REP,10001,0,0,2,2,
Adair,U.S. Senate,James Lankford,REP,10001,0,0,20,20,
Adair,U.S. Senate,Jason Weger,REP,10001,0,0,0,0,
Adair,U.S. House,Darrel Robertson,REP,10001,0,0,3,3,02
Adair,U.S. House,Markwayne Mullin,REP,10001,0,2,49,51,02
Adair,Superintendent of Public Instruction,John Cox,DEM,10002,2,3,47,52,
Adair,Superintendent of Public Instruction,Jack Jr.,DEM,10002,0,1,6,7,
Adair,Superintendent of Public Instruction,Ivan Holmes,DEM,10002,2,0,4,6,
Adair,Superintendent of Public Instruction,Freda Deskin,DEM,10002,0,0,17,17,
Adair,U.S. Senate,Patrick Michael Hayes,DEM,10002,2,1,13,16,
Adair,U.S. Senate,Jim Rogers,DEM,10002,1,3,39,43,
Adair,U.S. Senate,Connie Johnson,DEM,10002,0,0,16,16,
Adair,U.S. House,Earl Everett,DEM,10002,1,2,35,38,02
Adair,U.S. House,Joshua Harris-Till,DEM,10002,2,2,30,34,02
Adair,Governor,Dax Ewbank,REP,10002,0,0,6,6,
Adair,Governor,Chad Moody,REP,10002,0,1,16,17,
Adair,Governor,Mary Fallin,REP,10002,1,4,43,48,
Adair,Superintendent of Public Instruction,Brian Kelly,REP,10002,0,1,16,17,
Adair,Superintendent of Public Instruction,Janet Costello Barresi,REP,10002,0,1,6,7,
Adair,Superintendent of Public Instruction,Joy Hofmeister,REP,10002,1,2,41,44,
Adair,Insurance Commissioner,Bill Viner,REP,10002,1,2,18,21,
Adair,Insurance Commissioner,John Doak,REP,10002,0,2,44,46,
Adair,Corporation Commissioner,Todd Hiett,REP,10002,0,2,40,42,
Adair,Corporation Commissioner,Cliff Branan,REP,10002,1,1,23,25,
Adair,U.S. Senate,Evelyn Rogers,REP,10002,0,1,2,3,
Adair,U.S. Senate,Rob Moye,REP,10002,0,0,1,1,
Adair,U.S. Senate,D. Jean Mcbride-Samuels,REP,10002,0,0,2,2,
Adair,U.S. Senate,Jim Inhofe,REP,10002,1,4,56,61,
Adair,U.S. Senate,Erick Paul Wyatt,REP,10002,0,0,4,4,
Adair,U.S. Senate,Andy Craig,REP,10002,0,0,1,1,
Adair,U.S. Senate,T. Shannon,REP,10002,1,2,33,36,
Adair,U.S. Senate,Randy Brogdon,REP,10002,0,0,3,3,
Adair,U.S. Senate,Eric Mccray,REP,10002,0,0,0,0,
Adair,U.S. Senate,Kevin Crow,REP,10002,0,0,1,1,
Adair,U.S. Senate,James Lankford,REP,10002,0,3,27,30,
Adair,U.S. Senate,Jason Weger,REP,10002,0,0,0,0,
Adair,U.S. House,Darrel Robertson,REP,10002,0,0,5,5,02
Adair,U.S. House,Markwayne Mullin,REP,10002,1,5,61,67,02
Adair,Superintendent of Public Instruction,John Cox,DEM,10003,0,0,16,16,
Adair,Superintendent of Public Instruction,Jack Jr.,DEM,10003,0,0,5,5,
Adair,Superintendent of Public Instruction,Ivan Holmes,DEM,10003,0,0,2,2,
Adair,Superintendent of Public Instruction,Freda Deskin,DEM,10003,0,0,15,15,
Adair,U.S. Senate,Patrick Michael Hayes,DEM,10003,0,0,6,6,
Adair,U.S. Senate,Jim Rogers,DEM,10003,0,0,23,23,
Adair,U.S. Senate,Connie Johnson,DEM,10003,0,0,8,8,
Adair,U.S. House,Earl Everett,DEM,10003,0,0,25,25,02
Adair,U.S. House,Joshua Harris-Till,DEM,10003,0,0,12,12,02
Adair,Governor,Dax Ewbank,REP,10003,0,0,3,3,
Adair,Governor,Chad Moody,REP,10003,0,0,10,10,
Adair,Governor,Mary Fallin,REP,10003,0,3,25,28,
Adair,Superintendent of Public Instruction,Brian Kelly,REP,10003,0,0,11,11,
Adair,Superintendent of Public Instruction,Janet Costello Barresi,REP,10003,0,2,9,11,
Adair,Superintendent of Public Instruction,Joy Hofmeister,REP,10003,0,1,15,16,
Adair,Insurance Commissioner,Bill Viner,REP,10003,0,0,6,6,
Adair,Insurance Commissioner,John Doak,REP,10003,0,3,25,28,
Adair,Corporation Commissioner,Todd Hiett,REP,10003,0,3,27,30,
Adair,Corporation Commissioner,Cliff Branan,REP,10003,0,0,8,8,
Adair,U.S. Senate,Evelyn Rogers,REP,10003,0,0,0,0,
Adair,U.S. Senate,Rob Moye,REP,10003,0,0,1,1,
Adair,U.S. Senate,D. Jean Mcbride-Samuels,REP,10003,0,0,0,0,
Adair,U.S. Senate,Jim Inhofe,REP,10003,0,3,32,35,
Adair,U.S. Senate,Erick Paul Wyatt,REP,10003,0,0,3,3,
Adair,U.S. Senate,Andy Craig,REP,10003,0,0,0,0,
Adair,U.S. Senate,T. Shannon,REP,10003,0,0,16,16,
Adair,U.S. Senate,Randy Brogdon,REP,10003,0,0,3,3,
Adair,U.S. Senate,Eric Mccray,REP,10003,0,0,2,2,
Adair,U.S. Senate,Kevin Crow,REP,10003,0,0,2,2,
Adair,U.S. Senate,James Lankford,REP,10003,0,3,15,18,
Adair,U.S. Senate,Jason Weger,REP,10003,0,0,0,0,
Adair,U.S. House,Darrel Robertson,REP,10003,0,0,3,3,02
Adair,U.S. House,Markwayne Mullin,REP,10003,0,3,35,38,02
Adair,Superintendent of Public Instruction,John Cox,DEM,10004,1,4,55,60,
Adair,Superintendent of Public Instruction,Jack Jr.,DEM,10004,0,0,5,5,
Adair,Superintendent of Public Instruction,Ivan Holmes,DEM,10004,1,0,8,9,
Adair,Superintendent of Public Instruction,Freda Deskin,DEM,10004,2,0,12,14,
Adair,U.S. Senate,Patrick Michael Hayes,DEM,10004,0,1,19,20,
Adair,U.S. Senate,Jim Rogers,DEM,10004,3,1,39,43,
Adair,U.S. Senate,Connie Johnson,DEM,10004,1,1,19,21,
Adair,U.S. House,Earl Everett,DEM,10004,4,2,51,57,02
Adair,U.S. House,Joshua Harris-Till,DEM,10004,0,1,24,25,02
Adair,Governor,Dax Ewbank,REP,10004,0,0,3,3,
Adair,Governor,Chad Moody,REP,10004,0,3,8,11,
Adair,Governor,Mary Fallin,REP,10004,0,8,25,33,
Adair,Superintendent of Public Instruction,Brian Kelly,REP,10004,0,2,11,13,
Adair,Superintendent of Public Instruction,Janet Costello Barresi,REP,10004,0,4,5,9,
Adair,Superintendent of Public Instruction,Joy Hofmeister,REP,10004,0,5,20,25,
Adair,Insurance Commissioner,Bill Viner,REP,10004,0,4,11,15,
Adair,Insurance Commissioner,John Doak,REP,10004,0,7,22,29,
Adair,Corporation Commissioner,Todd Hiett,REP,10004,0,7,10,17,
Adair,Corporation Commissioner,Cliff Branan,REP,10004,0,4,23,27,
Adair,U.S. Senate,Evelyn Rogers,REP,10004,0,0,2,2,
Adair,U.S. Senate,Rob Moye,REP,10004,0,0,0,0,
Adair,U.S. Senate,D. Jean Mcbride-Samuels,REP,10004,0,0,0,0,
Adair,U.S. Senate,Jim Inhofe,REP,10004,0,11,28,39,
Adair,U.S. Senate,Erick Paul Wyatt,REP,10004,0,0,6,6,
Adair,U.S. Senate,Andy Craig,REP,10004,0,0,0,0,
Adair,U.S. Senate,T. Shannon,REP,10004,0,6,13,19,
Adair,U.S. Senate,Randy Brogdon,REP,10004,0,0,0,0,
Adair,U.S. Senate,Eric Mccray,REP,10004,0,0,3,3,
Adair,U.S. Senate,Kevin Crow,REP,10004,0,0,1,1,
Adair,U.S. Senate,James Lankford,REP,10004,0,5,17,22,
Adair,U.S. Senate,Jason Weger,REP,10004,0,0,0,0,
Adair,U.S. House,Darrel Robertson,REP,10004,0,0,4,4,02
Adair,U.S. House,Markwayne Mullin,REP,10004,0,11,31,42,02
Adair,Superintendent of Public Instruction,John Cox,DEM,10005,0,1,46,47,
Adair,Superintendent of Public Instruction,Jack Jr.,DEM,10005,0,0,3,3,
Adair,Superintendent of Public Instruction,Ivan Holmes,DEM,10005,0,0,0,0,
Adair,Superintendent of Public Instruction,Freda Deskin,DEM,10005,0,1,12,13,
Adair,U.S. Senate,Patrick Michael Hayes,DEM,10005,0,1,12,13,
Adair,U.S. Senate,Jim Rogers,DEM,10005,0,0,33,33,
Adair,U.S. Senate,Connie Johnson,DEM,10005,0,1,11,12,
Adair,U.S. House,Earl Everett,DEM,10005,0,1,35,36,02
Adair,U.S. House,Joshua Harris-Till,DEM,10005,0,0,17,17,02
Adair,Governor,Dax Ewbank,REP,10005,0,0,5,5,
Adair,Governor,Chad Moody,REP,10005,0,0,6,6,
Adair,Governor,Mary Fallin,REP,10005,0,0,47,47,
Adair,Superintendent of Public Instruction,Brian Kelly,REP,10005,0,0,14,14,
Adair,Superintendent of Public Instruction,Janet Costello Barresi,REP,10005,0,0,4,4,
Adair,Superintendent of Public Instruction,Joy Hofmeister,REP,10005,0,0,35,35,
Adair,Insurance Commissioner,Bill Viner,REP,10005,0,0,6,6,
Adair,Insurance Commissioner,John Doak,REP,10005,0,0,44,44,
Adair,Corporation Commissioner,Todd Hiett,REP,10005,0,0,24,24,
Adair,Corporation Commissioner,Cliff Branan,REP,10005,0,0,24,24,
Adair,U.S. Senate,Evelyn Rogers,REP,10005,0,0,1,1,
Adair,U.S. Senate,Rob Moye,REP,10005,0,0,0,0,
Adair,U.S. Senate,D. Jean Mcbride-Samuels,REP,10005,0,0,0,0,
Adair,U.S. Senate,Jim Inhofe,REP,10005,0,0,48,48,
Adair,U.S. Senate,Erick Paul Wyatt,REP,10005,0,0,4,4,
Adair,U.S. Senate,Andy Craig,REP,10005,0,0,1,1,
Adair,U.S. Senate,T. Shannon,REP,10005,0,0,37,37,
Adair,U.S. Senate,Randy Brogdon,REP,10005,0,0,3,3,
Adair,U.S. Senate,Eric Mccray,REP,10005,0,0,0,0,
Adair,U.S. Senate,Kevin Crow,REP,10005,0,0,0,0,
Adair,U.S. Senate,James Lankford,REP,10005,0,0,16,16,
Adair,U.S. Senate,Jason Weger,REP,10005,0,0,1,1,
Adair,U.S. House,Darrel Robertson,REP,10005,0,0,9,9,02
Adair,U.S. House,Markwayne Mullin,REP,10005,0,0,49,49,02
Adair,Superintendent of Public Instruction,John Cox,DEM,10006,2,3,116,121,
Adair,Superintendent of Public Instruction,Jack Jr.,DEM,10006,0,1,11,12,
Adair,Superintendent of Public Instruction,Ivan Holmes,DEM,10006,0,0,4,4,
Adair,Superintendent of Public Instruction,Freda Deskin,DEM,10006,0,0,14,14,
Adair,U.S. Senate,Patrick Michael Hayes,DEM,10006,1,2,20,23,
Adair,U.S. Senate,Jim Rogers,DEM,10006,0,2,90,92,
Adair,U.S. Senate,Connie Johnson,DEM,10006,0,0,29,29,
Adair,U.S. House,Earl Everett,DEM,10006,1,3,74,78,02
Adair,U.S. House,Joshua Harris-Till,DEM,10006,0,1,61,62,02
Adair,Governor,Dax Ewbank,REP,10006,0,1,7,8,
Adair,Governor,Chad Moody,REP,10006,0,0,15,15,
Adair,Governor,Mary Fallin,REP,10006,0,2,63,65,
Adair,Superintendent of Public Instruction,Brian Kelly,REP,10006,0,0,24,24,
Adair,Superintendent of Public Instruction,Janet Costello Barresi,REP,10006,0,1,12,13,
Adair,Superintendent of Public Instruction,Joy Hofmeister,REP,10006,0,2,53,55,
Adair,Insurance Commissioner,Bill Viner,REP,10006,0,1,23,24,
Adair,Insurance Commissioner,John Doak,REP,10006,0,2,56,58,
Adair,Corporation Commissioner,Todd Hiett,REP,10006,0,1,36,37,
Adair,Corporation Commissioner,Cliff Branan,REP,10006,0,2,49,51,
Adair,U.S. Senate,Evelyn Rogers,REP,10006,0,0,4,4,
Adair,U.S. Senate,Rob Moye,REP,10006,0,0,1,1,
Adair,U.S. Senate,D. Jean Mcbride-Samuels,REP,10006,0,0,0,0,
Adair,U.S. Senate,Jim Inhofe,REP,10006,0,3,77,80,
Adair,U.S. Senate,Erick Paul Wyatt,REP,10006,0,0,6,6,
Adair,U.S. Senate,Andy Craig,REP,10006,0,0,3,3,
Adair,U.S. Senate,T. Shannon,REP,10006,0,1,34,35,
Adair,U.S. Senate,Randy Brogdon,REP,10006,0,0,4,4,
Adair,U.S. Senate,Eric Mccray,REP,10006,0,0,0,0,
Adair,U.S. Senate,Kevin Crow,REP,10006,0,0,2,2,
Adair,U.S. Senate,James Lankford,REP,10006,0,2,42,44,
Adair,U.S. Senate,Jason Weger,REP,10006,0,0,0,0,
Adair,U.S. House,Darrel Robertson,REP,10006,0,0,5,5,02
Adair,U.S. House,Markwayne Mullin,REP,10006,0,3,85,88,02
Adair,Superintendent of Public Instruction,John Cox,DEM,10007,1,25,136,162,
Adair,Superintendent of Public Instruction,Jack Jr.,DEM,10007,0,0,7,7,
Adair,Superintendent of Public Instruction,Ivan Holmes,DEM,10007,0,1,3,4,
Adair,Superintendent of Public Instruction,Freda Deskin,DEM,10007,0,1,17,18,
Adair,U.S. Senate,Patrick Michael Hayes,DEM,10007,0,2,27,29,
Adair,U.S. Senate,Jim Rogers,DEM,10007,1,11,103,115,
Adair,U.S. Senate,Connie Johnson,DEM,10007,0,9,26,35,
Adair,U.S. House,Earl Everett,DEM,10007,0,12,97,109,02
Adair,U.S. House,Joshua Harris-Till,DEM,10007,0,9,50,59,02
Adair,Governor,Dax Ewbank,REP,10007,0,0,5,5,
Adair,Governor,Chad Moody,REP,10007,0,0,17,17,
Adair,Governor,Mary Fallin,REP,10007,0,5,47,52,
Adair,Superintendent of Public Instruction,Brian Kelly,REP,10007,0,3,16,19,
Adair,Superintendent of Public Instruction,Janet Costello Barresi,REP,10007,0,0,8,8,
Adair,Superintendent of Public Instruction,Joy Hofmeister,REP,10007,0,2,45,47,
Adair,Insurance Commissioner,Bill Viner,REP,10007,0,2,16,18,
Adair,Insurance Commissioner,John Doak,REP,10007,0,3,48,51,
Adair,Corporation Commissioner,Todd Hiett,REP,10007,0,2,32,34,
Adair,Corporation Commissioner,Cliff Branan,REP,10007,0,3,32,35,
Adair,U.S. Senate,Evelyn Rogers,REP,10007,0,1,1,2,
Adair,U.S. Senate,Rob Moye,REP,10007,0,0,1,1,
Adair,U.S. Senate,D. Jean Mcbride-Samuels,REP,10007,0,0,1,1,
Adair,U.S. Senate,Jim Inhofe,REP,10007,0,4,60,64,
Adair,U.S. Senate,Erick Paul Wyatt,REP,10007,0,0,7,7,
Adair,U.S. Senate,Andy Craig,REP,10007,0,0,1,1,
Adair,U.S. Senate,T. Shannon,REP,10007,0,4,36,40,
Adair,U.S. Senate,Randy Brogdon,REP,10007,0,0,0,0,
Adair,U.S. Senate,Eric Mccray,REP,10007,0,0,1,1,
Adair,U.S. Senate,Kevin Crow,REP,10007,0,0,2,2,
Adair,U.S. Senate,James Lankford,REP,10007,0,0,29,29,
Adair,U.S. Senate,Jason Weger,REP,10007,0,0,0,0,
Adair,U.S. House,Darrel Robertson,REP,10007,0,1,5,6,02
Adair,U.S. House,Markwayne Mullin,REP,10007,0,4,63,67,02
Adair,Superintendent of Public Instruction,John Cox,DEM,10008,0,7,98,105,
Adair,Superintendent of Public Instruction,Jack Jr.,DEM,10008,0,0,3,3,
Adair,Superintendent of Public Instruction,Ivan Holmes,DEM,10008,0,0,0,0,
Adair,Superintendent of Public Instruction,Freda Deskin,DEM,10008,0,0,15,15,
Adair,U.S. Senate,Patrick Michael Hayes,DEM,10008,0,0,25,25,
Adair,U.S. Senate,Jim Rogers,DEM,10008,0,5,71,76,
Adair,U.S. Senate,Connie Johnson,DEM,10008,0,1,15,16,
Adair,U.S. House,Earl Everett,DEM,10008,0,4,65,69,02
Adair,U.S. House,Joshua Harris-Till,DEM,10008,0,2,42,44,02
Adair,Governor,Dax Ewbank,REP,10008,0,0,5,5,
Adair,Governor,Chad Moody,REP,10008,0,1,17,18,
Adair,Governor,Mary Fallin,REP,10008,0,0,48,48,
Adair,Superintendent of Public Instruction,Brian Kelly,REP,10008,0,0,22,22,
Adair,Superintendent of Public Instruction,Janet Costello Barresi,REP,10008,0,0,12,12,
Adair,Superintendent of Public Instruction,Joy Hofmeister,REP,10008,0,1,36,37,
Adair,Insurance Commissioner,Bill Viner,REP,10008,0,0,26,26,
Adair,Insurance Commissioner,John Doak,REP,10008,0,1,42,43,
Adair,Corporation Commissioner,Todd Hiett,REP,10008,0,1,32,33,
Adair,Corporation Commissioner,Cliff Branan,REP,10008,0,0,36,36,
Adair,U.S. Senate,Evelyn Rogers,REP,10008,0,0,0,0,
Adair,U.S. Senate,Rob Moye,REP,10008,0,0,0,0,
Adair,U.S. Senate,D. Jean Mcbride-Samuels,REP,10008,0,0,0,0,
Adair,U.S. Senate,Jim Inhofe,REP,10008,0,1,67,68,
Adair,U.S. Senate,Erick Paul Wyatt,REP,10008,0,0,4,4,
Adair,U.S. Senate,Andy Craig,REP,10008,0,0,5,5,
Adair,U.S. Senate,T. Shannon,REP,10008,0,1,40,41,
Adair,U.S. Senate,Randy Brogdon,REP,10008,0,0,3,3,
Adair,U.S. Senate,Eric Mccray,REP,10008,0,0,0,0,
Adair,U.S. Senate,Kevin Crow,REP,10008,0,0,1,1,
Adair,U.S. Senate,James Lankford,REP,10008,0,0,19,19,
Adair,U.S. Senate,Jason Weger,REP,10008,0,0,1,1,
Adair,U.S. House,Darrel Robertson,REP,10008,0,0,4,4,02
Adair,U.S. House,Markwayne Mullin,REP,10008,0,1,67,68,02
Adair,Superintendent of Public Instruction,John Cox,DEM,10010,0,3,22,25,
Adair,Superintendent of Public Instruction,Jack Jr.,DEM,10010,1,0,1,2,
Adair,Superintendent of Public Instruction,Ivan Holmes,DEM,10010,0,0,7,7,
Adair,Superintendent of Public Instruction,Freda Deskin,DEM,10010,0,0,18,18,
Adair,U.S. Senate,Patrick Michael Hayes,DEM,10010,0,1,10,11,
Adair,U.S. Senate,Jim Rogers,DEM,10010,1,1,25,27,
Adair,U.S. Senate,Connie Johnson,DEM,10010,0,0,14,14,
Adair,U.S. House,Earl Everett,DEM,10010,1,2,32,35,02
Adair,U.S. House,Joshua Harris-Till,DEM,10010,0,1,14,15,02
Adair,Governor,Dax Ewbank,REP,10010,0,0,3,3,
Adair,Governor,Chad Moody,REP,10010,0,1,3,4,
Adair,Governor,Mary Fallin,REP,10010,0,1,9,10,
Adair,Superintendent of Public Instruction,Brian Kelly,REP,10010,0,1,2,3,
Adair,Superintendent of Public Instruction,Janet Costello Barresi,REP,10010,0,1,2,3,
Adair,Superintendent of Public Instruction,Joy Hofmeister,REP,10010,0,0,11,11,
Adair,Insurance Commissioner,Bill Viner,REP,10010,0,0,4,4,
Adair,Insurance Commissioner,John Doak,REP,10010,0,2,11,13,
Adair,Corporation Commissioner,Todd Hiett,REP,10010,0,1,5,6,
Adair,Corporation Commissioner,Cliff Branan,REP,10010,0,1,10,11,
Adair,U.S. Senate,Evelyn Rogers,REP,10010,0,0,0,0,
Adair,U.S. Senate,Rob Moye,REP,10010,0,0,0,0,
Adair,U.S. Senate,D. Jean Mcbride-Samuels,REP,10010,0,0,0,0,
Adair,U.S. Senate,Jim Inhofe,REP,10010,0,2,14,16,
Adair,U.S. Senate,Erick Paul Wyatt,REP,10010,0,0,0,0,
Adair,U.S. Senate,Andy Craig,REP,10010,0,0,0,0,
Adair,U.S. Senate,T. Shannon,REP,10010,0,0,9,9,
Adair,U.S. Senate,Randy Brogdon,REP,10010,0,2,1,3,
Adair,U.S. Senate,Eric Mccray,REP,10010,0,0,1,1,
Adair,U.S. Senate,Kevin Crow,REP,10010,0,0,0,0,
Adair,U.S. Senate,James Lankford,REP,10010,0,0,4,4,
Adair,U.S. Senate,Jason Weger,REP,10010,0,0,0,0,
Adair,U.S. House,Darrel Robertson,REP,10010,0,0,0,0,02
Adair,U.S. House,Markwayne Mullin,REP,10010,0,2,15,17,02
Adair,Superintendent of Public Instruction,John Cox,DEM,10011,4,3,33,40,
Adair,Superintendent of Public Instruction,Jack Jr.,DEM,10011,2,0,2,4,
Adair,Superintendent of Public Instruction,Ivan Holmes,DEM,10011,1,0,2,3,
Adair,Superintendent of Public Instruction,Freda Deskin,DEM,10011,0,0,5,5,
Adair,U.S. Senate,Patrick Michael Hayes,DEM,10011,0,0,13,13,
Adair,U.S. Senate,Jim Rogers,DEM,10011,12,2,20,34,
Adair,U.S. Senate,Connie Johnson,DEM,10011,0,1,6,7,
Adair,U.S. House,Earl Everett,DEM,10011,4,2,22,28,02
Adair,U.S. House,Joshua Harris-Till,DEM,10011,0,1,14,15,02
Adair,Governor,Dax Ewbank,REP,10011,1,0,3,4,
Adair,Governor,Chad Moody,REP,10011,0,0,3,3,
Adair,Governor,Mary Fallin,REP,10011,0,0,14,14,
Adair,Superintendent of Public Instruction,Brian Kelly,REP,10011,1,0,7,8,
Adair,Superintendent of Public Instruction,Janet Costello Barresi,REP,10011,0,0,3,3,
Adair,Superintendent of Public Instruction,Joy Hofmeister,REP,10011,0,0,9,9,
Adair,Insurance Commissioner,Bill Viner,REP,10011,0,0,7,7,
Adair,Insurance Commissioner,John Doak,REP,10011,1,0,10,11,
Adair,Corporation Commissioner,Todd Hiett,REP,10011,1,0,6,7,
Adair,Corporation Commissioner,Cliff Branan,REP,10011,0,0,12,12,
Adair,U.S. Senate,Evelyn Rogers,REP,10011,0,0,0,0,
Adair,U.S. Senate,Rob Moye,REP,10011,0,0,0,0,
Adair,U.S. Senate,D. Jean Mcbride-Samuels,REP,10011,0,0,0,0,
Adair,U.S. Senate,Jim Inhofe,REP,10011,1,0,20,21,
Adair,U.S. Senate,Erick Paul Wyatt,REP,10011,0,0,1,1,
Adair,U.S. Senate,Andy Craig,REP,10011,0,0,0,0,
Adair,U.S. Senate,T. Shannon,REP,10011,0,0,11,11,
Adair,U.S. Senate,Randy Brogdon,REP,10011,0,0,0,0,
Adair,U.S. Senate,Eric Mccray,REP,10011,0,0,0,0,
Adair,U.S. Senate,Kevin Crow,REP,10011,0,0,0,0,
Adair,U.S. Senate,James Lankford,REP,10011,1,0,8,9,
Adair,U.S. Senate,Jason Weger,REP,10011,0,0,2,2,
Adair,U.S. House,Darrel Robertson,REP,10011,0,0,0,0,02
Adair,U.S. House,Markwayne Mullin,REP,10011,1,0,21,22,02
Adair,Superintendent of Public Instruction,John Cox,DEM,10012,5,1,59,65,
Adair,Superintendent of Public Instruction,Jack Jr.,DEM,10012,1,0,7,8,
Adair,Superintendent of Public Instruction,Ivan Holmes,DEM,10012,0,0,9,9,
Adair,Superintendent of Public Instruction,Freda Deskin,DEM,10012,0,0,15,15,
Adair,U.S. Senate,Patrick Michael Hayes,DEM,10012,3,0,22,25,
Adair,U.S. Senate,Jim Rogers,DEM,10012,0,0,51,51,
Adair,U.S. Senate,Connie Johnson,DEM,10012,3,1,11,15,
Adair,U.S. House,Earl Everett,DEM,10012,4,0,46,50,02
Adair,U.S. House,Joshua Harris-Till,DEM,10012,2,1,37,40,02
Adair,Governor,Dax Ewbank,REP,10012,0,0,3,3,
Adair,Governor,Chad Moody,REP,10012,0,0,10,10,
Adair,Governor,Mary Fallin,REP,10012,0,1,64,65,
Adair,Superintendent of Public Instruction,Brian Kelly,REP,10012,0,0,25,25,
Adair,Superintendent of Public Instruction,Janet Costello Barresi,REP,10012,0,0,5,5,
Adair,Superintendent of Public Instruction,Joy Hofmeister,REP,10012,0,1,45,46,
Adair,Insurance Commissioner,Bill Viner,REP,10012,0,1,21,22,
Adair,Insurance Commissioner,John Doak,REP,10012,0,0,52,52,
Adair,Corporation Commissioner,Todd Hiett,REP,10012,0,1,38,39,
Adair,Corporation Commissioner,Cliff Branan,REP,10012,0,0,35,35,
Adair,U.S. Senate,Evelyn Rogers,REP,10012,0,0,2,2,
Adair,U.S. Senate,Rob Moye,REP,10012,0,0,2,2,
Adair,U.S. Senate,D. Jean Mcbride-Samuels,REP,10012,0,0,0,0,
Adair,U.S. Senate,Jim Inhofe,REP,10012,0,1,67,68,
Adair,U.S. Senate,Erick Paul Wyatt,REP,10012,0,0,3,3,
Adair,U.S. Senate,Andy Craig,REP,10012,0,0,0,0,
Adair,U.S. Senate,T. Shannon,REP,10012,0,1,39,40,
Adair,U.S. Senate,Randy Brogdon,REP,10012,0,0,2,2,
Adair,U.S. Senate,Eric Mccray,REP,10012,0,0,1,1,
Adair,U.S. Senate,Kevin Crow,REP,10012,0,0,1,1,
Adair,U.S. Senate,James Lankford,REP,10012,0,0,32,32,
Adair,U.S. Senate,Jason Weger,REP,10012,0,0,0,0,
Adair,U.S. House,Darrel Robertson,REP,10012,0,1,4,5,02
Adair,U.S. House,Markwayne Mullin,REP,10012,0,0,73,73,02
Adair,Superintendent of Public Instruction,John Cox,DEM,10013,3,8,82,93,
Adair,Superintendent of Public Instruction,Jack Jr.,DEM,10013,0,0,1,1,
Adair,Superintendent of Public Instruction,Ivan Holmes,DEM,10013,0,0,4,4,
Adair,Superintendent of Public Instruction,Freda Deskin,DEM,10013,0,0,14,14,
Adair,U.S. Senate,Patrick Michael Hayes,DEM,10013,0,3,16,19,
Adair,U.S. Senate,Jim Rogers,DEM,10013,3,3,60,66,
Adair,U.S. Senate,Connie Johnson,DEM,10013,0,2,21,23,
Adair,U.S. House,Earl Everett,DEM,10013,2,4,63,69,02
Adair,U.S. House,Joshua Harris-Till,DEM,10013,1,3,30,34,02
Adair,Governor,Dax Ewbank,REP,10013,0,0,4,4,
Adair,Governor,Chad Moody,REP,10013,0,1,5,6,
Adair,Governor,Mary Fallin,REP,10013,2,3,18,23,
Adair,Superintendent of Public Instruction,Brian Kelly,REP,10013,0,2,15,17,
Adair,Superintendent of Public Instruction,Janet Costello Barresi,REP,10013,0,0,2,2,
Adair,Superintendent of Public Instruction,Joy Hofmeister,REP,10013,2,2,10,14,
Adair,Insurance Commissioner,Bill Viner,REP,10013,0,3,10,13,
Adair,Insurance Commissioner,John Doak,REP,10013,2,1,15,18,
Adair,Corporation Commissioner,Todd Hiett,REP,10013,2,1,13,16,
Adair,Corporation Commissioner,Cliff Branan,REP,10013,0,3,14,17,
Adair,U.S. Senate,Evelyn Rogers,REP,10013,0,0,1,1,
Adair,U.S. Senate,Rob Moye,REP,10013,0,0,1,1,
Adair,U.S. Senate,D. Jean Mcbride-Samuels,REP,10013,0,0,0,0,
Adair,U.S. Senate,Jim Inhofe,REP,10013,2,4,25,31,
Adair,U.S. Senate,Erick Paul Wyatt,REP,10013,0,0,0,0,
Adair,U.S. Senate,Andy Craig,REP,10013,0,0,3,3,
Adair,U.S. Senate,T. Shannon,REP,10013,0,2,10,12,
Adair,U.S. Senate,Randy Brogdon,REP,10013,0,0,0,0,
Adair,U.S. Senate,Eric Mccray,REP,10013,0,0,0,0,
Adair,U.S. Senate,Kevin Crow,REP,10013,0,1,4,5,
Adair,U.S. Senate,James Lankford,REP,10013,2,1,10,13,
Adair,U.S. Senate,Jason Weger,REP,10013,0,0,0,0,
Adair,U.S. House,Darrel Robertson,REP,10013,0,0,4,4,02
Adair,U.S. House,Markwayne Mullin,REP,10013,2,4,23,29,02
Adair,Superintendent of Public Instruction,John Cox,DEM,10014,1,10,79,90,
Adair,Superintendent of Public Instruction,Jack Jr.,DEM,10014,0,0,12,12,
Adair,Superintendent of Public Instruction,Ivan Holmes,DEM,10014,0,1,2,3,
Adair,Superintendent of Public Instruction,Freda Deskin,DEM,10014,0,5,14,19,
Adair,U.S. Senate,Patrick Michael Hayes,DEM,10014,1,3,18,22,
Adair,U.S. Senate,Jim Rogers,DEM,10014,1,6,56,63,
Adair,U.S. Senate,Connie Johnson,DEM,10014,0,5,31,36,
Adair,U.S. House,Earl Everett,DEM,10014,1,8,64,73,02
Adair,U.S. House,Joshua Harris-Till,DEM,10014,0,5,33,38,02
Adair,Governor,Dax Ewbank,REP,10014,0,0,5,5,
Adair,Governor,Chad Moody,REP,10014,0,1,12,13,
Adair,Governor,Mary Fallin,REP,10014,0,0,40,40,
Adair,Superintendent of Public Instruction,Brian Kelly,REP,10014,0,1,13,14,
Adair,Superintendent of Public Instruction,Janet Costello Barresi,REP,10014,0,0,9,9,
Adair,Superintendent of Public Instruction,Joy Hofmeister,REP,10014,0,0,35,35,
Adair,Insurance Commissioner,Bill Viner,REP,10014,0,1,19,20,
Adair,Insurance Commissioner,John Doak,REP,10014,0,0,37,37,
Adair,Corporation Commissioner,Todd Hiett,REP,10014,0,0,31,31,
Adair,Corporation Commissioner,Cliff Branan,REP,10014,0,1,25,26,
Adair,U.S. Senate,Evelyn Rogers,REP,10014,0,1,2,3,
Adair,U.S. Senate,Rob Moye,REP,10014,0,0,1,1,
Adair,U.S. Senate,D. Jean Mcbride-Samuels,REP,10014,0,0,1,1,
Adair,U.S. Senate,Jim Inhofe,REP,10014,0,0,52,52,
Adair,U.S. Senate,Erick Paul Wyatt,REP,10014,0,0,1,1,
Adair,U.S. Senate,Andy Craig,REP,10014,0,0,0,0,
Adair,U.S. Senate,T. Shannon,REP,10014,0,1,29,30,
Adair,U.S. Senate,Randy Brogdon,REP,10014,0,0,1,1,
Adair,U.S. Senate,Eric Mccray,REP,10014,0,0,0,0,
Adair,U.S. Senate,Kevin Crow,REP,10014,0,0,0,0,
Adair,U.S. Senate,James Lankford,REP,10014,0,0,23,23,
Adair,U.S. Senate,Jason Weger,REP,10014,0,0,3,3,
Adair,U.S. House,Darrel Robertson,REP,10014,0,0,7,7,02
Adair,U.S. House,Markwayne Mullin,REP,10014,0,1,50,51,02
Adair,Superintendent of Public Instruction,John Cox,DEM,10016,0,0,24,24,
Adair,Superintendent of Public Instruction,Jack Jr.,DEM,10016,0,1,1,2,
Adair,Superintendent of Public Instruction,Ivan Holmes,DEM,10016,0,0,6,6,
Adair,Superintendent of Public Instruction,Freda Deskin,DEM,10016,0,0,16,16,
Adair,U.S. Senate,Patrick Michael Hayes,DEM,10016,0,0,7,7,
Adair,U.S. Senate,Jim Rogers,DEM,10016,0,1,21,22,
Adair,U.S. Senate,Connie Johnson,DEM,10016,0,0,17,17,
Adair,U.S. House,Earl Everett,DEM,10016,0,1,33,34,02
Adair,U.S. House,Joshua Harris-Till,DEM,10016,0,0,12,12,02
Adair,Governor,Dax Ewbank,REP,10016,0,0,4,4,
Adair,Governor,Chad Moody,REP,10016,0,0,2,2,
Adair,Governor,Mary Fallin,REP,10016,0,0,61,61,
Adair,Superintendent of Public Instruction,Brian Kelly,REP,10016,0,0,14,14,
Adair,Superintendent of Public Instruction,Janet Costello Barresi,REP,10016,0,0,15,15,
Adair,Superintendent of Public Instruction,Joy Hofmeister,REP,10016,0,0,39,39,
Adair,Insurance Commissioner,Bill Viner,REP,10016,0,0,11,11,
Adair,Insurance Commissioner,John Doak,REP,10016,0,0,50,50,
Adair,Corporation Commissioner,Todd Hiett,REP,10016,0,0,32,32,
Adair,Corporation Commissioner,Cliff Branan,REP,10016,0,0,31,31,
Adair,U.S. Senate,Evelyn Rogers,REP,10016,0,0,5,5,
Adair,U.S. Senate,Rob Moye,REP,10016,0,0,0,0,
Adair,U.S. Senate,D. Jean Mcbride-Samuels,REP,10016,0,0,0,0,
Adair,U.S. Senate,Jim Inhofe,REP,10016,0,0,60,60,
Adair,U.S. Senate,Erick Paul Wyatt,REP,10016,0,0,2,2,
Adair,U.S. Senate,Andy Craig,REP,10016,0,0,0,0,
Adair,U.S. Senate,T. Shannon,REP,10016,0,0,38,38,
Adair,U.S. Senate,Randy Brogdon,REP,10016,0,0,1,1,
Adair,U.S. Senate,Eric Mccray,REP,10016,0,0,0,0,
Adair,U.S. Senate,Kevin Crow,REP,10016,0,0,1,1,
Adair,U.S. Senate,James Lankford,REP,10016,0,0,30,30,
Adair,U.S. Senate,Jason Weger,REP,10016,0,0,0,0,
Adair,U.S. House,Darrel Robertson,REP,10016,0,0,1,1,02
Adair,U.S. House,Markwayne Mullin,REP,10016,0,0,68,68,02
Adair,Superintendent of Public Instruction,John Cox,DEM,10017,0,0,60,60,
Adair,Superintendent of Public Instruction,Jack Jr.,DEM,10017,0,1,10,11,
Adair,Superintendent of Public Instruction,Ivan Holmes,DEM,10017,0,0,6,6,
Adair,Superintendent of Public Instruction,Freda Deskin,DEM,10017,0,0,40,40,
Adair,U.S. Senate,Patrick Michael Hayes,DEM,10017,0,1,21,22,
Adair,U.S. Senate,Jim Rogers,DEM,10017,0,0,67,67,
Adair,U.S. Senate,Connie Johnson,DEM,10017,0,0,27,27,
Adair,U.S. House,Earl Everett,DEM,10017,0,0,91,91,02
Adair,U.S. House,Joshua Harris-Till,DEM,10017,0,0,21,21,02
Adair,Governor,Dax Ewbank,REP,10017,0,0,6,6,
Adair,Governor,Chad Moody,REP,10017,0,0,10,10,
Adair,Governor,Mary Fallin,REP,10017,0,0,69,69,
Adair,Superintendent of Public Instruction,Brian Kelly,REP,10017,0,0,28,28,
Adair,Superintendent of Public Instruction,Janet Costello Barresi,REP,10017,0,0,15,15,
Adair,Superintendent of Public Instruction,Joy Hofmeister,REP,10017,0,0,40,40,
Adair,Insurance Commissioner,Bill Viner,REP,10017,0,0,18,18,
Adair,Insurance Commissioner,John Doak,REP,10017,0,0,57,57,
Adair,Corporation Commissioner,Todd Hiett,REP,10017,0,0,34,34,
Adair,Corporation Commissioner,Cliff Branan,REP,10017,0,0,45,45,
Adair,U.S. Senate,Evelyn Rogers,REP,10017,0,0,0,0,
Adair,U.S. Senate,Rob Moye,REP,10017,0,0,2,2,
Adair,U.S. Senate,D. Jean Mcbride-Samuels,REP,10017,0,0,4,4,
Adair,U.S. Senate,Jim Inhofe,REP,10017,0,0,71,71,
Adair,U.S. Senate,Erick Paul Wyatt,REP,10017,0,0,9,9,
Adair,U.S. Senate,Andy Craig,REP,10017,0,0,4,4,
Adair,U.S. Senate,T. Shannon,REP,10017,0,0,39,39,
Adair,U.S. Senate,Randy Brogdon,REP,10017,0,0,0,0,
Adair,U.S. Senate,Eric Mccray,REP,10017,0,0,3,3,
Adair,U.S. Senate,Kevin Crow,REP,10017,0,0,3,3,
Adair,U.S. Senate,James Lankford,REP,10017,0,0,36,36,
Adair,U.S. Senate,Jason Weger,REP,10017,0,0,0,0,
Adair,U.S. House,Darrel Robertson,REP,10017,0,0,21,21,02
Adair,U.S. House,Markwayne Mullin,REP,10017,0,0,65,65,02
Adair,Superintendent of Public Instruction,John Cox,DEM,10018,0,1,103,104,
Adair,Superintendent of Public Instruction,Jack Jr.,DEM,10018,0,1,10,11,
Adair,Superintendent of Public Instruction,Ivan Holmes,DEM,10018,0,0,8,8,
Adair,Superintendent of Public Instruction,Freda Deskin,DEM,10018,1,0,24,25,
Adair,U.S. Senate,Patrick Michael Hayes,DEM,10018,0,0,24,24,
Adair,U.S. Senate,Jim Rogers,DEM,10018,0,1,85,86,
Adair,U.S. Senate,Connie Johnson,DEM,10018,1,0,28,29,
Adair,U.S. House,Earl Everett,DEM,10018,1,0,98,99,02
Adair,U.S. House,Joshua Harris-Till,DEM,10018,0,1,38,39,02
Adair,Governor,Dax Ewbank,REP,10018,0,0,7,7,
Adair,Governor,Chad Moody,REP,10018,0,1,17,18,
Adair,Governor,Mary Fallin,REP,10018,0,2,54,56,
Adair,Superintendent of Public Instruction,Brian Kelly,REP,10018,0,0,23,23,
Adair,Superintendent of Public Instruction,Janet Costello Barresi,REP,10018,0,0,6,6,
Adair,Superintendent of Public Instruction,Joy Hofmeister,REP,10018,0,3,49,52,
Adair,Insurance Commissioner,Bill Viner,REP,10018,0,1,18,19,
Adair,Insurance Commissioner,John Doak,REP,10018,0,2,54,56,
Adair,Corporation Commissioner,Todd Hiett,REP,10018,0,2,43,45,
Adair,Corporation Commissioner,Cliff Branan,REP,10018,0,1,30,31,
Adair,U.S. Senate,Evelyn Rogers,REP,10018,0,0,5,5,
Adair,U.S. Senate,Rob Moye,REP,10018,0,0,0,0,
Adair,U.S. Senate,D. Jean Mcbride-Samuels,REP,10018,0,0,0,0,
Adair,U.S. Senate,Jim Inhofe,REP,10018,0,3,71,74,
Adair,U.S. Senate,Erick Paul Wyatt,REP,10018,0,0,2,2,
Adair,U.S. Senate,Andy Craig,REP,10018,0,0,1,1,
Adair,U.S. Senate,T. Shannon,REP,10018,0,0,29,29,
Adair,U.S. Senate,Randy Brogdon,REP,10018,0,0,1,1,
Adair,U.S. Senate,Eric Mccray,REP,10018,0,0,4,4,
Adair,U.S. Senate,Kevin Crow,REP,10018,0,0,0,0,
Adair,U.S. Senate,James Lankford,REP,10018,0,3,40,43,
Adair,U.S. Senate,Jason Weger,REP,10018,0,0,1,1,
Adair,U.S. House,Darrel Robertson,REP,10018,0,0,5,5,02
Adair,U.S. House,Markwayne Mullin,REP,10018,0,3,74,77,02
Adair,Superintendent of Public Instruction,John Cox,DEM,10019,0,3,113,116,
Adair,Superintendent of Public Instruction,Jack Jr.,DEM,10019,0,0,23,23,
Adair,Superintendent of Public Instruction,Ivan Holmes,DEM,10019,0,0,6,6,
Adair,Superintendent of Public Instruction,Freda Deskin,DEM,10019,0,0,32,32,
Adair,U.S. Senate,Patrick Michael Hayes,DEM,10019,0,0,30,30,
Adair,U.S. Senate,Jim Rogers,DEM,10019,0,1,107,108,
Adair,U.S. Senate,Connie Johnson,DEM,10019,0,1,31,32,
Adair,U.S. House,Earl Everett,DEM,10019,0,1,101,102,02
Adair,U.S. House,Joshua Harris-Till,DEM,10019,0,0,64,64,02
Adair,Governor,Dax Ewbank,REP,10019,0,0,4,4,
Adair,Governor,Chad Moody,REP,10019,0,3,22,25,
Adair,Governor,Mary Fallin,REP,10019,0,4,100,104,
Adair,Superintendent of Public Instruction,Brian Kelly,REP,10019,0,0,31,31,
Adair,Superintendent of Public Instruction,Janet Costello Barresi,REP,10019,0,0,20,20,
Adair,Superintendent of Public Instruction,Joy Hofmeister,REP,10019,0,7,78,85,
Adair,Insurance Commissioner,Bill Viner,REP,10019,0,0,39,39,
Adair,Insurance Commissioner,John Doak,REP,10019,0,7,70,77,
Adair,Corporation Commissioner,Todd Hiett,REP,10019,0,4,67,71,
Adair,Corporation Commissioner,Cliff Branan,REP,10019,0,3,52,55,
Adair,U.S. Senate,Evelyn Rogers,REP,10019,0,1,3,4,
Adair,U.S. Senate,Rob Moye,REP,10019,0,0,0,0,
Adair,U.S. Senate,D. Jean Mcbride-Samuels,REP,10019,0,0,0,0,
Adair,U.S. Senate,Jim Inhofe,REP,10019,0,6,118,124,
Adair,U.S. Senate,Erick Paul Wyatt,REP,10019,0,0,8,8,
Adair,U.S. Senate,Andy Craig,REP,10019,0,0,3,3,
Adair,U.S. Senate,T. Shannon,REP,10019,0,3,64,67,
Adair,U.S. Senate,Randy Brogdon,REP,10019,0,0,5,5,
Adair,U.S. Senate,Eric Mccray,REP,10019,0,0,3,3,
Adair,U.S. Senate,Kevin Crow,REP,10019,0,0,5,5,
Adair,U.S. Senate,James Lankford,REP,10019,0,4,51,55,
Adair,U.S. Senate,Jason Weger,REP,10019,0,0,0,0,
Adair,U.S. House,Darrel Robertson,REP,10019,0,0,9,9,02
Adair,U.S. House,Markwayne Mullin,REP,10019,0,7,124,131,02
Alfalfa,Superintendent of Public Instruction,John Cox,DEM,20110,0,0,12,12,
Alfalfa,Superintendent of Public Instruction,Jack Jr.,DEM,20110,0,0,1,1,
Alfalfa,Superintendent of Public Instruction,Ivan Holmes,DEM,20110,0,0,3,3,
Alfalfa,Superintendent of Public Instruction,Freda Deskin,DEM,20110,0,0,16,16,
Alfalfa,U.S. Senate,Patrick Michael Hayes,DEM,20110,0,0,5,5,
Alfalfa,U.S. Senate,Jim Rogers,DEM,20110,0,0,15,15,
Alfalfa,U.S. Senate,Connie Johnson,DEM,20110,0,0,12,12,
Alfalfa,Governor,Dax Ewbank,REP,20110,0,0,12,12,
Alfalfa,Governor,Chad Moody,REP,20110,0,1,16,17,
Alfalfa,Governor,Mary Fallin,REP,20110,3,1,65,69,
Alfalfa,Superintendent of Public Instruction,Brian Kelly,REP,20110,0,1,16,17,
Alfalfa,Superintendent of Public Instruction,Janet Costello Barresi,REP,20110,0,0,3,3,
Alfalfa,Superintendent of Public Instruction,Joy Hofmeister,REP,20110,3,1,75,79,
Alfalfa,Insurance Commissioner,Bill Viner,REP,20110,1,0,22,23,
Alfalfa,Insurance Commissioner,John Doak,REP,20110,2,2,67,71,
Alfalfa,Corporation Commissioner,Todd Hiett,REP,20110,2,1,60,63,
Alfalfa,Corporation Commissioner,Cliff Branan,REP,20110,1,1,33,35,
Alfalfa,U.S. Senate,Evelyn Rogers,REP,20110,0,0,2,2,
Alfalfa,U.S. Senate,Rob Moye,REP,20110,0,0,3,3,
Alfalfa,U.S. Senate,D. Jean Mcbride-Samuels,REP,20110,0,0,0,0,
Alfalfa,U.S. Senate,Jim Inhofe,REP,20110,3,2,85,90,
Alfalfa,U.S. Senate,Erick Paul Wyatt,REP,20110,0,0,2,2,
Alfalfa,U.S. Senate,Andy Craig,REP,20110,0,0,1,1,
Alfalfa,U.S. Senate,T. Shannon,REP,20110,1,0,23,24,
Alfalfa,U.S. Senate,Randy Brogdon,REP,20110,0,0,3,3,
Alfalfa,U.S. Senate,Eric Mccray,REP,20110,0,0,1,1,
Alfalfa,U.S. Senate,Kevin Crow,REP,20110,0,0,0,0,
Alfalfa,U.S. Senate,James Lankford,REP,20110,2,1,65,68,
Alfalfa,U.S. Senate,Jason Weger,REP,20110,0,0,0,0,
Alfalfa,U.S. House,Timothy Ray Murray,REP,20110,0,0,5,5,03
Alfalfa,U.S. House,Robert Hubbard,REP,20110,0,0,5,5,03
Alfalfa,U.S. House,Frank Lucas,REP,20110,3,2,85,90,03
Alfalfa,Superintendent of Public Instruction,John Cox,DEM,20120,0,1,7,8,
Alfalfa,Superintendent of Public Instruction,Jack Jr.,DEM,20120,0,0,1,1,
Alfalfa,Superintendent of Public Instruction,Ivan Holmes,DEM,20120,0,0,0,0,
Alfalfa,Superintendent of Public Instruction,Freda Deskin,DEM,20120,0,0,6,6,
Alfalfa,U.S. Senate,Patrick Michael Hayes,DEM,20120,0,0,3,3,
Alfalfa,U.S. Senate,Jim Rogers,DEM,20120,0,1,7,8,
Alfalfa,U.S. Senate,Connie Johnson,DEM,20120,0,1,4,5,
Alfalfa,Governor,Dax Ewbank,REP,20120,0,0,11,11,
Alfalfa,Governor,Chad Moody,REP,20120,2,2,14,18,
Alfalfa,Governor,Mary Fallin,REP,20120,3,3,57,63,
Alfalfa,Superintendent of Public Instruction,Brian Kelly,REP,20120,3,5,26,34,
Alfalfa,Superintendent of Public Instruction,Janet Costello Barresi,REP,20120,0,0,7,7,
Alfalfa,Superintendent of Public Instruction,Joy Hofmeister,REP,20120,2,0,48,50,
Alfalfa,Insurance Commissioner,Bill Viner,REP,20120,1,3,17,21,
Alfalfa,Insurance Commissioner,John Doak,REP,20120,4,1,60,65,
Alfalfa,Corporation Commissioner,Todd Hiett,REP,20120,5,1,47,53,
Alfalfa,Corporation Commissioner,Cliff Branan,REP,20120,0,3,32,35,
Alfalfa,U.S. Senate,Evelyn Rogers,REP,20120,0,0,4,4,
Alfalfa,U.S. Senate,Rob Moye,REP,20120,0,0,0,0,
Alfalfa,U.S. Senate,D. Jean Mcbride-Samuels,REP,20120,0,0,0,0,
Alfalfa,U.S. Senate,Jim Inhofe,REP,20120,5,5,69,79,
Alfalfa,U.S. Senate,Erick Paul Wyatt,REP,20120,0,0,9,9,
Alfalfa,U.S. Senate,Andy Craig,REP,20120,0,0,1,1,
Alfalfa,U.S. Senate,T. Shannon,REP,20120,0,1,33,34,
Alfalfa,U.S. Senate,Randy Brogdon,REP,20120,0,0,2,2,
Alfalfa,U.S. Senate,Eric Mccray,REP,20120,0,0,2,2,
Alfalfa,U.S. Senate,Kevin Crow,REP,20120,0,0,0,0,
Alfalfa,U.S. Senate,James Lankford,REP,20120,5,4,43,52,
Alfalfa,U.S. Senate,Jason Weger,REP,20120,0,0,1,1,
Alfalfa,U.S. House,Timothy Ray Murray,REP,20120,0,1,6,7,03
Alfalfa,U.S. House,Robert Hubbard,REP,20120,0,0,4,4,03
Alfalfa,U.S. House,Frank Lucas,REP,20120,5,4,71,80,03
Alfalfa,Superintendent of Public Instruction,John Cox,DEM,20140,1,1,24,26,
Alfalfa,Superintendent of Public Instruction,Jack Jr.,DEM,20140,0,0,3,3,
Alfalfa,Superintendent of Public Instruction,Ivan Holmes,DEM,20140,0,0,6,6,
Alfalfa,Superintendent of Public Instruction,Freda Deskin,DEM,20140,0,2,17,19,
Alfalfa,U.S. Senate,Patrick Michael Hayes,DEM,20140,1,1,13,15,
Alfalfa,U.S. Senate,Jim Rogers,DEM,20140,0,1,19,20,
Alfalfa,U.S. Senate,Connie Johnson,DEM,20140,0,1,18,19,
Alfalfa,Governor,Dax Ewbank,REP,20140,0,1,25,26,
Alfalfa,Governor,Chad Moody,REP,20140,1,3,35,39,
Alfalfa,Governor,Mary Fallin,REP,20140,1,14,77,92,
Alfalfa,Superintendent of Public Instruction,Brian Kelly,REP,20140,1,5,28,34,
Alfalfa,Superintendent of Public Instruction,Janet Costello Barresi,REP,20140,0,4,14,18,
Alfalfa,Superintendent of Public Instruction,Joy Hofmeister,REP,20140,0,10,97,107,
Alfalfa,Insurance Commissioner,Bill Viner,REP,20140,0,2,17,19,
Alfalfa,Insurance Commissioner,John Doak,REP,20140,2,17,120,139,
Alfalfa,Corporation Commissioner,Todd Hiett,REP,20140,1,10,72,83,
Alfalfa,Corporation Commissioner,Cliff Branan,REP,20140,0,9,64,73,
Alfalfa,U.S. Senate,Evelyn Rogers,REP,20140,0,0,4,4,
Alfalfa,U.S. Senate,Rob Moye,REP,20140,0,0,0,0,
Alfalfa,U.S. Senate,D. Jean Mcbride-Samuels,REP,20140,0,0,4,4,
Alfalfa,U.S. Senate,Jim Inhofe,REP,20140,2,18,122,142,
Alfalfa,U.S. Senate,Erick Paul Wyatt,REP,20140,0,1,10,11,
Alfalfa,U.S. Senate,Andy Craig,REP,20140,0,0,0,0,
Alfalfa,U.S. Senate,T. Shannon,REP,20140,0,6,56,62,
Alfalfa,U.S. Senate,Randy Brogdon,REP,20140,0,0,6,6,
Alfalfa,U.S. Senate,Eric Mccray,REP,20140,0,0,1,1,
Alfalfa,U.S. Senate,Kevin Crow,REP,20140,0,0,4,4,
Alfalfa,U.S. Senate,James Lankford,REP,20140,2,13,72,87,
Alfalfa,U.S. Senate,Jason Weger,REP,20140,0,0,1,1,
Alfalfa,U.S. House,Timothy Ray Murray,REP,20140,0,1,11,12,03
Alfalfa,U.S. House,Robert Hubbard,REP,20140,0,2,9,11,03
Alfalfa,U.S. House,Frank Lucas,REP,20140,2,16,120,138,03
Alfalfa,Superintendent of Public Instruction,John Cox,DEM,20220,0,4,19,23,
Alfalfa,Superintendent of Public Instruction,Jack Jr.,DEM,20220,0,2,9,11,
Alfalfa,Superintendent of Public Instruction,Ivan Holmes,DEM,20220,0,1,7,8,
Alfalfa,Superintendent of Public Instruction,Freda Deskin,DEM,20220,3,1,19,23,
Alfalfa,U.S. Senate,Patrick Michael Hayes,DEM,20220,0,3,13,16,
Alfalfa,U.S. Senate,Jim Rogers,DEM,20220,2,2,17,21,
Alfalfa,U.S. Senate,Connie Johnson,DEM,20220,1,2,25,28,
Alfalfa,Governor,Dax Ewbank,REP,20220,0,4,23,27,
Alfalfa,Governor,Chad Moody,REP,20220,0,2,33,35,
Alfalfa,Governor,Mary Fallin,REP,20220,2,17,93,112,
Alfalfa,Superintendent of Public Instruction,Brian Kelly,REP,20220,1,6,40,47,
Alfalfa,Superintendent of Public Instruction,Janet Costello Barresi,REP,20220,0,4,16,20,
Alfalfa,Superintendent of Public Instruction,Joy Hofmeister,REP,20220,1,14,96,111,
Alfalfa,Insurance Commissioner,Bill Viner,REP,20220,1,2,28,31,
Alfalfa,Insurance Commissioner,John Doak,REP,20220,1,21,116,138,
Alfalfa,Corporation Commissioner,Todd Hiett,REP,20220,2,15,94,111,
Alfalfa,Corporation Commissioner,Cliff Branan,REP,20220,0,7,50,57,
Alfalfa,U.S. Senate,Evelyn Rogers,REP,20220,0,0,3,3,
Alfalfa,U.S. Senate,Rob Moye,REP,20220,0,0,0,0,
Alfalfa,U.S. Senate,D. Jean Mcbride-Samuels,REP,20220,0,0,3,3,
Alfalfa,U.S. Senate,Jim Inhofe,REP,20220,1,24,137,162,
Alfalfa,U.S. Senate,Erick Paul Wyatt,REP,20220,1,0,5,6,
Alfalfa,U.S. Senate,Andy Craig,REP,20220,0,0,4,4,
Alfalfa,U.S. Senate,T. Shannon,REP,20220,0,9,58,67,
Alfalfa,U.S. Senate,Randy Brogdon,REP,20220,0,0,5,5,
Alfalfa,U.S. Senate,Eric Mccray,REP,20220,0,1,3,4,
Alfalfa,U.S. Senate,Kevin Crow,REP,20220,0,0,2,2,
Alfalfa,U.S. Senate,James Lankford,REP,20220,2,14,78,94,
Alfalfa,U.S. Senate,Jason Weger,REP,20220,0,0,1,1,
Alfalfa,U.S. House,Timothy Ray Murray,REP,20220,1,1,11,13,03
Alfalfa,U.S. House,Robert Hubbard,REP,20220,0,0,5,5,03
Alfalfa,U.S. House,Frank Lucas,REP,20220,1,23,136,160,03
Alfalfa,Superintendent of Public Instruction,John Cox,DEM,20230,0,0,22,22,
Alfalfa,Superintendent of Public Instruction,Jack Jr.,DEM,20230,0,0,0,0,
Alfalfa,Superintendent of Public Instruction,Ivan Holmes,DEM,20230,0,0,5,5,
Alfalfa,Superintendent of Public Instruction,Freda Deskin,DEM,20230,0,0,12,12,
Alfalfa,U.S. Senate,Patrick Michael Hayes,DEM,20230,0,0,11,11,
Alfalfa,U.S. Senate,Jim Rogers,DEM,20230,0,0,14,14,
Alfalfa,U.S. Senate,Connie Johnson,DEM,20230,0,0,13,13,
Alfalfa,Governor,Dax Ewbank,REP,20230,1,0,35,36,
Alfalfa,Governor,Chad Moody,REP,20230,0,0,14,14,
Alfalfa,Governor,Mary Fallin,REP,20230,1,2,86,89,
Alfalfa,Superintendent of Public Instruction,Brian Kelly,REP,20230,1,0,27,28,
Alfalfa,Superintendent of Public Instruction,Janet Costello Barresi,REP,20230,0,0,16,16,
Alfalfa,Superintendent of Public Instruction,Joy Hofmeister,REP,20230,1,2,90,93,
Alfalfa,Insurance Commissioner,Bill Viner,REP,20230,1,0,32,33,
Alfalfa,Insurance Commissioner,John Doak,REP,20230,0,2,99,101,
Alfalfa,Corporation Commissioner,Todd Hiett,REP,20230,0,2,77,79,
Alfalfa,Corporation Commissioner,Cliff Branan,REP,20230,2,0,51,53,
Alfalfa,U.S. Senate,Evelyn Rogers,REP,20230,0,0,5,5,
Alfalfa,U.S. Senate,Rob Moye,REP,20230,0,0,4,4,
Alfalfa,U.S. Senate,D. Jean Mcbride-Samuels,REP,20230,1,0,1,2,
Alfalfa,U.S. Senate,Jim Inhofe,REP,20230,1,2,114,117,
Alfalfa,U.S. Senate,Erick Paul Wyatt,REP,20230,0,0,9,9,
Alfalfa,U.S. Senate,Andy Craig,REP,20230,0,0,1,1,
Alfalfa,U.S. Senate,T. Shannon,REP,20230,1,0,56,57,
Alfalfa,U.S. Senate,Randy Brogdon,REP,20230,0,0,1,1,
Alfalfa,U.S. Senate,Eric Mccray,REP,20230,0,0,0,0,
Alfalfa,U.S. Senate,Kevin Crow,REP,20230,0,0,0,0,
Alfalfa,U.S. Senate,James Lankford,REP,20230,1,1,75,77,
Alfalfa,U.S. Senate,Jason Weger,REP,20230,0,1,2,3,
Alfalfa,U.S. House,Timothy Ray Murray,REP,20230,1,0,1,2,03
Alfalfa,U.S. House,Robert Hubbard,REP,20230,0,0,13,13,03
Alfalfa,U.S. House,Frank Lucas,REP,20230,1,2,119,122,03
Alfalfa,Superintendent of Public Instruction,John Cox,DEM,20310,0,1,21,22,
Alfalfa,Superintendent of Public Instruction,Jack Jr.,DEM,20310,0,0,5,5,
Alfalfa,Superintendent of Public Instruction,Ivan Holmes,DEM,20310,0,0,6,6,
Alfalfa,Superintendent of Public Instruction,Freda Deskin,DEM,20310,0,0,12,12,
Alfalfa,U.S. Senate,Patrick Michael Hayes,DEM,20310,0,0,15,15,
Alfalfa,U.S. Senate,Jim Rogers,DEM,20310,0,1,17,18,
Alfalfa,U.S. Senate,Connie Johnson,DEM,20310,0,0,10,10,
Alfalfa,Governor,Dax Ewbank,REP,20310,0,4,25,29,
Alfalfa,Governor,Chad Moody,REP,20310,0,1,15,16,
Alfalfa,Governor,Mary Fallin,REP,20310,1,5,77,83,
Alfalfa,Superintendent of Public Instruction,Brian Kelly,REP,20310,0,1,41,42,
Alfalfa,Superintendent of Public Instruction,Janet Costello Barresi,REP,20310,1,1,9,11,
Alfalfa,Superintendent of Public Instruction,Joy Hofmeister,REP,20310,0,8,64,72,
Alfalfa,Insurance Commissioner,Bill Viner,REP,20310,0,3,21,24,
Alfalfa,Insurance Commissioner,John Doak,REP,20310,1,7,90,98,
Alfalfa,Corporation Commissioner,Todd Hiett,REP,20310,1,7,49,57,
Alfalfa,Corporation Commissioner,Cliff Branan,REP,20310,0,3,64,67,
Alfalfa,U.S. Senate,Evelyn Rogers,REP,20310,0,1,4,5,
Alfalfa,U.S. Senate,Rob Moye,REP,20310,0,1,1,2,
Alfalfa,U.S. Senate,D. Jean Mcbride-Samuels,REP,20310,0,0,0,0,
Alfalfa,U.S. Senate,Jim Inhofe,REP,20310,1,8,107,116,
Alfalfa,U.S. Senate,Erick Paul Wyatt,REP,20310,0,0,4,4,
Alfalfa,U.S. Senate,Andy Craig,REP,20310,0,0,1,1,
Alfalfa,U.S. Senate,T. Shannon,REP,20310,0,5,45,50,
Alfalfa,U.S. Senate,Randy Brogdon,REP,20310,0,0,0,0,
Alfalfa,U.S. Senate,Eric Mccray,REP,20310,0,0,0,0,
Alfalfa,U.S. Senate,Kevin Crow,REP,20310,0,0,3,3,
Alfalfa,U.S. Senate,James Lankford,REP,20310,1,5,65,71,
Alfalfa,U.S. Senate,Jason Weger,REP,20310,0,0,1,1,
Alfalfa,U.S. House,Timothy Ray Murray,REP,20310,0,1,6,7,03
Alfalfa,U.S. House,Robert Hubbard,REP,20310,0,1,13,14,03
Alfalfa,U.S. House,Frank Lucas,REP,20310,1,8,97,106,03
Alfalfa,Superintendent of Public Instruction,John Cox,DEM,20330,0,0,8,8,
Alfalfa,Superintendent of Public Instruction,Jack Jr.,DEM,20330,0,0,5,5,
Alfalfa,Superintendent of Public Instruction,Ivan Holmes,DEM,20330,0,1,2,3,
Alfalfa,Superintendent of Public Instruction,Freda Deskin,DEM,20330,4,0,18,22,
Alfalfa,U.S. Senate,Patrick Michael Hayes,DEM,20330,1,0,12,13,
Alfalfa,U.S. Senate,Jim Rogers,DEM,20330,2,1,11,14,
Alfalfa,U.S. Senate,Connie Johnson,DEM,20330,1,0,10,11,
Alfalfa,Governor,Dax Ewbank,REP,20330,1,0,12,13,
Alfalfa,Governor,Chad Moody,REP,20330,2,1,14,17,
Alfalfa,Governor,Mary Fallin,REP,20330,12,5,81,98,
Alfalfa,Superintendent of Public Instruction,Brian Kelly,REP,20330,1,1,18,20,
Alfalfa,Superintendent of Public Instruction,Janet Costello Barresi,REP,20330,3,2,8,13,
Alfalfa,Superintendent of Public Instruction,Joy Hofmeister,REP,20330,12,3,84,99,
Alfalfa,Insurance Commissioner,Bill Viner,REP,20330,3,1,25,29,
Alfalfa,Insurance Commissioner,John Doak,REP,20330,13,5,79,97,
Alfalfa,Corporation Commissioner,Todd Hiett,REP,20330,10,4,53,67,
Alfalfa,Corporation Commissioner,Cliff Branan,REP,20330,6,1,55,62,
Alfalfa,U.S. Senate,Evelyn Rogers,REP,20330,0,0,5,5,
Alfalfa,U.S. Senate,Rob Moye,REP,20330,0,0,3,3,
Alfalfa,U.S. Senate,D. Jean Mcbride-Samuels,REP,20330,0,0,0,0,
Alfalfa,U.S. Senate,Jim Inhofe,REP,20330,16,6,98,120,
Alfalfa,U.S. Senate,Erick Paul Wyatt,REP,20330,0,0,5,5,
Alfalfa,U.S. Senate,Andy Craig,REP,20330,0,0,0,0,
Alfalfa,U.S. Senate,T. Shannon,REP,20330,6,3,40,49,
Alfalfa,U.S. Senate,Randy Brogdon,REP,20330,0,0,1,1,
Alfalfa,U.S. Senate,Eric Mccray,REP,20330,0,0,1,1,
Alfalfa,U.S. Senate,Kevin Crow,REP,20330,0,0,1,1,
Alfalfa,U.S. Senate,James Lankford,REP,20330,10,3,65,78,
Alfalfa,U.S. Senate,Jason Weger,REP,20330,0,0,1,1,
Alfalfa,U.S. House,Timothy Ray Murray,REP,20330,0,0,5,5,03
Alfalfa,U.S. House,Robert Hubbard,REP,20330,4,1,9,14,03
Alfalfa,U.S. House,Frank Lucas,REP,20330,12,5,97,114,03
Atoka,Superintendent of Public Instruction,John Cox,DEM,30001,0,21,87,108,
Atoka,Superintendent of Public Instruction,Jack Jr.,DEM,30001,1,5,25,31,
Atoka,Superintendent of Public Instruction,Ivan Holmes,DEM,30001,0,3,4,7,
Atoka,Superintendent of Public Instruction,Freda Deskin,DEM,30001,0,11,48,59,
Atoka,U.S. Senate,Patrick Michael Hayes,DEM,30001,1,10,38,49,
Atoka,U.S. Senate,Jim Rogers,DEM,30001,0,16,84,100,
Atoka,U.S. Senate,Connie Johnson,DEM,30001,0,10,31,41,
Atoka,U.S. House,Earl Everett,DEM,30001,1,21,97,119,02
Atoka,U.S. House,Joshua Harris-Till,DEM,30001,0,15,53,68,02
Atoka,Governor,Dax Ewbank,REP,30001,0,1,5,6,
Atoka,Governor,Chad Moody,REP,30001,0,0,12,12,
Atoka,Governor,Mary Fallin,REP,30001,0,4,27,31,
Atoka,Superintendent of Public Instruction,Brian Kelly,REP,30001,0,4,16,20,
Atoka,Superintendent of Public Instruction,Janet Costello Barresi,REP,30001,0,0,7,7,
Atoka,Superintendent of Public Instruction,Joy Hofmeister,REP,30001,0,1,18,19,
Atoka,Insurance Commissioner,Bill Viner,REP,30001,0,0,8,8,
Atoka,Insurance Commissioner,John Doak,REP,30001,0,5,29,34,
Atoka,Corporation Commissioner,Todd Hiett,REP,30001,0,3,14,17,
Atoka,Corporation Commissioner,Cliff Branan,REP,30001,0,2,23,25,
Atoka,U.S. Senate,Evelyn Rogers,REP,30001,0,0,2,2,
Atoka,U.S. Senate,Rob Moye,REP,30001,0,0,0,0,
Atoka,U.S. Senate,D. Jean Mcbride-Samuels,REP,30001,0,0,0,0,
Atoka,U.S. Senate,Jim Inhofe,REP,30001,0,4,31,35,
Atoka,U.S. Senate,Erick Paul Wyatt,REP,30001,0,1,7,8,
Atoka,U.S. Senate,Andy Craig,REP,30001,0,0,2,2,
Atoka,U.S. Senate,T. Shannon,REP,30001,0,3,12,15,
Atoka,U.S. Senate,Randy Brogdon,REP,30001,0,0,0,0,
Atoka,U.S. Senate,Eric Mccray,REP,30001,0,0,1,1,
Atoka,U.S. Senate,Kevin Crow,REP,30001,0,0,3,3,
Atoka,U.S. Senate,James Lankford,REP,30001,0,2,21,23,
Atoka,U.S. Senate,Jason Weger,REP,30001,0,0,1,1,
Atoka,U.S. House,Darrel Robertson,REP,30001,0,1,9,10,02
Atoka,U.S. House,Markwayne Mullin,REP,30001,0,5,35,40,02
Atoka,Superintendent of Public Instruction,John Cox,DEM,30002,2,16,62,80,
Atoka,Superintendent of Public Instruction,Jack Jr.,DEM,30002,0,4,4,8,
Atoka,Superintendent of Public Instruction,Ivan Holmes,DEM,30002,1,2,7,10,
Atoka,Superintendent of Public Instruction,Freda Deskin,DEM,30002,1,6,26,33,
Atoka,U.S. Senate,Patrick Michael Hayes,DEM,30002,1,6,24,31,
Atoka,U.S. Senate,Jim Rogers,DEM,30002,0,14,47,61,
Atoka,U.S. Senate,Connie Johnson,DEM,30002,1,6,18,25,
Atoka,U.S. House,Earl Everett,DEM,30002,2,12,40,54,02
Atoka,U.S. House,Joshua Harris-Till,DEM,30002,0,14,43,57,02
Atoka,Governor,Dax Ewbank,REP,30002,0,0,1,1,
Atoka,Governor,Chad Moody,REP,30002,1,2,12,15,
Atoka,Governor,Mary Fallin,REP,30002,2,10,33,45,
Atoka,Superintendent of Public Instruction,Brian Kelly,REP,30002,1,3,14,18,
Atoka,Superintendent of Public Instruction,Janet Costello Barresi,REP,30002,0,3,9,12,
Atoka,Superintendent of Public Instruction,Joy Hofmeister,REP,30002,1,5,23,29,
Atoka,Insurance Commissioner,Bill Viner,REP,30002,1,1,6,8,
Atoka,Insurance Commissioner,John Doak,REP,30002,1,6,38,45,
Atoka,Corporation Commissioner,Todd Hiett,REP,30002,2,6,26,34,
Atoka,Corporation Commissioner,Cliff Branan,REP,30002,0,2,18,20,
Atoka,U.S. Senate,Evelyn Rogers,REP,30002,0,1,3,4,
Atoka,U.S. Senate,Rob Moye,REP,30002,0,0,1,1,
Atoka,U.S. Senate,D. Jean Mcbride-Samuels,REP,30002,0,0,0,0,
Atoka,U.S. Senate,Jim Inhofe,REP,30002,3,11,38,52,
Atoka,U.S. Senate,Erick Paul Wyatt,REP,30002,0,0,3,3,
Atoka,U.S. Senate,Andy Craig,REP,30002,0,0,1,1,
Atoka,U.S. Senate,T. Shannon,REP,30002,1,7,19,27,
Atoka,U.S. Senate,Randy Brogdon,REP,30002,0,0,0,0,
Atoka,U.S. Senate,Eric Mccray,REP,30002,0,0,2,2,
Atoka,U.S. Senate,Kevin Crow,REP,30002,0,2,0,2,
Atoka,U.S. Senate,James Lankford,REP,30002,2,3,23,28,
Atoka,U.S. Senate,Jason Weger,REP,30002,0,0,2,2,
Atoka,U.S. House,Darrel Robertson,REP,30002,0,2,6,8,02
Atoka,U.S. House,Markwayne Mullin,REP,30002,3,9,41,53,02
Atoka,Superintendent of Public Instruction,John Cox,DEM,30003,2,15,51,68,
Atoka,Superintendent of Public Instruction,Jack Jr.,DEM,30003,0,4,6,10,
Atoka,Superintendent of Public Instruction,Ivan Holmes,DEM,30003,0,3,8,11,
Atoka,Superintendent of Public Instruction,Freda Deskin,DEM,30003,0,3,19,22,
Atoka,U.S. Senate,Patrick Michael Hayes,DEM,30003,0,6,26,32,
Atoka,U.S. Senate,Jim Rogers,DEM,30003,0,14,40,54,
Atoka,U.S. Senate,Connie Johnson,DEM,30003,2,4,17,23,
Atoka,U.S. House,Earl Everett,DEM,30003,2,18,37,57,02
Atoka,U.S. House,Joshua Harris-Till,DEM,30003,0,7,40,47,02
Atoka,Governor,Dax Ewbank,REP,30003,0,0,2,2,
Atoka,Governor,Chad Moody,REP,30003,0,1,4,5,
Atoka,Governor,Mary Fallin,REP,30003,0,7,24,31,
Atoka,Superintendent of Public Instruction,Brian Kelly,REP,30003,0,4,12,16,
Atoka,Superintendent of Public Instruction,Janet Costello Barresi,REP,30003,0,2,8,10,
Atoka,Superintendent of Public Instruction,Joy Hofmeister,REP,30003,0,2,11,13,
Atoka,Insurance Commissioner,Bill Viner,REP,30003,0,0,5,5,
Atoka,Insurance Commissioner,John Doak,REP,30003,0,8,23,31,
Atoka,Corporation Commissioner,Todd Hiett,REP,30003,0,4,10,14,
Atoka,Corporation Commissioner,Cliff Branan,REP,30003,0,3,17,20,
Atoka,U.S. Senate,Evelyn Rogers,REP,30003,0,1,0,1,
Atoka,U.S. Senate,Rob Moye,REP,30003,0,0,1,1,
Atoka,U.S. Senate,D. Jean Mcbride-Samuels,REP,30003,0,0,0,0,
Atoka,U.S. Senate,Jim Inhofe,REP,30003,0,7,25,32,
Atoka,U.S. Senate,Erick Paul Wyatt,REP,30003,0,0,4,4,
Atoka,U.S. Senate,Andy Craig,REP,30003,0,0,0,0,
Atoka,U.S. Senate,T. Shannon,REP,30003,0,2,14,16,
Atoka,U.S. Senate,Randy Brogdon,REP,30003,0,0,0,0,
Atoka,U.S. Senate,Eric Mccray,REP,30003,0,0,3,3,
Atoka,U.S. Senate,Kevin Crow,REP,30003,0,0,1,1,
Atoka,U.S. Senate,James Lankford,REP,30003,0,5,10,15,
Atoka,U.S. Senate,Jason Weger,REP,30003,0,1,2,3,
Atoka,U.S. House,Darrel Robertson,REP,30003,0,1,3,4,02
Atoka,U.S. House,Markwayne Mullin,REP,30003,0,7,27,34,02
Atoka,Superintendent of Public Instruction,John Cox,DEM,30006,3,20,42,65,
Atoka,Superintendent of Public Instruction,Jack Jr.,DEM,30006,0,4,6,10,
Atoka,Superintendent of Public Instruction,Ivan Holmes,DEM,30006,0,1,4,5,
Atoka,Superintendent of Public Instruction,Freda Deskin,DEM,30006,0,0,14,14,
Atoka,U.S. Senate,Patrick Michael Hayes,DEM,30006,0,5,13,18,
Atoka,U.S. Senate,Jim Rogers,DEM,30006,0,13,30,43,
Atoka,U.S. Senate,Connie Johnson,DEM,30006,3,5,16,24,
Atoka,U.S. House,Earl Everett,DEM,30006,3,16,29,48,02
Atoka,U.S. House,Joshua Harris-Till,DEM,30006,0,7,28,35,02
Atoka,Governor,Dax Ewbank,REP,30006,0,0,1,1,
Atoka,Governor,Chad Moody,REP,30006,0,4,2,6,
Atoka,Governor,Mary Fallin,REP,30006,0,4,12,16,
Atoka,Superintendent of Public Instruction,Brian Kelly,REP,30006,0,3,7,10,
Atoka,Superintendent of Public Instruction,Janet Costello Barresi,REP,30006,0,0,3,3,
Atoka,Superintendent of Public Instruction,Joy Hofmeister,REP,30006,0,5,4,9,
Atoka,Insurance Commissioner,Bill Viner,REP,30006,0,1,3,4,
Atoka,Insurance Commissioner,John Doak,REP,30006,0,7,12,19,
Atoka,Corporation Commissioner,Todd Hiett,REP,30006,0,3,8,11,
Atoka,Corporation Commissioner,Cliff Branan,REP,30006,0,5,6,11,
Atoka,U.S. Senate,Evelyn Rogers,REP,30006,0,1,0,1,
Atoka,U.S. Senate,Rob Moye,REP,30006,0,0,0,0,
Atoka,U.S. Senate,D. Jean Mcbride-Samuels,REP,30006,0,0,0,0,
Atoka,U.S. Senate,Jim Inhofe,REP,30006,0,7,14,21,
Atoka,U.S. Senate,Erick Paul Wyatt,REP,30006,0,0,1,1,
Atoka,U.S. Senate,Andy Craig,REP,30006,0,0,2,2,
Atoka,U.S. Senate,T. Shannon,REP,30006,0,4,8,12,
Atoka,U.S. Senate,Randy Brogdon,REP,30006,0,0,1,1,
Atoka,U.S. Senate,Eric Mccray,REP,30006,0,0,0,0,
Atoka,U.S. Senate,Kevin Crow,REP,30006,0,0,0,0,
Atoka,U.S. Senate,James Lankford,REP,30006,0,4,3,7,
Atoka,U.S. Senate,Jason Weger,REP,30006,0,0,1,1,
Atoka,U.S. House,Darrel Robertson,REP,30006,0,0,3,3,02
Atoka,U.S. House,Markwayne Mullin,REP,30006,0,8,12,20,02
Atoka,Superintendent of Public Instruction,John Cox,DEM,30007,0,15,81,96,
Atoka,Superintendent of Public Instruction,Jack Jr.,DEM,30007,0,3,18,21,
Atoka,Superintendent of Public Instruction,Ivan Holmes,DEM,30007,0,1,13,14,
Atoka,Superintendent of Public Instruction,Freda Deskin,DEM,30007,0,2,49,51,
Atoka,U.S. Senate,Patrick Michael Hayes,DEM,30007,0,9,42,51,
Atoka,U.S. Senate,Jim Rogers,DEM,30007,0,8,68,76,
Atoka,U.S. Senate,Connie Johnson,DEM,30007,0,4,37,41,
Atoka,U.S. House,Earl Everett,DEM,30007,0,15,85,100,02
Atoka,U.S. House,Joshua Harris-Till,DEM,30007,0,5,60,65,02
Atoka,Governor,Dax Ewbank,REP,30007,0,1,3,4,
Atoka,Governor,Chad Moody,REP,30007,0,1,1,2,
Atoka,Governor,Mary Fallin,REP,30007,0,10,31,41,
Atoka,Superintendent of Public Instruction,Brian Kelly,REP,30007,0,3,11,14,
Atoka,Superintendent of Public Instruction,Janet Costello Barresi,REP,30007,0,3,6,9,
Atoka,Superintendent of Public Instruction,Joy Hofmeister,REP,30007,0,4,18,22,
Atoka,Insurance Commissioner,Bill Viner,REP,30007,0,1,8,9,
Atoka,Insurance Commissioner,John Doak,REP,30007,0,9,26,35,
Atoka,Corporation Commissioner,Todd Hiett,REP,30007,0,6,12,18,
Atoka,Corporation Commissioner,Cliff Branan,REP,30007,0,3,20,23,
Atoka,U.S. Senate,Evelyn Rogers,REP,30007,0,1,4,5,
Atoka,U.S. Senate,Rob Moye,REP,30007,0,0,1,1,
Atoka,U.S. Senate,D. Jean Mcbride-Samuels,REP,30007,0,0,3,3,
Atoka,U.S. Senate,Jim Inhofe,REP,30007,0,11,22,33,
Atoka,U.S. Senate,Erick Paul Wyatt,REP,30007,0,0,4,4,
Atoka,U.S. Senate,Andy Craig,REP,30007,0,0,0,0,
Atoka,U.S. Senate,T. Shannon,REP,30007,0,4,12,16,
Atoka,U.S. Senate,Randy Brogdon,REP,30007,0,0,1,1,
Atoka,U.S. Senate,Eric Mccray,REP,30007,0,0,2,2,
Atoka,U.S. Senate,Kevin Crow,REP,30007,0,1,0,1,
Atoka,U.S. Senate,James Lankford,REP,30007,0,7,16,23,
Atoka,U.S. Senate,Jason Weger,REP,30007,0,0,1,1,
Atoka,U.S. House,Darrel Robertson,REP,30007,0,3,4,7,02
Atoka,U.S. House,Markwayne Mullin,REP,30007,0,8,30,38,02
Atoka,Superintendent of Public Instruction,John Cox,DEM,30008,1,6,158,165,
Atoka,Superintendent of Public Instruction,Jack Jr.,DEM,30008,1,0,37,38,
Atoka,Superintendent of Public Instruction,Ivan Holmes,DEM,30008,2,0,19,21,
Atoka,Superintendent of Public Instruction,Freda Deskin,DEM,30008,4,1,71,76,
Atoka,U.S. Senate,Patrick Michael Hayes,DEM,30008,1,0,78,79,
Atoka,U.S. Senate,Jim Rogers,DEM,30008,3,7,144,154,
Atoka,U.S. Senate,Connie Johnson,DEM,30008,4,0,49,53,
Atoka,U.S. House,Earl Everett,DEM,30008,2,2,177,181,02
Atoka,U.S. House,Joshua Harris-Till,DEM,30008,5,4,76,85,02
Atoka,Governor,Dax Ewbank,REP,30008,0,0,2,2,
Atoka,Governor,Chad Moody,REP,30008,0,0,10,10,
Atoka,Governor,Mary Fallin,REP,30008,1,1,32,34,
Atoka,Superintendent of Public Instruction,Brian Kelly,REP,30008,0,1,20,21,
Atoka,Superintendent of Public Instruction,Janet Costello Barresi,REP,30008,0,0,9,9,
Atoka,Superintendent of Public Instruction,Joy Hofmeister,REP,30008,1,0,11,12,
Atoka,Insurance Commissioner,Bill Viner,REP,30008,0,0,6,6,
Atoka,Insurance Commissioner,John Doak,REP,30008,1,1,35,37,
Atoka,Corporation Commissioner,Todd Hiett,REP,30008,0,0,18,18,
Atoka,Corporation Commissioner,Cliff Branan,REP,30008,1,0,20,21,
Atoka,U.S. Senate,Evelyn Rogers,REP,30008,0,0,4,4,
Atoka,U.S. Senate,Rob Moye,REP,30008,0,0,2,2,
Atoka,U.S. Senate,D. Jean Mcbride-Samuels,REP,30008,0,0,3,3,
Atoka,U.S. Senate,Jim Inhofe,REP,30008,1,1,32,34,
Atoka,U.S. Senate,Erick Paul Wyatt,REP,30008,0,0,3,3,
Atoka,U.S. Senate,Andy Craig,REP,30008,0,0,3,3,
Atoka,U.S. Senate,T. Shannon,REP,30008,1,1,18,20,
Atoka,U.S. Senate,Randy Brogdon,REP,30008,0,0,2,2,
Atoka,U.S. Senate,Eric Mccray,REP,30008,0,0,2,2,
Atoka,U.S. Senate,Kevin Crow,REP,30008,0,0,5,5,
Atoka,U.S. Senate,James Lankford,REP,30008,0,0,11,11,
Atoka,U.S. Senate,Jason Weger,REP,30008,0,0,1,1,
Atoka,U.S. House,Darrel Robertson,REP,30008,0,0,8,8,02
Atoka,U.S. House,Markwayne Mullin,REP,30008,1,1,35,37,02
Atoka,Superintendent of Public Instruction,John Cox,DEM,30009,1,27,89,117,
Atoka,Superintendent of Public Instruction,Jack Jr.,DEM,30009,0,0,11,11,
Atoka,Superintendent of Public Instruction,Ivan Holmes,DEM,30009,0,1,7,8,
Atoka,Superintendent of Public Instruction,Freda Deskin,DEM,30009,1,4,25,30,
Atoka,U.S. Senate,Patrick Michael Hayes,DEM,30009,2,10,30,42,
Atoka,U.S. Senate,Jim Rogers,DEM,30009,0,11,67,78,
Atoka,U.S. Senate,Connie Johnson,DEM,30009,0,7,24,31,
Atoka,U.S. House,Earl Everett,DEM,30009,1,14,62,77,02
Atoka,U.S. House,Joshua Harris-Till,DEM,30009,1,15,56,72,02
Atoka,Governor,Dax Ewbank,REP,30009,0,0,6,6,
Atoka,Governor,Chad Moody,REP,30009,0,2,1,3,
Atoka,Governor,Mary Fallin,REP,30009,1,2,24,27,
Atoka,Superintendent of Public Instruction,Brian Kelly,REP,30009,0,2,10,12,
Atoka,Superintendent of Public Instruction,Janet Costello Barresi,REP,30009,0,0,3,3,
Atoka,Superintendent of Public Instruction,Joy Hofmeister,REP,30009,0,2,15,17,
Atoka,Insurance Commissioner,Bill Viner,REP,30009,0,2,6,8,
Atoka,Insurance Commissioner,John Doak,REP,30009,1,2,18,21,
Atoka,Corporation Commissioner,Todd Hiett,REP,30009,0,1,14,15,
Atoka,Corporation Commissioner,Cliff Branan,REP,30009,0,2,9,11,
Atoka,U.S. Senate,Evelyn Rogers,REP,30009,0,1,2,3,
Atoka,U.S. Senate,Rob Moye,REP,30009,0,0,1,1,
Atoka,U.S. Senate,D. Jean Mcbride-Samuels,REP,30009,0,0,0,0,
Atoka,U.S. Senate,Jim Inhofe,REP,30009,1,3,23,27,
Atoka,U.S. Senate,Erick Paul Wyatt,REP,30009,0,0,2,2,
Atoka,U.S. Senate,Andy Craig,REP,30009,0,0,0,0,
Atoka,U.S. Senate,T. Shannon,REP,30009,1,2,13,16,
Atoka,U.S. Senate,Randy Brogdon,REP,30009,0,1,0,1,
Atoka,U.S. Senate,Eric Mccray,REP,30009,0,0,5,5,
Atoka,U.S. Senate,Kevin Crow,REP,30009,0,0,0,0,
Atoka,U.S. Senate,James Lankford,REP,30009,0,0,11,11,
Atoka,U.S. Senate,Jason Weger,REP,30009,0,0,1,1,
Atoka,U.S. House,Darrel Robertson,REP,30009,0,1,4,5,02
Atoka,U.S. House,Markwayne Mullin,REP,30009,1,1,26,28,02
Atoka,Superintendent of Public Instruction,John Cox,DEM,30010,1,0,23,24,
Atoka,Superintendent of Public Instruction,Jack Jr.,DEM,30010,0,0,1,1,
Atoka,Superintendent of Public Instruction,Ivan Holmes,DEM,30010,0,0,1,1,
Atoka,Superintendent of Public Instruction,Freda Deskin,DEM,30010,0,0,14,14,
Atoka,U.S. Senate,Patrick Michael Hayes,DEM,30010,0,0,16,16,
Atoka,U.S. Senate,Jim Rogers,DEM,30010,0,0,14,14,
Atoka,U.S. Senate,Connie Johnson,DEM,30010,1,0,7,8,
Atoka,U.S. House,Earl Everett,DEM,30010,1,0,21,22,02
Atoka,U.S. House,Joshua Harris-Till,DEM,30010,0,0,16,16,02
Atoka,Governor,Dax Ewbank,REP,30010,0,0,0,0,
Atoka,Governor,Chad Moody,REP,30010,0,0,5,5,
Atoka,Governor,Mary Fallin,REP,30010,0,0,10,10,
Atoka,Superintendent of Public Instruction,Brian Kelly,REP,30010,0,0,2,2,
Atoka,Superintendent of Public Instruction,Janet Costello Barresi,REP,30010,0,0,0,0,
Atoka,Superintendent of Public Instruction,Joy Hofmeister,REP,30010,0,0,12,12,
Atoka,Insurance Commissioner,Bill Viner,REP,30010,0,0,4,4,
Atoka,Insurance Commissioner,John Doak,REP,30010,0,0,6,6,
Atoka,Corporation Commissioner,Todd Hiett,REP,30010,0,0,7,7,
Atoka,Corporation Commissioner,Cliff Branan,REP,30010,0,0,1,1,
Atoka,U.S. Senate,Evelyn Rogers,REP,30010,0,0,1,1,
Atoka,U.S. Senate,Rob Moye,REP,30010,0,0,0,0,
Atoka,U.S. Senate,D. Jean Mcbride-Samuels,REP,30010,0,0,0,0,
Atoka,U.S. Senate,Jim Inhofe,REP,30010,0,0,13,13,
Atoka,U.S. Senate,Erick Paul Wyatt,REP,30010,0,0,0,0,
Atoka,U.S. Senate,Andy Craig,REP,30010,0,0,0,0,
Atoka,U.S. Senate,T. Shannon,REP,30010,0,0,2,2,
Atoka,U.S. Senate,Randy Brogdon,REP,30010,0,0,0,0,
Atoka,U.S. Senate,Eric Mccray,REP,30010,0,0,2,2,
Atoka,U.S. Senate,Kevin Crow,REP,30010,0,0,0,0,
Atoka,U.S. Senate,James Lankford,REP,30010,0,0,11,11,
Atoka,U.S. Senate,Jason Weger,REP,30010,0,0,0,0,
Atoka,U.S. House,Darrel Robertson,REP,30010,0,0,2,2,02
Atoka,U.S. House,Markwayne Mullin,REP,30010,0,0,12,12,02
Atoka,State Senate,Joseph Silk,REP,30010,0,0,3,3,5
Atoka,State Senate,Brent Shain,REP,30010,0,0,6,6,5
Atoka,Superintendent of Public Instruction,John Cox,DEM,30011,0,53,163,216,
Atoka,Superintendent of Public Instruction,Jack Jr.,DEM,30011,1,11,22,34,
Atoka,Superintendent of Public Instruction,Ivan Holmes,DEM,30011,0,11,8,19,
Atoka,Superintendent of Public Instruction,Freda Deskin,DEM,30011,0,6,62,68,
Atoka,U.S. Senate,Patrick Michael Hayes,DEM,30011,0,17,54,71,
Atoka,U.S. Senate,Jim Rogers,DEM,30011,1,43,112,156,
Atoka,U.S. Senate,Connie Johnson,DEM,30011,0,13,63,76,
Atoka,U.S. House,Earl Everett,DEM,30011,1,42,152,195,02
Atoka,U.S. House,Joshua Harris-Till,DEM,30011,0,27,70,97,02
Atoka,Governor,Dax Ewbank,REP,30011,0,1,3,4,
Atoka,Governor,Chad Moody,REP,30011,0,3,13,16,
Atoka,Governor,Mary Fallin,REP,30011,0,9,58,67,
Atoka,Superintendent of Public Instruction,Brian Kelly,REP,30011,0,7,22,29,
Atoka,Superintendent of Public Instruction,Janet Costello Barresi,REP,30011,0,2,15,17,
Atoka,Superintendent of Public Instruction,Joy Hofmeister,REP,30011,0,4,29,33,
Atoka,Insurance Commissioner,Bill Viner,REP,30011,0,6,17,23,
Atoka,Insurance Commissioner,John Doak,REP,30011,0,6,46,52,
Atoka,Corporation Commissioner,Todd Hiett,REP,30011,0,9,33,42,
Atoka,Corporation Commissioner,Cliff Branan,REP,30011,0,3,29,32,
Atoka,U.S. Senate,Evelyn Rogers,REP,30011,0,1,4,5,
Atoka,U.S. Senate,Rob Moye,REP,30011,0,0,1,1,
Atoka,U.S. Senate,D. Jean Mcbride-Samuels,REP,30011,0,0,1,1,
Atoka,U.S. Senate,Jim Inhofe,REP,30011,0,9,62,71,
Atoka,U.S. Senate,Erick Paul Wyatt,REP,30011,0,3,3,6,
Atoka,U.S. Senate,Andy Craig,REP,30011,0,0,2,2,
Atoka,U.S. Senate,T. Shannon,REP,30011,0,12,30,42,
Atoka,U.S. Senate,Randy Brogdon,REP,30011,0,0,0,0,
Atoka,U.S. Senate,Eric Mccray,REP,30011,0,1,1,2,
Atoka,U.S. Senate,Kevin Crow,REP,30011,0,0,3,3,
Atoka,U.S. Senate,James Lankford,REP,30011,0,0,34,34,
Atoka,U.S. Senate,Jason Weger,REP,30011,0,0,0,0,
Atoka,U.S. House,Darrel Robertson,REP,30011,0,0,8,8,02
Atoka,U.S. House,Markwayne Mullin,REP,30011,0,14,64,78,02
Atoka,Superintendent of Public Instruction,John Cox,DEM,30012,0,2,53,55,
Atoka,Superintendent of Public Instruction,Jack Jr.,DEM,30012,0,0,8,8,
Atoka,Superintendent of Public Instruction,Ivan Holmes,DEM,30012,0,1,3,4,
Atoka,Superintendent of Public Instruction,Freda Deskin,DEM,30012,0,1,26,27,
Atoka,U.S. Senate,Patrick Michael Hayes,DEM,30012,0,2,22,24,
Atoka,U.S. Senate,Jim Rogers,DEM,30012,0,1,36,37,
Atoka,U.S. Senate,Connie Johnson,DEM,30012,0,1,24,25,
Atoka,U.S. House,Earl Everett,DEM,30012,0,1,40,41,02
Atoka,U.S. House,Joshua Harris-Till,DEM,30012,0,3,42,45,02
Atoka,Governor,Dax Ewbank,REP,30012,0,0,2,2,
Atoka,Governor,Chad Moody,REP,30012,0,0,8,8,
Atoka,Governor,Mary Fallin,REP,30012,0,0,17,17,
Atoka,Superintendent of Public Instruction,Brian Kelly,REP,30012,0,0,6,6,
Atoka,Superintendent of Public Instruction,Janet Costello Barresi,REP,30012,0,0,7,7,
Atoka,Superintendent of Public Instruction,Joy Hofmeister,REP,30012,0,0,10,10,
Atoka,Insurance Commissioner,Bill Viner,REP,30012,0,0,5,5,
Atoka,Insurance Commissioner,John Doak,REP,30012,0,0,18,18,
Atoka,Corporation Commissioner,Todd Hiett,REP,30012,0,0,11,11,
Atoka,Corporation Commissioner,Cliff Branan,REP,30012,0,0,9,9,
Atoka,U.S. Senate,Evelyn Rogers,REP,30012,0,0,0,0,
Atoka,U.S. Senate,Rob Moye,REP,30012,0,0,0,0,
Atoka,U.S. Senate,D. Jean Mcbride-Samuels,REP,30012,0,0,1,1,
Atoka,U.S. Senate,Jim Inhofe,REP,30012,0,0,25,25,
Atoka,U.S. Senate,Erick Paul Wyatt,REP,30012,0,0,0,0,
Atoka,U.S. Senate,Andy Craig,REP,30012,0,0,0,0,
Atoka,U.S. Senate,T. Shannon,REP,30012,0,0,13,13,
Atoka,U.S. Senate,Randy Brogdon,REP,30012,0,0,3,3,
Atoka,U.S. Senate,Eric Mccray,REP,30012,0,0,1,1,
Atoka,U.S. Senate,Kevin Crow,REP,30012,0,0,0,0,
Atoka,U.S. Senate,James Lankford,REP,30012,0,0,9,9,
Atoka,U.S. Senate,Jason Weger,REP,30012,0,0,0,0,
Atoka,U.S. House,Darrel Robertson,REP,30012,0,0,2,2,02
Atoka,U.S. House,Markwayne Mullin,REP,30012,0,0,22,22,02
Atoka,State Senate,Joseph Silk,REP,30012,0,0,10,10,5
Atoka,State Senate,Brent Shain,REP,30012,0,0,9,9,5
Atoka,Superintendent of Public Instruction,John Cox,DEM,30013,0,3,56,59,
Atoka,Superintendent of Public Instruction,Jack Jr.,DEM,30013,0,0,7,7,
Atoka,Superintendent of Public Instruction,Ivan Holmes,DEM,30013,0,1,4,5,
Atoka,Superintendent of Public Instruction,Freda Deskin,DEM,30013,0,1,20,21,
Atoka,U.S. Senate,Patrick Michael Hayes,DEM,30013,0,1,20,21,
Atoka,U.S. Senate,Jim Rogers,DEM,30013,0,1,38,39,
Atoka,U.S. Senate,Connie Johnson,DEM,30013,0,2,22,24,
Atoka,U.S. House,Earl Everett,DEM,30013,0,3,40,43,02
Atoka,U.S. House,Joshua Harris-Till,DEM,30013,0,1,37,38,02
Atoka,Governor,Dax Ewbank,REP,30013,0,0,6,6,
Atoka,Governor,Chad Moody,REP,30013,0,1,10,11,
Atoka,Governor,Mary Fallin,REP,30013,2,0,20,22,
Atoka,Superintendent of Public Instruction,Brian Kelly,REP,30013,1,0,12,13,
Atoka,Superintendent of Public Instruction,Janet Costello Barresi,REP,30013,0,0,3,3,
Atoka,Superintendent of Public Instruction,Joy Hofmeister,REP,30013,1,1,25,27,
Atoka,Insurance Commissioner,Bill Viner,REP,30013,0,0,10,10,
Atoka,Insurance Commissioner,John Doak,REP,30013,2,1,23,26,
Atoka,Corporation Commissioner,Todd Hiett,REP,30013,2,0,20,22,
Atoka,Corporation Commissioner,Cliff Branan,REP,30013,0,1,14,15,
Atoka,U.S. Senate,Evelyn Rogers,REP,30013,0,0,3,3,
Atoka,U.S. Senate,Rob Moye,REP,30013,0,0,3,3,
Atoka,U.S. Senate,D. Jean Mcbride-Samuels,REP,30013,0,0,0,0,
Atoka,U.S. Senate,Jim Inhofe,REP,30013,2,0,25,27,
Atoka,U.S. Senate,Erick Paul Wyatt,REP,30013,0,1,5,6,
Atoka,U.S. Senate,Andy Craig,REP,30013,0,0,2,2,
Atoka,U.S. Senate,T. Shannon,REP,30013,2,1,24,27,
Atoka,U.S. Senate,Randy Brogdon,REP,30013,0,0,0,0,
Atoka,U.S. Senate,Eric Mccray,REP,30013,0,0,0,0,
Atoka,U.S. Senate,Kevin Crow,REP,30013,0,0,0,0,
Atoka,U.S. Senate,James Lankford,REP,30013,0,0,7,7,
Atoka,U.S. Senate,Jason Weger,REP,30013,0,0,0,0,
Atoka,U.S. House,Darrel Robertson,REP,30013,0,0,13,13,02
Atoka,U.S. House,Markwayne Mullin,REP,30013,2,1,23,26,02
Atoka,State Senate,Joseph Silk,REP,30013,2,0,21,23,5
Atoka,State Senate,Brent Shain,REP,30013,0,1,14,15,5
Atoka,Superintendent of Public Instruction,John Cox,DEM,30014,0,0,35,35,
Atoka,Superintendent of Public Instruction,Jack Jr.,DEM,30014,0,0,1,1,
Atoka,Superintendent of Public Instruction,Ivan Holmes,DEM,30014,0,0,0,0,
Atoka,Superintendent of Public Instruction,Freda Deskin,DEM,30014,0,0,11,11,
Atoka,U.S. Senate,Patrick Michael Hayes,DEM,30014,0,0,13,13,
Atoka,U.S. Senate,Jim Rogers,DEM,30014,0,0,21,21,
Atoka,U.S. Senate,Connie Johnson,DEM,30014,0,0,11,11,
Atoka,U.S. House,Earl Everett,DEM,30014,0,0,29,29,02
Atoka,U.S. House,Joshua Harris-Till,DEM,30014,0,0,16,16,02
Atoka,Governor,Dax Ewbank,REP,30014,0,0,3,3,
Atoka,Governor,Chad Moody,REP,30014,0,0,1,1,
Atoka,Governor,Mary Fallin,REP,30014,0,0,11,11,
Atoka,Superintendent of Public Instruction,Brian Kelly,REP,30014,0,0,8,8,
Atoka,Superintendent of Public Instruction,Janet Costello Barresi,REP,30014,0,0,0,0,
Atoka,Superintendent of Public Instruction,Joy Hofmeister,REP,30014,0,0,7,7,
Atoka,Insurance Commissioner,Bill Viner,REP,30014,0,0,2,2,
Atoka,Insurance Commissioner,John Doak,REP,30014,0,0,11,11,
Atoka,Corporation Commissioner,Todd Hiett,REP,30014,0,0,5,5,
Atoka,Corporation Commissioner,Cliff Branan,REP,30014,0,0,6,6,
Atoka,U.S. Senate,Evelyn Rogers,REP,30014,0,0,2,2,
Atoka,U.S. Senate,Rob Moye,REP,30014,0,0,1,1,
Atoka,U.S. Senate,D. Jean Mcbride-Samuels,REP,30014,0,0,0,0,
Atoka,U.S. Senate,Jim Inhofe,REP,30014,0,0,14,14,
Atoka,U.S. Senate,Erick Paul Wyatt,REP,30014,0,0,0,0,
Atoka,U.S. Senate,Andy Craig,REP,30014,0,0,1,1,
Atoka,U.S. Senate,T. Shannon,REP,30014,0,0,6,6,
Atoka,U.S. Senate,Randy Brogdon,REP,30014,0,0,0,0,
Atoka,U.S. Senate,Eric Mccray,REP,30014,0,0,0,0,
Atoka,U.S. Senate,Kevin Crow,REP,30014,0,0,1,1,
Atoka,U.S. Senate,James Lankford,REP,30014,0,0,7,7,
Atoka,U.S. Senate,Jason Weger,REP,30014,0,0,1,1,
Atoka,U.S. House,Darrel Robertson,REP,30014,0,0,6,6,02
Atoka,U.S. House,Markwayne Mullin,REP,30014,0,0,10,10,02
Atoka,State Senate,Joseph Silk,REP,30014,0,0,4,4,5
Atoka,State Senate,Brent Shain,REP,30014,0,0,8,8,5
Atoka,Superintendent of Public Instruction,John Cox,DEM,30015,0,0,11,11,
Atoka,Superintendent of Public Instruction,Jack Jr.,DEM,30015,0,0,0,0,
Atoka,Superintendent of Public Instruction,Ivan Holmes,DEM,30015,0,1,0,1,
Atoka,Superintendent of Public Instruction,Freda Deskin,DEM,30015,0,0,7,7,
Atoka,U.S. Senate,Patrick Michael Hayes,DEM,30015,0,0,2,2,
Atoka,U.S. Senate,Jim Rogers,DEM,30015,0,0,12,12,
Atoka,U.S. Senate,Connie Johnson,DEM,30015,0,1,2,3,
Atoka,U.S. House,Earl Everett,DEM,30015,0,0,11,11,02
Atoka,U.S. House,Joshua Harris-Till,DEM,30015,0,0,5,5,02
Atoka,Governor,Dax Ewbank,REP,30015,0,0,2,2,
Atoka,Governor,Chad Moody,REP,30015,0,0,3,3,
Atoka,Governor,Mary Fallin,REP,30015,0,0,7,7,
Atoka,Superintendent of Public Instruction,Brian Kelly,REP,30015,0,0,3,3,
Atoka,Superintendent of Public Instruction,Janet Costello Barresi,REP,30015,0,0,1,1,
Atoka,Superintendent of Public Instruction,Joy Hofmeister,REP,30015,0,0,8,8,
Atoka,Insurance Commissioner,Bill Viner,REP,30015,0,0,5,5,
Atoka,Insurance Commissioner,John Doak,REP,30015,0,0,7,7,
Atoka,Corporation Commissioner,Todd Hiett,REP,30015,0,0,9,9,
Atoka,Corporation Commissioner,Cliff Branan,REP,30015,0,0,3,3,
Atoka,U.S. Senate,Evelyn Rogers,REP,30015,0,0,0,0,
Atoka,U.S. Senate,Rob Moye,REP,30015,0,0,1,1,
Atoka,U.S. Senate,D. Jean Mcbride-Samuels,REP,30015,0,0,0,0,
Atoka,U.S. Senate,Jim Inhofe,REP,30015,0,0,9,9,
Atoka,U.S. Senate,Erick Paul Wyatt,REP,30015,0,0,2,2,
Atoka,U.S. Senate,Andy Craig,REP,30015,0,0,0,0,
Atoka,U.S. Senate,T. Shannon,REP,30015,0,0,2,2,
Atoka,U.S. Senate,Randy Brogdon,REP,30015,0,0,2,2,
Atoka,U.S. Senate,Eric Mccray,REP,30015,0,0,0,0,
Atoka,U.S. Senate,Kevin Crow,REP,30015,0,0,0,0,
Atoka,U.S. Senate,James Lankford,REP,30015,0,0,8,8,
Atoka,U.S. Senate,Jason Weger,REP,30015,0,0,0,0,
Atoka,U.S. House,Darrel Robertson,REP,30015,0,0,1,1,02
Atoka,U.S. House,Markwayne Mullin,REP,30015,0,0,12,12,02
Atoka,State Senate,Joseph Silk,REP,30015,0,0,10,10,5
Atoka,State Senate,Brent Shain,REP,30015,0,0,1,1,5
Atoka,Superintendent of Public Instruction,John Cox,DEM,30016,0,0,0,0,
Atoka,Superintendent of Public Instruction,Jack Jr.,DEM,30016,0,0,0,0,
Atoka,Superintendent of Public Instruction,Ivan Holmes,DEM,30016,0,0,0,0,
Atoka,Superintendent of Public Instruction,Freda Deskin,DEM,30016,0,0,0,0,
Atoka,U.S. Senate,Patrick Michael Hayes,DEM,30016,0,0,0,0,
Atoka,U.S. Senate,Jim Rogers,DEM,30016,0,0,0,0,
Atoka,U.S. Senate,Connie Johnson,DEM,30016,0,0,0,0,
Atoka,U.S. House,Earl Everett,DEM,30016,0,0,0,0,02
Atoka,U.S. House,Joshua Harris-Till,DEM,30016,0,0,0,0,02
Atoka,Governor,Dax Ewbank,REP,30016,0,0,0,0,
Atoka,Governor,Chad Moody,REP,30016,0,0,0,0,
Atoka,Governor,Mary Fallin,REP,30016,0,0,0,0,
Atoka,Superintendent of Public Instruction,Brian Kelly,REP,30016,0,0,0,0,
Atoka,Superintendent of Public Instruction,Janet Costello Barresi,REP,30016,0,0,0,0,
Atoka,Superintendent of Public Instruction,Joy Hofmeister,REP,30016,0,0,0,0,
Atoka,Insurance Commissioner,Bill Viner,REP,30016,0,0,0,0,
Atoka,Insurance Commissioner,John Doak,REP,30016,0,0,0,0,
Atoka,Corporation Commissioner,Todd Hiett,REP,30016,0,0,0,0,
Atoka,Corporation Commissioner,Cliff Branan,REP,30016,0,0,0,0,
Atoka,U.S. Senate,Evelyn Rogers,REP,30016,0,0,0,0,
Atoka,U.S. Senate,Rob Moye,REP,30016,0,0,0,0,
Atoka,U.S. Senate,D. Jean Mcbride-Samuels,REP,30016,0,0,0,0,
Atoka,U.S. Senate,Jim Inhofe,REP,30016,0,0,0,0,
Atoka,U.S. Senate,Erick Paul Wyatt,REP,30016,0,0,0,0,
Atoka,U.S. Senate,Andy Craig,REP,30016,0,0,0,0,
Atoka,U.S. Senate,T. Shannon,REP,30016,0,0,0,0,
Atoka,U.S. Senate,Randy Brogdon,REP,30016,0,0,0,0,
Atoka,U.S. Senate,Eric Mccray,REP,30016,0,0,0,0,
Atoka,U.S. Senate,Kevin Crow,REP,30016,0,0,0,0,
Atoka,U.S. Senate,James Lankford,REP,30016,0,0,0,0,
Atoka,U.S. Senate,Jason Weger,REP,30016,0,0,0,0,
Atoka,U.S. House,Darrel Robertson,REP,30016,0,0,0,0,02
Atoka,U.S. House,Markwayne Mullin,REP,30016,0,0,0,0,02
Atoka,Superintendent of Public Instruction,John Cox,DEM,30017,0,0,0,0,
Atoka,Superintendent of Public Instruction,Jack Jr.,DEM,30017,0,0,0,0,
Atoka,Superintendent of Public Instruction,Ivan Holmes,DEM,30017,0,0,0,0,
Atoka,Superintendent of Public Instruction,Freda Deskin,DEM,30017,0,0,0,0,
Atoka,U.S. Senate,Patrick Michael Hayes,DEM,30017,0,0,0,0,
Atoka,U.S. Senate,Jim Rogers,DEM,30017,0,0,0,0,
Atoka,U.S. Senate,Connie Johnson,DEM,30017,0,0,0,0,
Atoka,U.S. House,Earl Everett,DEM,30017,0,0,0,0,02
Atoka,U.S. House,Joshua Harris-Till,DEM,30017,0,0,0,0,02
Atoka,Governor,Dax Ewbank,REP,30017,0,0,0,0,
Atoka,Governor,Chad Moody,REP,30017,0,0,0,0,
Atoka,Governor,Mary Fallin,REP,30017,0,0,0,0,
Atoka,Superintendent of Public Instruction,Brian Kelly,REP,30017,0,0,0,0,
Atoka,Superintendent of Public Instruction,Janet Costello Barresi,REP,30017,0,0,0,0,
Atoka,Superintendent of Public Instruction,Joy Hofmeister,REP,30017,0,0,0,0,
Atoka,Insurance Commissioner,Bill Viner,REP,30017,0,0,0,0,
Atoka,Insurance Commissioner,John Doak,REP,30017,0,0,0,0,
Atoka,Corporation Commissioner,Todd Hiett,REP,30017,0,0,0,0,
Atoka,Corporation Commissioner,Cliff Branan,REP,30017,0,0,0,0,
Atoka,U.S. Senate,Evelyn Rogers,REP,30017,0,0,0,0,
Atoka,U.S. Senate,Rob Moye,REP,30017,0,0,0,0,
Atoka,U.S. Senate,D. Jean Mcbride-Samuels,REP,30017,0,0,0,0,
Atoka,U.S. Senate,Jim Inhofe,REP,30017,0,0,0,0,
Atoka,U.S. Senate,Erick Paul Wyatt,REP,30017,0,0,0,0,
Atoka,U.S. Senate,Andy Craig,REP,30017,0,0,0,0,
Atoka,U.S. Senate,T. Shannon,REP,30017,0,0,0,0,
Atoka,U.S. Senate,Randy Brogdon,REP,30017,0,0,0,0,
Atoka,U.S. Senate,Eric Mccray,REP,30017,0,0,0,0,
Atoka,U.S. Senate,Kevin Crow,REP,30017,0,0,0,0,
Atoka,U.S. Senate,James Lankford,REP,30017,0,0,0,0,
Atoka,U.S. Senate,Jason Weger,REP,30017,0,0,0,0,
Atoka,U.S. House,Darrel Robertson,REP,30017,0,0,0,0,02
Atoka,U.S. House,Markwayne Mullin,REP,30017,0,0,0,0,02
Atoka,Superintendent of Public Instruction,John Cox,DEM,30018,0,0,0,0,
Atoka,Superintendent of Public Instruction,Jack Jr.,DEM,30018,0,0,0,0,
Atoka,Superintendent of Public Instruction,Ivan Holmes,DEM,30018,0,0,0,0,
Atoka,Superintendent of Public Instruction,Freda Deskin,DEM,30018,0,0,0,0,
Atoka,U.S. Senate,Patrick Michael Hayes,DEM,30018,0,0,0,0,
Atoka,U.S. Senate,Jim Rogers,DEM,30018,0,0,0,0,
Atoka,U.S. Senate,Connie Johnson,DEM,30018,0,0,0,0,
Atoka,U.S. House,Earl Everett,DEM,30018,0,0,0,0,02
Atoka,U.S. House,Joshua Harris-Till,DEM,30018,0,0,0,0,02
Atoka,Governor,Dax Ewbank,REP,30018,0,0,0,0,
Atoka,Governor,Chad Moody,REP,30018,0,0,0,0,
Atoka,Governor,Mary Fallin,REP,30018,0,0,0,0,
Atoka,Superintendent of Public Instruction,Brian Kelly,REP,30018,0,0,0,0,
Atoka,Superintendent of Public Instruction,Janet Costello Barresi,REP,30018,0,0,0,0,
Atoka,Superintendent of Public Instruction,Joy Hofmeister,REP,30018,0,0,0,0,
Atoka,Insurance Commissioner,Bill Viner,REP,30018,0,0,0,0,
Atoka,Insurance Commissioner,John Doak,REP,30018,0,0,0,0,
Atoka,Corporation Commissioner,Todd Hiett,REP,30018,0,0,0,0,
Atoka,Corporation Commissioner,Cliff Branan,REP,30018,0,0,0,0,
Atoka,U.S. Senate,Evelyn Rogers,REP,30018,0,0,0,0,
Atoka,U.S. Senate,Rob Moye,REP,30018,0,0,0,0,
Atoka,U.S. Senate,D. Jean Mcbride-Samuels,REP,30018,0,0,0,0,
Atoka,U.S. Senate,Jim Inhofe,REP,30018,0,0,0,0,
Atoka,U.S. Senate,Erick Paul Wyatt,REP,30018,0,0,0,0,
Atoka,U.S. Senate,Andy Craig,REP,30018,0,0,0,0,
Atoka,U.S. Senate,T. Shannon,REP,30018,0,0,0,0,
Atoka,U.S. Senate,Randy Brogdon,REP,30018,0,0,0,0,
Atoka,U.S. Senate,Eric Mccray,REP,30018,0,0,0,0,
Atoka,U.S. Senate,Kevin Crow,REP,30018,0,0,0,0,
Atoka,U.S. Senate,James Lankford,REP,30018,0,0,0,0,
Atoka,U.S. Senate,Jason Weger,REP,30018,0,0,0,0,
Atoka,U.S. House,Darrel Robertson,REP,30018,0,0,0,0,02
Atoka,U.S. House,Markwayne Mullin,REP,30018,0,0,0,0,02
Atoka,State Senate,Joseph Silk,REP,30018,0,0,0,0,5
Atoka,State Senate,Brent Shain,REP,30018,0,0,0,0,5
Atoka,Superintendent of Public Instruction,John Cox,DEM,30019,0,0,8,8,
Atoka,Superintendent of Public Instruction,Jack Jr.,DEM,30019,0,0,1,1,
Atoka,Superintendent of Public Instruction,Ivan Holmes,DEM,30019,0,0,0,0,
Atoka,Superintendent of Public Instruction,Freda Deskin,DEM,30019,0,0,1,1,
Atoka,U.S. Senate,Patrick Michael Hayes,DEM,30019,0,0,2,2,
Atoka,U.S. Senate,Jim Rogers,DEM,30019,0,0,6,6,
Atoka,U.S. Senate,Connie Johnson,DEM,30019,0,0,2,2,
Atoka,U.S. House,Earl Everett,DEM,30019,0,0,3,3,02
Atoka,U.S. House,Joshua Harris-Till,DEM,30019,0,0,6,6,02
Atoka,Governor,Dax Ewbank,REP,30019,0,0,0,0,
Atoka,Governor,Chad Moody,REP,30019,0,0,0,0,
Atoka,Governor,Mary Fallin,REP,30019,0,0,5,5,
Atoka,Superintendent of Public Instruction,Brian Kelly,REP,30019,0,0,1,1,
Atoka,Superintendent of Public Instruction,Janet Costello Barresi,REP,30019,0,0,1,1,
Atoka,Superintendent of Public Instruction,Joy Hofmeister,REP,30019,0,0,1,1,
Atoka,Insurance Commissioner,Bill Viner,REP,30019,0,0,1,1,
Atoka,Insurance Commissioner,John Doak,REP,30019,0,0,4,4,
Atoka,Corporation Commissioner,Todd Hiett,REP,30019,0,0,3,3,
Atoka,Corporation Commissioner,Cliff Branan,REP,30019,0,0,1,1,
Atoka,U.S. Senate,Evelyn Rogers,REP,30019,0,0,0,0,
Atoka,U.S. Senate,Rob Moye,REP,30019,0,0,0,0,
Atoka,U.S. Senate,D. Jean Mcbride-Samuels,REP,30019,0,0,0,0,
Atoka,U.S. Senate,Jim Inhofe,REP,30019,0,0,5,5,
Atoka,U.S. Senate,Erick Paul Wyatt,REP,30019,0,0,0,0,
Atoka,U.S. Senate,Andy Craig,REP,30019,0,0,0,0,
Atoka,U.S. Senate,T. Shannon,REP,30019,0,0,0,0,
Atoka,U.S. Senate,Randy Brogdon,REP,30019,0,0,0,0,
Atoka,U.S. Senate,Eric Mccray,REP,30019,0,0,0,0,
Atoka,U.S. Senate,Kevin Crow,REP,30019,0,0,0,0,
Atoka,U.S. Senate,James Lankford,REP,30019,0,0,5,5,
Atoka,U.S. Senate,Jason Weger,REP,30019,0,0,0,0,
Atoka,U.S. House,Darrel Robertson,REP,30019,0,0,2,2,02
Atoka,U.S. House,Markwayne Mullin,REP,30019,0,0,3,3,02
Beaver,Superintendent of Public Instruction,John Cox,DEM,40011,0,0,4,4,
Beaver,Superintendent of Public Instruction,Jack Jr.,DEM,40011,0,0,3,3,
Beaver,Superintendent of Public Instruction,Ivan Holmes,DEM,40011,0,0,0,0,
Beaver,Superintendent of Public Instruction,Freda Deskin,DEM,40011,0,1,5,6,
Beaver,U.S. Senate,Patrick Michael Hayes,DEM,40011,0,0,1,1,
Beaver,U.S. Senate,Jim Rogers,DEM,40011,0,0,6,6,
Beaver,U.S. Senate,Connie Johnson,DEM,40011,0,1,4,5,
Beaver,Governor,Dax Ewbank,REP,40011,0,1,14,15,
Beaver,Governor,Chad Moody,REP,40011,0,0,9,9,
Beaver,Governor,Mary Fallin,REP,40011,2,1,67,70,
Beaver,Superintendent of Public Instruction,Brian Kelly,REP,40011,1,1,22,24,
Beaver,Superintendent of Public Instruction,Janet Costello Barresi,REP,40011,1,0,16,17,
Beaver,Superintendent of Public Instruction,Joy Hofmeister,REP,40011,0,1,51,52,
Beaver,Insurance Commissioner,Bill Viner,REP,40011,0,1,20,21,
Beaver,Insurance Commissioner,John Doak,REP,40011,2,1,62,65,
Beaver,Corporation Commissioner,Todd Hiett,REP,40011,2,2,59,63,
Beaver,Corporation Commissioner,Cliff Branan,REP,40011,0,0,24,24,
Beaver,U.S. Senate,Evelyn Rogers,REP,40011,0,1,5,6,
Beaver,U.S. Senate,Rob Moye,REP,40011,0,0,0,0,
Beaver,U.S. Senate,D. Jean Mcbride-Samuels,REP,40011,0,0,1,1,
Beaver,U.S. Senate,Jim Inhofe,REP,40011,2,1,75,78,
Beaver,U.S. Senate,Erick Paul Wyatt,REP,40011,0,0,7,7,
Beaver,U.S. Senate,Andy Craig,REP,40011,0,0,0,0,
Beaver,U.S. Senate,T. Shannon,REP,40011,1,1,32,34,
Beaver,U.S. Senate,Randy Brogdon,REP,40011,0,0,5,5,
Beaver,U.S. Senate,Eric Mccray,REP,40011,0,0,1,1,
Beaver,U.S. Senate,Kevin Crow,REP,40011,0,0,0,0,
Beaver,U.S. Senate,James Lankford,REP,40011,1,1,51,53,
Beaver,U.S. Senate,Jason Weger,REP,40011,0,0,0,0,
Beaver,U.S. House,Timothy Ray Murray,REP,40011,0,1,1,2,03
Beaver,U.S. House,Robert Hubbard,REP,40011,0,0,12,12,03
Beaver,U.S. House,Frank Lucas,REP,40011,2,1,76,79,03
Beaver,State House,Casey Murdock,REP,40011,1,1,39,41,61
Beaver,State House,David Elder,REP,40011,0,0,24,24,61
Beaver,State House,Steve Moore,REP,40011,1,1,3,5,61
Beaver,State House,Kenny Bob Tapp,REP,40011,0,0,20,20,61
Beaver,State House,Larry Swager,REP,40011,0,0,3,3,61
Beaver,Superintendent of Public Instruction,John Cox,DEM,40013,0,0,3,3,
Beaver,Superintendent of Public Instruction,Jack Jr.,DEM,40013,0,0,0,0,
Beaver,Superintendent of Public Instruction,Ivan Holmes,DEM,40013,0,0,0,0,
Beaver,Superintendent of Public Instruction,Freda Deskin,DEM,40013,1,0,5,6,
Beaver,U.S. Senate,Patrick Michael Hayes,DEM,40013,0,0,2,2,
Beaver,U.S. Senate,Jim Rogers,DEM,40013,1,0,4,5,
Beaver,U.S. Senate,Connie Johnson,DEM,40013,0,0,2,2,
Beaver,Governor,Dax Ewbank,REP,40013,0,0,3,3,
Beaver,Governor,Chad Moody,REP,40013,0,0,5,5,
Beaver,Governor,Mary Fallin,REP,40013,6,4,48,58,
Beaver,Superintendent of Public Instruction,Brian Kelly,REP,40013,0,0,13,13,
Beaver,Superintendent of Public Instruction,Janet Costello Barresi,REP,40013,0,0,12,12,
Beaver,Superintendent of Public Instruction,Joy Hofmeister,REP,40013,6,3,28,37,
Beaver,Insurance Commissioner,Bill Viner,REP,40013,1,1,10,12,
Beaver,Insurance Commissioner,John Doak,REP,40013,5,2,37,44,
Beaver,Corporation Commissioner,Todd Hiett,REP,40013,4,3,43,50,
Beaver,Corporation Commissioner,Cliff Branan,REP,40013,2,0,9,11,
Beaver,U.S. Senate,Evelyn Rogers,REP,40013,0,0,0,0,
Beaver,U.S. Senate,Rob Moye,REP,40013,0,0,2,2,
Beaver,U.S. Senate,D. Jean Mcbride-Samuels,REP,40013,0,0,0,0,
Beaver,U.S. Senate,Jim Inhofe,REP,40013,6,4,48,58,
Beaver,U.S. Senate,Erick Paul Wyatt,REP,40013,0,0,4,4,
Beaver,U.S. Senate,Andy Craig,REP,40013,0,0,1,1,
Beaver,U.S. Senate,T. Shannon,REP,40013,0,0,28,28,
Beaver,U.S. Senate,Randy Brogdon,REP,40013,0,0,0,0,
Beaver,U.S. Senate,Eric Mccray,REP,40013,0,0,1,1,
Beaver,U.S. Senate,Kevin Crow,REP,40013,0,0,0,0,
Beaver,U.S. Senate,James Lankford,REP,40013,6,4,24,34,
Beaver,U.S. Senate,Jason Weger,REP,40013,0,0,0,0,
Beaver,U.S. House,Timothy Ray Murray,REP,40013,0,0,2,2,03
Beaver,U.S. House,Robert Hubbard,REP,40013,0,0,12,12,03
Beaver,U.S. House,Frank Lucas,REP,40013,6,4,42,52,03
Beaver,State House,Casey Murdock,REP,40013,6,2,17,25,61
Beaver,State House,David Elder,REP,40013,0,0,11,11,61
Beaver,State House,Steve Moore,REP,40013,0,0,9,9,61
Beaver,State House,Kenny Bob Tapp,REP,40013,0,2,14,16,61
Beaver,State House,Larry Swager,REP,40013,0,0,3,3,61
Beaver,Superintendent of Public Instruction,John Cox,DEM,40023,1,3,17,21,
Beaver,Superintendent of Public Instruction,Jack Jr.,DEM,40023,0,2,9,11,
Beaver,Superintendent of Public Instruction,Ivan Holmes,DEM,40023,0,3,6,9,
Beaver,Superintendent of Public Instruction,Freda Deskin,DEM,40023,0,5,3,8,
Beaver,U.S. Senate,Patrick Michael Hayes,DEM,40023,0,1,8,9,
Beaver,U.S. Senate,Jim Rogers,DEM,40023,1,6,13,20,
Beaver,U.S. Senate,Connie Johnson,DEM,40023,0,4,14,18,
Beaver,Governor,Dax Ewbank,REP,40023,2,10,54,66,
Beaver,Governor,Chad Moody,REP,40023,5,11,68,84,
Beaver,Governor,Mary Fallin,REP,40023,19,49,223,291,
Beaver,Superintendent of Public Instruction,Brian Kelly,REP,40023,13,24,128,165,
Beaver,Superintendent of Public Instruction,Janet Costello Barresi,REP,40023,1,10,39,50,
Beaver,Superintendent of Public Instruction,Joy Hofmeister,REP,40023,10,37,156,203,
Beaver,Insurance Commissioner,Bill Viner,REP,40023,4,21,101,126,
Beaver,Insurance Commissioner,John Doak,REP,40023,18,43,205,266,
Beaver,Corporation Commissioner,Todd Hiett,REP,40023,16,40,191,247,
Beaver,Corporation Commissioner,Cliff Branan,REP,40023,8,26,117,151,
Beaver,U.S. Senate,Evelyn Rogers,REP,40023,1,2,21,24,
Beaver,U.S. Senate,Rob Moye,REP,40023,1,0,12,13,
Beaver,U.S. Senate,D. Jean Mcbride-Samuels,REP,40023,0,2,5,7,
Beaver,U.S. Senate,Jim Inhofe,REP,40023,23,57,266,346,
Beaver,U.S. Senate,Erick Paul Wyatt,REP,40023,1,8,29,38,
Beaver,U.S. Senate,Andy Craig,REP,40023,0,2,5,7,
Beaver,U.S. Senate,T. Shannon,REP,40023,11,24,121,156,
Beaver,U.S. Senate,Randy Brogdon,REP,40023,0,6,32,38,
Beaver,U.S. Senate,Eric Mccray,REP,40023,1,1,9,11,
Beaver,U.S. Senate,Kevin Crow,REP,40023,3,0,26,29,
Beaver,U.S. Senate,James Lankford,REP,40023,11,34,134,179,
Beaver,U.S. Senate,Jason Weger,REP,40023,0,2,2,4,
Beaver,U.S. House,Timothy Ray Murray,REP,40023,1,4,21,26,03
Beaver,U.S. House,Robert Hubbard,REP,40023,6,5,60,71,03
Beaver,U.S. House,Frank Lucas,REP,40023,20,62,256,338,03
Beaver,State House,Casey Murdock,REP,40023,13,29,109,151,61
Beaver,State House,David Elder,REP,40023,0,3,16,19,61
Beaver,State House,Steve Moore,REP,40023,2,10,49,61,61
Beaver,State House,Kenny Bob Tapp,REP,40023,9,22,118,149,61
Beaver,State House,Larry Swager,REP,40023,1,6,43,50,61
Beaver,Superintendent of Public Instruction,John Cox,DEM,40025,0,0,9,9,
Beaver,Superintendent of Public Instruction,Jack Jr.,DEM,40025,0,0,2,2,
Beaver,Superintendent of Public Instruction,Ivan Holmes,DEM,40025,0,0,3,3,
Beaver,Superintendent of Public Instruction,Freda Deskin,DEM,40025,0,0,7,7,
Beaver,U.S. Senate,Patrick Michael Hayes,DEM,40025,0,0,11,11,
Beaver,U.S. Senate,Jim Rogers,DEM,40025,0,0,6,6,
Beaver,U.S. Senate,Connie Johnson,DEM,40025,0,0,3,3,
Beaver,Governor,Dax Ewbank,REP,40025,0,0,4,4,
Beaver,Governor,Chad Moody,REP,40025,2,1,9,12,
Beaver,Governor,Mary Fallin,REP,40025,2,7,53,62,
Beaver,Superintendent of Public Instruction,Brian Kelly,REP,40025,0,2,22,24,
Beaver,Superintendent of Public Instruction,Janet Costello Barresi,REP,40025,0,0,9,9,
Beaver,Superintendent of Public Instruction,Joy Hofmeister,REP,40025,4,5,33,42,
Beaver,Insurance Commissioner,Bill Viner,REP,40025,0,3,18,21,
Beaver,Insurance Commissioner,John Doak,REP,40025,4,4,44,52,
Beaver,Corporation Commissioner,Todd Hiett,REP,40025,4,4,35,43,
Beaver,Corporation Commissioner,Cliff Branan,REP,40025,0,3,24,27,
Beaver,U.S. Senate,Evelyn Rogers,REP,40025,0,1,4,5,
Beaver,U.S. Senate,Rob Moye,REP,40025,0,0,2,2,
Beaver,U.S. Senate,D. Jean Mcbride-Samuels,REP,40025,0,0,2,2,
Beaver,U.S. Senate,Jim Inhofe,REP,40025,4,6,49,59,
Beaver,U.S. Senate,Erick Paul Wyatt,REP,40025,0,0,9,9,
Beaver,U.S. Senate,Andy Craig,REP,40025,0,0,4,4,
Beaver,U.S. Senate,T. Shannon,REP,40025,0,1,21,22,
Beaver,U.S. Senate,Randy Brogdon,REP,40025,2,1,5,8,
Beaver,U.S. Senate,Eric Mccray,REP,40025,0,0,0,0,
Beaver,U.S. Senate,Kevin Crow,REP,40025,0,2,6,8,
Beaver,U.S. Senate,James Lankford,REP,40025,2,3,24,29,
Beaver,U.S. Senate,Jason Weger,REP,40025,0,0,4,4,
Beaver,U.S. House,Timothy Ray Murray,REP,40025,0,0,8,8,03
Beaver,U.S. House,Robert Hubbard,REP,40025,2,1,7,10,03
Beaver,U.S. House,Frank Lucas,REP,40025,2,7,50,59,03
Beaver,State House,Casey Murdock,REP,40025,0,5,25,30,61
Beaver,State House,David Elder,REP,40025,0,0,1,1,61
Beaver,State House,Steve Moore,REP,40025,0,1,14,15,61
Beaver,State House,Kenny Bob Tapp,REP,40025,4,1,20,25,61
Beaver,State House,Larry Swager,REP,40025,0,0,7,7,61
Beaver,Superintendent of Public Instruction,John Cox,DEM,40026,0,0,0,0,
Beaver,Superintendent of Public Instruction,Jack Jr.,DEM,40026,0,0,1,1,
Beaver,Superintendent of Public Instruction,Ivan Holmes,DEM,40026,0,0,0,0,
Beaver,Superintendent of Public Instruction,Freda Deskin,DEM,40026,1,1,0,2,
Beaver,U.S. Senate,Patrick Michael Hayes,DEM,40026,0,0,0,0,
Beaver,U.S. Senate,Jim Rogers,DEM,40026,0,0,0,0,
Beaver,U.S. Senate,Connie Johnson,DEM,40026,1,1,1,3,
Beaver,Governor,Dax Ewbank,REP,40026,0,0,0,0,
Beaver,Governor,Chad Moody,REP,40026,0,0,5,5,
Beaver,Governor,Mary Fallin,REP,40026,0,0,18,18,
Beaver,Superintendent of Public Instruction,Brian Kelly,REP,40026,0,0,9,9,
Beaver,Superintendent of Public Instruction,Janet Costello Barresi,REP,40026,0,0,3,3,
Beaver,Superintendent of Public Instruction,Joy Hofmeister,REP,40026,0,0,12,12,
Beaver,Insurance Commissioner,Bill Viner,REP,40026,0,0,7,7,
Beaver,Insurance Commissioner,John Doak,REP,40026,0,0,14,14,
Beaver,Corporation Commissioner,Todd Hiett,REP,40026,0,0,14,14,
Beaver,Corporation Commissioner,Cliff Branan,REP,40026,0,0,6,6,
Beaver,U.S. Senate,Evelyn Rogers,REP,40026,0,0,1,1,
Beaver,U.S. Senate,Rob Moye,REP,40026,0,0,1,1,
Beaver,U.S. Senate,D. Jean Mcbride-Samuels,REP,40026,0,0,0,0,
Beaver,U.S. Senate,Jim Inhofe,REP,40026,0,0,19,19,
Beaver,U.S. Senate,Erick Paul Wyatt,REP,40026,0,0,2,2,
Beaver,U.S. Senate,Andy Craig,REP,40026,0,0,0,0,
Beaver,U.S. Senate,T. Shannon,REP,40026,0,0,12,12,
Beaver,U.S. Senate,Randy Brogdon,REP,40026,0,0,1,1,
Beaver,U.S. Senate,Eric Mccray,REP,40026,0,0,1,1,
Beaver,U.S. Senate,Kevin Crow,REP,40026,0,0,1,1,
Beaver,U.S. Senate,James Lankford,REP,40026,0,0,8,8,
Beaver,U.S. Senate,Jason Weger,REP,40026,0,0,1,1,
Beaver,U.S. House,Timothy Ray Murray,REP,40026,0,0,1,1,03
Beaver,U.S. House,Robert Hubbard,REP,40026,0,0,1,1,03
Beaver,U.S. House,Frank Lucas,REP,40026,0,0,22,22,03
Beaver,State House,Casey Murdock,REP,40026,0,0,6,6,61
Beaver,State House,David Elder,REP,40026,0,0,1,1,61
Beaver,State House,Steve Moore,REP,40026,0,0,13,13,61
Beaver,State House,Kenny Bob Tapp,REP,40026,0,0,3,3,61
Beaver,State House,Larry Swager,REP,40026,0,0,2,2,61
Beaver,Superintendent of Public Instruction,John Cox,DEM,40031,0,0,11,11,
Beaver,Superintendent of Public Instruction,Jack Jr.,DEM,40031,0,0,1,1,
Beaver,Superintendent of Public Instruction,Ivan Holmes,DEM,40031,0,0,2,2,
Beaver,Superintendent of Public Instruction,Freda Deskin,DEM,40031,0,1,6,7,
Beaver,U.S. Senate,Patrick Michael Hayes,DEM,40031,0,0,6,6,
Beaver,U.S. Senate,Jim Rogers,DEM,40031,0,1,7,8,
Beaver,U.S. Senate,Connie Johnson,DEM,40031,0,0,6,6,
Beaver,Governor,Dax Ewbank,REP,40031,0,0,10,10,
Beaver,Governor,Chad Moody,REP,40031,1,0,14,15,
Beaver,Governor,Mary Fallin,REP,40031,3,7,72,82,
Beaver,Superintendent of Public Instruction,Brian Kelly,REP,40031,2,2,40,44,
Beaver,Superintendent of Public Instruction,Janet Costello Barresi,REP,40031,0,0,7,7,
Beaver,Superintendent of Public Instruction,Joy Hofmeister,REP,40031,2,5,44,51,
Beaver,Insurance Commissioner,Bill Viner,REP,40031,0,2,21,23,
Beaver,Insurance Commissioner,John Doak,REP,40031,4,5,62,71,
Beaver,Corporation Commissioner,Todd Hiett,REP,40031,1,5,57,63,
Beaver,Corporation Commissioner,Cliff Branan,REP,40031,3,2,30,35,
Beaver,U.S. Senate,Evelyn Rogers,REP,40031,3,0,4,7,
Beaver,U.S. Senate,Rob Moye,REP,40031,0,0,2,2,
Beaver,U.S. Senate,D. Jean Mcbride-Samuels,REP,40031,0,0,3,3,
Beaver,U.S. Senate,Jim Inhofe,REP,40031,1,7,72,80,
Beaver,U.S. Senate,Erick Paul Wyatt,REP,40031,0,0,10,10,
Beaver,U.S. Senate,Andy Craig,REP,40031,0,0,5,5,
Beaver,U.S. Senate,T. Shannon,REP,40031,3,2,46,51,
Beaver,U.S. Senate,Randy Brogdon,REP,40031,0,0,2,2,
Beaver,U.S. Senate,Eric Mccray,REP,40031,0,0,6,6,
Beaver,U.S. Senate,Kevin Crow,REP,40031,0,0,2,2,
Beaver,U.S. Senate,James Lankford,REP,40031,1,4,27,32,
Beaver,U.S. Senate,Jason Weger,REP,40031,0,1,3,4,
Beaver,U.S. House,Timothy Ray Murray,REP,40031,2,0,8,10,03
Beaver,U.S. House,Robert Hubbard,REP,40031,1,0,14,15,03
Beaver,U.S. House,Frank Lucas,REP,40031,2,8,70,80,03
Beaver,State House,Casey Murdock,REP,40031,2,0,30,32,61
Beaver,State House,David Elder,REP,40031,0,3,4,7,61
Beaver,State House,Steve Moore,REP,40031,1,3,21,25,61
Beaver,State House,Kenny Bob Tapp,REP,40031,1,1,21,23,61
Beaver,State House,Larry Swager,REP,40031,0,1,14,15,61
Beaver,Superintendent of Public Instruction,John Cox,DEM,40033,0,0,12,12,
Beaver,Superintendent of Public Instruction,Jack Jr.,DEM,40033,0,0,4,4,
Beaver,Superintendent of Public Instruction,Ivan Holmes,DEM,40033,0,0,4,4,
Beaver,Superintendent of Public Instruction,Freda Deskin,DEM,40033,0,0,5,5,
Beaver,U.S. Senate,Patrick Michael Hayes,DEM,40033,0,0,11,11,
Beaver,U.S. Senate,Jim Rogers,DEM,40033,0,0,12,12,
Beaver,U.S. Senate,Connie Johnson,DEM,40033,0,0,2,2,
Beaver,Governor,Dax Ewbank,REP,40033,1,3,32,36,
Beaver,Governor,Chad Moody,REP,40033,1,3,40,44,
Beaver,Governor,Mary Fallin,REP,40033,5,4,153,162,
Beaver,Superintendent of Public Instruction,Brian Kelly,REP,40033,1,1,55,57,
Beaver,Superintendent of Public Instruction,Janet Costello Barresi,REP,40033,2,0,30,32,
Beaver,Superintendent of Public Instruction,Joy Hofmeister,REP,40033,3,9,137,149,
Beaver,Insurance Commissioner,Bill Viner,REP,40033,2,5,72,79,
Beaver,Insurance Commissioner,John Doak,REP,40033,3,5,115,123,
Beaver,Corporation Commissioner,Todd Hiett,REP,40033,2,6,99,107,
Beaver,Corporation Commissioner,Cliff Branan,REP,40033,3,4,88,95,
Beaver,U.S. Senate,Evelyn Rogers,REP,40033,0,0,12,12,
Beaver,U.S. Senate,Rob Moye,REP,40033,0,0,11,11,
Beaver,U.S. Senate,D. Jean Mcbride-Samuels,REP,40033,0,0,2,2,
Beaver,U.S. Senate,Jim Inhofe,REP,40033,7,9,173,189,
Beaver,U.S. Senate,Erick Paul Wyatt,REP,40033,0,1,25,26,
Beaver,U.S. Senate,Andy Craig,REP,40033,2,0,7,9,
Beaver,U.S. Senate,T. Shannon,REP,40033,2,3,94,99,
Beaver,U.S. Senate,Randy Brogdon,REP,40033,0,0,10,10,
Beaver,U.S. Senate,Eric Mccray,REP,40033,0,0,15,15,
Beaver,U.S. Senate,Kevin Crow,REP,40033,0,0,15,15,
Beaver,U.S. Senate,James Lankford,REP,40033,1,7,79,87,
Beaver,U.S. Senate,Jason Weger,REP,40033,0,0,3,3,
Beaver,U.S. House,Timothy Ray Murray,REP,40033,0,0,16,16,03
Beaver,U.S. House,Robert Hubbard,REP,40033,0,0,30,30,03
Beaver,U.S. House,Frank Lucas,REP,40033,7,10,176,193,03
Beaver,State House,Casey Murdock,REP,40033,2,0,53,55,61
Beaver,State House,David Elder,REP,40033,0,0,15,15,61
Beaver,State House,Steve Moore,REP,40033,1,10,112,123,61
Beaver,State House,Kenny Bob Tapp,REP,40033,2,0,30,32,61
Beaver,State House,Larry Swager,REP,40033,1,0,17,18,61
Beckham,Superintendent of Public Instruction,John Cox,DEM,50111,1,7,46,54,
Beckham,Superintendent of Public Instruction,Jack Jr.,DEM,50111,0,2,17,19,
Beckham,Superintendent of Public Instruction,Ivan Holmes,DEM,50111,1,5,14,20,
Beckham,Superintendent of Public Instruction,Freda Deskin,DEM,50111,0,4,42,46,
Beckham,U.S. Senate,Patrick Michael Hayes,DEM,50111,1,4,30,35,
Beckham,U.S. Senate,Jim Rogers,DEM,50111,0,6,52,58,
Beckham,U.S. Senate,Connie Johnson,DEM,50111,1,6,32,39,
Beckham,Governor,Dax Ewbank,REP,50111,0,1,9,10,
Beckham,Governor,Chad Moody,REP,50111,1,1,11,13,
Beckham,Governor,Mary Fallin,REP,50111,1,3,54,58,
Beckham,Superintendent of Public Instruction,Brian Kelly,REP,50111,0,1,9,10,
Beckham,Superintendent of Public Instruction,Janet Costello Barresi,REP,50111,0,0,12,12,
Beckham,Superintendent of Public Instruction,Joy Hofmeister,REP,50111,3,4,53,60,
Beckham,Insurance Commissioner,Bill Viner,REP,50111,0,0,9,9,
Beckham,Insurance Commissioner,John Doak,REP,50111,3,5,56,64,
Beckham,Corporation Commissioner,Todd Hiett,REP,50111,2,3,35,40,
Beckham,Corporation Commissioner,Cliff Branan,REP,50111,1,1,31,33,
Beckham,U.S. Senate,Evelyn Rogers,REP,50111,0,1,4,5,
Beckham,U.S. Senate,Rob Moye,REP,50111,0,0,0,0,
Beckham,U.S. Senate,D. Jean Mcbride-Samuels,REP,50111,0,0,0,0,
Beckham,U.S. Senate,Jim Inhofe,REP,50111,3,4,60,67,
Beckham,U.S. Senate,Erick Paul Wyatt,REP,50111,0,0,7,7,
Beckham,U.S. Senate,Andy Craig,REP,50111,0,0,0,0,
Beckham,U.S. Senate,T. Shannon,REP,50111,0,1,19,20,
Beckham,U.S. Senate,Randy Brogdon,REP,50111,0,0,8,8,
Beckham,U.S. Senate,Eric Mccray,REP,50111,0,0,1,1,
Beckham,U.S. Senate,Kevin Crow,REP,50111,0,0,1,1,
Beckham,U.S. Senate,James Lankford,REP,50111,3,4,44,51,
Beckham,U.S. Senate,Jason Weger,REP,50111,0,0,1,1,
Beckham,U.S. House,Timothy Ray Murray,REP,50111,0,0,2,2,03
Beckham,U.S. House,Robert Hubbard,REP,50111,0,0,6,6,03
Beckham,U.S. House,Frank Lucas,REP,50111,3,5,62,70,03
Beckham,State Senate,Darcy Jech,REP,50111,3,5,29,37,26
Beckham,State Senate,Dan Gambill,REP,50111,0,0,43,43,26
Beckham,Superintendent of Public Instruction,John Cox,DEM,50112,0,5,18,23,
Beckham,Superintendent of Public Instruction,Jack Jr.,DEM,50112,0,0,6,6,
Beckham,Superintendent of Public Instruction,Ivan Holmes,DEM,50112,0,0,4,4,
Beckham,Superintendent of Public Instruction,Freda Deskin,DEM,50112,1,0,26,27,
Beckham,U.S. Senate,Patrick Michael Hayes,DEM,50112,0,2,11,13,
Beckham,U.S. Senate,Jim Rogers,DEM,50112,0,3,26,29,
Beckham,U.S. Senate,Connie Johnson,DEM,50112,1,0,18,19,
Beckham,Governor,Dax Ewbank,REP,50112,0,0,1,1,
Beckham,Governor,Chad Moody,REP,50112,0,3,12,15,
Beckham,Governor,Mary Fallin,REP,50112,0,4,34,38,
Beckham,Superintendent of Public Instruction,Brian Kelly,REP,50112,0,0,14,14,
Beckham,Superintendent of Public Instruction,Janet Costello Barresi,REP,50112,0,4,6,10,
Beckham,Superintendent of Public Instruction,Joy Hofmeister,REP,50112,0,3,27,30,
Beckham,Insurance Commissioner,Bill Viner,REP,50112,0,2,12,14,
Beckham,Insurance Commissioner,John Doak,REP,50112,0,5,34,39,
Beckham,Corporation Commissioner,Todd Hiett,REP,50112,0,2,28,30,
Beckham,Corporation Commissioner,Cliff Branan,REP,50112,0,3,18,21,
Beckham,U.S. Senate,Evelyn Rogers,REP,50112,0,0,1,1,
Beckham,U.S. Senate,Rob Moye,REP,50112,0,0,1,1,
Beckham,U.S. Senate,D. Jean Mcbride-Samuels,REP,50112,0,0,1,1,
Beckham,U.S. Senate,Jim Inhofe,REP,50112,0,6,41,47,
Beckham,U.S. Senate,Erick Paul Wyatt,REP,50112,0,1,2,3,
Beckham,U.S. Senate,Andy Craig,REP,50112,0,0,2,2,
Beckham,U.S. Senate,T. Shannon,REP,50112,0,3,25,28,
Beckham,U.S. Senate,Randy Brogdon,REP,50112,0,0,0,0,
Beckham,U.S. Senate,Eric Mccray,REP,50112,0,0,0,0,
Beckham,U.S. Senate,Kevin Crow,REP,50112,0,0,0,0,
Beckham,U.S. Senate,James Lankford,REP,50112,0,2,20,22,
Beckham,U.S. Senate,Jason Weger,REP,50112,0,2,0,2,
Beckham,U.S. House,Timothy Ray Murray,REP,50112,0,0,2,2,03
Beckham,U.S. House,Robert Hubbard,REP,50112,0,2,11,13,03
Beckham,U.S. House,Frank Lucas,REP,50112,0,5,34,39,03
Beckham,State Senate,Darcy Jech,REP,50112,0,0,10,10,26
Beckham,State Senate,Dan Gambill,REP,50112,0,7,36,43,26
Beckham,Superintendent of Public Instruction,John Cox,DEM,50115,0,4,5,9,
Beckham,Superintendent of Public Instruction,Jack Jr.,DEM,50115,0,1,6,7,
Beckham,Superintendent of Public Instruction,Ivan Holmes,DEM,50115,0,0,2,2,
Beckham,Superintendent of Public Instruction,Freda Deskin,DEM,50115,0,3,0,3,
Beckham,U.S. Senate,Patrick Michael Hayes,DEM,50115,0,2,4,6,
Beckham,U.S. Senate,Jim Rogers,DEM,50115,0,4,4,8,
Beckham,U.S. Senate,Connie Johnson,DEM,50115,0,1,5,6,
Beckham,Governor,Dax Ewbank,REP,50115,0,2,1,3,
Beckham,Governor,Chad Moody,REP,50115,0,0,3,3,
Beckham,Governor,Mary Fallin,REP,50115,0,0,11,11,
Beckham,Superintendent of Public Instruction,Brian Kelly,REP,50115,0,1,3,4,
Beckham,Superintendent of Public Instruction,Janet Costello Barresi,REP,50115,0,0,3,3,
Beckham,Superintendent of Public Instruction,Joy Hofmeister,REP,50115,0,1,9,10,
Beckham,Insurance Commissioner,Bill Viner,REP,50115,0,1,3,4,
Beckham,Insurance Commissioner,John Doak,REP,50115,0,1,12,13,
Beckham,Corporation Commissioner,Todd Hiett,REP,50115,0,2,10,12,
Beckham,Corporation Commissioner,Cliff Branan,REP,50115,0,0,5,5,
Beckham,U.S. Senate,Evelyn Rogers,REP,50115,0,0,0,0,
Beckham,U.S. Senate,Rob Moye,REP,50115,0,0,0,0,
Beckham,U.S. Senate,D. Jean Mcbride-Samuels,REP,50115,0,0,2,2,
Beckham,U.S. Senate,Jim Inhofe,REP,50115,0,2,13,15,
Beckham,U.S. Senate,Erick Paul Wyatt,REP,50115,0,0,0,0,
Beckham,U.S. Senate,Andy Craig,REP,50115,0,0,0,0,
Beckham,U.S. Senate,T. Shannon,REP,50115,0,0,6,6,
Beckham,U.S. Senate,Randy Brogdon,REP,50115,0,0,0,0,
Beckham,U.S. Senate,Eric Mccray,REP,50115,0,0,0,0,
Beckham,U.S. Senate,Kevin Crow,REP,50115,0,0,0,0,
Beckham,U.S. Senate,James Lankford,REP,50115,0,2,9,11,
Beckham,U.S. Senate,Jason Weger,REP,50115,0,0,0,0,
Beckham,U.S. House,Timothy Ray Murray,REP,50115,0,0,0,0,03
Beckham,U.S. House,Robert Hubbard,REP,50115,0,0,0,0,03
Beckham,U.S. House,Frank Lucas,REP,50115,0,2,15,17,03
Beckham,State Senate,Darcy Jech,REP,50115,0,1,6,7,26
Beckham,State Senate,Dan Gambill,REP,50115,0,1,9,10,26
Beckham,Superintendent of Public Instruction,John Cox,DEM,50141,0,0,27,27,
Beckham,Superintendent of Public Instruction,Jack Jr.,DEM,50141,1,0,9,10,
Beckham,Superintendent of Public Instruction,Ivan Holmes,DEM,50141,1,0,11,12,
Beckham,Superintendent of Public Instruction,Freda Deskin,DEM,50141,1,0,24,25,
Beckham,U.S. Senate,Patrick Michael Hayes,DEM,50141,0,0,16,16,
Beckham,U.S. Senate,Jim Rogers,DEM,50141,2,0,32,34,
Beckham,U.S. Senate,Connie Johnson,DEM,50141,1,0,23,24,
Beckham,Governor,Dax Ewbank,REP,50141,3,0,6,9,
Beckham,Governor,Chad Moody,REP,50141,0,3,27,30,
Beckham,Governor,Mary Fallin,REP,50141,1,4,94,99,
Beckham,Superintendent of Public Instruction,Brian Kelly,REP,50141,0,0,19,19,
Beckham,Superintendent of Public Instruction,Janet Costello Barresi,REP,50141,0,0,13,13,
Beckham,Superintendent of Public Instruction,Joy Hofmeister,REP,50141,4,7,97,108,
Beckham,Insurance Commissioner,Bill Viner,REP,50141,0,4,25,29,
Beckham,Insurance Commissioner,John Doak,REP,50141,4,3,89,96,
Beckham,Corporation Commissioner,Todd Hiett,REP,50141,3,6,58,67,
Beckham,Corporation Commissioner,Cliff Branan,REP,50141,1,1,59,61,
Beckham,U.S. Senate,Evelyn Rogers,REP,50141,0,0,6,6,
Beckham,U.S. Senate,Rob Moye,REP,50141,0,0,0,0,
Beckham,U.S. Senate,D. Jean Mcbride-Samuels,REP,50141,0,0,1,1,
Beckham,U.S. Senate,Jim Inhofe,REP,50141,4,6,112,122,
Beckham,U.S. Senate,Erick Paul Wyatt,REP,50141,0,1,7,8,
Beckham,U.S. Senate,Andy Craig,REP,50141,0,0,0,0,
Beckham,U.S. Senate,T. Shannon,REP,50141,0,2,46,48,
Beckham,U.S. Senate,Randy Brogdon,REP,50141,1,0,4,5,
Beckham,U.S. Senate,Eric Mccray,REP,50141,0,0,0,0,
Beckham,U.S. Senate,Kevin Crow,REP,50141,0,0,2,2,
Beckham,U.S. Senate,James Lankford,REP,50141,3,5,74,82,
Beckham,U.S. Senate,Jason Weger,REP,50141,0,0,0,0,
Beckham,U.S. House,Timothy Ray Murray,REP,50141,0,1,2,3,03
Beckham,U.S. House,Robert Hubbard,REP,50141,0,0,14,14,03
Beckham,U.S. House,Frank Lucas,REP,50141,4,6,111,121,03
Beckham,State Senate,Darcy Jech,REP,50141,0,1,52,53,26
Beckham,State Senate,Dan Gambill,REP,50141,4,6,73,83,26
Beckham,Superintendent of Public Instruction,John Cox,DEM,50231,0,3,12,15,
Beckham,Superintendent of Public Instruction,Jack Jr.,DEM,50231,0,0,1,1,
Beckham,Superintendent of Public Instruction,Ivan Holmes,DEM,50231,0,0,4,4,
Beckham,Superintendent of Public Instruction,Freda Deskin,DEM,50231,0,0,19,19,
Beckham,U.S. Senate,Patrick Michael Hayes,DEM,50231,0,0,7,7,
Beckham,U.S. Senate,Jim Rogers,DEM,50231,0,0,14,14,
Beckham,U.S. Senate,Connie Johnson,DEM,50231,0,3,14,17,
Beckham,Governor,Dax Ewbank,REP,50231,0,0,11,11,
Beckham,Governor,Chad Moody,REP,50231,0,0,9,9,
Beckham,Governor,Mary Fallin,REP,50231,0,0,48,48,
Beckham,Superintendent of Public Instruction,Brian Kelly,REP,50231,0,0,15,15,
Beckham,Superintendent of Public Instruction,Janet Costello Barresi,REP,50231,0,0,5,5,
Beckham,Superintendent of Public Instruction,Joy Hofmeister,REP,50231,0,0,47,47,
Beckham,Insurance Commissioner,Bill Viner,REP,50231,0,0,12,12,
Beckham,Insurance Commissioner,John Doak,REP,50231,0,0,52,52,
Beckham,Corporation Commissioner,Todd Hiett,REP,50231,0,0,29,29,
Beckham,Corporation Commissioner,Cliff Branan,REP,50231,0,0,36,36,
Beckham,U.S. Senate,Evelyn Rogers,REP,50231,0,0,2,2,
Beckham,U.S. Senate,Rob Moye,REP,50231,0,0,1,1,
Beckham,U.S. Senate,D. Jean Mcbride-Samuels,REP,50231,0,0,0,0,
Beckham,U.S. Senate,Jim Inhofe,REP,50231,0,0,60,60,
Beckham,U.S. Senate,Erick Paul Wyatt,REP,50231,0,0,3,3,
Beckham,U.S. Senate,Andy Craig,REP,50231,0,0,1,1,
Beckham,U.S. Senate,T. Shannon,REP,50231,0,0,25,25,
Beckham,U.S. Senate,Randy Brogdon,REP,50231,0,0,0,0,
Beckham,U.S. Senate,Eric Mccray,REP,50231,0,0,1,1,
Beckham,U.S. Senate,Kevin Crow,REP,50231,0,0,0,0,
Beckham,U.S. Senate,James Lankford,REP,50231,0,0,41,41,
Beckham,U.S. Senate,Jason Weger,REP,50231,0,0,0,0,
Beckham,U.S. House,Timothy Ray Murray,REP,50231,0,0,3,3,03
Beckham,U.S. House,Robert Hubbard,REP,50231,0,0,8,8,03
Beckham,U.S. House,Frank Lucas,REP,50231,0,0,57,57,03
Beckham,State Senate,Darcy Jech,REP,50231,0,0,19,19,26
Beckham,State Senate,Dan Gambill,REP,50231,0,0,48,48,26
Beckham,Superintendent of Public Instruction,John Cox,DEM,50232,0,0,3,3,
Beckham,Superintendent of Public Instruction,Jack Jr.,DEM,50232,0,0,3,3,
Beckham,Superintendent of Public Instruction,Ivan Holmes,DEM,50232,0,0,0,0,
Beckham,Superintendent of Public Instruction,Freda Deskin,DEM,50232,0,0,2,2,
Beckham,U.S. Senate,Patrick Michael Hayes,DEM,50232,0,0,1,1,
Beckham,U.S. Senate,Jim Rogers,DEM,50232,0,0,1,1,
Beckham,U.S. Senate,Connie Johnson,DEM,50232,0,0,4,4,
Beckham,Governor,Dax Ewbank,REP,50232,0,0,1,1,
Beckham,Governor,Chad Moody,REP,50232,0,0,2,2,
Beckham,Governor,Mary Fallin,REP,50232,0,0,12,12,
Beckham,Superintendent of Public Instruction,Brian Kelly,REP,50232,0,0,2,2,
Beckham,Superintendent of Public Instruction,Janet Costello Barresi,REP,50232,0,0,1,1,
Beckham,Superintendent of Public Instruction,Joy Hofmeister,REP,50232,0,0,13,13,
Beckham,Insurance Commissioner,Bill Viner,REP,50232,0,0,3,3,
Beckham,Insurance Commissioner,John Doak,REP,50232,0,0,10,10,
Beckham,Corporation Commissioner,Todd Hiett,REP,50232,0,0,6,6,
Beckham,Corporation Commissioner,Cliff Branan,REP,50232,0,0,6,6,
Beckham,U.S. Senate,Evelyn Rogers,REP,50232,0,0,3,3,
Beckham,U.S. Senate,Rob Moye,REP,50232,0,0,0,0,
Beckham,U.S. Senate,D. Jean Mcbride-Samuels,REP,50232,0,0,0,0,
Beckham,U.S. Senate,Jim Inhofe,REP,50232,0,0,11,11,
Beckham,U.S. Senate,Erick Paul Wyatt,REP,50232,0,0,1,1,
Beckham,U.S. Senate,Andy Craig,REP,50232,0,0,0,0,
Beckham,U.S. Senate,T. Shannon,REP,50232,0,0,2,2,
Beckham,U.S. Senate,Randy Brogdon,REP,50232,0,0,0,0,
Beckham,U.S. Senate,Eric Mccray,REP,50232,0,0,0,0,
Beckham,U.S. Senate,Kevin Crow,REP,50232,0,0,0,0,
Beckham,U.S. Senate,James Lankford,REP,50232,0,0,14,14,
Beckham,U.S. Senate,Jason Weger,REP,50232,0,0,0,0,
Beckham,U.S. House,Timothy Ray Murray,REP,50232,0,0,0,0,03
Beckham,U.S. House,Robert Hubbard,REP,50232,0,0,0,0,03
Beckham,U.S. House,Frank Lucas,REP,50232,0,0,16,16,03
Beckham,State Senate,Darcy Jech,REP,50232,0,0,4,4,26
Beckham,State Senate,Dan Gambill,REP,50232,0,0,12,12,26
Beckham,Superintendent of Public Instruction,John Cox,DEM,50235,0,0,44,44,
Beckham,Superintendent of Public Instruction,Jack Jr.,DEM,50235,0,0,18,18,
Beckham,Superintendent of Public Instruction,Ivan Holmes,DEM,50235,0,1,12,13,
Beckham,Superintendent of Public Instruction,Freda Deskin,DEM,50235,1,0,42,43,
Beckham,U.S. Senate,Patrick Michael Hayes,DEM,50235,0,0,26,26,
Beckham,U.S. Senate,Jim Rogers,DEM,50235,0,1,49,50,
Beckham,U.S. Senate,Connie Johnson,DEM,50235,1,0,38,39,
Beckham,Governor,Dax Ewbank,REP,50235,3,1,30,34,
Beckham,Governor,Chad Moody,REP,50235,1,4,48,53,
Beckham,Governor,Mary Fallin,REP,50235,4,5,142,151,
Beckham,Superintendent of Public Instruction,Brian Kelly,REP,50235,1,2,36,39,
Beckham,Superintendent of Public Instruction,Janet Costello Barresi,REP,50235,3,0,21,24,
Beckham,Superintendent of Public Instruction,Joy Hofmeister,REP,50235,4,10,168,182,
Beckham,Insurance Commissioner,Bill Viner,REP,50235,1,2,68,71,
Beckham,Insurance Commissioner,John Doak,REP,50235,6,5,143,154,
Beckham,Corporation Commissioner,Todd Hiett,REP,50235,3,7,121,131,
Beckham,Corporation Commissioner,Cliff Branan,REP,50235,4,1,90,95,
Beckham,U.S. Senate,Evelyn Rogers,REP,50235,0,0,8,8,
Beckham,U.S. Senate,Rob Moye,REP,50235,1,0,6,7,
Beckham,U.S. Senate,D. Jean Mcbride-Samuels,REP,50235,0,0,4,4,
Beckham,U.S. Senate,Jim Inhofe,REP,50235,6,10,194,210,
Beckham,U.S. Senate,Erick Paul Wyatt,REP,50235,1,0,9,10,
Beckham,U.S. Senate,Andy Craig,REP,50235,0,0,3,3,
Beckham,U.S. Senate,T. Shannon,REP,50235,1,2,80,83,
Beckham,U.S. Senate,Randy Brogdon,REP,50235,0,0,4,4,
Beckham,U.S. Senate,Eric Mccray,REP,50235,0,0,5,5,
Beckham,U.S. Senate,Kevin Crow,REP,50235,0,0,1,1,
Beckham,U.S. Senate,James Lankford,REP,50235,6,10,130,146,
Beckham,U.S. Senate,Jason Weger,REP,50235,1,0,1,2,
Beckham,U.S. House,Timothy Ray Murray,REP,50235,0,0,11,11,03
Beckham,U.S. House,Robert Hubbard,REP,50235,0,1,22,23,03
Beckham,U.S. House,Frank Lucas,REP,50235,8,10,191,209,03
Beckham,State Senate,Darcy Jech,REP,50235,3,4,81,88,26
Beckham,State Senate,Dan Gambill,REP,50235,5,6,143,154,26
Beckham,Superintendent of Public Instruction,John Cox,DEM,50242,2,2,23,27,
Beckham,Superintendent of Public Instruction,Jack Jr.,DEM,50242,0,0,5,5,
Beckham,Superintendent of Public Instruction,Ivan Holmes,DEM,50242,0,0,3,3,
Beckham,Superintendent of Public Instruction,Freda Deskin,DEM,50242,0,0,11,11,
Beckham,U.S. Senate,Patrick Michael Hayes,DEM,50242,0,0,11,11,
Beckham,U.S. Senate,Jim Rogers,DEM,50242,0,2,19,21,
Beckham,U.S. Senate,Connie Johnson,DEM,50242,2,0,11,13,
Beckham,Governor,Dax Ewbank,REP,50242,0,0,3,3,
Beckham,Governor,Chad Moody,REP,50242,0,0,8,8,
Beckham,Governor,Mary Fallin,REP,50242,3,1,21,25,
Beckham,Superintendent of Public Instruction,Brian Kelly,REP,50242,0,0,5,5,
Beckham,Superintendent of Public Instruction,Janet Costello Barresi,REP,50242,0,0,2,2,
Beckham,Superintendent of Public Instruction,Joy Hofmeister,REP,50242,3,1,25,29,
Beckham,Insurance Commissioner,Bill Viner,REP,50242,0,0,3,3,
Beckham,Insurance Commissioner,John Doak,REP,50242,3,1,27,31,
Beckham,Corporation Commissioner,Todd Hiett,REP,50242,1,1,18,20,
Beckham,Corporation Commissioner,Cliff Branan,REP,50242,2,0,13,15,
Beckham,U.S. Senate,Evelyn Rogers,REP,50242,0,0,1,1,
Beckham,U.S. Senate,Rob Moye,REP,50242,0,0,2,2,
Beckham,U.S. Senate,D. Jean Mcbride-Samuels,REP,50242,0,0,0,0,
Beckham,U.S. Senate,Jim Inhofe,REP,50242,3,1,28,32,
Beckham,U.S. Senate,Erick Paul Wyatt,REP,50242,0,0,1,1,
Beckham,U.S. Senate,Andy Craig,REP,50242,0,0,1,1,
Beckham,U.S. Senate,T. Shannon,REP,50242,0,0,15,15,
Beckham,U.S. Senate,Randy Brogdon,REP,50242,0,0,0,0,
Beckham,U.S. Senate,Eric Mccray,REP,50242,0,0,0,0,
Beckham,U.S. Senate,Kevin Crow,REP,50242,0,0,0,0,
Beckham,U.S. Senate,James Lankford,REP,50242,3,1,16,20,
Beckham,U.S. Senate,Jason Weger,REP,50242,0,0,0,0,
Beckham,U.S. House,Timothy Ray Murray,REP,50242,0,0,0,0,03
Beckham,U.S. House,Robert Hubbard,REP,50242,0,0,1,1,03
Beckham,U.S. House,Frank Lucas,REP,50242,3,1,31,35,03
Beckham,State Senate,Darcy Jech,REP,50242,0,1,15,16,26
Beckham,State Senate,Dan Gambill,REP,50242,3,0,16,19,26
Beckham,Superintendent of Public Instruction,John Cox,DEM,50320,1,0,30,31,
Beckham,Superintendent of Public Instruction,Jack Jr.,DEM,50320,0,0,11,11,
Beckham,Superintendent of Public Instruction,Ivan Holmes,DEM,50320,0,0,3,3,
Beckham,Superintendent of Public Instruction,Freda Deskin,DEM,50320,1,0,19,20,
Beckham,U.S. Senate,Patrick Michael Hayes,DEM,50320,0,0,17,17,
Beckham,U.S. Senate,Jim Rogers,DEM,50320,2,0,26,28,
Beckham,U.S. Senate,Connie Johnson,DEM,50320,0,0,14,14,
Beckham,Governor,Dax Ewbank,REP,50320,1,0,9,10,
Beckham,Governor,Chad Moody,REP,50320,0,0,7,7,
Beckham,Governor,Mary Fallin,REP,50320,0,2,40,42,
Beckham,Superintendent of Public Instruction,Brian Kelly,REP,50320,0,0,10,10,
Beckham,Superintendent of Public Instruction,Janet Costello Barresi,REP,50320,0,0,5,5,
Beckham,Superintendent of Public Instruction,Joy Hofmeister,REP,50320,1,2,41,44,
Beckham,Insurance Commissioner,Bill Viner,REP,50320,0,2,14,16,
Beckham,Insurance Commissioner,John Doak,REP,50320,1,0,39,40,
Beckham,Corporation Commissioner,Todd Hiett,REP,50320,1,1,24,26,
Beckham,Corporation Commissioner,Cliff Branan,REP,50320,0,1,29,30,
Beckham,U.S. Senate,Evelyn Rogers,REP,50320,0,0,4,4,
Beckham,U.S. Senate,Rob Moye,REP,50320,0,0,0,0,
Beckham,U.S. Senate,D. Jean Mcbride-Samuels,REP,50320,0,0,0,0,
Beckham,U.S. Senate,Jim Inhofe,REP,50320,1,2,45,48,
Beckham,U.S. Senate,Erick Paul Wyatt,REP,50320,0,0,6,6,
Beckham,U.S. Senate,Andy Craig,REP,50320,0,0,2,2,
Beckham,U.S. Senate,T. Shannon,REP,50320,0,1,25,26,
Beckham,U.S. Senate,Randy Brogdon,REP,50320,0,0,0,0,
Beckham,U.S. Senate,Eric Mccray,REP,50320,0,0,0,0,
Beckham,U.S. Senate,Kevin Crow,REP,50320,0,0,1,1,
Beckham,U.S. Senate,James Lankford,REP,50320,0,1,28,29,
Beckham,U.S. Senate,Jason Weger,REP,50320,1,0,0,1,
Beckham,U.S. House,Timothy Ray Murray,REP,50320,1,0,5,6,03
Beckham,U.S. House,Robert Hubbard,REP,50320,0,0,7,7,03
Beckham,U.S. House,Frank Lucas,REP,50320,0,2,44,46,03
Beckham,State Senate,Darcy Jech,REP,50320,0,0,30,30,26
Beckham,State Senate,Dan Gambill,REP,50320,1,2,26,29,26
Beckham,Superintendent of Public Instruction,John Cox,DEM,50330,0,0,13,13,
Beckham,Superintendent of Public Instruction,Jack Jr.,DEM,50330,0,0,2,2,
Beckham,Superintendent of Public Instruction,Ivan Holmes,DEM,50330,0,0,0,0,
Beckham,Superintendent of Public Instruction,Freda Deskin,DEM,50330,0,1,12,13,
Beckham,U.S. Senate,Patrick Michael Hayes,DEM,50330,0,0,6,6,
Beckham,U.S. Senate,Jim Rogers,DEM,50330,0,0,12,12,
Beckham,U.S. Senate,Connie Johnson,DEM,50330,0,1,7,8,
Beckham,Governor,Dax Ewbank,REP,50330,0,1,11,12,
Beckham,Governor,Chad Moody,REP,50330,2,1,9,12,
Beckham,Governor,Mary Fallin,REP,50330,0,3,48,51,
Beckham,Superintendent of Public Instruction,Brian Kelly,REP,50330,0,0,7,7,
Beckham,Superintendent of Public Instruction,Janet Costello Barresi,REP,50330,0,0,11,11,
Beckham,Superintendent of Public Instruction,Joy Hofmeister,REP,50330,2,5,50,57,
Beckham,Insurance Commissioner,Bill Viner,REP,50330,0,0,12,12,
Beckham,Insurance Commissioner,John Doak,REP,50330,2,4,47,53,
Beckham,Corporation Commissioner,Todd Hiett,REP,50330,2,3,32,37,
Beckham,Corporation Commissioner,Cliff Branan,REP,50330,0,1,32,33,
Beckham,U.S. Senate,Evelyn Rogers,REP,50330,0,0,1,1,
Beckham,U.S. Senate,Rob Moye,REP,50330,0,0,0,0,
Beckham,U.S. Senate,D. Jean Mcbride-Samuels,REP,50330,0,0,0,0,
Beckham,U.S. Senate,Jim Inhofe,REP,50330,2,5,65,72,
Beckham,U.S. Senate,Erick Paul Wyatt,REP,50330,0,0,0,0,
Beckham,U.S. Senate,Andy Craig,REP,50330,0,0,0,0,
Beckham,U.S. Senate,T. Shannon,REP,50330,2,2,23,27,
Beckham,U.S. Senate,Randy Brogdon,REP,50330,0,0,0,0,
Beckham,U.S. Senate,Eric Mccray,REP,50330,0,0,0,0,
Beckham,U.S. Senate,Kevin Crow,REP,50330,0,0,1,1,
Beckham,U.S. Senate,James Lankford,REP,50330,0,3,44,47,
Beckham,U.S. Senate,Jason Weger,REP,50330,0,0,0,0,
Beckham,U.S. House,Timothy Ray Murray,REP,50330,0,0,2,2,03
Beckham,U.S. House,Robert Hubbard,REP,50330,0,0,2,2,03
Beckham,U.S. House,Frank Lucas,REP,50330,2,5,62,69,03
Beckham,State Senate,Darcy Jech,REP,50330,2,1,26,29,26
Beckham,State Senate,Dan Gambill,REP,50330,0,4,39,43,26
Beckham,Superintendent of Public Instruction,John Cox,DEM,50332,0,2,50,52,
Beckham,Superintendent of Public Instruction,Jack Jr.,DEM,50332,0,0,21,21,
Beckham,Superintendent of Public Instruction,Ivan Holmes,DEM,50332,0,0,17,17,
Beckham,Superintendent of Public Instruction,Freda Deskin,DEM,50332,1,0,41,42,
Beckham,U.S. Senate,Patrick Michael Hayes,DEM,50332,0,0,23,23,
Beckham,U.S. Senate,Jim Rogers,DEM,50332,0,0,57,57,
Beckham,U.S. Senate,Connie Johnson,DEM,50332,1,1,44,46,
Beckham,Governor,Dax Ewbank,REP,50332,3,1,22,26,
Beckham,Governor,Chad Moody,REP,50332,0,3,52,55,
Beckham,Governor,Mary Fallin,REP,50332,8,6,138,152,
Beckham,Superintendent of Public Instruction,Brian Kelly,REP,50332,0,1,26,27,
Beckham,Superintendent of Public Instruction,Janet Costello Barresi,REP,50332,0,0,24,24,
Beckham,Superintendent of Public Instruction,Joy Hofmeister,REP,50332,9,11,164,184,
Beckham,Insurance Commissioner,Bill Viner,REP,50332,1,0,32,33,
Beckham,Insurance Commissioner,John Doak,REP,50332,8,6,166,180,
Beckham,Corporation Commissioner,Todd Hiett,REP,50332,3,4,94,101,
Beckham,Corporation Commissioner,Cliff Branan,REP,50332,6,3,105,114,
Beckham,U.S. Senate,Evelyn Rogers,REP,50332,0,0,5,5,
Beckham,U.S. Senate,Rob Moye,REP,50332,0,0,4,4,
Beckham,U.S. Senate,D. Jean Mcbride-Samuels,REP,50332,0,0,2,2,
Beckham,U.S. Senate,Jim Inhofe,REP,50332,11,12,186,209,
Beckham,U.S. Senate,Erick Paul Wyatt,REP,50332,0,0,11,11,
Beckham,U.S. Senate,Andy Craig,REP,50332,0,0,1,1,
Beckham,U.S. Senate,T. Shannon,REP,50332,3,2,59,64,
Beckham,U.S. Senate,Randy Brogdon,REP,50332,0,0,2,2,
Beckham,U.S. Senate,Eric Mccray,REP,50332,0,0,2,2,
Beckham,U.S. Senate,Kevin Crow,REP,50332,0,0,4,4,
Beckham,U.S. Senate,James Lankford,REP,50332,8,10,146,164,
Beckham,U.S. Senate,Jason Weger,REP,50332,0,0,0,0,
Beckham,U.S. House,Timothy Ray Murray,REP,50332,0,0,6,6,03
Beckham,U.S. House,Robert Hubbard,REP,50332,0,0,23,23,03
Beckham,U.S. House,Frank Lucas,REP,50332,11,11,183,205,03
Beckham,State Senate,Darcy Jech,REP,50332,5,6,91,102,26
Beckham,State Senate,Dan Gambill,REP,50332,6,4,120,130,26
Beckham,Superintendent of Public Instruction,John Cox,DEM,50333,2,1,35,38,
Beckham,Superintendent of Public Instruction,Jack Jr.,DEM,50333,0,0,24,24,
Beckham,Superintendent of Public Instruction,Ivan Holmes,DEM,50333,1,0,10,11,
Beckham,Superintendent of Public Instruction,Freda Deskin,DEM,50333,2,0,42,44,
Beckham,U.S. Senate,Patrick Michael Hayes,DEM,50333,1,0,23,24,
Beckham,U.S. Senate,Jim Rogers,DEM,50333,2,1,41,44,
Beckham,U.S. Senate,Connie Johnson,DEM,50333,2,0,45,47,
Beckham,Governor,Dax Ewbank,REP,50333,3,0,13,16,
Beckham,Governor,Chad Moody,REP,50333,1,3,37,41,
Beckham,Governor,Mary Fallin,REP,50333,3,4,95,102,
Beckham,Superintendent of Public Instruction,Brian Kelly,REP,50333,0,1,32,33,
Beckham,Superintendent of Public Instruction,Janet Costello Barresi,REP,50333,0,0,14,14,
Beckham,Superintendent of Public Instruction,Joy Hofmeister,REP,50333,7,6,98,111,
Beckham,Insurance Commissioner,Bill Viner,REP,50333,0,2,40,42,
Beckham,Insurance Commissioner,John Doak,REP,50333,7,5,95,107,
Beckham,Corporation Commissioner,Todd Hiett,REP,50333,3,3,79,85,
Beckham,Corporation Commissioner,Cliff Branan,REP,50333,4,4,58,66,
Beckham,U.S. Senate,Evelyn Rogers,REP,50333,1,0,7,8,
Beckham,U.S. Senate,Rob Moye,REP,50333,0,0,3,3,
Beckham,U.S. Senate,D. Jean Mcbride-Samuels,REP,50333,0,0,0,0,
Beckham,U.S. Senate,Jim Inhofe,REP,50333,6,7,129,142,
Beckham,U.S. Senate,Erick Paul Wyatt,REP,50333,0,0,6,6,
Beckham,U.S. Senate,Andy Craig,REP,50333,0,0,0,0,
Beckham,U.S. Senate,T. Shannon,REP,50333,4,0,46,50,
Beckham,U.S. Senate,Randy Brogdon,REP,50333,0,0,4,4,
Beckham,U.S. Senate,Eric Mccray,REP,50333,0,0,2,2,
Beckham,U.S. Senate,Kevin Crow,REP,50333,0,0,3,3,
Beckham,U.S. Senate,James Lankford,REP,50333,3,7,92,102,
Beckham,U.S. Senate,Jason Weger,REP,50333,0,0,0,0,
Beckham,U.S. House,Timothy Ray Murray,REP,50333,0,1,4,5,03
Beckham,U.S. House,Robert Hubbard,REP,50333,0,1,13,14,03
Beckham,U.S. House,Frank Lucas,REP,50333,7,5,129,141,03
Beckham,State Senate,Darcy Jech,REP,50333,3,4,66,73,26
Beckham,State Senate,Dan Gambill,REP,50333,4,3,79,86,26
Beckham,Superintendent of Public Instruction,John Cox,DEM,50343,0,2,9,11,
Beckham,Superintendent of Public Instruction,Jack Jr.,DEM,50343,0,0,3,3,
Beckham,Superintendent of Public Instruction,Ivan Holmes,DEM,50343,0,0,6,6,
Beckham,Superintendent of Public Instruction,Freda Deskin,DEM,50343,1,4,12,17,
Beckham,U.S. Senate,Patrick Michael Hayes,DEM,50343,0,1,7,8,
Beckham,U.S. Senate,Jim Rogers,DEM,50343,0,3,14,17,
Beckham,U.S. Senate,Connie Johnson,DEM,50343,1,2,9,12,
Beckham,Governor,Dax Ewbank,REP,50343,0,0,3,3,
Beckham,Governor,Chad Moody,REP,50343,0,1,4,5,
Beckham,Governor,Mary Fallin,REP,50343,0,3,16,19,
Beckham,Superintendent of Public Instruction,Brian Kelly,REP,50343,0,4,6,10,
Beckham,Superintendent of Public Instruction,Janet Costello Barresi,REP,50343,0,0,1,1,
Beckham,Superintendent of Public Instruction,Joy Hofmeister,REP,50343,0,0,16,16,
Beckham,Insurance Commissioner,Bill Viner,REP,50343,0,0,3,3,
Beckham,Insurance Commissioner,John Doak,REP,50343,0,4,19,23,
Beckham,Corporation Commissioner,Todd Hiett,REP,50343,0,1,9,10,
Beckham,Corporation Commissioner,Cliff Branan,REP,50343,0,3,14,17,
Beckham,U.S. Senate,Evelyn Rogers,REP,50343,0,0,0,0,
Beckham,U.S. Senate,Rob Moye,REP,50343,0,0,2,2,
Beckham,U.S. Senate,D. Jean Mcbride-Samuels,REP,50343,0,0,0,0,
Beckham,U.S. Senate,Jim Inhofe,REP,50343,0,4,20,24,
Beckham,U.S. Senate,Erick Paul Wyatt,REP,50343,0,0,1,1,
Beckham,U.S. Senate,Andy Craig,REP,50343,0,0,0,0,
Beckham,U.S. Senate,T. Shannon,REP,50343,0,0,7,7,
Beckham,U.S. Senate,Randy Brogdon,REP,50343,0,0,0,0,
Beckham,U.S. Senate,Eric Mccray,REP,50343,0,0,0,0,
Beckham,U.S. Senate,Kevin Crow,REP,50343,0,0,1,1,
Beckham,U.S. Senate,James Lankford,REP,50343,0,4,15,19,
Beckham,U.S. Senate,Jason Weger,REP,50343,0,0,0,0,
Beckham,U.S. House,Timothy Ray Murray,REP,50343,0,0,1,1,03
Beckham,U.S. House,Robert Hubbard,REP,50343,0,0,1,1,03
Beckham,U.S. House,Frank Lucas,REP,50343,0,4,21,25,03
Beckham,State Senate,Darcy Jech,REP,50343,0,0,9,9,26
Beckham,State Senate,Dan Gambill,REP,50343,0,4,14,18,26
Blaine,Superintendent of Public Instruction,John Cox,DEM,60002,0,0,26,26,
Blaine,Superintendent of Public Instruction,Jack Jr.,DEM,60002,1,0,5,6,
Blaine,Superintendent of Public Instruction,Ivan Holmes,DEM,60002,0,0,7,7,
Blaine,Superintendent of Public Instruction,Freda Deskin,DEM,60002,0,0,25,25,
Blaine,U.S. Senate,Patrick Michael Hayes,DEM,60002,0,0,19,19,
Blaine,U.S. Senate,Jim Rogers,DEM,60002,1,0,19,20,
Blaine,U.S. Senate,Connie Johnson,DEM,60002,0,0,25,25,
Blaine,Governor,Dax Ewbank,REP,60002,2,2,49,53,
Blaine,Governor,Chad Moody,REP,60002,0,0,27,27,
Blaine,Governor,Mary Fallin,REP,60002,2,3,125,130,
Blaine,Superintendent of Public Instruction,Brian Kelly,REP,60002,3,3,49,55,
Blaine,Superintendent of Public Instruction,Janet Costello Barresi,REP,60002,0,0,22,22,
Blaine,Superintendent of Public Instruction,Joy Hofmeister,REP,60002,1,2,130,133,
Blaine,Insurance Commissioner,Bill Viner,REP,60002,1,0,22,23,
Blaine,Insurance Commissioner,John Doak,REP,60002,3,5,171,179,
Blaine,Corporation Commissioner,Todd Hiett,REP,60002,3,4,115,122,
Blaine,Corporation Commissioner,Cliff Branan,REP,60002,1,1,79,81,
Blaine,U.S. Senate,Evelyn Rogers,REP,60002,0,0,9,9,
Blaine,U.S. Senate,Rob Moye,REP,60002,0,0,4,4,
Blaine,U.S. Senate,D. Jean Mcbride-Samuels,REP,60002,0,0,2,2,
Blaine,U.S. Senate,Jim Inhofe,REP,60002,4,5,178,187,
Blaine,U.S. Senate,Erick Paul Wyatt,REP,60002,0,0,8,8,
Blaine,U.S. Senate,Andy Craig,REP,60002,0,0,0,0,
Blaine,U.S. Senate,T. Shannon,REP,60002,0,1,86,87,
Blaine,U.S. Senate,Randy Brogdon,REP,60002,2,0,4,6,
Blaine,U.S. Senate,Eric Mccray,REP,60002,0,0,2,2,
Blaine,U.S. Senate,Kevin Crow,REP,60002,0,0,2,2,
Blaine,U.S. Senate,James Lankford,REP,60002,2,4,109,115,
Blaine,U.S. Senate,Jason Weger,REP,60002,0,0,0,0,
Blaine,U.S. House,Timothy Ray Murray,REP,60002,1,0,6,7,03
Blaine,U.S. House,Robert Hubbard,REP,60002,1,1,21,23,03
Blaine,U.S. House,Frank Lucas,REP,60002,2,4,175,181,03
Blaine,State Senate,Darcy Jech,REP,60002,2,4,120,126,26
Blaine,State Senate,Dan Gambill,REP,60002,2,1,83,86,26
Blaine,Superintendent of Public Instruction,John Cox,DEM,60007,0,0,30,30,
Blaine,Superintendent of Public Instruction,Jack Jr.,DEM,60007,0,0,4,4,
Blaine,Superintendent of Public Instruction,Ivan Holmes,DEM,60007,0,0,3,3,
Blaine,Superintendent of Public Instruction,Freda Deskin,DEM,60007,0,0,21,21,
Blaine,U.S. Senate,Patrick Michael Hayes,DEM,60007,0,0,13,13,
Blaine,U.S. Senate,Jim Rogers,DEM,60007,0,0,23,23,
Blaine,U.S. Senate,Connie Johnson,DEM,60007,0,0,21,21,
Blaine,Governor,Dax Ewbank,REP,60007,1,4,65,70,
Blaine,Governor,Chad Moody,REP,60007,0,2,18,20,
Blaine,Governor,Mary Fallin,REP,60007,3,5,63,71,
Blaine,Superintendent of Public Instruction,Brian Kelly,REP,60007,1,2,40,43,
Blaine,Superintendent of Public Instruction,Janet Costello Barresi,REP,60007,1,1,11,13,
Blaine,Superintendent of Public Instruction,Joy Hofmeister,REP,60007,2,8,94,104,
Blaine,Insurance Commissioner,Bill Viner,REP,60007,0,1,26,27,
Blaine,Insurance Commissioner,John Doak,REP,60007,4,10,111,125,
Blaine,Corporation Commissioner,Todd Hiett,REP,60007,2,6,75,83,
Blaine,Corporation Commissioner,Cliff Branan,REP,60007,1,5,66,72,
Blaine,U.S. Senate,Evelyn Rogers,REP,60007,0,0,11,11,
Blaine,U.S. Senate,Rob Moye,REP,60007,0,0,4,4,
Blaine,U.S. Senate,D. Jean Mcbride-Samuels,REP,60007,0,0,4,4,
Blaine,U.S. Senate,Jim Inhofe,REP,60007,4,8,113,125,
Blaine,U.S. Senate,Erick Paul Wyatt,REP,60007,0,3,9,12,
Blaine,U.S. Senate,Andy Craig,REP,60007,0,0,1,1,
Blaine,U.S. Senate,T. Shannon,REP,60007,2,5,66,73,
Blaine,U.S. Senate,Randy Brogdon,REP,60007,0,0,1,1,
Blaine,U.S. Senate,Eric Mccray,REP,60007,0,0,2,2,
Blaine,U.S. Senate,Kevin Crow,REP,60007,0,0,2,2,
Blaine,U.S. Senate,James Lankford,REP,60007,2,6,71,79,
Blaine,U.S. Senate,Jason Weger,REP,60007,0,0,1,1,
Blaine,U.S. House,Timothy Ray Murray,REP,60007,0,0,16,16,03
Blaine,U.S. House,Robert Hubbard,REP,60007,0,2,22,24,03
Blaine,U.S. House,Frank Lucas,REP,60007,4,8,105,117,03
Blaine,State Senate,Darcy Jech,REP,60007,0,7,67,74,26
Blaine,State Senate,Dan Gambill,REP,60007,4,4,73,81,26
Blaine,Superintendent of Public Instruction,John Cox,DEM,60010,0,0,15,15,
Blaine,Superintendent of Public Instruction,Jack Jr.,DEM,60010,0,0,5,5,
Blaine,Superintendent of Public Instruction,Ivan Holmes,DEM,60010,0,0,1,1,
Blaine,Superintendent of Public Instruction,Freda Deskin,DEM,60010,0,0,13,13,
Blaine,U.S. Senate,Patrick Michael Hayes,DEM,60010,0,0,11,11,
Blaine,U.S. Senate,Jim Rogers,DEM,60010,0,0,9,9,
Blaine,U.S. Senate,Connie Johnson,DEM,60010,0,0,12,12,
Blaine,Governor,Dax Ewbank,REP,60010,0,2,8,10,
Blaine,Governor,Chad Moody,REP,60010,0,1,15,16,
Blaine,Governor,Mary Fallin,REP,60010,0,6,55,61,
Blaine,Superintendent of Public Instruction,Brian Kelly,REP,60010,0,0,19,19,
Blaine,Superintendent of Public Instruction,Janet Costello Barresi,REP,60010,0,2,11,13,
Blaine,Superintendent of Public Instruction,Joy Hofmeister,REP,60010,0,6,48,54,
Blaine,Insurance Commissioner,Bill Viner,REP,60010,0,2,9,11,
Blaine,Insurance Commissioner,John Doak,REP,60010,0,6,68,74,
Blaine,Corporation Commissioner,Todd Hiett,REP,60010,0,6,33,39,
Blaine,Corporation Commissioner,Cliff Branan,REP,60010,0,2,42,44,
Blaine,U.S. Senate,Evelyn Rogers,REP,60010,0,0,0,0,
Blaine,U.S. Senate,Rob Moye,REP,60010,0,0,0,0,
Blaine,U.S. Senate,D. Jean Mcbride-Samuels,REP,60010,0,0,0,0,
Blaine,U.S. Senate,Jim Inhofe,REP,60010,0,8,72,80,
Blaine,U.S. Senate,Erick Paul Wyatt,REP,60010,0,0,4,4,
Blaine,U.S. Senate,Andy Craig,REP,60010,0,0,0,0,
Blaine,U.S. Senate,T. Shannon,REP,60010,0,2,26,28,
Blaine,U.S. Senate,Randy Brogdon,REP,60010,0,0,4,4,
Blaine,U.S. Senate,Eric Mccray,REP,60010,0,0,1,1,
Blaine,U.S. Senate,Kevin Crow,REP,60010,0,0,0,0,
Blaine,U.S. Senate,James Lankford,REP,60010,0,6,47,53,
Blaine,U.S. Senate,Jason Weger,REP,60010,0,0,0,0,
Blaine,U.S. House,Timothy Ray Murray,REP,60010,0,1,3,4,03
Blaine,U.S. House,Robert Hubbard,REP,60010,0,0,9,9,03
Blaine,U.S. House,Frank Lucas,REP,60010,0,7,66,73,03
Blaine,State Senate,Darcy Jech,REP,60010,0,3,32,35,26
Blaine,State Senate,Dan Gambill,REP,60010,0,6,46,52,26
Blaine,Superintendent of Public Instruction,John Cox,DEM,60011,0,2,11,13,
Blaine,Superintendent of Public Instruction,Jack Jr.,DEM,60011,0,1,4,5,
Blaine,Superintendent of Public Instruction,Ivan Holmes,DEM,60011,0,0,4,4,
Blaine,Superintendent of Public Instruction,Freda Deskin,DEM,60011,0,2,14,16,
Blaine,U.S. Senate,Patrick Michael Hayes,DEM,60011,0,1,7,8,
Blaine,U.S. Senate,Jim Rogers,DEM,60011,0,3,10,13,
Blaine,U.S. Senate,Connie Johnson,DEM,60011,0,1,15,16,
Blaine,Governor,Dax Ewbank,REP,60011,1,3,3,7,
Blaine,Governor,Chad Moody,REP,60011,0,1,4,5,
Blaine,Governor,Mary Fallin,REP,60011,0,9,27,36,
Blaine,Superintendent of Public Instruction,Brian Kelly,REP,60011,1,0,9,10,
Blaine,Superintendent of Public Instruction,Janet Costello Barresi,REP,60011,0,4,2,6,
Blaine,Superintendent of Public Instruction,Joy Hofmeister,REP,60011,0,8,23,31,
Blaine,Insurance Commissioner,Bill Viner,REP,60011,1,2,9,12,
Blaine,Insurance Commissioner,John Doak,REP,60011,0,10,25,35,
Blaine,Corporation Commissioner,Todd Hiett,REP,60011,0,5,15,20,
Blaine,Corporation Commissioner,Cliff Branan,REP,60011,1,7,19,27,
Blaine,U.S. Senate,Evelyn Rogers,REP,60011,0,1,1,2,
Blaine,U.S. Senate,Rob Moye,REP,60011,0,1,1,2,
Blaine,U.S. Senate,D. Jean Mcbride-Samuels,REP,60011,0,0,1,1,
Blaine,U.S. Senate,Jim Inhofe,REP,60011,1,10,28,39,
Blaine,U.S. Senate,Erick Paul Wyatt,REP,60011,0,0,3,3,
Blaine,U.S. Senate,Andy Craig,REP,60011,0,0,1,1,
Blaine,U.S. Senate,T. Shannon,REP,60011,0,4,11,15,
Blaine,U.S. Senate,Randy Brogdon,REP,60011,0,0,1,1,
Blaine,U.S. Senate,Eric Mccray,REP,60011,0,1,1,2,
Blaine,U.S. Senate,Kevin Crow,REP,60011,0,0,0,0,
Blaine,U.S. Senate,James Lankford,REP,60011,1,7,20,28,
Blaine,U.S. Senate,Jason Weger,REP,60011,0,0,0,0,
Blaine,U.S. House,Timothy Ray Murray,REP,60011,0,0,5,5,03
Blaine,U.S. House,Robert Hubbard,REP,60011,0,2,2,4,03
Blaine,U.S. House,Frank Lucas,REP,60011,1,11,27,39,03
Blaine,State Senate,Darcy Jech,REP,60011,0,8,17,25,26
Blaine,State Senate,Dan Gambill,REP,60011,1,5,17,23,26
Blaine,Superintendent of Public Instruction,John Cox,DEM,60012,3,10,49,62,
Blaine,Superintendent of Public Instruction,Jack Jr.,DEM,60012,0,2,19,21,
Blaine,Superintendent of Public Instruction,Ivan Holmes,DEM,60012,0,2,9,11,
Blaine,Superintendent of Public Instruction,Freda Deskin,DEM,60012,3,6,32,41,
Blaine,U.S. Senate,Patrick Michael Hayes,DEM,60012,2,3,21,26,
Blaine,U.S. Senate,Jim Rogers,DEM,60012,0,11,42,53,
Blaine,U.S. Senate,Connie Johnson,DEM,60012,4,6,40,50,
Blaine,Governor,Dax Ewbank,REP,60012,0,3,29,32,
Blaine,Governor,Chad Moody,REP,60012,0,3,28,31,
Blaine,Governor,Mary Fallin,REP,60012,10,33,193,236,
Blaine,Superintendent of Public Instruction,Brian Kelly,REP,60012,4,6,64,74,
Blaine,Superintendent of Public Instruction,Janet Costello Barresi,REP,60012,5,6,26,37,
Blaine,Superintendent of Public Instruction,Joy Hofmeister,REP,60012,0,26,155,181,
Blaine,Insurance Commissioner,Bill Viner,REP,60012,0,6,52,58,
Blaine,Insurance Commissioner,John Doak,REP,60012,10,32,183,225,
Blaine,Corporation Commissioner,Todd Hiett,REP,60012,7,24,126,157,
Blaine,Corporation Commissioner,Cliff Branan,REP,60012,2,14,110,126,
Blaine,U.S. Senate,Evelyn Rogers,REP,60012,0,2,8,10,
Blaine,U.S. Senate,Rob Moye,REP,60012,0,0,3,3,
Blaine,U.S. Senate,D. Jean Mcbride-Samuels,REP,60012,0,1,5,6,
Blaine,U.S. Senate,Jim Inhofe,REP,60012,9,36,214,259,
Blaine,U.S. Senate,Erick Paul Wyatt,REP,60012,0,0,13,13,
Blaine,U.S. Senate,Andy Craig,REP,60012,0,2,2,4,
Blaine,U.S. Senate,T. Shannon,REP,60012,0,5,82,87,
Blaine,U.S. Senate,Randy Brogdon,REP,60012,0,0,16,16,
Blaine,U.S. Senate,Eric Mccray,REP,60012,0,0,2,2,
Blaine,U.S. Senate,Kevin Crow,REP,60012,0,0,2,2,
Blaine,U.S. Senate,James Lankford,REP,60012,10,32,140,182,
Blaine,U.S. Senate,Jason Weger,REP,60012,0,0,3,3,
Blaine,U.S. House,Timothy Ray Murray,REP,60012,0,4,10,14,03
Blaine,U.S. House,Robert Hubbard,REP,60012,0,1,28,29,03
Blaine,U.S. House,Frank Lucas,REP,60012,10,34,207,251,03
Blaine,State Senate,Darcy Jech,REP,60012,8,24,108,140,26
Blaine,State Senate,Dan Gambill,REP,60012,2,15,133,150,26
Blaine,Superintendent of Public Instruction,John Cox,DEM,60016,0,2,7,9,
Blaine,Superintendent of Public Instruction,Jack Jr.,DEM,60016,0,1,0,1,
Blaine,Superintendent of Public Instruction,Ivan Holmes,DEM,60016,0,0,2,2,
Blaine,Superintendent of Public Instruction,Freda Deskin,DEM,60016,0,0,5,5,
Blaine,U.S. Senate,Patrick Michael Hayes,DEM,60016,0,0,1,1,
Blaine,U.S. Senate,Jim Rogers,DEM,60016,0,0,8,8,
Blaine,U.S. Senate,Connie Johnson,DEM,60016,0,3,3,6,
Blaine,Governor,Dax Ewbank,REP,60016,0,1,4,5,
Blaine,Governor,Chad Moody,REP,60016,0,0,7,7,
Blaine,Governor,Mary Fallin,REP,60016,1,4,40,45,
Blaine,Superintendent of Public Instruction,Brian Kelly,REP,60016,1,3,15,19,
Blaine,Superintendent of Public Instruction,Janet Costello Barresi,REP,60016,0,0,13,13,
Blaine,Superintendent of Public Instruction,Joy Hofmeister,REP,60016,0,2,23,25,
Blaine,Insurance Commissioner,Bill Viner,REP,60016,0,1,6,7,
Blaine,Insurance Commissioner,John Doak,REP,60016,1,4,41,46,
Blaine,Corporation Commissioner,Todd Hiett,REP,60016,1,1,24,26,
Blaine,Corporation Commissioner,Cliff Branan,REP,60016,0,3,22,25,
Blaine,U.S. Senate,Evelyn Rogers,REP,60016,0,0,1,1,
Blaine,U.S. Senate,Rob Moye,REP,60016,0,0,2,2,
Blaine,U.S. Senate,D. Jean Mcbride-Samuels,REP,60016,0,0,1,1,
Blaine,U.S. Senate,Jim Inhofe,REP,60016,1,5,42,48,
Blaine,U.S. Senate,Erick Paul Wyatt,REP,60016,0,0,2,2,
Blaine,U.S. Senate,Andy Craig,REP,60016,0,0,0,0,
Blaine,U.S. Senate,T. Shannon,REP,60016,0,2,20,22,
Blaine,U.S. Senate,Randy Brogdon,REP,60016,0,0,0,0,
Blaine,U.S. Senate,Eric Mccray,REP,60016,0,0,1,1,
Blaine,U.S. Senate,Kevin Crow,REP,60016,0,0,1,1,
Blaine,U.S. Senate,James Lankford,REP,60016,1,3,30,34,
Blaine,U.S. Senate,Jason Weger,REP,60016,0,0,0,0,
Blaine,U.S. House,Timothy Ray Murray,REP,60016,0,0,1,1,03
Blaine,U.S. House,Robert Hubbard,REP,60016,0,1,3,4,03
Blaine,U.S. House,Frank Lucas,REP,60016,1,4,48,53,03
Blaine,State Senate,Darcy Jech,REP,60016,0,5,21,26,26
Blaine,State Senate,Dan Gambill,REP,60016,1,0,30,31,26
Blaine,Superintendent of Public Instruction,John Cox,DEM,60017,0,3,29,32,
Blaine,Superintendent of Public Instruction,Jack Jr.,DEM,60017,0,1,9,10,
Blaine,Superintendent of Public Instruction,Ivan Holmes,DEM,60017,0,0,7,7,
Blaine,Superintendent of Public Instruction,Freda Deskin,DEM,60017,0,0,32,32,
Blaine,U.S. Senate,Patrick Michael Hayes,DEM,60017,0,0,18,18,
Blaine,U.S. Senate,Jim Rogers,DEM,60017,0,4,28,32,
Blaine,U.S. Senate,Connie Johnson,DEM,60017,0,0,31,31,
Blaine,Governor,Dax Ewbank,REP,60017,1,0,11,12,
Blaine,Governor,Chad Moody,REP,60017,1,0,14,15,
Blaine,Governor,Mary Fallin,REP,60017,0,1,66,67,
Blaine,Superintendent of Public Instruction,Brian Kelly,REP,60017,0,1,23,24,
Blaine,Superintendent of Public Instruction,Janet Costello Barresi,REP,60017,0,0,12,12,
Blaine,Superintendent of Public Instruction,Joy Hofmeister,REP,60017,2,0,58,60,
Blaine,Insurance Commissioner,Bill Viner,REP,60017,2,0,16,18,
Blaine,Insurance Commissioner,John Doak,REP,60017,0,1,74,75,
Blaine,Corporation Commissioner,Todd Hiett,REP,60017,0,0,41,41,
Blaine,Corporation Commissioner,Cliff Branan,REP,60017,2,1,49,52,
Blaine,U.S. Senate,Evelyn Rogers,REP,60017,0,0,8,8,
Blaine,U.S. Senate,Rob Moye,REP,60017,1,0,5,6,
Blaine,U.S. Senate,D. Jean Mcbride-Samuels,REP,60017,0,0,0,0,
Blaine,U.S. Senate,Jim Inhofe,REP,60017,1,1,71,73,
Blaine,U.S. Senate,Erick Paul Wyatt,REP,60017,0,0,10,10,
Blaine,U.S. Senate,Andy Craig,REP,60017,0,0,1,1,
Blaine,U.S. Senate,T. Shannon,REP,60017,0,1,25,26,
Blaine,U.S. Senate,Randy Brogdon,REP,60017,0,0,1,1,
Blaine,U.S. Senate,Eric Mccray,REP,60017,0,0,1,1,
Blaine,U.S. Senate,Kevin Crow,REP,60017,0,0,2,2,
Blaine,U.S. Senate,James Lankford,REP,60017,2,0,61,63,
Blaine,U.S. Senate,Jason Weger,REP,60017,0,0,2,2,
Blaine,U.S. House,Timothy Ray Murray,REP,60017,1,0,10,11,03
Blaine,U.S. House,Robert Hubbard,REP,60017,0,0,12,12,03
Blaine,U.S. House,Frank Lucas,REP,60017,1,1,72,74,03
Blaine,State Senate,Darcy Jech,REP,60017,0,0,53,53,26
Blaine,State Senate,Dan Gambill,REP,60017,2,1,37,40,26
Blaine,Superintendent of Public Instruction,John Cox,DEM,60020,0,0,20,20,
Blaine,Superintendent of Public Instruction,Jack Jr.,DEM,60020,0,0,3,3,
Blaine,Superintendent of Public Instruction,Ivan Holmes,DEM,60020,0,0,4,4,
Blaine,Superintendent of Public Instruction,Freda Deskin,DEM,60020,0,0,16,16,
Blaine,U.S. Senate,Patrick Michael Hayes,DEM,60020,0,0,11,11,
Blaine,U.S. Senate,Jim Rogers,DEM,60020,0,0,18,18,
Blaine,U.S. Senate,Connie Johnson,DEM,60020,0,0,13,13,
Blaine,Governor,Dax Ewbank,REP,60020,2,0,4,6,
Blaine,Governor,Chad Moody,REP,60020,3,0,10,13,
Blaine,Governor,Mary Fallin,REP,60020,2,0,51,53,
Blaine,Superintendent of Public Instruction,Brian Kelly,REP,60020,0,0,8,8,
Blaine,Superintendent of Public Instruction,Janet Costello Barresi,REP,60020,1,0,3,4,
Blaine,Superintendent of Public Instruction,Joy Hofmeister,REP,60020,6,0,54,60,
Blaine,Insurance Commissioner,Bill Viner,REP,60020,0,0,16,16,
Blaine,Insurance Commissioner,John Doak,REP,60020,7,0,46,53,
Blaine,Corporation Commissioner,Todd Hiett,REP,60020,2,0,34,36,
Blaine,Corporation Commissioner,Cliff Branan,REP,60020,5,0,29,34,
Blaine,U.S. Senate,Evelyn Rogers,REP,60020,0,0,1,1,
Blaine,U.S. Senate,Rob Moye,REP,60020,0,0,1,1,
Blaine,U.S. Senate,D. Jean Mcbride-Samuels,REP,60020,0,0,1,1,
Blaine,U.S. Senate,Jim Inhofe,REP,60020,7,0,58,65,
Blaine,U.S. Senate,Erick Paul Wyatt,REP,60020,0,0,3,3,
Blaine,U.S. Senate,Andy Craig,REP,60020,0,0,0,0,
Blaine,U.S. Senate,T. Shannon,REP,60020,2,0,16,18,
Blaine,U.S. Senate,Randy Brogdon,REP,60020,0,0,0,0,
Blaine,U.S. Senate,Eric Mccray,REP,60020,0,0,0,0,
Blaine,U.S. Senate,Kevin Crow,REP,60020,0,0,1,1,
Blaine,U.S. Senate,James Lankford,REP,60020,5,0,46,51,
Blaine,U.S. Senate,Jason Weger,REP,60020,0,0,1,1,
Blaine,U.S. House,Timothy Ray Murray,REP,60020,0,0,0,0,03
Blaine,U.S. House,Robert Hubbard,REP,60020,0,0,4,4,03
Blaine,U.S. House,Frank Lucas,REP,60020,7,0,61,68,03
Blaine,State Senate,Darcy Jech,REP,60020,1,0,28,29,26
Blaine,State Senate,Dan Gambill,REP,60020,6,0,37,43,26
Blaine,Superintendent of Public Instruction,John Cox,DEM,60022,0,0,1,1,
Blaine,Superintendent of Public Instruction,Jack Jr.,DEM,60022,0,0,1,1,
Blaine,Superintendent of Public Instruction,Ivan Holmes,DEM,60022,0,0,2,2,
Blaine,Superintendent of Public Instruction,Freda Deskin,DEM,60022,0,0,4,4,
Blaine,U.S. Senate,Patrick Michael Hayes,DEM,60022,0,0,5,5,
Blaine,U.S. Senate,Jim Rogers,DEM,60022,0,0,3,3,
Blaine,U.S. Senate,Connie Johnson,DEM,60022,0,0,0,0,
Blaine,Governor,Dax Ewbank,REP,60022,0,0,9,9,
Blaine,Governor,Chad Moody,REP,60022,0,0,2,2,
Blaine,Governor,Mary Fallin,REP,60022,0,2,9,11,
Blaine,Superintendent of Public Instruction,Brian Kelly,REP,60022,0,0,0,0,
Blaine,Superintendent of Public Instruction,Janet Costello Barresi,REP,60022,0,1,0,1,
Blaine,Superintendent of Public Instruction,Joy Hofmeister,REP,60022,0,1,20,21,
Blaine,Insurance Commissioner,Bill Viner,REP,60022,0,0,5,5,
Blaine,Insurance Commissioner,John Doak,REP,60022,0,2,15,17,
Blaine,Corporation Commissioner,Todd Hiett,REP,60022,0,2,10,12,
Blaine,Corporation Commissioner,Cliff Branan,REP,60022,0,0,10,10,
Blaine,U.S. Senate,Evelyn Rogers,REP,60022,0,0,0,0,
Blaine,U.S. Senate,Rob Moye,REP,60022,0,0,0,0,
Blaine,U.S. Senate,D. Jean Mcbride-Samuels,REP,60022,0,0,0,0,
Blaine,U.S. Senate,Jim Inhofe,REP,60022,0,2,18,20,
Blaine,U.S. Senate,Erick Paul Wyatt,REP,60022,0,0,2,2,
Blaine,U.S. Senate,Andy Craig,REP,60022,0,0,0,0,
Blaine,U.S. Senate,T. Shannon,REP,60022,0,0,13,13,
Blaine,U.S. Senate,Randy Brogdon,REP,60022,0,0,2,2,
Blaine,U.S. Senate,Eric Mccray,REP,60022,0,0,0,0,
Blaine,U.S. Senate,Kevin Crow,REP,60022,0,0,0,0,
Blaine,U.S. Senate,James Lankford,REP,60022,0,2,3,5,
Blaine,U.S. Senate,Jason Weger,REP,60022,0,0,2,2,
Blaine,U.S. House,Timothy Ray Murray,REP,60022,0,0,0,0,03
Blaine,U.S. House,Robert Hubbard,REP,60022,0,0,4,4,03
Blaine,U.S. House,Frank Lucas,REP,60022,0,2,16,18,03
Blaine,State Senate,Darcy Jech,REP,60022,0,1,12,13,26
Blaine,State Senate,Dan Gambill,REP,60022,0,1,8,9,26
Bryan,Superintendent of Public Instruction,John Cox,DEM,70003,0,1,49,50,
Bryan,Superintendent of Public Instruction,Jack Jr.,DEM,70003,0,1,6,7,
Bryan,Superintendent of Public Instruction,Ivan Holmes,DEM,70003,1,0,3,4,
Bryan,Superintendent of Public Instruction,Freda Deskin,DEM,70003,0,3,39,42,
Bryan,U.S. Senate,Patrick Michael Hayes,DEM,70003,0,0,19,19,
Bryan,U.S. Senate,Jim Rogers,DEM,70003,1,1,34,36,
Bryan,U.S. Senate,Connie Johnson,DEM,70003,0,4,34,38,
Bryan,U.S. House,Earl Everett,DEM,70003,1,3,42,46,02
Bryan,U.S. House,Joshua Harris-Till,DEM,70003,0,2,43,45,02
Bryan,Governor,Dax Ewbank,REP,70003,0,0,5,5,
Bryan,Governor,Chad Moody,REP,70003,0,1,10,11,
Bryan,Governor,Mary Fallin,REP,70003,0,1,28,29,
Bryan,Superintendent of Public Instruction,Brian Kelly,REP,70003,0,0,9,9,
Bryan,Superintendent of Public Instruction,Janet Costello Barresi,REP,70003,0,0,10,10,
Bryan,Superintendent of Public Instruction,Joy Hofmeister,REP,70003,0,2,21,23,
Bryan,Insurance Commissioner,Bill Viner,REP,70003,0,0,8,8,
Bryan,Insurance Commissioner,John Doak,REP,70003,0,2,30,32,
Bryan,Corporation Commissioner,Todd Hiett,REP,70003,0,1,26,27,
Bryan,Corporation Commissioner,Cliff Branan,REP,70003,0,1,12,13,
Bryan,U.S. Senate,Evelyn Rogers,REP,70003,0,0,1,1,
Bryan,U.S. Senate,Rob Moye,REP,70003,0,0,3,3,
Bryan,U.S. Senate,D. Jean Mcbride-Samuels,REP,70003,0,0,0,0,
Bryan,U.S. Senate,Jim Inhofe,REP,70003,0,2,32,34,
Bryan,U.S. Senate,Erick Paul Wyatt,REP,70003,0,0,5,5,
Bryan,U.S. Senate,Andy Craig,REP,70003,0,0,0,0,
Bryan,U.S. Senate,T. Shannon,REP,70003,0,1,7,8,
Bryan,U.S. Senate,Randy Brogdon,REP,70003,0,0,1,1,
Bryan,U.S. Senate,Eric Mccray,REP,70003,0,0,0,0,
Bryan,U.S. Senate,Kevin Crow,REP,70003,0,0,5,5,
Bryan,U.S. Senate,James Lankford,REP,70003,0,1,27,28,
Bryan,U.S. Senate,Jason Weger,REP,70003,0,0,1,1,
Bryan,U.S. House,Darrel Robertson,REP,70003,0,2,12,14,02
Bryan,U.S. House,Markwayne Mullin,REP,70003,0,0,30,30,02
Bryan,Superintendent of Public Instruction,John Cox,DEM,70004,3,8,65,76,
Bryan,Superintendent of Public Instruction,Jack Jr.,DEM,70004,0,0,14,14,
Bryan,Superintendent of Public Instruction,Ivan Holmes,DEM,70004,1,0,5,6,
Bryan,Superintendent of Public Instruction,Freda Deskin,DEM,70004,2,3,55,60,
Bryan,U.S. Senate,Patrick Michael Hayes,DEM,70004,1,1,38,40,
Bryan,U.S. Senate,Jim Rogers,DEM,70004,2,4,51,57,
Bryan,U.S. Senate,Connie Johnson,DEM,70004,2,4,44,50,
Bryan,U.S. House,Earl Everett,DEM,70004,3,3,77,83,02
Bryan,U.S. House,Joshua Harris-Till,DEM,70004,2,5,53,60,02
Bryan,Governor,Dax Ewbank,REP,70004,0,0,9,9,
Bryan,Governor,Chad Moody,REP,70004,0,0,10,10,
Bryan,Governor,Mary Fallin,REP,70004,1,1,40,42,
Bryan,Superintendent of Public Instruction,Brian Kelly,REP,70004,1,0,9,10,
Bryan,Superintendent of Public Instruction,Janet Costello Barresi,REP,70004,0,0,14,14,
Bryan,Superintendent of Public Instruction,Joy Hofmeister,REP,70004,0,1,35,36,
Bryan,Insurance Commissioner,Bill Viner,REP,70004,0,0,10,10,
Bryan,Insurance Commissioner,John Doak,REP,70004,1,1,43,45,
Bryan,Corporation Commissioner,Todd Hiett,REP,70004,0,0,34,34,
Bryan,Corporation Commissioner,Cliff Branan,REP,70004,1,0,20,21,
Bryan,U.S. Senate,Evelyn Rogers,REP,70004,0,0,1,1,
Bryan,U.S. Senate,Rob Moye,REP,70004,0,0,0,0,
Bryan,U.S. Senate,D. Jean Mcbride-Samuels,REP,70004,0,0,1,1,
Bryan,U.S. Senate,Jim Inhofe,REP,70004,1,0,47,48,
Bryan,U.S. Senate,Erick Paul Wyatt,REP,70004,0,1,8,9,
Bryan,U.S. Senate,Andy Craig,REP,70004,0,0,0,0,
Bryan,U.S. Senate,T. Shannon,REP,70004,0,1,21,22,
Bryan,U.S. Senate,Randy Brogdon,REP,70004,0,0,7,7,
Bryan,U.S. Senate,Eric Mccray,REP,70004,0,0,1,1,
Bryan,U.S. Senate,Kevin Crow,REP,70004,0,0,1,1,
Bryan,U.S. Senate,James Lankford,REP,70004,1,0,25,26,
Bryan,U.S. Senate,Jason Weger,REP,70004,0,0,3,3,
Bryan,U.S. House,Darrel Robertson,REP,70004,0,0,24,24,02
Bryan,U.S. House,Markwayne Mullin,REP,70004,1,0,33,34,02
Bryan,Superintendent of Public Instruction,John Cox,DEM,70005,4,8,58,70,
Bryan,Superintendent of Public Instruction,Jack Jr.,DEM,70005,1,0,10,11,
Bryan,Superintendent of Public Instruction,Ivan Holmes,DEM,70005,0,0,4,4,
Bryan,Superintendent of Public Instruction,Freda Deskin,DEM,70005,0,2,36,38,
Bryan,U.S. Senate,Patrick Michael Hayes,DEM,70005,4,3,28,35,
Bryan,U.S. Senate,Jim Rogers,DEM,70005,0,4,38,42,
Bryan,U.S. Senate,Connie Johnson,DEM,70005,2,3,39,44,
Bryan,U.S. House,Earl Everett,DEM,70005,3,6,53,62,02
Bryan,U.S. House,Joshua Harris-Till,DEM,70005,2,4,47,53,02
Bryan,Governor,Dax Ewbank,REP,70005,1,0,13,14,
Bryan,Governor,Chad Moody,REP,70005,1,1,12,14,
Bryan,Governor,Mary Fallin,REP,70005,2,3,35,40,
Bryan,Superintendent of Public Instruction,Brian Kelly,REP,70005,2,1,18,21,
Bryan,Superintendent of Public Instruction,Janet Costello Barresi,REP,70005,0,2,8,10,
Bryan,Superintendent of Public Instruction,Joy Hofmeister,REP,70005,2,1,31,34,
Bryan,Insurance Commissioner,Bill Viner,REP,70005,0,1,7,8,
Bryan,Insurance Commissioner,John Doak,REP,70005,4,3,47,54,
Bryan,Corporation Commissioner,Todd Hiett,REP,70005,1,3,44,48,
Bryan,Corporation Commissioner,Cliff Branan,REP,70005,2,0,11,13,
Bryan,U.S. Senate,Evelyn Rogers,REP,70005,0,0,2,2,
Bryan,U.S. Senate,Rob Moye,REP,70005,1,0,1,2,
Bryan,U.S. Senate,D. Jean Mcbride-Samuels,REP,70005,0,1,1,2,
Bryan,U.S. Senate,Jim Inhofe,REP,70005,3,3,49,55,
Bryan,U.S. Senate,Erick Paul Wyatt,REP,70005,0,0,6,6,
Bryan,U.S. Senate,Andy Craig,REP,70005,0,0,1,1,
Bryan,U.S. Senate,T. Shannon,REP,70005,0,0,21,21,
Bryan,U.S. Senate,Randy Brogdon,REP,70005,1,0,7,8,
Bryan,U.S. Senate,Eric Mccray,REP,70005,0,1,0,1,
Bryan,U.S. Senate,Kevin Crow,REP,70005,0,0,2,2,
Bryan,U.S. Senate,James Lankford,REP,70005,1,3,27,31,
Bryan,U.S. Senate,Jason Weger,REP,70005,1,0,0,1,
Bryan,U.S. House,Darrel Robertson,REP,70005,1,0,20,21,02
Bryan,U.S. House,Markwayne Mullin,REP,70005,2,3,38,43,02
Bryan,Superintendent of Public Instruction,John Cox,DEM,70008,5,9,66,80,
Bryan,Superintendent of Public Instruction,Jack Jr.,DEM,70008,1,0,12,13,
Bryan,Superintendent of Public Instruction,Ivan Holmes,DEM,70008,0,0,2,2,
Bryan,Superintendent of Public Instruction,Freda Deskin,DEM,70008,3,0,42,45,
Bryan,U.S. Senate,Patrick Michael Hayes,DEM,70008,2,4,25,31,
Bryan,U.S. Senate,Jim Rogers,DEM,70008,0,4,58,62,
Bryan,U.S. Senate,Connie Johnson,DEM,70008,7,1,30,38,
Bryan,U.S. House,Earl Everett,DEM,70008,6,4,71,81,02
Bryan,U.S. House,Joshua Harris-Till,DEM,70008,3,4,37,44,02
Bryan,Governor,Dax Ewbank,REP,70008,0,0,9,9,
Bryan,Governor,Chad Moody,REP,70008,0,1,5,6,
Bryan,Governor,Mary Fallin,REP,70008,2,3,43,48,
Bryan,Superintendent of Public Instruction,Brian Kelly,REP,70008,0,2,17,19,
Bryan,Superintendent of Public Instruction,Janet Costello Barresi,REP,70008,1,0,9,10,
Bryan,Superintendent of Public Instruction,Joy Hofmeister,REP,70008,1,1,29,31,
Bryan,Insurance Commissioner,Bill Viner,REP,70008,1,1,14,16,
Bryan,Insurance Commissioner,John Doak,REP,70008,1,2,39,42,
Bryan,Corporation Commissioner,Todd Hiett,REP,70008,1,2,33,36,
Bryan,Corporation Commissioner,Cliff Branan,REP,70008,1,0,19,20,
Bryan,U.S. Senate,Evelyn Rogers,REP,70008,0,0,2,2,
Bryan,U.S. Senate,Rob Moye,REP,70008,0,0,1,1,
Bryan,U.S. Senate,D. Jean Mcbride-Samuels,REP,70008,0,0,2,2,
Bryan,U.S. Senate,Jim Inhofe,REP,70008,2,4,51,57,
Bryan,U.S. Senate,Erick Paul Wyatt,REP,70008,0,0,1,1,
Bryan,U.S. Senate,Andy Craig,REP,70008,0,0,0,0,
Bryan,U.S. Senate,T. Shannon,REP,70008,1,0,23,24,
Bryan,U.S. Senate,Randy Brogdon,REP,70008,0,1,2,3,
Bryan,U.S. Senate,Eric Mccray,REP,70008,0,1,1,2,
Bryan,U.S. Senate,Kevin Crow,REP,70008,0,0,2,2,
Bryan,U.S. Senate,James Lankford,REP,70008,1,2,29,32,
Bryan,U.S. Senate,Jason Weger,REP,70008,0,0,2,2,
Bryan,U.S. House,Darrel Robertson,REP,70008,0,2,23,25,02
Bryan,U.S. House,Markwayne Mullin,REP,70008,2,2,33,37,02
Bryan,Superintendent of Public Instruction,John Cox,DEM,70010,0,3,54,57,
Bryan,Superintendent of Public Instruction,Jack Jr.,DEM,70010,0,0,6,6,
Bryan,Superintendent of Public Instruction,Ivan Holmes,DEM,70010,0,0,3,3,
Bryan,Superintendent of Public Instruction,Freda Deskin,DEM,70010,0,2,16,18,
Bryan,U.S. Senate,Patrick Michael Hayes,DEM,70010,0,0,18,18,
Bryan,U.S. Senate,Jim Rogers,DEM,70010,0,4,41,45,
Bryan,U.S. Senate,Connie Johnson,DEM,70010,0,1,18,19,
Bryan,U.S. House,Earl Everett,DEM,70010,0,4,45,49,02
Bryan,U.S. House,Joshua Harris-Till,DEM,70010,0,1,31,32,02
Bryan,Governor,Dax Ewbank,REP,70010,0,0,4,4,
Bryan,Governor,Chad Moody,REP,70010,0,0,7,7,
Bryan,Governor,Mary Fallin,REP,70010,0,1,22,23,
Bryan,Superintendent of Public Instruction,Brian Kelly,REP,70010,0,0,14,14,
Bryan,Superintendent of Public Instruction,Janet Costello Barresi,REP,70010,0,1,4,5,
Bryan,Superintendent of Public Instruction,Joy Hofmeister,REP,70010,0,0,12,12,
Bryan,Insurance Commissioner,Bill Viner,REP,70010,0,1,12,13,
Bryan,Insurance Commissioner,John Doak,REP,70010,0,0,17,17,
Bryan,Corporation Commissioner,Todd Hiett,REP,70010,0,1,15,16,
Bryan,Corporation Commissioner,Cliff Branan,REP,70010,0,0,11,11,
Bryan,U.S. Senate,Evelyn Rogers,REP,70010,0,0,4,4,
Bryan,U.S. Senate,Rob Moye,REP,70010,0,0,0,0,
Bryan,U.S. Senate,D. Jean Mcbride-Samuels,REP,70010,0,0,1,1,
Bryan,U.S. Senate,Jim Inhofe,REP,70010,0,1,20,21,
Bryan,U.S. Senate,Erick Paul Wyatt,REP,70010,0,0,5,5,
Bryan,U.S. Senate,Andy Craig,REP,70010,0,0,2,2,
Bryan,U.S. Senate,T. Shannon,REP,70010,0,0,21,21,
Bryan,U.S. Senate,Randy Brogdon,REP,70010,0,0,0,0,
Bryan,U.S. Senate,Eric Mccray,REP,70010,0,0,1,1,
Bryan,U.S. Senate,Kevin Crow,REP,70010,0,1,0,1,
Bryan,U.S. Senate,James Lankford,REP,70010,0,0,7,7,
Bryan,U.S. Senate,Jason Weger,REP,70010,0,0,1,1,
Bryan,U.S. House,Darrel Robertson,REP,70010,0,0,10,10,02
Bryan,U.S. House,Markwayne Mullin,REP,70010,0,1,23,24,02
Bryan,Superintendent of Public Instruction,John Cox,DEM,70011,0,0,39,39,
Bryan,Superintendent of Public Instruction,Jack Jr.,DEM,70011,0,0,4,4,
Bryan,Superintendent of Public Instruction,Ivan Holmes,DEM,70011,0,0,4,4,
Bryan,Superintendent of Public Instruction,Freda Deskin,DEM,70011,1,1,17,19,
Bryan,U.S. Senate,Patrick Michael Hayes,DEM,70011,0,0,11,11,
Bryan,U.S. Senate,Jim Rogers,DEM,70011,0,1,23,24,
Bryan,U.S. Senate,Connie Johnson,DEM,70011,1,0,18,19,
Bryan,U.S. House,Earl Everett,DEM,70011,0,0,27,27,02
Bryan,U.S. House,Joshua Harris-Till,DEM,70011,1,0,27,28,02
Bryan,Governor,Dax Ewbank,REP,70011,0,0,3,3,
Bryan,Governor,Chad Moody,REP,70011,0,0,3,3,
Bryan,Governor,Mary Fallin,REP,70011,0,0,16,16,
Bryan,Superintendent of Public Instruction,Brian Kelly,REP,70011,0,0,6,6,
Bryan,Superintendent of Public Instruction,Janet Costello Barresi,REP,70011,0,0,3,3,
Bryan,Superintendent of Public Instruction,Joy Hofmeister,REP,70011,0,0,10,10,
Bryan,Insurance Commissioner,Bill Viner,REP,70011,0,0,6,6,
Bryan,Insurance Commissioner,John Doak,REP,70011,0,0,11,11,
Bryan,Corporation Commissioner,Todd Hiett,REP,70011,0,0,10,10,
Bryan,Corporation Commissioner,Cliff Branan,REP,70011,0,0,5,5,
Bryan,U.S. Senate,Evelyn Rogers,REP,70011,0,0,0,0,
Bryan,U.S. Senate,Rob Moye,REP,70011,0,0,1,1,
Bryan,U.S. Senate,D. Jean Mcbride-Samuels,REP,70011,0,0,1,1,
Bryan,U.S. Senate,Jim Inhofe,REP,70011,0,0,17,17,
Bryan,U.S. Senate,Erick Paul Wyatt,REP,70011,0,0,1,1,
Bryan,U.S. Senate,Andy Craig,REP,70011,0,0,0,0,
Bryan,U.S. Senate,T. Shannon,REP,70011,0,0,10,10,
Bryan,U.S. Senate,Randy Brogdon,REP,70011,0,0,0,0,
Bryan,U.S. Senate,Eric Mccray,REP,70011,0,0,0,0,
Bryan,U.S. Senate,Kevin Crow,REP,70011,0,0,1,1,
Bryan,U.S. Senate,James Lankford,REP,70011,0,0,8,8,
Bryan,U.S. Senate,Jason Weger,REP,70011,0,0,1,1,
Bryan,U.S. House,Darrel Robertson,REP,70011,0,0,4,4,02
Bryan,U.S. House,Markwayne Mullin,REP,70011,0,0,17,17,02
Bryan,Superintendent of Public Instruction,John Cox,DEM,70013,3,0,105,108,
Bryan,Superintendent of Public Instruction,Jack Jr.,DEM,70013,1,0,18,19,
Bryan,Superintendent of Public Instruction,Ivan Holmes,DEM,70013,0,0,10,10,
Bryan,Superintendent of Public Instruction,Freda Deskin,DEM,70013,0,1,47,48,
Bryan,U.S. Senate,Patrick Michael Hayes,DEM,70013,0,0,34,34,
Bryan,U.S. Senate,Jim Rogers,DEM,70013,2,0,92,94,
Bryan,U.S. Senate,Connie Johnson,DEM,70013,2,1,40,43,
Bryan,U.S. House,Earl Everett,DEM,70013,1,1,97,99,02
Bryan,U.S. House,Joshua Harris-Till,DEM,70013,3,0,64,67,02
Bryan,Governor,Dax Ewbank,REP,70013,0,0,2,2,
Bryan,Governor,Chad Moody,REP,70013,0,0,9,9,
Bryan,Governor,Mary Fallin,REP,70013,0,0,29,29,
Bryan,Superintendent of Public Instruction,Brian Kelly,REP,70013,0,0,16,16,
Bryan,Superintendent of Public Instruction,Janet Costello Barresi,REP,70013,0,0,4,4,
Bryan,Superintendent of Public Instruction,Joy Hofmeister,REP,70013,0,0,17,17,
Bryan,Insurance Commissioner,Bill Viner,REP,70013,0,0,8,8,
Bryan,Insurance Commissioner,John Doak,REP,70013,0,0,25,25,
Bryan,Corporation Commissioner,Todd Hiett,REP,70013,0,0,17,17,
Bryan,Corporation Commissioner,Cliff Branan,REP,70013,0,0,13,13,
Bryan,U.S. Senate,Evelyn Rogers,REP,70013,0,0,1,1,
Bryan,U.S. Senate,Rob Moye,REP,70013,0,0,2,2,
Bryan,U.S. Senate,D. Jean Mcbride-Samuels,REP,70013,0,0,1,1,
Bryan,U.S. Senate,Jim Inhofe,REP,70013,0,0,32,32,
Bryan,U.S. Senate,Erick Paul Wyatt,REP,70013,0,0,3,3,
Bryan,U.S. Senate,Andy Craig,REP,70013,0,0,0,0,
Bryan,U.S. Senate,T. Shannon,REP,70013,0,0,17,17,
Bryan,U.S. Senate,Randy Brogdon,REP,70013,0,0,2,2,
Bryan,U.S. Senate,Eric Mccray,REP,70013,0,0,0,0,
Bryan,U.S. Senate,Kevin Crow,REP,70013,0,0,1,1,
Bryan,U.S. Senate,James Lankford,REP,70013,0,0,17,17,
Bryan,U.S. Senate,Jason Weger,REP,70013,0,0,3,3,
Bryan,U.S. House,Darrel Robertson,REP,70013,0,0,11,11,02
Bryan,U.S. House,Markwayne Mullin,REP,70013,0,0,30,30,02
Bryan,Superintendent of Public Instruction,John Cox,DEM,70014,0,2,42,44,
Bryan,Superintendent of Public Instruction,Jack Jr.,DEM,70014,0,0,14,14,
Bryan,Superintendent of Public Instruction,Ivan Holmes,DEM,70014,0,0,10,10,
Bryan,Superintendent of Public Instruction,Freda Deskin,DEM,70014,0,0,20,20,
Bryan,U.S. Senate,Patrick Michael Hayes,DEM,70014,0,1,15,16,
Bryan,U.S. Senate,Jim Rogers,DEM,70014,0,0,43,43,
Bryan,U.S. Senate,Connie Johnson,DEM,70014,0,0,26,26,
Bryan,U.S. House,Earl Everett,DEM,70014,0,1,49,50,02
Bryan,U.S. House,Joshua Harris-Till,DEM,70014,0,0,33,33,02
Bryan,Governor,Dax Ewbank,REP,70014,0,0,2,2,
Bryan,Governor,Chad Moody,REP,70014,0,0,4,4,
Bryan,Governor,Mary Fallin,REP,70014,0,1,16,17,
Bryan,Superintendent of Public Instruction,Brian Kelly,REP,70014,0,0,6,6,
Bryan,Superintendent of Public Instruction,Janet Costello Barresi,REP,70014,0,1,6,7,
Bryan,Superintendent of Public Instruction,Joy Hofmeister,REP,70014,0,0,9,9,
Bryan,Insurance Commissioner,Bill Viner,REP,70014,0,1,6,7,
Bryan,Insurance Commissioner,John Doak,REP,70014,0,0,14,14,
Bryan,Corporation Commissioner,Todd Hiett,REP,70014,0,0,13,13,
Bryan,Corporation Commissioner,Cliff Branan,REP,70014,0,1,7,8,
Bryan,U.S. Senate,Evelyn Rogers,REP,70014,0,0,2,2,
Bryan,U.S. Senate,Rob Moye,REP,70014,0,0,0,0,
Bryan,U.S. Senate,D. Jean Mcbride-Samuels,REP,70014,0,0,0,0,
Bryan,U.S. Senate,Jim Inhofe,REP,70014,0,1,17,18,
Bryan,U.S. Senate,Erick Paul Wyatt,REP,70014,0,0,2,2,
Bryan,U.S. Senate,Andy Craig,REP,70014,0,0,1,1,
Bryan,U.S. Senate,T. Shannon,REP,70014,0,1,13,14,
Bryan,U.S. Senate,Randy Brogdon,REP,70014,0,0,0,0,
Bryan,U.S. Senate,Eric Mccray,REP,70014,0,0,0,0,
Bryan,U.S. Senate,Kevin Crow,REP,70014,0,0,0,0,
Bryan,U.S. Senate,James Lankford,REP,70014,0,0,7,7,
Bryan,U.S. Senate,Jason Weger,REP,70014,0,0,1,1,
Bryan,U.S. House,Darrel Robertson,REP,70014,0,0,6,6,02
Bryan,U.S. House,Markwayne Mullin,REP,70014,0,1,16,17,02
Bryan,Superintendent of Public Instruction,John Cox,DEM,70015,2,0,97,99,
Bryan,Superintendent of Public Instruction,Jack Jr.,DEM,70015,1,0,21,22,
Bryan,Superintendent of Public Instruction,Ivan Holmes,DEM,70015,1,0,12,13,
Bryan,Superintendent of Public Instruction,Freda Deskin,DEM,70015,1,1,57,59,
Bryan,U.S. Senate,Patrick Michael Hayes,DEM,70015,1,0,38,39,
Bryan,U.S. Senate,Jim Rogers,DEM,70015,3,0,92,95,
Bryan,U.S. Senate,Connie Johnson,DEM,70015,1,1,45,47,
Bryan,U.S. House,Earl Everett,DEM,70015,2,1,108,111,02
Bryan,U.S. House,Joshua Harris-Till,DEM,70015,2,0,65,67,02
Bryan,Governor,Dax Ewbank,REP,70015,0,1,10,11,
Bryan,Governor,Chad Moody,REP,70015,0,0,9,9,
Bryan,Governor,Mary Fallin,REP,70015,0,0,33,33,
Bryan,Superintendent of Public Instruction,Brian Kelly,REP,70015,0,0,20,20,
Bryan,Superintendent of Public Instruction,Janet Costello Barresi,REP,70015,0,0,8,8,
Bryan,Superintendent of Public Instruction,Joy Hofmeister,REP,70015,0,1,18,19,
Bryan,Insurance Commissioner,Bill Viner,REP,70015,0,0,17,17,
Bryan,Insurance Commissioner,John Doak,REP,70015,0,1,24,25,
Bryan,Corporation Commissioner,Todd Hiett,REP,70015,0,1,24,25,
Bryan,Corporation Commissioner,Cliff Branan,REP,70015,0,0,15,15,
Bryan,U.S. Senate,Evelyn Rogers,REP,70015,0,0,1,1,
Bryan,U.S. Senate,Rob Moye,REP,70015,0,0,2,2,
Bryan,U.S. Senate,D. Jean Mcbride-Samuels,REP,70015,0,0,0,0,
Bryan,U.S. Senate,Jim Inhofe,REP,70015,0,1,45,46,
Bryan,U.S. Senate,Erick Paul Wyatt,REP,70015,0,0,4,4,
Bryan,U.S. Senate,Andy Craig,REP,70015,0,0,0,0,
Bryan,U.S. Senate,T. Shannon,REP,70015,0,1,27,28,
Bryan,U.S. Senate,Randy Brogdon,REP,70015,0,0,8,8,
Bryan,U.S. Senate,Eric Mccray,REP,70015,0,0,0,0,
Bryan,U.S. Senate,Kevin Crow,REP,70015,0,0,2,2,
Bryan,U.S. Senate,James Lankford,REP,70015,0,0,12,12,
Bryan,U.S. Senate,Jason Weger,REP,70015,0,0,3,3,
Bryan,U.S. House,Darrel Robertson,REP,70015,0,0,25,25,02
Bryan,U.S. House,Markwayne Mullin,REP,70015,0,1,27,28,02
Bryan,Superintendent of Public Instruction,John Cox,DEM,70017,3,4,48,55,
Bryan,Superintendent of Public Instruction,Jack Jr.,DEM,70017,0,0,10,10,
Bryan,Superintendent of Public Instruction,Ivan Holmes,DEM,70017,0,0,8,8,
Bryan,Superintendent of Public Instruction,Freda Deskin,DEM,70017,0,1,31,32,
Bryan,U.S. Senate,Patrick Michael Hayes,DEM,70017,1,2,17,20,
Bryan,U.S. Senate,Jim Rogers,DEM,70017,2,1,49,52,
Bryan,U.S. Senate,Connie Johnson,DEM,70017,0,0,26,26,
Bryan,U.S. House,Earl Everett,DEM,70017,2,2,52,56,02
Bryan,U.S. House,Joshua Harris-Till,DEM,70017,1,1,38,40,02
Bryan,Governor,Dax Ewbank,REP,70017,0,0,2,2,
Bryan,Governor,Chad Moody,REP,70017,0,0,4,4,
Bryan,Governor,Mary Fallin,REP,70017,0,1,15,16,
Bryan,Superintendent of Public Instruction,Brian Kelly,REP,70017,0,1,8,9,
Bryan,Superintendent of Public Instruction,Janet Costello Barresi,REP,70017,0,0,6,6,
Bryan,Superintendent of Public Instruction,Joy Hofmeister,REP,70017,0,0,8,8,
Bryan,Insurance Commissioner,Bill Viner,REP,70017,0,1,3,4,
Bryan,Insurance Commissioner,John Doak,REP,70017,0,0,16,16,
Bryan,Corporation Commissioner,Todd Hiett,REP,70017,0,0,9,9,
Bryan,Corporation Commissioner,Cliff Branan,REP,70017,0,1,10,11,
Bryan,U.S. Senate,Evelyn Rogers,REP,70017,0,0,3,3,
Bryan,U.S. Senate,Rob Moye,REP,70017,0,0,1,1,
Bryan,U.S. Senate,D. Jean Mcbride-Samuels,REP,70017,0,0,0,0,
Bryan,U.S. Senate,Jim Inhofe,REP,70017,0,1,15,16,
Bryan,U.S. Senate,Erick Paul Wyatt,REP,70017,0,0,2,2,
Bryan,U.S. Senate,Andy Craig,REP,70017,0,0,1,1,
Bryan,U.S. Senate,T. Shannon,REP,70017,0,0,10,10,
Bryan,U.S. Senate,Randy Brogdon,REP,70017,0,0,1,1,
Bryan,U.S. Senate,Eric Mccray,REP,70017,0,0,0,0,
Bryan,U.S. Senate,Kevin Crow,REP,70017,0,1,0,1,
Bryan,U.S. Senate,James Lankford,REP,70017,0,0,7,7,
Bryan,U.S. Senate,Jason Weger,REP,70017,0,0,2,2,
Bryan,U.S. House,Darrel Robertson,REP,70017,0,0,3,3,02
Bryan,U.S. House,Markwayne Mullin,REP,70017,0,1,18,19,02
Bryan,Superintendent of Public Instruction,John Cox,DEM,70018,1,3,82,86,
Bryan,Superintendent of Public Instruction,Jack Jr.,DEM,70018,1,2,13,16,
Bryan,Superintendent of Public Instruction,Ivan Holmes,DEM,70018,1,0,6,7,
Bryan,Superintendent of Public Instruction,Freda Deskin,DEM,70018,3,1,33,37,
Bryan,U.S. Senate,Patrick Michael Hayes,DEM,70018,1,0,37,38,
Bryan,U.S. Senate,Jim Rogers,DEM,70018,2,4,64,70,
Bryan,U.S. Senate,Connie Johnson,DEM,70018,1,2,24,27,
Bryan,U.S. House,Earl Everett,DEM,70018,4,2,78,84,02
Bryan,U.S. House,Joshua Harris-Till,DEM,70018,1,4,41,46,02
Bryan,Governor,Dax Ewbank,REP,70018,0,0,5,5,
Bryan,Governor,Chad Moody,REP,70018,0,0,14,14,
Bryan,Governor,Mary Fallin,REP,70018,1,0,40,41,
Bryan,Superintendent of Public Instruction,Brian Kelly,REP,70018,0,0,12,12,
Bryan,Superintendent of Public Instruction,Janet Costello Barresi,REP,70018,1,0,8,9,
Bryan,Superintendent of Public Instruction,Joy Hofmeister,REP,70018,0,0,36,36,
Bryan,Insurance Commissioner,Bill Viner,REP,70018,1,0,23,24,
Bryan,Insurance Commissioner,John Doak,REP,70018,0,0,31,31,
Bryan,Corporation Commissioner,Todd Hiett,REP,70018,1,0,26,27,
Bryan,Corporation Commissioner,Cliff Branan,REP,70018,0,0,23,23,
Bryan,U.S. Senate,Evelyn Rogers,REP,70018,0,0,4,4,
Bryan,U.S. Senate,Rob Moye,REP,70018,0,0,0,0,
Bryan,U.S. Senate,D. Jean Mcbride-Samuels,REP,70018,0,0,3,3,
Bryan,U.S. Senate,Jim Inhofe,REP,70018,1,0,45,46,
Bryan,U.S. Senate,Erick Paul Wyatt,REP,70018,0,0,6,6,
Bryan,U.S. Senate,Andy Craig,REP,70018,0,0,0,0,
Bryan,U.S. Senate,T. Shannon,REP,70018,0,0,24,24,
Bryan,U.S. Senate,Randy Brogdon,REP,70018,0,0,3,3,
Bryan,U.S. Senate,Eric Mccray,REP,70018,0,0,1,1,
Bryan,U.S. Senate,Kevin Crow,REP,70018,0,0,3,3,
Bryan,U.S. Senate,James Lankford,REP,70018,1,0,19,20,
Bryan,U.S. Senate,Jason Weger,REP,70018,0,0,5,5,
Bryan,U.S. House,Darrel Robertson,REP,70018,0,0,20,20,02
Bryan,U.S. House,Markwayne Mullin,REP,70018,1,0,38,39,02
Bryan,Superintendent of Public Instruction,John Cox,DEM,70019,0,3,44,47,
Bryan,Superintendent of Public Instruction,Jack Jr.,DEM,70019,0,4,7,11,
Bryan,Superintendent of Public Instruction,Ivan Holmes,DEM,70019,0,0,4,4,
Bryan,Superintendent of Public Instruction,Freda Deskin,DEM,70019,0,3,29,32,
Bryan,U.S. Senate,Patrick Michael Hayes,DEM,70019,0,4,14,18,
Bryan,U.S. Senate,Jim Rogers,DEM,70019,0,1,52,53,
Bryan,U.S. Senate,Connie Johnson,DEM,70019,0,5,15,20,
Bryan,U.S. House,Earl Everett,DEM,70019,0,6,41,47,02
Bryan,U.S. House,Joshua Harris-Till,DEM,70019,0,4,38,42,02
Bryan,Governor,Dax Ewbank,REP,70019,0,0,6,6,
Bryan,Governor,Chad Moody,REP,70019,0,0,6,6,
Bryan,Governor,Mary Fallin,REP,70019,0,1,25,26,
Bryan,Superintendent of Public Instruction,Brian Kelly,REP,70019,0,0,13,13,
Bryan,Superintendent of Public Instruction,Janet Costello Barresi,REP,70019,0,0,8,8,
Bryan,Superintendent of Public Instruction,Joy Hofmeister,REP,70019,0,1,15,16,
Bryan,Insurance Commissioner,Bill Viner,REP,70019,0,0,9,9,
Bryan,Insurance Commissioner,John Doak,REP,70019,0,1,21,22,
Bryan,Corporation Commissioner,Todd Hiett,REP,70019,0,1,21,22,
Bryan,Corporation Commissioner,Cliff Branan,REP,70019,0,0,10,10,
Bryan,U.S. Senate,Evelyn Rogers,REP,70019,0,0,0,0,
Bryan,U.S. Senate,Rob Moye,REP,70019,0,0,1,1,
Bryan,U.S. Senate,D. Jean Mcbride-Samuels,REP,70019,0,0,0,0,
Bryan,U.S. Senate,Jim Inhofe,REP,70019,0,1,33,34,
Bryan,U.S. Senate,Erick Paul Wyatt,REP,70019,0,0,4,4,
Bryan,U.S. Senate,Andy Craig,REP,70019,0,0,0,0,
Bryan,U.S. Senate,T. Shannon,REP,70019,0,1,13,14,
Bryan,U.S. Senate,Randy Brogdon,REP,70019,0,0,1,1,
Bryan,U.S. Senate,Eric Mccray,REP,70019,0,0,1,1,
Bryan,U.S. Senate,Kevin Crow,REP,70019,0,0,0,0,
Bryan,U.S. Senate,James Lankford,REP,70019,0,0,20,20,
Bryan,U.S. Senate,Jason Weger,REP,70019,0,0,2,2,
Bryan,U.S. House,Darrel Robertson,REP,70019,0,0,10,10,02
Bryan,U.S. House,Markwayne Mullin,REP,70019,0,1,27,28,02
Bryan,Superintendent of Public Instruction,John Cox,DEM,70020,0,0,21,21,
Bryan,Superintendent of Public Instruction,Jack Jr.,DEM,70020,0,0,4,4,
Bryan,Superintendent of Public Instruction,Ivan Holmes,DEM,70020,0,0,1,1,
Bryan,Superintendent of Public Instruction,Freda Deskin,DEM,70020,2,0,29,31,
Bryan,U.S. Senate,Patrick Michael Hayes,DEM,70020,0,0,16,16,
Bryan,U.S. Senate,Jim Rogers,DEM,70020,0,0,26,26,
Bryan,U.S. Senate,Connie Johnson,DEM,70020,2,0,11,13,
Bryan,U.S. House,Earl Everett,DEM,70020,0,0,27,27,02
Bryan,U.S. House,Joshua Harris-Till,DEM,70020,2,0,24,26,02
Bryan,Governor,Dax Ewbank,REP,70020,0,0,6,6,
Bryan,Governor,Chad Moody,REP,70020,0,0,3,3,
Bryan,Governor,Mary Fallin,REP,70020,2,0,23,25,
Bryan,Superintendent of Public Instruction,Brian Kelly,REP,70020,0,0,12,12,
Bryan,Superintendent of Public Instruction,Janet Costello Barresi,REP,70020,0,0,3,3,
Bryan,Superintendent of Public Instruction,Joy Hofmeister,REP,70020,2,0,15,17,
Bryan,Insurance Commissioner,Bill Viner,REP,70020,0,0,8,8,
Bryan,Insurance Commissioner,John Doak,REP,70020,2,0,21,23,
Bryan,Corporation Commissioner,Todd Hiett,REP,70020,2,0,18,20,
Bryan,Corporation Commissioner,Cliff Branan,REP,70020,0,0,10,10,
Bryan,U.S. Senate,Evelyn Rogers,REP,70020,0,0,2,2,
Bryan,U.S. Senate,Rob Moye,REP,70020,0,0,0,0,
Bryan,U.S. Senate,D. Jean Mcbride-Samuels,REP,70020,0,0,0,0,
Bryan,U.S. Senate,Jim Inhofe,REP,70020,2,0,28,30,
Bryan,U.S. Senate,Erick Paul Wyatt,REP,70020,0,0,0,0,
Bryan,U.S. Senate,Andy Craig,REP,70020,0,0,0,0,
Bryan,U.S. Senate,T. Shannon,REP,70020,2,0,18,20,
Bryan,U.S. Senate,Randy Brogdon,REP,70020,0,0,0,0,
Bryan,U.S. Senate,Eric Mccray,REP,70020,0,0,0,0,
Bryan,U.S. Senate,Kevin Crow,REP,70020,0,0,0,0,
Bryan,U.S. Senate,James Lankford,REP,70020,0,0,11,11,
Bryan,U.S. Senate,Jason Weger,REP,70020,0,0,2,2,
Bryan,U.S. House,Darrel Robertson,REP,70020,0,0,12,12,02
Bryan,U.S. House,Markwayne Mullin,REP,70020,2,0,20,22,02
Bryan,Superintendent of Public Instruction,John Cox,DEM,70021,0,3,50,53,
Bryan,Superintendent of Public Instruction,Jack Jr.,DEM,70021,0,0,6,6,
Bryan,Superintendent of Public Instruction,Ivan Holmes,DEM,70021,0,0,6,6,
Bryan,Superintendent of Public Instruction,Freda Deskin,DEM,70021,1,2,39,42,
Bryan,U.S. Senate,Patrick Michael Hayes,DEM,70021,0,0,18,18,
Bryan,U.S. Senate,Jim Rogers,DEM,70021,1,3,48,52,
Bryan,U.S. Senate,Connie Johnson,DEM,70021,0,1,28,29,
Bryan,U.S. House,Earl Everett,DEM,70021,1,4,47,52,02
Bryan,U.S. House,Joshua Harris-Till,DEM,70021,0,0,44,44,02
Bryan,Governor,Dax Ewbank,REP,70021,0,0,9,9,
Bryan,Governor,Chad Moody,REP,70021,0,0,12,12,
Bryan,Governor,Mary Fallin,REP,70021,0,0,30,30,
Bryan,Superintendent of Public Instruction,Brian Kelly,REP,70021,0,0,7,7,
Bryan,Superintendent of Public Instruction,Janet Costello Barresi,REP,70021,0,0,8,8,
Bryan,Superintendent of Public Instruction,Joy Hofmeister,REP,70021,0,0,35,35,
Bryan,Insurance Commissioner,Bill Viner,REP,70021,0,0,12,12,
Bryan,Insurance Commissioner,John Doak,REP,70021,0,0,35,35,
Bryan,Corporation Commissioner,Todd Hiett,REP,70021,0,0,29,29,
Bryan,Corporation Commissioner,Cliff Branan,REP,70021,0,0,16,16,
Bryan,U.S. Senate,Evelyn Rogers,REP,70021,0,0,2,2,
Bryan,U.S. Senate,Rob Moye,REP,70021,0,0,2,2,
Bryan,U.S. Senate,D. Jean Mcbride-Samuels,REP,70021,0,0,0,0,
Bryan,U.S. Senate,Jim Inhofe,REP,70021,0,0,44,44,
Bryan,U.S. Senate,Erick Paul Wyatt,REP,70021,0,0,1,1,
Bryan,U.S. Senate,Andy Craig,REP,70021,0,0,0,0,
Bryan,U.S. Senate,T. Shannon,REP,70021,0,0,21,21,
Bryan,U.S. Senate,Randy Brogdon,REP,70021,0,0,1,1,
Bryan,U.S. Senate,Eric Mccray,REP,70021,0,0,0,0,
Bryan,U.S. Senate,Kevin Crow,REP,70021,0,0,1,1,
Bryan,U.S. Senate,James Lankford,REP,70021,0,0,28,28,
Bryan,U.S. Senate,Jason Weger,REP,70021,0,0,0,0,
Bryan,U.S. House,Darrel Robertson,REP,70021,0,0,9,9,02
Bryan,U.S. House,Markwayne Mullin,REP,70021,0,0,40,40,02
Bryan,Superintendent of Public Instruction,John Cox,DEM,70022,6,1,53,60,
Bryan,Superintendent of Public Instruction,Jack Jr.,DEM,70022,1,0,7,8,
Bryan,Superintendent of Public Instruction,Ivan Holmes,DEM,70022,1,0,4,5,
Bryan,Superintendent of Public Instruction,Freda Deskin,DEM,70022,2,0,30,32,
Bryan,U.S. Senate,Patrick Michael Hayes,DEM,70022,1,0,17,18,
Bryan,U.S. Senate,Jim Rogers,DEM,70022,1,0,39,40,
Bryan,U.S. Senate,Connie Johnson,DEM,70022,8,0,23,31,
Bryan,U.S. House,Earl Everett,DEM,70022,2,0,50,52,02
Bryan,U.S. House,Joshua Harris-Till,DEM,70022,7,1,28,36,02
Bryan,Governor,Dax Ewbank,REP,70022,0,1,5,6,
Bryan,Governor,Chad Moody,REP,70022,2,0,3,5,
Bryan,Governor,Mary Fallin,REP,70022,0,3,34,37,
Bryan,Superintendent of Public Instruction,Brian Kelly,REP,70022,0,0,12,12,
Bryan,Superintendent of Public Instruction,Janet Costello Barresi,REP,70022,2,1,8,11,
Bryan,Superintendent of Public Instruction,Joy Hofmeister,REP,70022,0,2,19,21,
Bryan,Insurance Commissioner,Bill Viner,REP,70022,1,1,15,17,
Bryan,Insurance Commissioner,John Doak,REP,70022,1,1,22,24,
Bryan,Corporation Commissioner,Todd Hiett,REP,70022,2,1,18,21,
Bryan,Corporation Commissioner,Cliff Branan,REP,70022,0,1,19,20,
Bryan,U.S. Senate,Evelyn Rogers,REP,70022,0,0,3,3,
Bryan,U.S. Senate,Rob Moye,REP,70022,0,0,0,0,
Bryan,U.S. Senate,D. Jean Mcbride-Samuels,REP,70022,0,0,0,0,
Bryan,U.S. Senate,Jim Inhofe,REP,70022,0,4,32,36,
Bryan,U.S. Senate,Erick Paul Wyatt,REP,70022,2,0,6,8,
Bryan,U.S. Senate,Andy Craig,REP,70022,0,0,0,0,
Bryan,U.S. Senate,T. Shannon,REP,70022,0,1,21,22,
Bryan,U.S. Senate,Randy Brogdon,REP,70022,1,0,1,2,
Bryan,U.S. Senate,Eric Mccray,REP,70022,0,1,1,2,
Bryan,U.S. Senate,Kevin Crow,REP,70022,0,0,2,2,
Bryan,U.S. Senate,James Lankford,REP,70022,0,1,14,15,
Bryan,U.S. Senate,Jason Weger,REP,70022,1,0,3,4,
Bryan,U.S. House,Darrel Robertson,REP,70022,2,0,14,16,02
Bryan,U.S. House,Markwayne Mullin,REP,70022,0,3,28,31,02
Bryan,Superintendent of Public Instruction,John Cox,DEM,70023,0,0,44,44,
Bryan,Superintendent of Public Instruction,Jack Jr.,DEM,70023,0,0,6,6,
Bryan,Superintendent of Public Instruction,Ivan Holmes,DEM,70023,0,0,0,0,
Bryan,Superintendent of Public Instruction,Freda Deskin,DEM,70023,0,1,29,30,
Bryan,U.S. Senate,Patrick Michael Hayes,DEM,70023,0,0,17,17,
Bryan,U.S. Senate,Jim Rogers,DEM,70023,0,1,35,36,
Bryan,U.S. Senate,Connie Johnson,DEM,70023,0,0,20,20,
Bryan,U.S. House,Earl Everett,DEM,70023,0,0,28,28,02
Bryan,U.S. House,Joshua Harris-Till,DEM,70023,0,1,39,40,02
Bryan,Governor,Dax Ewbank,REP,70023,0,0,2,2,
Bryan,Governor,Chad Moody,REP,70023,0,0,2,2,
Bryan,Governor,Mary Fallin,REP,70023,0,0,11,11,
Bryan,Superintendent of Public Instruction,Brian Kelly,REP,70023,0,0,4,4,
Bryan,Superintendent of Public Instruction,Janet Costello Barresi,REP,70023,0,0,4,4,
Bryan,Superintendent of Public Instruction,Joy Hofmeister,REP,70023,0,0,7,7,
Bryan,Insurance Commissioner,Bill Viner,REP,70023,0,0,5,5,
Bryan,Insurance Commissioner,John Doak,REP,70023,0,0,9,9,
Bryan,Corporation Commissioner,Todd Hiett,REP,70023,0,0,10,10,
Bryan,Corporation Commissioner,Cliff Branan,REP,70023,0,0,5,5,
Bryan,U.S. Senate,Evelyn Rogers,REP,70023,0,0,1,1,
Bryan,U.S. Senate,Rob Moye,REP,70023,0,0,0,0,
Bryan,U.S. Senate,D. Jean Mcbride-Samuels,REP,70023,0,0,1,1,
Bryan,U.S. Senate,Jim Inhofe,REP,70023,0,0,11,11,
Bryan,U.S. Senate,Erick Paul Wyatt,REP,70023,0,0,2,2,
Bryan,U.S. Senate,Andy Craig,REP,70023,0,0,0,0,
Bryan,U.S. Senate,T. Shannon,REP,70023,0,0,4,4,
Bryan,U.S. Senate,Randy Brogdon,REP,70023,0,0,1,1,
Bryan,U.S. Senate,Eric Mccray,REP,70023,0,0,2,2,
Bryan,U.S. Senate,Kevin Crow,REP,70023,0,0,0,0,
Bryan,U.S. Senate,James Lankford,REP,70023,0,0,4,4,
Bryan,U.S. Senate,Jason Weger,REP,70023,0,0,4,4,
Bryan,U.S. House,Darrel Robertson,REP,70023,0,0,5,5,02
Bryan,U.S. House,Markwayne Mullin,REP,70023,0,0,10,10,02
Bryan,Superintendent of Public Instruction,John Cox,DEM,70025,2,4,62,68,
Bryan,Superintendent of Public Instruction,Jack Jr.,DEM,70025,1,1,11,13,
Bryan,Superintendent of Public Instruction,Ivan Holmes,DEM,70025,0,1,4,5,
Bryan,Superintendent of Public Instruction,Freda Deskin,DEM,70025,2,0,63,65,
Bryan,U.S. Senate,Patrick Michael Hayes,DEM,70025,0,1,32,33,
Bryan,U.S. Senate,Jim Rogers,DEM,70025,2,1,55,58,
Bryan,U.S. Senate,Connie Johnson,DEM,70025,3,4,43,50,
Bryan,U.S. House,Earl Everett,DEM,70025,4,2,71,77,02
Bryan,U.S. House,Joshua Harris-Till,DEM,70025,1,4,57,62,02
Bryan,Governor,Dax Ewbank,REP,70025,0,2,5,7,
Bryan,Governor,Chad Moody,REP,70025,0,0,4,4,
Bryan,Governor,Mary Fallin,REP,70025,4,2,36,42,
Bryan,Superintendent of Public Instruction,Brian Kelly,REP,70025,2,1,16,19,
Bryan,Superintendent of Public Instruction,Janet Costello Barresi,REP,70025,0,0,4,4,
Bryan,Superintendent of Public Instruction,Joy Hofmeister,REP,70025,2,3,19,24,
Bryan,Insurance Commissioner,Bill Viner,REP,70025,3,2,10,15,
Bryan,Insurance Commissioner,John Doak,REP,70025,1,1,30,32,
Bryan,Corporation Commissioner,Todd Hiett,REP,70025,4,3,31,38,
Bryan,Corporation Commissioner,Cliff Branan,REP,70025,0,1,9,10,
Bryan,U.S. Senate,Evelyn Rogers,REP,70025,0,0,5,5,
Bryan,U.S. Senate,Rob Moye,REP,70025,0,0,0,0,
Bryan,U.S. Senate,D. Jean Mcbride-Samuels,REP,70025,0,0,0,0,
Bryan,U.S. Senate,Jim Inhofe,REP,70025,4,2,36,42,
Bryan,U.S. Senate,Erick Paul Wyatt,REP,70025,0,2,3,5,
Bryan,U.S. Senate,Andy Craig,REP,70025,0,0,2,2,
Bryan,U.S. Senate,T. Shannon,REP,70025,4,1,23,28,
Bryan,U.S. Senate,Randy Brogdon,REP,70025,0,1,5,6,
Bryan,U.S. Senate,Eric Mccray,REP,70025,0,0,1,1,
Bryan,U.S. Senate,Kevin Crow,REP,70025,0,0,0,0,
Bryan,U.S. Senate,James Lankford,REP,70025,0,2,14,16,
Bryan,U.S. Senate,Jason Weger,REP,70025,0,0,0,0,
Bryan,U.S. House,Darrel Robertson,REP,70025,0,0,12,12,02
Bryan,U.S. House,Markwayne Mullin,REP,70025,4,4,32,40,02
Bryan,Superintendent of Public Instruction,John Cox,DEM,70026,0,2,35,37,
Bryan,Superintendent of Public Instruction,Jack Jr.,DEM,70026,0,0,10,10,
Bryan,Superintendent of Public Instruction,Ivan Holmes,DEM,70026,0,0,2,2,
Bryan,Superintendent of Public Instruction,Freda Deskin,DEM,70026,0,0,18,18,
Bryan,U.S. Senate,Patrick Michael Hayes,DEM,70026,0,1,16,17,
Bryan,U.S. Senate,Jim Rogers,DEM,70026,0,0,30,30,
Bryan,U.S. Senate,Connie Johnson,DEM,70026,0,1,17,18,
Bryan,U.S. House,Earl Everett,DEM,70026,0,2,34,36,02
Bryan,U.S. House,Joshua Harris-Till,DEM,70026,0,0,27,27,02
Bryan,Governor,Dax Ewbank,REP,70026,0,0,6,6,
Bryan,Governor,Chad Moody,REP,70026,0,0,5,5,
Bryan,Governor,Mary Fallin,REP,70026,0,3,26,29,
Bryan,Superintendent of Public Instruction,Brian Kelly,REP,70026,0,0,7,7,
Bryan,Superintendent of Public Instruction,Janet Costello Barresi,REP,70026,0,0,4,4,
Bryan,Superintendent of Public Instruction,Joy Hofmeister,REP,70026,0,3,27,30,
Bryan,Insurance Commissioner,Bill Viner,REP,70026,0,0,10,10,
Bryan,Insurance Commissioner,John Doak,REP,70026,0,3,22,25,
Bryan,Corporation Commissioner,Todd Hiett,REP,70026,0,3,16,19,
Bryan,Corporation Commissioner,Cliff Branan,REP,70026,0,0,16,16,
Bryan,U.S. Senate,Evelyn Rogers,REP,70026,0,0,5,5,
Bryan,U.S. Senate,Rob Moye,REP,70026,0,0,0,0,
Bryan,U.S. Senate,D. Jean Mcbride-Samuels,REP,70026,0,0,0,0,
Bryan,U.S. Senate,Jim Inhofe,REP,70026,0,3,28,31,
Bryan,U.S. Senate,Erick Paul Wyatt,REP,70026,0,0,4,4,
Bryan,U.S. Senate,Andy Craig,REP,70026,0,0,0,0,
Bryan,U.S. Senate,T. Shannon,REP,70026,0,0,11,11,
Bryan,U.S. Senate,Randy Brogdon,REP,70026,0,0,4,4,
Bryan,U.S. Senate,Eric Mccray,REP,70026,0,0,0,0,
Bryan,U.S. Senate,Kevin Crow,REP,70026,0,0,0,0,
Bryan,U.S. Senate,James Lankford,REP,70026,0,2,20,22,
Bryan,U.S. Senate,Jason Weger,REP,70026,0,0,3,3,
Bryan,U.S. House,Darrel Robertson,REP,70026,0,2,10,12,02
Bryan,U.S. House,Markwayne Mullin,REP,70026,0,1,28,29,02
Bryan,Superintendent of Public Instruction,John Cox,DEM,70027,0,4,55,59,
Bryan,Superintendent of Public Instruction,Jack Jr.,DEM,70027,0,0,14,14,
Bryan,Superintendent of Public Instruction,Ivan Holmes,DEM,70027,0,0,4,4,
Bryan,Superintendent of Public Instruction,Freda Deskin,DEM,70027,0,3,43,46,
Bryan,U.S. Senate,Patrick Michael Hayes,DEM,70027,0,3,21,24,
Bryan,U.S. Senate,Jim Rogers,DEM,70027,0,2,56,58,
Bryan,U.S. Senate,Connie Johnson,DEM,70027,0,3,28,31,
Bryan,U.S. House,Earl Everett,DEM,70027,0,3,63,66,02
Bryan,U.S. House,Joshua Harris-Till,DEM,70027,0,4,39,43,02
Bryan,Governor,Dax Ewbank,REP,70027,0,1,8,9,
Bryan,Governor,Chad Moody,REP,70027,0,1,12,13,
Bryan,Governor,Mary Fallin,REP,70027,2,5,51,58,
Bryan,Superintendent of Public Instruction,Brian Kelly,REP,70027,0,0,10,10,
Bryan,Superintendent of Public Instruction,Janet Costello Barresi,REP,70027,0,2,16,18,
Bryan,Superintendent of Public Instruction,Joy Hofmeister,REP,70027,2,5,47,54,
Bryan,Insurance Commissioner,Bill Viner,REP,70027,1,1,17,19,
Bryan,Insurance Commissioner,John Doak,REP,70027,1,5,44,50,
Bryan,Corporation Commissioner,Todd Hiett,REP,70027,0,2,46,48,
Bryan,Corporation Commissioner,Cliff Branan,REP,70027,2,4,17,23,
Bryan,U.S. Senate,Evelyn Rogers,REP,70027,0,0,2,2,
Bryan,U.S. Senate,Rob Moye,REP,70027,0,1,0,1,
Bryan,U.S. Senate,D. Jean Mcbride-Samuels,REP,70027,0,0,0,0,
Bryan,U.S. Senate,Jim Inhofe,REP,70027,2,6,62,70,
Bryan,U.S. Senate,Erick Paul Wyatt,REP,70027,0,0,7,7,
Bryan,U.S. Senate,Andy Craig,REP,70027,0,0,1,1,
Bryan,U.S. Senate,T. Shannon,REP,70027,0,5,34,39,
Bryan,U.S. Senate,Randy Brogdon,REP,70027,0,0,6,6,
Bryan,U.S. Senate,Eric Mccray,REP,70027,0,0,0,0,
Bryan,U.S. Senate,Kevin Crow,REP,70027,0,0,0,0,
Bryan,U.S. Senate,James Lankford,REP,70027,2,2,30,34,
Bryan,U.S. Senate,Jason Weger,REP,70027,0,0,1,1,
Bryan,U.S. House,Darrel Robertson,REP,70027,0,1,25,26,02
Bryan,U.S. House,Markwayne Mullin,REP,70027,2,6,48,56,02
Bryan,Superintendent of Public Instruction,John Cox,DEM,70028,0,3,49,52,
Bryan,Superintendent of Public Instruction,Jack Jr.,DEM,70028,0,0,16,16,
Bryan,Superintendent of Public Instruction,Ivan Holmes,DEM,70028,0,0,9,9,
Bryan,Superintendent of Public Instruction,Freda Deskin,DEM,70028,0,3,38,41,
Bryan,U.S. Senate,Patrick Michael Hayes,DEM,70028,0,2,14,16,
Bryan,U.S. Senate,Jim Rogers,DEM,70028,0,1,64,65,
Bryan,U.S. Senate,Connie Johnson,DEM,70028,0,3,29,32,
Bryan,U.S. House,Earl Everett,DEM,70028,0,4,66,70,02
Bryan,U.S. House,Joshua Harris-Till,DEM,70028,0,2,36,38,02
Bryan,Governor,Dax Ewbank,REP,70028,0,1,15,16,
Bryan,Governor,Chad Moody,REP,70028,0,0,8,8,
Bryan,Governor,Mary Fallin,REP,70028,0,3,28,31,
Bryan,Superintendent of Public Instruction,Brian Kelly,REP,70028,0,0,11,11,
Bryan,Superintendent of Public Instruction,Janet Costello Barresi,REP,70028,0,0,5,5,
Bryan,Superintendent of Public Instruction,Joy Hofmeister,REP,70028,0,4,31,35,
Bryan,Insurance Commissioner,Bill Viner,REP,70028,0,3,15,18,
Bryan,Insurance Commissioner,John Doak,REP,70028,0,1,25,26,
Bryan,Corporation Commissioner,Todd Hiett,REP,70028,0,1,23,24,
Bryan,Corporation Commissioner,Cliff Branan,REP,70028,0,3,14,17,
Bryan,U.S. Senate,Evelyn Rogers,REP,70028,0,1,2,3,
Bryan,U.S. Senate,Rob Moye,REP,70028,0,0,2,2,
Bryan,U.S. Senate,D. Jean Mcbride-Samuels,REP,70028,0,1,3,4,
Bryan,U.S. Senate,Jim Inhofe,REP,70028,0,1,41,42,
Bryan,U.S. Senate,Erick Paul Wyatt,REP,70028,0,1,1,2,
Bryan,U.S. Senate,Andy Craig,REP,70028,0,0,0,0,
Bryan,U.S. Senate,T. Shannon,REP,70028,0,0,18,18,
Bryan,U.S. Senate,Randy Brogdon,REP,70028,0,0,7,7,
Bryan,U.S. Senate,Eric Mccray,REP,70028,0,0,0,0,
Bryan,U.S. Senate,Kevin Crow,REP,70028,0,0,1,1,
Bryan,U.S. Senate,James Lankford,REP,70028,0,3,22,25,
Bryan,U.S. Senate,Jason Weger,REP,70028,0,1,2,3,
Bryan,U.S. House,Darrel Robertson,REP,70028,0,1,19,20,02
Bryan,U.S. House,Markwayne Mullin,REP,70028,0,3,29,32,02
Bryan,Superintendent of Public Instruction,John Cox,DEM,70029,0,1,20,21,
Bryan,Superintendent of Public Instruction,Jack Jr.,DEM,70029,0,0,6,6,
Bryan,Superintendent of Public Instruction,Ivan Holmes,DEM,70029,0,0,3,3,
Bryan,Superintendent of Public Instruction,Freda Deskin,DEM,70029,1,1,23,25,
Bryan,U.S. Senate,Patrick Michael Hayes,DEM,70029,0,1,16,17,
Bryan,U.S. Senate,Jim Rogers,DEM,70029,0,0,13,13,
Bryan,U.S. Senate,Connie Johnson,DEM,70029,1,0,16,17,
Bryan,U.S. House,Earl Everett,DEM,70029,0,1,21,22,02
Bryan,U.S. House,Joshua Harris-Till,DEM,70029,1,0,24,25,02
Bryan,Governor,Dax Ewbank,REP,70029,0,0,0,0,
Bryan,Governor,Chad Moody,REP,70029,0,0,1,1,
Bryan,Governor,Mary Fallin,REP,70029,0,0,1,1,
Bryan,Superintendent of Public Instruction,Brian Kelly,REP,70029,0,0,0,0,
Bryan,Superintendent of Public Instruction,Janet Costello Barresi,REP,70029,0,0,0,0,
Bryan,Superintendent of Public Instruction,Joy Hofmeister,REP,70029,0,0,2,2,
Bryan,Insurance Commissioner,Bill Viner,REP,70029,0,0,0,0,
Bryan,Insurance Commissioner,John Doak,REP,70029,0,0,1,1,
Bryan,Corporation Commissioner,Todd Hiett,REP,70029,0,0,0,0,
Bryan,Corporation Commissioner,Cliff Branan,REP,70029,0,0,1,1,
Bryan,U.S. Senate,Evelyn Rogers,REP,70029,0,0,0,0,
Bryan,U.S. Senate,Rob Moye,REP,70029,0,0,0,0,
Bryan,U.S. Senate,D. Jean Mcbride-Samuels,REP,70029,0,0,0,0,
Bryan,U.S. Senate,Jim Inhofe,REP,70029,0,0,1,1,
Bryan,U.S. Senate,Erick Paul Wyatt,REP,70029,0,0,1,1,
Bryan,U.S. Senate,Andy Craig,REP,70029,0,0,0,0,
Bryan,U.S. Senate,T. Shannon,REP,70029,0,0,0,0,
Bryan,U.S. Senate,Randy Brogdon,REP,70029,0,0,0,0,
Bryan,U.S. Senate,Eric Mccray,REP,70029,0,0,0,0,
Bryan,U.S. Senate,Kevin Crow,REP,70029,0,0,0,0,
Bryan,U.S. Senate,James Lankford,REP,70029,0,0,0,0,
Bryan,U.S. Senate,Jason Weger,REP,70029,0,0,1,1,
Bryan,U.S. House,Darrel Robertson,REP,70029,0,0,2,2,02
Bryan,U.S. House,Markwayne Mullin,REP,70029,0,0,0,0,02
Bryan,Superintendent of Public Instruction,John Cox,DEM,70033,3,3,117,123,
Bryan,Superintendent of Public Instruction,Jack Jr.,DEM,70033,1,2,23,26,
Bryan,Superintendent of Public Instruction,Ivan Holmes,DEM,70033,0,1,12,13,
Bryan,Superintendent of Public Instruction,Freda Deskin,DEM,70033,4,0,75,79,
Bryan,U.S. Senate,Patrick Michael Hayes,DEM,70033,3,1,56,60,
Bryan,U.S. Senate,Jim Rogers,DEM,70033,2,1,82,85,
Bryan,U.S. Senate,Connie Johnson,DEM,70033,2,4,75,81,
Bryan,U.S. House,Earl Everett,DEM,70033,3,2,127,132,02
Bryan,U.S. House,Joshua Harris-Till,DEM,70033,3,4,83,90,02
Bryan,Governor,Dax Ewbank,REP,70033,0,3,22,25,
Bryan,Governor,Chad Moody,REP,70033,1,2,35,38,
Bryan,Governor,Mary Fallin,REP,70033,3,8,92,103,
Bryan,Superintendent of Public Instruction,Brian Kelly,REP,70033,2,1,29,32,
Bryan,Superintendent of Public Instruction,Janet Costello Barresi,REP,70033,1,6,23,30,
Bryan,Superintendent of Public Instruction,Joy Hofmeister,REP,70033,1,6,97,104,
Bryan,Insurance Commissioner,Bill Viner,REP,70033,0,3,37,40,
Bryan,Insurance Commissioner,John Doak,REP,70033,4,7,95,106,
Bryan,Corporation Commissioner,Todd Hiett,REP,70033,0,9,93,102,
Bryan,Corporation Commissioner,Cliff Branan,REP,70033,4,2,43,49,
Bryan,U.S. Senate,Evelyn Rogers,REP,70033,0,0,3,3,
Bryan,U.S. Senate,Rob Moye,REP,70033,0,0,6,6,
Bryan,U.S. Senate,D. Jean Mcbride-Samuels,REP,70033,0,0,2,2,
Bryan,U.S. Senate,Jim Inhofe,REP,70033,4,13,126,143,
Bryan,U.S. Senate,Erick Paul Wyatt,REP,70033,0,0,12,12,
Bryan,U.S. Senate,Andy Craig,REP,70033,0,0,3,3,
Bryan,U.S. Senate,T. Shannon,REP,70033,2,5,50,57,
Bryan,U.S. Senate,Randy Brogdon,REP,70033,0,2,8,10,
Bryan,U.S. Senate,Eric Mccray,REP,70033,0,0,2,2,
Bryan,U.S. Senate,Kevin Crow,REP,70033,0,0,2,2,
Bryan,U.S. Senate,James Lankford,REP,70033,2,6,84,92,
Bryan,U.S. Senate,Jason Weger,REP,70033,0,0,2,2,
Bryan,U.S. House,Darrel Robertson,REP,70033,2,7,32,41,02
Bryan,U.S. House,Markwayne Mullin,REP,70033,2,6,116,124,02
Caddo,Superintendent of Public Instruction,John Cox,DEM,80012,0,2,17,19,
Caddo,Superintendent of Public Instruction,Jack Jr.,DEM,80012,0,1,9,10,
Caddo,Superintendent of Public Instruction,Ivan Holmes,DEM,80012,0,0,6,6,
Caddo,Superintendent of Public Instruction,Freda Deskin,DEM,80012,0,0,13,13,
Caddo,U.S. Senate,Patrick Michael Hayes,DEM,80012,0,1,10,11,
Caddo,U.S. Senate,Jim Rogers,DEM,80012,0,2,18,20,
Caddo,U.S. Senate,Connie Johnson,DEM,80012,0,0,17,17,
Caddo,Governor,Dax Ewbank,REP,80012,1,0,4,5,
Caddo,Governor,Chad Moody,REP,80012,0,0,6,6,
Caddo,Governor,Mary Fallin,REP,80012,0,0,12,12,
Caddo,Superintendent of Public Instruction,Brian Kelly,REP,80012,0,0,7,7,
Caddo,Superintendent of Public Instruction,Janet Costello Barresi,REP,80012,0,0,3,3,
Caddo,Superintendent of Public Instruction,Joy Hofmeister,REP,80012,1,0,12,13,
Caddo,Insurance Commissioner,Bill Viner,REP,80012,0,0,7,7,
Caddo,Insurance Commissioner,John Doak,REP,80012,1,0,15,16,
Caddo,Corporation Commissioner,Todd Hiett,REP,80012,0,0,8,8,
Caddo,Corporation Commissioner,Cliff Branan,REP,80012,1,0,13,14,
Caddo,U.S. Senate,Evelyn Rogers,REP,80012,0,0,1,1,
Caddo,U.S. Senate,Rob Moye,REP,80012,0,0,0,0,
Caddo,U.S. Senate,D. Jean Mcbride-Samuels,REP,80012,0,0,0,0,
Caddo,U.S. Senate,Jim Inhofe,REP,80012,1,0,19,20,
Caddo,U.S. Senate,Erick Paul Wyatt,REP,80012,0,0,2,2,
Caddo,U.S. Senate,Andy Craig,REP,80012,0,0,0,0,
Caddo,U.S. Senate,T. Shannon,REP,80012,1,0,9,10,
Caddo,U.S. Senate,Randy Brogdon,REP,80012,0,0,0,0,
Caddo,U.S. Senate,Eric Mccray,REP,80012,0,0,0,0,
Caddo,U.S. Senate,Kevin Crow,REP,80012,0,0,1,1,
Caddo,U.S. Senate,James Lankford,REP,80012,0,0,11,11,
Caddo,U.S. Senate,Jason Weger,REP,80012,0,0,0,0,
Caddo,U.S. House,Timothy Ray Murray,REP,80012,0,0,2,2,03
Caddo,U.S. House,Robert Hubbard,REP,80012,0,0,3,3,03
Caddo,U.S. House,Frank Lucas,REP,80012,1,0,17,18,03
Caddo,State Senate,Darcy Jech,REP,80012,0,0,9,9,26
Caddo,State Senate,Dan Gambill,REP,80012,1,0,13,14,26
Caddo,Superintendent of Public Instruction,John Cox,DEM,80022,5,7,29,41,
Caddo,Superintendent of Public Instruction,Jack Jr.,DEM,80022,0,0,17,17,
Caddo,Superintendent of Public Instruction,Ivan Holmes,DEM,80022,0,1,6,7,
Caddo,Superintendent of Public Instruction,Freda Deskin,DEM,80022,2,5,28,35,
Caddo,U.S. Senate,Patrick Michael Hayes,DEM,80022,3,2,9,14,
Caddo,U.S. Senate,Jim Rogers,DEM,80022,3,2,40,45,
Caddo,U.S. Senate,Connie Johnson,DEM,80022,1,9,31,41,
Caddo,Governor,Dax Ewbank,REP,80022,0,0,4,4,
Caddo,Governor,Chad Moody,REP,80022,0,0,4,4,
Caddo,Governor,Mary Fallin,REP,80022,0,3,21,24,
Caddo,Superintendent of Public Instruction,Brian Kelly,REP,80022,0,0,10,10,
Caddo,Superintendent of Public Instruction,Janet Costello Barresi,REP,80022,0,1,9,10,
Caddo,Superintendent of Public Instruction,Joy Hofmeister,REP,80022,0,2,12,14,
Caddo,Insurance Commissioner,Bill Viner,REP,80022,0,2,6,8,
Caddo,Insurance Commissioner,John Doak,REP,80022,0,1,24,25,
Caddo,Corporation Commissioner,Todd Hiett,REP,80022,0,2,12,14,
Caddo,Corporation Commissioner,Cliff Branan,REP,80022,0,1,16,17,
Caddo,U.S. Senate,Evelyn Rogers,REP,80022,0,0,2,2,
Caddo,U.S. Senate,Rob Moye,REP,80022,0,0,1,1,
Caddo,U.S. Senate,D. Jean Mcbride-Samuels,REP,80022,0,0,0,0,
Caddo,U.S. Senate,Jim Inhofe,REP,80022,0,3,21,24,
Caddo,U.S. Senate,Erick Paul Wyatt,REP,80022,0,0,6,6,
Caddo,U.S. Senate,Andy Craig,REP,80022,0,0,0,0,
Caddo,U.S. Senate,T. Shannon,REP,80022,0,1,13,14,
Caddo,U.S. Senate,Randy Brogdon,REP,80022,0,0,0,0,
Caddo,U.S. Senate,Eric Mccray,REP,80022,0,0,0,0,
Caddo,U.S. Senate,Kevin Crow,REP,80022,0,0,0,0,
Caddo,U.S. Senate,James Lankford,REP,80022,0,2,17,19,
Caddo,U.S. Senate,Jason Weger,REP,80022,0,0,0,0,
Caddo,U.S. House,Timothy Ray Murray,REP,80022,0,0,1,1,03
Caddo,U.S. House,Robert Hubbard,REP,80022,0,1,4,5,03
Caddo,U.S. House,Frank Lucas,REP,80022,0,2,25,27,03
Caddo,State Senate,Darcy Jech,REP,80022,0,2,11,13,26
Caddo,State Senate,Dan Gambill,REP,80022,0,1,19,20,26
Caddo,Superintendent of Public Instruction,John Cox,DEM,80031,0,3,17,20,
Caddo,Superintendent of Public Instruction,Jack Jr.,DEM,80031,1,0,5,6,
Caddo,Superintendent of Public Instruction,Ivan Holmes,DEM,80031,1,2,2,5,
Caddo,Superintendent of Public Instruction,Freda Deskin,DEM,80031,0,3,22,25,
Caddo,U.S. Senate,Patrick Michael Hayes,DEM,80031,0,1,11,12,
Caddo,U.S. Senate,Jim Rogers,DEM,80031,1,3,20,24,
Caddo,U.S. Senate,Connie Johnson,DEM,80031,1,4,15,20,
Caddo,Governor,Dax Ewbank,REP,80031,0,0,3,3,
Caddo,Governor,Chad Moody,REP,80031,0,0,3,3,
Caddo,Governor,Mary Fallin,REP,80031,1,2,6,9,
Caddo,Superintendent of Public Instruction,Brian Kelly,REP,80031,0,2,5,7,
Caddo,Superintendent of Public Instruction,Janet Costello Barresi,REP,80031,1,0,2,3,
Caddo,Superintendent of Public Instruction,Joy Hofmeister,REP,80031,0,0,5,5,
Caddo,Insurance Commissioner,Bill Viner,REP,80031,0,1,6,7,
Caddo,Insurance Commissioner,John Doak,REP,80031,1,1,6,8,
Caddo,Corporation Commissioner,Todd Hiett,REP,80031,1,1,4,6,
Caddo,Corporation Commissioner,Cliff Branan,REP,80031,0,1,8,9,
Caddo,U.S. Senate,Evelyn Rogers,REP,80031,0,0,1,1,
Caddo,U.S. Senate,Rob Moye,REP,80031,0,0,0,0,
Caddo,U.S. Senate,D. Jean Mcbride-Samuels,REP,80031,0,0,1,1,
Caddo,U.S. Senate,Jim Inhofe,REP,80031,1,2,10,13,
Caddo,U.S. Senate,Erick Paul Wyatt,REP,80031,0,0,0,0,
Caddo,U.S. Senate,Andy Craig,REP,80031,0,0,0,0,
Caddo,U.S. Senate,T. Shannon,REP,80031,0,0,4,4,
Caddo,U.S. Senate,Randy Brogdon,REP,80031,0,0,2,2,
Caddo,U.S. Senate,Eric Mccray,REP,80031,0,0,0,0,
Caddo,U.S. Senate,Kevin Crow,REP,80031,0,0,0,0,
Caddo,U.S. Senate,James Lankford,REP,80031,1,2,6,9,
Caddo,U.S. Senate,Jason Weger,REP,80031,0,0,0,0,
Caddo,U.S. House,Timothy Ray Murray,REP,80031,0,0,2,2,03
Caddo,U.S. House,Robert Hubbard,REP,80031,0,0,0,0,03
Caddo,U.S. House,Frank Lucas,REP,80031,1,2,10,13,03
Caddo,State Senate,Darcy Jech,REP,80031,0,0,8,8,26
Caddo,State Senate,Dan Gambill,REP,80031,1,2,4,7,26
Caddo,Superintendent of Public Instruction,John Cox,DEM,80041,1,11,41,53,
Caddo,Superintendent of Public Instruction,Jack Jr.,DEM,80041,0,1,24,25,
Caddo,Superintendent of Public Instruction,Ivan Holmes,DEM,80041,1,3,11,15,
Caddo,Superintendent of Public Instruction,Freda Deskin,DEM,80041,3,12,64,79,
Caddo,U.S. Senate,Patrick Michael Hayes,DEM,80041,0,2,23,25,
Caddo,U.S. Senate,Jim Rogers,DEM,80041,1,14,73,88,
Caddo,U.S. Senate,Connie Johnson,DEM,80041,4,11,47,62,
Caddo,Governor,Dax Ewbank,REP,80041,1,3,8,12,
Caddo,Governor,Chad Moody,REP,80041,1,1,13,15,
Caddo,Governor,Mary Fallin,REP,80041,5,4,57,66,
Caddo,Superintendent of Public Instruction,Brian Kelly,REP,80041,2,1,10,13,
Caddo,Superintendent of Public Instruction,Janet Costello Barresi,REP,80041,1,2,11,14,
Caddo,Superintendent of Public Instruction,Joy Hofmeister,REP,80041,3,5,52,60,
Caddo,Insurance Commissioner,Bill Viner,REP,80041,1,1,12,14,
Caddo,Insurance Commissioner,John Doak,REP,80041,6,6,59,71,
Caddo,Corporation Commissioner,Todd Hiett,REP,80041,4,3,26,33,
Caddo,Corporation Commissioner,Cliff Branan,REP,80041,3,4,47,54,
Caddo,U.S. Senate,Evelyn Rogers,REP,80041,0,0,1,1,
Caddo,U.S. Senate,Rob Moye,REP,80041,0,0,2,2,
Caddo,U.S. Senate,D. Jean Mcbride-Samuels,REP,80041,0,0,0,0,
Caddo,U.S. Senate,Jim Inhofe,REP,80041,6,8,72,86,
Caddo,U.S. Senate,Erick Paul Wyatt,REP,80041,1,0,3,4,
Caddo,U.S. Senate,Andy Craig,REP,80041,0,0,0,0,
Caddo,U.S. Senate,T. Shannon,REP,80041,4,1,29,34,
Caddo,U.S. Senate,Randy Brogdon,REP,80041,1,0,4,5,
Caddo,U.S. Senate,Eric Mccray,REP,80041,0,0,0,0,
Caddo,U.S. Senate,Kevin Crow,REP,80041,0,0,0,0,
Caddo,U.S. Senate,James Lankford,REP,80041,2,7,45,54,
Caddo,U.S. Senate,Jason Weger,REP,80041,0,0,0,0,
Caddo,U.S. House,Timothy Ray Murray,REP,80041,0,0,7,7,03
Caddo,U.S. House,Robert Hubbard,REP,80041,4,0,7,11,03
Caddo,U.S. House,Frank Lucas,REP,80041,3,8,64,75,03
Caddo,State Senate,Darcy Jech,REP,80041,0,0,32,32,26
Caddo,State Senate,Dan Gambill,REP,80041,6,7,43,56,26
Caddo,Superintendent of Public Instruction,John Cox,DEM,80051,1,8,89,98,
Caddo,Superintendent of Public Instruction,Jack Jr.,DEM,80051,0,3,25,28,
Caddo,Superintendent of Public Instruction,Ivan Holmes,DEM,80051,0,3,6,9,
Caddo,Superintendent of Public Instruction,Freda Deskin,DEM,80051,0,19,80,99,
Caddo,U.S. Senate,Patrick Michael Hayes,DEM,80051,0,1,32,33,
Caddo,U.S. Senate,Jim Rogers,DEM,80051,1,17,98,116,
Caddo,U.S. Senate,Connie Johnson,DEM,80051,0,15,73,88,
Caddo,Governor,Dax Ewbank,REP,80051,0,1,6,7,
Caddo,Governor,Chad Moody,REP,80051,1,4,7,12,
Caddo,Governor,Mary Fallin,REP,80051,2,8,56,66,
Caddo,Superintendent of Public Instruction,Brian Kelly,REP,80051,1,4,24,29,
Caddo,Superintendent of Public Instruction,Janet Costello Barresi,REP,80051,0,0,9,9,
Caddo,Superintendent of Public Instruction,Joy Hofmeister,REP,80051,2,9,35,46,
Caddo,Insurance Commissioner,Bill Viner,REP,80051,0,2,19,21,
Caddo,Insurance Commissioner,John Doak,REP,80051,3,11,48,62,
Caddo,Corporation Commissioner,Todd Hiett,REP,80051,2,5,31,38,
Caddo,Corporation Commissioner,Cliff Branan,REP,80051,1,8,35,44,
Caddo,U.S. Senate,Evelyn Rogers,REP,80051,0,2,2,4,
Caddo,U.S. Senate,Rob Moye,REP,80051,0,0,0,0,
Caddo,U.S. Senate,D. Jean Mcbride-Samuels,REP,80051,0,0,0,0,
Caddo,U.S. Senate,Jim Inhofe,REP,80051,3,11,63,77,
Caddo,U.S. Senate,Erick Paul Wyatt,REP,80051,0,0,4,4,
Caddo,U.S. Senate,Andy Craig,REP,80051,0,0,0,0,
Caddo,U.S. Senate,T. Shannon,REP,80051,0,9,20,29,
Caddo,U.S. Senate,Randy Brogdon,REP,80051,0,0,1,1,
Caddo,U.S. Senate,Eric Mccray,REP,80051,0,0,2,2,
Caddo,U.S. Senate,Kevin Crow,REP,80051,0,0,0,0,
Caddo,U.S. Senate,James Lankford,REP,80051,3,4,47,54,
Caddo,U.S. Senate,Jason Weger,REP,80051,0,0,0,0,
Caddo,U.S. House,Timothy Ray Murray,REP,80051,0,1,4,5,03
Caddo,U.S. House,Robert Hubbard,REP,80051,0,0,1,1,03
Caddo,U.S. House,Frank Lucas,REP,80051,3,12,64,79,03
Caddo,State Senate,Darcy Jech,REP,80051,1,7,27,35,26
Caddo,State Senate,Dan Gambill,REP,80051,2,6,41,49,26
Caddo,Superintendent of Public Instruction,John Cox,DEM,80102,2,2,127,131,
Caddo,Superintendent of Public Instruction,Jack Jr.,DEM,80102,0,1,28,29,
Caddo,Superintendent of Public Instruction,Ivan Holmes,DEM,80102,1,2,18,21,
Caddo,Superintendent of Public Instruction,Freda Deskin,DEM,80102,9,2,73,84,
Caddo,U.S. Senate,Patrick Michael Hayes,DEM,80102,2,0,64,66,
Caddo,U.S. Senate,Jim Rogers,DEM,80102,5,3,111,119,
Caddo,U.S. Senate,Connie Johnson,DEM,80102,5,4,59,68,
Caddo,Governor,Dax Ewbank,REP,80102,0,0,6,6,
Caddo,Governor,Chad Moody,REP,80102,0,0,19,19,
Caddo,Governor,Mary Fallin,REP,80102,2,3,55,60,
Caddo,Superintendent of Public Instruction,Brian Kelly,REP,80102,1,0,18,19,
Caddo,Superintendent of Public Instruction,Janet Costello Barresi,REP,80102,0,0,9,9,
Caddo,Superintendent of Public Instruction,Joy Hofmeister,REP,80102,1,3,53,57,
Caddo,Insurance Commissioner,Bill Viner,REP,80102,0,0,16,16,
Caddo,Insurance Commissioner,John Doak,REP,80102,2,3,59,64,
Caddo,Corporation Commissioner,Todd Hiett,REP,80102,0,2,41,43,
Caddo,Corporation Commissioner,Cliff Branan,REP,80102,2,1,33,36,
Caddo,U.S. Senate,Evelyn Rogers,REP,80102,0,0,7,7,
Caddo,U.S. Senate,Rob Moye,REP,80102,0,0,2,2,
Caddo,U.S. Senate,D. Jean Mcbride-Samuels,REP,80102,0,0,1,1,
Caddo,U.S. Senate,Jim Inhofe,REP,80102,2,3,64,69,
Caddo,U.S. Senate,Erick Paul Wyatt,REP,80102,0,0,6,6,
Caddo,U.S. Senate,Andy Craig,REP,80102,0,0,1,1,
Caddo,U.S. Senate,T. Shannon,REP,80102,1,0,35,36,
Caddo,U.S. Senate,Randy Brogdon,REP,80102,0,0,1,1,
Caddo,U.S. Senate,Eric Mccray,REP,80102,0,0,0,0,
Caddo,U.S. Senate,Kevin Crow,REP,80102,0,0,0,0,
Caddo,U.S. Senate,James Lankford,REP,80102,1,3,43,47,
Caddo,U.S. Senate,Jason Weger,REP,80102,0,0,0,0,
Caddo,U.S. House,Timothy Ray Murray,REP,80102,0,0,7,7,03
Caddo,U.S. House,Robert Hubbard,REP,80102,0,0,4,4,03
Caddo,U.S. House,Frank Lucas,REP,80102,2,3,69,74,03
Caddo,State Senate,Darcy Jech,REP,80102,0,2,23,25,26
Caddo,State Senate,Dan Gambill,REP,80102,2,1,54,57,26
Caddo,Superintendent of Public Instruction,John Cox,DEM,80509,0,0,23,23,
Caddo,Superintendent of Public Instruction,Jack Jr.,DEM,80509,1,0,5,6,
Caddo,Superintendent of Public Instruction,Ivan Holmes,DEM,80509,0,0,7,7,
Caddo,Superintendent of Public Instruction,Freda Deskin,DEM,80509,0,0,26,26,
Caddo,U.S. Senate,Patrick Michael Hayes,DEM,80509,0,0,14,14,
Caddo,U.S. Senate,Jim Rogers,DEM,80509,1,0,29,30,
Caddo,U.S. Senate,Connie Johnson,DEM,80509,0,0,18,18,
Caddo,Governor,Dax Ewbank,REP,80509,0,0,2,2,
Caddo,Governor,Chad Moody,REP,80509,0,0,7,7,
Caddo,Governor,Mary Fallin,REP,80509,2,2,14,18,
Caddo,Superintendent of Public Instruction,Brian Kelly,REP,80509,0,0,4,4,
Caddo,Superintendent of Public Instruction,Janet Costello Barresi,REP,80509,0,0,5,5,
Caddo,Superintendent of Public Instruction,Joy Hofmeister,REP,80509,2,2,13,17,
Caddo,Insurance Commissioner,Bill Viner,REP,80509,0,0,4,4,
Caddo,Insurance Commissioner,John Doak,REP,80509,2,2,15,19,
Caddo,Corporation Commissioner,Todd Hiett,REP,80509,2,0,8,10,
Caddo,Corporation Commissioner,Cliff Branan,REP,80509,0,1,12,13,
Caddo,U.S. Senate,Evelyn Rogers,REP,80509,0,0,3,3,
Caddo,U.S. Senate,Rob Moye,REP,80509,0,0,1,1,
Caddo,U.S. Senate,D. Jean Mcbride-Samuels,REP,80509,0,0,1,1,
Caddo,U.S. Senate,Jim Inhofe,REP,80509,1,2,17,20,
Caddo,U.S. Senate,Erick Paul Wyatt,REP,80509,1,0,0,1,
Caddo,U.S. Senate,Andy Craig,REP,80509,0,0,0,0,
Caddo,U.S. Senate,T. Shannon,REP,80509,0,1,12,13,
Caddo,U.S. Senate,Randy Brogdon,REP,80509,0,0,0,0,
Caddo,U.S. Senate,Eric Mccray,REP,80509,0,0,0,0,
Caddo,U.S. Senate,Kevin Crow,REP,80509,0,0,0,0,
Caddo,U.S. Senate,James Lankford,REP,80509,2,1,10,13,
Caddo,U.S. Senate,Jason Weger,REP,80509,0,0,0,0,
Caddo,U.S. House,Timothy Ray Murray,REP,80509,0,0,1,1,03
Caddo,U.S. House,Robert Hubbard,REP,80509,1,0,1,2,03
Caddo,U.S. House,Frank Lucas,REP,80509,1,2,18,21,03
Caddo,State Senate,Darcy Jech,REP,80509,0,1,10,11,26
Caddo,State Senate,Dan Gambill,REP,80509,2,1,9,12,26
Caddo,State House,Renae Sexton,REP,80509,0,1,7,8,65
Caddo,State House,Scott Hayes,REP,80509,0,0,8,8,65
Caddo,State House,Scooter Park,REP,80509,2,0,4,6,65
Caddo,State House,Stephen Mills,REP,80509,0,1,3,4,65
Caddo,Superintendent of Public Instruction,John Cox,DEM,80510,0,0,59,59,
Caddo,Superintendent of Public Instruction,Jack Jr.,DEM,80510,0,1,23,24,
Caddo,Superintendent of Public Instruction,Ivan Holmes,DEM,80510,0,1,9,10,
Caddo,Superintendent of Public Instruction,Freda Deskin,DEM,80510,2,0,28,30,
Caddo,U.S. Senate,Patrick Michael Hayes,DEM,80510,0,2,50,52,
Caddo,U.S. Senate,Jim Rogers,DEM,80510,1,0,48,49,
Caddo,U.S. Senate,Connie Johnson,DEM,80510,1,0,20,21,
Caddo,Governor,Dax Ewbank,REP,80510,0,0,12,12,
Caddo,Governor,Chad Moody,REP,80510,0,0,27,27,
Caddo,Governor,Mary Fallin,REP,80510,5,0,75,80,
Caddo,Superintendent of Public Instruction,Brian Kelly,REP,80510,0,0,22,22,
Caddo,Superintendent of Public Instruction,Janet Costello Barresi,REP,80510,0,0,12,12,
Caddo,Superintendent of Public Instruction,Joy Hofmeister,REP,80510,5,0,75,80,
Caddo,Insurance Commissioner,Bill Viner,REP,80510,1,0,24,25,
Caddo,Insurance Commissioner,John Doak,REP,80510,4,0,73,77,
Caddo,Corporation Commissioner,Todd Hiett,REP,80510,1,0,49,50,
Caddo,Corporation Commissioner,Cliff Branan,REP,80510,4,0,54,58,
Caddo,U.S. Senate,Evelyn Rogers,REP,80510,0,0,4,4,
Caddo,U.S. Senate,Rob Moye,REP,80510,0,0,2,2,
Caddo,U.S. Senate,D. Jean Mcbride-Samuels,REP,80510,0,0,2,2,
Caddo,U.S. Senate,Jim Inhofe,REP,80510,5,0,98,103,
Caddo,U.S. Senate,Erick Paul Wyatt,REP,80510,0,0,6,6,
Caddo,U.S. Senate,Andy Craig,REP,80510,0,0,1,1,
Caddo,U.S. Senate,T. Shannon,REP,80510,1,0,33,34,
Caddo,U.S. Senate,Randy Brogdon,REP,80510,0,0,1,1,
Caddo,U.S. Senate,Eric Mccray,REP,80510,0,0,1,1,
Caddo,U.S. Senate,Kevin Crow,REP,80510,0,0,3,3,
Caddo,U.S. Senate,James Lankford,REP,80510,4,0,76,80,
Caddo,U.S. Senate,Jason Weger,REP,80510,0,0,0,0,
Caddo,U.S. House,Timothy Ray Murray,REP,80510,0,0,6,6,03
Caddo,U.S. House,Robert Hubbard,REP,80510,0,0,6,6,03
Caddo,U.S. House,Frank Lucas,REP,80510,5,0,98,103,03
Caddo,State Senate,Darcy Jech,REP,80510,1,0,27,28,26
Caddo,State Senate,Dan Gambill,REP,80510,4,0,75,79,26
Caddo,State House,Renae Sexton,REP,80510,2,0,31,33,65
Caddo,State House,Scott Hayes,REP,80510,0,0,36,36,65
Caddo,State House,Scooter Park,REP,80510,0,0,30,30,65
Caddo,State House,Stephen Mills,REP,80510,3,0,17,20,65
Caddo,Superintendent of Public Instruction,John Cox,DEM,80511,4,4,81,89,
Caddo,Superintendent of Public Instruction,Jack Jr.,DEM,80511,0,3,31,34,
Caddo,Superintendent of Public Instruction,Ivan Holmes,DEM,80511,0,0,13,13,
Caddo,Superintendent of Public Instruction,Freda Deskin,DEM,80511,2,0,55,57,
Caddo,U.S. Senate,Patrick Michael Hayes,DEM,80511,2,1,69,72,
Caddo,U.S. Senate,Jim Rogers,DEM,80511,0,2,59,61,
Caddo,U.S. Senate,Connie Johnson,DEM,80511,4,3,45,52,
Caddo,Governor,Dax Ewbank,REP,80511,0,0,11,11,
Caddo,Governor,Chad Moody,REP,80511,0,1,26,27,
Caddo,Governor,Mary Fallin,REP,80511,0,3,65,68,
Caddo,Superintendent of Public Instruction,Brian Kelly,REP,80511,0,0,34,34,
Caddo,Superintendent of Public Instruction,Janet Costello Barresi,REP,80511,0,1,17,18,
Caddo,Superintendent of Public Instruction,Joy Hofmeister,REP,80511,0,3,48,51,
Caddo,Insurance Commissioner,Bill Viner,REP,80511,0,1,16,17,
Caddo,Insurance Commissioner,John Doak,REP,80511,0,3,78,81,
Caddo,Corporation Commissioner,Todd Hiett,REP,80511,0,2,39,41,
Caddo,Corporation Commissioner,Cliff Branan,REP,80511,0,2,53,55,
Caddo,U.S. Senate,Evelyn Rogers,REP,80511,0,0,9,9,
Caddo,U.S. Senate,Rob Moye,REP,80511,0,0,1,1,
Caddo,U.S. Senate,D. Jean Mcbride-Samuels,REP,80511,0,0,0,0,
Caddo,U.S. Senate,Jim Inhofe,REP,80511,0,4,85,89,
Caddo,U.S. Senate,Erick Paul Wyatt,REP,80511,0,0,7,7,
Caddo,U.S. Senate,Andy Craig,REP,80511,0,0,1,1,
Caddo,U.S. Senate,T. Shannon,REP,80511,0,2,43,45,
Caddo,U.S. Senate,Randy Brogdon,REP,80511,0,0,1,1,
Caddo,U.S. Senate,Eric Mccray,REP,80511,0,0,0,0,
Caddo,U.S. Senate,Kevin Crow,REP,80511,0,0,1,1,
Caddo,U.S. Senate,James Lankford,REP,80511,0,2,57,59,
Caddo,U.S. Senate,Jason Weger,REP,80511,0,0,0,0,
Caddo,U.S. House,Timothy Ray Murray,REP,80511,0,0,6,6,03
Caddo,U.S. House,Robert Hubbard,REP,80511,0,0,8,8,03
Caddo,U.S. House,Frank Lucas,REP,80511,0,4,86,90,03
Caddo,State Senate,Darcy Jech,REP,80511,0,2,39,41,26
Caddo,State Senate,Dan Gambill,REP,80511,0,2,61,63,26
Caddo,State House,Renae Sexton,REP,80511,0,1,42,43,65
Caddo,State House,Scott Hayes,REP,80511,0,1,26,27,65
Caddo,State House,Scooter Park,REP,80511,0,0,19,19,65
Caddo,State House,Stephen Mills,REP,80511,0,2,18,20,65
Caddo,Superintendent of Public Instruction,John Cox,DEM,80712,3,1,79,83,
Caddo,Superintendent of Public Instruction,Jack Jr.,DEM,80712,1,0,18,19,
Caddo,Superintendent of Public Instruction,Ivan Holmes,DEM,80712,0,0,8,8,
Caddo,Superintendent of Public Instruction,Freda Deskin,DEM,80712,1,3,37,41,
Caddo,U.S. Senate,Patrick Michael Hayes,DEM,80712,1,1,28,30,
Caddo,U.S. Senate,Jim Rogers,DEM,80712,2,3,70,75,
Caddo,U.S. Senate,Connie Johnson,DEM,80712,3,0,45,48,
Caddo,Governor,Dax Ewbank,REP,80712,0,0,7,7,
Caddo,Governor,Chad Moody,REP,80712,0,0,26,26,
Caddo,Governor,Mary Fallin,REP,80712,0,0,48,48,
Caddo,Superintendent of Public Instruction,Brian Kelly,REP,80712,0,0,15,15,
Caddo,Superintendent of Public Instruction,Janet Costello Barresi,REP,80712,0,0,11,11,
Caddo,Superintendent of Public Instruction,Joy Hofmeister,REP,80712,0,0,55,55,
Caddo,Insurance Commissioner,Bill Viner,REP,80712,0,0,18,18,
Caddo,Insurance Commissioner,John Doak,REP,80712,0,0,61,61,
Caddo,Corporation Commissioner,Todd Hiett,REP,80712,0,0,30,30,
Caddo,Corporation Commissioner,Cliff Branan,REP,80712,0,0,47,47,
Caddo,U.S. Senate,Evelyn Rogers,REP,80712,0,0,4,4,
Caddo,U.S. Senate,Rob Moye,REP,80712,0,0,0,0,
Caddo,U.S. Senate,D. Jean Mcbride-Samuels,REP,80712,0,0,0,0,
Caddo,U.S. Senate,Jim Inhofe,REP,80712,0,0,72,72,
Caddo,U.S. Senate,Erick Paul Wyatt,REP,80712,0,0,4,4,
Caddo,U.S. Senate,Andy Craig,REP,80712,0,0,0,0,
Caddo,U.S. Senate,T. Shannon,REP,80712,0,0,29,29,
Caddo,U.S. Senate,Randy Brogdon,REP,80712,0,0,3,3,
Caddo,U.S. Senate,Eric Mccray,REP,80712,0,0,1,1,
Caddo,U.S. Senate,Kevin Crow,REP,80712,0,0,1,1,
Caddo,U.S. Senate,James Lankford,REP,80712,0,0,46,46,
Caddo,U.S. Senate,Jason Weger,REP,80712,0,0,1,1,
Caddo,U.S. House,Timothy Ray Murray,REP,80712,0,0,4,4,03
Caddo,U.S. House,Robert Hubbard,REP,80712,0,0,6,6,03
Caddo,U.S. House,Frank Lucas,REP,80712,0,0,69,69,03
Caddo,State Senate,Darcy Jech,REP,80712,0,0,12,12,26
Caddo,State Senate,Dan Gambill,REP,80712,0,0,66,66,26
Caddo,Superintendent of Public Instruction,John Cox,DEM,80715,1,0,13,14,
Caddo,Superintendent of Public Instruction,Jack Jr.,DEM,80715,0,0,3,3,
Caddo,Superintendent of Public Instruction,Ivan Holmes,DEM,80715,0,0,5,5,
Caddo,Superintendent of Public Instruction,Freda Deskin,DEM,80715,0,0,8,8,
Caddo,U.S. Senate,Patrick Michael Hayes,DEM,80715,0,0,12,12,
Caddo,U.S. Senate,Jim Rogers,DEM,80715,1,0,11,12,
Caddo,U.S. Senate,Connie Johnson,DEM,80715,0,0,4,4,
Caddo,Governor,Dax Ewbank,REP,80715,0,0,1,1,
Caddo,Governor,Chad Moody,REP,80715,0,0,2,2,
Caddo,Governor,Mary Fallin,REP,80715,3,0,12,15,
Caddo,Superintendent of Public Instruction,Brian Kelly,REP,80715,0,0,1,1,
Caddo,Superintendent of Public Instruction,Janet Costello Barresi,REP,80715,1,0,2,3,
Caddo,Superintendent of Public Instruction,Joy Hofmeister,REP,80715,2,0,12,14,
Caddo,Insurance Commissioner,Bill Viner,REP,80715,2,0,2,4,
Caddo,Insurance Commissioner,John Doak,REP,80715,1,0,11,12,
Caddo,Corporation Commissioner,Todd Hiett,REP,80715,1,0,7,8,
Caddo,Corporation Commissioner,Cliff Branan,REP,80715,2,0,7,9,
Caddo,U.S. Senate,Evelyn Rogers,REP,80715,2,0,0,2,
Caddo,U.S. Senate,Rob Moye,REP,80715,0,0,0,0,
Caddo,U.S. Senate,D. Jean Mcbride-Samuels,REP,80715,0,0,0,0,
Caddo,U.S. Senate,Jim Inhofe,REP,80715,1,0,15,16,
Caddo,U.S. Senate,Erick Paul Wyatt,REP,80715,0,0,0,0,
Caddo,U.S. Senate,Andy Craig,REP,80715,0,0,0,0,
Caddo,U.S. Senate,T. Shannon,REP,80715,1,0,2,3,
Caddo,U.S. Senate,Randy Brogdon,REP,80715,0,0,0,0,
Caddo,U.S. Senate,Eric Mccray,REP,80715,0,0,0,0,
Caddo,U.S. Senate,Kevin Crow,REP,80715,0,0,0,0,
Caddo,U.S. Senate,James Lankford,REP,80715,2,0,13,15,
Caddo,U.S. Senate,Jason Weger,REP,80715,0,0,0,0,
Caddo,U.S. House,Timothy Ray Murray,REP,80715,1,0,0,1,03
Caddo,U.S. House,Robert Hubbard,REP,80715,0,0,1,1,03
Caddo,U.S. House,Frank Lucas,REP,80715,2,0,13,15,03
Caddo,State Senate,Darcy Jech,REP,80715,1,0,2,3,26
Caddo,State Senate,Dan Gambill,REP,80715,2,0,12,14,26
Caddo,Superintendent of Public Instruction,John Cox,DEM,80810,1,0,25,26,
Caddo,Superintendent of Public Instruction,Jack Jr.,DEM,80810,0,0,7,7,
Caddo,Superintendent of Public Instruction,Ivan Holmes,DEM,80810,0,0,2,2,
Caddo,Superintendent of Public Instruction,Freda Deskin,DEM,80810,0,2,17,19,
Caddo,U.S. Senate,Patrick Michael Hayes,DEM,80810,0,0,9,9,
Caddo,U.S. Senate,Jim Rogers,DEM,80810,1,1,25,27,
Caddo,U.S. Senate,Connie Johnson,DEM,80810,0,1,16,17,
Caddo,Governor,Dax Ewbank,REP,80810,0,0,4,4,
Caddo,Governor,Chad Moody,REP,80810,0,0,2,2,
Caddo,Governor,Mary Fallin,REP,80810,0,0,19,19,
Caddo,Superintendent of Public Instruction,Brian Kelly,REP,80810,0,0,4,4,
Caddo,Superintendent of Public Instruction,Janet Costello Barresi,REP,80810,0,0,5,5,
Caddo,Superintendent of Public Instruction,Joy Hofmeister,REP,80810,0,0,16,16,
Caddo,Insurance Commissioner,Bill Viner,REP,80810,0,0,4,4,
Caddo,Insurance Commissioner,John Doak,REP,80810,0,0,21,21,
Caddo,Corporation Commissioner,Todd Hiett,REP,80810,0,0,13,13,
Caddo,Corporation Commissioner,Cliff Branan,REP,80810,0,0,12,12,
Caddo,U.S. Senate,Evelyn Rogers,REP,80810,0,0,0,0,
Caddo,U.S. Senate,Rob Moye,REP,80810,0,0,0,0,
Caddo,U.S. Senate,D. Jean Mcbride-Samuels,REP,80810,0,0,1,1,
Caddo,U.S. Senate,Jim Inhofe,REP,80810,0,0,24,24,
Caddo,U.S. Senate,Erick Paul Wyatt,REP,80810,0,0,1,1,
Caddo,U.S. Senate,Andy Craig,REP,80810,0,0,0,0,
Caddo,U.S. Senate,T. Shannon,REP,80810,0,0,2,2,
Caddo,U.S. Senate,Randy Brogdon,REP,80810,0,0,0,0,
Caddo,U.S. Senate,Eric Mccray,REP,80810,0,0,1,1,
Caddo,U.S. Senate,Kevin Crow,REP,80810,0,0,1,1,
Caddo,U.S. Senate,James Lankford,REP,80810,0,0,19,19,
Caddo,U.S. Senate,Jason Weger,REP,80810,0,0,2,2,
Caddo,U.S. House,Timothy Ray Murray,REP,80810,0,0,1,1,03
Caddo,U.S. House,Robert Hubbard,REP,80810,0,0,1,1,03
Caddo,U.S. House,Frank Lucas,REP,80810,0,0,24,24,03
Caddo,State Senate,Darcy Jech,REP,80810,0,0,7,7,26
Caddo,State Senate,Dan Gambill,REP,80810,0,0,19,19,26
Caddo,Superintendent of Public Instruction,John Cox,DEM,80811,0,6,45,51,
Caddo,Superintendent of Public Instruction,Jack Jr.,DEM,80811,0,4,13,17,
Caddo,Superintendent of Public Instruction,Ivan Holmes,DEM,80811,0,3,7,10,
Caddo,Superintendent of Public Instruction,Freda Deskin,DEM,80811,1,1,25,27,
Caddo,U.S. Senate,Patrick Michael Hayes,DEM,80811,0,2,17,19,
Caddo,U.S. Senate,Jim Rogers,DEM,80811,0,6,43,49,
Caddo,U.S. Senate,Connie Johnson,DEM,80811,1,6,28,35,
Caddo,Governor,Dax Ewbank,REP,80811,0,0,1,1,
Caddo,Governor,Chad Moody,REP,80811,0,2,9,11,
Caddo,Governor,Mary Fallin,REP,80811,1,1,20,22,
Caddo,Superintendent of Public Instruction,Brian Kelly,REP,80811,1,1,8,10,
Caddo,Superintendent of Public Instruction,Janet Costello Barresi,REP,80811,0,0,4,4,
Caddo,Superintendent of Public Instruction,Joy Hofmeister,REP,80811,0,2,18,20,
Caddo,Insurance Commissioner,Bill Viner,REP,80811,0,0,5,5,
Caddo,Insurance Commissioner,John Doak,REP,80811,1,3,23,27,
Caddo,Corporation Commissioner,Todd Hiett,REP,80811,1,2,17,20,
Caddo,Corporation Commissioner,Cliff Branan,REP,80811,0,1,11,12,
Caddo,U.S. Senate,Evelyn Rogers,REP,80811,0,0,1,1,
Caddo,U.S. Senate,Rob Moye,REP,80811,0,0,0,0,
Caddo,U.S. Senate,D. Jean Mcbride-Samuels,REP,80811,0,0,2,2,
Caddo,U.S. Senate,Jim Inhofe,REP,80811,1,3,26,30,
Caddo,U.S. Senate,Erick Paul Wyatt,REP,80811,0,0,0,0,
Caddo,U.S. Senate,Andy Craig,REP,80811,0,0,0,0,
Caddo,U.S. Senate,T. Shannon,REP,80811,0,2,13,15,
Caddo,U.S. Senate,Randy Brogdon,REP,80811,0,0,0,0,
Caddo,U.S. Senate,Eric Mccray,REP,80811,0,0,0,0,
Caddo,U.S. Senate,Kevin Crow,REP,80811,0,0,0,0,
Caddo,U.S. Senate,James Lankford,REP,80811,1,1,18,20,
Caddo,U.S. Senate,Jason Weger,REP,80811,0,0,0,0,
Caddo,U.S. House,Timothy Ray Murray,REP,80811,0,0,5,5,03
Caddo,U.S. House,Robert Hubbard,REP,80811,0,0,1,1,03
Caddo,U.S. House,Frank Lucas,REP,80811,1,3,22,26,03
Caddo,State Senate,Darcy Jech,REP,80811,1,2,13,16,26
Caddo,State Senate,Dan Gambill,REP,80811,0,1,16,17,26
Caddo,Superintendent of Public Instruction,John Cox,DEM,80812,2,0,26,28,
Caddo,Superintendent of Public Instruction,Jack Jr.,DEM,80812,1,0,5,6,
Caddo,Superintendent of Public Instruction,Ivan Holmes,DEM,80812,0,0,4,4,
Caddo,Superintendent of Public Instruction,Freda Deskin,DEM,80812,0,0,10,10,
Caddo,U.S. Senate,Patrick Michael Hayes,DEM,80812,2,0,8,10,
Caddo,U.S. Senate,Jim Rogers,DEM,80812,1,0,18,19,
Caddo,U.S. Senate,Connie Johnson,DEM,80812,0,0,16,16,
Caddo,Governor,Dax Ewbank,REP,80812,0,0,0,0,
Caddo,Governor,Chad Moody,REP,80812,0,0,4,4,
Caddo,Governor,Mary Fallin,REP,80812,0,0,22,22,
Caddo,Superintendent of Public Instruction,Brian Kelly,REP,80812,0,0,7,7,
Caddo,Superintendent of Public Instruction,Janet Costello Barresi,REP,80812,0,0,4,4,
Caddo,Superintendent of Public Instruction,Joy Hofmeister,REP,80812,0,0,14,14,
Caddo,Insurance Commissioner,Bill Viner,REP,80812,0,0,7,7,
Caddo,Insurance Commissioner,John Doak,REP,80812,0,0,18,18,
Caddo,Corporation Commissioner,Todd Hiett,REP,80812,0,0,10,10,
Caddo,Corporation Commissioner,Cliff Branan,REP,80812,0,0,14,14,
Caddo,U.S. Senate,Evelyn Rogers,REP,80812,0,0,1,1,
Caddo,U.S. Senate,Rob Moye,REP,80812,0,0,0,0,
Caddo,U.S. Senate,D. Jean Mcbride-Samuels,REP,80812,0,0,0,0,
Caddo,U.S. Senate,Jim Inhofe,REP,80812,0,0,23,23,
Caddo,U.S. Senate,Erick Paul Wyatt,REP,80812,0,0,1,1,
Caddo,U.S. Senate,Andy Craig,REP,80812,0,0,0,0,
Caddo,U.S. Senate,T. Shannon,REP,80812,0,0,9,9,
Caddo,U.S. Senate,Randy Brogdon,REP,80812,0,0,0,0,
Caddo,U.S. Senate,Eric Mccray,REP,80812,0,0,0,0,
Caddo,U.S. Senate,Kevin Crow,REP,80812,0,0,0,0,
Caddo,U.S. Senate,James Lankford,REP,80812,0,0,17,17,
Caddo,U.S. Senate,Jason Weger,REP,80812,0,0,0,0,
Caddo,U.S. House,Timothy Ray Murray,REP,80812,0,0,2,2,03
Caddo,U.S. House,Robert Hubbard,REP,80812,0,0,2,2,03
Caddo,U.S. House,Frank Lucas,REP,80812,0,0,22,22,03
Caddo,State Senate,Darcy Jech,REP,80812,0,0,9,9,26
Caddo,State Senate,Dan Gambill,REP,80812,0,0,16,16,26
Caddo,Superintendent of Public Instruction,John Cox,DEM,81009,0,2,18,20,
Caddo,Superintendent of Public Instruction,Jack Jr.,DEM,81009,0,0,3,3,
Caddo,Superintendent of Public Instruction,Ivan Holmes,DEM,81009,0,0,2,2,
Caddo,Superintendent of Public Instruction,Freda Deskin,DEM,81009,0,0,12,12,
Caddo,U.S. Senate,Patrick Michael Hayes,DEM,81009,0,0,9,9,
Caddo,U.S. Senate,Jim Rogers,DEM,81009,0,2,11,13,
Caddo,U.S. Senate,Connie Johnson,DEM,81009,0,0,11,11,
Caddo,Governor,Dax Ewbank,REP,81009,0,1,5,6,
Caddo,Governor,Chad Moody,REP,81009,0,0,8,8,
Caddo,Governor,Mary Fallin,REP,81009,0,2,35,37,
Caddo,Superintendent of Public Instruction,Brian Kelly,REP,81009,0,2,16,18,
Caddo,Superintendent of Public Instruction,Janet Costello Barresi,REP,81009,0,0,3,3,
Caddo,Superintendent of Public Instruction,Joy Hofmeister,REP,81009,0,1,29,30,
Caddo,Insurance Commissioner,Bill Viner,REP,81009,0,0,11,11,
Caddo,Insurance Commissioner,John Doak,REP,81009,0,3,32,35,
Caddo,Corporation Commissioner,Todd Hiett,REP,81009,0,1,20,21,
Caddo,Corporation Commissioner,Cliff Branan,REP,81009,0,2,23,25,
Caddo,U.S. Senate,Evelyn Rogers,REP,81009,0,0,2,2,
Caddo,U.S. Senate,Rob Moye,REP,81009,0,0,2,2,
Caddo,U.S. Senate,D. Jean Mcbride-Samuels,REP,81009,0,0,0,0,
Caddo,U.S. Senate,Jim Inhofe,REP,81009,0,3,41,44,
Caddo,U.S. Senate,Erick Paul Wyatt,REP,81009,0,0,4,4,
Caddo,U.S. Senate,Andy Craig,REP,81009,0,0,1,1,
Caddo,U.S. Senate,T. Shannon,REP,81009,0,2,16,18,
Caddo,U.S. Senate,Randy Brogdon,REP,81009,0,1,0,1,
Caddo,U.S. Senate,Eric Mccray,REP,81009,0,0,0,0,
Caddo,U.S. Senate,Kevin Crow,REP,81009,0,0,0,0,
Caddo,U.S. Senate,James Lankford,REP,81009,0,0,29,29,
Caddo,U.S. Senate,Jason Weger,REP,81009,0,0,1,1,
Caddo,U.S. House,Timothy Ray Murray,REP,81009,0,0,2,2,03
Caddo,U.S. House,Robert Hubbard,REP,81009,0,1,4,5,03
Caddo,U.S. House,Frank Lucas,REP,81009,0,2,42,44,03
Caddo,State Senate,Darcy Jech,REP,81009,0,1,23,24,26
Caddo,State Senate,Dan Gambill,REP,81009,0,1,23,24,26
Caddo,Superintendent of Public Instruction,John Cox,DEM,81010,0,2,67,69,
Caddo,Superintendent of Public Instruction,Jack Jr.,DEM,81010,0,0,6,6,
Caddo,Superintendent of Public Instruction,Ivan Holmes,DEM,81010,0,0,6,6,
Caddo,Superintendent of Public Instruction,Freda Deskin,DEM,81010,2,2,29,33,
Caddo,U.S. Senate,Patrick Michael Hayes,DEM,81010,0,1,19,20,
Caddo,U.S. Senate,Jim Rogers,DEM,81010,0,1,68,69,
Caddo,U.S. Senate,Connie Johnson,DEM,81010,2,1,20,23,
Caddo,Governor,Dax Ewbank,REP,81010,0,0,0,0,
Caddo,Governor,Chad Moody,REP,81010,0,0,6,6,
Caddo,Governor,Mary Fallin,REP,81010,1,1,25,27,
Caddo,Superintendent of Public Instruction,Brian Kelly,REP,81010,1,0,7,8,
Caddo,Superintendent of Public Instruction,Janet Costello Barresi,REP,81010,0,0,4,4,
Caddo,Superintendent of Public Instruction,Joy Hofmeister,REP,81010,0,1,20,21,
Caddo,Insurance Commissioner,Bill Viner,REP,81010,1,0,5,6,
Caddo,Insurance Commissioner,John Doak,REP,81010,0,1,25,26,
Caddo,Corporation Commissioner,Todd Hiett,REP,81010,1,0,11,12,
Caddo,Corporation Commissioner,Cliff Branan,REP,81010,0,1,19,20,
Caddo,U.S. Senate,Evelyn Rogers,REP,81010,0,0,2,2,
Caddo,U.S. Senate,Rob Moye,REP,81010,0,0,0,0,
Caddo,U.S. Senate,D. Jean Mcbride-Samuels,REP,81010,0,0,1,1,
Caddo,U.S. Senate,Jim Inhofe,REP,81010,1,1,27,29,
Caddo,U.S. Senate,Erick Paul Wyatt,REP,81010,0,0,1,1,
Caddo,U.S. Senate,Andy Craig,REP,81010,0,0,1,1,
Caddo,U.S. Senate,T. Shannon,REP,81010,1,1,8,10,
Caddo,U.S. Senate,Randy Brogdon,REP,81010,0,0,0,0,
Caddo,U.S. Senate,Eric Mccray,REP,81010,0,0,0,0,
Caddo,U.S. Senate,Kevin Crow,REP,81010,0,0,0,0,
Caddo,U.S. Senate,James Lankford,REP,81010,0,0,22,22,
Caddo,U.S. Senate,Jason Weger,REP,81010,0,0,0,0,
Caddo,U.S. House,Timothy Ray Murray,REP,81010,0,0,0,0,03
Caddo,U.S. House,Robert Hubbard,REP,81010,1,0,2,3,03
Caddo,U.S. House,Frank Lucas,REP,81010,0,1,29,30,03
Caddo,State Senate,Darcy Jech,REP,81010,1,0,14,15,26
Caddo,State Senate,Dan Gambill,REP,81010,0,1,17,18,26
Caddo,Superintendent of Public Instruction,John Cox,DEM,81011,0,2,40,42,
Caddo,Superintendent of Public Instruction,Jack Jr.,DEM,81011,0,0,4,4,
Caddo,Superintendent of Public Instruction,Ivan Holmes,DEM,81011,0,0,1,1,
Caddo,Superintendent of Public Instruction,Freda Deskin,DEM,81011,0,0,15,15,
Caddo,U.S. Senate,Patrick Michael Hayes,DEM,81011,0,0,12,12,
Caddo,U.S. Senate,Jim Rogers,DEM,81011,0,2,35,37,
Caddo,U.S. Senate,Connie Johnson,DEM,81011,0,0,11,11,
Caddo,Governor,Dax Ewbank,REP,81011,0,0,4,4,
Caddo,Governor,Chad Moody,REP,81011,0,0,2,2,
Caddo,Governor,Mary Fallin,REP,81011,1,2,31,34,
Caddo,Superintendent of Public Instruction,Brian Kelly,REP,81011,1,1,17,19,
Caddo,Superintendent of Public Instruction,Janet Costello Barresi,REP,81011,0,0,3,3,
Caddo,Superintendent of Public Instruction,Joy Hofmeister,REP,81011,0,1,15,16,
Caddo,Insurance Commissioner,Bill Viner,REP,81011,0,0,9,9,
Caddo,Insurance Commissioner,John Doak,REP,81011,1,2,25,28,
Caddo,Corporation Commissioner,Todd Hiett,REP,81011,0,2,16,18,
Caddo,Corporation Commissioner,Cliff Branan,REP,81011,1,0,20,21,
Caddo,U.S. Senate,Evelyn Rogers,REP,81011,0,0,0,0,
Caddo,U.S. Senate,Rob Moye,REP,81011,0,0,0,0,
Caddo,U.S. Senate,D. Jean Mcbride-Samuels,REP,81011,0,0,0,0,
Caddo,U.S. Senate,Jim Inhofe,REP,81011,1,2,37,40,
Caddo,U.S. Senate,Erick Paul Wyatt,REP,81011,0,0,0,0,
Caddo,U.S. Senate,Andy Craig,REP,81011,0,0,0,0,
Caddo,U.S. Senate,T. Shannon,REP,81011,0,0,17,17,
Caddo,U.S. Senate,Randy Brogdon,REP,81011,0,0,1,1,
Caddo,U.S. Senate,Eric Mccray,REP,81011,0,0,0,0,
Caddo,U.S. Senate,Kevin Crow,REP,81011,0,0,0,0,
Caddo,U.S. Senate,James Lankford,REP,81011,1,2,20,23,
Caddo,U.S. Senate,Jason Weger,REP,81011,0,0,0,0,
Caddo,U.S. House,Timothy Ray Murray,REP,81011,0,0,0,0,03
Caddo,U.S. House,Robert Hubbard,REP,81011,0,0,2,2,03
Caddo,U.S. House,Frank Lucas,REP,81011,1,2,35,38,03
Caddo,State Senate,Darcy Jech,REP,81011,0,2,18,20,26
Caddo,State Senate,Dan Gambill,REP,81011,1,0,17,18,26
Caddo,Superintendent of Public Instruction,John Cox,DEM,81013,4,0,33,37,
Caddo,Superintendent of Public Instruction,Jack Jr.,DEM,81013,1,0,4,5,
Caddo,Superintendent of Public Instruction,Ivan Holmes,DEM,81013,0,0,5,5,
Caddo,Superintendent of Public Instruction,Freda Deskin,DEM,81013,1,0,16,17,
Caddo,U.S. Senate,Patrick Michael Hayes,DEM,81013,2,0,7,9,
Caddo,U.S. Senate,Jim Rogers,DEM,81013,0,0,24,24,
Caddo,U.S. Senate,Connie Johnson,DEM,81013,4,0,21,25,
Caddo,Governor,Dax Ewbank,REP,81013,0,0,2,2,
Caddo,Governor,Chad Moody,REP,81013,1,0,3,4,
Caddo,Governor,Mary Fallin,REP,81013,3,0,20,23,
Caddo,Superintendent of Public Instruction,Brian Kelly,REP,81013,1,0,2,3,
Caddo,Superintendent of Public Instruction,Janet Costello Barresi,REP,81013,0,0,2,2,
Caddo,Superintendent of Public Instruction,Joy Hofmeister,REP,81013,3,0,21,24,
Caddo,Insurance Commissioner,Bill Viner,REP,81013,0,0,2,2,
Caddo,Insurance Commissioner,John Doak,REP,81013,4,0,20,24,
Caddo,Corporation Commissioner,Todd Hiett,REP,81013,2,0,12,14,
Caddo,Corporation Commissioner,Cliff Branan,REP,81013,2,0,11,13,
Caddo,U.S. Senate,Evelyn Rogers,REP,81013,0,0,0,0,
Caddo,U.S. Senate,Rob Moye,REP,81013,0,0,0,0,
Caddo,U.S. Senate,D. Jean Mcbride-Samuels,REP,81013,0,0,0,0,
Caddo,U.S. Senate,Jim Inhofe,REP,81013,4,0,24,28,
Caddo,U.S. Senate,Erick Paul Wyatt,REP,81013,0,0,1,1,
Caddo,U.S. Senate,Andy Craig,REP,81013,0,0,0,0,
Caddo,U.S. Senate,T. Shannon,REP,81013,1,0,9,10,
Caddo,U.S. Senate,Randy Brogdon,REP,81013,0,0,1,1,
Caddo,U.S. Senate,Eric Mccray,REP,81013,0,0,0,0,
Caddo,U.S. Senate,Kevin Crow,REP,81013,0,0,0,0,
Caddo,U.S. Senate,James Lankford,REP,81013,3,0,13,16,
Caddo,U.S. Senate,Jason Weger,REP,81013,0,0,1,1,
Caddo,U.S. House,Timothy Ray Murray,REP,81013,0,0,1,1,03
Caddo,U.S. House,Robert Hubbard,REP,81013,0,0,3,3,03
Caddo,U.S. House,Frank Lucas,REP,81013,4,0,21,25,03
Caddo,State Senate,Darcy Jech,REP,81013,4,0,13,17,26
Caddo,State Senate,Dan Gambill,REP,81013,0,0,11,11,26
Caddo,Superintendent of Public Instruction,John Cox,DEM,81111,0,0,67,67,
Caddo,Superintendent of Public Instruction,Jack Jr.,DEM,81111,0,0,16,16,
Caddo,Superintendent of Public Instruction,Ivan Holmes,DEM,81111,0,0,11,11,
Caddo,Superintendent of Public Instruction,Freda Deskin,DEM,81111,1,0,42,43,
Caddo,U.S. Senate,Patrick Michael Hayes,DEM,81111,1,0,34,35,
Caddo,U.S. Senate,Jim Rogers,DEM,81111,0,0,66,66,
Caddo,U.S. Senate,Connie Johnson,DEM,81111,0,0,36,36,
Caddo,Governor,Dax Ewbank,REP,81111,0,1,18,19,
Caddo,Governor,Chad Moody,REP,81111,0,1,22,23,
Caddo,Governor,Mary Fallin,REP,81111,2,0,126,128,
Caddo,Superintendent of Public Instruction,Brian Kelly,REP,81111,0,0,23,23,
Caddo,Superintendent of Public Instruction,Janet Costello Barresi,REP,81111,1,0,18,19,
Caddo,Superintendent of Public Instruction,Joy Hofmeister,REP,81111,1,2,122,125,
Caddo,Insurance Commissioner,Bill Viner,REP,81111,1,1,25,27,
Caddo,Insurance Commissioner,John Doak,REP,81111,1,1,130,132,
Caddo,Corporation Commissioner,Todd Hiett,REP,81111,1,2,91,94,
Caddo,Corporation Commissioner,Cliff Branan,REP,81111,0,0,65,65,
Caddo,U.S. Senate,Evelyn Rogers,REP,81111,1,0,6,7,
Caddo,U.S. Senate,Rob Moye,REP,81111,0,0,1,1,
Caddo,U.S. Senate,D. Jean Mcbride-Samuels,REP,81111,0,0,0,0,
Caddo,U.S. Senate,Jim Inhofe,REP,81111,1,2,157,160,
Caddo,U.S. Senate,Erick Paul Wyatt,REP,81111,0,0,2,2,
Caddo,U.S. Senate,Andy Craig,REP,81111,0,0,1,1,
Caddo,U.S. Senate,T. Shannon,REP,81111,1,2,36,39,
Caddo,U.S. Senate,Randy Brogdon,REP,81111,0,0,1,1,
Caddo,U.S. Senate,Eric Mccray,REP,81111,0,0,0,0,
Caddo,U.S. Senate,Kevin Crow,REP,81111,0,0,0,0,
Caddo,U.S. Senate,James Lankford,REP,81111,1,0,126,127,
Caddo,U.S. Senate,Jason Weger,REP,81111,0,0,3,3,
Caddo,U.S. House,Timothy Ray Murray,REP,81111,0,0,4,4,03
Caddo,U.S. House,Robert Hubbard,REP,81111,0,0,7,7,03
Caddo,U.S. House,Frank Lucas,REP,81111,2,2,156,160,03
Caddo,State Senate,Darcy Jech,REP,81111,2,2,89,93,26
Caddo,State Senate,Dan Gambill,REP,81111,0,0,68,68,26
Caddo,Superintendent of Public Instruction,John Cox,DEM,81213,0,0,16,16,
Caddo,Superintendent of Public Instruction,Jack Jr.,DEM,81213,0,0,4,4,
Caddo,Superintendent of Public Instruction,Ivan Holmes,DEM,81213,0,0,0,0,
Caddo,Superintendent of Public Instruction,Freda Deskin,DEM,81213,1,0,10,11,
Caddo,U.S. Senate,Patrick Michael Hayes,DEM,81213,0,0,11,11,
Caddo,U.S. Senate,Jim Rogers,DEM,81213,0,0,10,10,
Caddo,U.S. Senate,Connie Johnson,DEM,81213,1,0,8,9,
Caddo,Governor,Dax Ewbank,REP,81213,0,0,7,7,
Caddo,Governor,Chad Moody,REP,81213,0,0,3,3,
Caddo,Governor,Mary Fallin,REP,81213,1,0,44,45,
Caddo,Superintendent of Public Instruction,Brian Kelly,REP,81213,0,0,12,12,
Caddo,Superintendent of Public Instruction,Janet Costello Barresi,REP,81213,0,0,4,4,
Caddo,Superintendent of Public Instruction,Joy Hofmeister,REP,81213,1,0,39,40,
Caddo,Insurance Commissioner,Bill Viner,REP,81213,0,0,7,7,
Caddo,Insurance Commissioner,John Doak,REP,81213,1,0,45,46,
Caddo,Corporation Commissioner,Todd Hiett,REP,81213,1,0,33,34,
Caddo,Corporation Commissioner,Cliff Branan,REP,81213,0,0,19,19,
Caddo,U.S. Senate,Evelyn Rogers,REP,81213,0,0,0,0,
Caddo,U.S. Senate,Rob Moye,REP,81213,0,0,2,2,
Caddo,U.S. Senate,D. Jean Mcbride-Samuels,REP,81213,0,0,0,0,
Caddo,U.S. Senate,Jim Inhofe,REP,81213,1,0,50,51,
Caddo,U.S. Senate,Erick Paul Wyatt,REP,81213,0,0,2,2,
Caddo,U.S. Senate,Andy Craig,REP,81213,0,0,0,0,
Caddo,U.S. Senate,T. Shannon,REP,81213,0,0,24,24,
Caddo,U.S. Senate,Randy Brogdon,REP,81213,0,0,0,0,
Caddo,U.S. Senate,Eric Mccray,REP,81213,0,0,0,0,
Caddo,U.S. Senate,Kevin Crow,REP,81213,0,0,0,0,
Caddo,U.S. Senate,James Lankford,REP,81213,1,0,31,32,
Caddo,U.S. Senate,Jason Weger,REP,81213,0,0,0,0,
Caddo,U.S. House,Timothy Ray Murray,REP,81213,0,0,4,4,03
Caddo,U.S. House,Robert Hubbard,REP,81213,0,0,3,3,03
Caddo,U.S. House,Frank Lucas,REP,81213,1,0,47,48,03
Caddo,State Senate,Darcy Jech,REP,81213,0,0,25,25,26
Caddo,State Senate,Dan Gambill,REP,81213,1,0,29,30,26
Canadian,Superintendent of Public Instruction,John Cox,DEM,90100,0,1,23,24,
Canadian,Superintendent of Public Instruction,Jack Jr.,DEM,90100,0,1,11,12,
Canadian,Superintendent of Public Instruction,Ivan Holmes,DEM,90100,0,0,6,6,
Canadian,Superintendent of Public Instruction,Freda Deskin,DEM,90100,0,1,16,17,
Canadian,U.S. Senate,Patrick Michael Hayes,DEM,90100,0,0,13,13,
Canadian,U.S. Senate,Jim Rogers,DEM,90100,0,1,16,17,
Canadian,U.S. Senate,Connie Johnson,DEM,90100,0,2,25,27,
Canadian,Governor,Dax Ewbank,REP,90100,0,0,16,16,
Canadian,Governor,Chad Moody,REP,90100,0,2,23,25,
Canadian,Governor,Mary Fallin,REP,90100,3,7,134,144,
Canadian,Superintendent of Public Instruction,Brian Kelly,REP,90100,4,2,52,58,
Canadian,Superintendent of Public Instruction,Janet Costello Barresi,REP,90100,0,2,33,35,
Canadian,Superintendent of Public Instruction,Joy Hofmeister,REP,90100,0,5,88,93,
Canadian,Insurance Commissioner,Bill Viner,REP,90100,2,5,43,50,
Canadian,Insurance Commissioner,John Doak,REP,90100,2,4,120,126,
Canadian,Corporation Commissioner,Todd Hiett,REP,90100,4,4,73,81,
Canadian,Corporation Commissioner,Cliff Branan,REP,90100,0,5,91,96,
Canadian,U.S. Senate,Evelyn Rogers,REP,90100,0,1,7,8,
Canadian,U.S. Senate,Rob Moye,REP,90100,0,0,3,3,
Canadian,U.S. Senate,D. Jean Mcbride-Samuels,REP,90100,0,0,8,8,
Canadian,U.S. Senate,Jim Inhofe,REP,90100,4,6,146,156,
Canadian,U.S. Senate,Erick Paul Wyatt,REP,90100,0,2,10,12,
Canadian,U.S. Senate,Andy Craig,REP,90100,0,0,3,3,
Canadian,U.S. Senate,T. Shannon,REP,90100,3,3,52,58,
Canadian,U.S. Senate,Randy Brogdon,REP,90100,0,0,7,7,
Canadian,U.S. Senate,Eric Mccray,REP,90100,0,0,2,2,
Canadian,U.S. Senate,Kevin Crow,REP,90100,0,0,1,1,
Canadian,U.S. Senate,James Lankford,REP,90100,1,6,110,117,
Canadian,U.S. Senate,Jason Weger,REP,90100,0,0,1,1,
Canadian,U.S. House,Timothy Ray Murray,REP,90100,0,2,10,12,03
Canadian,U.S. House,Robert Hubbard,REP,90100,0,1,21,22,03
Canadian,U.S. House,Frank Lucas,REP,90100,4,6,143,153,03
Canadian,Superintendent of Public Instruction,John Cox,DEM,90102,0,0,7,7,
Canadian,Superintendent of Public Instruction,Jack Jr.,DEM,90102,0,0,0,0,
Canadian,Superintendent of Public Instruction,Ivan Holmes,DEM,90102,0,0,1,1,
Canadian,Superintendent of Public Instruction,Freda Deskin,DEM,90102,0,0,10,10,
Canadian,U.S. Senate,Patrick Michael Hayes,DEM,90102,0,0,3,3,
Canadian,U.S. Senate,Jim Rogers,DEM,90102,0,0,6,6,
Canadian,U.S. Senate,Connie Johnson,DEM,90102,0,0,8,8,
Canadian,Governor,Dax Ewbank,REP,90102,0,0,1,1,
Canadian,Governor,Chad Moody,REP,90102,0,2,2,4,
Canadian,Governor,Mary Fallin,REP,90102,0,6,41,47,
Canadian,Superintendent of Public Instruction,Brian Kelly,REP,90102,0,3,13,16,
Canadian,Superintendent of Public Instruction,Janet Costello Barresi,REP,90102,0,0,12,12,
Canadian,Superintendent of Public Instruction,Joy Hofmeister,REP,90102,0,5,16,21,
Canadian,Insurance Commissioner,Bill Viner,REP,90102,0,2,6,8,
Canadian,Insurance Commissioner,John Doak,REP,90102,0,6,35,41,
Canadian,Corporation Commissioner,Todd Hiett,REP,90102,0,3,14,17,
Canadian,Corporation Commissioner,Cliff Branan,REP,90102,0,5,24,29,
Canadian,U.S. Senate,Evelyn Rogers,REP,90102,0,1,1,2,
Canadian,U.S. Senate,Rob Moye,REP,90102,0,0,1,1,
Canadian,U.S. Senate,D. Jean Mcbride-Samuels,REP,90102,0,0,0,0,
Canadian,U.S. Senate,Jim Inhofe,REP,90102,0,7,40,47,
Canadian,U.S. Senate,Erick Paul Wyatt,REP,90102,0,0,1,1,
Canadian,U.S. Senate,Andy Craig,REP,90102,0,0,0,0,
Canadian,U.S. Senate,T. Shannon,REP,90102,0,1,17,18,
Canadian,U.S. Senate,Randy Brogdon,REP,90102,0,0,1,1,
Canadian,U.S. Senate,Eric Mccray,REP,90102,0,0,0,0,
Canadian,U.S. Senate,Kevin Crow,REP,90102,0,0,0,0,
Canadian,U.S. Senate,James Lankford,REP,90102,0,7,26,33,
Canadian,U.S. Senate,Jason Weger,REP,90102,0,0,0,0,
Canadian,U.S. House,Timothy Ray Murray,REP,90102,0,0,2,2,03
Canadian,U.S. House,Robert Hubbard,REP,90102,0,1,5,6,03
Canadian,U.S. House,Frank Lucas,REP,90102,0,7,37,44,03
Canadian,Superintendent of Public Instruction,John Cox,DEM,90106,0,1,16,17,
Canadian,Superintendent of Public Instruction,Jack Jr.,DEM,90106,0,0,12,12,
Canadian,Superintendent of Public Instruction,Ivan Holmes,DEM,90106,0,0,2,2,
Canadian,Superintendent of Public Instruction,Freda Deskin,DEM,90106,2,5,37,44,
Canadian,U.S. Senate,Patrick Michael Hayes,DEM,90106,0,1,8,9,
Canadian,U.S. Senate,Jim Rogers,DEM,90106,0,0,27,27,
Canadian,U.S. Senate,Connie Johnson,DEM,90106,2,5,30,37,
Canadian,Governor,Dax Ewbank,REP,90106,0,1,17,18,
Canadian,Governor,Chad Moody,REP,90106,2,4,26,32,
Canadian,Governor,Mary Fallin,REP,90106,4,19,128,151,
Canadian,Superintendent of Public Instruction,Brian Kelly,REP,90106,0,6,30,36,
Canadian,Superintendent of Public Instruction,Janet Costello Barresi,REP,90106,2,1,46,49,
Canadian,Superintendent of Public Instruction,Joy Hofmeister,REP,90106,5,16,93,114,
Canadian,Insurance Commissioner,Bill Viner,REP,90106,3,3,34,40,
Canadian,Insurance Commissioner,John Doak,REP,90106,3,19,128,150,
Canadian,Corporation Commissioner,Todd Hiett,REP,90106,4,12,79,95,
Canadian,Corporation Commissioner,Cliff Branan,REP,90106,2,11,86,99,
Canadian,U.S. Senate,Evelyn Rogers,REP,90106,0,1,13,14,
Canadian,U.S. Senate,Rob Moye,REP,90106,0,0,3,3,
Canadian,U.S. Senate,D. Jean Mcbride-Samuels,REP,90106,1,0,3,4,
Canadian,U.S. Senate,Jim Inhofe,REP,90106,5,23,147,175,
Canadian,U.S. Senate,Erick Paul Wyatt,REP,90106,0,0,3,3,
Canadian,U.S. Senate,Andy Craig,REP,90106,0,0,1,1,
Canadian,U.S. Senate,T. Shannon,REP,90106,0,5,53,58,
Canadian,U.S. Senate,Randy Brogdon,REP,90106,0,0,4,4,
Canadian,U.S. Senate,Eric Mccray,REP,90106,0,0,2,2,
Canadian,U.S. Senate,Kevin Crow,REP,90106,0,0,0,0,
Canadian,U.S. Senate,James Lankford,REP,90106,7,19,112,138,
Canadian,U.S. Senate,Jason Weger,REP,90106,0,0,0,0,
Canadian,U.S. House,Timothy Ray Murray,REP,90106,0,1,3,4,03
Canadian,U.S. House,Robert Hubbard,REP,90106,1,2,7,10,03
Canadian,U.S. House,Frank Lucas,REP,90106,5,21,158,184,03
Canadian,Superintendent of Public Instruction,John Cox,DEM,90107,0,1,10,11,
Canadian,Superintendent of Public Instruction,Jack Jr.,DEM,90107,0,0,2,2,
Canadian,Superintendent of Public Instruction,Ivan Holmes,DEM,90107,0,0,2,2,
Canadian,Superintendent of Public Instruction,Freda Deskin,DEM,90107,0,0,12,12,
Canadian,U.S. Senate,Patrick Michael Hayes,DEM,90107,0,1,10,11,
Canadian,U.S. Senate,Jim Rogers,DEM,90107,0,0,8,8,
Canadian,U.S. Senate,Connie Johnson,DEM,90107,0,0,8,8,
Canadian,Governor,Dax Ewbank,REP,90107,0,1,4,5,
Canadian,Governor,Chad Moody,REP,90107,0,0,11,11,
Canadian,Governor,Mary Fallin,REP,90107,0,9,76,85,
Canadian,Superintendent of Public Instruction,Brian Kelly,REP,90107,0,2,13,15,
Canadian,Superintendent of Public Instruction,Janet Costello Barresi,REP,90107,0,0,17,17,
Canadian,Superintendent of Public Instruction,Joy Hofmeister,REP,90107,0,8,59,67,
Canadian,Insurance Commissioner,Bill Viner,REP,90107,0,2,18,20,
Canadian,Insurance Commissioner,John Doak,REP,90107,0,8,67,75,
Canadian,Corporation Commissioner,Todd Hiett,REP,90107,0,6,34,40,
Canadian,Corporation Commissioner,Cliff Branan,REP,90107,0,4,50,54,
Canadian,U.S. Senate,Evelyn Rogers,REP,90107,0,1,3,4,
Canadian,U.S. Senate,Rob Moye,REP,90107,0,0,0,0,
Canadian,U.S. Senate,D. Jean Mcbride-Samuels,REP,90107,0,0,0,0,
Canadian,U.S. Senate,Jim Inhofe,REP,90107,0,8,84,92,
Canadian,U.S. Senate,Erick Paul Wyatt,REP,90107,0,0,4,4,
Canadian,U.S. Senate,Andy Craig,REP,90107,0,0,0,0,
Canadian,U.S. Senate,T. Shannon,REP,90107,0,1,21,22,
Canadian,U.S. Senate,Randy Brogdon,REP,90107,0,0,0,0,
Canadian,U.S. Senate,Eric Mccray,REP,90107,0,1,0,1,
Canadian,U.S. Senate,Kevin Crow,REP,90107,0,0,0,0,
Canadian,U.S. Senate,James Lankford,REP,90107,0,8,70,78,
Canadian,U.S. Senate,Jason Weger,REP,90107,0,0,0,0,
Canadian,U.S. House,Timothy Ray Murray,REP,90107,0,1,4,5,03
Canadian,U.S. House,Robert Hubbard,REP,90107,0,0,4,4,03
Canadian,U.S. House,Frank Lucas,REP,90107,0,9,82,91,03
Canadian,Superintendent of Public Instruction,John Cox,DEM,90109,1,0,2,3,
Canadian,Superintendent of Public Instruction,Jack Jr.,DEM,90109,0,0,3,3,
Canadian,Superintendent of Public Instruction,Ivan Holmes,DEM,90109,0,0,1,1,
Canadian,Superintendent of Public Instruction,Freda Deskin,DEM,90109,1,0,4,5,
Canadian,U.S. Senate,Patrick Michael Hayes,DEM,90109,0,0,4,4,
Canadian,U.S. Senate,Jim Rogers,DEM,90109,1,0,3,4,
Canadian,U.S. Senate,Connie Johnson,DEM,90109,1,0,3,4,
Canadian,Governor,Dax Ewbank,REP,90109,0,0,6,6,
Canadian,Governor,Chad Moody,REP,90109,0,2,3,5,
Canadian,Governor,Mary Fallin,REP,90109,0,3,31,34,
Canadian,Superintendent of Public Instruction,Brian Kelly,REP,90109,0,3,10,13,
Canadian,Superintendent of Public Instruction,Janet Costello Barresi,REP,90109,0,0,4,4,
Canadian,Superintendent of Public Instruction,Joy Hofmeister,REP,90109,0,2,27,29,
Canadian,Insurance Commissioner,Bill Viner,REP,90109,0,0,8,8,
Canadian,Insurance Commissioner,John Doak,REP,90109,0,5,32,37,
Canadian,Corporation Commissioner,Todd Hiett,REP,90109,0,3,24,27,
Canadian,Corporation Commissioner,Cliff Branan,REP,90109,0,2,16,18,
Canadian,U.S. Senate,Evelyn Rogers,REP,90109,0,0,0,0,
Canadian,U.S. Senate,Rob Moye,REP,90109,0,0,1,1,
Canadian,U.S. Senate,D. Jean Mcbride-Samuels,REP,90109,0,0,0,0,
Canadian,U.S. Senate,Jim Inhofe,REP,90109,0,4,36,40,
Canadian,U.S. Senate,Erick Paul Wyatt,REP,90109,0,1,3,4,
Canadian,U.S. Senate,Andy Craig,REP,90109,0,0,2,2,
Canadian,U.S. Senate,T. Shannon,REP,90109,0,2,14,16,
Canadian,U.S. Senate,Randy Brogdon,REP,90109,0,0,0,0,
Canadian,U.S. Senate,Eric Mccray,REP,90109,0,0,0,0,
Canadian,U.S. Senate,Kevin Crow,REP,90109,0,0,1,1,
Canadian,U.S. Senate,James Lankford,REP,90109,0,3,24,27,
Canadian,U.S. Senate,Jason Weger,REP,90109,0,0,0,0,
Canadian,U.S. House,Timothy Ray Murray,REP,90109,0,0,2,2,03
Canadian,U.S. House,Robert Hubbard,REP,90109,0,3,2,5,03
Canadian,U.S. House,Frank Lucas,REP,90109,0,2,37,39,03
Canadian,Superintendent of Public Instruction,John Cox,DEM,90114,0,1,13,14,
Canadian,Superintendent of Public Instruction,Jack Jr.,DEM,90114,0,2,9,11,
Canadian,Superintendent of Public Instruction,Ivan Holmes,DEM,90114,0,0,3,3,
Canadian,Superintendent of Public Instruction,Freda Deskin,DEM,90114,0,2,16,18,
Canadian,U.S. Senate,Patrick Michael Hayes,DEM,90114,0,1,9,10,
Canadian,U.S. Senate,Jim Rogers,DEM,90114,0,4,15,19,
Canadian,U.S. Senate,Connie Johnson,DEM,90114,0,0,16,16,
Canadian,Governor,Dax Ewbank,REP,90114,0,1,6,7,
Canadian,Governor,Chad Moody,REP,90114,1,7,16,24,
Canadian,Governor,Mary Fallin,REP,90114,6,12,115,133,
Canadian,Superintendent of Public Instruction,Brian Kelly,REP,90114,2,5,25,32,
Canadian,Superintendent of Public Instruction,Janet Costello Barresi,REP,90114,2,1,19,22,
Canadian,Superintendent of Public Instruction,Joy Hofmeister,REP,90114,3,14,91,108,
Canadian,Insurance Commissioner,Bill Viner,REP,90114,1,6,27,34,
Canadian,Insurance Commissioner,John Doak,REP,90114,6,12,100,118,
Canadian,Corporation Commissioner,Todd Hiett,REP,90114,2,7,57,66,
Canadian,Corporation Commissioner,Cliff Branan,REP,90114,5,12,65,82,
Canadian,U.S. Senate,Evelyn Rogers,REP,90114,0,3,6,9,
Canadian,U.S. Senate,Rob Moye,REP,90114,0,0,1,1,
Canadian,U.S. Senate,D. Jean Mcbride-Samuels,REP,90114,0,0,1,1,
Canadian,U.S. Senate,Jim Inhofe,REP,90114,7,15,125,147,
Canadian,U.S. Senate,Erick Paul Wyatt,REP,90114,0,1,5,6,
Canadian,U.S. Senate,Andy Craig,REP,90114,0,0,1,1,
Canadian,U.S. Senate,T. Shannon,REP,90114,3,2,48,53,
Canadian,U.S. Senate,Randy Brogdon,REP,90114,0,1,2,3,
Canadian,U.S. Senate,Eric Mccray,REP,90114,0,1,0,1,
Canadian,U.S. Senate,Kevin Crow,REP,90114,0,0,0,0,
Canadian,U.S. Senate,James Lankford,REP,90114,4,16,87,107,
Canadian,U.S. Senate,Jason Weger,REP,90114,0,0,1,1,
Canadian,U.S. House,Timothy Ray Murray,REP,90114,0,1,6,7,03
Canadian,U.S. House,Robert Hubbard,REP,90114,0,4,15,19,03
Canadian,U.S. House,Frank Lucas,REP,90114,7,15,115,137,03
Canadian,Superintendent of Public Instruction,John Cox,DEM,90116,0,2,32,34,
Canadian,Superintendent of Public Instruction,Jack Jr.,DEM,90116,1,1,12,14,
Canadian,Superintendent of Public Instruction,Ivan Holmes,DEM,90116,0,0,4,4,
Canadian,Superintendent of Public Instruction,Freda Deskin,DEM,90116,0,4,33,37,
Canadian,U.S. Senate,Patrick Michael Hayes,DEM,90116,1,0,17,18,
Canadian,U.S. Senate,Jim Rogers,DEM,90116,0,1,29,30,
Canadian,U.S. Senate,Connie Johnson,DEM,90116,0,4,33,37,
Canadian,Governor,Dax Ewbank,REP,90116,0,1,8,9,
Canadian,Governor,Chad Moody,REP,90116,0,5,23,28,
Canadian,Governor,Mary Fallin,REP,90116,3,31,113,147,
Canadian,Superintendent of Public Instruction,Brian Kelly,REP,90116,0,16,34,50,
Canadian,Superintendent of Public Instruction,Janet Costello Barresi,REP,90116,2,4,21,27,
Canadian,Superintendent of Public Instruction,Joy Hofmeister,REP,90116,1,17,91,109,
Canadian,Insurance Commissioner,Bill Viner,REP,90116,0,9,32,41,
Canadian,Insurance Commissioner,John Doak,REP,90116,3,25,108,136,
Canadian,Corporation Commissioner,Todd Hiett,REP,90116,0,16,71,87,
Canadian,Corporation Commissioner,Cliff Branan,REP,90116,3,17,64,84,
Canadian,U.S. Senate,Evelyn Rogers,REP,90116,0,1,8,9,
Canadian,U.S. Senate,Rob Moye,REP,90116,0,0,0,0,
Canadian,U.S. Senate,D. Jean Mcbride-Samuels,REP,90116,0,0,3,3,
Canadian,U.S. Senate,Jim Inhofe,REP,90116,3,34,127,164,
Canadian,U.S. Senate,Erick Paul Wyatt,REP,90116,0,3,8,11,
Canadian,U.S. Senate,Andy Craig,REP,90116,0,0,0,0,
Canadian,U.S. Senate,T. Shannon,REP,90116,0,7,43,50,
Canadian,U.S. Senate,Randy Brogdon,REP,90116,0,1,1,2,
Canadian,U.S. Senate,Eric Mccray,REP,90116,0,0,2,2,
Canadian,U.S. Senate,Kevin Crow,REP,90116,0,1,5,6,
Canadian,U.S. Senate,James Lankford,REP,90116,3,28,94,125,
Canadian,U.S. Senate,Jason Weger,REP,90116,0,0,0,0,
Canadian,U.S. House,Timothy Ray Murray,REP,90116,0,2,5,7,03
Canadian,U.S. House,Robert Hubbard,REP,90116,0,6,11,17,03
Canadian,U.S. House,Frank Lucas,REP,90116,3,28,127,158,03
Canadian,Superintendent of Public Instruction,John Cox,DEM,90124,0,5,33,38,
Canadian,Superintendent of Public Instruction,Jack Jr.,DEM,90124,0,1,21,22,
Canadian,Superintendent of Public Instruction,Ivan Holmes,DEM,90124,0,0,5,5,
Canadian,Superintendent of Public Instruction,Freda Deskin,DEM,90124,1,3,47,51,
Canadian,U.S. Senate,Patrick Michael Hayes,DEM,90124,1,2,23,26,
Canadian,U.S. Senate,Jim Rogers,DEM,90124,0,4,32,36,
Canadian,U.S. Senate,Connie Johnson,DEM,90124,1,2,49,52,
Canadian,Governor,Dax Ewbank,REP,90124,2,1,11,14,
Canadian,Governor,Chad Moody,REP,90124,0,4,28,32,
Canadian,Governor,Mary Fallin,REP,90124,2,13,191,206,
Canadian,Superintendent of Public Instruction,Brian Kelly,REP,90124,1,5,61,67,
Canadian,Superintendent of Public Instruction,Janet Costello Barresi,REP,90124,0,4,46,50,
Canadian,Superintendent of Public Instruction,Joy Hofmeister,REP,90124,3,12,126,141,
Canadian,Insurance Commissioner,Bill Viner,REP,90124,1,1,49,51,
Canadian,Insurance Commissioner,John Doak,REP,90124,3,14,170,187,
Canadian,Corporation Commissioner,Todd Hiett,REP,90124,3,4,98,105,
Canadian,Corporation Commissioner,Cliff Branan,REP,90124,1,13,119,133,
Canadian,U.S. Senate,Evelyn Rogers,REP,90124,0,2,9,11,
Canadian,U.S. Senate,Rob Moye,REP,90124,0,0,3,3,
Canadian,U.S. Senate,D. Jean Mcbride-Samuels,REP,90124,0,0,4,4,
Canadian,U.S. Senate,Jim Inhofe,REP,90124,4,16,204,224,
Canadian,U.S. Senate,Erick Paul Wyatt,REP,90124,0,0,12,12,
Canadian,U.S. Senate,Andy Craig,REP,90124,0,0,3,3,
Canadian,U.S. Senate,T. Shannon,REP,90124,1,9,59,69,
Canadian,U.S. Senate,Randy Brogdon,REP,90124,0,1,4,5,
Canadian,U.S. Senate,Eric Mccray,REP,90124,0,0,3,3,
Canadian,U.S. Senate,Kevin Crow,REP,90124,0,0,1,1,
Canadian,U.S. Senate,James Lankford,REP,90124,3,11,160,174,
Canadian,U.S. Senate,Jason Weger,REP,90124,0,0,2,2,
Canadian,U.S. House,Timothy Ray Murray,REP,90124,0,1,9,10,03
Canadian,U.S. House,Robert Hubbard,REP,90124,0,3,29,32,03
Canadian,U.S. House,Frank Lucas,REP,90124,4,15,194,213,03
Canadian,Superintendent of Public Instruction,John Cox,DEM,90200,1,0,46,47,
Canadian,Superintendent of Public Instruction,Jack Jr.,DEM,90200,0,0,19,19,
Canadian,Superintendent of Public Instruction,Ivan Holmes,DEM,90200,1,0,8,9,
Canadian,Superintendent of Public Instruction,Freda Deskin,DEM,90200,3,0,62,65,
Canadian,U.S. Senate,Patrick Michael Hayes,DEM,90200,0,0,24,24,
Canadian,U.S. Senate,Jim Rogers,DEM,90200,1,0,31,32,
Canadian,U.S. Senate,Connie Johnson,DEM,90200,4,0,76,80,
Canadian,Governor,Dax Ewbank,REP,90200,1,3,66,70,
Canadian,Governor,Chad Moody,REP,90200,2,2,125,129,
Canadian,Governor,Mary Fallin,REP,90200,12,10,595,617,
Canadian,Superintendent of Public Instruction,Brian Kelly,REP,90200,3,1,194,198,
Canadian,Superintendent of Public Instruction,Janet Costello Barresi,REP,90200,5,4,173,182,
Canadian,Superintendent of Public Instruction,Joy Hofmeister,REP,90200,7,10,412,429,
Canadian,Insurance Commissioner,Bill Viner,REP,90200,7,1,153,161,
Canadian,Insurance Commissioner,John Doak,REP,90200,6,14,576,596,
Canadian,Corporation Commissioner,Todd Hiett,REP,90200,2,10,325,337,
Canadian,Corporation Commissioner,Cliff Branan,REP,90200,11,5,395,411,
Canadian,U.S. Senate,Evelyn Rogers,REP,90200,1,0,31,32,
Canadian,U.S. Senate,Rob Moye,REP,90200,3,0,10,13,
Canadian,U.S. Senate,D. Jean Mcbride-Samuels,REP,90200,0,0,8,8,
Canadian,U.S. Senate,Jim Inhofe,REP,90200,11,14,699,724,
Canadian,U.S. Senate,Erick Paul Wyatt,REP,90200,0,1,31,32,
Canadian,U.S. Senate,Andy Craig,REP,90200,1,0,8,9,
Canadian,U.S. Senate,T. Shannon,REP,90200,0,4,180,184,
Canadian,U.S. Senate,Randy Brogdon,REP,90200,0,1,18,19,
Canadian,U.S. Senate,Eric Mccray,REP,90200,0,0,7,7,
Canadian,U.S. Senate,Kevin Crow,REP,90200,0,0,4,4,
Canadian,U.S. Senate,James Lankford,REP,90200,14,10,571,595,
Canadian,U.S. Senate,Jason Weger,REP,90200,0,0,2,2,
Canadian,U.S. House,Timothy Ray Murray,REP,90200,2,1,31,34,03
Canadian,U.S. House,Robert Hubbard,REP,90200,4,1,122,127,03
Canadian,U.S. House,Frank Lucas,REP,90200,9,13,618,640,03
Canadian,State Senate,Mark Thomas,REP,90200,6,2,282,290,22
Canadian,State Senate,Leif Francel,REP,90200,2,5,216,223,22
Canadian,State Senate,Stephanie Bice,REP,90200,4,4,240,248,22
Canadian,State House,Ross Vanhooser,REP,90200,5,3,260,268,41
Canadian,State House,John Enns,REP,90200,8,8,467,483,41
Canadian,Superintendent of Public Instruction,John Cox,DEM,90201,2,0,15,17,
Canadian,Superintendent of Public Instruction,Jack Jr.,DEM,90201,0,1,5,6,
Canadian,Superintendent of Public Instruction,Ivan Holmes,DEM,90201,0,0,6,6,
Canadian,Superintendent of Public Instruction,Freda Deskin,DEM,90201,2,0,24,26,
Canadian,U.S. Senate,Patrick Michael Hayes,DEM,90201,0,1,10,11,
Canadian,U.S. Senate,Jim Rogers,DEM,90201,2,0,14,16,
Canadian,U.S. Senate,Connie Johnson,DEM,90201,2,0,23,25,
Canadian,Governor,Dax Ewbank,REP,90201,0,1,38,39,
Canadian,Governor,Chad Moody,REP,90201,3,0,48,51,
Canadian,Governor,Mary Fallin,REP,90201,8,7,232,247,
Canadian,Superintendent of Public Instruction,Brian Kelly,REP,90201,4,1,79,84,
Canadian,Superintendent of Public Instruction,Janet Costello Barresi,REP,90201,2,0,66,68,
Canadian,Superintendent of Public Instruction,Joy Hofmeister,REP,90201,5,7,178,190,
Canadian,Insurance Commissioner,Bill Viner,REP,90201,0,2,73,75,
Canadian,Insurance Commissioner,John Doak,REP,90201,11,6,238,255,
Canadian,Corporation Commissioner,Todd Hiett,REP,90201,5,5,158,168,
Canadian,Corporation Commissioner,Cliff Branan,REP,90201,5,3,150,158,
Canadian,U.S. Senate,Evelyn Rogers,REP,90201,0,0,12,12,
Canadian,U.S. Senate,Rob Moye,REP,90201,0,0,12,12,
Canadian,U.S. Senate,D. Jean Mcbride-Samuels,REP,90201,0,0,4,4,
Canadian,U.S. Senate,Jim Inhofe,REP,90201,7,8,277,292,
Canadian,U.S. Senate,Erick Paul Wyatt,REP,90201,4,0,14,18,
Canadian,U.S. Senate,Andy Craig,REP,90201,0,0,5,5,
Canadian,U.S. Senate,T. Shannon,REP,90201,5,2,84,91,
Canadian,U.S. Senate,Randy Brogdon,REP,90201,3,0,12,15,
Canadian,U.S. Senate,Eric Mccray,REP,90201,0,0,0,0,
Canadian,U.S. Senate,Kevin Crow,REP,90201,0,0,2,2,
Canadian,U.S. Senate,James Lankford,REP,90201,3,6,218,227,
Canadian,U.S. Senate,Jason Weger,REP,90201,0,0,1,1,
Canadian,U.S. House,Timothy Ray Murray,REP,90201,0,0,7,7,03
Canadian,U.S. House,Robert Hubbard,REP,90201,3,0,56,59,03
Canadian,U.S. House,Frank Lucas,REP,90201,8,8,255,271,03
Canadian,Superintendent of Public Instruction,John Cox,DEM,90202,0,0,5,5,
Canadian,Superintendent of Public Instruction,Jack Jr.,DEM,90202,0,0,0,0,
Canadian,Superintendent of Public Instruction,Ivan Holmes,DEM,90202,0,0,1,1,
Canadian,Superintendent of Public Instruction,Freda Deskin,DEM,90202,1,0,7,8,
Canadian,U.S. Senate,Patrick Michael Hayes,DEM,90202,0,0,4,4,
Canadian,U.S. Senate,Jim Rogers,DEM,90202,0,0,3,3,
Canadian,U.S. Senate,Connie Johnson,DEM,90202,1,0,5,6,
Canadian,Governor,Dax Ewbank,REP,90202,0,1,15,16,
Canadian,Governor,Chad Moody,REP,90202,0,0,8,8,
Canadian,Governor,Mary Fallin,REP,90202,1,1,111,113,
Canadian,Superintendent of Public Instruction,Brian Kelly,REP,90202,1,0,31,32,
Canadian,Superintendent of Public Instruction,Janet Costello Barresi,REP,90202,0,0,33,33,
Canadian,Superintendent of Public Instruction,Joy Hofmeister,REP,90202,0,2,67,69,
Canadian,Insurance Commissioner,Bill Viner,REP,90202,0,1,25,26,
Canadian,Insurance Commissioner,John Doak,REP,90202,0,1,98,99,
Canadian,Corporation Commissioner,Todd Hiett,REP,90202,0,1,48,49,
Canadian,Corporation Commissioner,Cliff Branan,REP,90202,1,1,76,78,
Canadian,U.S. Senate,Evelyn Rogers,REP,90202,0,1,4,5,
Canadian,U.S. Senate,Rob Moye,REP,90202,0,0,0,0,
Canadian,U.S. Senate,D. Jean Mcbride-Samuels,REP,90202,0,0,2,2,
Canadian,U.S. Senate,Jim Inhofe,REP,90202,1,1,118,120,
Canadian,U.S. Senate,Erick Paul Wyatt,REP,90202,0,0,7,7,
Canadian,U.S. Senate,Andy Craig,REP,90202,0,0,0,0,
Canadian,U.S. Senate,T. Shannon,REP,90202,0,0,34,34,
Canadian,U.S. Senate,Randy Brogdon,REP,90202,0,0,5,5,
Canadian,U.S. Senate,Eric Mccray,REP,90202,0,0,0,0,
Canadian,U.S. Senate,Kevin Crow,REP,90202,0,0,1,1,
Canadian,U.S. Senate,James Lankford,REP,90202,1,2,93,96,
Canadian,U.S. Senate,Jason Weger,REP,90202,0,0,0,0,
Canadian,U.S. House,Timothy Ray Murray,REP,90202,0,0,0,0,03
Canadian,U.S. House,Robert Hubbard,REP,90202,0,1,31,32,03
Canadian,U.S. House,Frank Lucas,REP,90202,1,1,100,102,03
Canadian,Superintendent of Public Instruction,John Cox,DEM,90204,0,1,7,8,
Canadian,Superintendent of Public Instruction,Jack Jr.,DEM,90204,0,0,5,5,
Canadian,Superintendent of Public Instruction,Ivan Holmes,DEM,90204,1,0,4,5,
Canadian,Superintendent of Public Instruction,Freda Deskin,DEM,90204,1,0,9,10,
Canadian,U.S. Senate,Patrick Michael Hayes,DEM,90204,0,0,1,1,
Canadian,U.S. Senate,Jim Rogers,DEM,90204,1,0,10,11,
Canadian,U.S. Senate,Connie Johnson,DEM,90204,1,1,16,18,
Canadian,Governor,Dax Ewbank,REP,90204,0,1,34,35,
Canadian,Governor,Chad Moody,REP,90204,1,1,39,41,
Canadian,Governor,Mary Fallin,REP,90204,5,5,204,214,
Canadian,Superintendent of Public Instruction,Brian Kelly,REP,90204,3,3,64,70,
Canadian,Superintendent of Public Instruction,Janet Costello Barresi,REP,90204,0,0,56,56,
Canadian,Superintendent of Public Instruction,Joy Hofmeister,REP,90204,3,4,157,164,
Canadian,Insurance Commissioner,Bill Viner,REP,90204,1,1,48,50,
Canadian,Insurance Commissioner,John Doak,REP,90204,4,6,199,209,
Canadian,Corporation Commissioner,Todd Hiett,REP,90204,1,4,125,130,
Canadian,Corporation Commissioner,Cliff Branan,REP,90204,4,3,133,140,
Canadian,U.S. Senate,Evelyn Rogers,REP,90204,0,1,16,17,
Canadian,U.S. Senate,Rob Moye,REP,90204,0,0,4,4,
Canadian,U.S. Senate,D. Jean Mcbride-Samuels,REP,90204,0,0,6,6,
Canadian,U.S. Senate,Jim Inhofe,REP,90204,5,6,236,247,
Canadian,U.S. Senate,Erick Paul Wyatt,REP,90204,1,0,15,16,
Canadian,U.S. Senate,Andy Craig,REP,90204,0,0,3,3,
Canadian,U.S. Senate,T. Shannon,REP,90204,2,0,84,86,
Canadian,U.S. Senate,Randy Brogdon,REP,90204,0,0,7,7,
Canadian,U.S. Senate,Eric Mccray,REP,90204,0,0,2,2,
Canadian,U.S. Senate,Kevin Crow,REP,90204,1,0,5,6,
Canadian,U.S. Senate,James Lankford,REP,90204,3,7,180,190,
Canadian,U.S. Senate,Jason Weger,REP,90204,0,0,1,1,
Canadian,U.S. House,Timothy Ray Murray,REP,90204,1,1,9,11,03
Canadian,U.S. House,Robert Hubbard,REP,90204,0,1,52,53,03
Canadian,U.S. House,Frank Lucas,REP,90204,5,5,213,223,03
Canadian,State Senate,Mark Thomas,REP,90204,0,2,124,126,22
Canadian,State Senate,Leif Francel,REP,90204,3,4,61,68,22
Canadian,State Senate,Stephanie Bice,REP,90204,3,1,75,79,22
Canadian,Superintendent of Public Instruction,John Cox,DEM,90206,0,0,39,39,
Canadian,Superintendent of Public Instruction,Jack Jr.,DEM,90206,0,0,6,6,
Canadian,Superintendent of Public Instruction,Ivan Holmes,DEM,90206,0,0,5,5,
Canadian,Superintendent of Public Instruction,Freda Deskin,DEM,90206,3,0,28,31,
Canadian,U.S. Senate,Patrick Michael Hayes,DEM,90206,0,0,10,10,
Canadian,U.S. Senate,Jim Rogers,DEM,90206,0,0,22,22,
Canadian,U.S. Senate,Connie Johnson,DEM,90206,3,0,45,48,
Canadian,Governor,Dax Ewbank,REP,90206,1,1,30,32,
Canadian,Governor,Chad Moody,REP,90206,0,1,54,55,
Canadian,Governor,Mary Fallin,REP,90206,6,12,269,287,
Canadian,Superintendent of Public Instruction,Brian Kelly,REP,90206,3,2,75,80,
Canadian,Superintendent of Public Instruction,Janet Costello Barresi,REP,90206,1,2,77,80,
Canadian,Superintendent of Public Instruction,Joy Hofmeister,REP,90206,3,9,196,208,
Canadian,Insurance Commissioner,Bill Viner,REP,90206,0,4,71,75,
Canadian,Insurance Commissioner,John Doak,REP,90206,6,7,257,270,
Canadian,Corporation Commissioner,Todd Hiett,REP,90206,1,6,160,167,
Canadian,Corporation Commissioner,Cliff Branan,REP,90206,4,7,169,180,
Canadian,U.S. Senate,Evelyn Rogers,REP,90206,0,0,13,13,
Canadian,U.S. Senate,Rob Moye,REP,90206,0,0,7,7,
Canadian,U.S. Senate,D. Jean Mcbride-Samuels,REP,90206,0,0,0,0,
Canadian,U.S. Senate,Jim Inhofe,REP,90206,6,14,308,328,
Canadian,U.S. Senate,Erick Paul Wyatt,REP,90206,0,0,18,18,
Canadian,U.S. Senate,Andy Craig,REP,90206,0,0,0,0,
Canadian,U.S. Senate,T. Shannon,REP,90206,2,1,77,80,
Canadian,U.S. Senate,Randy Brogdon,REP,90206,0,1,12,13,
Canadian,U.S. Senate,Eric Mccray,REP,90206,0,0,1,1,
Canadian,U.S. Senate,Kevin Crow,REP,90206,0,0,0,0,
Canadian,U.S. Senate,James Lankford,REP,90206,5,12,260,277,
Canadian,U.S. Senate,Jason Weger,REP,90206,0,0,2,2,
Canadian,U.S. House,Timothy Ray Murray,REP,90206,0,1,11,12,03
Canadian,U.S. House,Robert Hubbard,REP,90206,2,1,55,58,03
Canadian,U.S. House,Frank Lucas,REP,90206,5,12,278,295,03
Canadian,State Senate,Mark Thomas,REP,90206,4,2,110,116,22
Canadian,State Senate,Leif Francel,REP,90206,0,4,108,112,22
Canadian,State Senate,Stephanie Bice,REP,90206,2,7,113,122,22
Canadian,Superintendent of Public Instruction,John Cox,DEM,90208,1,0,30,31,
Canadian,Superintendent of Public Instruction,Jack Jr.,DEM,90208,0,0,17,17,
Canadian,Superintendent of Public Instruction,Ivan Holmes,DEM,90208,1,0,6,7,
Canadian,Superintendent of Public Instruction,Freda Deskin,DEM,90208,2,1,49,52,
Canadian,U.S. Senate,Patrick Michael Hayes,DEM,90208,2,0,18,20,
Canadian,U.S. Senate,Jim Rogers,DEM,90208,0,0,28,28,
Canadian,U.S. Senate,Connie Johnson,DEM,90208,2,1,55,58,
Canadian,Governor,Dax Ewbank,REP,90208,3,0,42,45,
Canadian,Governor,Chad Moody,REP,90208,0,3,36,39,
Canadian,Governor,Mary Fallin,REP,90208,13,3,203,219,
Canadian,Superintendent of Public Instruction,Brian Kelly,REP,90208,2,2,85,89,
Canadian,Superintendent of Public Instruction,Janet Costello Barresi,REP,90208,7,0,56,63,
Canadian,Superintendent of Public Instruction,Joy Hofmeister,REP,90208,5,5,142,152,
Canadian,Insurance Commissioner,Bill Viner,REP,90208,2,3,73,78,
Canadian,Insurance Commissioner,John Doak,REP,90208,11,4,198,213,
Canadian,Corporation Commissioner,Todd Hiett,REP,90208,7,4,128,139,
Canadian,Corporation Commissioner,Cliff Branan,REP,90208,4,3,135,142,
Canadian,U.S. Senate,Evelyn Rogers,REP,90208,0,1,19,20,
Canadian,U.S. Senate,Rob Moye,REP,90208,0,0,6,6,
Canadian,U.S. Senate,D. Jean Mcbride-Samuels,REP,90208,0,0,0,0,
Canadian,U.S. Senate,Jim Inhofe,REP,90208,16,5,247,268,
Canadian,U.S. Senate,Erick Paul Wyatt,REP,90208,0,1,14,15,
Canadian,U.S. Senate,Andy Craig,REP,90208,0,0,5,5,
Canadian,U.S. Senate,T. Shannon,REP,90208,2,2,83,87,
Canadian,U.S. Senate,Randy Brogdon,REP,90208,2,1,12,15,
Canadian,U.S. Senate,Eric Mccray,REP,90208,0,0,5,5,
Canadian,U.S. Senate,Kevin Crow,REP,90208,0,0,2,2,
Canadian,U.S. Senate,James Lankford,REP,90208,12,4,177,193,
Canadian,U.S. Senate,Jason Weger,REP,90208,0,0,1,1,
Canadian,U.S. House,Timothy Ray Murray,REP,90208,2,2,16,20,03
Canadian,U.S. House,Robert Hubbard,REP,90208,2,1,48,51,03
Canadian,U.S. House,Frank Lucas,REP,90208,11,4,219,234,03
Canadian,State Senate,Mark Thomas,REP,90208,8,2,116,126,22
Canadian,State Senate,Leif Francel,REP,90208,4,3,63,70,22
Canadian,State Senate,Stephanie Bice,REP,90208,4,2,93,99,22
Canadian,State House,Bill Baker,REP,90208,5,1,53,59,43
Canadian,State House,John Paul Jordan,REP,90208,9,6,126,141,43
Canadian,State House,Jonathan Clour,REP,90208,1,0,85,86,43
Canadian,State House,Nathan Harper,REP,90208,0,0,16,16,43
Canadian,Superintendent of Public Instruction,John Cox,DEM,90209,0,0,1,1,
Canadian,Superintendent of Public Instruction,Jack Jr.,DEM,90209,0,0,0,0,
Canadian,Superintendent of Public Instruction,Ivan Holmes,DEM,90209,0,0,0,0,
Canadian,Superintendent of Public Instruction,Freda Deskin,DEM,90209,0,0,1,1,
Canadian,U.S. Senate,Patrick Michael Hayes,DEM,90209,0,0,0,0,
Canadian,U.S. Senate,Jim Rogers,DEM,90209,0,0,2,2,
Canadian,U.S. Senate,Connie Johnson,DEM,90209,0,0,0,0,
Canadian,Governor,Dax Ewbank,REP,90209,0,0,2,2,
Canadian,Governor,Chad Moody,REP,90209,0,0,6,6,
Canadian,Governor,Mary Fallin,REP,90209,0,0,6,6,
Canadian,Superintendent of Public Instruction,Brian Kelly,REP,90209,0,0,3,3,
Canadian,Superintendent of Public Instruction,Janet Costello Barresi,REP,90209,0,0,1,1,
Canadian,Superintendent of Public Instruction,Joy Hofmeister,REP,90209,0,0,8,8,
Canadian,Insurance Commissioner,Bill Viner,REP,90209,0,0,2,2,
Canadian,Insurance Commissioner,John Doak,REP,90209,0,0,9,9,
Canadian,Corporation Commissioner,Todd Hiett,REP,90209,0,0,6,6,
Canadian,Corporation Commissioner,Cliff Branan,REP,90209,0,0,6,6,
Canadian,U.S. Senate,Evelyn Rogers,REP,90209,0,0,2,2,
Canadian,U.S. Senate,Rob Moye,REP,90209,0,0,2,2,
Canadian,U.S. Senate,D. Jean Mcbride-Samuels,REP,90209,0,0,1,1,
Canadian,U.S. Senate,Jim Inhofe,REP,90209,0,0,8,8,
Canadian,U.S. Senate,Erick Paul Wyatt,REP,90209,0,0,0,0,
Canadian,U.S. Senate,Andy Craig,REP,90209,0,0,0,0,
Canadian,U.S. Senate,T. Shannon,REP,90209,0,0,8,8,
Canadian,U.S. Senate,Randy Brogdon,REP,90209,0,0,0,0,
Canadian,U.S. Senate,Eric Mccray,REP,90209,0,0,0,0,
Canadian,U.S. Senate,Kevin Crow,REP,90209,0,0,0,0,
Canadian,U.S. Senate,James Lankford,REP,90209,0,0,5,5,
Canadian,U.S. Senate,Jason Weger,REP,90209,0,0,1,1,
Canadian,U.S. House,Timothy Ray Murray,REP,90209,0,0,4,4,03
Canadian,U.S. House,Robert Hubbard,REP,90209,0,0,1,1,03
Canadian,U.S. House,Frank Lucas,REP,90209,0,0,8,8,03
Canadian,State Senate,Mark Thomas,REP,90209,0,0,4,4,22
Canadian,State Senate,Leif Francel,REP,90209,0,0,5,5,22
Canadian,State Senate,Stephanie Bice,REP,90209,0,0,4,4,22
Canadian,Superintendent of Public Instruction,John Cox,DEM,90210,0,0,7,7,
Canadian,Superintendent of Public Instruction,Jack Jr.,DEM,90210,0,0,1,1,
Canadian,Superintendent of Public Instruction,Ivan Holmes,DEM,90210,0,0,1,1,
Canadian,Superintendent of Public Instruction,Freda Deskin,DEM,90210,0,0,8,8,
Canadian,U.S. Senate,Patrick Michael Hayes,DEM,90210,0,0,5,5,
Canadian,U.S. Senate,Jim Rogers,DEM,90210,0,0,8,8,
Canadian,U.S. Senate,Connie Johnson,DEM,90210,0,0,4,4,
Canadian,Governor,Dax Ewbank,REP,90210,0,1,20,21,
Canadian,Governor,Chad Moody,REP,90210,0,0,21,21,
Canadian,Governor,Mary Fallin,REP,90210,6,11,152,169,
Canadian,Superintendent of Public Instruction,Brian Kelly,REP,90210,5,1,37,43,
Canadian,Superintendent of Public Instruction,Janet Costello Barresi,REP,90210,0,2,40,42,
Canadian,Superintendent of Public Instruction,Joy Hofmeister,REP,90210,1,9,116,126,
Canadian,Insurance Commissioner,Bill Viner,REP,90210,2,2,34,38,
Canadian,Insurance Commissioner,John Doak,REP,90210,4,10,139,153,
Canadian,Corporation Commissioner,Todd Hiett,REP,90210,2,3,94,99,
Canadian,Corporation Commissioner,Cliff Branan,REP,90210,4,7,86,97,
Canadian,U.S. Senate,Evelyn Rogers,REP,90210,0,0,9,9,
Canadian,U.S. Senate,Rob Moye,REP,90210,0,0,3,3,
Canadian,U.S. Senate,D. Jean Mcbride-Samuels,REP,90210,0,0,2,2,
Canadian,U.S. Senate,Jim Inhofe,REP,90210,4,12,176,192,
Canadian,U.S. Senate,Erick Paul Wyatt,REP,90210,2,0,2,4,
Canadian,U.S. Senate,Andy Craig,REP,90210,0,0,1,1,
Canadian,U.S. Senate,T. Shannon,REP,90210,5,2,40,47,
Canadian,U.S. Senate,Randy Brogdon,REP,90210,0,0,7,7,
Canadian,U.S. Senate,Eric Mccray,REP,90210,0,0,0,0,
Canadian,U.S. Senate,Kevin Crow,REP,90210,0,0,0,0,
Canadian,U.S. Senate,James Lankford,REP,90210,1,10,148,159,
Canadian,U.S. Senate,Jason Weger,REP,90210,0,0,0,0,
Canadian,U.S. House,Timothy Ray Murray,REP,90210,0,0,6,6,03
Canadian,U.S. House,Robert Hubbard,REP,90210,2,1,22,25,03
Canadian,U.S. House,Frank Lucas,REP,90210,4,11,161,176,03
Canadian,State House,Bill Baker,REP,90210,3,3,80,86,43
Canadian,State House,John Paul Jordan,REP,90210,1,7,56,64,43
Canadian,State House,Jonathan Clour,REP,90210,2,2,48,52,43
Canadian,State House,Nathan Harper,REP,90210,0,0,3,3,43
Canadian,Superintendent of Public Instruction,John Cox,DEM,90211,0,0,12,12,
Canadian,Superintendent of Public Instruction,Jack Jr.,DEM,90211,0,0,3,3,
Canadian,Superintendent of Public Instruction,Ivan Holmes,DEM,90211,1,0,0,1,
Canadian,Superintendent of Public Instruction,Freda Deskin,DEM,90211,0,0,13,13,
Canadian,U.S. Senate,Patrick Michael Hayes,DEM,90211,0,0,5,5,
Canadian,U.S. Senate,Jim Rogers,DEM,90211,0,0,4,4,
Canadian,U.S. Senate,Connie Johnson,DEM,90211,0,0,18,18,
Canadian,Governor,Dax Ewbank,REP,90211,2,0,21,23,
Canadian,Governor,Chad Moody,REP,90211,0,0,10,10,
Canadian,Governor,Mary Fallin,REP,90211,6,1,100,107,
Canadian,Superintendent of Public Instruction,Brian Kelly,REP,90211,1,0,26,27,
Canadian,Superintendent of Public Instruction,Janet Costello Barresi,REP,90211,1,0,28,29,
Canadian,Superintendent of Public Instruction,Joy Hofmeister,REP,90211,6,1,73,80,
Canadian,Insurance Commissioner,Bill Viner,REP,90211,0,0,20,20,
Canadian,Insurance Commissioner,John Doak,REP,90211,7,1,103,111,
Canadian,Corporation Commissioner,Todd Hiett,REP,90211,4,1,65,70,
Canadian,Corporation Commissioner,Cliff Branan,REP,90211,4,0,59,63,
Canadian,U.S. Senate,Evelyn Rogers,REP,90211,0,0,6,6,
Canadian,U.S. Senate,Rob Moye,REP,90211,0,0,0,0,
Canadian,U.S. Senate,D. Jean Mcbride-Samuels,REP,90211,0,0,1,1,
Canadian,U.S. Senate,Jim Inhofe,REP,90211,8,1,121,130,
Canadian,U.S. Senate,Erick Paul Wyatt,REP,90211,0,0,4,4,
Canadian,U.S. Senate,Andy Craig,REP,90211,0,0,1,1,
Canadian,U.S. Senate,T. Shannon,REP,90211,2,0,41,43,
Canadian,U.S. Senate,Randy Brogdon,REP,90211,0,0,9,9,
Canadian,U.S. Senate,Eric Mccray,REP,90211,0,0,0,0,
Canadian,U.S. Senate,Kevin Crow,REP,90211,0,0,1,1,
Canadian,U.S. Senate,James Lankford,REP,90211,6,1,81,88,
Canadian,U.S. Senate,Jason Weger,REP,90211,0,0,0,0,
Canadian,U.S. House,Timothy Ray Murray,REP,90211,0,0,3,3,03
Canadian,U.S. House,Robert Hubbard,REP,90211,2,0,16,18,03
Canadian,U.S. House,Frank Lucas,REP,90211,6,1,113,120,03
Canadian,Superintendent of Public Instruction,John Cox,DEM,90214,0,0,19,19,
Canadian,Superintendent of Public Instruction,Jack Jr.,DEM,90214,0,0,12,12,
Canadian,Superintendent of Public Instruction,Ivan Holmes,DEM,90214,0,0,7,7,
Canadian,Superintendent of Public Instruction,Freda Deskin,DEM,90214,0,0,32,32,
Canadian,U.S. Senate,Patrick Michael Hayes,DEM,90214,0,0,10,10,
Canadian,U.S. Senate,Jim Rogers,DEM,90214,0,0,22,22,
Canadian,U.S. Senate,Connie Johnson,DEM,90214,0,0,38,38,
Canadian,Governor,Dax Ewbank,REP,90214,0,2,47,49,
Canadian,Governor,Chad Moody,REP,90214,0,2,64,66,
Canadian,Governor,Mary Fallin,REP,90214,10,5,234,249,
Canadian,Superintendent of Public Instruction,Brian Kelly,REP,90214,4,1,102,107,
Canadian,Superintendent of Public Instruction,Janet Costello Barresi,REP,90214,4,2,65,71,
Canadian,Superintendent of Public Instruction,Joy Hofmeister,REP,90214,2,6,180,188,
Canadian,Insurance Commissioner,Bill Viner,REP,90214,2,2,85,89,
Canadian,Insurance Commissioner,John Doak,REP,90214,8,6,248,262,
Canadian,Corporation Commissioner,Todd Hiett,REP,90214,4,3,160,167,
Canadian,Corporation Commissioner,Cliff Branan,REP,90214,6,5,173,184,
Canadian,U.S. Senate,Evelyn Rogers,REP,90214,0,0,17,17,
Canadian,U.S. Senate,Rob Moye,REP,90214,0,0,6,6,
Canadian,U.S. Senate,D. Jean Mcbride-Samuels,REP,90214,0,0,3,3,
Canadian,U.S. Senate,Jim Inhofe,REP,90214,10,8,308,326,
Canadian,U.S. Senate,Erick Paul Wyatt,REP,90214,0,0,14,14,
Canadian,U.S. Senate,Andy Craig,REP,90214,0,0,0,0,
Canadian,U.S. Senate,T. Shannon,REP,90214,1,2,86,89,
Canadian,U.S. Senate,Randy Brogdon,REP,90214,0,1,15,16,
Canadian,U.S. Senate,Eric Mccray,REP,90214,0,0,2,2,
Canadian,U.S. Senate,Kevin Crow,REP,90214,0,0,3,3,
Canadian,U.S. Senate,James Lankford,REP,90214,9,5,244,258,
Canadian,U.S. Senate,Jason Weger,REP,90214,0,0,3,3,
Canadian,U.S. House,Timothy Ray Murray,REP,90214,0,1,13,14,03
Canadian,U.S. House,Robert Hubbard,REP,90214,1,1,42,44,03
Canadian,U.S. House,Frank Lucas,REP,90214,9,6,292,307,03
Canadian,State Senate,Mark Thomas,REP,90214,4,3,166,173,22
Canadian,State Senate,Leif Francel,REP,90214,2,1,69,72,22
Canadian,State Senate,Stephanie Bice,REP,90214,4,5,102,111,22
Canadian,State House,Bill Baker,REP,90214,2,3,77,82,43
Canadian,State House,John Paul Jordan,REP,90214,6,3,137,146,43
Canadian,State House,Jonathan Clour,REP,90214,2,2,116,120,43
Canadian,State House,Nathan Harper,REP,90214,0,0,14,14,43
Canadian,Superintendent of Public Instruction,John Cox,DEM,90215,0,0,25,25,
Canadian,Superintendent of Public Instruction,Jack Jr.,DEM,90215,1,0,11,12,
Canadian,Superintendent of Public Instruction,Ivan Holmes,DEM,90215,0,0,3,3,
Canadian,Superintendent of Public Instruction,Freda Deskin,DEM,90215,0,0,30,30,
Canadian,U.S. Senate,Patrick Michael Hayes,DEM,90215,0,0,14,14,
Canadian,U.S. Senate,Jim Rogers,DEM,90215,0,0,22,22,
Canadian,U.S. Senate,Connie Johnson,DEM,90215,1,0,32,33,
Canadian,Governor,Dax Ewbank,REP,90215,0,0,44,44,
Canadian,Governor,Chad Moody,REP,90215,3,1,54,58,
Canadian,Governor,Mary Fallin,REP,90215,17,8,256,281,
Canadian,Superintendent of Public Instruction,Brian Kelly,REP,90215,7,2,103,112,
Canadian,Superintendent of Public Instruction,Janet Costello Barresi,REP,90215,4,2,72,78,
Canadian,Superintendent of Public Instruction,Joy Hofmeister,REP,90215,7,5,177,189,
Canadian,Insurance Commissioner,Bill Viner,REP,90215,5,1,84,90,
Canadian,Insurance Commissioner,John Doak,REP,90215,14,8,254,276,
Canadian,Corporation Commissioner,Todd Hiett,REP,90215,7,6,159,172,
Canadian,Corporation Commissioner,Cliff Branan,REP,90215,11,3,170,184,
Canadian,U.S. Senate,Evelyn Rogers,REP,90215,0,0,22,22,
Canadian,U.S. Senate,Rob Moye,REP,90215,0,0,11,11,
Canadian,U.S. Senate,D. Jean Mcbride-Samuels,REP,90215,0,0,5,5,
Canadian,U.S. Senate,Jim Inhofe,REP,90215,18,8,291,317,
Canadian,U.S. Senate,Erick Paul Wyatt,REP,90215,1,1,20,22,
Canadian,U.S. Senate,Andy Craig,REP,90215,1,0,4,5,
Canadian,U.S. Senate,T. Shannon,REP,90215,4,2,94,100,
Canadian,U.S. Senate,Randy Brogdon,REP,90215,0,0,23,23,
Canadian,U.S. Senate,Eric Mccray,REP,90215,0,0,1,1,
Canadian,U.S. Senate,Kevin Crow,REP,90215,0,0,5,5,
Canadian,U.S. Senate,James Lankford,REP,90215,15,7,229,251,
Canadian,U.S. Senate,Jason Weger,REP,90215,0,0,2,2,
Canadian,U.S. House,Timothy Ray Murray,REP,90215,1,1,25,27,03
Canadian,U.S. House,Robert Hubbard,REP,90215,2,2,51,55,03
Canadian,U.S. House,Frank Lucas,REP,90215,17,6,271,294,03
Canadian,State House,Bill Baker,REP,90215,2,2,82,86,43
Canadian,State House,John Paul Jordan,REP,90215,14,4,150,168,43
Canadian,State House,Jonathan Clour,REP,90215,3,2,91,96,43
Canadian,State House,Nathan Harper,REP,90215,1,1,24,26,43
Canadian,Superintendent of Public Instruction,John Cox,DEM,90216,0,3,33,36,
Canadian,Superintendent of Public Instruction,Jack Jr.,DEM,90216,0,3,12,15,
Canadian,Superintendent of Public Instruction,Ivan Holmes,DEM,90216,0,0,5,5,
Canadian,Superintendent of Public Instruction,Freda Deskin,DEM,90216,0,1,71,72,
Canadian,U.S. Senate,Patrick Michael Hayes,DEM,90216,0,1,14,15,
Canadian,U.S. Senate,Jim Rogers,DEM,90216,0,3,35,38,
Canadian,U.S. Senate,Connie Johnson,DEM,90216,0,3,69,72,
Canadian,Governor,Dax Ewbank,REP,90216,2,0,65,67,
Canadian,Governor,Chad Moody,REP,90216,0,2,72,74,
Canadian,Governor,Mary Fallin,REP,90216,24,7,402,433,
Canadian,Superintendent of Public Instruction,Brian Kelly,REP,90216,4,0,140,144,
Canadian,Superintendent of Public Instruction,Janet Costello Barresi,REP,90216,10,0,105,115,
Canadian,Superintendent of Public Instruction,Joy Hofmeister,REP,90216,11,9,290,310,
Canadian,Insurance Commissioner,Bill Viner,REP,90216,5,2,108,115,
Canadian,Insurance Commissioner,John Doak,REP,90216,19,7,387,413,
Canadian,Corporation Commissioner,Todd Hiett,REP,90216,13,3,197,213,
Canadian,Corporation Commissioner,Cliff Branan,REP,90216,13,6,310,329,
Canadian,U.S. Senate,Evelyn Rogers,REP,90216,2,0,24,26,
Canadian,U.S. Senate,Rob Moye,REP,90216,1,0,11,12,
Canadian,U.S. Senate,D. Jean Mcbride-Samuels,REP,90216,0,0,7,7,
Canadian,U.S. Senate,Jim Inhofe,REP,90216,22,9,484,515,
Canadian,U.S. Senate,Erick Paul Wyatt,REP,90216,1,0,17,18,
Canadian,U.S. Senate,Andy Craig,REP,90216,1,0,2,3,
Canadian,U.S. Senate,T. Shannon,REP,90216,4,3,137,144,
Canadian,U.S. Senate,Randy Brogdon,REP,90216,1,0,12,13,
Canadian,U.S. Senate,Eric Mccray,REP,90216,1,0,2,3,
Canadian,U.S. Senate,Kevin Crow,REP,90216,0,0,3,3,
Canadian,U.S. Senate,James Lankford,REP,90216,18,6,389,413,
Canadian,U.S. Senate,Jason Weger,REP,90216,1,0,5,6,
Canadian,U.S. House,Timothy Ray Murray,REP,90216,0,0,25,25,03
Canadian,U.S. House,Robert Hubbard,REP,90216,3,2,75,80,03
Canadian,U.S. House,Frank Lucas,REP,90216,23,7,439,469,03
Canadian,State Senate,Mark Thomas,REP,90216,5,4,224,233,22
Canadian,State Senate,Leif Francel,REP,90216,6,2,152,160,22
Canadian,State Senate,Stephanie Bice,REP,90216,14,3,130,147,22
Canadian,State House,Bill Baker,REP,90216,6,5,126,137,43
Canadian,State House,John Paul Jordan,REP,90216,10,2,220,232,43
Canadian,State House,Jonathan Clour,REP,90216,6,2,146,154,43
Canadian,State House,Nathan Harper,REP,90216,4,0,26,30,43
Canadian,Superintendent of Public Instruction,John Cox,DEM,90217,0,0,14,14,
Canadian,Superintendent of Public Instruction,Jack Jr.,DEM,90217,1,0,7,8,
Canadian,Superintendent of Public Instruction,Ivan Holmes,DEM,90217,0,0,4,4,
Canadian,Superintendent of Public Instruction,Freda Deskin,DEM,90217,2,1,27,30,
Canadian,U.S. Senate,Patrick Michael Hayes,DEM,90217,0,0,11,11,
Canadian,U.S. Senate,Jim Rogers,DEM,90217,1,0,13,14,
Canadian,U.S. Senate,Connie Johnson,DEM,90217,2,1,29,32,
Canadian,Governor,Dax Ewbank,REP,90217,0,0,35,35,
Canadian,Governor,Chad Moody,REP,90217,1,1,47,49,
Canadian,Governor,Mary Fallin,REP,90217,17,8,276,301,
Canadian,Superintendent of Public Instruction,Brian Kelly,REP,90217,1,0,83,84,
Canadian,Superintendent of Public Instruction,Janet Costello Barresi,REP,90217,10,2,76,88,
Canadian,Superintendent of Public Instruction,Joy Hofmeister,REP,90217,7,6,198,211,
Canadian,Insurance Commissioner,Bill Viner,REP,90217,0,1,91,92,
Canadian,Insurance Commissioner,John Doak,REP,90217,14,7,241,262,
Canadian,Corporation Commissioner,Todd Hiett,REP,90217,7,4,162,173,
Canadian,Corporation Commissioner,Cliff Branan,REP,90217,6,3,177,186,
Canadian,U.S. Senate,Evelyn Rogers,REP,90217,0,0,16,16,
Canadian,U.S. Senate,Rob Moye,REP,90217,0,0,5,5,
Canadian,U.S. Senate,D. Jean Mcbride-Samuels,REP,90217,0,0,3,3,
Canadian,U.S. Senate,Jim Inhofe,REP,90217,18,9,318,345,
Canadian,U.S. Senate,Erick Paul Wyatt,REP,90217,0,0,17,17,
Canadian,U.S. Senate,Andy Craig,REP,90217,0,0,0,0,
Canadian,U.S. Senate,T. Shannon,REP,90217,2,2,103,107,
Canadian,U.S. Senate,Randy Brogdon,REP,90217,0,0,17,17,
Canadian,U.S. Senate,Eric Mccray,REP,90217,0,0,3,3,
Canadian,U.S. Senate,Kevin Crow,REP,90217,0,0,0,0,
Canadian,U.S. Senate,James Lankford,REP,90217,16,7,239,262,
Canadian,U.S. Senate,Jason Weger,REP,90217,0,0,1,1,
Canadian,U.S. House,Timothy Ray Murray,REP,90217,0,0,23,23,03
Canadian,U.S. House,Robert Hubbard,REP,90217,0,0,55,55,03
Canadian,U.S. House,Frank Lucas,REP,90217,16,9,274,299,03
Canadian,State Senate,Mark Thomas,REP,90217,7,1,105,113,22
Canadian,State Senate,Leif Francel,REP,90217,3,5,116,124,22
Canadian,State Senate,Stephanie Bice,REP,90217,8,3,117,128,22
Canadian,State House,Bill Baker,REP,90217,9,1,79,89,43
Canadian,State House,John Paul Jordan,REP,90217,3,6,119,128,43
Canadian,State House,Jonathan Clour,REP,90217,4,1,119,124,43
Canadian,State House,Nathan Harper,REP,90217,1,1,19,21,43
Canadian,Superintendent of Public Instruction,John Cox,DEM,90218,0,2,17,19,
Canadian,Superintendent of Public Instruction,Jack Jr.,DEM,90218,1,2,7,10,
Canadian,Superintendent of Public Instruction,Ivan Holmes,DEM,90218,0,0,8,8,
Canadian,Superintendent of Public Instruction,Freda Deskin,DEM,90218,0,0,22,22,
Canadian,U.S. Senate,Patrick Michael Hayes,DEM,90218,0,3,4,7,
Canadian,U.S. Senate,Jim Rogers,DEM,90218,1,1,20,22,
Canadian,U.S. Senate,Connie Johnson,DEM,90218,0,0,31,31,
Canadian,Governor,Dax Ewbank,REP,90218,0,0,23,23,
Canadian,Governor,Chad Moody,REP,90218,0,0,45,45,
Canadian,Governor,Mary Fallin,REP,90218,9,4,193,206,
Canadian,Superintendent of Public Instruction,Brian Kelly,REP,90218,3,1,83,87,
Canadian,Superintendent of Public Instruction,Janet Costello Barresi,REP,90218,0,0,53,53,
Canadian,Superintendent of Public Instruction,Joy Hofmeister,REP,90218,5,2,125,132,
Canadian,Insurance Commissioner,Bill Viner,REP,90218,2,0,52,54,
Canadian,Insurance Commissioner,John Doak,REP,90218,5,4,193,202,
Canadian,Corporation Commissioner,Todd Hiett,REP,90218,4,3,133,140,
Canadian,Corporation Commissioner,Cliff Branan,REP,90218,3,1,112,116,
Canadian,U.S. Senate,Evelyn Rogers,REP,90218,0,0,9,9,
Canadian,U.S. Senate,Rob Moye,REP,90218,0,0,7,7,
Canadian,U.S. Senate,D. Jean Mcbride-Samuels,REP,90218,0,0,4,4,
Canadian,U.S. Senate,Jim Inhofe,REP,90218,9,4,232,245,
Canadian,U.S. Senate,Erick Paul Wyatt,REP,90218,0,0,8,8,
Canadian,U.S. Senate,Andy Craig,REP,90218,0,0,1,1,
Canadian,U.S. Senate,T. Shannon,REP,90218,3,0,87,90,
Canadian,U.S. Senate,Randy Brogdon,REP,90218,1,0,8,9,
Canadian,U.S. Senate,Eric Mccray,REP,90218,0,0,0,0,
Canadian,U.S. Senate,Kevin Crow,REP,90218,0,0,0,0,
Canadian,U.S. Senate,James Lankford,REP,90218,5,4,169,178,
Canadian,U.S. Senate,Jason Weger,REP,90218,0,0,2,2,
Canadian,U.S. House,Timothy Ray Murray,REP,90218,1,0,14,15,03
Canadian,U.S. House,Robert Hubbard,REP,90218,0,0,32,32,03
Canadian,U.S. House,Frank Lucas,REP,90218,8,4,216,228,03
Canadian,State Senate,Mark Thomas,REP,90218,0,0,105,105,22
Canadian,State Senate,Leif Francel,REP,90218,4,2,72,78,22
Canadian,State Senate,Stephanie Bice,REP,90218,4,1,80,85,22
Canadian,State House,Bill Baker,REP,90218,4,1,62,67,43
Canadian,State House,John Paul Jordan,REP,90218,4,2,76,82,43
Canadian,State House,Jonathan Clour,REP,90218,0,1,101,102,43
Canadian,State House,Nathan Harper,REP,90218,1,0,15,16,43
Canadian,Superintendent of Public Instruction,John Cox,DEM,90220,2,0,27,29,
Canadian,Superintendent of Public Instruction,Jack Jr.,DEM,90220,0,0,10,10,
Canadian,Superintendent of Public Instruction,Ivan Holmes,DEM,90220,0,0,2,2,
Canadian,Superintendent of Public Instruction,Freda Deskin,DEM,90220,0,1,37,38,
Canadian,U.S. Senate,Patrick Michael Hayes,DEM,90220,0,0,11,11,
Canadian,U.S. Senate,Jim Rogers,DEM,90220,2,1,28,31,
Canadian,U.S. Senate,Connie Johnson,DEM,90220,0,0,33,33,
Canadian,Governor,Dax Ewbank,REP,90220,3,0,51,54,
Canadian,Governor,Chad Moody,REP,90220,2,0,78,80,
Canadian,Governor,Mary Fallin,REP,90220,14,3,352,369,
Canadian,Superintendent of Public Instruction,Brian Kelly,REP,90220,3,3,113,119,
Canadian,Superintendent of Public Instruction,Janet Costello Barresi,REP,90220,6,0,98,104,
Canadian,Superintendent of Public Instruction,Joy Hofmeister,REP,90220,9,0,265,274,
Canadian,Insurance Commissioner,Bill Viner,REP,90220,3,2,98,103,
Canadian,Insurance Commissioner,John Doak,REP,90220,15,0,357,372,
Canadian,Corporation Commissioner,Todd Hiett,REP,90220,13,0,238,251,
Canadian,Corporation Commissioner,Cliff Branan,REP,90220,4,2,210,216,
Canadian,U.S. Senate,Evelyn Rogers,REP,90220,0,0,21,21,
Canadian,U.S. Senate,Rob Moye,REP,90220,1,0,11,12,
Canadian,U.S. Senate,D. Jean Mcbride-Samuels,REP,90220,0,0,4,4,
Canadian,U.S. Senate,Jim Inhofe,REP,90220,15,3,431,449,
Canadian,U.S. Senate,Erick Paul Wyatt,REP,90220,3,0,14,17,
Canadian,U.S. Senate,Andy Craig,REP,90220,0,0,2,2,
Canadian,U.S. Senate,T. Shannon,REP,90220,4,0,140,144,
Canadian,U.S. Senate,Randy Brogdon,REP,90220,1,0,15,16,
Canadian,U.S. Senate,Eric Mccray,REP,90220,0,0,5,5,
Canadian,U.S. Senate,Kevin Crow,REP,90220,0,0,4,4,
Canadian,U.S. Senate,James Lankford,REP,90220,12,3,323,338,
Canadian,U.S. Senate,Jason Weger,REP,90220,2,0,2,4,
Canadian,U.S. House,Timothy Ray Murray,REP,90220,0,0,19,19,03
Canadian,U.S. House,Robert Hubbard,REP,90220,2,2,62,66,03
Canadian,U.S. House,Frank Lucas,REP,90220,17,0,398,415,03
Canadian,State Senate,Mark Thomas,REP,90220,4,2,149,155,22
Canadian,State Senate,Leif Francel,REP,90220,9,1,131,141,22
Canadian,State Senate,Stephanie Bice,REP,90220,2,0,178,180,22
Canadian,State House,Bill Baker,REP,90220,7,0,102,109,43
Canadian,State House,John Paul Jordan,REP,90220,4,0,172,176,43
Canadian,State House,Jonathan Clour,REP,90220,5,1,170,176,43
Canadian,State House,Nathan Harper,REP,90220,1,2,24,27,43
Canadian,Superintendent of Public Instruction,John Cox,DEM,90221,0,0,16,16,
Canadian,Superintendent of Public Instruction,Jack Jr.,DEM,90221,0,0,10,10,
Canadian,Superintendent of Public Instruction,Ivan Holmes,DEM,90221,2,0,1,3,
Canadian,Superintendent of Public Instruction,Freda Deskin,DEM,90221,0,0,32,32,
Canadian,U.S. Senate,Patrick Michael Hayes,DEM,90221,0,0,7,7,
Canadian,U.S. Senate,Jim Rogers,DEM,90221,0,0,10,10,
Canadian,U.S. Senate,Connie Johnson,DEM,90221,2,0,41,43,
Canadian,Governor,Dax Ewbank,REP,90221,2,0,11,13,
Canadian,Governor,Chad Moody,REP,90221,3,0,42,45,
Canadian,Governor,Mary Fallin,REP,90221,2,0,157,159,
Canadian,Superintendent of Public Instruction,Brian Kelly,REP,90221,0,0,57,57,
Canadian,Superintendent of Public Instruction,Janet Costello Barresi,REP,90221,4,0,39,43,
Canadian,Superintendent of Public Instruction,Joy Hofmeister,REP,90221,3,0,117,120,
Canadian,Insurance Commissioner,Bill Viner,REP,90221,2,0,48,50,
Canadian,Insurance Commissioner,John Doak,REP,90221,5,0,151,156,
Canadian,Corporation Commissioner,Todd Hiett,REP,90221,4,0,85,89,
Canadian,Corporation Commissioner,Cliff Branan,REP,90221,3,0,111,114,
Canadian,U.S. Senate,Evelyn Rogers,REP,90221,0,0,9,9,
Canadian,U.S. Senate,Rob Moye,REP,90221,0,0,2,2,
Canadian,U.S. Senate,D. Jean Mcbride-Samuels,REP,90221,0,0,2,2,
Canadian,U.S. Senate,Jim Inhofe,REP,90221,7,0,192,199,
Canadian,U.S. Senate,Erick Paul Wyatt,REP,90221,0,0,6,6,
Canadian,U.S. Senate,Andy Craig,REP,90221,2,0,1,3,
Canadian,U.S. Senate,T. Shannon,REP,90221,2,0,68,70,
Canadian,U.S. Senate,Randy Brogdon,REP,90221,0,0,7,7,
Canadian,U.S. Senate,Eric Mccray,REP,90221,0,0,1,1,
Canadian,U.S. Senate,Kevin Crow,REP,90221,0,0,1,1,
Canadian,U.S. Senate,James Lankford,REP,90221,3,0,135,138,
Canadian,U.S. Senate,Jason Weger,REP,90221,0,0,0,0,
Canadian,U.S. House,Timothy Ray Murray,REP,90221,2,0,12,14,03
Canadian,U.S. House,Robert Hubbard,REP,90221,2,0,28,30,03
Canadian,U.S. House,Frank Lucas,REP,90221,3,0,170,173,03
Canadian,State House,Bill Baker,REP,90221,1,0,36,37,43
Canadian,State House,John Paul Jordan,REP,90221,1,0,98,99,43
Canadian,State House,Jonathan Clour,REP,90221,2,0,45,47,43
Canadian,State House,Nathan Harper,REP,90221,3,0,21,24,43
Canadian,Superintendent of Public Instruction,John Cox,DEM,90223,0,0,23,23,
Canadian,Superintendent of Public Instruction,Jack Jr.,DEM,90223,0,0,9,9,
Canadian,Superintendent of Public Instruction,Ivan Holmes,DEM,90223,0,0,2,2,
Canadian,Superintendent of Public Instruction,Freda Deskin,DEM,90223,2,1,37,40,
Canadian,U.S. Senate,Patrick Michael Hayes,DEM,90223,0,0,12,12,
Canadian,U.S. Senate,Jim Rogers,DEM,90223,0,0,13,13,
Canadian,U.S. Senate,Connie Johnson,DEM,90223,2,1,43,46,
Canadian,Governor,Dax Ewbank,REP,90223,0,4,39,43,
Canadian,Governor,Chad Moody,REP,90223,0,0,52,52,
Canadian,Governor,Mary Fallin,REP,90223,18,7,231,256,
Canadian,Superintendent of Public Instruction,Brian Kelly,REP,90223,7,2,87,96,
Canadian,Superintendent of Public Instruction,Janet Costello Barresi,REP,90223,0,4,59,63,
Canadian,Superintendent of Public Instruction,Joy Hofmeister,REP,90223,11,5,173,189,
Canadian,Insurance Commissioner,Bill Viner,REP,90223,4,1,63,68,
Canadian,Insurance Commissioner,John Doak,REP,90223,12,9,233,254,
Canadian,Corporation Commissioner,Todd Hiett,REP,90223,11,8,140,159,
Canadian,Corporation Commissioner,Cliff Branan,REP,90223,7,2,161,170,
Canadian,U.S. Senate,Evelyn Rogers,REP,90223,0,0,9,9,
Canadian,U.S. Senate,Rob Moye,REP,90223,0,0,7,7,
Canadian,U.S. Senate,D. Jean Mcbride-Samuels,REP,90223,0,0,2,2,
Canadian,U.S. Senate,Jim Inhofe,REP,90223,15,11,287,313,
Canadian,U.S. Senate,Erick Paul Wyatt,REP,90223,3,0,17,20,
Canadian,U.S. Senate,Andy Craig,REP,90223,0,0,4,4,
Canadian,U.S. Senate,T. Shannon,REP,90223,6,2,105,113,
Canadian,U.S. Senate,Randy Brogdon,REP,90223,0,3,12,15,
Canadian,U.S. Senate,Eric Mccray,REP,90223,0,0,6,6,
Canadian,U.S. Senate,Kevin Crow,REP,90223,0,0,3,3,
Canadian,U.S. Senate,James Lankford,REP,90223,12,6,194,212,
Canadian,U.S. Senate,Jason Weger,REP,90223,0,0,3,3,
Canadian,U.S. House,Timothy Ray Murray,REP,90223,0,0,16,16,03
Canadian,U.S. House,Robert Hubbard,REP,90223,2,4,51,57,03
Canadian,U.S. House,Frank Lucas,REP,90223,16,6,251,273,03
Canadian,State House,Bill Baker,REP,90223,7,1,56,64,43
Canadian,State House,John Paul Jordan,REP,90223,4,9,176,189,43
Canadian,State House,Jonathan Clour,REP,90223,2,1,58,61,43
Canadian,State House,Nathan Harper,REP,90223,3,0,19,22,43
Canadian,Superintendent of Public Instruction,John Cox,DEM,90224,0,0,6,6,
Canadian,Superintendent of Public Instruction,Jack Jr.,DEM,90224,0,0,0,0,
Canadian,Superintendent of Public Instruction,Ivan Holmes,DEM,90224,0,0,2,2,
Canadian,Superintendent of Public Instruction,Freda Deskin,DEM,90224,0,0,21,21,
Canadian,U.S. Senate,Patrick Michael Hayes,DEM,90224,0,0,4,4,
Canadian,U.S. Senate,Jim Rogers,DEM,90224,0,0,7,7,
Canadian,U.S. Senate,Connie Johnson,DEM,90224,0,0,17,17,
Canadian,Governor,Dax Ewbank,REP,90224,1,2,12,15,
Canadian,Governor,Chad Moody,REP,90224,0,0,16,16,
Canadian,Governor,Mary Fallin,REP,90224,7,0,79,86,
Canadian,Superintendent of Public Instruction,Brian Kelly,REP,90224,5,0,24,29,
Canadian,Superintendent of Public Instruction,Janet Costello Barresi,REP,90224,0,0,17,17,
Canadian,Superintendent of Public Instruction,Joy Hofmeister,REP,90224,3,2,64,69,
Canadian,Insurance Commissioner,Bill Viner,REP,90224,3,0,22,25,
Canadian,Insurance Commissioner,John Doak,REP,90224,5,2,76,83,
Canadian,Corporation Commissioner,Todd Hiett,REP,90224,1,0,40,41,
Canadian,Corporation Commissioner,Cliff Branan,REP,90224,7,2,58,67,
Canadian,U.S. Senate,Evelyn Rogers,REP,90224,0,0,7,7,
Canadian,U.S. Senate,Rob Moye,REP,90224,0,0,6,6,
Canadian,U.S. Senate,D. Jean Mcbride-Samuels,REP,90224,0,0,4,4,
Canadian,U.S. Senate,Jim Inhofe,REP,90224,8,0,88,96,
Canadian,U.S. Senate,Erick Paul Wyatt,REP,90224,0,2,3,5,
Canadian,U.S. Senate,Andy Craig,REP,90224,0,0,1,1,
Canadian,U.S. Senate,T. Shannon,REP,90224,2,2,43,47,
Canadian,U.S. Senate,Randy Brogdon,REP,90224,0,0,4,4,
Canadian,U.S. Senate,Eric Mccray,REP,90224,0,0,0,0,
Canadian,U.S. Senate,Kevin Crow,REP,90224,0,0,0,0,
Canadian,U.S. Senate,James Lankford,REP,90224,6,0,60,66,
Canadian,U.S. Senate,Jason Weger,REP,90224,0,0,0,0,
Canadian,U.S. House,Timothy Ray Murray,REP,90224,0,0,5,5,03
Canadian,U.S. House,Robert Hubbard,REP,90224,0,0,15,15,03
Canadian,U.S. House,Frank Lucas,REP,90224,8,2,84,94,03
Canadian,State House,Bill Baker,REP,90224,0,0,21,21,43
Canadian,State House,John Paul Jordan,REP,90224,5,1,54,60,43
Canadian,State House,Jonathan Clour,REP,90224,0,0,20,20,43
Canadian,State House,Nathan Harper,REP,90224,3,1,4,8,43
Canadian,Superintendent of Public Instruction,John Cox,DEM,90225,1,0,22,23,
Canadian,Superintendent of Public Instruction,Jack Jr.,DEM,90225,0,0,8,8,
Canadian,Superintendent of Public Instruction,Ivan Holmes,DEM,90225,0,0,3,3,
Canadian,Superintendent of Public Instruction,Freda Deskin,DEM,90225,1,2,24,27,
Canadian,U.S. Senate,Patrick Michael Hayes,DEM,90225,0,0,10,10,
Canadian,U.S. Senate,Jim Rogers,DEM,90225,2,1,18,21,
Canadian,U.S. Senate,Connie Johnson,DEM,90225,0,1,29,30,
Canadian,Governor,Dax Ewbank,REP,90225,0,1,41,42,
Canadian,Governor,Chad Moody,REP,90225,1,1,37,39,
Canadian,Governor,Mary Fallin,REP,90225,12,2,134,148,
Canadian,Superintendent of Public Instruction,Brian Kelly,REP,90225,1,3,45,49,
Canadian,Superintendent of Public Instruction,Janet Costello Barresi,REP,90225,5,0,37,42,
Canadian,Superintendent of Public Instruction,Joy Hofmeister,REP,90225,7,1,132,140,
Canadian,Insurance Commissioner,Bill Viner,REP,90225,2,0,55,57,
Canadian,Insurance Commissioner,John Doak,REP,90225,11,4,149,164,
Canadian,Corporation Commissioner,Todd Hiett,REP,90225,6,3,109,118,
Canadian,Corporation Commissioner,Cliff Branan,REP,90225,7,1,94,102,
Canadian,U.S. Senate,Evelyn Rogers,REP,90225,0,0,8,8,
Canadian,U.S. Senate,Rob Moye,REP,90225,0,0,6,6,
Canadian,U.S. Senate,D. Jean Mcbride-Samuels,REP,90225,0,0,2,2,
Canadian,U.S. Senate,Jim Inhofe,REP,90225,13,3,186,202,
Canadian,U.S. Senate,Erick Paul Wyatt,REP,90225,0,1,14,15,
Canadian,U.S. Senate,Andy Craig,REP,90225,0,0,3,3,
Canadian,U.S. Senate,T. Shannon,REP,90225,0,1,60,61,
Canadian,U.S. Senate,Randy Brogdon,REP,90225,2,0,15,17,
Canadian,U.S. Senate,Eric Mccray,REP,90225,0,0,2,2,
Canadian,U.S. Senate,Kevin Crow,REP,90225,0,0,4,4,
Canadian,U.S. Senate,James Lankford,REP,90225,11,2,133,146,
Canadian,U.S. Senate,Jason Weger,REP,90225,0,1,0,1,
Canadian,U.S. House,Timothy Ray Murray,REP,90225,0,0,15,15,03
Canadian,U.S. House,Robert Hubbard,REP,90225,2,2,43,47,03
Canadian,U.S. House,Frank Lucas,REP,90225,11,2,151,164,03
Canadian,Superintendent of Public Instruction,John Cox,DEM,90226,1,0,3,4,
Canadian,Superintendent of Public Instruction,Jack Jr.,DEM,90226,0,0,2,2,
Canadian,Superintendent of Public Instruction,Ivan Holmes,DEM,90226,0,0,1,1,
Canadian,Superintendent of Public Instruction,Freda Deskin,DEM,90226,0,0,13,13,
Canadian,U.S. Senate,Patrick Michael Hayes,DEM,90226,0,0,2,2,
Canadian,U.S. Senate,Jim Rogers,DEM,90226,0,0,10,10,
Canadian,U.S. Senate,Connie Johnson,DEM,90226,1,0,7,8,
Canadian,Governor,Dax Ewbank,REP,90226,1,0,10,11,
Canadian,Governor,Chad Moody,REP,90226,3,0,6,9,
Canadian,Governor,Mary Fallin,REP,90226,4,3,77,84,
Canadian,Superintendent of Public Instruction,Brian Kelly,REP,90226,3,0,24,27,
Canadian,Superintendent of Public Instruction,Janet Costello Barresi,REP,90226,1,2,20,23,
Canadian,Superintendent of Public Instruction,Joy Hofmeister,REP,90226,4,0,49,53,
Canadian,Insurance Commissioner,Bill Viner,REP,90226,5,1,16,22,
Canadian,Insurance Commissioner,John Doak,REP,90226,2,2,73,77,
Canadian,Corporation Commissioner,Todd Hiett,REP,90226,4,2,47,53,
Canadian,Corporation Commissioner,Cliff Branan,REP,90226,4,1,43,48,
Canadian,U.S. Senate,Evelyn Rogers,REP,90226,1,0,1,2,
Canadian,U.S. Senate,Rob Moye,REP,90226,0,0,2,2,
Canadian,U.S. Senate,D. Jean Mcbride-Samuels,REP,90226,1,0,2,3,
Canadian,U.S. Senate,Jim Inhofe,REP,90226,2,2,86,90,
Canadian,U.S. Senate,Erick Paul Wyatt,REP,90226,4,0,2,6,
Canadian,U.S. Senate,Andy Craig,REP,90226,0,0,0,0,
Canadian,U.S. Senate,T. Shannon,REP,90226,4,2,34,40,
Canadian,U.S. Senate,Randy Brogdon,REP,90226,1,0,5,6,
Canadian,U.S. Senate,Eric Mccray,REP,90226,0,0,0,0,
Canadian,U.S. Senate,Kevin Crow,REP,90226,0,0,0,0,
Canadian,U.S. Senate,James Lankford,REP,90226,3,1,57,61,
Canadian,U.S. Senate,Jason Weger,REP,90226,0,0,0,0,
Canadian,U.S. House,Timothy Ray Murray,REP,90226,2,0,5,7,03
Canadian,U.S. House,Robert Hubbard,REP,90226,4,2,11,17,03
Canadian,U.S. House,Frank Lucas,REP,90226,2,1,76,79,03
Canadian,Superintendent of Public Instruction,John Cox,DEM,90227,3,0,19,22,
Canadian,Superintendent of Public Instruction,Jack Jr.,DEM,90227,0,0,6,6,
Canadian,Superintendent of Public Instruction,Ivan Holmes,DEM,90227,0,0,4,4,
Canadian,Superintendent of Public Instruction,Freda Deskin,DEM,90227,1,0,46,47,
Canadian,U.S. Senate,Patrick Michael Hayes,DEM,90227,0,0,14,14,
Canadian,U.S. Senate,Jim Rogers,DEM,90227,1,0,24,25,
Canadian,U.S. Senate,Connie Johnson,DEM,90227,3,0,37,40,
Canadian,Governor,Dax Ewbank,REP,90227,0,0,44,44,
Canadian,Governor,Chad Moody,REP,90227,2,0,55,57,
Canadian,Governor,Mary Fallin,REP,90227,26,7,281,314,
Canadian,Superintendent of Public Instruction,Brian Kelly,REP,90227,8,1,78,87,
Canadian,Superintendent of Public Instruction,Janet Costello Barresi,REP,90227,8,4,84,96,
Canadian,Superintendent of Public Instruction,Joy Hofmeister,REP,90227,13,2,209,224,
Canadian,Insurance Commissioner,Bill Viner,REP,90227,6,0,69,75,
Canadian,Insurance Commissioner,John Doak,REP,90227,23,7,278,308,
Canadian,Corporation Commissioner,Todd Hiett,REP,90227,13,3,152,168,
Canadian,Corporation Commissioner,Cliff Branan,REP,90227,13,4,196,213,
Canadian,U.S. Senate,Evelyn Rogers,REP,90227,0,0,13,13,
Canadian,U.S. Senate,Rob Moye,REP,90227,0,0,4,4,
Canadian,U.S. Senate,D. Jean Mcbride-Samuels,REP,90227,2,0,3,5,
Canadian,U.S. Senate,Jim Inhofe,REP,90227,27,7,346,380,
Canadian,U.S. Senate,Erick Paul Wyatt,REP,90227,1,0,15,16,
Canadian,U.S. Senate,Andy Craig,REP,90227,0,0,1,1,
Canadian,U.S. Senate,T. Shannon,REP,90227,7,1,106,114,
Canadian,U.S. Senate,Randy Brogdon,REP,90227,0,0,26,26,
Canadian,U.S. Senate,Eric Mccray,REP,90227,0,0,1,1,
Canadian,U.S. Senate,Kevin Crow,REP,90227,0,0,1,1,
Canadian,U.S. Senate,James Lankford,REP,90227,22,6,247,275,
Canadian,U.S. Senate,Jason Weger,REP,90227,1,0,2,3,
Canadian,U.S. House,Timothy Ray Murray,REP,90227,2,0,15,17,03
Canadian,U.S. House,Robert Hubbard,REP,90227,3,0,64,67,03
Canadian,U.S. House,Frank Lucas,REP,90227,25,7,296,328,03
Canadian,Superintendent of Public Instruction,John Cox,DEM,90228,0,0,2,2,
Canadian,Superintendent of Public Instruction,Jack Jr.,DEM,90228,0,0,2,2,
Canadian,Superintendent of Public Instruction,Ivan Holmes,DEM,90228,0,0,0,0,
Canadian,Superintendent of Public Instruction,Freda Deskin,DEM,90228,0,0,3,3,
Canadian,U.S. Senate,Patrick Michael Hayes,DEM,90228,0,0,4,4,
Canadian,U.S. Senate,Jim Rogers,DEM,90228,0,0,0,0,
Canadian,U.S. Senate,Connie Johnson,DEM,90228,0,0,2,2,
Canadian,Governor,Dax Ewbank,REP,90228,1,0,13,14,
Canadian,Governor,Chad Moody,REP,90228,1,1,10,12,
Canadian,Governor,Mary Fallin,REP,90228,4,1,26,31,
Canadian,Superintendent of Public Instruction,Brian Kelly,REP,90228,1,2,8,11,
Canadian,Superintendent of Public Instruction,Janet Costello Barresi,REP,90228,2,0,8,10,
Canadian,Superintendent of Public Instruction,Joy Hofmeister,REP,90228,3,0,34,37,
Canadian,Insurance Commissioner,Bill Viner,REP,90228,0,0,6,6,
Canadian,Insurance Commissioner,John Doak,REP,90228,6,2,40,48,
Canadian,Corporation Commissioner,Todd Hiett,REP,90228,6,1,24,31,
Canadian,Corporation Commissioner,Cliff Branan,REP,90228,0,1,22,23,
Canadian,U.S. Senate,Evelyn Rogers,REP,90228,0,0,1,1,
Canadian,U.S. Senate,Rob Moye,REP,90228,0,1,1,2,
Canadian,U.S. Senate,D. Jean Mcbride-Samuels,REP,90228,0,0,2,2,
Canadian,U.S. Senate,Jim Inhofe,REP,90228,6,1,34,41,
Canadian,U.S. Senate,Erick Paul Wyatt,REP,90228,0,0,10,10,
Canadian,U.S. Senate,Andy Craig,REP,90228,0,0,0,0,
Canadian,U.S. Senate,T. Shannon,REP,90228,0,0,14,14,
Canadian,U.S. Senate,Randy Brogdon,REP,90228,2,0,8,10,
Canadian,U.S. Senate,Eric Mccray,REP,90228,0,0,2,2,
Canadian,U.S. Senate,Kevin Crow,REP,90228,0,0,1,1,
Canadian,U.S. Senate,James Lankford,REP,90228,4,2,23,29,
Canadian,U.S. Senate,Jason Weger,REP,90228,0,0,0,0,
Canadian,U.S. House,Timothy Ray Murray,REP,90228,0,0,6,6,03
Canadian,U.S. House,Robert Hubbard,REP,90228,1,1,8,10,03
Canadian,U.S. House,Frank Lucas,REP,90228,5,1,34,40,03
Canadian,State House,Bill Baker,REP,90228,3,0,12,15,43
Canadian,State House,John Paul Jordan,REP,90228,3,0,22,25,43
Canadian,State House,Jonathan Clour,REP,90228,0,2,5,7,43
Canadian,State House,Nathan Harper,REP,90228,0,0,6,6,43
Canadian,Superintendent of Public Instruction,John Cox,DEM,90300,1,0,29,30,
Canadian,Superintendent of Public Instruction,Jack Jr.,DEM,90300,0,0,6,6,
Canadian,Superintendent of Public Instruction,Ivan Holmes,DEM,90300,0,1,7,8,
Canadian,Superintendent of Public Instruction,Freda Deskin,DEM,90300,0,1,24,25,
Canadian,U.S. Senate,Patrick Michael Hayes,DEM,90300,1,0,11,12,
Canadian,U.S. Senate,Jim Rogers,DEM,90300,0,1,18,19,
Canadian,U.S. Senate,Connie Johnson,DEM,90300,0,1,35,36,
Canadian,U.S. House,Bert Smith,DEM,90300,1,2,52,55,04
Canadian,U.S. House,Tae Si,DEM,90300,0,0,11,11,04
Canadian,Governor,Dax Ewbank,REP,90300,0,0,25,25,
Canadian,Governor,Chad Moody,REP,90300,1,1,42,44,
Canadian,Governor,Mary Fallin,REP,90300,11,1,209,221,
Canadian,Superintendent of Public Instruction,Brian Kelly,REP,90300,1,1,81,83,
Canadian,Superintendent of Public Instruction,Janet Costello Barresi,REP,90300,9,1,66,76,
Canadian,Superintendent of Public Instruction,Joy Hofmeister,REP,90300,2,0,131,133,
Canadian,Insurance Commissioner,Bill Viner,REP,90300,5,1,66,72,
Canadian,Insurance Commissioner,John Doak,REP,90300,6,1,193,200,
Canadian,Corporation Commissioner,Todd Hiett,REP,90300,6,1,117,124,
Canadian,Corporation Commissioner,Cliff Branan,REP,90300,6,1,141,148,
Canadian,U.S. Senate,Evelyn Rogers,REP,90300,0,0,10,10,
Canadian,U.S. Senate,Rob Moye,REP,90300,0,0,8,8,
Canadian,U.S. Senate,D. Jean Mcbride-Samuels,REP,90300,0,0,4,4,
Canadian,U.S. Senate,Jim Inhofe,REP,90300,8,2,242,252,
Canadian,U.S. Senate,Erick Paul Wyatt,REP,90300,3,0,13,16,
Canadian,U.S. Senate,Andy Craig,REP,90300,0,0,2,2,
Canadian,U.S. Senate,T. Shannon,REP,90300,0,0,105,105,
Canadian,U.S. Senate,Randy Brogdon,REP,90300,0,0,7,7,
Canadian,U.S. Senate,Eric Mccray,REP,90300,0,0,0,0,
Canadian,U.S. Senate,Kevin Crow,REP,90300,0,0,1,1,
Canadian,U.S. Senate,James Lankford,REP,90300,11,2,166,179,
Canadian,U.S. Senate,Jason Weger,REP,90300,0,0,0,0,
Canadian,U.S. House,Anna Flatt,REP,90300,3,0,48,51,04
Canadian,U.S. House,Tom Cole,REP,90300,8,2,225,235,04
Canadian,Superintendent of Public Instruction,John Cox,DEM,90301,0,0,31,31,
Canadian,Superintendent of Public Instruction,Jack Jr.,DEM,90301,1,0,10,11,
Canadian,Superintendent of Public Instruction,Ivan Holmes,DEM,90301,0,0,7,7,
Canadian,Superintendent of Public Instruction,Freda Deskin,DEM,90301,4,0,31,35,
Canadian,U.S. Senate,Patrick Michael Hayes,DEM,90301,0,0,19,19,
Canadian,U.S. Senate,Jim Rogers,DEM,90301,1,0,25,26,
Canadian,U.S. Senate,Connie Johnson,DEM,90301,4,0,33,37,
Canadian,U.S. House,Bert Smith,DEM,90301,3,0,56,59,04
Canadian,U.S. House,Tae Si,DEM,90301,2,0,21,23,04
Canadian,Governor,Dax Ewbank,REP,90301,2,0,38,40,
Canadian,Governor,Chad Moody,REP,90301,1,0,55,56,
Canadian,Governor,Mary Fallin,REP,90301,13,9,280,302,
Canadian,Superintendent of Public Instruction,Brian Kelly,REP,90301,5,2,85,92,
Canadian,Superintendent of Public Instruction,Janet Costello Barresi,REP,90301,2,2,96,100,
Canadian,Superintendent of Public Instruction,Joy Hofmeister,REP,90301,8,4,186,198,
Canadian,Insurance Commissioner,Bill Viner,REP,90301,3,2,90,95,
Canadian,Insurance Commissioner,John Doak,REP,90301,11,5,260,276,
Canadian,Corporation Commissioner,Todd Hiett,REP,90301,9,2,186,197,
Canadian,Corporation Commissioner,Cliff Branan,REP,90301,6,5,157,168,
Canadian,U.S. Senate,Evelyn Rogers,REP,90301,0,0,16,16,
Canadian,U.S. Senate,Rob Moye,REP,90301,0,1,4,5,
Canadian,U.S. Senate,D. Jean Mcbride-Samuels,REP,90301,0,0,6,6,
Canadian,U.S. Senate,Jim Inhofe,REP,90301,15,7,323,345,
Canadian,U.S. Senate,Erick Paul Wyatt,REP,90301,1,0,19,20,
Canadian,U.S. Senate,Andy Craig,REP,90301,0,0,3,3,
Canadian,U.S. Senate,T. Shannon,REP,90301,3,2,104,109,
Canadian,U.S. Senate,Randy Brogdon,REP,90301,0,0,14,14,
Canadian,U.S. Senate,Eric Mccray,REP,90301,0,0,1,1,
Canadian,U.S. Senate,Kevin Crow,REP,90301,0,0,1,1,
Canadian,U.S. Senate,James Lankford,REP,90301,12,7,255,274,
Canadian,U.S. Senate,Jason Weger,REP,90301,0,0,3,3,
Canadian,U.S. House,Anna Flatt,REP,90301,0,1,64,65,04
Canadian,U.S. House,Tom Cole,REP,90301,16,7,306,329,04
Canadian,Superintendent of Public Instruction,John Cox,DEM,90302,0,0,22,22,
Canadian,Superintendent of Public Instruction,Jack Jr.,DEM,90302,0,0,8,8,
Canadian,Superintendent of Public Instruction,Ivan Holmes,DEM,90302,0,0,1,1,
Canadian,Superintendent of Public Instruction,Freda Deskin,DEM,90302,1,0,36,37,
Canadian,U.S. Senate,Patrick Michael Hayes,DEM,90302,0,0,15,15,
Canadian,U.S. Senate,Jim Rogers,DEM,90302,0,0,21,21,
Canadian,U.S. Senate,Connie Johnson,DEM,90302,1,0,30,31,
Canadian,U.S. House,Bert Smith,DEM,90302,1,0,55,56,04
Canadian,U.S. House,Tae Si,DEM,90302,0,0,9,9,04
Canadian,Governor,Dax Ewbank,REP,90302,2,1,32,35,
Canadian,Governor,Chad Moody,REP,90302,0,0,42,42,
Canadian,Governor,Mary Fallin,REP,90302,11,4,217,232,
Canadian,Superintendent of Public Instruction,Brian Kelly,REP,90302,4,0,67,71,
Canadian,Superintendent of Public Instruction,Janet Costello Barresi,REP,90302,3,0,61,64,
Canadian,Superintendent of Public Instruction,Joy Hofmeister,REP,90302,5,6,162,173,
Canadian,Insurance Commissioner,Bill Viner,REP,90302,2,1,59,62,
Canadian,Insurance Commissioner,John Doak,REP,90302,10,5,217,232,
Canadian,Corporation Commissioner,Todd Hiett,REP,90302,9,3,135,147,
Canadian,Corporation Commissioner,Cliff Branan,REP,90302,3,4,143,150,
Canadian,U.S. Senate,Evelyn Rogers,REP,90302,1,0,6,7,
Canadian,U.S. Senate,Rob Moye,REP,90302,0,0,4,4,
Canadian,U.S. Senate,D. Jean Mcbride-Samuels,REP,90302,0,0,1,1,
Canadian,U.S. Senate,Jim Inhofe,REP,90302,10,7,266,283,
Canadian,U.S. Senate,Erick Paul Wyatt,REP,90302,1,0,13,14,
Canadian,U.S. Senate,Andy Craig,REP,90302,0,0,4,4,
Canadian,U.S. Senate,T. Shannon,REP,90302,6,2,71,79,
Canadian,U.S. Senate,Randy Brogdon,REP,90302,0,1,17,18,
Canadian,U.S. Senate,Eric Mccray,REP,90302,1,0,2,3,
Canadian,U.S. Senate,Kevin Crow,REP,90302,0,0,3,3,
Canadian,U.S. Senate,James Lankford,REP,90302,6,4,194,204,
Canadian,U.S. Senate,Jason Weger,REP,90302,0,0,1,1,
Canadian,U.S. House,Anna Flatt,REP,90302,3,1,57,61,04
Canadian,U.S. House,Tom Cole,REP,90302,9,6,233,248,04
Canadian,Superintendent of Public Instruction,John Cox,DEM,90303,0,2,18,20,
Canadian,Superintendent of Public Instruction,Jack Jr.,DEM,90303,0,0,7,7,
Canadian,Superintendent of Public Instruction,Ivan Holmes,DEM,90303,0,0,4,4,
Canadian,Superintendent of Public Instruction,Freda Deskin,DEM,90303,2,1,33,36,
Canadian,U.S. Senate,Patrick Michael Hayes,DEM,90303,0,1,12,13,
Canadian,U.S. Senate,Jim Rogers,DEM,90303,0,1,18,19,
Canadian,U.S. Senate,Connie Johnson,DEM,90303,2,1,29,32,
Canadian,Governor,Dax Ewbank,REP,90303,2,0,41,43,
Canadian,Governor,Chad Moody,REP,90303,1,1,65,67,
Canadian,Governor,Mary Fallin,REP,90303,13,5,285,303,
Canadian,Superintendent of Public Instruction,Brian Kelly,REP,90303,2,1,76,79,
Canadian,Superintendent of Public Instruction,Janet Costello Barresi,REP,90303,5,0,83,88,
Canadian,Superintendent of Public Instruction,Joy Hofmeister,REP,90303,11,5,227,243,
Canadian,Insurance Commissioner,Bill Viner,REP,90303,1,2,80,83,
Canadian,Insurance Commissioner,John Doak,REP,90303,17,3,268,288,
Canadian,Corporation Commissioner,Todd Hiett,REP,90303,8,1,167,176,
Canadian,Corporation Commissioner,Cliff Branan,REP,90303,10,4,176,190,
Canadian,U.S. Senate,Evelyn Rogers,REP,90303,4,0,11,15,
Canadian,U.S. Senate,Rob Moye,REP,90303,1,0,12,13,
Canadian,U.S. Senate,D. Jean Mcbride-Samuels,REP,90303,0,0,1,1,
Canadian,U.S. Senate,Jim Inhofe,REP,90303,12,6,347,365,
Canadian,U.S. Senate,Erick Paul Wyatt,REP,90303,1,0,19,20,
Canadian,U.S. Senate,Andy Craig,REP,90303,0,0,0,0,
Canadian,U.S. Senate,T. Shannon,REP,90303,11,1,108,120,
Canadian,U.S. Senate,Randy Brogdon,REP,90303,0,0,17,17,
Canadian,U.S. Senate,Eric Mccray,REP,90303,0,0,1,1,
Canadian,U.S. Senate,Kevin Crow,REP,90303,2,0,0,2,
Canadian,U.S. Senate,James Lankford,REP,90303,5,5,267,277,
Canadian,U.S. Senate,Jason Weger,REP,90303,0,0,2,2,
Canadian,U.S. House,Timothy Ray Murray,REP,90303,1,0,11,12,03
Canadian,U.S. House,Robert Hubbard,REP,90303,3,1,45,49,03
Canadian,U.S. House,Frank Lucas,REP,90303,14,5,320,339,03
Canadian,Superintendent of Public Instruction,John Cox,DEM,90304,0,0,15,15,
Canadian,Superintendent of Public Instruction,Jack Jr.,DEM,90304,0,0,5,5,
Canadian,Superintendent of Public Instruction,Ivan Holmes,DEM,90304,0,0,5,5,
Canadian,Superintendent of Public Instruction,Freda Deskin,DEM,90304,1,0,25,26,
Canadian,U.S. Senate,Patrick Michael Hayes,DEM,90304,0,0,8,8,
Canadian,U.S. Senate,Jim Rogers,DEM,90304,0,0,19,19,
Canadian,U.S. Senate,Connie Johnson,DEM,90304,1,0,20,21,
Canadian,U.S. House,Bert Smith,DEM,90304,1,0,38,39,04
Canadian,U.S. House,Tae Si,DEM,90304,0,0,9,9,04
Canadian,Governor,Dax Ewbank,REP,90304,2,0,32,34,
Canadian,Governor,Chad Moody,REP,90304,2,0,58,60,
Canadian,Governor,Mary Fallin,REP,90304,6,2,228,236,
Canadian,Superintendent of Public Instruction,Brian Kelly,REP,90304,5,0,93,98,
Canadian,Superintendent of Public Instruction,Janet Costello Barresi,REP,90304,0,1,77,78,
Canadian,Superintendent of Public Instruction,Joy Hofmeister,REP,90304,5,1,141,147,
Canadian,Insurance Commissioner,Bill Viner,REP,90304,2,0,67,69,
Canadian,Insurance Commissioner,John Doak,REP,90304,8,2,228,238,
Canadian,Corporation Commissioner,Todd Hiett,REP,90304,7,1,158,166,
Canadian,Corporation Commissioner,Cliff Branan,REP,90304,3,1,136,140,
Canadian,U.S. Senate,Evelyn Rogers,REP,90304,1,0,14,15,
Canadian,U.S. Senate,Rob Moye,REP,90304,0,0,6,6,
Canadian,U.S. Senate,D. Jean Mcbride-Samuels,REP,90304,0,0,2,2,
Canadian,U.S. Senate,Jim Inhofe,REP,90304,8,2,274,284,
Canadian,U.S. Senate,Erick Paul Wyatt,REP,90304,1,0,21,22,
Canadian,U.S. Senate,Andy Craig,REP,90304,0,0,4,4,
Canadian,U.S. Senate,T. Shannon,REP,90304,3,0,87,90,
Canadian,U.S. Senate,Randy Brogdon,REP,90304,0,1,15,16,
Canadian,U.S. Senate,Eric Mccray,REP,90304,0,0,2,2,
Canadian,U.S. Senate,Kevin Crow,REP,90304,0,0,7,7,
Canadian,U.S. Senate,James Lankford,REP,90304,6,1,204,211,
Canadian,U.S. Senate,Jason Weger,REP,90304,1,0,2,3,
Canadian,U.S. House,Anna Flatt,REP,90304,1,1,48,50,04
Canadian,U.S. House,Tom Cole,REP,90304,9,1,270,280,04
Canadian,Superintendent of Public Instruction,John Cox,DEM,90306,2,1,23,26,
Canadian,Superintendent of Public Instruction,Jack Jr.,DEM,90306,3,0,14,17,
Canadian,Superintendent of Public Instruction,Ivan Holmes,DEM,90306,0,0,3,3,
Canadian,Superintendent of Public Instruction,Freda Deskin,DEM,90306,2,1,55,58,
Canadian,U.S. Senate,Patrick Michael Hayes,DEM,90306,5,0,10,15,
Canadian,U.S. Senate,Jim Rogers,DEM,90306,2,0,30,32,
Canadian,U.S. Senate,Connie Johnson,DEM,90306,0,2,52,54,
Canadian,U.S. House,Bert Smith,DEM,90306,7,1,67,75,04
Canadian,U.S. House,Tae Si,DEM,90306,0,0,18,18,04
Canadian,Governor,Dax Ewbank,REP,90306,3,3,41,47,
Canadian,Governor,Chad Moody,REP,90306,1,2,50,53,
Canadian,Governor,Mary Fallin,REP,90306,30,7,381,418,
Canadian,Superintendent of Public Instruction,Brian Kelly,REP,90306,5,3,133,141,
Canadian,Superintendent of Public Instruction,Janet Costello Barresi,REP,90306,18,6,99,123,
Canadian,Superintendent of Public Instruction,Joy Hofmeister,REP,90306,10,3,240,253,
Canadian,Insurance Commissioner,Bill Viner,REP,90306,6,1,102,109,
Canadian,Insurance Commissioner,John Doak,REP,90306,26,11,338,375,
Canadian,Corporation Commissioner,Todd Hiett,REP,90306,16,6,193,215,
Canadian,Corporation Commissioner,Cliff Branan,REP,90306,16,5,250,271,
Canadian,U.S. Senate,Evelyn Rogers,REP,90306,0,1,18,19,
Canadian,U.S. Senate,Rob Moye,REP,90306,0,0,10,10,
Canadian,U.S. Senate,D. Jean Mcbride-Samuels,REP,90306,0,0,2,2,
Canadian,U.S. Senate,Jim Inhofe,REP,90306,34,11,423,468,
Canadian,U.S. Senate,Erick Paul Wyatt,REP,90306,0,0,15,15,
Canadian,U.S. Senate,Andy Craig,REP,90306,0,0,2,2,
Canadian,U.S. Senate,T. Shannon,REP,90306,3,5,150,158,
Canadian,U.S. Senate,Randy Brogdon,REP,90306,1,0,13,14,
Canadian,U.S. Senate,Eric Mccray,REP,90306,0,0,2,2,
Canadian,U.S. Senate,Kevin Crow,REP,90306,0,0,3,3,
Canadian,U.S. Senate,James Lankford,REP,90306,30,7,306,343,
Canadian,U.S. Senate,Jason Weger,REP,90306,0,0,2,2,
Canadian,U.S. House,Anna Flatt,REP,90306,6,3,58,67,04
Canadian,U.S. House,Tom Cole,REP,90306,28,9,412,449,04
Canadian,Superintendent of Public Instruction,John Cox,DEM,90308,0,0,7,7,
Canadian,Superintendent of Public Instruction,Jack Jr.,DEM,90308,0,0,3,3,
Canadian,Superintendent of Public Instruction,Ivan Holmes,DEM,90308,1,0,0,1,
Canadian,Superintendent of Public Instruction,Freda Deskin,DEM,90308,0,1,9,10,
Canadian,U.S. Senate,Patrick Michael Hayes,DEM,90308,0,0,4,4,
Canadian,U.S. Senate,Jim Rogers,DEM,90308,1,0,3,4,
Canadian,U.S. Senate,Connie Johnson,DEM,90308,0,1,11,12,
Canadian,Governor,Dax Ewbank,REP,90308,3,0,13,16,
Canadian,Governor,Chad Moody,REP,90308,1,0,19,20,
Canadian,Governor,Mary Fallin,REP,90308,3,2,98,103,
Canadian,Superintendent of Public Instruction,Brian Kelly,REP,90308,1,1,27,29,
Canadian,Superintendent of Public Instruction,Janet Costello Barresi,REP,90308,0,0,24,24,
Canadian,Superintendent of Public Instruction,Joy Hofmeister,REP,90308,5,1,79,85,
Canadian,Insurance Commissioner,Bill Viner,REP,90308,1,0,33,34,
Canadian,Insurance Commissioner,John Doak,REP,90308,5,2,92,99,
Canadian,Corporation Commissioner,Todd Hiett,REP,90308,5,2,52,59,
Canadian,Corporation Commissioner,Cliff Branan,REP,90308,1,0,69,70,
Canadian,U.S. Senate,Evelyn Rogers,REP,90308,1,0,6,7,
Canadian,U.S. Senate,Rob Moye,REP,90308,0,0,1,1,
Canadian,U.S. Senate,D. Jean Mcbride-Samuels,REP,90308,0,0,1,1,
Canadian,U.S. Senate,Jim Inhofe,REP,90308,6,2,119,127,
Canadian,U.S. Senate,Erick Paul Wyatt,REP,90308,0,0,4,4,
Canadian,U.S. Senate,Andy Craig,REP,90308,0,0,1,1,
Canadian,U.S. Senate,T. Shannon,REP,90308,1,0,27,28,
Canadian,U.S. Senate,Randy Brogdon,REP,90308,0,0,1,1,
Canadian,U.S. Senate,Eric Mccray,REP,90308,0,0,1,1,
Canadian,U.S. Senate,Kevin Crow,REP,90308,0,0,2,2,
Canadian,U.S. Senate,James Lankford,REP,90308,6,2,98,106,
Canadian,U.S. Senate,Jason Weger,REP,90308,0,0,1,1,
Canadian,U.S. House,Timothy Ray Murray,REP,90308,0,0,3,3,03
Canadian,U.S. House,Robert Hubbard,REP,90308,1,0,9,10,03
Canadian,U.S. House,Frank Lucas,REP,90308,6,2,116,124,03
Canadian,Superintendent of Public Instruction,John Cox,DEM,90309,0,0,0,0,
Canadian,Superintendent of Public Instruction,Jack Jr.,DEM,90309,0,0,1,1,
Canadian,Superintendent of Public Instruction,Ivan Holmes,DEM,90309,0,0,0,0,
Canadian,Superintendent of Public Instruction,Freda Deskin,DEM,90309,0,0,4,4,
Canadian,U.S. Senate,Patrick Michael Hayes,DEM,90309,0,0,0,0,
Canadian,U.S. Senate,Jim Rogers,DEM,90309,0,0,2,2,
Canadian,U.S. Senate,Connie Johnson,DEM,90309,0,0,2,2,
Canadian,U.S. House,Bert Smith,DEM,90309,0,0,3,3,04
Canadian,U.S. House,Tae Si,DEM,90309,0,0,1,1,04
Canadian,Governor,Dax Ewbank,REP,90309,0,0,1,1,
Canadian,Governor,Chad Moody,REP,90309,0,0,2,2,
Canadian,Governor,Mary Fallin,REP,90309,1,4,30,35,
Canadian,Superintendent of Public Instruction,Brian Kelly,REP,90309,0,0,5,5,
Canadian,Superintendent of Public Instruction,Janet Costello Barresi,REP,90309,0,2,7,9,
Canadian,Superintendent of Public Instruction,Joy Hofmeister,REP,90309,1,1,22,24,
Canadian,Insurance Commissioner,Bill Viner,REP,90309,1,2,6,9,
Canadian,Insurance Commissioner,John Doak,REP,90309,0,2,27,29,
Canadian,Corporation Commissioner,Todd Hiett,REP,90309,1,1,15,17,
Canadian,Corporation Commissioner,Cliff Branan,REP,90309,0,3,18,21,
Canadian,U.S. Senate,Evelyn Rogers,REP,90309,0,0,1,1,
Canadian,U.S. Senate,Rob Moye,REP,90309,0,0,0,0,
Canadian,U.S. Senate,D. Jean Mcbride-Samuels,REP,90309,0,2,0,2,
Canadian,U.S. Senate,Jim Inhofe,REP,90309,1,2,30,33,
Canadian,U.S. Senate,Erick Paul Wyatt,REP,90309,0,0,2,2,
Canadian,U.S. Senate,Andy Craig,REP,90309,0,0,0,0,
Canadian,U.S. Senate,T. Shannon,REP,90309,0,4,5,9,
Canadian,U.S. Senate,Randy Brogdon,REP,90309,0,0,0,0,
Canadian,U.S. Senate,Eric Mccray,REP,90309,0,0,0,0,
Canadian,U.S. Senate,Kevin Crow,REP,90309,0,0,0,0,
Canadian,U.S. Senate,James Lankford,REP,90309,1,0,29,30,
Canadian,U.S. Senate,Jason Weger,REP,90309,0,0,0,0,
Canadian,U.S. House,Anna Flatt,REP,90309,0,2,4,6,04
Canadian,U.S. House,Tom Cole,REP,90309,1,2,29,32,04
Canadian,Superintendent of Public Instruction,John Cox,DEM,90398,0,0,0,0,
Canadian,Superintendent of Public Instruction,Jack Jr.,DEM,90398,0,0,0,0,
Canadian,Superintendent of Public Instruction,Ivan Holmes,DEM,90398,0,0,0,0,
Canadian,Superintendent of Public Instruction,Freda Deskin,DEM,90398,0,0,0,0,
Canadian,U.S. Senate,Patrick Michael Hayes,DEM,90398,0,0,0,0,
Canadian,U.S. Senate,Jim Rogers,DEM,90398,0,0,0,0,
Canadian,U.S. Senate,Connie Johnson,DEM,90398,0,0,0,0,
Canadian,U.S. House,Bert Smith,DEM,90398,0,0,0,0,04
Canadian,U.S. House,Tae Si,DEM,90398,0,0,0,0,04
Canadian,Governor,Dax Ewbank,REP,90398,0,0,0,0,
Canadian,Governor,Chad Moody,REP,90398,0,0,0,0,
Canadian,Governor,Mary Fallin,REP,90398,0,0,0,0,
Canadian,Superintendent of Public Instruction,Brian Kelly,REP,90398,0,0,0,0,
Canadian,Superintendent of Public Instruction,Janet Costello Barresi,REP,90398,0,0,0,0,
Canadian,Superintendent of Public Instruction,Joy Hofmeister,REP,90398,0,0,0,0,
Canadian,Insurance Commissioner,Bill Viner,REP,90398,0,0,0,0,
Canadian,Insurance Commissioner,John Doak,REP,90398,0,0,0,0,
Canadian,Corporation Commissioner,Todd Hiett,REP,90398,0,0,0,0,
Canadian,Corporation Commissioner,Cliff Branan,REP,90398,0,0,0,0,
Canadian,U.S. Senate,Evelyn Rogers,REP,90398,0,0,0,0,
Canadian,U.S. Senate,Rob Moye,REP,90398,0,0,0,0,
Canadian,U.S. Senate,D. Jean Mcbride-Samuels,REP,90398,0,0,0,0,
Canadian,U.S. Senate,Jim Inhofe,REP,90398,0,0,0,0,
Canadian,U.S. Senate,Erick Paul Wyatt,REP,90398,0,0,0,0,
Canadian,U.S. Senate,Andy Craig,REP,90398,0,0,0,0,
Canadian,U.S. Senate,T. Shannon,REP,90398,0,0,0,0,
Canadian,U.S. Senate,Randy Brogdon,REP,90398,0,0,0,0,
Canadian,U.S. Senate,Eric Mccray,REP,90398,0,0,0,0,
Canadian,U.S. Senate,Kevin Crow,REP,90398,0,0,0,0,
Canadian,U.S. Senate,James Lankford,REP,90398,0,0,0,0,
Canadian,U.S. Senate,Jason Weger,REP,90398,0,0,0,0,
Canadian,U.S. House,Anna Flatt,REP,90398,0,0,0,0,04
Canadian,U.S. House,Tom Cole,REP,90398,0,0,0,0,04
Canadian,Superintendent of Public Instruction,John Cox,DEM,90399,0,0,0,0,
Canadian,Superintendent of Public Instruction,Jack Jr.,DEM,90399,0,0,0,0,
Canadian,Superintendent of Public Instruction,Ivan Holmes,DEM,90399,0,0,0,0,
Canadian,Superintendent of Public Instruction,Freda Deskin,DEM,90399,0,0,0,0,
Canadian,U.S. Senate,Patrick Michael Hayes,DEM,90399,0,0,0,0,
Canadian,U.S. Senate,Jim Rogers,DEM,90399,0,0,0,0,
Canadian,U.S. Senate,Connie Johnson,DEM,90399,0,0,0,0,
Canadian,U.S. House,Bert Smith,DEM,90399,0,0,0,0,04
Canadian,U.S. House,Tae Si,DEM,90399,0,0,0,0,04
Canadian,Governor,Dax Ewbank,REP,90399,0,0,0,0,
Canadian,Governor,Chad Moody,REP,90399,0,0,0,0,
Canadian,Governor,Mary Fallin,REP,90399,0,0,0,0,
Canadian,Superintendent of Public Instruction,Brian Kelly,REP,90399,0,0,0,0,
Canadian,Superintendent of Public Instruction,Janet Costello Barresi,REP,90399,0,0,0,0,
Canadian,Superintendent of Public Instruction,Joy Hofmeister,REP,90399,0,0,0,0,
Canadian,Insurance Commissioner,Bill Viner,REP,90399,0,0,0,0,
Canadian,Insurance Commissioner,John Doak,REP,90399,0,0,0,0,
Canadian,Corporation Commissioner,Todd Hiett,REP,90399,0,0,0,0,
Canadian,Corporation Commissioner,Cliff Branan,REP,90399,0,0,0,0,
Canadian,U.S. Senate,Evelyn Rogers,REP,90399,0,0,0,0,
Canadian,U.S. Senate,Rob Moye,REP,90399,0,0,0,0,
Canadian,U.S. Senate,D. Jean Mcbride-Samuels,REP,90399,0,0,0,0,
Canadian,U.S. Senate,Jim Inhofe,REP,90399,0,0,0,0,
Canadian,U.S. Senate,Erick Paul Wyatt,REP,90399,0,0,0,0,
Canadian,U.S. Senate,Andy Craig,REP,90399,0,0,0,0,
Canadian,U.S. Senate,T. Shannon,REP,90399,0,0,0,0,
Canadian,U.S. Senate,Randy Brogdon,REP,90399,0,0,0,0,
Canadian,U.S. Senate,Eric Mccray,REP,90399,0,0,0,0,
Canadian,U.S. Senate,Kevin Crow,REP,90399,0,0,0,0,
Canadian,U.S. Senate,James Lankford,REP,90399,0,0,0,0,
Canadian,U.S. Senate,Jason Weger,REP,90399,0,0,0,0,
Canadian,U.S. House,Anna Flatt,REP,90399,0,0,0,0,04
Canadian,U.S. House,Tom Cole,REP,90399,0,0,0,0,04
Canadian,Superintendent of Public Instruction,John Cox,DEM,90400,0,3,19,22,
Canadian,Superintendent of Public Instruction,Jack Jr.,DEM,90400,0,0,6,6,
Canadian,Superintendent of Public Instruction,Ivan Holmes,DEM,90400,0,0,4,4,
Canadian,Superintendent of Public Instruction,Freda Deskin,DEM,90400,0,0,20,20,
Canadian,U.S. Senate,Patrick Michael Hayes,DEM,90400,0,1,10,11,
Canadian,U.S. Senate,Jim Rogers,DEM,90400,0,1,18,19,
Canadian,U.S. Senate,Connie Johnson,DEM,90400,0,1,21,22,
Canadian,Governor,Dax Ewbank,REP,90400,0,0,19,19,
Canadian,Governor,Chad Moody,REP,90400,0,1,28,29,
Canadian,Governor,Mary Fallin,REP,90400,5,3,132,140,
Canadian,Superintendent of Public Instruction,Brian Kelly,REP,90400,3,0,51,54,
Canadian,Superintendent of Public Instruction,Janet Costello Barresi,REP,90400,1,1,23,25,
Canadian,Superintendent of Public Instruction,Joy Hofmeister,REP,90400,1,3,102,106,
Canadian,Insurance Commissioner,Bill Viner,REP,90400,0,0,42,42,
Canadian,Insurance Commissioner,John Doak,REP,90400,5,4,126,135,
Canadian,Corporation Commissioner,Todd Hiett,REP,90400,4,2,79,85,
Canadian,Corporation Commissioner,Cliff Branan,REP,90400,1,2,91,94,
Canadian,U.S. Senate,Evelyn Rogers,REP,90400,0,0,3,3,
Canadian,U.S. Senate,Rob Moye,REP,90400,0,0,6,6,
Canadian,U.S. Senate,D. Jean Mcbride-Samuels,REP,90400,0,0,2,2,
Canadian,U.S. Senate,Jim Inhofe,REP,90400,5,4,149,158,
Canadian,U.S. Senate,Erick Paul Wyatt,REP,90400,0,0,15,15,
Canadian,U.S. Senate,Andy Craig,REP,90400,0,0,2,2,
Canadian,U.S. Senate,T. Shannon,REP,90400,1,2,62,65,
Canadian,U.S. Senate,Randy Brogdon,REP,90400,0,0,5,5,
Canadian,U.S. Senate,Eric Mccray,REP,90400,0,0,2,2,
Canadian,U.S. Senate,Kevin Crow,REP,90400,0,0,2,2,
Canadian,U.S. Senate,James Lankford,REP,90400,4,2,103,109,
Canadian,U.S. Senate,Jason Weger,REP,90400,0,0,1,1,
Canadian,U.S. House,Timothy Ray Murray,REP,90400,0,0,10,10,03
Canadian,U.S. House,Robert Hubbard,REP,90400,0,1,27,28,03
Canadian,U.S. House,Frank Lucas,REP,90400,5,3,137,145,03
Canadian,Superintendent of Public Instruction,John Cox,DEM,90403,0,0,11,11,
Canadian,Superintendent of Public Instruction,Jack Jr.,DEM,90403,0,0,2,2,
Canadian,Superintendent of Public Instruction,Ivan Holmes,DEM,90403,0,0,3,3,
Canadian,Superintendent of Public Instruction,Freda Deskin,DEM,90403,0,0,4,4,
Canadian,U.S. Senate,Patrick Michael Hayes,DEM,90403,0,0,1,1,
Canadian,U.S. Senate,Jim Rogers,DEM,90403,0,0,10,10,
Canadian,U.S. Senate,Connie Johnson,DEM,90403,0,0,9,9,
Canadian,Governor,Dax Ewbank,REP,90403,1,0,0,1,
Canadian,Governor,Chad Moody,REP,90403,0,0,7,7,
Canadian,Governor,Mary Fallin,REP,90403,1,2,54,57,
Canadian,Superintendent of Public Instruction,Brian Kelly,REP,90403,0,0,16,16,
Canadian,Superintendent of Public Instruction,Janet Costello Barresi,REP,90403,1,2,4,7,
Canadian,Superintendent of Public Instruction,Joy Hofmeister,REP,90403,1,0,40,41,
Canadian,Insurance Commissioner,Bill Viner,REP,90403,0,0,16,16,
Canadian,Insurance Commissioner,John Doak,REP,90403,2,2,44,48,
Canadian,Corporation Commissioner,Todd Hiett,REP,90403,1,0,36,37,
Canadian,Corporation Commissioner,Cliff Branan,REP,90403,0,2,23,25,
Canadian,U.S. Senate,Evelyn Rogers,REP,90403,0,0,3,3,
Canadian,U.S. Senate,Rob Moye,REP,90403,0,0,1,1,
Canadian,U.S. Senate,D. Jean Mcbride-Samuels,REP,90403,0,0,1,1,
Canadian,U.S. Senate,Jim Inhofe,REP,90403,2,2,56,60,
Canadian,U.S. Senate,Erick Paul Wyatt,REP,90403,0,0,0,0,
Canadian,U.S. Senate,Andy Craig,REP,90403,0,0,0,0,
Canadian,U.S. Senate,T. Shannon,REP,90403,0,0,14,14,
Canadian,U.S. Senate,Randy Brogdon,REP,90403,1,0,3,4,
Canadian,U.S. Senate,Eric Mccray,REP,90403,0,0,1,1,
Canadian,U.S. Senate,Kevin Crow,REP,90403,0,0,0,0,
Canadian,U.S. Senate,James Lankford,REP,90403,1,2,43,46,
Canadian,U.S. Senate,Jason Weger,REP,90403,0,0,0,0,
Canadian,U.S. House,Timothy Ray Murray,REP,90403,0,0,4,4,03
Canadian,U.S. House,Robert Hubbard,REP,90403,1,0,6,7,03
Canadian,U.S. House,Frank Lucas,REP,90403,1,2,51,54,03
Canadian,Superintendent of Public Instruction,John Cox,DEM,90404,0,0,22,22,
Canadian,Superintendent of Public Instruction,Jack Jr.,DEM,90404,0,0,0,0,
Canadian,Superintendent of Public Instruction,Ivan Holmes,DEM,90404,0,0,1,1,
Canadian,Superintendent of Public Instruction,Freda Deskin,DEM,90404,0,0,0,0,
Canadian,U.S. Senate,Patrick Michael Hayes,DEM,90404,0,0,6,6,
Canadian,U.S. Senate,Jim Rogers,DEM,90404,0,0,9,9,
Canadian,U.S. Senate,Connie Johnson,DEM,90404,0,0,8,8,
Canadian,Governor,Dax Ewbank,REP,90404,0,1,6,7,
Canadian,Governor,Chad Moody,REP,90404,0,3,6,9,
Canadian,Governor,Mary Fallin,REP,90404,3,7,41,51,
Canadian,Superintendent of Public Instruction,Brian Kelly,REP,90404,1,1,13,15,
Canadian,Superintendent of Public Instruction,Janet Costello Barresi,REP,90404,1,0,10,11,
Canadian,Superintendent of Public Instruction,Joy Hofmeister,REP,90404,1,10,30,41,
Canadian,Insurance Commissioner,Bill Viner,REP,90404,1,3,7,11,
Canadian,Insurance Commissioner,John Doak,REP,90404,2,8,41,51,
Canadian,Corporation Commissioner,Todd Hiett,REP,90404,2,3,23,28,
Canadian,Corporation Commissioner,Cliff Branan,REP,90404,1,7,28,36,
Canadian,U.S. Senate,Evelyn Rogers,REP,90404,1,0,3,4,
Canadian,U.S. Senate,Rob Moye,REP,90404,0,0,1,1,
Canadian,U.S. Senate,D. Jean Mcbride-Samuels,REP,90404,0,1,0,1,
Canadian,U.S. Senate,Jim Inhofe,REP,90404,2,9,47,58,
Canadian,U.S. Senate,Erick Paul Wyatt,REP,90404,0,1,2,3,
Canadian,U.S. Senate,Andy Craig,REP,90404,1,0,0,1,
Canadian,U.S. Senate,T. Shannon,REP,90404,0,2,14,16,
Canadian,U.S. Senate,Randy Brogdon,REP,90404,0,1,1,2,
Canadian,U.S. Senate,Eric Mccray,REP,90404,0,0,1,1,
Canadian,U.S. Senate,Kevin Crow,REP,90404,0,0,0,0,
Canadian,U.S. Senate,James Lankford,REP,90404,2,8,39,49,
Canadian,U.S. Senate,Jason Weger,REP,90404,0,0,1,1,
Canadian,U.S. House,Timothy Ray Murray,REP,90404,1,0,2,3,03
Canadian,U.S. House,Robert Hubbard,REP,90404,1,2,7,10,03
Canadian,U.S. House,Frank Lucas,REP,90404,1,9,47,57,03
Canadian,Superintendent of Public Instruction,John Cox,DEM,90406,0,0,8,8,
Canadian,Superintendent of Public Instruction,Jack Jr.,DEM,90406,0,0,2,2,
Canadian,Superintendent of Public Instruction,Ivan Holmes,DEM,90406,0,0,1,1,
Canadian,Superintendent of Public Instruction,Freda Deskin,DEM,90406,0,0,10,10,
Canadian,U.S. Senate,Patrick Michael Hayes,DEM,90406,0,0,3,3,
Canadian,U.S. Senate,Jim Rogers,DEM,90406,0,0,7,7,
Canadian,U.S. Senate,Connie Johnson,DEM,90406,0,0,11,11,
Canadian,Governor,Dax Ewbank,REP,90406,0,0,3,3,
Canadian,Governor,Chad Moody,REP,90406,1,2,4,7,
Canadian,Governor,Mary Fallin,REP,90406,0,0,24,24,
Canadian,Superintendent of Public Instruction,Brian Kelly,REP,90406,0,1,5,6,
Canadian,Superintendent of Public Instruction,Janet Costello Barresi,REP,90406,0,0,4,4,
Canadian,Superintendent of Public Instruction,Joy Hofmeister,REP,90406,1,1,20,22,
Canadian,Insurance Commissioner,Bill Viner,REP,90406,0,0,9,9,
Canadian,Insurance Commissioner,John Doak,REP,90406,1,2,20,23,
Canadian,Corporation Commissioner,Todd Hiett,REP,90406,1,1,10,12,
Canadian,Corporation Commissioner,Cliff Branan,REP,90406,0,1,20,21,
Canadian,U.S. Senate,Evelyn Rogers,REP,90406,0,0,4,4,
Canadian,U.S. Senate,Rob Moye,REP,90406,0,0,0,0,
Canadian,U.S. Senate,D. Jean Mcbride-Samuels,REP,90406,0,0,0,0,
Canadian,U.S. Senate,Jim Inhofe,REP,90406,1,2,23,26,
Canadian,U.S. Senate,Erick Paul Wyatt,REP,90406,0,0,3,3,
Canadian,U.S. Senate,Andy Craig,REP,90406,0,0,0,0,
Canadian,U.S. Senate,T. Shannon,REP,90406,0,1,10,11,
Canadian,U.S. Senate,Randy Brogdon,REP,90406,0,0,0,0,
Canadian,U.S. Senate,Eric Mccray,REP,90406,0,0,0,0,
Canadian,U.S. Senate,Kevin Crow,REP,90406,0,0,0,0,
Canadian,U.S. Senate,James Lankford,REP,90406,1,1,20,22,
Canadian,U.S. Senate,Jason Weger,REP,90406,0,0,0,0,
Canadian,U.S. House,Timothy Ray Murray,REP,90406,0,0,3,3,03
Canadian,U.S. House,Robert Hubbard,REP,90406,0,0,3,3,03
Canadian,U.S. House,Frank Lucas,REP,90406,1,2,25,28,03
Canadian,Superintendent of Public Instruction,John Cox,DEM,90408,0,0,22,22,
Canadian,Superintendent of Public Instruction,Jack Jr.,DEM,90408,0,0,6,6,
Canadian,Superintendent of Public Instruction,Ivan Holmes,DEM,90408,0,0,0,0,
Canadian,Superintendent of Public Instruction,Freda Deskin,DEM,90408,0,0,18,18,
Canadian,U.S. Senate,Patrick Michael Hayes,DEM,90408,0,0,13,13,
Canadian,U.S. Senate,Jim Rogers,DEM,90408,0,0,19,19,
Canadian,U.S. Senate,Connie Johnson,DEM,90408,0,0,11,11,
Canadian,Governor,Dax Ewbank,REP,90408,0,0,14,14,
Canadian,Governor,Chad Moody,REP,90408,0,2,9,11,
Canadian,Governor,Mary Fallin,REP,90408,2,5,48,55,
Canadian,Superintendent of Public Instruction,Brian Kelly,REP,90408,0,2,19,21,
Canadian,Superintendent of Public Instruction,Janet Costello Barresi,REP,90408,0,0,7,7,
Canadian,Superintendent of Public Instruction,Joy Hofmeister,REP,90408,2,3,46,51,
Canadian,Insurance Commissioner,Bill Viner,REP,90408,0,0,12,12,
Canadian,Insurance Commissioner,John Doak,REP,90408,2,5,58,65,
Canadian,Corporation Commissioner,Todd Hiett,REP,90408,1,3,31,35,
Canadian,Corporation Commissioner,Cliff Branan,REP,90408,1,3,39,43,
Canadian,U.S. Senate,Evelyn Rogers,REP,90408,0,0,1,1,
Canadian,U.S. Senate,Rob Moye,REP,90408,0,0,0,0,
Canadian,U.S. Senate,D. Jean Mcbride-Samuels,REP,90408,0,0,1,1,
Canadian,U.S. Senate,Jim Inhofe,REP,90408,2,7,63,72,
Canadian,U.S. Senate,Erick Paul Wyatt,REP,90408,0,0,5,5,
Canadian,U.S. Senate,Andy Craig,REP,90408,0,0,1,1,
Canadian,U.S. Senate,T. Shannon,REP,90408,1,1,26,28,
Canadian,U.S. Senate,Randy Brogdon,REP,90408,0,2,2,4,
Canadian,U.S. Senate,Eric Mccray,REP,90408,0,0,1,1,
Canadian,U.S. Senate,Kevin Crow,REP,90408,0,0,0,0,
Canadian,U.S. Senate,James Lankford,REP,90408,1,4,38,43,
Canadian,U.S. Senate,Jason Weger,REP,90408,0,0,3,3,
Canadian,U.S. House,Timothy Ray Murray,REP,90408,0,0,5,5,03
Canadian,U.S. House,Robert Hubbard,REP,90408,0,0,9,9,03
Canadian,U.S. House,Frank Lucas,REP,90408,2,7,56,65,03
Canadian,Superintendent of Public Instruction,John Cox,DEM,90409,0,0,7,7,
Canadian,Superintendent of Public Instruction,Jack Jr.,DEM,90409,0,0,0,0,
Canadian,Superintendent of Public Instruction,Ivan Holmes,DEM,90409,0,0,0,0,
Canadian,Superintendent of Public Instruction,Freda Deskin,DEM,90409,0,0,1,1,
Canadian,U.S. Senate,Patrick Michael Hayes,DEM,90409,0,0,2,2,
Canadian,U.S. Senate,Jim Rogers,DEM,90409,0,0,1,1,
Canadian,U.S. Senate,Connie Johnson,DEM,90409,0,0,5,5,
Canadian,Governor,Dax Ewbank,REP,90409,0,0,0,0,
Canadian,Governor,Chad Moody,REP,90409,0,1,1,2,
Canadian,Governor,Mary Fallin,REP,90409,0,0,7,7,
Canadian,Superintendent of Public Instruction,Brian Kelly,REP,90409,0,0,1,1,
Canadian,Superintendent of Public Instruction,Janet Costello Barresi,REP,90409,0,0,0,0,
Canadian,Superintendent of Public Instruction,Joy Hofmeister,REP,90409,0,1,7,8,
Canadian,Insurance Commissioner,Bill Viner,REP,90409,0,0,2,2,
Canadian,Insurance Commissioner,John Doak,REP,90409,0,1,3,4,
Canadian,Corporation Commissioner,Todd Hiett,REP,90409,0,0,3,3,
Canadian,Corporation Commissioner,Cliff Branan,REP,90409,0,1,4,5,
Canadian,U.S. Senate,Evelyn Rogers,REP,90409,0,0,0,0,
Canadian,U.S. Senate,Rob Moye,REP,90409,0,0,0,0,
Canadian,U.S. Senate,D. Jean Mcbride-Samuels,REP,90409,0,0,0,0,
Canadian,U.S. Senate,Jim Inhofe,REP,90409,0,1,8,9,
Canadian,U.S. Senate,Erick Paul Wyatt,REP,90409,0,0,0,0,
Canadian,U.S. Senate,Andy Craig,REP,90409,0,0,0,0,
Canadian,U.S. Senate,T. Shannon,REP,90409,0,0,4,4,
Canadian,U.S. Senate,Randy Brogdon,REP,90409,0,0,0,0,
Canadian,U.S. Senate,Eric Mccray,REP,90409,0,0,0,0,
Canadian,U.S. Senate,Kevin Crow,REP,90409,0,0,0,0,
Canadian,U.S. Senate,James Lankford,REP,90409,0,1,4,5,
Canadian,U.S. Senate,Jason Weger,REP,90409,0,0,0,0,
Canadian,U.S. House,Timothy Ray Murray,REP,90409,0,0,0,0,03
Canadian,U.S. House,Robert Hubbard,REP,90409,0,0,0,0,03
Canadian,U.S. House,Frank Lucas,REP,90409,0,1,8,9,03
Canadian,Superintendent of Public Instruction,John Cox,DEM,90502,0,0,3,3,
Canadian,Superintendent of Public Instruction,Jack Jr.,DEM,90502,0,0,3,3,
Canadian,Superintendent of Public Instruction,Ivan Holmes,DEM,90502,0,0,3,3,
Canadian,Superintendent of Public Instruction,Freda Deskin,DEM,90502,0,1,4,5,
Canadian,U.S. Senate,Patrick Michael Hayes,DEM,90502,0,0,6,6,
Canadian,U.S. Senate,Jim Rogers,DEM,90502,0,1,3,4,
Canadian,U.S. Senate,Connie Johnson,DEM,90502,0,0,4,4,
Canadian,Governor,Dax Ewbank,REP,90502,0,0,4,4,
Canadian,Governor,Chad Moody,REP,90502,0,0,4,4,
Canadian,Governor,Mary Fallin,REP,90502,1,5,75,81,
Canadian,Superintendent of Public Instruction,Brian Kelly,REP,90502,0,2,20,22,
Canadian,Superintendent of Public Instruction,Janet Costello Barresi,REP,90502,1,2,15,18,
Canadian,Superintendent of Public Instruction,Joy Hofmeister,REP,90502,0,1,46,47,
Canadian,Insurance Commissioner,Bill Viner,REP,90502,0,1,13,14,
Canadian,Insurance Commissioner,John Doak,REP,90502,1,4,67,72,
Canadian,Corporation Commissioner,Todd Hiett,REP,90502,1,3,40,44,
Canadian,Corporation Commissioner,Cliff Branan,REP,90502,0,2,42,44,
Canadian,U.S. Senate,Evelyn Rogers,REP,90502,0,0,4,4,
Canadian,U.S. Senate,Rob Moye,REP,90502,0,0,0,0,
Canadian,U.S. Senate,D. Jean Mcbride-Samuels,REP,90502,0,0,1,1,
Canadian,U.S. Senate,Jim Inhofe,REP,90502,1,5,79,85,
Canadian,U.S. Senate,Erick Paul Wyatt,REP,90502,0,0,1,1,
Canadian,U.S. Senate,Andy Craig,REP,90502,0,0,0,0,
Canadian,U.S. Senate,T. Shannon,REP,90502,0,0,26,26,
Canadian,U.S. Senate,Randy Brogdon,REP,90502,0,0,0,0,
Canadian,U.S. Senate,Eric Mccray,REP,90502,0,0,0,0,
Canadian,U.S. Senate,Kevin Crow,REP,90502,0,0,0,0,
Canadian,U.S. Senate,James Lankford,REP,90502,1,5,57,63,
Canadian,U.S. Senate,Jason Weger,REP,90502,0,0,1,1,
Canadian,U.S. House,Timothy Ray Murray,REP,90502,0,0,3,3,03
Canadian,U.S. House,Robert Hubbard,REP,90502,0,0,10,10,03
Canadian,U.S. House,Frank Lucas,REP,90502,1,5,72,78,03
Canadian,Superintendent of Public Instruction,John Cox,DEM,90503,0,0,6,6,
Canadian,Superintendent of Public Instruction,Jack Jr.,DEM,90503,0,0,3,3,
Canadian,Superintendent of Public Instruction,Ivan Holmes,DEM,90503,0,0,0,0,
Canadian,Superintendent of Public Instruction,Freda Deskin,DEM,90503,1,0,2,3,
Canadian,U.S. Senate,Patrick Michael Hayes,DEM,90503,0,0,2,2,
Canadian,U.S. Senate,Jim Rogers,DEM,90503,0,0,8,8,
Canadian,U.S. Senate,Connie Johnson,DEM,90503,1,0,1,2,
Canadian,Governor,Dax Ewbank,REP,90503,2,4,8,14,
Canadian,Governor,Chad Moody,REP,90503,0,0,12,12,
Canadian,Governor,Mary Fallin,REP,90503,3,2,74,79,
Canadian,Superintendent of Public Instruction,Brian Kelly,REP,90503,2,0,24,26,
Canadian,Superintendent of Public Instruction,Janet Costello Barresi,REP,90503,1,2,11,14,
Canadian,Superintendent of Public Instruction,Joy Hofmeister,REP,90503,1,2,56,59,
Canadian,Insurance Commissioner,Bill Viner,REP,90503,2,5,19,26,
Canadian,Insurance Commissioner,John Doak,REP,90503,3,0,63,66,
Canadian,Corporation Commissioner,Todd Hiett,REP,90503,2,0,46,48,
Canadian,Corporation Commissioner,Cliff Branan,REP,90503,2,5,38,45,
Canadian,U.S. Senate,Evelyn Rogers,REP,90503,0,0,3,3,
Canadian,U.S. Senate,Rob Moye,REP,90503,0,0,0,0,
Canadian,U.S. Senate,D. Jean Mcbride-Samuels,REP,90503,0,0,1,1,
Canadian,U.S. Senate,Jim Inhofe,REP,90503,3,1,86,90,
Canadian,U.S. Senate,Erick Paul Wyatt,REP,90503,2,4,2,8,
Canadian,U.S. Senate,Andy Craig,REP,90503,1,0,0,1,
Canadian,U.S. Senate,T. Shannon,REP,90503,0,4,29,33,
Canadian,U.S. Senate,Randy Brogdon,REP,90503,0,0,4,4,
Canadian,U.S. Senate,Eric Mccray,REP,90503,0,0,0,0,
Canadian,U.S. Senate,Kevin Crow,REP,90503,1,0,1,2,
Canadian,U.S. Senate,James Lankford,REP,90503,3,2,60,65,
Canadian,U.S. Senate,Jason Weger,REP,90503,0,0,0,0,
Canadian,U.S. House,Timothy Ray Murray,REP,90503,0,0,1,1,03
Canadian,U.S. House,Robert Hubbard,REP,90503,2,0,24,26,03
Canadian,U.S. House,Frank Lucas,REP,90503,3,4,66,73,03
Canadian,State Senate,Mark Thomas,REP,90503,0,0,21,21,22
Canadian,State Senate,Leif Francel,REP,90503,4,4,44,52,22
Canadian,State Senate,Stephanie Bice,REP,90503,2,2,24,28,22
Canadian,Superintendent of Public Instruction,John Cox,DEM,90504,0,1,39,40,
Canadian,Superintendent of Public Instruction,Jack Jr.,DEM,90504,0,0,11,11,
Canadian,Superintendent of Public Instruction,Ivan Holmes,DEM,90504,0,0,8,8,
Canadian,Superintendent of Public Instruction,Freda Deskin,DEM,90504,0,0,41,41,
Canadian,U.S. Senate,Patrick Michael Hayes,DEM,90504,0,0,20,20,
Canadian,U.S. Senate,Jim Rogers,DEM,90504,0,1,29,30,
Canadian,U.S. Senate,Connie Johnson,DEM,90504,0,0,45,45,
Canadian,Governor,Dax Ewbank,REP,90504,1,1,72,74,
Canadian,Governor,Chad Moody,REP,90504,0,1,75,76,
Canadian,Governor,Mary Fallin,REP,90504,11,5,403,419,
Canadian,Superintendent of Public Instruction,Brian Kelly,REP,90504,2,3,140,145,
Canadian,Superintendent of Public Instruction,Janet Costello Barresi,REP,90504,2,1,103,106,
Canadian,Superintendent of Public Instruction,Joy Hofmeister,REP,90504,5,3,306,314,
Canadian,Insurance Commissioner,Bill Viner,REP,90504,3,2,103,108,
Canadian,Insurance Commissioner,John Doak,REP,90504,7,4,424,435,
Canadian,Corporation Commissioner,Todd Hiett,REP,90504,10,4,259,273,
Canadian,Corporation Commissioner,Cliff Branan,REP,90504,0,2,264,266,
Canadian,U.S. Senate,Evelyn Rogers,REP,90504,0,1,18,19,
Canadian,U.S. Senate,Rob Moye,REP,90504,0,0,14,14,
Canadian,U.S. Senate,D. Jean Mcbride-Samuels,REP,90504,0,0,7,7,
Canadian,U.S. Senate,Jim Inhofe,REP,90504,12,5,483,500,
Canadian,U.S. Senate,Erick Paul Wyatt,REP,90504,0,1,20,21,
Canadian,U.S. Senate,Andy Craig,REP,90504,0,0,3,3,
Canadian,U.S. Senate,T. Shannon,REP,90504,3,3,156,162,
Canadian,U.S. Senate,Randy Brogdon,REP,90504,1,2,24,27,
Canadian,U.S. Senate,Eric Mccray,REP,90504,0,0,1,1,
Canadian,U.S. Senate,Kevin Crow,REP,90504,0,0,4,4,
Canadian,U.S. Senate,James Lankford,REP,90504,8,2,361,371,
Canadian,U.S. Senate,Jason Weger,REP,90504,0,0,5,5,
Canadian,U.S. House,Timothy Ray Murray,REP,90504,0,0,26,26,03
Canadian,U.S. House,Robert Hubbard,REP,90504,3,1,121,125,03
Canadian,U.S. House,Frank Lucas,REP,90504,9,5,400,414,03
Canadian,State Senate,Mark Thomas,REP,90504,5,1,103,109,22
Canadian,State Senate,Leif Francel,REP,90504,7,5,349,361,22
Canadian,State Senate,Stephanie Bice,REP,90504,0,0,93,93,22
Canadian,State House,Ross Vanhooser,REP,90504,2,2,170,174,41
Canadian,State House,John Enns,REP,90504,8,5,360,373,41
Canadian,Superintendent of Public Instruction,John Cox,DEM,90506,0,0,32,32,
Canadian,Superintendent of Public Instruction,Jack Jr.,DEM,90506,0,0,9,9,
Canadian,Superintendent of Public Instruction,Ivan Holmes,DEM,90506,0,0,6,6,
Canadian,Superintendent of Public Instruction,Freda Deskin,DEM,90506,1,1,33,35,
Canadian,U.S. Senate,Patrick Michael Hayes,DEM,90506,0,0,15,15,
Canadian,U.S. Senate,Jim Rogers,DEM,90506,1,0,23,24,
Canadian,U.S. Senate,Connie Johnson,DEM,90506,0,1,41,42,
Canadian,Governor,Dax Ewbank,REP,90506,3,1,55,59,
Canadian,Governor,Chad Moody,REP,90506,0,1,92,93,
Canadian,Governor,Mary Fallin,REP,90506,11,7,415,433,
Canadian,Superintendent of Public Instruction,Brian Kelly,REP,90506,2,2,114,118,
Canadian,Superintendent of Public Instruction,Janet Costello Barresi,REP,90506,5,1,116,122,
Canadian,Superintendent of Public Instruction,Joy Hofmeister,REP,90506,7,5,322,334,
Canadian,Insurance Commissioner,Bill Viner,REP,90506,2,2,102,106,
Canadian,Insurance Commissioner,John Doak,REP,90506,11,6,411,428,
Canadian,Corporation Commissioner,Todd Hiett,REP,90506,5,5,233,243,
Canadian,Corporation Commissioner,Cliff Branan,REP,90506,8,3,268,279,
Canadian,U.S. Senate,Evelyn Rogers,REP,90506,1,0,27,28,
Canadian,U.S. Senate,Rob Moye,REP,90506,0,0,9,9,
Canadian,U.S. Senate,D. Jean Mcbride-Samuels,REP,90506,0,0,8,8,
Canadian,U.S. Senate,Jim Inhofe,REP,90506,12,9,492,513,
Canadian,U.S. Senate,Erick Paul Wyatt,REP,90506,0,0,15,15,
Canadian,U.S. Senate,Andy Craig,REP,90506,0,0,3,3,
Canadian,U.S. Senate,T. Shannon,REP,90506,5,2,164,171,
Canadian,U.S. Senate,Randy Brogdon,REP,90506,0,0,15,15,
Canadian,U.S. Senate,Eric Mccray,REP,90506,0,0,1,1,
Canadian,U.S. Senate,Kevin Crow,REP,90506,0,0,0,0,
Canadian,U.S. Senate,James Lankford,REP,90506,9,7,383,399,
Canadian,U.S. Senate,Jason Weger,REP,90506,0,0,1,1,
Canadian,U.S. House,Timothy Ray Murray,REP,90506,0,0,24,24,03
Canadian,U.S. House,Robert Hubbard,REP,90506,3,1,117,121,03
Canadian,U.S. House,Frank Lucas,REP,90506,10,8,407,425,03
Canadian,State Senate,Mark Thomas,REP,90506,2,3,116,121,22
Canadian,State Senate,Leif Francel,REP,90506,7,4,267,278,22
Canadian,State Senate,Stephanie Bice,REP,90506,5,1,150,156,22
Canadian,State House,Ross Vanhooser,REP,90506,0,2,244,246,41
Canadian,State House,John Enns,REP,90506,13,6,270,289,41
Carter,Superintendent of Public Instruction,John Cox,DEM,100001,1,6,29,36,
Carter,Superintendent of Public Instruction,Jack Jr.,DEM,100001,0,0,16,16,
Carter,Superintendent of Public Instruction,Ivan Holmes,DEM,100001,0,0,5,5,
Carter,Superintendent of Public Instruction,Freda Deskin,DEM,100001,2,0,33,35,
Carter,U.S. Senate,Patrick Michael Hayes,DEM,100001,1,2,19,22,
Carter,U.S. Senate,Jim Rogers,DEM,100001,0,3,28,31,
Carter,U.S. Senate,Connie Johnson,DEM,100001,1,1,32,34,
Carter,U.S. House,Bert Smith,DEM,100001,1,5,73,79,04
Carter,U.S. House,Tae Si,DEM,100001,2,1,8,11,04
Carter,Governor,Dax Ewbank,REP,100001,0,0,6,6,
Carter,Governor,Chad Moody,REP,100001,0,1,15,16,
Carter,Governor,Mary Fallin,REP,100001,0,1,37,38,
Carter,Superintendent of Public Instruction,Brian Kelly,REP,100001,0,2,14,16,
Carter,Superintendent of Public Instruction,Janet Costello Barresi,REP,100001,0,0,10,10,
Carter,Superintendent of Public Instruction,Joy Hofmeister,REP,100001,0,0,32,32,
Carter,Insurance Commissioner,Bill Viner,REP,100001,0,1,14,15,
Carter,Insurance Commissioner,John Doak,REP,100001,0,1,35,36,
Carter,Corporation Commissioner,Todd Hiett,REP,100001,0,0,25,25,
Carter,Corporation Commissioner,Cliff Branan,REP,100001,0,2,24,26,
Carter,U.S. Senate,Evelyn Rogers,REP,100001,0,1,3,4,
Carter,U.S. Senate,Rob Moye,REP,100001,0,0,1,1,
Carter,U.S. Senate,D. Jean Mcbride-Samuels,REP,100001,0,0,3,3,
Carter,U.S. Senate,Jim Inhofe,REP,100001,0,1,50,51,
Carter,U.S. Senate,Erick Paul Wyatt,REP,100001,0,0,2,2,
Carter,U.S. Senate,Andy Craig,REP,100001,0,0,0,0,
Carter,U.S. Senate,T. Shannon,REP,100001,0,0,18,18,
Carter,U.S. Senate,Randy Brogdon,REP,100001,0,0,1,1,
Carter,U.S. Senate,Eric Mccray,REP,100001,0,0,0,0,
Carter,U.S. Senate,Kevin Crow,REP,100001,0,0,3,3,
Carter,U.S. Senate,James Lankford,REP,100001,0,2,34,36,
Carter,U.S. Senate,Jason Weger,REP,100001,0,0,0,0,
Carter,U.S. House,Anna Flatt,REP,100001,0,0,20,20,04
Carter,U.S. House,Tom Cole,REP,100001,0,2,40,42,04
Carter,Superintendent of Public Instruction,John Cox,DEM,100002,4,4,52,60,
Carter,Superintendent of Public Instruction,Jack Jr.,DEM,100002,6,1,24,31,
Carter,Superintendent of Public Instruction,Ivan Holmes,DEM,100002,0,1,9,10,
Carter,Superintendent of Public Instruction,Freda Deskin,DEM,100002,3,3,55,61,
Carter,U.S. Senate,Patrick Michael Hayes,DEM,100002,4,1,34,39,
Carter,U.S. Senate,Jim Rogers,DEM,100002,7,3,64,74,
Carter,U.S. Senate,Connie Johnson,DEM,100002,1,5,38,44,
Carter,U.S. House,Bert Smith,DEM,100002,9,5,105,119,04
Carter,U.S. House,Tae Si,DEM,100002,0,4,26,30,04
Carter,Governor,Dax Ewbank,REP,100002,0,1,11,12,
Carter,Governor,Chad Moody,REP,100002,0,3,23,26,
Carter,Governor,Mary Fallin,REP,100002,2,10,81,93,
Carter,Superintendent of Public Instruction,Brian Kelly,REP,100002,0,8,28,36,
Carter,Superintendent of Public Instruction,Janet Costello Barresi,REP,100002,0,4,30,34,
Carter,Superintendent of Public Instruction,Joy Hofmeister,REP,100002,1,2,54,57,
Carter,Insurance Commissioner,Bill Viner,REP,100002,0,2,29,31,
Carter,Insurance Commissioner,John Doak,REP,100002,1,12,77,90,
Carter,Corporation Commissioner,Todd Hiett,REP,100002,0,8,68,76,
Carter,Corporation Commissioner,Cliff Branan,REP,100002,1,6,42,49,
Carter,U.S. Senate,Evelyn Rogers,REP,100002,0,2,3,5,
Carter,U.S. Senate,Rob Moye,REP,100002,0,0,2,2,
Carter,U.S. Senate,D. Jean Mcbride-Samuels,REP,100002,0,1,1,2,
Carter,U.S. Senate,Jim Inhofe,REP,100002,3,11,103,117,
Carter,U.S. Senate,Erick Paul Wyatt,REP,100002,0,0,3,3,
Carter,U.S. Senate,Andy Craig,REP,100002,0,3,5,8,
Carter,U.S. Senate,T. Shannon,REP,100002,0,3,36,39,
Carter,U.S. Senate,Randy Brogdon,REP,100002,0,0,8,8,
Carter,U.S. Senate,Eric Mccray,REP,100002,0,1,0,1,
Carter,U.S. Senate,Kevin Crow,REP,100002,0,0,3,3,
Carter,U.S. Senate,James Lankford,REP,100002,2,5,59,66,
Carter,U.S. Senate,Jason Weger,REP,100002,0,0,2,2,
Carter,U.S. House,Anna Flatt,REP,100002,0,2,24,26,04
Carter,U.S. House,Tom Cole,REP,100002,3,12,92,107,04
Carter,Superintendent of Public Instruction,John Cox,DEM,100007,0,5,33,38,
Carter,Superintendent of Public Instruction,Jack Jr.,DEM,100007,0,0,9,9,
Carter,Superintendent of Public Instruction,Ivan Holmes,DEM,100007,0,1,1,2,
Carter,Superintendent of Public Instruction,Freda Deskin,DEM,100007,1,1,34,36,
Carter,U.S. Senate,Patrick Michael Hayes,DEM,100007,0,0,22,22,
Carter,U.S. Senate,Jim Rogers,DEM,100007,0,3,16,19,
Carter,U.S. Senate,Connie Johnson,DEM,100007,1,4,40,45,
Carter,U.S. House,Bert Smith,DEM,100007,1,4,49,54,04
Carter,U.S. House,Tae Si,DEM,100007,0,3,27,30,04
Carter,Governor,Dax Ewbank,REP,100007,0,0,0,0,
Carter,Governor,Chad Moody,REP,100007,0,0,2,2,
Carter,Governor,Mary Fallin,REP,100007,0,4,6,10,
Carter,Superintendent of Public Instruction,Brian Kelly,REP,100007,0,2,3,5,
Carter,Superintendent of Public Instruction,Janet Costello Barresi,REP,100007,0,0,0,0,
Carter,Superintendent of Public Instruction,Joy Hofmeister,REP,100007,0,2,3,5,
Carter,Insurance Commissioner,Bill Viner,REP,100007,0,2,4,6,
Carter,Insurance Commissioner,John Doak,REP,100007,0,2,2,4,
Carter,Corporation Commissioner,Todd Hiett,REP,100007,0,2,3,5,
Carter,Corporation Commissioner,Cliff Branan,REP,100007,0,2,3,5,
Carter,U.S. Senate,Evelyn Rogers,REP,100007,0,0,1,1,
Carter,U.S. Senate,Rob Moye,REP,100007,0,0,0,0,
Carter,U.S. Senate,D. Jean Mcbride-Samuels,REP,100007,0,0,0,0,
Carter,U.S. Senate,Jim Inhofe,REP,100007,0,4,6,10,
Carter,U.S. Senate,Erick Paul Wyatt,REP,100007,0,0,1,1,
Carter,U.S. Senate,Andy Craig,REP,100007,0,0,2,2,
Carter,U.S. Senate,T. Shannon,REP,100007,0,1,1,2,
Carter,U.S. Senate,Randy Brogdon,REP,100007,0,0,0,0,
Carter,U.S. Senate,Eric Mccray,REP,100007,0,1,1,2,
Carter,U.S. Senate,Kevin Crow,REP,100007,0,0,0,0,
Carter,U.S. Senate,James Lankford,REP,100007,0,2,3,5,
Carter,U.S. Senate,Jason Weger,REP,100007,0,0,0,0,
Carter,U.S. House,Anna Flatt,REP,100007,0,0,3,3,04
Carter,U.S. House,Tom Cole,REP,100007,0,4,4,8,04
Carter,Superintendent of Public Instruction,John Cox,DEM,100011,0,6,25,31,
Carter,Superintendent of Public Instruction,Jack Jr.,DEM,100011,0,1,3,4,
Carter,Superintendent of Public Instruction,Ivan Holmes,DEM,100011,1,1,6,8,
Carter,Superintendent of Public Instruction,Freda Deskin,DEM,100011,2,5,28,35,
Carter,U.S. Senate,Patrick Michael Hayes,DEM,100011,0,0,17,17,
Carter,U.S. Senate,Jim Rogers,DEM,100011,0,5,17,22,
Carter,U.S. Senate,Connie Johnson,DEM,100011,2,8,27,37,
Carter,U.S. House,Bert Smith,DEM,100011,1,7,43,51,04
Carter,U.S. House,Tae Si,DEM,100011,0,6,16,22,04
Carter,Governor,Dax Ewbank,REP,100011,0,1,3,4,
Carter,Governor,Chad Moody,REP,100011,0,1,7,8,
Carter,Governor,Mary Fallin,REP,100011,0,2,44,46,
Carter,Superintendent of Public Instruction,Brian Kelly,REP,100011,0,1,12,13,
Carter,Superintendent of Public Instruction,Janet Costello Barresi,REP,100011,0,1,12,13,
Carter,Superintendent of Public Instruction,Joy Hofmeister,REP,100011,0,2,25,27,
Carter,Insurance Commissioner,Bill Viner,REP,100011,0,0,9,9,
Carter,Insurance Commissioner,John Doak,REP,100011,0,4,32,36,
Carter,Corporation Commissioner,Todd Hiett,REP,100011,0,4,28,32,
Carter,Corporation Commissioner,Cliff Branan,REP,100011,0,0,15,15,
Carter,U.S. Senate,Evelyn Rogers,REP,100011,0,0,1,1,
Carter,U.S. Senate,Rob Moye,REP,100011,0,0,0,0,
Carter,U.S. Senate,D. Jean Mcbride-Samuels,REP,100011,0,0,0,0,
Carter,U.S. Senate,Jim Inhofe,REP,100011,0,4,47,51,
Carter,U.S. Senate,Erick Paul Wyatt,REP,100011,0,0,2,2,
Carter,U.S. Senate,Andy Craig,REP,100011,0,0,2,2,
Carter,U.S. Senate,T. Shannon,REP,100011,0,1,19,20,
Carter,U.S. Senate,Randy Brogdon,REP,100011,0,0,0,0,
Carter,U.S. Senate,Eric Mccray,REP,100011,0,0,0,0,
Carter,U.S. Senate,Kevin Crow,REP,100011,0,0,2,2,
Carter,U.S. Senate,James Lankford,REP,100011,0,3,27,30,
Carter,U.S. Senate,Jason Weger,REP,100011,0,0,1,1,
Carter,U.S. House,Anna Flatt,REP,100011,0,0,9,9,04
Carter,U.S. House,Tom Cole,REP,100011,0,4,44,48,04
Carter,Superintendent of Public Instruction,John Cox,DEM,100014,2,0,24,26,
Carter,Superintendent of Public Instruction,Jack Jr.,DEM,100014,2,1,19,22,
Carter,Superintendent of Public Instruction,Ivan Holmes,DEM,100014,0,0,2,2,
Carter,Superintendent of Public Instruction,Freda Deskin,DEM,100014,3,2,26,31,
Carter,U.S. Senate,Patrick Michael Hayes,DEM,100014,3,1,18,22,
Carter,U.S. Senate,Jim Rogers,DEM,100014,3,0,29,32,
Carter,U.S. Senate,Connie Johnson,DEM,100014,3,2,24,29,
Carter,U.S. House,Bert Smith,DEM,100014,5,3,57,65,04
Carter,U.S. House,Tae Si,DEM,100014,3,0,11,14,04
Carter,Governor,Dax Ewbank,REP,100014,0,4,6,10,
Carter,Governor,Chad Moody,REP,100014,1,2,12,15,
Carter,Governor,Mary Fallin,REP,100014,4,3,30,37,
Carter,Superintendent of Public Instruction,Brian Kelly,REP,100014,0,1,18,19,
Carter,Superintendent of Public Instruction,Janet Costello Barresi,REP,100014,3,2,7,12,
Carter,Superintendent of Public Instruction,Joy Hofmeister,REP,100014,1,6,20,27,
Carter,Insurance Commissioner,Bill Viner,REP,100014,0,2,13,15,
Carter,Insurance Commissioner,John Doak,REP,100014,4,6,31,41,
Carter,Corporation Commissioner,Todd Hiett,REP,100014,3,7,26,36,
Carter,Corporation Commissioner,Cliff Branan,REP,100014,1,2,18,21,
Carter,U.S. Senate,Evelyn Rogers,REP,100014,0,1,5,6,
Carter,U.S. Senate,Rob Moye,REP,100014,0,0,1,1,
Carter,U.S. Senate,D. Jean Mcbride-Samuels,REP,100014,0,0,2,2,
Carter,U.S. Senate,Jim Inhofe,REP,100014,4,8,36,48,
Carter,U.S. Senate,Erick Paul Wyatt,REP,100014,0,0,5,5,
Carter,U.S. Senate,Andy Craig,REP,100014,0,1,2,3,
Carter,U.S. Senate,T. Shannon,REP,100014,0,0,17,17,
Carter,U.S. Senate,Randy Brogdon,REP,100014,0,0,2,2,
Carter,U.S. Senate,Eric Mccray,REP,100014,0,0,1,1,
Carter,U.S. Senate,Kevin Crow,REP,100014,0,0,2,2,
Carter,U.S. Senate,James Lankford,REP,100014,4,8,23,35,
Carter,U.S. Senate,Jason Weger,REP,100014,0,0,2,2,
Carter,U.S. House,Anna Flatt,REP,100014,1,0,10,11,04
Carter,U.S. House,Tom Cole,REP,100014,4,8,40,52,04
Carter,Superintendent of Public Instruction,John Cox,DEM,100015,9,5,50,64,
Carter,Superintendent of Public Instruction,Jack Jr.,DEM,100015,0,6,26,32,
Carter,Superintendent of Public Instruction,Ivan Holmes,DEM,100015,2,1,10,13,
Carter,Superintendent of Public Instruction,Freda Deskin,DEM,100015,2,4,76,82,
Carter,U.S. Senate,Patrick Michael Hayes,DEM,100015,8,5,40,53,
Carter,U.S. Senate,Jim Rogers,DEM,100015,5,7,64,76,
Carter,U.S. Senate,Connie Johnson,DEM,100015,1,3,51,55,
Carter,U.S. House,Bert Smith,DEM,100015,13,15,125,153,04
Carter,U.S. House,Tae Si,DEM,100015,1,0,24,25,04
Carter,Governor,Dax Ewbank,REP,100015,0,0,8,8,
Carter,Governor,Chad Moody,REP,100015,0,1,10,11,
Carter,Governor,Mary Fallin,REP,100015,2,5,68,75,
Carter,Superintendent of Public Instruction,Brian Kelly,REP,100015,0,4,30,34,
Carter,Superintendent of Public Instruction,Janet Costello Barresi,REP,100015,1,0,20,21,
Carter,Superintendent of Public Instruction,Joy Hofmeister,REP,100015,1,2,31,34,
Carter,Insurance Commissioner,Bill Viner,REP,100015,0,2,22,24,
Carter,Insurance Commissioner,John Doak,REP,100015,2,4,57,63,
Carter,Corporation Commissioner,Todd Hiett,REP,100015,1,5,33,39,
Carter,Corporation Commissioner,Cliff Branan,REP,100015,1,1,45,47,
Carter,U.S. Senate,Evelyn Rogers,REP,100015,0,0,4,4,
Carter,U.S. Senate,Rob Moye,REP,100015,0,0,2,2,
Carter,U.S. Senate,D. Jean Mcbride-Samuels,REP,100015,0,0,1,1,
Carter,U.S. Senate,Jim Inhofe,REP,100015,2,6,75,83,
Carter,U.S. Senate,Erick Paul Wyatt,REP,100015,0,0,6,6,
Carter,U.S. Senate,Andy Craig,REP,100015,0,0,1,1,
Carter,U.S. Senate,T. Shannon,REP,100015,2,3,30,35,
Carter,U.S. Senate,Randy Brogdon,REP,100015,0,0,2,2,
Carter,U.S. Senate,Eric Mccray,REP,100015,0,0,1,1,
Carter,U.S. Senate,Kevin Crow,REP,100015,0,1,4,5,
Carter,U.S. Senate,James Lankford,REP,100015,0,2,42,44,
Carter,U.S. Senate,Jason Weger,REP,100015,0,0,2,2,
Carter,U.S. House,Anna Flatt,REP,100015,0,0,20,20,04
Carter,U.S. House,Tom Cole,REP,100015,2,6,65,73,04
Carter,Superintendent of Public Instruction,John Cox,DEM,100017,1,2,30,33,
Carter,Superintendent of Public Instruction,Jack Jr.,DEM,100017,0,1,19,20,
Carter,Superintendent of Public Instruction,Ivan Holmes,DEM,100017,0,3,7,10,
Carter,Superintendent of Public Instruction,Freda Deskin,DEM,100017,2,6,42,50,
Carter,U.S. Senate,Patrick Michael Hayes,DEM,100017,0,3,19,22,
Carter,U.S. Senate,Jim Rogers,DEM,100017,2,1,37,40,
Carter,U.S. Senate,Connie Johnson,DEM,100017,1,6,40,47,
Carter,U.S. House,Bert Smith,DEM,100017,3,9,74,86,04
Carter,U.S. House,Tae Si,DEM,100017,0,1,15,16,04
Carter,Governor,Dax Ewbank,REP,100017,1,2,7,10,
Carter,Governor,Chad Moody,REP,100017,0,0,9,9,
Carter,Governor,Mary Fallin,REP,100017,2,2,59,63,
Carter,Superintendent of Public Instruction,Brian Kelly,REP,100017,0,2,18,20,
Carter,Superintendent of Public Instruction,Janet Costello Barresi,REP,100017,2,2,13,17,
Carter,Superintendent of Public Instruction,Joy Hofmeister,REP,100017,1,0,39,40,
Carter,Insurance Commissioner,Bill Viner,REP,100017,2,0,19,21,
Carter,Insurance Commissioner,John Doak,REP,100017,1,4,43,48,
Carter,Corporation Commissioner,Todd Hiett,REP,100017,1,4,35,40,
Carter,Corporation Commissioner,Cliff Branan,REP,100017,2,0,28,30,
Carter,U.S. Senate,Evelyn Rogers,REP,100017,0,0,5,5,
Carter,U.S. Senate,Rob Moye,REP,100017,0,0,0,0,
Carter,U.S. Senate,D. Jean Mcbride-Samuels,REP,100017,0,0,1,1,
Carter,U.S. Senate,Jim Inhofe,REP,100017,3,3,64,70,
Carter,U.S. Senate,Erick Paul Wyatt,REP,100017,0,0,5,5,
Carter,U.S. Senate,Andy Craig,REP,100017,0,0,2,2,
Carter,U.S. Senate,T. Shannon,REP,100017,0,3,26,29,
Carter,U.S. Senate,Randy Brogdon,REP,100017,0,1,4,5,
Carter,U.S. Senate,Eric Mccray,REP,100017,0,0,1,1,
Carter,U.S. Senate,Kevin Crow,REP,100017,0,0,1,1,
Carter,U.S. Senate,James Lankford,REP,100017,3,0,34,37,
Carter,U.S. Senate,Jason Weger,REP,100017,0,0,1,1,
Carter,U.S. House,Anna Flatt,REP,100017,0,1,18,19,04
Carter,U.S. House,Tom Cole,REP,100017,3,3,56,62,04
Carter,Superintendent of Public Instruction,John Cox,DEM,100019,3,14,99,116,
Carter,Superintendent of Public Instruction,Jack Jr.,DEM,100019,2,5,45,52,
Carter,Superintendent of Public Instruction,Ivan Holmes,DEM,100019,0,2,18,20,
Carter,Superintendent of Public Instruction,Freda Deskin,DEM,100019,0,13,157,170,
Carter,U.S. Senate,Patrick Michael Hayes,DEM,100019,0,10,70,80,
Carter,U.S. Senate,Jim Rogers,DEM,100019,4,9,106,119,
Carter,U.S. Senate,Connie Johnson,DEM,100019,1,9,121,131,
Carter,U.S. House,Bert Smith,DEM,100019,5,26,245,276,04
Carter,U.S. House,Tae Si,DEM,100019,0,2,51,53,04
Carter,Governor,Dax Ewbank,REP,100019,0,3,24,27,
Carter,Governor,Chad Moody,REP,100019,0,8,60,68,
Carter,Governor,Mary Fallin,REP,100019,7,35,299,341,
Carter,Superintendent of Public Instruction,Brian Kelly,REP,100019,0,16,110,126,
Carter,Superintendent of Public Instruction,Janet Costello Barresi,REP,100019,3,11,93,107,
Carter,Superintendent of Public Instruction,Joy Hofmeister,REP,100019,2,19,157,178,
Carter,Insurance Commissioner,Bill Viner,REP,100019,1,12,101,114,
Carter,Insurance Commissioner,John Doak,REP,100019,3,29,221,253,
Carter,Corporation Commissioner,Todd Hiett,REP,100019,3,22,182,207,
Carter,Corporation Commissioner,Cliff Branan,REP,100019,4,19,146,169,
Carter,U.S. Senate,Evelyn Rogers,REP,100019,0,0,20,20,
Carter,U.S. Senate,Rob Moye,REP,100019,0,0,5,5,
Carter,U.S. Senate,D. Jean Mcbride-Samuels,REP,100019,0,0,5,5,
Carter,U.S. Senate,Jim Inhofe,REP,100019,8,44,330,382,
Carter,U.S. Senate,Erick Paul Wyatt,REP,100019,0,1,17,18,
Carter,U.S. Senate,Andy Craig,REP,100019,0,3,15,18,
Carter,U.S. Senate,T. Shannon,REP,100019,6,15,131,152,
Carter,U.S. Senate,Randy Brogdon,REP,100019,0,1,8,9,
Carter,U.S. Senate,Eric Mccray,REP,100019,0,0,6,6,
Carter,U.S. Senate,Kevin Crow,REP,100019,0,0,5,5,
Carter,U.S. Senate,James Lankford,REP,100019,2,25,210,237,
Carter,U.S. Senate,Jason Weger,REP,100019,0,0,1,1,
Carter,U.S. House,Anna Flatt,REP,100019,1,5,71,77,04
Carter,U.S. House,Tom Cole,REP,100019,7,41,313,361,04
Carter,Superintendent of Public Instruction,John Cox,DEM,100020,0,2,60,62,
Carter,Superintendent of Public Instruction,Jack Jr.,DEM,100020,0,1,21,22,
Carter,Superintendent of Public Instruction,Ivan Holmes,DEM,100020,0,1,8,9,
Carter,Superintendent of Public Instruction,Freda Deskin,DEM,100020,0,3,63,66,
Carter,U.S. Senate,Patrick Michael Hayes,DEM,100020,0,2,45,47,
Carter,U.S. Senate,Jim Rogers,DEM,100020,0,3,53,56,
Carter,U.S. Senate,Connie Johnson,DEM,100020,0,2,47,49,
Carter,U.S. House,Bert Smith,DEM,100020,0,6,129,135,04
Carter,U.S. House,Tae Si,DEM,100020,0,1,19,20,04
Carter,Governor,Dax Ewbank,REP,100020,0,1,13,14,
Carter,Governor,Chad Moody,REP,100020,0,0,21,21,
Carter,Governor,Mary Fallin,REP,100020,2,0,60,62,
Carter,Superintendent of Public Instruction,Brian Kelly,REP,100020,1,1,25,27,
Carter,Superintendent of Public Instruction,Janet Costello Barresi,REP,100020,0,0,17,17,
Carter,Superintendent of Public Instruction,Joy Hofmeister,REP,100020,1,0,50,51,
Carter,Insurance Commissioner,Bill Viner,REP,100020,0,0,31,31,
Carter,Insurance Commissioner,John Doak,REP,100020,1,1,55,57,
Carter,Corporation Commissioner,Todd Hiett,REP,100020,1,1,47,49,
Carter,Corporation Commissioner,Cliff Branan,REP,100020,0,0,37,37,
Carter,U.S. Senate,Evelyn Rogers,REP,100020,0,0,4,4,
Carter,U.S. Senate,Rob Moye,REP,100020,0,0,4,4,
Carter,U.S. Senate,D. Jean Mcbride-Samuels,REP,100020,0,0,3,3,
Carter,U.S. Senate,Jim Inhofe,REP,100020,2,1,72,75,
Carter,U.S. Senate,Erick Paul Wyatt,REP,100020,0,0,10,10,
Carter,U.S. Senate,Andy Craig,REP,100020,0,0,1,1,
Carter,U.S. Senate,T. Shannon,REP,100020,1,1,31,33,
Carter,U.S. Senate,Randy Brogdon,REP,100020,0,0,4,4,
Carter,U.S. Senate,Eric Mccray,REP,100020,0,0,3,3,
Carter,U.S. Senate,Kevin Crow,REP,100020,0,0,5,5,
Carter,U.S. Senate,James Lankford,REP,100020,1,1,49,51,
Carter,U.S. Senate,Jason Weger,REP,100020,0,0,1,1,
Carter,U.S. House,Anna Flatt,REP,100020,0,0,26,26,04
Carter,U.S. House,Tom Cole,REP,100020,2,2,69,73,04
Carter,Superintendent of Public Instruction,John Cox,DEM,100024,0,1,63,64,
Carter,Superintendent of Public Instruction,Jack Jr.,DEM,100024,1,1,28,30,
Carter,Superintendent of Public Instruction,Ivan Holmes,DEM,100024,1,2,12,15,
Carter,Superintendent of Public Instruction,Freda Deskin,DEM,100024,1,2,78,81,
Carter,U.S. Senate,Patrick Michael Hayes,DEM,100024,0,0,37,37,
Carter,U.S. Senate,Jim Rogers,DEM,100024,0,2,81,83,
Carter,U.S. Senate,Connie Johnson,DEM,100024,2,4,57,63,
Carter,U.S. House,Bert Smith,DEM,100024,3,5,139,147,04
Carter,U.S. House,Tae Si,DEM,100024,0,2,29,31,04
Carter,Governor,Dax Ewbank,REP,100024,3,2,14,19,
Carter,Governor,Chad Moody,REP,100024,0,2,25,27,
Carter,Governor,Mary Fallin,REP,100024,3,18,149,170,
Carter,Superintendent of Public Instruction,Brian Kelly,REP,100024,3,5,52,60,
Carter,Superintendent of Public Instruction,Janet Costello Barresi,REP,100024,3,7,62,72,
Carter,Superintendent of Public Instruction,Joy Hofmeister,REP,100024,0,8,67,75,
Carter,Insurance Commissioner,Bill Viner,REP,100024,0,3,55,58,
Carter,Insurance Commissioner,John Doak,REP,100024,4,17,111,132,
Carter,Corporation Commissioner,Todd Hiett,REP,100024,4,16,95,115,
Carter,Corporation Commissioner,Cliff Branan,REP,100024,0,5,81,86,
Carter,U.S. Senate,Evelyn Rogers,REP,100024,0,0,6,6,
Carter,U.S. Senate,Rob Moye,REP,100024,0,0,4,4,
Carter,U.S. Senate,D. Jean Mcbride-Samuels,REP,100024,0,1,2,3,
Carter,U.S. Senate,Jim Inhofe,REP,100024,5,21,166,192,
Carter,U.S. Senate,Erick Paul Wyatt,REP,100024,1,0,6,7,
Carter,U.S. Senate,Andy Craig,REP,100024,0,0,4,4,
Carter,U.S. Senate,T. Shannon,REP,100024,4,10,65,79,
Carter,U.S. Senate,Randy Brogdon,REP,100024,1,1,6,8,
Carter,U.S. Senate,Eric Mccray,REP,100024,0,0,8,8,
Carter,U.S. Senate,Kevin Crow,REP,100024,0,0,2,2,
Carter,U.S. Senate,James Lankford,REP,100024,1,10,103,114,
Carter,U.S. Senate,Jason Weger,REP,100024,0,0,2,2,
Carter,U.S. House,Anna Flatt,REP,100024,3,5,37,45,04
Carter,U.S. House,Tom Cole,REP,100024,3,17,153,173,04
Carter,Superintendent of Public Instruction,John Cox,DEM,100025,0,2,11,13,
Carter,Superintendent of Public Instruction,Jack Jr.,DEM,100025,0,0,7,7,
Carter,Superintendent of Public Instruction,Ivan Holmes,DEM,100025,0,1,2,3,
Carter,Superintendent of Public Instruction,Freda Deskin,DEM,100025,0,2,13,15,
Carter,U.S. Senate,Patrick Michael Hayes,DEM,100025,0,1,7,8,
Carter,U.S. Senate,Jim Rogers,DEM,100025,0,1,16,17,
Carter,U.S. Senate,Connie Johnson,DEM,100025,0,2,10,12,
Carter,U.S. House,Bert Smith,DEM,100025,0,3,29,32,04
Carter,U.S. House,Tae Si,DEM,100025,0,1,3,4,04
Carter,Governor,Dax Ewbank,REP,100025,0,1,2,3,
Carter,Governor,Chad Moody,REP,100025,0,0,11,11,
Carter,Governor,Mary Fallin,REP,100025,0,4,41,45,
Carter,Superintendent of Public Instruction,Brian Kelly,REP,100025,0,0,23,23,
Carter,Superintendent of Public Instruction,Janet Costello Barresi,REP,100025,0,0,4,4,
Carter,Superintendent of Public Instruction,Joy Hofmeister,REP,100025,0,5,28,33,
Carter,Insurance Commissioner,Bill Viner,REP,100025,0,1,15,16,
Carter,Insurance Commissioner,John Doak,REP,100025,0,4,39,43,
Carter,Corporation Commissioner,Todd Hiett,REP,100025,0,4,27,31,
Carter,Corporation Commissioner,Cliff Branan,REP,100025,0,1,27,28,
Carter,U.S. Senate,Evelyn Rogers,REP,100025,0,0,0,0,
Carter,U.S. Senate,Rob Moye,REP,100025,0,0,0,0,
Carter,U.S. Senate,D. Jean Mcbride-Samuels,REP,100025,0,0,1,1,
Carter,U.S. Senate,Jim Inhofe,REP,100025,0,5,50,55,
Carter,U.S. Senate,Erick Paul Wyatt,REP,100025,0,0,4,4,
Carter,U.S. Senate,Andy Craig,REP,100025,0,0,2,2,
Carter,U.S. Senate,T. Shannon,REP,100025,0,3,19,22,
Carter,U.S. Senate,Randy Brogdon,REP,100025,0,0,2,2,
Carter,U.S. Senate,Eric Mccray,REP,100025,0,0,1,1,
Carter,U.S. Senate,Kevin Crow,REP,100025,0,0,0,0,
Carter,U.S. Senate,James Lankford,REP,100025,0,2,31,33,
Carter,U.S. Senate,Jason Weger,REP,100025,0,0,0,0,
Carter,U.S. House,Anna Flatt,REP,100025,0,0,10,10,04
Carter,U.S. House,Tom Cole,REP,100025,0,5,45,50,04
Carter,State House,Tommy Hardin,REP,100025,0,5,37,42,49
Carter,State House,Kyle Reid Chatham,REP,100025,0,0,18,18,49
Carter,Superintendent of Public Instruction,John Cox,DEM,100026,2,1,12,15,
Carter,Superintendent of Public Instruction,Jack Jr.,DEM,100026,0,0,5,5,
Carter,Superintendent of Public Instruction,Ivan Holmes,DEM,100026,0,0,1,1,
Carter,Superintendent of Public Instruction,Freda Deskin,DEM,100026,0,0,16,16,
Carter,U.S. Senate,Patrick Michael Hayes,DEM,100026,0,0,7,7,
Carter,U.S. Senate,Jim Rogers,DEM,100026,0,0,14,14,
Carter,U.S. Senate,Connie Johnson,DEM,100026,2,1,11,14,
Carter,U.S. House,Bert Smith,DEM,100026,1,1,27,29,04
Carter,U.S. House,Tae Si,DEM,100026,1,0,3,4,04
Carter,Governor,Dax Ewbank,REP,100026,0,0,5,5,
Carter,Governor,Chad Moody,REP,100026,0,0,0,0,
Carter,Governor,Mary Fallin,REP,100026,1,1,19,21,
Carter,Superintendent of Public Instruction,Brian Kelly,REP,100026,0,1,6,7,
Carter,Superintendent of Public Instruction,Janet Costello Barresi,REP,100026,0,0,5,5,
Carter,Superintendent of Public Instruction,Joy Hofmeister,REP,100026,1,0,12,13,
Carter,Insurance Commissioner,Bill Viner,REP,100026,0,1,11,12,
Carter,Insurance Commissioner,John Doak,REP,100026,1,0,13,14,
Carter,Corporation Commissioner,Todd Hiett,REP,100026,0,0,14,14,
Carter,Corporation Commissioner,Cliff Branan,REP,100026,1,1,8,10,
Carter,U.S. Senate,Evelyn Rogers,REP,100026,0,0,1,1,
Carter,U.S. Senate,Rob Moye,REP,100026,0,0,1,1,
Carter,U.S. Senate,D. Jean Mcbride-Samuels,REP,100026,0,0,0,0,
Carter,U.S. Senate,Jim Inhofe,REP,100026,1,1,20,22,
Carter,U.S. Senate,Erick Paul Wyatt,REP,100026,0,0,2,2,
Carter,U.S. Senate,Andy Craig,REP,100026,0,0,1,1,
Carter,U.S. Senate,T. Shannon,REP,100026,1,0,9,10,
Carter,U.S. Senate,Randy Brogdon,REP,100026,0,0,1,1,
Carter,U.S. Senate,Eric Mccray,REP,100026,0,0,0,0,
Carter,U.S. Senate,Kevin Crow,REP,100026,0,0,0,0,
Carter,U.S. Senate,James Lankford,REP,100026,0,1,12,13,
Carter,U.S. Senate,Jason Weger,REP,100026,0,0,1,1,
Carter,U.S. House,Anna Flatt,REP,100026,0,0,4,4,04
Carter,U.S. House,Tom Cole,REP,100026,1,1,20,22,04
Carter,Superintendent of Public Instruction,John Cox,DEM,100030,0,0,17,17,
Carter,Superintendent of Public Instruction,Jack Jr.,DEM,100030,0,0,7,7,
Carter,Superintendent of Public Instruction,Ivan Holmes,DEM,100030,0,1,8,9,
Carter,Superintendent of Public Instruction,Freda Deskin,DEM,100030,0,0,17,17,
Carter,U.S. Senate,Patrick Michael Hayes,DEM,100030,0,1,13,14,
Carter,U.S. Senate,Jim Rogers,DEM,100030,0,0,13,13,
Carter,U.S. Senate,Connie Johnson,DEM,100030,0,0,19,19,
Carter,U.S. House,Bert Smith,DEM,100030,0,1,39,40,04
Carter,U.S. House,Tae Si,DEM,100030,0,0,4,4,04
Carter,Governor,Dax Ewbank,REP,100030,0,0,6,6,
Carter,Governor,Chad Moody,REP,100030,0,0,1,1,
Carter,Governor,Mary Fallin,REP,100030,0,0,17,17,
Carter,Superintendent of Public Instruction,Brian Kelly,REP,100030,0,0,9,9,
Carter,Superintendent of Public Instruction,Janet Costello Barresi,REP,100030,0,0,4,4,
Carter,Superintendent of Public Instruction,Joy Hofmeister,REP,100030,0,0,10,10,
Carter,Insurance Commissioner,Bill Viner,REP,100030,0,0,13,13,
Carter,Insurance Commissioner,John Doak,REP,100030,0,0,8,8,
Carter,Corporation Commissioner,Todd Hiett,REP,100030,0,0,12,12,
Carter,Corporation Commissioner,Cliff Branan,REP,100030,0,0,9,9,
Carter,U.S. Senate,Evelyn Rogers,REP,100030,0,0,0,0,
Carter,U.S. Senate,Rob Moye,REP,100030,0,0,0,0,
Carter,U.S. Senate,D. Jean Mcbride-Samuels,REP,100030,0,0,1,1,
Carter,U.S. Senate,Jim Inhofe,REP,100030,0,0,21,21,
Carter,U.S. Senate,Erick Paul Wyatt,REP,100030,0,0,2,2,
Carter,U.S. Senate,Andy Craig,REP,100030,0,0,3,3,
Carter,U.S. Senate,T. Shannon,REP,100030,0,0,7,7,
Carter,U.S. Senate,Randy Brogdon,REP,100030,0,0,1,1,
Carter,U.S. Senate,Eric Mccray,REP,100030,0,0,0,0,
Carter,U.S. Senate,Kevin Crow,REP,100030,0,0,0,0,
Carter,U.S. Senate,James Lankford,REP,100030,0,0,11,11,
Carter,U.S. Senate,Jason Weger,REP,100030,0,0,1,1,
Carter,U.S. House,Anna Flatt,REP,100030,0,0,7,7,04
Carter,U.S. House,Tom Cole,REP,100030,0,0,17,17,04
Carter,State House,Tommy Hardin,REP,100030,0,0,13,13,49
Carter,State House,Kyle Reid Chatham,REP,100030,0,0,10,10,49
Carter,Superintendent of Public Instruction,John Cox,DEM,100031,3,1,101,105,
Carter,Superintendent of Public Instruction,Jack Jr.,DEM,100031,0,3,37,40,
Carter,Superintendent of Public Instruction,Ivan Holmes,DEM,100031,1,1,10,12,
Carter,Superintendent of Public Instruction,Freda Deskin,DEM,100031,0,5,87,92,
Carter,U.S. Senate,Patrick Michael Hayes,DEM,100031,1,2,61,64,
Carter,U.S. Senate,Jim Rogers,DEM,100031,0,3,94,97,
Carter,U.S. Senate,Connie Johnson,DEM,100031,3,5,65,73,
Carter,U.S. House,Bert Smith,DEM,100031,3,8,205,216,04
Carter,U.S. House,Tae Si,DEM,100031,1,2,23,26,04
Carter,Governor,Dax Ewbank,REP,100031,1,2,22,25,
Carter,Governor,Chad Moody,REP,100031,0,3,29,32,
Carter,Governor,Mary Fallin,REP,100031,2,3,110,115,
Carter,Superintendent of Public Instruction,Brian Kelly,REP,100031,0,2,35,37,
Carter,Superintendent of Public Instruction,Janet Costello Barresi,REP,100031,0,1,27,28,
Carter,Superintendent of Public Instruction,Joy Hofmeister,REP,100031,3,4,92,99,
Carter,Insurance Commissioner,Bill Viner,REP,100031,1,1,41,43,
Carter,Insurance Commissioner,John Doak,REP,100031,2,5,103,110,
Carter,Corporation Commissioner,Todd Hiett,REP,100031,2,6,85,93,
Carter,Corporation Commissioner,Cliff Branan,REP,100031,1,0,59,60,
Carter,U.S. Senate,Evelyn Rogers,REP,100031,0,0,4,4,
Carter,U.S. Senate,Rob Moye,REP,100031,0,1,7,8,
Carter,U.S. Senate,D. Jean Mcbride-Samuels,REP,100031,0,0,2,2,
Carter,U.S. Senate,Jim Inhofe,REP,100031,2,6,133,141,
Carter,U.S. Senate,Erick Paul Wyatt,REP,100031,1,1,9,11,
Carter,U.S. Senate,Andy Craig,REP,100031,0,0,10,10,
Carter,U.S. Senate,T. Shannon,REP,100031,0,3,53,56,
Carter,U.S. Senate,Randy Brogdon,REP,100031,0,0,9,9,
Carter,U.S. Senate,Eric Mccray,REP,100031,0,0,6,6,
Carter,U.S. Senate,Kevin Crow,REP,100031,0,0,4,4,
Carter,U.S. Senate,James Lankford,REP,100031,3,3,70,76,
Carter,U.S. Senate,Jason Weger,REP,100031,0,0,1,1,
Carter,U.S. House,Anna Flatt,REP,100031,1,1,25,27,04
Carter,U.S. House,Tom Cole,REP,100031,2,7,139,148,04
Carter,State House,Tommy Hardin,REP,100031,1,4,86,91,49
Carter,State House,Kyle Reid Chatham,REP,100031,2,3,71,76,49
Carter,Superintendent of Public Instruction,John Cox,DEM,100032,0,2,8,10,
Carter,Superintendent of Public Instruction,Jack Jr.,DEM,100032,0,0,3,3,
Carter,Superintendent of Public Instruction,Ivan Holmes,DEM,100032,0,0,4,4,
Carter,Superintendent of Public Instruction,Freda Deskin,DEM,100032,0,3,20,23,
Carter,U.S. Senate,Patrick Michael Hayes,DEM,100032,0,0,8,8,
Carter,U.S. Senate,Jim Rogers,DEM,100032,0,4,11,15,
Carter,U.S. Senate,Connie Johnson,DEM,100032,0,1,15,16,
Carter,U.S. House,Bert Smith,DEM,100032,0,5,27,32,04
Carter,U.S. House,Tae Si,DEM,100032,0,0,4,4,04
Carter,Governor,Dax Ewbank,REP,100032,0,0,3,3,
Carter,Governor,Chad Moody,REP,100032,0,0,1,1,
Carter,Governor,Mary Fallin,REP,100032,0,0,9,9,
Carter,Superintendent of Public Instruction,Brian Kelly,REP,100032,0,0,0,0,
Carter,Superintendent of Public Instruction,Janet Costello Barresi,REP,100032,0,0,7,7,
Carter,Superintendent of Public Instruction,Joy Hofmeister,REP,100032,0,0,6,6,
Carter,Insurance Commissioner,Bill Viner,REP,100032,0,0,4,4,
Carter,Insurance Commissioner,John Doak,REP,100032,0,0,6,6,
Carter,Corporation Commissioner,Todd Hiett,REP,100032,0,0,5,5,
Carter,Corporation Commissioner,Cliff Branan,REP,100032,0,0,8,8,
Carter,U.S. Senate,Evelyn Rogers,REP,100032,0,0,2,2,
Carter,U.S. Senate,Rob Moye,REP,100032,0,0,0,0,
Carter,U.S. Senate,D. Jean Mcbride-Samuels,REP,100032,0,0,0,0,
Carter,U.S. Senate,Jim Inhofe,REP,100032,0,0,10,10,
Carter,U.S. Senate,Erick Paul Wyatt,REP,100032,0,0,1,1,
Carter,U.S. Senate,Andy Craig,REP,100032,0,0,0,0,
Carter,U.S. Senate,T. Shannon,REP,100032,0,0,7,7,
Carter,U.S. Senate,Randy Brogdon,REP,100032,0,0,1,1,
Carter,U.S. Senate,Eric Mccray,REP,100032,0,0,0,0,
Carter,U.S. Senate,Kevin Crow,REP,100032,0,0,0,0,
Carter,U.S. Senate,James Lankford,REP,100032,0,0,5,5,
Carter,U.S. Senate,Jason Weger,REP,100032,0,0,0,0,
Carter,U.S. House,Anna Flatt,REP,100032,0,0,4,4,04
Carter,U.S. House,Tom Cole,REP,100032,0,0,9,9,04
Carter,Superintendent of Public Instruction,John Cox,DEM,100033,0,1,27,28,
Carter,Superintendent of Public Instruction,Jack Jr.,DEM,100033,0,0,11,11,
Carter,Superintendent of Public Instruction,Ivan Holmes,DEM,100033,0,0,4,4,
Carter,Superintendent of Public Instruction,Freda Deskin,DEM,100033,1,3,36,40,
Carter,U.S. Senate,Patrick Michael Hayes,DEM,100033,0,0,14,14,
Carter,U.S. Senate,Jim Rogers,DEM,100033,0,1,28,29,
Carter,U.S. Senate,Connie Johnson,DEM,100033,1,3,35,39,
Carter,U.S. House,Bert Smith,DEM,100033,1,3,62,66,04
Carter,U.S. House,Tae Si,DEM,100033,0,1,10,11,04
Carter,Governor,Dax Ewbank,REP,100033,0,1,4,5,
Carter,Governor,Chad Moody,REP,100033,0,2,13,15,
Carter,Governor,Mary Fallin,REP,100033,0,2,34,36,
Carter,Superintendent of Public Instruction,Brian Kelly,REP,100033,0,1,20,21,
Carter,Superintendent of Public Instruction,Janet Costello Barresi,REP,100033,0,2,11,13,
Carter,Superintendent of Public Instruction,Joy Hofmeister,REP,100033,0,2,20,22,
Carter,Insurance Commissioner,Bill Viner,REP,100033,0,2,12,14,
Carter,Insurance Commissioner,John Doak,REP,100033,0,2,32,34,
Carter,Corporation Commissioner,Todd Hiett,REP,100033,0,3,26,29,
Carter,Corporation Commissioner,Cliff Branan,REP,100033,0,2,15,17,
Carter,U.S. Senate,Evelyn Rogers,REP,100033,0,0,3,3,
Carter,U.S. Senate,Rob Moye,REP,100033,0,0,0,0,
Carter,U.S. Senate,D. Jean Mcbride-Samuels,REP,100033,0,0,1,1,
Carter,U.S. Senate,Jim Inhofe,REP,100033,0,5,46,51,
Carter,U.S. Senate,Erick Paul Wyatt,REP,100033,0,0,2,2,
Carter,U.S. Senate,Andy Craig,REP,100033,0,0,3,3,
Carter,U.S. Senate,T. Shannon,REP,100033,0,3,16,19,
Carter,U.S. Senate,Randy Brogdon,REP,100033,0,0,1,1,
Carter,U.S. Senate,Eric Mccray,REP,100033,0,0,0,0,
Carter,U.S. Senate,Kevin Crow,REP,100033,0,0,2,2,
Carter,U.S. Senate,James Lankford,REP,100033,0,2,27,29,
Carter,U.S. Senate,Jason Weger,REP,100033,0,0,1,1,
Carter,U.S. House,Anna Flatt,REP,100033,0,0,16,16,04
Carter,U.S. House,Tom Cole,REP,100033,0,5,36,41,04
Carter,Superintendent of Public Instruction,John Cox,DEM,100034,0,3,42,45,
Carter,Superintendent of Public Instruction,Jack Jr.,DEM,100034,0,1,23,24,
Carter,Superintendent of Public Instruction,Ivan Holmes,DEM,100034,0,2,8,10,
Carter,Superintendent of Public Instruction,Freda Deskin,DEM,100034,0,1,46,47,
Carter,U.S. Senate,Patrick Michael Hayes,DEM,100034,0,2,34,36,
Carter,U.S. Senate,Jim Rogers,DEM,100034,0,2,46,48,
Carter,U.S. Senate,Connie Johnson,DEM,100034,0,3,34,37,
Carter,U.S. House,Bert Smith,DEM,100034,0,6,105,111,04
Carter,U.S. House,Tae Si,DEM,100034,0,1,11,12,04
Carter,Governor,Dax Ewbank,REP,100034,0,1,13,14,
Carter,Governor,Chad Moody,REP,100034,0,1,21,22,
Carter,Governor,Mary Fallin,REP,100034,0,5,47,52,
Carter,Superintendent of Public Instruction,Brian Kelly,REP,100034,0,1,16,17,
Carter,Superintendent of Public Instruction,Janet Costello Barresi,REP,100034,0,1,12,13,
Carter,Superintendent of Public Instruction,Joy Hofmeister,REP,100034,0,4,51,55,
Carter,Insurance Commissioner,Bill Viner,REP,100034,0,3,16,19,
Carter,Insurance Commissioner,John Doak,REP,100034,0,4,53,57,
Carter,Corporation Commissioner,Todd Hiett,REP,100034,0,4,33,37,
Carter,Corporation Commissioner,Cliff Branan,REP,100034,0,3,35,38,
Carter,U.S. Senate,Evelyn Rogers,REP,100034,0,1,3,4,
Carter,U.S. Senate,Rob Moye,REP,100034,0,1,4,5,
Carter,U.S. Senate,D. Jean Mcbride-Samuels,REP,100034,0,0,1,1,
Carter,U.S. Senate,Jim Inhofe,REP,100034,0,5,65,70,
Carter,U.S. Senate,Erick Paul Wyatt,REP,100034,0,0,5,5,
Carter,U.S. Senate,Andy Craig,REP,100034,0,1,6,7,
Carter,U.S. Senate,T. Shannon,REP,100034,0,2,26,28,
Carter,U.S. Senate,Randy Brogdon,REP,100034,0,1,5,6,
Carter,U.S. Senate,Eric Mccray,REP,100034,0,0,2,2,
Carter,U.S. Senate,Kevin Crow,REP,100034,0,2,4,6,
Carter,U.S. Senate,James Lankford,REP,100034,0,1,30,31,
Carter,U.S. Senate,Jason Weger,REP,100034,0,0,2,2,
Carter,U.S. House,Anna Flatt,REP,100034,0,1,19,20,04
Carter,U.S. House,Tom Cole,REP,100034,0,5,60,65,04
Carter,State House,Tommy Hardin,REP,100034,0,1,41,42,49
Carter,State House,Kyle Reid Chatham,REP,100034,0,6,37,43,49
Carter,Superintendent of Public Instruction,John Cox,DEM,100039,1,1,16,18,
Carter,Superintendent of Public Instruction,Jack Jr.,DEM,100039,0,0,8,8,
Carter,Superintendent of Public Instruction,Ivan Holmes,DEM,100039,0,0,1,1,
Carter,Superintendent of Public Instruction,Freda Deskin,DEM,100039,0,0,18,18,
Carter,U.S. Senate,Patrick Michael Hayes,DEM,100039,0,0,15,15,
Carter,U.S. Senate,Jim Rogers,DEM,100039,1,1,14,16,
Carter,U.S. Senate,Connie Johnson,DEM,100039,0,0,9,9,
Carter,U.S. House,Bert Smith,DEM,100039,1,1,36,38,04
Carter,U.S. House,Tae Si,DEM,100039,0,0,1,1,04
Carter,Governor,Dax Ewbank,REP,100039,0,0,5,5,
Carter,Governor,Chad Moody,REP,100039,0,0,4,4,
Carter,Governor,Mary Fallin,REP,100039,0,0,18,18,
Carter,Superintendent of Public Instruction,Brian Kelly,REP,100039,0,0,12,12,
Carter,Superintendent of Public Instruction,Janet Costello Barresi,REP,100039,0,0,1,1,
Carter,Superintendent of Public Instruction,Joy Hofmeister,REP,100039,0,0,13,13,
Carter,Insurance Commissioner,Bill Viner,REP,100039,0,0,8,8,
Carter,Insurance Commissioner,John Doak,REP,100039,0,0,16,16,
Carter,Corporation Commissioner,Todd Hiett,REP,100039,0,0,13,13,
Carter,Corporation Commissioner,Cliff Branan,REP,100039,0,0,10,10,
Carter,U.S. Senate,Evelyn Rogers,REP,100039,0,0,3,3,
Carter,U.S. Senate,Rob Moye,REP,100039,0,0,1,1,
Carter,U.S. Senate,D. Jean Mcbride-Samuels,REP,100039,0,0,0,0,
Carter,U.S. Senate,Jim Inhofe,REP,100039,0,0,22,22,
Carter,U.S. Senate,Erick Paul Wyatt,REP,100039,0,0,0,0,
Carter,U.S. Senate,Andy Craig,REP,100039,0,0,0,0,
Carter,U.S. Senate,T. Shannon,REP,100039,0,0,8,8,
Carter,U.S. Senate,Randy Brogdon,REP,100039,0,0,2,2,
Carter,U.S. Senate,Eric Mccray,REP,100039,0,0,0,0,
Carter,U.S. Senate,Kevin Crow,REP,100039,0,0,0,0,
Carter,U.S. Senate,James Lankford,REP,100039,0,0,13,13,
Carter,U.S. Senate,Jason Weger,REP,100039,0,0,1,1,
Carter,U.S. House,Anna Flatt,REP,100039,0,0,4,4,04
Carter,U.S. House,Tom Cole,REP,100039,0,0,21,21,04
Carter,Superintendent of Public Instruction,John Cox,DEM,100041,0,0,76,76,
Carter,Superintendent of Public Instruction,Jack Jr.,DEM,100041,0,1,29,30,
Carter,Superintendent of Public Instruction,Ivan Holmes,DEM,100041,0,0,11,11,
Carter,Superintendent of Public Instruction,Freda Deskin,DEM,100041,1,0,73,74,
Carter,U.S. Senate,Patrick Michael Hayes,DEM,100041,0,0,53,53,
Carter,U.S. Senate,Jim Rogers,DEM,100041,0,1,82,83,
Carter,U.S. Senate,Connie Johnson,DEM,100041,1,0,47,48,
Carter,U.S. House,Bert Smith,DEM,100041,0,1,164,165,04
Carter,U.S. House,Tae Si,DEM,100041,0,0,15,15,04
Carter,Governor,Dax Ewbank,REP,100041,0,0,11,11,
Carter,Governor,Chad Moody,REP,100041,0,0,27,27,
Carter,Governor,Mary Fallin,REP,100041,4,0,68,72,
Carter,Superintendent of Public Instruction,Brian Kelly,REP,100041,1,0,28,29,
Carter,Superintendent of Public Instruction,Janet Costello Barresi,REP,100041,2,0,12,14,
Carter,Superintendent of Public Instruction,Joy Hofmeister,REP,100041,1,0,64,65,
Carter,Insurance Commissioner,Bill Viner,REP,100041,1,0,25,26,
Carter,Insurance Commissioner,John Doak,REP,100041,3,0,72,75,
Carter,Corporation Commissioner,Todd Hiett,REP,100041,2,0,43,45,
Carter,Corporation Commissioner,Cliff Branan,REP,100041,2,0,54,56,
Carter,U.S. Senate,Evelyn Rogers,REP,100041,0,0,4,4,
Carter,U.S. Senate,Rob Moye,REP,100041,0,0,4,4,
Carter,U.S. Senate,D. Jean Mcbride-Samuels,REP,100041,0,0,2,2,
Carter,U.S. Senate,Jim Inhofe,REP,100041,4,0,86,90,
Carter,U.S. Senate,Erick Paul Wyatt,REP,100041,0,0,7,7,
Carter,U.S. Senate,Andy Craig,REP,100041,0,0,3,3,
Carter,U.S. Senate,T. Shannon,REP,100041,0,0,38,38,
Carter,U.S. Senate,Randy Brogdon,REP,100041,0,0,3,3,
Carter,U.S. Senate,Eric Mccray,REP,100041,0,0,1,1,
Carter,U.S. Senate,Kevin Crow,REP,100041,0,0,9,9,
Carter,U.S. Senate,James Lankford,REP,100041,4,0,47,51,
Carter,U.S. Senate,Jason Weger,REP,100041,0,0,2,2,
Carter,U.S. House,Anna Flatt,REP,100041,0,0,15,15,04
Carter,U.S. House,Tom Cole,REP,100041,4,0,89,93,04
Carter,Superintendent of Public Instruction,John Cox,DEM,100051,0,0,14,14,
Carter,Superintendent of Public Instruction,Jack Jr.,DEM,100051,0,0,11,11,
Carter,Superintendent of Public Instruction,Ivan Holmes,DEM,100051,0,0,2,2,
Carter,Superintendent of Public Instruction,Freda Deskin,DEM,100051,0,0,18,18,
Carter,U.S. Senate,Patrick Michael Hayes,DEM,100051,0,0,9,9,
Carter,U.S. Senate,Jim Rogers,DEM,100051,0,0,20,20,
Carter,U.S. Senate,Connie Johnson,DEM,100051,0,0,13,13,
Carter,U.S. House,Bert Smith,DEM,100051,0,0,37,37,04
Carter,U.S. House,Tae Si,DEM,100051,0,0,5,5,04
Carter,Governor,Dax Ewbank,REP,100051,0,0,5,5,
Carter,Governor,Chad Moody,REP,100051,0,0,5,5,
Carter,Governor,Mary Fallin,REP,100051,0,0,15,15,
Carter,Superintendent of Public Instruction,Brian Kelly,REP,100051,0,0,8,8,
Carter,Superintendent of Public Instruction,Janet Costello Barresi,REP,100051,0,0,2,2,
Carter,Superintendent of Public Instruction,Joy Hofmeister,REP,100051,0,0,14,14,
Carter,Insurance Commissioner,Bill Viner,REP,100051,0,0,13,13,
Carter,Insurance Commissioner,John Doak,REP,100051,0,0,9,9,
Carter,Corporation Commissioner,Todd Hiett,REP,100051,0,0,14,14,
Carter,Corporation Commissioner,Cliff Branan,REP,100051,0,0,7,7,
Carter,U.S. Senate,Evelyn Rogers,REP,100051,0,0,1,1,
Carter,U.S. Senate,Rob Moye,REP,100051,0,0,3,3,
Carter,U.S. Senate,D. Jean Mcbride-Samuels,REP,100051,0,0,1,1,
Carter,U.S. Senate,Jim Inhofe,REP,100051,0,0,16,16,
Carter,U.S. Senate,Erick Paul Wyatt,REP,100051,0,0,3,3,
Carter,U.S. Senate,Andy Craig,REP,100051,0,0,5,5,
Carter,U.S. Senate,T. Shannon,REP,100051,0,0,9,9,
Carter,U.S. Senate,Randy Brogdon,REP,100051,0,0,2,2,
Carter,U.S. Senate,Eric Mccray,REP,100051,0,0,0,0,
Carter,U.S. Senate,Kevin Crow,REP,100051,0,0,1,1,
Carter,U.S. Senate,James Lankford,REP,100051,0,0,8,8,
Carter,U.S. Senate,Jason Weger,REP,100051,0,0,0,0,
Carter,U.S. House,Anna Flatt,REP,100051,0,0,5,5,04
Carter,U.S. House,Tom Cole,REP,100051,0,0,18,18,04
Carter,Superintendent of Public Instruction,John Cox,DEM,100052,0,1,24,25,
Carter,Superintendent of Public Instruction,Jack Jr.,DEM,100052,0,1,6,7,
Carter,Superintendent of Public Instruction,Ivan Holmes,DEM,100052,0,1,6,7,
Carter,Superintendent of Public Instruction,Freda Deskin,DEM,100052,0,0,20,20,
Carter,U.S. Senate,Patrick Michael Hayes,DEM,100052,0,0,13,13,
Carter,U.S. Senate,Jim Rogers,DEM,100052,0,2,27,29,
Carter,U.S. Senate,Connie Johnson,DEM,100052,0,1,15,16,
Carter,U.S. House,Bert Smith,DEM,100052,0,3,53,56,04
Carter,U.S. House,Tae Si,DEM,100052,0,0,2,2,04
Carter,Governor,Dax Ewbank,REP,100052,0,0,8,8,
Carter,Governor,Chad Moody,REP,100052,0,2,5,7,
Carter,Governor,Mary Fallin,REP,100052,0,0,26,26,
Carter,Superintendent of Public Instruction,Brian Kelly,REP,100052,0,1,8,9,
Carter,Superintendent of Public Instruction,Janet Costello Barresi,REP,100052,0,0,9,9,
Carter,Superintendent of Public Instruction,Joy Hofmeister,REP,100052,0,1,22,23,
Carter,Insurance Commissioner,Bill Viner,REP,100052,0,2,6,8,
Carter,Insurance Commissioner,John Doak,REP,100052,0,0,30,30,
Carter,Corporation Commissioner,Todd Hiett,REP,100052,0,2,19,21,
Carter,Corporation Commissioner,Cliff Branan,REP,100052,0,0,14,14,
Carter,U.S. Senate,Evelyn Rogers,REP,100052,0,0,4,4,
Carter,U.S. Senate,Rob Moye,REP,100052,0,0,1,1,
Carter,U.S. Senate,D. Jean Mcbride-Samuels,REP,100052,0,0,0,0,
Carter,U.S. Senate,Jim Inhofe,REP,100052,0,2,32,34,
Carter,U.S. Senate,Erick Paul Wyatt,REP,100052,0,0,2,2,
Carter,U.S. Senate,Andy Craig,REP,100052,0,0,0,0,
Carter,U.S. Senate,T. Shannon,REP,100052,0,1,14,15,
Carter,U.S. Senate,Randy Brogdon,REP,100052,0,0,0,0,
Carter,U.S. Senate,Eric Mccray,REP,100052,0,0,0,0,
Carter,U.S. Senate,Kevin Crow,REP,100052,0,0,2,2,
Carter,U.S. Senate,James Lankford,REP,100052,0,1,19,20,
Carter,U.S. Senate,Jason Weger,REP,100052,0,0,1,1,
Carter,U.S. House,Anna Flatt,REP,100052,0,1,7,8,04
Carter,U.S. House,Tom Cole,REP,100052,0,1,31,32,04
Carter,Superintendent of Public Instruction,John Cox,DEM,100061,0,1,22,23,
Carter,Superintendent of Public Instruction,Jack Jr.,DEM,100061,0,1,7,8,
Carter,Superintendent of Public Instruction,Ivan Holmes,DEM,100061,0,0,4,4,
Carter,Superintendent of Public Instruction,Freda Deskin,DEM,100061,0,0,15,15,
Carter,U.S. Senate,Patrick Michael Hayes,DEM,100061,0,0,14,14,
Carter,U.S. Senate,Jim Rogers,DEM,100061,0,1,21,22,
Carter,U.S. Senate,Connie Johnson,DEM,100061,0,1,11,12,
Carter,U.S. House,Bert Smith,DEM,100061,0,1,38,39,04
Carter,U.S. House,Tae Si,DEM,100061,0,1,6,7,04
Carter,Governor,Dax Ewbank,REP,100061,0,0,12,12,
Carter,Governor,Chad Moody,REP,100061,0,0,5,5,
Carter,Governor,Mary Fallin,REP,100061,0,6,45,51,
Carter,Superintendent of Public Instruction,Brian Kelly,REP,100061,0,2,19,21,
Carter,Superintendent of Public Instruction,Janet Costello Barresi,REP,100061,0,1,9,10,
Carter,Superintendent of Public Instruction,Joy Hofmeister,REP,100061,0,2,32,34,
Carter,Insurance Commissioner,Bill Viner,REP,100061,0,2,18,20,
Carter,Insurance Commissioner,John Doak,REP,100061,0,4,38,42,
Carter,Corporation Commissioner,Todd Hiett,REP,100061,0,2,38,40,
Carter,Corporation Commissioner,Cliff Branan,REP,100061,0,4,17,21,
Carter,U.S. Senate,Evelyn Rogers,REP,100061,0,0,2,2,
Carter,U.S. Senate,Rob Moye,REP,100061,0,0,1,1,
Carter,U.S. Senate,D. Jean Mcbride-Samuels,REP,100061,0,0,1,1,
Carter,U.S. Senate,Jim Inhofe,REP,100061,0,6,54,60,
Carter,U.S. Senate,Erick Paul Wyatt,REP,100061,0,0,4,4,
Carter,U.S. Senate,Andy Craig,REP,100061,0,0,4,4,
Carter,U.S. Senate,T. Shannon,REP,100061,0,4,26,30,
Carter,U.S. Senate,Randy Brogdon,REP,100061,0,0,3,3,
Carter,U.S. Senate,Eric Mccray,REP,100061,0,0,0,0,
Carter,U.S. Senate,Kevin Crow,REP,100061,0,0,1,1,
Carter,U.S. Senate,James Lankford,REP,100061,0,2,25,27,
Carter,U.S. Senate,Jason Weger,REP,100061,0,0,2,2,
Carter,U.S. House,Anna Flatt,REP,100061,0,0,16,16,04
Carter,U.S. House,Tom Cole,REP,100061,0,6,47,53,04
Carter,State House,Tommy Hardin,REP,100061,0,4,34,38,49
Carter,State House,Kyle Reid Chatham,REP,100061,0,0,29,29,49
Carter,Superintendent of Public Instruction,John Cox,DEM,100062,1,6,36,43,
Carter,Superintendent of Public Instruction,Jack Jr.,DEM,100062,0,3,25,28,
Carter,Superintendent of Public Instruction,Ivan Holmes,DEM,100062,0,0,4,4,
Carter,Superintendent of Public Instruction,Freda Deskin,DEM,100062,0,2,42,44,
Carter,U.S. Senate,Patrick Michael Hayes,DEM,100062,0,5,28,33,
Carter,U.S. Senate,Jim Rogers,DEM,100062,0,6,41,47,
Carter,U.S. Senate,Connie Johnson,DEM,100062,1,0,34,35,
Carter,U.S. House,Bert Smith,DEM,100062,1,12,95,108,04
Carter,U.S. House,Tae Si,DEM,100062,0,0,11,11,04
Carter,Governor,Dax Ewbank,REP,100062,0,0,5,5,
Carter,Governor,Chad Moody,REP,100062,0,0,9,9,
Carter,Governor,Mary Fallin,REP,100062,0,4,47,51,
Carter,Superintendent of Public Instruction,Brian Kelly,REP,100062,0,1,12,13,
Carter,Superintendent of Public Instruction,Janet Costello Barresi,REP,100062,0,0,14,14,
Carter,Superintendent of Public Instruction,Joy Hofmeister,REP,100062,0,3,30,33,
Carter,Insurance Commissioner,Bill Viner,REP,100062,0,0,11,11,
Carter,Insurance Commissioner,John Doak,REP,100062,0,4,41,45,
Carter,Corporation Commissioner,Todd Hiett,REP,100062,0,1,30,31,
Carter,Corporation Commissioner,Cliff Branan,REP,100062,0,3,22,25,
Carter,U.S. Senate,Evelyn Rogers,REP,100062,0,0,3,3,
Carter,U.S. Senate,Rob Moye,REP,100062,0,0,1,1,
Carter,U.S. Senate,D. Jean Mcbride-Samuels,REP,100062,0,0,0,0,
Carter,U.S. Senate,Jim Inhofe,REP,100062,0,4,51,55,
Carter,U.S. Senate,Erick Paul Wyatt,REP,100062,0,0,2,2,
Carter,U.S. Senate,Andy Craig,REP,100062,0,0,2,2,
Carter,U.S. Senate,T. Shannon,REP,100062,0,1,21,22,
Carter,U.S. Senate,Randy Brogdon,REP,100062,0,0,3,3,
Carter,U.S. Senate,Eric Mccray,REP,100062,0,0,0,0,
Carter,U.S. Senate,Kevin Crow,REP,100062,0,0,4,4,
Carter,U.S. Senate,James Lankford,REP,100062,0,3,29,32,
Carter,U.S. Senate,Jason Weger,REP,100062,0,0,1,1,
Carter,U.S. House,Anna Flatt,REP,100062,0,0,16,16,04
Carter,U.S. House,Tom Cole,REP,100062,0,4,43,47,04
Carter,State House,Tommy Hardin,REP,100062,0,3,35,38,49
Carter,State House,Kyle Reid Chatham,REP,100062,0,1,23,24,49
Carter,Superintendent of Public Instruction,John Cox,DEM,100063,0,1,47,48,
Carter,Superintendent of Public Instruction,Jack Jr.,DEM,100063,0,1,27,28,
Carter,Superintendent of Public Instruction,Ivan Holmes,DEM,100063,0,0,3,3,
Carter,Superintendent of Public Instruction,Freda Deskin,DEM,100063,0,1,48,49,
Carter,U.S. Senate,Patrick Michael Hayes,DEM,100063,0,0,37,37,
Carter,U.S. Senate,Jim Rogers,DEM,100063,0,1,55,56,
Carter,U.S. Senate,Connie Johnson,DEM,100063,0,2,30,32,
Carter,U.S. House,Bert Smith,DEM,100063,0,2,107,109,04
Carter,U.S. House,Tae Si,DEM,100063,0,1,9,10,04
Carter,Governor,Dax Ewbank,REP,100063,0,2,9,11,
Carter,Governor,Chad Moody,REP,100063,0,1,16,17,
Carter,Governor,Mary Fallin,REP,100063,1,0,70,71,
Carter,Superintendent of Public Instruction,Brian Kelly,REP,100063,0,2,23,25,
Carter,Superintendent of Public Instruction,Janet Costello Barresi,REP,100063,1,0,19,20,
Carter,Superintendent of Public Instruction,Joy Hofmeister,REP,100063,0,1,47,48,
Carter,Insurance Commissioner,Bill Viner,REP,100063,1,1,24,26,
Carter,Insurance Commissioner,John Doak,REP,100063,0,1,63,64,
Carter,Corporation Commissioner,Todd Hiett,REP,100063,1,0,46,47,
Carter,Corporation Commissioner,Cliff Branan,REP,100063,0,2,36,38,
Carter,U.S. Senate,Evelyn Rogers,REP,100063,0,0,1,1,
Carter,U.S. Senate,Rob Moye,REP,100063,0,1,2,3,
Carter,U.S. Senate,D. Jean Mcbride-Samuels,REP,100063,0,0,2,2,
Carter,U.S. Senate,Jim Inhofe,REP,100063,1,1,80,82,
Carter,U.S. Senate,Erick Paul Wyatt,REP,100063,0,1,9,10,
Carter,U.S. Senate,Andy Craig,REP,100063,0,0,2,2,
Carter,U.S. Senate,T. Shannon,REP,100063,1,1,31,33,
Carter,U.S. Senate,Randy Brogdon,REP,100063,0,0,8,8,
Carter,U.S. Senate,Eric Mccray,REP,100063,0,0,2,2,
Carter,U.S. Senate,Kevin Crow,REP,100063,0,1,2,3,
Carter,U.S. Senate,James Lankford,REP,100063,0,1,46,47,
Carter,U.S. Senate,Jason Weger,REP,100063,0,0,3,3,
Carter,U.S. House,Anna Flatt,REP,100063,0,2,25,27,04
Carter,U.S. House,Tom Cole,REP,100063,1,1,71,73,04
Carter,State House,Tommy Hardin,REP,100063,1,1,66,68,49
Carter,State House,Kyle Reid Chatham,REP,100063,0,2,25,27,49
Carter,Superintendent of Public Instruction,John Cox,DEM,100071,5,0,68,73,
Carter,Superintendent of Public Instruction,Jack Jr.,DEM,100071,0,0,16,16,
Carter,Superintendent of Public Instruction,Ivan Holmes,DEM,100071,1,0,7,8,
Carter,Superintendent of Public Instruction,Freda Deskin,DEM,100071,2,2,45,49,
Carter,U.S. Senate,Patrick Michael Hayes,DEM,100071,2,0,44,46,
Carter,U.S. Senate,Jim Rogers,DEM,100071,3,2,47,52,
Carter,U.S. Senate,Connie Johnson,DEM,100071,3,0,41,44,
Carter,U.S. House,Bert Smith,DEM,100071,7,2,110,119,04
Carter,U.S. House,Tae Si,DEM,100071,1,0,16,17,04
Carter,Governor,Dax Ewbank,REP,100071,0,1,9,10,
Carter,Governor,Chad Moody,REP,100071,0,1,18,19,
Carter,Governor,Mary Fallin,REP,100071,1,0,28,29,
Carter,Superintendent of Public Instruction,Brian Kelly,REP,100071,0,0,17,17,
Carter,Superintendent of Public Instruction,Janet Costello Barresi,REP,100071,0,0,13,13,
Carter,Superintendent of Public Instruction,Joy Hofmeister,REP,100071,1,2,25,28,
Carter,Insurance Commissioner,Bill Viner,REP,100071,0,0,17,17,
Carter,Insurance Commissioner,John Doak,REP,100071,1,2,36,39,
Carter,Corporation Commissioner,Todd Hiett,REP,100071,0,1,28,29,
Carter,Corporation Commissioner,Cliff Branan,REP,100071,1,1,25,27,
Carter,U.S. Senate,Evelyn Rogers,REP,100071,0,0,4,4,
Carter,U.S. Senate,Rob Moye,REP,100071,0,0,2,2,
Carter,U.S. Senate,D. Jean Mcbride-Samuels,REP,100071,0,0,1,1,
Carter,U.S. Senate,Jim Inhofe,REP,100071,1,1,42,44,
Carter,U.S. Senate,Erick Paul Wyatt,REP,100071,0,1,5,6,
Carter,U.S. Senate,Andy Craig,REP,100071,0,0,2,2,
Carter,U.S. Senate,T. Shannon,REP,100071,0,0,24,24,
Carter,U.S. Senate,Randy Brogdon,REP,100071,1,1,3,5,
Carter,U.S. Senate,Eric Mccray,REP,100071,0,0,5,5,
Carter,U.S. Senate,Kevin Crow,REP,100071,0,0,4,4,
Carter,U.S. Senate,James Lankford,REP,100071,0,1,15,16,
Carter,U.S. Senate,Jason Weger,REP,100071,0,0,1,1,
Carter,U.S. House,Anna Flatt,REP,100071,0,1,18,19,04
Carter,U.S. House,Tom Cole,REP,100071,1,1,36,38,04
Cherokee,Superintendent of Public Instruction,John Cox,DEM,110001,5,11,118,134,
Cherokee,Superintendent of Public Instruction,Jack Jr.,DEM,110001,0,1,11,12,
Cherokee,Superintendent of Public Instruction,Ivan Holmes,DEM,110001,3,0,12,15,
Cherokee,Superintendent of Public Instruction,Freda Deskin,DEM,110001,1,4,48,53,
Cherokee,U.S. Senate,Patrick Michael Hayes,DEM,110001,0,1,34,35,
Cherokee,U.S. Senate,Jim Rogers,DEM,110001,6,3,74,83,
Cherokee,U.S. Senate,Connie Johnson,DEM,110001,1,11,76,88,
Cherokee,U.S. House,Earl Everett,DEM,110001,6,6,102,114,02
Cherokee,U.S. House,Joshua Harris-Till,DEM,110001,1,8,79,88,02
Cherokee,Governor,Dax Ewbank,REP,110001,1,2,10,13,
Cherokee,Governor,Chad Moody,REP,110001,0,0,16,16,
Cherokee,Governor,Mary Fallin,REP,110001,4,4,43,51,
Cherokee,Superintendent of Public Instruction,Brian Kelly,REP,110001,1,3,16,20,
Cherokee,Superintendent of Public Instruction,Janet Costello Barresi,REP,110001,2,1,13,16,
Cherokee,Superintendent of Public Instruction,Joy Hofmeister,REP,110001,2,2,43,47,
Cherokee,Insurance Commissioner,Bill Viner,REP,110001,1,1,19,21,
Cherokee,Insurance Commissioner,John Doak,REP,110001,4,4,45,53,
Cherokee,Corporation Commissioner,Todd Hiett,REP,110001,1,3,31,35,
Cherokee,Corporation Commissioner,Cliff Branan,REP,110001,4,0,30,34,
Cherokee,U.S. Senate,Evelyn Rogers,REP,110001,1,0,4,5,
Cherokee,U.S. Senate,Rob Moye,REP,110001,0,0,1,1,
Cherokee,U.S. Senate,D. Jean Mcbride-Samuels,REP,110001,0,0,1,1,
Cherokee,U.S. Senate,Jim Inhofe,REP,110001,4,5,59,68,
Cherokee,U.S. Senate,Erick Paul Wyatt,REP,110001,0,1,3,4,
Cherokee,U.S. Senate,Andy Craig,REP,110001,0,0,1,1,
Cherokee,U.S. Senate,T. Shannon,REP,110001,3,0,23,26,
Cherokee,U.S. Senate,Randy Brogdon,REP,110001,1,1,4,6,
Cherokee,U.S. Senate,Eric Mccray,REP,110001,0,0,2,2,
Cherokee,U.S. Senate,Kevin Crow,REP,110001,0,0,3,3,
Cherokee,U.S. Senate,James Lankford,REP,110001,1,5,37,43,
Cherokee,U.S. Senate,Jason Weger,REP,110001,0,0,1,1,
Cherokee,U.S. House,Darrel Robertson,REP,110001,1,1,13,15,02
Cherokee,U.S. House,Markwayne Mullin,REP,110001,4,5,58,67,02
Cherokee,Superintendent of Public Instruction,John Cox,DEM,110002,3,47,233,283,
Cherokee,Superintendent of Public Instruction,Jack Jr.,DEM,110002,0,2,21,23,
Cherokee,Superintendent of Public Instruction,Ivan Holmes,DEM,110002,1,5,28,34,
Cherokee,Superintendent of Public Instruction,Freda Deskin,DEM,110002,0,5,71,76,
Cherokee,U.S. Senate,Patrick Michael Hayes,DEM,110002,0,9,68,77,
Cherokee,U.S. Senate,Jim Rogers,DEM,110002,3,29,157,189,
Cherokee,U.S. Senate,Connie Johnson,DEM,110002,1,16,109,126,
Cherokee,U.S. House,Earl Everett,DEM,110002,3,31,201,235,02
Cherokee,U.S. House,Joshua Harris-Till,DEM,110002,1,18,130,149,02
Cherokee,Governor,Dax Ewbank,REP,110002,0,5,20,25,
Cherokee,Governor,Chad Moody,REP,110002,0,3,28,31,
Cherokee,Governor,Mary Fallin,REP,110002,1,25,174,200,
Cherokee,Superintendent of Public Instruction,Brian Kelly,REP,110002,0,6,44,50,
Cherokee,Superintendent of Public Instruction,Janet Costello Barresi,REP,110002,1,4,50,55,
Cherokee,Superintendent of Public Instruction,Joy Hofmeister,REP,110002,0,23,129,152,
Cherokee,Insurance Commissioner,Bill Viner,REP,110002,0,7,75,82,
Cherokee,Insurance Commissioner,John Doak,REP,110002,1,25,133,159,
Cherokee,Corporation Commissioner,Todd Hiett,REP,110002,1,16,124,141,
Cherokee,Corporation Commissioner,Cliff Branan,REP,110002,0,16,85,101,
Cherokee,U.S. Senate,Evelyn Rogers,REP,110002,0,1,11,12,
Cherokee,U.S. Senate,Rob Moye,REP,110002,0,0,2,2,
Cherokee,U.S. Senate,D. Jean Mcbride-Samuels,REP,110002,0,0,6,6,
Cherokee,U.S. Senate,Jim Inhofe,REP,110002,1,30,195,226,
Cherokee,U.S. Senate,Erick Paul Wyatt,REP,110002,0,2,11,13,
Cherokee,U.S. Senate,Andy Craig,REP,110002,0,0,0,0,
Cherokee,U.S. Senate,T. Shannon,REP,110002,1,14,108,123,
Cherokee,U.S. Senate,Randy Brogdon,REP,110002,0,0,7,7,
Cherokee,U.S. Senate,Eric Mccray,REP,110002,0,0,2,2,
Cherokee,U.S. Senate,Kevin Crow,REP,110002,0,0,1,1,
Cherokee,U.S. Senate,James Lankford,REP,110002,0,19,105,124,
Cherokee,U.S. Senate,Jason Weger,REP,110002,0,0,0,0,
Cherokee,U.S. House,Darrel Robertson,REP,110002,0,2,43,45,02
Cherokee,U.S. House,Markwayne Mullin,REP,110002,1,31,181,213,02
Cherokee,Superintendent of Public Instruction,John Cox,DEM,110003,1,46,118,165,
Cherokee,Superintendent of Public Instruction,Jack Jr.,DEM,110003,0,7,13,20,
Cherokee,Superintendent of Public Instruction,Ivan Holmes,DEM,110003,1,3,12,16,
Cherokee,Superintendent of Public Instruction,Freda Deskin,DEM,110003,0,9,41,50,
Cherokee,U.S. Senate,Patrick Michael Hayes,DEM,110003,0,14,35,49,
Cherokee,U.S. Senate,Jim Rogers,DEM,110003,1,22,73,96,
Cherokee,U.S. Senate,Connie Johnson,DEM,110003,1,25,70,96,
Cherokee,U.S. House,Earl Everett,DEM,110003,0,34,98,132,02
Cherokee,U.S. House,Joshua Harris-Till,DEM,110003,2,23,78,103,02
Cherokee,Governor,Dax Ewbank,REP,110003,0,4,23,27,
Cherokee,Governor,Chad Moody,REP,110003,0,6,23,29,
Cherokee,Governor,Mary Fallin,REP,110003,1,20,155,176,
Cherokee,Superintendent of Public Instruction,Brian Kelly,REP,110003,0,5,47,52,
Cherokee,Superintendent of Public Instruction,Janet Costello Barresi,REP,110003,0,6,37,43,
Cherokee,Superintendent of Public Instruction,Joy Hofmeister,REP,110003,1,19,111,131,
Cherokee,Insurance Commissioner,Bill Viner,REP,110003,0,7,51,58,
Cherokee,Insurance Commissioner,John Doak,REP,110003,1,22,122,145,
Cherokee,Corporation Commissioner,Todd Hiett,REP,110003,0,20,96,116,
Cherokee,Corporation Commissioner,Cliff Branan,REP,110003,1,10,86,97,
Cherokee,U.S. Senate,Evelyn Rogers,REP,110003,0,2,7,9,
Cherokee,U.S. Senate,Rob Moye,REP,110003,0,1,1,2,
Cherokee,U.S. Senate,D. Jean Mcbride-Samuels,REP,110003,0,1,3,4,
Cherokee,U.S. Senate,Jim Inhofe,REP,110003,1,24,180,205,
Cherokee,U.S. Senate,Erick Paul Wyatt,REP,110003,0,1,11,12,
Cherokee,U.S. Senate,Andy Craig,REP,110003,0,0,2,2,
Cherokee,U.S. Senate,T. Shannon,REP,110003,0,11,77,88,
Cherokee,U.S. Senate,Randy Brogdon,REP,110003,0,1,4,5,
Cherokee,U.S. Senate,Eric Mccray,REP,110003,0,0,5,5,
Cherokee,U.S. Senate,Kevin Crow,REP,110003,0,0,3,3,
Cherokee,U.S. Senate,James Lankford,REP,110003,1,18,107,126,
Cherokee,U.S. Senate,Jason Weger,REP,110003,0,0,1,1,
Cherokee,U.S. House,Darrel Robertson,REP,110003,0,2,26,28,02
Cherokee,U.S. House,Markwayne Mullin,REP,110003,1,28,173,202,02
Cherokee,Superintendent of Public Instruction,John Cox,DEM,110004,1,19,137,157,
Cherokee,Superintendent of Public Instruction,Jack Jr.,DEM,110004,0,1,20,21,
Cherokee,Superintendent of Public Instruction,Ivan Holmes,DEM,110004,4,2,12,18,
Cherokee,Superintendent of Public Instruction,Freda Deskin,DEM,110004,3,10,33,46,
Cherokee,U.S. Senate,Patrick Michael Hayes,DEM,110004,0,7,39,46,
Cherokee,U.S. Senate,Jim Rogers,DEM,110004,4,15,88,107,
Cherokee,U.S. Senate,Connie Johnson,DEM,110004,4,9,68,81,
Cherokee,U.S. House,Earl Everett,DEM,110004,5,17,105,127,02
Cherokee,U.S. House,Joshua Harris-Till,DEM,110004,2,14,84,100,02
Cherokee,Governor,Dax Ewbank,REP,110004,0,1,20,21,
Cherokee,Governor,Chad Moody,REP,110004,0,4,24,28,
Cherokee,Governor,Mary Fallin,REP,110004,4,11,57,72,
Cherokee,Superintendent of Public Instruction,Brian Kelly,REP,110004,3,1,19,23,
Cherokee,Superintendent of Public Instruction,Janet Costello Barresi,REP,110004,0,5,16,21,
Cherokee,Superintendent of Public Instruction,Joy Hofmeister,REP,110004,1,11,62,74,
Cherokee,Insurance Commissioner,Bill Viner,REP,110004,2,7,20,29,
Cherokee,Insurance Commissioner,John Doak,REP,110004,2,8,74,84,
Cherokee,Corporation Commissioner,Todd Hiett,REP,110004,3,4,56,63,
Cherokee,Corporation Commissioner,Cliff Branan,REP,110004,1,12,39,52,
Cherokee,U.S. Senate,Evelyn Rogers,REP,110004,0,1,6,7,
Cherokee,U.S. Senate,Rob Moye,REP,110004,0,2,4,6,
Cherokee,U.S. Senate,D. Jean Mcbride-Samuels,REP,110004,0,0,2,2,
Cherokee,U.S. Senate,Jim Inhofe,REP,110004,4,10,80,94,
Cherokee,U.S. Senate,Erick Paul Wyatt,REP,110004,0,3,7,10,
Cherokee,U.S. Senate,Andy Craig,REP,110004,0,0,2,2,
Cherokee,U.S. Senate,T. Shannon,REP,110004,2,5,39,46,
Cherokee,U.S. Senate,Randy Brogdon,REP,110004,0,0,9,9,
Cherokee,U.S. Senate,Eric Mccray,REP,110004,0,0,4,4,
Cherokee,U.S. Senate,Kevin Crow,REP,110004,0,1,2,3,
Cherokee,U.S. Senate,James Lankford,REP,110004,2,10,43,55,
Cherokee,U.S. Senate,Jason Weger,REP,110004,0,0,1,1,
Cherokee,U.S. House,Darrel Robertson,REP,110004,0,2,18,20,02
Cherokee,U.S. House,Markwayne Mullin,REP,110004,4,13,83,100,02
Cherokee,Superintendent of Public Instruction,John Cox,DEM,110005,0,4,32,36,
Cherokee,Superintendent of Public Instruction,Jack Jr.,DEM,110005,0,0,6,6,
Cherokee,Superintendent of Public Instruction,Ivan Holmes,DEM,110005,0,1,3,4,
Cherokee,Superintendent of Public Instruction,Freda Deskin,DEM,110005,0,2,14,16,
Cherokee,U.S. Senate,Patrick Michael Hayes,DEM,110005,0,2,6,8,
Cherokee,U.S. Senate,Jim Rogers,DEM,110005,0,4,27,31,
Cherokee,U.S. Senate,Connie Johnson,DEM,110005,0,1,19,20,
Cherokee,U.S. House,Earl Everett,DEM,110005,0,3,19,22,02
Cherokee,U.S. House,Joshua Harris-Till,DEM,110005,0,4,32,36,02
Cherokee,Governor,Dax Ewbank,REP,110005,0,0,4,4,
Cherokee,Governor,Chad Moody,REP,110005,1,1,8,10,
Cherokee,Governor,Mary Fallin,REP,110005,0,2,16,18,
Cherokee,Superintendent of Public Instruction,Brian Kelly,REP,110005,0,0,7,7,
Cherokee,Superintendent of Public Instruction,Janet Costello Barresi,REP,110005,0,0,5,5,
Cherokee,Superintendent of Public Instruction,Joy Hofmeister,REP,110005,1,3,16,20,
Cherokee,Insurance Commissioner,Bill Viner,REP,110005,0,1,7,8,
Cherokee,Insurance Commissioner,John Doak,REP,110005,1,2,19,22,
Cherokee,Corporation Commissioner,Todd Hiett,REP,110005,1,0,14,15,
Cherokee,Corporation Commissioner,Cliff Branan,REP,110005,0,3,13,16,
Cherokee,U.S. Senate,Evelyn Rogers,REP,110005,0,1,4,5,
Cherokee,U.S. Senate,Rob Moye,REP,110005,0,0,0,0,
Cherokee,U.S. Senate,D. Jean Mcbride-Samuels,REP,110005,0,0,0,0,
Cherokee,U.S. Senate,Jim Inhofe,REP,110005,1,2,22,25,
Cherokee,U.S. Senate,Erick Paul Wyatt,REP,110005,0,0,2,2,
Cherokee,U.S. Senate,Andy Craig,REP,110005,0,0,2,2,
Cherokee,U.S. Senate,T. Shannon,REP,110005,0,1,16,17,
Cherokee,U.S. Senate,Randy Brogdon,REP,110005,0,0,1,1,
Cherokee,U.S. Senate,Eric Mccray,REP,110005,0,0,0,0,
Cherokee,U.S. Senate,Kevin Crow,REP,110005,0,0,1,1,
Cherokee,U.S. Senate,James Lankford,REP,110005,1,2,7,10,
Cherokee,U.S. Senate,Jason Weger,REP,110005,0,0,0,0,
Cherokee,U.S. House,Darrel Robertson,REP,110005,0,1,5,6,02
Cherokee,U.S. House,Markwayne Mullin,REP,110005,1,2,23,26,02
Cherokee,Superintendent of Public Instruction,John Cox,DEM,110006,1,16,61,78,
Cherokee,Superintendent of Public Instruction,Jack Jr.,DEM,110006,0,1,8,9,
Cherokee,Superintendent of Public Instruction,Ivan Holmes,DEM,110006,0,1,8,9,
Cherokee,Superintendent of Public Instruction,Freda Deskin,DEM,110006,2,2,25,29,
Cherokee,U.S. Senate,Patrick Michael Hayes,DEM,110006,0,6,14,20,
Cherokee,U.S. Senate,Jim Rogers,DEM,110006,0,7,51,58,
Cherokee,U.S. Senate,Connie Johnson,DEM,110006,3,7,33,43,
Cherokee,U.S. House,Earl Everett,DEM,110006,1,14,53,68,02
Cherokee,U.S. House,Joshua Harris-Till,DEM,110006,2,5,40,47,02
Cherokee,Governor,Dax Ewbank,REP,110006,0,0,2,2,
Cherokee,Governor,Chad Moody,REP,110006,0,0,12,12,
Cherokee,Governor,Mary Fallin,REP,110006,2,2,54,58,
Cherokee,Superintendent of Public Instruction,Brian Kelly,REP,110006,0,0,16,16,
Cherokee,Superintendent of Public Instruction,Janet Costello Barresi,REP,110006,2,0,4,6,
Cherokee,Superintendent of Public Instruction,Joy Hofmeister,REP,110006,0,1,46,47,
Cherokee,Insurance Commissioner,Bill Viner,REP,110006,0,0,17,17,
Cherokee,Insurance Commissioner,John Doak,REP,110006,2,1,46,49,
Cherokee,Corporation Commissioner,Todd Hiett,REP,110006,0,1,30,31,
Cherokee,Corporation Commissioner,Cliff Branan,REP,110006,2,0,33,35,
Cherokee,U.S. Senate,Evelyn Rogers,REP,110006,0,0,1,1,
Cherokee,U.S. Senate,Rob Moye,REP,110006,0,0,2,2,
Cherokee,U.S. Senate,D. Jean Mcbride-Samuels,REP,110006,0,0,0,0,
Cherokee,U.S. Senate,Jim Inhofe,REP,110006,2,2,63,67,
Cherokee,U.S. Senate,Erick Paul Wyatt,REP,110006,0,0,3,3,
Cherokee,U.S. Senate,Andy Craig,REP,110006,0,0,2,2,
Cherokee,U.S. Senate,T. Shannon,REP,110006,0,1,28,29,
Cherokee,U.S. Senate,Randy Brogdon,REP,110006,0,0,0,0,
Cherokee,U.S. Senate,Eric Mccray,REP,110006,0,0,1,1,
Cherokee,U.S. Senate,Kevin Crow,REP,110006,0,0,1,1,
Cherokee,U.S. Senate,James Lankford,REP,110006,2,1,39,42,
Cherokee,U.S. Senate,Jason Weger,REP,110006,0,0,0,0,
Cherokee,U.S. House,Darrel Robertson,REP,110006,0,0,5,5,02
Cherokee,U.S. House,Markwayne Mullin,REP,110006,2,2,66,70,02
Cherokee,Superintendent of Public Instruction,John Cox,DEM,110007,0,0,13,13,
Cherokee,Superintendent of Public Instruction,Jack Jr.,DEM,110007,0,0,1,1,
Cherokee,Superintendent of Public Instruction,Ivan Holmes,DEM,110007,0,0,1,1,
Cherokee,Superintendent of Public Instruction,Freda Deskin,DEM,110007,0,1,3,4,
Cherokee,U.S. Senate,Patrick Michael Hayes,DEM,110007,0,0,1,1,
Cherokee,U.S. Senate,Jim Rogers,DEM,110007,0,1,11,12,
Cherokee,U.S. Senate,Connie Johnson,DEM,110007,0,0,6,6,
Cherokee,U.S. House,Earl Everett,DEM,110007,0,1,13,14,02
Cherokee,U.S. House,Joshua Harris-Till,DEM,110007,0,0,5,5,02
Cherokee,Governor,Dax Ewbank,REP,110007,0,2,0,2,
Cherokee,Governor,Chad Moody,REP,110007,0,0,5,5,
Cherokee,Governor,Mary Fallin,REP,110007,2,0,4,6,
Cherokee,Superintendent of Public Instruction,Brian Kelly,REP,110007,0,0,1,1,
Cherokee,Superintendent of Public Instruction,Janet Costello Barresi,REP,110007,0,0,1,1,
Cherokee,Superintendent of Public Instruction,Joy Hofmeister,REP,110007,2,2,7,11,
Cherokee,Insurance Commissioner,Bill Viner,REP,110007,2,0,1,3,
Cherokee,Insurance Commissioner,John Doak,REP,110007,0,2,7,9,
Cherokee,Corporation Commissioner,Todd Hiett,REP,110007,1,0,7,8,
Cherokee,Corporation Commissioner,Cliff Branan,REP,110007,1,2,2,5,
Cherokee,U.S. Senate,Evelyn Rogers,REP,110007,0,0,0,0,
Cherokee,U.S. Senate,Rob Moye,REP,110007,0,0,0,0,
Cherokee,U.S. Senate,D. Jean Mcbride-Samuels,REP,110007,0,0,0,0,
Cherokee,U.S. Senate,Jim Inhofe,REP,110007,2,2,8,12,
Cherokee,U.S. Senate,Erick Paul Wyatt,REP,110007,0,0,1,1,
Cherokee,U.S. Senate,Andy Craig,REP,110007,0,0,0,0,
Cherokee,U.S. Senate,T. Shannon,REP,110007,2,0,5,7,
Cherokee,U.S. Senate,Randy Brogdon,REP,110007,0,0,0,0,
Cherokee,U.S. Senate,Eric Mccray,REP,110007,0,0,0,0,
Cherokee,U.S. Senate,Kevin Crow,REP,110007,0,2,0,2,
Cherokee,U.S. Senate,James Lankford,REP,110007,0,0,4,4,
Cherokee,U.S. Senate,Jason Weger,REP,110007,0,0,0,0,
Cherokee,U.S. House,Darrel Robertson,REP,110007,0,0,2,2,02
Cherokee,U.S. House,Markwayne Mullin,REP,110007,2,2,7,11,02
Cherokee,Superintendent of Public Instruction,John Cox,DEM,110008,0,9,41,50,
Cherokee,Superintendent of Public Instruction,Jack Jr.,DEM,110008,0,2,6,8,
Cherokee,Superintendent of Public Instruction,Ivan Holmes,DEM,110008,0,0,4,4,
Cherokee,Superintendent of Public Instruction,Freda Deskin,DEM,110008,0,1,19,20,
Cherokee,U.S. Senate,Patrick Michael Hayes,DEM,110008,0,4,8,12,
Cherokee,U.S. Senate,Jim Rogers,DEM,110008,0,6,35,41,
Cherokee,U.S. Senate,Connie Johnson,DEM,110008,0,1,24,25,
Cherokee,U.S. House,Earl Everett,DEM,110008,0,6,42,48,02
Cherokee,U.S. House,Joshua Harris-Till,DEM,110008,0,5,24,29,02
Cherokee,Governor,Dax Ewbank,REP,110008,0,0,3,3,
Cherokee,Governor,Chad Moody,REP,110008,0,1,4,5,
Cherokee,Governor,Mary Fallin,REP,110008,0,3,21,24,
Cherokee,Superintendent of Public Instruction,Brian Kelly,REP,110008,0,0,8,8,
Cherokee,Superintendent of Public Instruction,Janet Costello Barresi,REP,110008,0,2,3,5,
Cherokee,Superintendent of Public Instruction,Joy Hofmeister,REP,110008,0,2,16,18,
Cherokee,Insurance Commissioner,Bill Viner,REP,110008,0,1,8,9,
Cherokee,Insurance Commissioner,John Doak,REP,110008,0,3,19,22,
Cherokee,Corporation Commissioner,Todd Hiett,REP,110008,0,2,10,12,
Cherokee,Corporation Commissioner,Cliff Branan,REP,110008,0,1,17,18,
Cherokee,U.S. Senate,Evelyn Rogers,REP,110008,0,1,2,3,
Cherokee,U.S. Senate,Rob Moye,REP,110008,0,0,1,1,
Cherokee,U.S. Senate,D. Jean Mcbride-Samuels,REP,110008,0,0,0,0,
Cherokee,U.S. Senate,Jim Inhofe,REP,110008,0,3,22,25,
Cherokee,U.S. Senate,Erick Paul Wyatt,REP,110008,0,0,1,1,
Cherokee,U.S. Senate,Andy Craig,REP,110008,0,0,1,1,
Cherokee,U.S. Senate,T. Shannon,REP,110008,0,4,12,16,
Cherokee,U.S. Senate,Randy Brogdon,REP,110008,0,0,1,1,
Cherokee,U.S. Senate,Eric Mccray,REP,110008,0,0,0,0,
Cherokee,U.S. Senate,Kevin Crow,REP,110008,0,0,0,0,
Cherokee,U.S. Senate,James Lankford,REP,110008,0,0,13,13,
Cherokee,U.S. Senate,Jason Weger,REP,110008,0,0,1,1,
Cherokee,U.S. House,Darrel Robertson,REP,110008,0,0,5,5,02
Cherokee,U.S. House,Markwayne Mullin,REP,110008,0,4,23,27,02
Cherokee,Superintendent of Public Instruction,John Cox,DEM,110009,0,2,65,67,
Cherokee,Superintendent of Public Instruction,Jack Jr.,DEM,110009,0,0,11,11,
Cherokee,Superintendent of Public Instruction,Ivan Holmes,DEM,110009,0,0,13,13,
Cherokee,Superintendent of Public Instruction,Freda Deskin,DEM,110009,0,5,34,39,
Cherokee,U.S. Senate,Patrick Michael Hayes,DEM,110009,0,2,17,19,
Cherokee,U.S. Senate,Jim Rogers,DEM,110009,0,0,60,60,
Cherokee,U.S. Senate,Connie Johnson,DEM,110009,0,4,35,39,
Cherokee,U.S. House,Earl Everett,DEM,110009,0,2,61,63,02
Cherokee,U.S. House,Joshua Harris-Till,DEM,110009,0,4,49,53,02
Cherokee,Governor,Dax Ewbank,REP,110009,0,1,6,7,
Cherokee,Governor,Chad Moody,REP,110009,0,0,9,9,
Cherokee,Governor,Mary Fallin,REP,110009,2,0,120,122,
Cherokee,Superintendent of Public Instruction,Brian Kelly,REP,110009,0,1,37,38,
Cherokee,Superintendent of Public Instruction,Janet Costello Barresi,REP,110009,0,0,23,23,
Cherokee,Superintendent of Public Instruction,Joy Hofmeister,REP,110009,2,0,74,76,
Cherokee,Insurance Commissioner,Bill Viner,REP,110009,0,0,33,33,
Cherokee,Insurance Commissioner,John Doak,REP,110009,2,1,90,93,
Cherokee,Corporation Commissioner,Todd Hiett,REP,110009,0,1,78,79,
Cherokee,Corporation Commissioner,Cliff Branan,REP,110009,2,0,49,51,
Cherokee,U.S. Senate,Evelyn Rogers,REP,110009,0,0,3,3,
Cherokee,U.S. Senate,Rob Moye,REP,110009,0,0,1,1,
Cherokee,U.S. Senate,D. Jean Mcbride-Samuels,REP,110009,0,0,1,1,
Cherokee,U.S. Senate,Jim Inhofe,REP,110009,2,1,123,126,
Cherokee,U.S. Senate,Erick Paul Wyatt,REP,110009,0,0,5,5,
Cherokee,U.S. Senate,Andy Craig,REP,110009,0,0,1,1,
Cherokee,U.S. Senate,T. Shannon,REP,110009,0,0,64,64,
Cherokee,U.S. Senate,Randy Brogdon,REP,110009,0,0,4,4,
Cherokee,U.S. Senate,Eric Mccray,REP,110009,0,0,0,0,
Cherokee,U.S. Senate,Kevin Crow,REP,110009,0,0,0,0,
Cherokee,U.S. Senate,James Lankford,REP,110009,2,1,67,70,
Cherokee,U.S. Senate,Jason Weger,REP,110009,0,0,0,0,
Cherokee,U.S. House,Darrel Robertson,REP,110009,0,0,25,25,02
Cherokee,U.S. House,Markwayne Mullin,REP,110009,2,1,109,112,02
Cherokee,Superintendent of Public Instruction,John Cox,DEM,110010,1,20,249,270,
Cherokee,Superintendent of Public Instruction,Jack Jr.,DEM,110010,2,4,21,27,
Cherokee,Superintendent of Public Instruction,Ivan Holmes,DEM,110010,0,2,13,15,
Cherokee,Superintendent of Public Instruction,Freda Deskin,DEM,110010,0,4,86,90,
Cherokee,U.S. Senate,Patrick Michael Hayes,DEM,110010,0,7,86,93,
Cherokee,U.S. Senate,Jim Rogers,DEM,110010,2,18,181,201,
Cherokee,U.S. Senate,Connie Johnson,DEM,110010,1,5,95,101,
Cherokee,U.S. House,Earl Everett,DEM,110010,2,21,215,238,02
Cherokee,U.S. House,Joshua Harris-Till,DEM,110010,1,9,139,149,02
Cherokee,Governor,Dax Ewbank,REP,110010,0,0,7,7,
Cherokee,Governor,Chad Moody,REP,110010,1,0,30,31,
Cherokee,Governor,Mary Fallin,REP,110010,0,4,99,103,
Cherokee,Superintendent of Public Instruction,Brian Kelly,REP,110010,0,0,37,37,
Cherokee,Superintendent of Public Instruction,Janet Costello Barresi,REP,110010,0,0,19,19,
Cherokee,Superintendent of Public Instruction,Joy Hofmeister,REP,110010,1,4,76,81,
Cherokee,Insurance Commissioner,Bill Viner,REP,110010,0,0,32,32,
Cherokee,Insurance Commissioner,John Doak,REP,110010,1,4,96,101,
Cherokee,Corporation Commissioner,Todd Hiett,REP,110010,0,0,60,60,
Cherokee,Corporation Commissioner,Cliff Branan,REP,110010,1,4,67,72,
Cherokee,U.S. Senate,Evelyn Rogers,REP,110010,0,0,8,8,
Cherokee,U.S. Senate,Rob Moye,REP,110010,0,0,2,2,
Cherokee,U.S. Senate,D. Jean Mcbride-Samuels,REP,110010,0,0,0,0,
Cherokee,U.S. Senate,Jim Inhofe,REP,110010,1,4,114,119,
Cherokee,U.S. Senate,Erick Paul Wyatt,REP,110010,0,0,11,11,
Cherokee,U.S. Senate,Andy Craig,REP,110010,0,0,2,2,
Cherokee,U.S. Senate,T. Shannon,REP,110010,0,2,72,74,
Cherokee,U.S. Senate,Randy Brogdon,REP,110010,1,0,4,5,
Cherokee,U.S. Senate,Eric Mccray,REP,110010,0,0,1,1,
Cherokee,U.S. Senate,Kevin Crow,REP,110010,0,0,2,2,
Cherokee,U.S. Senate,James Lankford,REP,110010,0,2,53,55,
Cherokee,U.S. Senate,Jason Weger,REP,110010,0,0,1,1,
Cherokee,U.S. House,Darrel Robertson,REP,110010,0,0,22,22,02
Cherokee,U.S. House,Markwayne Mullin,REP,110010,1,4,115,120,02
Cherokee,Superintendent of Public Instruction,John Cox,DEM,110011,0,9,66,75,
Cherokee,Superintendent of Public Instruction,Jack Jr.,DEM,110011,0,0,3,3,
Cherokee,Superintendent of Public Instruction,Ivan Holmes,DEM,110011,0,0,4,4,
Cherokee,Superintendent of Public Instruction,Freda Deskin,DEM,110011,0,1,10,11,
Cherokee,U.S. Senate,Patrick Michael Hayes,DEM,110011,0,3,14,17,
Cherokee,U.S. Senate,Jim Rogers,DEM,110011,0,1,43,44,
Cherokee,U.S. Senate,Connie Johnson,DEM,110011,0,3,21,24,
Cherokee,U.S. House,Earl Everett,DEM,110011,0,1,40,41,02
Cherokee,U.S. House,Joshua Harris-Till,DEM,110011,0,6,35,41,02
Cherokee,Governor,Dax Ewbank,REP,110011,0,0,2,2,
Cherokee,Governor,Chad Moody,REP,110011,0,0,3,3,
Cherokee,Governor,Mary Fallin,REP,110011,0,3,24,27,
Cherokee,Superintendent of Public Instruction,Brian Kelly,REP,110011,0,1,8,9,
Cherokee,Superintendent of Public Instruction,Janet Costello Barresi,REP,110011,0,2,5,7,
Cherokee,Superintendent of Public Instruction,Joy Hofmeister,REP,110011,0,0,15,15,
Cherokee,Insurance Commissioner,Bill Viner,REP,110011,0,1,5,6,
Cherokee,Insurance Commissioner,John Doak,REP,110011,0,2,23,25,
Cherokee,Corporation Commissioner,Todd Hiett,REP,110011,0,1,15,16,
Cherokee,Corporation Commissioner,Cliff Branan,REP,110011,0,2,13,15,
Cherokee,U.S. Senate,Evelyn Rogers,REP,110011,0,0,1,1,
Cherokee,U.S. Senate,Rob Moye,REP,110011,0,0,2,2,
Cherokee,U.S. Senate,D. Jean Mcbride-Samuels,REP,110011,0,0,0,0,
Cherokee,U.S. Senate,Jim Inhofe,REP,110011,0,3,24,27,
Cherokee,U.S. Senate,Erick Paul Wyatt,REP,110011,0,0,1,1,
Cherokee,U.S. Senate,Andy Craig,REP,110011,0,0,0,0,
Cherokee,U.S. Senate,T. Shannon,REP,110011,0,1,16,17,
Cherokee,U.S. Senate,Randy Brogdon,REP,110011,0,0,1,1,
Cherokee,U.S. Senate,Eric Mccray,REP,110011,0,0,0,0,
Cherokee,U.S. Senate,Kevin Crow,REP,110011,0,0,0,0,
Cherokee,U.S. Senate,James Lankford,REP,110011,0,2,11,13,
Cherokee,U.S. Senate,Jason Weger,REP,110011,0,0,1,1,
Cherokee,U.S. House,Darrel Robertson,REP,110011,0,0,2,2,02
Cherokee,U.S. House,Markwayne Mullin,REP,110011,0,3,27,30,02
Cherokee,Superintendent of Public Instruction,John Cox,DEM,110012,1,37,138,176,
Cherokee,Superintendent of Public Instruction,Jack Jr.,DEM,110012,0,3,9,12,
Cherokee,Superintendent of Public Instruction,Ivan Holmes,DEM,110012,0,1,8,9,
Cherokee,Superintendent of Public Instruction,Freda Deskin,DEM,110012,0,2,27,29,
Cherokee,U.S. Senate,Patrick Michael Hayes,DEM,110012,1,19,25,45,
Cherokee,U.S. Senate,Jim Rogers,DEM,110012,0,18,106,124,
Cherokee,U.S. Senate,Connie Johnson,DEM,110012,0,6,45,51,
Cherokee,U.S. House,Earl Everett,DEM,110012,1,33,114,148,02
Cherokee,U.S. House,Joshua Harris-Till,DEM,110012,0,9,62,71,02
Cherokee,Governor,Dax Ewbank,REP,110012,0,6,12,18,
Cherokee,Governor,Chad Moody,REP,110012,0,0,12,12,
Cherokee,Governor,Mary Fallin,REP,110012,0,7,51,58,
Cherokee,Superintendent of Public Instruction,Brian Kelly,REP,110012,0,4,16,20,
Cherokee,Superintendent of Public Instruction,Janet Costello Barresi,REP,110012,0,2,16,18,
Cherokee,Superintendent of Public Instruction,Joy Hofmeister,REP,110012,0,6,41,47,
Cherokee,Insurance Commissioner,Bill Viner,REP,110012,0,5,17,22,
Cherokee,Insurance Commissioner,John Doak,REP,110012,0,6,54,60,
Cherokee,Corporation Commissioner,Todd Hiett,REP,110012,0,5,35,40,
Cherokee,Corporation Commissioner,Cliff Branan,REP,110012,0,4,33,37,
Cherokee,U.S. Senate,Evelyn Rogers,REP,110012,0,1,3,4,
Cherokee,U.S. Senate,Rob Moye,REP,110012,0,0,2,2,
Cherokee,U.S. Senate,D. Jean Mcbride-Samuels,REP,110012,0,0,3,3,
Cherokee,U.S. Senate,Jim Inhofe,REP,110012,0,9,62,71,
Cherokee,U.S. Senate,Erick Paul Wyatt,REP,110012,0,4,2,6,
Cherokee,U.S. Senate,Andy Craig,REP,110012,0,4,1,5,
Cherokee,U.S. Senate,T. Shannon,REP,110012,0,4,35,39,
Cherokee,U.S. Senate,Randy Brogdon,REP,110012,0,1,9,10,
Cherokee,U.S. Senate,Eric Mccray,REP,110012,0,0,1,1,
Cherokee,U.S. Senate,Kevin Crow,REP,110012,0,0,2,2,
Cherokee,U.S. Senate,James Lankford,REP,110012,0,4,25,29,
Cherokee,U.S. Senate,Jason Weger,REP,110012,0,0,0,0,
Cherokee,U.S. House,Darrel Robertson,REP,110012,0,5,13,18,02
Cherokee,U.S. House,Markwayne Mullin,REP,110012,0,9,60,69,02
Cherokee,Superintendent of Public Instruction,John Cox,DEM,110013,0,9,113,122,
Cherokee,Superintendent of Public Instruction,Jack Jr.,DEM,110013,0,0,17,17,
Cherokee,Superintendent of Public Instruction,Ivan Holmes,DEM,110013,0,0,12,12,
Cherokee,Superintendent of Public Instruction,Freda Deskin,DEM,110013,2,0,29,31,
Cherokee,U.S. Senate,Patrick Michael Hayes,DEM,110013,0,3,25,28,
Cherokee,U.S. Senate,Jim Rogers,DEM,110013,1,1,97,99,
Cherokee,U.S. Senate,Connie Johnson,DEM,110013,1,3,39,43,
Cherokee,U.S. House,Earl Everett,DEM,110013,1,3,95,99,02
Cherokee,U.S. House,Joshua Harris-Till,DEM,110013,1,5,62,68,02
Cherokee,Governor,Dax Ewbank,REP,110013,0,1,6,7,
Cherokee,Governor,Chad Moody,REP,110013,0,1,8,9,
Cherokee,Governor,Mary Fallin,REP,110013,2,4,38,44,
Cherokee,Superintendent of Public Instruction,Brian Kelly,REP,110013,0,1,17,18,
Cherokee,Superintendent of Public Instruction,Janet Costello Barresi,REP,110013,2,3,6,11,
Cherokee,Superintendent of Public Instruction,Joy Hofmeister,REP,110013,0,2,31,33,
Cherokee,Insurance Commissioner,Bill Viner,REP,110013,0,0,15,15,
Cherokee,Insurance Commissioner,John Doak,REP,110013,2,6,36,44,
Cherokee,Corporation Commissioner,Todd Hiett,REP,110013,2,2,20,24,
Cherokee,Corporation Commissioner,Cliff Branan,REP,110013,0,4,31,35,
Cherokee,U.S. Senate,Evelyn Rogers,REP,110013,0,1,4,5,
Cherokee,U.S. Senate,Rob Moye,REP,110013,0,0,2,2,
Cherokee,U.S. Senate,D. Jean Mcbride-Samuels,REP,110013,0,0,1,1,
Cherokee,U.S. Senate,Jim Inhofe,REP,110013,2,5,44,51,
Cherokee,U.S. Senate,Erick Paul Wyatt,REP,110013,0,0,1,1,
Cherokee,U.S. Senate,Andy Craig,REP,110013,0,0,0,0,
Cherokee,U.S. Senate,T. Shannon,REP,110013,0,2,26,28,
Cherokee,U.S. Senate,Randy Brogdon,REP,110013,0,1,3,4,
Cherokee,U.S. Senate,Eric Mccray,REP,110013,0,0,1,1,
Cherokee,U.S. Senate,Kevin Crow,REP,110013,0,0,2,2,
Cherokee,U.S. Senate,James Lankford,REP,110013,2,3,21,26,
Cherokee,U.S. Senate,Jason Weger,REP,110013,0,0,0,0,
Cherokee,U.S. House,Darrel Robertson,REP,110013,0,0,7,7,02
Cherokee,U.S. House,Markwayne Mullin,REP,110013,2,6,46,54,02
Cherokee,Superintendent of Public Instruction,John Cox,DEM,110014,2,2,93,97,
Cherokee,Superintendent of Public Instruction,Jack Jr.,DEM,110014,0,0,9,9,
Cherokee,Superintendent of Public Instruction,Ivan Holmes,DEM,110014,0,0,5,5,
Cherokee,Superintendent of Public Instruction,Freda Deskin,DEM,110014,0,0,14,14,
Cherokee,U.S. Senate,Patrick Michael Hayes,DEM,110014,2,1,25,28,
Cherokee,U.S. Senate,Jim Rogers,DEM,110014,0,0,57,57,
Cherokee,U.S. Senate,Connie Johnson,DEM,110014,0,1,38,39,
Cherokee,U.S. House,Earl Everett,DEM,110014,2,1,75,78,02
Cherokee,U.S. House,Joshua Harris-Till,DEM,110014,0,1,42,43,02
Cherokee,Governor,Dax Ewbank,REP,110014,0,1,8,9,
Cherokee,Governor,Chad Moody,REP,110014,0,0,11,11,
Cherokee,Governor,Mary Fallin,REP,110014,2,3,45,50,
Cherokee,Superintendent of Public Instruction,Brian Kelly,REP,110014,0,0,21,21,
Cherokee,Superintendent of Public Instruction,Janet Costello Barresi,REP,110014,2,2,15,19,
Cherokee,Superintendent of Public Instruction,Joy Hofmeister,REP,110014,0,2,25,27,
Cherokee,Insurance Commissioner,Bill Viner,REP,110014,0,1,18,19,
Cherokee,Insurance Commissioner,John Doak,REP,110014,2,3,44,49,
Cherokee,Corporation Commissioner,Todd Hiett,REP,110014,2,2,29,33,
Cherokee,Corporation Commissioner,Cliff Branan,REP,110014,0,2,32,34,
Cherokee,U.S. Senate,Evelyn Rogers,REP,110014,0,0,3,3,
Cherokee,U.S. Senate,Rob Moye,REP,110014,0,0,0,0,
Cherokee,U.S. Senate,D. Jean Mcbride-Samuels,REP,110014,0,0,3,3,
Cherokee,U.S. Senate,Jim Inhofe,REP,110014,2,2,51,55,
Cherokee,U.S. Senate,Erick Paul Wyatt,REP,110014,0,1,6,7,
Cherokee,U.S. Senate,Andy Craig,REP,110014,0,1,0,1,
Cherokee,U.S. Senate,T. Shannon,REP,110014,2,1,29,32,
Cherokee,U.S. Senate,Randy Brogdon,REP,110014,0,1,2,3,
Cherokee,U.S. Senate,Eric Mccray,REP,110014,0,0,1,1,
Cherokee,U.S. Senate,Kevin Crow,REP,110014,0,0,0,0,
Cherokee,U.S. Senate,James Lankford,REP,110014,0,1,28,29,
Cherokee,U.S. Senate,Jason Weger,REP,110014,0,0,1,1,
Cherokee,U.S. House,Darrel Robertson,REP,110014,0,2,16,18,02
Cherokee,U.S. House,Markwayne Mullin,REP,110014,2,3,47,52,02
Cherokee,Superintendent of Public Instruction,John Cox,DEM,110015,0,2,80,82,
Cherokee,Superintendent of Public Instruction,Jack Jr.,DEM,110015,0,0,11,11,
Cherokee,Superintendent of Public Instruction,Ivan Holmes,DEM,110015,0,0,3,3,
Cherokee,Superintendent of Public Instruction,Freda Deskin,DEM,110015,0,0,35,35,
Cherokee,U.S. Senate,Patrick Michael Hayes,DEM,110015,0,0,30,30,
Cherokee,U.S. Senate,Jim Rogers,DEM,110015,0,2,62,64,
Cherokee,U.S. Senate,Connie Johnson,DEM,110015,0,0,34,34,
Cherokee,U.S. House,Earl Everett,DEM,110015,0,1,81,82,02
Cherokee,U.S. House,Joshua Harris-Till,DEM,110015,0,1,42,43,02
Cherokee,Governor,Dax Ewbank,REP,110015,2,0,9,11,
Cherokee,Governor,Chad Moody,REP,110015,0,2,20,22,
Cherokee,Governor,Mary Fallin,REP,110015,0,3,88,91,
Cherokee,Superintendent of Public Instruction,Brian Kelly,REP,110015,0,0,28,28,
Cherokee,Superintendent of Public Instruction,Janet Costello Barresi,REP,110015,0,2,13,15,
Cherokee,Superintendent of Public Instruction,Joy Hofmeister,REP,110015,2,3,78,83,
Cherokee,Insurance Commissioner,Bill Viner,REP,110015,0,1,27,28,
Cherokee,Insurance Commissioner,John Doak,REP,110015,2,4,87,93,
Cherokee,Corporation Commissioner,Todd Hiett,REP,110015,0,2,63,65,
Cherokee,Corporation Commissioner,Cliff Branan,REP,110015,2,3,46,51,
Cherokee,U.S. Senate,Evelyn Rogers,REP,110015,0,0,3,3,
Cherokee,U.S. Senate,Rob Moye,REP,110015,0,0,2,2,
Cherokee,U.S. Senate,D. Jean Mcbride-Samuels,REP,110015,0,0,2,2,
Cherokee,U.S. Senate,Jim Inhofe,REP,110015,2,4,106,112,
Cherokee,U.S. Senate,Erick Paul Wyatt,REP,110015,0,1,6,7,
Cherokee,U.S. Senate,Andy Craig,REP,110015,0,0,1,1,
Cherokee,U.S. Senate,T. Shannon,REP,110015,0,3,54,57,
Cherokee,U.S. Senate,Randy Brogdon,REP,110015,0,0,0,0,
Cherokee,U.S. Senate,Eric Mccray,REP,110015,0,0,0,0,
Cherokee,U.S. Senate,Kevin Crow,REP,110015,0,0,4,4,
Cherokee,U.S. Senate,James Lankford,REP,110015,2,2,60,64,
Cherokee,U.S. Senate,Jason Weger,REP,110015,0,0,1,1,
Cherokee,U.S. House,Darrel Robertson,REP,110015,2,1,25,28,02
Cherokee,U.S. House,Markwayne Mullin,REP,110015,0,4,94,98,02
Cherokee,Superintendent of Public Instruction,John Cox,DEM,110016,0,7,97,104,
Cherokee,Superintendent of Public Instruction,Jack Jr.,DEM,110016,0,0,0,0,
Cherokee,Superintendent of Public Instruction,Ivan Holmes,DEM,110016,0,0,1,1,
Cherokee,Superintendent of Public Instruction,Freda Deskin,DEM,110016,0,0,17,17,
Cherokee,U.S. Senate,Patrick Michael Hayes,DEM,110016,0,3,32,35,
Cherokee,U.S. Senate,Jim Rogers,DEM,110016,0,1,36,37,
Cherokee,U.S. Senate,Connie Johnson,DEM,110016,0,3,33,36,
Cherokee,U.S. House,Earl Everett,DEM,110016,0,3,52,55,02
Cherokee,U.S. House,Joshua Harris-Till,DEM,110016,0,4,48,52,02
Cherokee,Governor,Dax Ewbank,REP,110016,0,0,6,6,
Cherokee,Governor,Chad Moody,REP,110016,0,1,6,7,
Cherokee,Governor,Mary Fallin,REP,110016,3,0,17,20,
Cherokee,Superintendent of Public Instruction,Brian Kelly,REP,110016,1,0,5,6,
Cherokee,Superintendent of Public Instruction,Janet Costello Barresi,REP,110016,2,0,6,8,
Cherokee,Superintendent of Public Instruction,Joy Hofmeister,REP,110016,0,1,19,20,
Cherokee,Insurance Commissioner,Bill Viner,REP,110016,0,0,11,11,
Cherokee,Insurance Commissioner,John Doak,REP,110016,3,1,16,20,
Cherokee,Corporation Commissioner,Todd Hiett,REP,110016,2,0,19,21,
Cherokee,Corporation Commissioner,Cliff Branan,REP,110016,1,1,8,10,
Cherokee,U.S. Senate,Evelyn Rogers,REP,110016,0,0,1,1,
Cherokee,U.S. Senate,Rob Moye,REP,110016,0,0,0,0,
Cherokee,U.S. Senate,D. Jean Mcbride-Samuels,REP,110016,0,0,0,0,
Cherokee,U.S. Senate,Jim Inhofe,REP,110016,3,1,22,26,
Cherokee,U.S. Senate,Erick Paul Wyatt,REP,110016,0,0,5,5,
Cherokee,U.S. Senate,Andy Craig,REP,110016,0,0,0,0,
Cherokee,U.S. Senate,T. Shannon,REP,110016,0,1,13,14,
Cherokee,U.S. Senate,Randy Brogdon,REP,110016,0,0,7,7,
Cherokee,U.S. Senate,Eric Mccray,REP,110016,0,0,0,0,
Cherokee,U.S. Senate,Kevin Crow,REP,110016,0,0,0,0,
Cherokee,U.S. Senate,James Lankford,REP,110016,3,0,10,13,
Cherokee,U.S. Senate,Jason Weger,REP,110016,0,0,0,0,
Cherokee,U.S. House,Darrel Robertson,REP,110016,0,0,0,0,02
Cherokee,U.S. House,Markwayne Mullin,REP,110016,3,1,27,31,02
Cherokee,Superintendent of Public Instruction,John Cox,DEM,110017,0,1,28,29,
Cherokee,Superintendent of Public Instruction,Jack Jr.,DEM,110017,0,0,4,4,
Cherokee,Superintendent of Public Instruction,Ivan Holmes,DEM,110017,0,0,4,4,
Cherokee,Superintendent of Public Instruction,Freda Deskin,DEM,110017,0,1,11,12,
Cherokee,U.S. Senate,Patrick Michael Hayes,DEM,110017,0,0,12,12,
Cherokee,U.S. Senate,Jim Rogers,DEM,110017,0,2,21,23,
Cherokee,U.S. Senate,Connie Johnson,DEM,110017,0,0,13,13,
Cherokee,U.S. House,Earl Everett,DEM,110017,0,2,27,29,02
Cherokee,U.S. House,Joshua Harris-Till,DEM,110017,0,0,19,19,02
Cherokee,Governor,Dax Ewbank,REP,110017,0,0,0,0,
Cherokee,Governor,Chad Moody,REP,110017,0,1,6,7,
Cherokee,Governor,Mary Fallin,REP,110017,0,1,18,19,
Cherokee,Superintendent of Public Instruction,Brian Kelly,REP,110017,0,2,8,10,
Cherokee,Superintendent of Public Instruction,Janet Costello Barresi,REP,110017,0,0,2,2,
Cherokee,Superintendent of Public Instruction,Joy Hofmeister,REP,110017,0,0,14,14,
Cherokee,Insurance Commissioner,Bill Viner,REP,110017,0,0,4,4,
Cherokee,Insurance Commissioner,John Doak,REP,110017,0,2,20,22,
Cherokee,Corporation Commissioner,Todd Hiett,REP,110017,0,1,11,12,
Cherokee,Corporation Commissioner,Cliff Branan,REP,110017,0,1,13,14,
Cherokee,U.S. Senate,Evelyn Rogers,REP,110017,0,1,1,2,
Cherokee,U.S. Senate,Rob Moye,REP,110017,0,0,1,1,
Cherokee,U.S. Senate,D. Jean Mcbride-Samuels,REP,110017,0,0,0,0,
Cherokee,U.S. Senate,Jim Inhofe,REP,110017,0,1,21,22,
Cherokee,U.S. Senate,Erick Paul Wyatt,REP,110017,0,0,1,1,
Cherokee,U.S. Senate,Andy Craig,REP,110017,0,0,0,0,
Cherokee,U.S. Senate,T. Shannon,REP,110017,0,1,11,12,
Cherokee,U.S. Senate,Randy Brogdon,REP,110017,0,0,1,1,
Cherokee,U.S. Senate,Eric Mccray,REP,110017,0,0,0,0,
Cherokee,U.S. Senate,Kevin Crow,REP,110017,0,0,2,2,
Cherokee,U.S. Senate,James Lankford,REP,110017,0,1,10,11,
Cherokee,U.S. Senate,Jason Weger,REP,110017,0,0,0,0,
Cherokee,U.S. House,Darrel Robertson,REP,110017,0,0,2,2,02
Cherokee,U.S. House,Markwayne Mullin,REP,110017,0,2,22,24,02
Cherokee,Superintendent of Public Instruction,John Cox,DEM,110018,0,2,22,24,
Cherokee,Superintendent of Public Instruction,Jack Jr.,DEM,110018,0,2,1,3,
Cherokee,Superintendent of Public Instruction,Ivan Holmes,DEM,110018,0,1,0,1,
Cherokee,Superintendent of Public Instruction,Freda Deskin,DEM,110018,0,0,9,9,
Cherokee,U.S. Senate,Patrick Michael Hayes,DEM,110018,0,1,7,8,
Cherokee,U.S. Senate,Jim Rogers,DEM,110018,0,3,13,16,
Cherokee,U.S. Senate,Connie Johnson,DEM,110018,0,0,11,11,
Cherokee,U.S. House,Earl Everett,DEM,110018,0,3,19,22,02
Cherokee,U.S. House,Joshua Harris-Till,DEM,110018,0,1,11,12,02
Cherokee,Governor,Dax Ewbank,REP,110018,0,0,1,1,
Cherokee,Governor,Chad Moody,REP,110018,0,1,8,9,
Cherokee,Governor,Mary Fallin,REP,110018,0,2,18,20,
Cherokee,Superintendent of Public Instruction,Brian Kelly,REP,110018,0,1,14,15,
Cherokee,Superintendent of Public Instruction,Janet Costello Barresi,REP,110018,0,0,4,4,
Cherokee,Superintendent of Public Instruction,Joy Hofmeister,REP,110018,0,3,9,12,
Cherokee,Insurance Commissioner,Bill Viner,REP,110018,0,1,10,11,
Cherokee,Insurance Commissioner,John Doak,REP,110018,0,1,16,17,
Cherokee,Corporation Commissioner,Todd Hiett,REP,110018,0,0,11,11,
Cherokee,Corporation Commissioner,Cliff Branan,REP,110018,0,3,14,17,
Cherokee,U.S. Senate,Evelyn Rogers,REP,110018,0,1,4,5,
Cherokee,U.S. Senate,Rob Moye,REP,110018,0,0,4,4,
Cherokee,U.S. Senate,D. Jean Mcbride-Samuels,REP,110018,0,0,0,0,
Cherokee,U.S. Senate,Jim Inhofe,REP,110018,0,3,14,17,
Cherokee,U.S. Senate,Erick Paul Wyatt,REP,110018,0,0,5,5,
Cherokee,U.S. Senate,Andy Craig,REP,110018,0,0,1,1,
Cherokee,U.S. Senate,T. Shannon,REP,110018,0,3,13,16,
Cherokee,U.S. Senate,Randy Brogdon,REP,110018,0,0,0,0,
Cherokee,U.S. Senate,Eric Mccray,REP,110018,0,0,0,0,
Cherokee,U.S. Senate,Kevin Crow,REP,110018,0,0,2,2,
Cherokee,U.S. Senate,James Lankford,REP,110018,0,1,8,9,
Cherokee,U.S. Senate,Jason Weger,REP,110018,0,0,2,2,
Cherokee,U.S. House,Darrel Robertson,REP,110018,0,2,5,7,02
Cherokee,U.S. House,Markwayne Mullin,REP,110018,0,2,20,22,02
Cherokee,Superintendent of Public Instruction,John Cox,DEM,110019,1,9,60,70,
Cherokee,Superintendent of Public Instruction,Jack Jr.,DEM,110019,0,0,13,13,
Cherokee,Superintendent of Public Instruction,Ivan Holmes,DEM,110019,1,0,9,10,
Cherokee,Superintendent of Public Instruction,Freda Deskin,DEM,110019,0,1,18,19,
Cherokee,U.S. Senate,Patrick Michael Hayes,DEM,110019,0,0,11,11,
Cherokee,U.S. Senate,Jim Rogers,DEM,110019,2,4,58,64,
Cherokee,U.S. Senate,Connie Johnson,DEM,110019,0,6,29,35,
Cherokee,U.S. House,Earl Everett,DEM,110019,2,4,63,69,02
Cherokee,U.S. House,Joshua Harris-Till,DEM,110019,0,6,34,40,02
Cherokee,Governor,Dax Ewbank,REP,110019,0,0,5,5,
Cherokee,Governor,Chad Moody,REP,110019,0,1,10,11,
Cherokee,Governor,Mary Fallin,REP,110019,0,6,36,42,
Cherokee,Superintendent of Public Instruction,Brian Kelly,REP,110019,0,0,11,11,
Cherokee,Superintendent of Public Instruction,Janet Costello Barresi,REP,110019,0,3,5,8,
Cherokee,Superintendent of Public Instruction,Joy Hofmeister,REP,110019,0,4,34,38,
Cherokee,Insurance Commissioner,Bill Viner,REP,110019,0,0,9,9,
Cherokee,Insurance Commissioner,John Doak,REP,110019,0,7,41,48,
Cherokee,Corporation Commissioner,Todd Hiett,REP,110019,0,4,25,29,
Cherokee,Corporation Commissioner,Cliff Branan,REP,110019,0,3,24,27,
Cherokee,U.S. Senate,Evelyn Rogers,REP,110019,0,0,3,3,
Cherokee,U.S. Senate,Rob Moye,REP,110019,0,0,2,2,
Cherokee,U.S. Senate,D. Jean Mcbride-Samuels,REP,110019,0,0,1,1,
Cherokee,U.S. Senate,Jim Inhofe,REP,110019,0,6,39,45,
Cherokee,U.S. Senate,Erick Paul Wyatt,REP,110019,0,1,6,7,
Cherokee,U.S. Senate,Andy Craig,REP,110019,0,1,0,1,
Cherokee,U.S. Senate,T. Shannon,REP,110019,0,1,27,28,
Cherokee,U.S. Senate,Randy Brogdon,REP,110019,0,0,2,2,
Cherokee,U.S. Senate,Eric Mccray,REP,110019,0,0,0,0,
Cherokee,U.S. Senate,Kevin Crow,REP,110019,0,0,0,0,
Cherokee,U.S. Senate,James Lankford,REP,110019,0,5,22,27,
Cherokee,U.S. Senate,Jason Weger,REP,110019,0,0,0,0,
Cherokee,U.S. House,Darrel Robertson,REP,110019,0,0,11,11,02
Cherokee,U.S. House,Markwayne Mullin,REP,110019,0,7,40,47,02
Cherokee,Superintendent of Public Instruction,John Cox,DEM,110020,2,9,89,100,
Cherokee,Superintendent of Public Instruction,Jack Jr.,DEM,110020,0,4,6,10,
Cherokee,Superintendent of Public Instruction,Ivan Holmes,DEM,110020,0,1,10,11,
Cherokee,Superintendent of Public Instruction,Freda Deskin,DEM,110020,1,4,25,30,
Cherokee,U.S. Senate,Patrick Michael Hayes,DEM,110020,0,2,19,21,
Cherokee,U.S. Senate,Jim Rogers,DEM,110020,1,13,68,82,
Cherokee,U.S. Senate,Connie Johnson,DEM,110020,2,3,39,44,
Cherokee,U.S. House,Earl Everett,DEM,110020,2,9,76,87,02
Cherokee,U.S. House,Joshua Harris-Till,DEM,110020,1,9,47,57,02
Cherokee,Governor,Dax Ewbank,REP,110020,0,3,9,12,
Cherokee,Governor,Chad Moody,REP,110020,0,1,13,14,
Cherokee,Governor,Mary Fallin,REP,110020,0,9,58,67,
Cherokee,Superintendent of Public Instruction,Brian Kelly,REP,110020,0,1,22,23,
Cherokee,Superintendent of Public Instruction,Janet Costello Barresi,REP,110020,0,3,9,12,
Cherokee,Superintendent of Public Instruction,Joy Hofmeister,REP,110020,0,9,49,58,
Cherokee,Insurance Commissioner,Bill Viner,REP,110020,0,3,20,23,
Cherokee,Insurance Commissioner,John Doak,REP,110020,0,9,53,62,
Cherokee,Corporation Commissioner,Todd Hiett,REP,110020,0,4,42,46,
Cherokee,Corporation Commissioner,Cliff Branan,REP,110020,0,6,30,36,
Cherokee,U.S. Senate,Evelyn Rogers,REP,110020,0,0,4,4,
Cherokee,U.S. Senate,Rob Moye,REP,110020,0,0,0,0,
Cherokee,U.S. Senate,D. Jean Mcbride-Samuels,REP,110020,0,0,3,3,
Cherokee,U.S. Senate,Jim Inhofe,REP,110020,0,11,70,81,
Cherokee,U.S. Senate,Erick Paul Wyatt,REP,110020,0,2,3,5,
Cherokee,U.S. Senate,Andy Craig,REP,110020,0,0,0,0,
Cherokee,U.S. Senate,T. Shannon,REP,110020,0,9,36,45,
Cherokee,U.S. Senate,Randy Brogdon,REP,110020,0,1,2,3,
Cherokee,U.S. Senate,Eric Mccray,REP,110020,0,0,1,1,
Cherokee,U.S. Senate,Kevin Crow,REP,110020,0,1,2,3,
Cherokee,U.S. Senate,James Lankford,REP,110020,0,2,35,37,
Cherokee,U.S. Senate,Jason Weger,REP,110020,0,0,4,4,
Cherokee,U.S. House,Darrel Robertson,REP,110020,0,1,14,15,02
Cherokee,U.S. House,Markwayne Mullin,REP,110020,0,12,66,78,02
Cherokee,Superintendent of Public Instruction,John Cox,DEM,110021,0,1,68,69,
Cherokee,Superintendent of Public Instruction,Jack Jr.,DEM,110021,0,0,3,3,
Cherokee,Superintendent of Public Instruction,Ivan Holmes,DEM,110021,0,0,3,3,
Cherokee,Superintendent of Public Instruction,Freda Deskin,DEM,110021,0,1,14,15,
Cherokee,U.S. Senate,Patrick Michael Hayes,DEM,110021,0,1,18,19,
Cherokee,U.S. Senate,Jim Rogers,DEM,110021,0,1,32,33,
Cherokee,U.S. Senate,Connie Johnson,DEM,110021,0,0,30,30,
Cherokee,U.S. House,Earl Everett,DEM,110021,0,1,50,51,02
Cherokee,U.S. House,Joshua Harris-Till,DEM,110021,0,1,28,29,02
Cherokee,Governor,Dax Ewbank,REP,110021,0,0,3,3,
Cherokee,Governor,Chad Moody,REP,110021,0,0,7,7,
Cherokee,Governor,Mary Fallin,REP,110021,0,0,26,26,
Cherokee,Superintendent of Public Instruction,Brian Kelly,REP,110021,0,0,9,9,
Cherokee,Superintendent of Public Instruction,Janet Costello Barresi,REP,110021,0,0,8,8,
Cherokee,Superintendent of Public Instruction,Joy Hofmeister,REP,110021,0,0,17,17,
Cherokee,Insurance Commissioner,Bill Viner,REP,110021,0,0,6,6,
Cherokee,Insurance Commissioner,John Doak,REP,110021,0,0,25,25,
Cherokee,Corporation Commissioner,Todd Hiett,REP,110021,0,0,14,14,
Cherokee,Corporation Commissioner,Cliff Branan,REP,110021,0,0,19,19,
Cherokee,U.S. Senate,Evelyn Rogers,REP,110021,0,0,2,2,
Cherokee,U.S. Senate,Rob Moye,REP,110021,0,0,0,0,
Cherokee,U.S. Senate,D. Jean Mcbride-Samuels,REP,110021,0,0,0,0,
Cherokee,U.S. Senate,Jim Inhofe,REP,110021,0,0,28,28,
Cherokee,U.S. Senate,Erick Paul Wyatt,REP,110021,0,0,6,6,
Cherokee,U.S. Senate,Andy Craig,REP,110021,0,0,0,0,
Cherokee,U.S. Senate,T. Shannon,REP,110021,0,0,15,15,
Cherokee,U.S. Senate,Randy Brogdon,REP,110021,0,0,5,5,
Cherokee,U.S. Senate,Eric Mccray,REP,110021,0,0,1,1,
Cherokee,U.S. Senate,Kevin Crow,REP,110021,0,0,1,1,
Cherokee,U.S. Senate,James Lankford,REP,110021,0,0,13,13,
Cherokee,U.S. Senate,Jason Weger,REP,110021,0,0,0,0,
Cherokee,U.S. House,Darrel Robertson,REP,110021,0,0,7,7,02
Cherokee,U.S. House,Markwayne Mullin,REP,110021,0,0,30,30,02
Cherokee,Superintendent of Public Instruction,John Cox,DEM,110022,0,0,45,45,
Cherokee,Superintendent of Public Instruction,Jack Jr.,DEM,110022,0,1,6,7,
Cherokee,Superintendent of Public Instruction,Ivan Holmes,DEM,110022,0,0,9,9,
Cherokee,Superintendent of Public Instruction,Freda Deskin,DEM,110022,0,0,21,21,
Cherokee,U.S. Senate,Patrick Michael Hayes,DEM,110022,0,0,15,15,
Cherokee,U.S. Senate,Jim Rogers,DEM,110022,0,1,42,43,
Cherokee,U.S. Senate,Connie Johnson,DEM,110022,0,0,18,18,
Cherokee,U.S. House,Earl Everett,DEM,110022,0,0,44,44,02
Cherokee,U.S. House,Joshua Harris-Till,DEM,110022,0,1,27,28,02
Cherokee,Governor,Dax Ewbank,REP,110022,0,0,1,1,
Cherokee,Governor,Chad Moody,REP,110022,0,0,10,10,
Cherokee,Governor,Mary Fallin,REP,110022,1,0,19,20,
Cherokee,Superintendent of Public Instruction,Brian Kelly,REP,110022,0,1,13,14,
Cherokee,Superintendent of Public Instruction,Janet Costello Barresi,REP,110022,0,0,3,3,
Cherokee,Superintendent of Public Instruction,Joy Hofmeister,REP,110022,1,0,14,15,
Cherokee,Insurance Commissioner,Bill Viner,REP,110022,1,1,9,11,
Cherokee,Insurance Commissioner,John Doak,REP,110022,0,0,22,22,
Cherokee,Corporation Commissioner,Todd Hiett,REP,110022,0,0,16,16,
Cherokee,Corporation Commissioner,Cliff Branan,REP,110022,1,1,14,16,
Cherokee,U.S. Senate,Evelyn Rogers,REP,110022,0,0,0,0,
Cherokee,U.S. Senate,Rob Moye,REP,110022,0,0,0,0,
Cherokee,U.S. Senate,D. Jean Mcbride-Samuels,REP,110022,0,0,1,1,
Cherokee,U.S. Senate,Jim Inhofe,REP,110022,1,0,27,28,
Cherokee,U.S. Senate,Erick Paul Wyatt,REP,110022,0,1,3,4,
Cherokee,U.S. Senate,Andy Craig,REP,110022,0,0,1,1,
Cherokee,U.S. Senate,T. Shannon,REP,110022,0,1,8,9,
Cherokee,U.S. Senate,Randy Brogdon,REP,110022,0,0,0,0,
Cherokee,U.S. Senate,Eric Mccray,REP,110022,0,0,1,1,
Cherokee,U.S. Senate,Kevin Crow,REP,110022,1,0,0,1,
Cherokee,U.S. Senate,James Lankford,REP,110022,0,0,20,20,
Cherokee,U.S. Senate,Jason Weger,REP,110022,0,0,0,0,
Cherokee,U.S. House,Darrel Robertson,REP,110022,0,0,2,2,02
Cherokee,U.S. House,Markwayne Mullin,REP,110022,1,1,29,31,02
Cherokee,Superintendent of Public Instruction,John Cox,DEM,110023,0,12,47,59,
Cherokee,Superintendent of Public Instruction,Jack Jr.,DEM,110023,0,2,2,4,
Cherokee,Superintendent of Public Instruction,Ivan Holmes,DEM,110023,0,0,3,3,
Cherokee,Superintendent of Public Instruction,Freda Deskin,DEM,110023,0,2,4,6,
Cherokee,U.S. Senate,Patrick Michael Hayes,DEM,110023,0,1,12,13,
Cherokee,U.S. Senate,Jim Rogers,DEM,110023,0,8,22,30,
Cherokee,U.S. Senate,Connie Johnson,DEM,110023,0,6,20,26,
Cherokee,U.S. House,Earl Everett,DEM,110023,0,8,31,39,02
Cherokee,U.S. House,Joshua Harris-Till,DEM,110023,0,7,21,28,02
Cherokee,Governor,Dax Ewbank,REP,110023,0,0,5,5,
Cherokee,Governor,Chad Moody,REP,110023,0,1,5,6,
Cherokee,Governor,Mary Fallin,REP,110023,1,0,17,18,
Cherokee,Superintendent of Public Instruction,Brian Kelly,REP,110023,0,0,16,16,
Cherokee,Superintendent of Public Instruction,Janet Costello Barresi,REP,110023,0,1,3,4,
Cherokee,Superintendent of Public Instruction,Joy Hofmeister,REP,110023,1,0,8,9,
Cherokee,Insurance Commissioner,Bill Viner,REP,110023,0,0,5,5,
Cherokee,Insurance Commissioner,John Doak,REP,110023,1,1,22,24,
Cherokee,Corporation Commissioner,Todd Hiett,REP,110023,1,0,19,20,
Cherokee,Corporation Commissioner,Cliff Branan,REP,110023,0,1,7,8,
Cherokee,U.S. Senate,Evelyn Rogers,REP,110023,0,0,4,4,
Cherokee,U.S. Senate,Rob Moye,REP,110023,0,0,1,1,
Cherokee,U.S. Senate,D. Jean Mcbride-Samuels,REP,110023,0,0,0,0,
Cherokee,U.S. Senate,Jim Inhofe,REP,110023,1,1,23,25,
Cherokee,U.S. Senate,Erick Paul Wyatt,REP,110023,0,0,0,0,
Cherokee,U.S. Senate,Andy Craig,REP,110023,0,0,1,1,
Cherokee,U.S. Senate,T. Shannon,REP,110023,0,1,16,17,
Cherokee,U.S. Senate,Randy Brogdon,REP,110023,0,0,2,2,
Cherokee,U.S. Senate,Eric Mccray,REP,110023,0,0,1,1,
Cherokee,U.S. Senate,Kevin Crow,REP,110023,0,0,0,0,
Cherokee,U.S. Senate,James Lankford,REP,110023,1,0,5,6,
Cherokee,U.S. Senate,Jason Weger,REP,110023,0,0,3,3,
Cherokee,U.S. House,Darrel Robertson,REP,110023,0,0,4,4,02
Cherokee,U.S. House,Markwayne Mullin,REP,110023,1,1,24,26,02
Cherokee,Superintendent of Public Instruction,John Cox,DEM,110025,3,17,93,113,
Cherokee,Superintendent of Public Instruction,Jack Jr.,DEM,110025,0,0,9,9,
Cherokee,Superintendent of Public Instruction,Ivan Holmes,DEM,110025,1,0,9,10,
Cherokee,Superintendent of Public Instruction,Freda Deskin,DEM,110025,0,0,22,22,
Cherokee,U.S. Senate,Patrick Michael Hayes,DEM,110025,3,7,19,29,
Cherokee,U.S. Senate,Jim Rogers,DEM,110025,1,6,83,90,
Cherokee,U.S. Senate,Connie Johnson,DEM,110025,0,1,27,28,
Cherokee,U.S. House,Earl Everett,DEM,110025,4,6,86,96,02
Cherokee,U.S. House,Joshua Harris-Till,DEM,110025,0,9,43,52,02
Cherokee,Governor,Dax Ewbank,REP,110025,0,0,9,9,
Cherokee,Governor,Chad Moody,REP,110025,0,0,2,2,
Cherokee,Governor,Mary Fallin,REP,110025,0,3,18,21,
Cherokee,Superintendent of Public Instruction,Brian Kelly,REP,110025,0,0,10,10,
Cherokee,Superintendent of Public Instruction,Janet Costello Barresi,REP,110025,0,2,3,5,
Cherokee,Superintendent of Public Instruction,Joy Hofmeister,REP,110025,0,1,16,17,
Cherokee,Insurance Commissioner,Bill Viner,REP,110025,0,0,8,8,
Cherokee,Insurance Commissioner,John Doak,REP,110025,0,3,21,24,
Cherokee,Corporation Commissioner,Todd Hiett,REP,110025,0,3,8,11,
Cherokee,Corporation Commissioner,Cliff Branan,REP,110025,0,0,20,20,
Cherokee,U.S. Senate,Evelyn Rogers,REP,110025,0,0,0,0,
Cherokee,U.S. Senate,Rob Moye,REP,110025,0,0,1,1,
Cherokee,U.S. Senate,D. Jean Mcbride-Samuels,REP,110025,0,0,2,2,
Cherokee,U.S. Senate,Jim Inhofe,REP,110025,0,3,21,24,
Cherokee,U.S. Senate,Erick Paul Wyatt,REP,110025,0,0,4,4,
Cherokee,U.S. Senate,Andy Craig,REP,110025,0,0,0,0,
Cherokee,U.S. Senate,T. Shannon,REP,110025,0,1,15,16,
Cherokee,U.S. Senate,Randy Brogdon,REP,110025,0,0,2,2,
Cherokee,U.S. Senate,Eric Mccray,REP,110025,0,0,0,0,
Cherokee,U.S. Senate,Kevin Crow,REP,110025,0,0,3,3,
Cherokee,U.S. Senate,James Lankford,REP,110025,0,2,9,11,
Cherokee,U.S. Senate,Jason Weger,REP,110025,0,0,0,0,
Cherokee,U.S. House,Darrel Robertson,REP,110025,0,0,6,6,02
Cherokee,U.S. House,Markwayne Mullin,REP,110025,0,3,22,25,02
Choctaw,Superintendent of Public Instruction,John Cox,DEM,120101,0,2,50,52,
Choctaw,Superintendent of Public Instruction,Jack Jr.,DEM,120101,2,0,6,8,
Choctaw,Superintendent of Public Instruction,Ivan Holmes,DEM,120101,0,0,1,1,
Choctaw,Superintendent of Public Instruction,Freda Deskin,DEM,120101,1,0,19,20,
Choctaw,U.S. Senate,Patrick Michael Hayes,DEM,120101,1,2,18,21,
Choctaw,U.S. Senate,Jim Rogers,DEM,120101,2,0,30,32,
Choctaw,U.S. Senate,Connie Johnson,DEM,120101,0,0,16,16,
Choctaw,U.S. House,Earl Everett,DEM,120101,3,2,43,48,02
Choctaw,U.S. House,Joshua Harris-Till,DEM,120101,0,0,17,17,02
Choctaw,Governor,Dax Ewbank,REP,120101,1,2,4,7,
Choctaw,Governor,Chad Moody,REP,120101,0,0,4,4,
Choctaw,Governor,Mary Fallin,REP,120101,0,2,40,42,
Choctaw,Superintendent of Public Instruction,Brian Kelly,REP,120101,1,2,12,15,
Choctaw,Superintendent of Public Instruction,Janet Costello Barresi,REP,120101,0,0,7,7,
Choctaw,Superintendent of Public Instruction,Joy Hofmeister,REP,120101,0,2,24,26,
Choctaw,Insurance Commissioner,Bill Viner,REP,120101,0,0,6,6,
Choctaw,Insurance Commissioner,John Doak,REP,120101,1,4,31,36,
Choctaw,Corporation Commissioner,Todd Hiett,REP,120101,1,4,24,29,
Choctaw,Corporation Commissioner,Cliff Branan,REP,120101,0,0,14,14,
Choctaw,U.S. Senate,Evelyn Rogers,REP,120101,0,0,5,5,
Choctaw,U.S. Senate,Rob Moye,REP,120101,0,0,1,1,
Choctaw,U.S. Senate,D. Jean Mcbride-Samuels,REP,120101,0,0,1,1,
Choctaw,U.S. Senate,Jim Inhofe,REP,120101,0,2,34,36,
Choctaw,U.S. Senate,Erick Paul Wyatt,REP,120101,1,2,6,9,
Choctaw,U.S. Senate,Andy Craig,REP,120101,0,0,0,0,
Choctaw,U.S. Senate,T. Shannon,REP,120101,0,0,16,16,
Choctaw,U.S. Senate,Randy Brogdon,REP,120101,0,2,5,7,
Choctaw,U.S. Senate,Eric Mccray,REP,120101,0,0,1,1,
Choctaw,U.S. Senate,Kevin Crow,REP,120101,1,0,0,1,
Choctaw,U.S. Senate,James Lankford,REP,120101,0,2,24,26,
Choctaw,U.S. Senate,Jason Weger,REP,120101,0,0,1,1,
Choctaw,U.S. House,Darrel Robertson,REP,120101,1,1,11,13,02
Choctaw,U.S. House,Markwayne Mullin,REP,120101,0,3,36,39,02
Choctaw,State Senate,Joseph Silk,REP,120101,1,4,17,22,5
Choctaw,State Senate,Brent Shain,REP,120101,0,0,30,30,5
Choctaw,Superintendent of Public Instruction,John Cox,DEM,120104,0,0,54,54,
Choctaw,Superintendent of Public Instruction,Jack Jr.,DEM,120104,0,1,2,3,
Choctaw,Superintendent of Public Instruction,Ivan Holmes,DEM,120104,0,0,4,4,
Choctaw,Superintendent of Public Instruction,Freda Deskin,DEM,120104,0,0,26,26,
Choctaw,U.S. Senate,Patrick Michael Hayes,DEM,120104,0,0,15,15,
Choctaw,U.S. Senate,Jim Rogers,DEM,120104,0,1,41,42,
Choctaw,U.S. Senate,Connie Johnson,DEM,120104,0,0,21,21,
Choctaw,U.S. House,Earl Everett,DEM,120104,0,1,55,56,02
Choctaw,U.S. House,Joshua Harris-Till,DEM,120104,0,0,18,18,02
Choctaw,Governor,Dax Ewbank,REP,120104,0,0,3,3,
Choctaw,Governor,Chad Moody,REP,120104,0,0,4,4,
Choctaw,Governor,Mary Fallin,REP,120104,0,1,9,10,
Choctaw,Superintendent of Public Instruction,Brian Kelly,REP,120104,0,1,5,6,
Choctaw,Superintendent of Public Instruction,Janet Costello Barresi,REP,120104,0,0,1,1,
Choctaw,Superintendent of Public Instruction,Joy Hofmeister,REP,120104,0,0,9,9,
Choctaw,Insurance Commissioner,Bill Viner,REP,120104,0,0,5,5,
Choctaw,Insurance Commissioner,John Doak,REP,120104,0,1,7,8,
Choctaw,Corporation Commissioner,Todd Hiett,REP,120104,0,1,5,6,
Choctaw,Corporation Commissioner,Cliff Branan,REP,120104,0,0,7,7,
Choctaw,U.S. Senate,Evelyn Rogers,REP,120104,0,0,1,1,
Choctaw,U.S. Senate,Rob Moye,REP,120104,0,0,1,1,
Choctaw,U.S. Senate,D. Jean Mcbride-Samuels,REP,120104,0,0,0,0,
Choctaw,U.S. Senate,Jim Inhofe,REP,120104,0,1,10,11,
Choctaw,U.S. Senate,Erick Paul Wyatt,REP,120104,0,0,2,2,
Choctaw,U.S. Senate,Andy Craig,REP,120104,0,0,0,0,
Choctaw,U.S. Senate,T. Shannon,REP,120104,0,1,7,8,
Choctaw,U.S. Senate,Randy Brogdon,REP,120104,0,0,1,1,
Choctaw,U.S. Senate,Eric Mccray,REP,120104,0,0,1,1,
Choctaw,U.S. Senate,Kevin Crow,REP,120104,0,0,0,0,
Choctaw,U.S. Senate,James Lankford,REP,120104,0,0,3,3,
Choctaw,U.S. Senate,Jason Weger,REP,120104,0,0,1,1,
Choctaw,U.S. House,Darrel Robertson,REP,120104,0,0,8,8,02
Choctaw,U.S. House,Markwayne Mullin,REP,120104,0,1,8,9,02
Choctaw,State Senate,Joseph Silk,REP,120104,0,0,6,6,5
Choctaw,State Senate,Brent Shain,REP,120104,0,1,8,9,5
Choctaw,Superintendent of Public Instruction,John Cox,DEM,120105,0,2,8,10,
Choctaw,Superintendent of Public Instruction,Jack Jr.,DEM,120105,0,1,3,4,
Choctaw,Superintendent of Public Instruction,Ivan Holmes,DEM,120105,0,0,2,2,
Choctaw,Superintendent of Public Instruction,Freda Deskin,DEM,120105,0,1,9,10,
Choctaw,U.S. Senate,Patrick Michael Hayes,DEM,120105,0,0,6,6,
Choctaw,U.S. Senate,Jim Rogers,DEM,120105,0,3,6,9,
Choctaw,U.S. Senate,Connie Johnson,DEM,120105,0,1,10,11,
Choctaw,U.S. House,Earl Everett,DEM,120105,0,2,10,12,02
Choctaw,U.S. House,Joshua Harris-Till,DEM,120105,0,2,10,12,02
Choctaw,Governor,Dax Ewbank,REP,120105,0,0,0,0,
Choctaw,Governor,Chad Moody,REP,120105,1,0,2,3,
Choctaw,Governor,Mary Fallin,REP,120105,0,0,1,1,
Choctaw,Superintendent of Public Instruction,Brian Kelly,REP,120105,0,0,1,1,
Choctaw,Superintendent of Public Instruction,Janet Costello Barresi,REP,120105,1,0,1,2,
Choctaw,Superintendent of Public Instruction,Joy Hofmeister,REP,120105,0,0,0,0,
Choctaw,Insurance Commissioner,Bill Viner,REP,120105,0,0,2,2,
Choctaw,Insurance Commissioner,John Doak,REP,120105,1,0,0,1,
Choctaw,Corporation Commissioner,Todd Hiett,REP,120105,1,0,1,2,
Choctaw,Corporation Commissioner,Cliff Branan,REP,120105,0,0,1,1,
Choctaw,U.S. Senate,Evelyn Rogers,REP,120105,1,0,1,2,
Choctaw,U.S. Senate,Rob Moye,REP,120105,0,0,0,0,
Choctaw,U.S. Senate,D. Jean Mcbride-Samuels,REP,120105,0,0,0,0,
Choctaw,U.S. Senate,Jim Inhofe,REP,120105,0,0,0,0,
Choctaw,U.S. Senate,Erick Paul Wyatt,REP,120105,0,0,1,1,
Choctaw,U.S. Senate,Andy Craig,REP,120105,0,0,0,0,
Choctaw,U.S. Senate,T. Shannon,REP,120105,1,0,0,1,
Choctaw,U.S. Senate,Randy Brogdon,REP,120105,0,0,0,0,
Choctaw,U.S. Senate,Eric Mccray,REP,120105,0,0,0,0,
Choctaw,U.S. Senate,Kevin Crow,REP,120105,0,0,1,1,
Choctaw,U.S. Senate,James Lankford,REP,120105,0,0,1,1,
Choctaw,U.S. Senate,Jason Weger,REP,120105,0,0,0,0,
Choctaw,U.S. House,Darrel Robertson,REP,120105,1,0,1,2,02
Choctaw,U.S. House,Markwayne Mullin,REP,120105,0,0,2,2,02
Choctaw,State Senate,Joseph Silk,REP,120105,1,0,1,2,5
Choctaw,State Senate,Brent Shain,REP,120105,0,0,2,2,5
Choctaw,Superintendent of Public Instruction,John Cox,DEM,120106,1,2,15,18,
Choctaw,Superintendent of Public Instruction,Jack Jr.,DEM,120106,0,0,1,1,
Choctaw,Superintendent of Public Instruction,Ivan Holmes,DEM,120106,0,1,2,3,
Choctaw,Superintendent of Public Instruction,Freda Deskin,DEM,120106,0,0,13,13,
Choctaw,U.S. Senate,Patrick Michael Hayes,DEM,120106,0,2,11,13,
Choctaw,U.S. Senate,Jim Rogers,DEM,120106,1,0,10,11,
Choctaw,U.S. Senate,Connie Johnson,DEM,120106,0,1,10,11,
Choctaw,U.S. House,Earl Everett,DEM,120106,1,1,20,22,02
Choctaw,U.S. House,Joshua Harris-Till,DEM,120106,0,2,11,13,02
Choctaw,Governor,Dax Ewbank,REP,120106,0,0,2,2,
Choctaw,Governor,Chad Moody,REP,120106,0,0,3,3,
Choctaw,Governor,Mary Fallin,REP,120106,1,0,14,15,
Choctaw,Superintendent of Public Instruction,Brian Kelly,REP,120106,1,0,3,4,
Choctaw,Superintendent of Public Instruction,Janet Costello Barresi,REP,120106,0,0,2,2,
Choctaw,Superintendent of Public Instruction,Joy Hofmeister,REP,120106,0,0,12,12,
Choctaw,Insurance Commissioner,Bill Viner,REP,120106,1,0,4,5,
Choctaw,Insurance Commissioner,John Doak,REP,120106,0,0,13,13,
Choctaw,Corporation Commissioner,Todd Hiett,REP,120106,0,0,12,12,
Choctaw,Corporation Commissioner,Cliff Branan,REP,120106,1,0,5,6,
Choctaw,U.S. Senate,Evelyn Rogers,REP,120106,0,0,0,0,
Choctaw,U.S. Senate,Rob Moye,REP,120106,0,0,0,0,
Choctaw,U.S. Senate,D. Jean Mcbride-Samuels,REP,120106,0,0,0,0,
Choctaw,U.S. Senate,Jim Inhofe,REP,120106,1,0,18,19,
Choctaw,U.S. Senate,Erick Paul Wyatt,REP,120106,0,0,1,1,
Choctaw,U.S. Senate,Andy Craig,REP,120106,0,0,0,0,
Choctaw,U.S. Senate,T. Shannon,REP,120106,1,0,2,3,
Choctaw,U.S. Senate,Randy Brogdon,REP,120106,0,0,1,1,
Choctaw,U.S. Senate,Eric Mccray,REP,120106,0,0,1,1,
Choctaw,U.S. Senate,Kevin Crow,REP,120106,0,0,1,1,
Choctaw,U.S. Senate,James Lankford,REP,120106,0,0,14,14,
Choctaw,U.S. Senate,Jason Weger,REP,120106,0,0,0,0,
Choctaw,U.S. House,Darrel Robertson,REP,120106,0,0,5,5,02
Choctaw,U.S. House,Markwayne Mullin,REP,120106,1,0,14,15,02
Choctaw,State Senate,Joseph Silk,REP,120106,1,0,8,9,5
Choctaw,State Senate,Brent Shain,REP,120106,0,0,11,11,5
Choctaw,Superintendent of Public Instruction,John Cox,DEM,120207,0,0,4,4,
Choctaw,Superintendent of Public Instruction,Jack Jr.,DEM,120207,0,0,0,0,
Choctaw,Superintendent of Public Instruction,Ivan Holmes,DEM,120207,0,1,0,1,
Choctaw,Superintendent of Public Instruction,Freda Deskin,DEM,120207,0,0,5,5,
Choctaw,U.S. Senate,Patrick Michael Hayes,DEM,120207,0,1,0,1,
Choctaw,U.S. Senate,Jim Rogers,DEM,120207,0,0,3,3,
Choctaw,U.S. Senate,Connie Johnson,DEM,120207,0,0,6,6,
Choctaw,U.S. House,Earl Everett,DEM,120207,0,0,6,6,02
Choctaw,U.S. House,Joshua Harris-Till,DEM,120207,0,1,2,3,02
Choctaw,Governor,Dax Ewbank,REP,120207,0,0,0,0,
Choctaw,Governor,Chad Moody,REP,120207,0,0,0,0,
Choctaw,Governor,Mary Fallin,REP,120207,0,0,4,4,
Choctaw,Superintendent of Public Instruction,Brian Kelly,REP,120207,0,0,1,1,
Choctaw,Superintendent of Public Instruction,Janet Costello Barresi,REP,120207,0,0,2,2,
Choctaw,Superintendent of Public Instruction,Joy Hofmeister,REP,120207,0,0,1,1,
Choctaw,Insurance Commissioner,Bill Viner,REP,120207,0,0,4,4,
Choctaw,Insurance Commissioner,John Doak,REP,120207,0,0,0,0,
Choctaw,Corporation Commissioner,Todd Hiett,REP,120207,0,0,4,4,
Choctaw,Corporation Commissioner,Cliff Branan,REP,120207,0,0,0,0,
Choctaw,U.S. Senate,Evelyn Rogers,REP,120207,0,0,0,0,
Choctaw,U.S. Senate,Rob Moye,REP,120207,0,0,1,1,
Choctaw,U.S. Senate,D. Jean Mcbride-Samuels,REP,120207,0,0,0,0,
Choctaw,U.S. Senate,Jim Inhofe,REP,120207,0,0,3,3,
Choctaw,U.S. Senate,Erick Paul Wyatt,REP,120207,0,0,0,0,
Choctaw,U.S. Senate,Andy Craig,REP,120207,0,0,1,1,
Choctaw,U.S. Senate,T. Shannon,REP,120207,0,0,2,2,
Choctaw,U.S. Senate,Randy Brogdon,REP,120207,0,0,1,1,
Choctaw,U.S. Senate,Eric Mccray,REP,120207,0,0,0,0,
Choctaw,U.S. Senate,Kevin Crow,REP,120207,0,0,0,0,
Choctaw,U.S. Senate,James Lankford,REP,120207,0,0,0,0,
Choctaw,U.S. Senate,Jason Weger,REP,120207,0,0,0,0,
Choctaw,U.S. House,Darrel Robertson,REP,120207,0,0,1,1,02
Choctaw,U.S. House,Markwayne Mullin,REP,120207,0,0,3,3,02
Choctaw,State Senate,Joseph Silk,REP,120207,0,0,3,3,5
Choctaw,State Senate,Brent Shain,REP,120207,0,0,1,1,5
Choctaw,Superintendent of Public Instruction,John Cox,DEM,120208,0,2,30,32,
Choctaw,Superintendent of Public Instruction,Jack Jr.,DEM,120208,0,0,4,4,
Choctaw,Superintendent of Public Instruction,Ivan Holmes,DEM,120208,0,2,5,7,
Choctaw,Superintendent of Public Instruction,Freda Deskin,DEM,120208,0,2,8,10,
Choctaw,U.S. Senate,Patrick Michael Hayes,DEM,120208,0,1,15,16,
Choctaw,U.S. Senate,Jim Rogers,DEM,120208,0,2,20,22,
Choctaw,U.S. Senate,Connie Johnson,DEM,120208,0,3,8,11,
Choctaw,U.S. House,Earl Everett,DEM,120208,0,4,26,30,02
Choctaw,U.S. House,Joshua Harris-Till,DEM,120208,0,2,13,15,02
Choctaw,Governor,Dax Ewbank,REP,120208,0,3,0,3,
Choctaw,Governor,Chad Moody,REP,120208,0,1,1,2,
Choctaw,Governor,Mary Fallin,REP,120208,1,2,20,23,
Choctaw,Superintendent of Public Instruction,Brian Kelly,REP,120208,0,0,12,12,
Choctaw,Superintendent of Public Instruction,Janet Costello Barresi,REP,120208,1,0,2,3,
Choctaw,Superintendent of Public Instruction,Joy Hofmeister,REP,120208,0,6,6,12,
Choctaw,Insurance Commissioner,Bill Viner,REP,120208,1,2,6,9,
Choctaw,Insurance Commissioner,John Doak,REP,120208,0,4,13,17,
Choctaw,Corporation Commissioner,Todd Hiett,REP,120208,0,3,11,14,
Choctaw,Corporation Commissioner,Cliff Branan,REP,120208,1,3,8,12,
Choctaw,U.S. Senate,Evelyn Rogers,REP,120208,0,1,0,1,
Choctaw,U.S. Senate,Rob Moye,REP,120208,0,0,0,0,
Choctaw,U.S. Senate,D. Jean Mcbride-Samuels,REP,120208,0,0,0,0,
Choctaw,U.S. Senate,Jim Inhofe,REP,120208,1,3,21,25,
Choctaw,U.S. Senate,Erick Paul Wyatt,REP,120208,0,2,1,3,
Choctaw,U.S. Senate,Andy Craig,REP,120208,0,0,0,0,
Choctaw,U.S. Senate,T. Shannon,REP,120208,1,1,6,8,
Choctaw,U.S. Senate,Randy Brogdon,REP,120208,0,3,2,5,
Choctaw,U.S. Senate,Eric Mccray,REP,120208,0,1,0,1,
Choctaw,U.S. Senate,Kevin Crow,REP,120208,0,0,1,1,
Choctaw,U.S. Senate,James Lankford,REP,120208,0,1,12,13,
Choctaw,U.S. Senate,Jason Weger,REP,120208,0,0,1,1,
Choctaw,U.S. House,Darrel Robertson,REP,120208,1,4,5,10,02
Choctaw,U.S. House,Markwayne Mullin,REP,120208,0,2,15,17,02
Choctaw,State Senate,Joseph Silk,REP,120208,0,3,9,12,5
Choctaw,State Senate,Brent Shain,REP,120208,1,3,15,19,5
Choctaw,Superintendent of Public Instruction,John Cox,DEM,120209,0,1,6,7,
Choctaw,Superintendent of Public Instruction,Jack Jr.,DEM,120209,0,0,3,3,
Choctaw,Superintendent of Public Instruction,Ivan Holmes,DEM,120209,0,0,1,1,
Choctaw,Superintendent of Public Instruction,Freda Deskin,DEM,120209,0,0,2,2,
Choctaw,U.S. Senate,Patrick Michael Hayes,DEM,120209,0,0,8,8,
Choctaw,U.S. Senate,Jim Rogers,DEM,120209,0,1,2,3,
Choctaw,U.S. Senate,Connie Johnson,DEM,120209,0,0,2,2,
Choctaw,U.S. House,Earl Everett,DEM,120209,0,1,4,5,02
Choctaw,U.S. House,Joshua Harris-Till,DEM,120209,0,0,7,7,02
Choctaw,Governor,Dax Ewbank,REP,120209,0,0,1,1,
Choctaw,Governor,Chad Moody,REP,120209,0,0,0,0,
Choctaw,Governor,Mary Fallin,REP,120209,0,0,2,2,
Choctaw,Superintendent of Public Instruction,Brian Kelly,REP,120209,0,0,1,1,
Choctaw,Superintendent of Public Instruction,Janet Costello Barresi,REP,120209,0,0,1,1,
Choctaw,Superintendent of Public Instruction,Joy Hofmeister,REP,120209,0,0,1,1,
Choctaw,Insurance Commissioner,Bill Viner,REP,120209,0,0,1,1,
Choctaw,Insurance Commissioner,John Doak,REP,120209,0,0,2,2,
Choctaw,Corporation Commissioner,Todd Hiett,REP,120209,0,0,2,2,
Choctaw,Corporation Commissioner,Cliff Branan,REP,120209,0,0,1,1,
Choctaw,U.S. Senate,Evelyn Rogers,REP,120209,0,0,0,0,
Choctaw,U.S. Senate,Rob Moye,REP,120209,0,0,0,0,
Choctaw,U.S. Senate,D. Jean Mcbride-Samuels,REP,120209,0,0,0,0,
Choctaw,U.S. Senate,Jim Inhofe,REP,120209,0,0,3,3,
Choctaw,U.S. Senate,Erick Paul Wyatt,REP,120209,0,0,0,0,
Choctaw,U.S. Senate,Andy Craig,REP,120209,0,0,0,0,
Choctaw,U.S. Senate,T. Shannon,REP,120209,0,0,1,1,
Choctaw,U.S. Senate,Randy Brogdon,REP,120209,0,0,0,0,
Choctaw,U.S. Senate,Eric Mccray,REP,120209,0,0,0,0,
Choctaw,U.S. Senate,Kevin Crow,REP,120209,0,0,0,0,
Choctaw,U.S. Senate,James Lankford,REP,120209,0,0,2,2,
Choctaw,U.S. Senate,Jason Weger,REP,120209,0,0,0,0,
Choctaw,U.S. House,Darrel Robertson,REP,120209,0,0,1,1,02
Choctaw,U.S. House,Markwayne Mullin,REP,120209,0,0,2,2,02
Choctaw,State Senate,Joseph Silk,REP,120209,0,0,2,2,5
Choctaw,State Senate,Brent Shain,REP,120209,0,0,1,1,5
Choctaw,Superintendent of Public Instruction,John Cox,DEM,120210,0,1,34,35,
Choctaw,Superintendent of Public Instruction,Jack Jr.,DEM,120210,1,1,4,6,
Choctaw,Superintendent of Public Instruction,Ivan Holmes,DEM,120210,0,2,3,5,
Choctaw,Superintendent of Public Instruction,Freda Deskin,DEM,120210,0,1,12,13,
Choctaw,U.S. Senate,Patrick Michael Hayes,DEM,120210,1,2,16,19,
Choctaw,U.S. Senate,Jim Rogers,DEM,120210,0,3,25,28,
Choctaw,U.S. Senate,Connie Johnson,DEM,120210,0,0,9,9,
Choctaw,U.S. House,Earl Everett,DEM,120210,0,3,36,39,02
Choctaw,U.S. House,Joshua Harris-Till,DEM,120210,1,2,13,16,02
Choctaw,Governor,Dax Ewbank,REP,120210,1,2,7,10,
Choctaw,Governor,Chad Moody,REP,120210,0,0,4,4,
Choctaw,Governor,Mary Fallin,REP,120210,1,2,29,32,
Choctaw,Superintendent of Public Instruction,Brian Kelly,REP,120210,1,1,13,15,
Choctaw,Superintendent of Public Instruction,Janet Costello Barresi,REP,120210,0,1,7,8,
Choctaw,Superintendent of Public Instruction,Joy Hofmeister,REP,120210,1,2,16,19,
Choctaw,Insurance Commissioner,Bill Viner,REP,120210,0,1,9,10,
Choctaw,Insurance Commissioner,John Doak,REP,120210,2,3,23,28,
Choctaw,Corporation Commissioner,Todd Hiett,REP,120210,0,3,19,22,
Choctaw,Corporation Commissioner,Cliff Branan,REP,120210,1,1,13,15,
Choctaw,U.S. Senate,Evelyn Rogers,REP,120210,0,0,3,3,
Choctaw,U.S. Senate,Rob Moye,REP,120210,0,0,2,2,
Choctaw,U.S. Senate,D. Jean Mcbride-Samuels,REP,120210,0,0,0,0,
Choctaw,U.S. Senate,Jim Inhofe,REP,120210,2,4,23,29,
Choctaw,U.S. Senate,Erick Paul Wyatt,REP,120210,0,0,9,9,
Choctaw,U.S. Senate,Andy Craig,REP,120210,0,0,1,1,
Choctaw,U.S. Senate,T. Shannon,REP,120210,0,1,13,14,
Choctaw,U.S. Senate,Randy Brogdon,REP,120210,0,0,5,5,
Choctaw,U.S. Senate,Eric Mccray,REP,120210,0,0,0,0,
Choctaw,U.S. Senate,Kevin Crow,REP,120210,0,0,1,1,
Choctaw,U.S. Senate,James Lankford,REP,120210,2,3,20,25,
Choctaw,U.S. Senate,Jason Weger,REP,120210,0,0,0,0,
Choctaw,U.S. House,Darrel Robertson,REP,120210,0,0,15,15,02
Choctaw,U.S. House,Markwayne Mullin,REP,120210,2,4,23,29,02
Choctaw,State Senate,Joseph Silk,REP,120210,0,2,18,20,5
Choctaw,State Senate,Brent Shain,REP,120210,2,2,22,26,5
Choctaw,Superintendent of Public Instruction,John Cox,DEM,120211,0,0,8,8,
Choctaw,Superintendent of Public Instruction,Jack Jr.,DEM,120211,0,0,1,1,
Choctaw,Superintendent of Public Instruction,Ivan Holmes,DEM,120211,0,0,3,3,
Choctaw,Superintendent of Public Instruction,Freda Deskin,DEM,120211,0,0,7,7,
Choctaw,U.S. Senate,Patrick Michael Hayes,DEM,120211,0,0,2,2,
Choctaw,U.S. Senate,Jim Rogers,DEM,120211,0,0,6,6,
Choctaw,U.S. Senate,Connie Johnson,DEM,120211,0,0,11,11,
Choctaw,U.S. House,Earl Everett,DEM,120211,0,0,9,9,02
Choctaw,U.S. House,Joshua Harris-Till,DEM,120211,0,0,9,9,02
Choctaw,Governor,Dax Ewbank,REP,120211,0,0,0,0,
Choctaw,Governor,Chad Moody,REP,120211,0,0,0,0,
Choctaw,Governor,Mary Fallin,REP,120211,0,0,0,0,
Choctaw,Superintendent of Public Instruction,Brian Kelly,REP,120211,0,0,0,0,
Choctaw,Superintendent of Public Instruction,Janet Costello Barresi,REP,120211,0,0,0,0,
Choctaw,Superintendent of Public Instruction,Joy Hofmeister,REP,120211,0,0,0,0,
Choctaw,Insurance Commissioner,Bill Viner,REP,120211,0,0,0,0,
Choctaw,Insurance Commissioner,John Doak,REP,120211,0,0,0,0,
Choctaw,Corporation Commissioner,Todd Hiett,REP,120211,0,0,0,0,
Choctaw,Corporation Commissioner,Cliff Branan,REP,120211,0,0,0,0,
Choctaw,U.S. Senate,Evelyn Rogers,REP,120211,0,0,0,0,
Choctaw,U.S. Senate,Rob Moye,REP,120211,0,0,0,0,
Choctaw,U.S. Senate,D. Jean Mcbride-Samuels,REP,120211,0,0,0,0,
Choctaw,U.S. Senate,Jim Inhofe,REP,120211,0,0,0,0,
Choctaw,U.S. Senate,Erick Paul Wyatt,REP,120211,0,0,0,0,
Choctaw,U.S. Senate,Andy Craig,REP,120211,0,0,0,0,
Choctaw,U.S. Senate,T. Shannon,REP,120211,0,0,0,0,
Choctaw,U.S. Senate,Randy Brogdon,REP,120211,0,0,0,0,
Choctaw,U.S. Senate,Eric Mccray,REP,120211,0,0,0,0,
Choctaw,U.S. Senate,Kevin Crow,REP,120211,0,0,0,0,
Choctaw,U.S. Senate,James Lankford,REP,120211,0,0,0,0,
Choctaw,U.S. Senate,Jason Weger,REP,120211,0,0,0,0,
Choctaw,U.S. House,Darrel Robertson,REP,120211,0,0,0,0,02
Choctaw,U.S. House,Markwayne Mullin,REP,120211,0,0,0,0,02
Choctaw,State Senate,Joseph Silk,REP,120211,0,0,0,0,5
Choctaw,State Senate,Brent Shain,REP,120211,0,0,0,0,5
Choctaw,Superintendent of Public Instruction,John Cox,DEM,120214,0,0,21,21,
Choctaw,Superintendent of Public Instruction,Jack Jr.,DEM,120214,0,0,7,7,
Choctaw,Superintendent of Public Instruction,Ivan Holmes,DEM,120214,0,0,6,6,
Choctaw,Superintendent of Public Instruction,Freda Deskin,DEM,120214,1,0,15,16,
Choctaw,U.S. Senate,Patrick Michael Hayes,DEM,120214,0,0,8,8,
Choctaw,U.S. Senate,Jim Rogers,DEM,120214,0,0,24,24,
Choctaw,U.S. Senate,Connie Johnson,DEM,120214,1,0,15,16,
Choctaw,U.S. House,Earl Everett,DEM,120214,0,0,31,31,02
Choctaw,U.S. House,Joshua Harris-Till,DEM,120214,1,0,13,14,02
Choctaw,Governor,Dax Ewbank,REP,120214,0,2,2,4,
Choctaw,Governor,Chad Moody,REP,120214,0,0,1,1,
Choctaw,Governor,Mary Fallin,REP,120214,0,0,10,10,
Choctaw,Superintendent of Public Instruction,Brian Kelly,REP,120214,0,0,5,5,
Choctaw,Superintendent of Public Instruction,Janet Costello Barresi,REP,120214,0,0,0,0,
Choctaw,Superintendent of Public Instruction,Joy Hofmeister,REP,120214,0,2,7,9,
Choctaw,Insurance Commissioner,Bill Viner,REP,120214,0,0,3,3,
Choctaw,Insurance Commissioner,John Doak,REP,120214,0,2,8,10,
Choctaw,Corporation Commissioner,Todd Hiett,REP,120214,0,2,4,6,
Choctaw,Corporation Commissioner,Cliff Branan,REP,120214,0,0,7,7,
Choctaw,U.S. Senate,Evelyn Rogers,REP,120214,0,0,1,1,
Choctaw,U.S. Senate,Rob Moye,REP,120214,0,0,1,1,
Choctaw,U.S. Senate,D. Jean Mcbride-Samuels,REP,120214,0,0,0,0,
Choctaw,U.S. Senate,Jim Inhofe,REP,120214,0,2,11,13,
Choctaw,U.S. Senate,Erick Paul Wyatt,REP,120214,0,0,0,0,
Choctaw,U.S. Senate,Andy Craig,REP,120214,0,0,0,0,
Choctaw,U.S. Senate,T. Shannon,REP,120214,0,0,1,1,
Choctaw,U.S. Senate,Randy Brogdon,REP,120214,0,1,0,1,
Choctaw,U.S. Senate,Eric Mccray,REP,120214,0,0,0,0,
Choctaw,U.S. Senate,Kevin Crow,REP,120214,0,0,0,0,
Choctaw,U.S. Senate,James Lankford,REP,120214,0,1,11,12,
Choctaw,U.S. Senate,Jason Weger,REP,120214,0,0,0,0,
Choctaw,U.S. House,Darrel Robertson,REP,120214,0,1,4,5,02
Choctaw,U.S. House,Markwayne Mullin,REP,120214,0,1,9,10,02
Choctaw,State Senate,Joseph Silk,REP,120214,0,2,3,5,5
Choctaw,State Senate,Brent Shain,REP,120214,0,0,10,10,5
Choctaw,Superintendent of Public Instruction,John Cox,DEM,120215,0,3,10,13,
Choctaw,Superintendent of Public Instruction,Jack Jr.,DEM,120215,0,0,3,3,
Choctaw,Superintendent of Public Instruction,Ivan Holmes,DEM,120215,0,0,3,3,
Choctaw,Superintendent of Public Instruction,Freda Deskin,DEM,120215,0,2,6,8,
Choctaw,U.S. Senate,Patrick Michael Hayes,DEM,120215,0,1,4,5,
Choctaw,U.S. Senate,Jim Rogers,DEM,120215,0,1,11,12,
Choctaw,U.S. Senate,Connie Johnson,DEM,120215,0,3,6,9,
Choctaw,U.S. House,Earl Everett,DEM,120215,0,2,13,15,02
Choctaw,U.S. House,Joshua Harris-Till,DEM,120215,0,3,8,11,02
Choctaw,Governor,Dax Ewbank,REP,120215,0,0,1,1,
Choctaw,Governor,Chad Moody,REP,120215,0,0,2,2,
Choctaw,Governor,Mary Fallin,REP,120215,0,1,21,22,
Choctaw,Superintendent of Public Instruction,Brian Kelly,REP,120215,0,0,7,7,
Choctaw,Superintendent of Public Instruction,Janet Costello Barresi,REP,120215,0,0,6,6,
Choctaw,Superintendent of Public Instruction,Joy Hofmeister,REP,120215,0,1,8,9,
Choctaw,Insurance Commissioner,Bill Viner,REP,120215,0,0,6,6,
Choctaw,Insurance Commissioner,John Doak,REP,120215,0,1,13,14,
Choctaw,Corporation Commissioner,Todd Hiett,REP,120215,0,0,10,10,
Choctaw,Corporation Commissioner,Cliff Branan,REP,120215,0,1,9,10,
Choctaw,U.S. Senate,Evelyn Rogers,REP,120215,0,0,0,0,
Choctaw,U.S. Senate,Rob Moye,REP,120215,0,0,0,0,
Choctaw,U.S. Senate,D. Jean Mcbride-Samuels,REP,120215,0,0,0,0,
Choctaw,U.S. Senate,Jim Inhofe,REP,120215,0,1,22,23,
Choctaw,U.S. Senate,Erick Paul Wyatt,REP,120215,0,0,2,2,
Choctaw,U.S. Senate,Andy Craig,REP,120215,0,0,0,0,
Choctaw,U.S. Senate,T. Shannon,REP,120215,0,1,6,7,
Choctaw,U.S. Senate,Randy Brogdon,REP,120215,0,0,1,1,
Choctaw,U.S. Senate,Eric Mccray,REP,120215,0,0,0,0,
Choctaw,U.S. Senate,Kevin Crow,REP,120215,0,0,1,1,
Choctaw,U.S. Senate,James Lankford,REP,120215,0,0,14,14,
Choctaw,U.S. Senate,Jason Weger,REP,120215,0,0,1,1,
Choctaw,U.S. House,Darrel Robertson,REP,120215,0,0,10,10,02
Choctaw,U.S. House,Markwayne Mullin,REP,120215,0,1,14,15,02
Choctaw,State Senate,Joseph Silk,REP,120215,0,0,11,11,5
Choctaw,State Senate,Brent Shain,REP,120215,0,1,13,14,5
Choctaw,Superintendent of Public Instruction,John Cox,DEM,120316,1,10,43,54,
Choctaw,Superintendent of Public Instruction,Jack Jr.,DEM,120316,1,0,11,12,
Choctaw,Superintendent of Public Instruction,Ivan Holmes,DEM,120316,2,3,8,13,
Choctaw,Superintendent of Public Instruction,Freda Deskin,DEM,120316,4,5,29,38,
Choctaw,U.S. Senate,Patrick Michael Hayes,DEM,120316,0,4,29,33,
Choctaw,U.S. Senate,Jim Rogers,DEM,120316,4,4,39,47,
Choctaw,U.S. Senate,Connie Johnson,DEM,120316,4,9,22,35,
Choctaw,U.S. House,Earl Everett,DEM,120316,5,9,53,67,02
Choctaw,U.S. House,Joshua Harris-Till,DEM,120316,3,7,33,43,02
Choctaw,Governor,Dax Ewbank,REP,120316,0,0,9,9,
Choctaw,Governor,Chad Moody,REP,120316,0,0,3,3,
Choctaw,Governor,Mary Fallin,REP,120316,0,7,38,45,
Choctaw,Superintendent of Public Instruction,Brian Kelly,REP,120316,0,0,10,10,
Choctaw,Superintendent of Public Instruction,Janet Costello Barresi,REP,120316,0,2,9,11,
Choctaw,Superintendent of Public Instruction,Joy Hofmeister,REP,120316,0,5,29,34,
Choctaw,Insurance Commissioner,Bill Viner,REP,120316,0,0,5,5,
Choctaw,Insurance Commissioner,John Doak,REP,120316,0,7,41,48,
Choctaw,Corporation Commissioner,Todd Hiett,REP,120316,0,6,30,36,
Choctaw,Corporation Commissioner,Cliff Branan,REP,120316,0,1,14,15,
Choctaw,U.S. Senate,Evelyn Rogers,REP,120316,0,0,2,2,
Choctaw,U.S. Senate,Rob Moye,REP,120316,0,0,4,4,
Choctaw,U.S. Senate,D. Jean Mcbride-Samuels,REP,120316,0,0,1,1,
Choctaw,U.S. Senate,Jim Inhofe,REP,120316,0,7,35,42,
Choctaw,U.S. Senate,Erick Paul Wyatt,REP,120316,0,0,7,7,
Choctaw,U.S. Senate,Andy Craig,REP,120316,0,0,0,0,
Choctaw,U.S. Senate,T. Shannon,REP,120316,0,1,19,20,
Choctaw,U.S. Senate,Randy Brogdon,REP,120316,0,0,3,3,
Choctaw,U.S. Senate,Eric Mccray,REP,120316,0,0,1,1,
Choctaw,U.S. Senate,Kevin Crow,REP,120316,0,0,0,0,
Choctaw,U.S. Senate,James Lankford,REP,120316,0,6,28,34,
Choctaw,U.S. Senate,Jason Weger,REP,120316,0,0,0,0,
Choctaw,U.S. House,Darrel Robertson,REP,120316,0,0,10,10,02
Choctaw,U.S. House,Markwayne Mullin,REP,120316,0,7,40,47,02
Choctaw,State Senate,Joseph Silk,REP,120316,0,1,9,10,5
Choctaw,State Senate,Brent Shain,REP,120316,0,6,41,47,5
Choctaw,Superintendent of Public Instruction,John Cox,DEM,120318,0,3,33,36,
Choctaw,Superintendent of Public Instruction,Jack Jr.,DEM,120318,0,1,17,18,
Choctaw,Superintendent of Public Instruction,Ivan Holmes,DEM,120318,0,0,7,7,
Choctaw,Superintendent of Public Instruction,Freda Deskin,DEM,120318,0,6,28,34,
Choctaw,U.S. Senate,Patrick Michael Hayes,DEM,120318,0,2,24,26,
Choctaw,U.S. Senate,Jim Rogers,DEM,120318,0,4,35,39,
Choctaw,U.S. Senate,Connie Johnson,DEM,120318,0,4,22,26,
Choctaw,U.S. House,Earl Everett,DEM,120318,0,8,51,59,02
Choctaw,U.S. House,Joshua Harris-Till,DEM,120318,0,4,26,30,02
Choctaw,Governor,Dax Ewbank,REP,120318,0,5,6,11,
Choctaw,Governor,Chad Moody,REP,120318,0,1,1,2,
Choctaw,Governor,Mary Fallin,REP,120318,0,6,10,16,
Choctaw,Superintendent of Public Instruction,Brian Kelly,REP,120318,0,3,1,4,
Choctaw,Superintendent of Public Instruction,Janet Costello Barresi,REP,120318,0,4,6,10,
Choctaw,Superintendent of Public Instruction,Joy Hofmeister,REP,120318,0,2,5,7,
Choctaw,Insurance Commissioner,Bill Viner,REP,120318,0,2,5,7,
Choctaw,Insurance Commissioner,John Doak,REP,120318,0,7,7,14,
Choctaw,Corporation Commissioner,Todd Hiett,REP,120318,0,8,12,20,
Choctaw,Corporation Commissioner,Cliff Branan,REP,120318,0,1,4,5,
Choctaw,U.S. Senate,Evelyn Rogers,REP,120318,0,1,0,1,
Choctaw,U.S. Senate,Rob Moye,REP,120318,0,0,1,1,
Choctaw,U.S. Senate,D. Jean Mcbride-Samuels,REP,120318,0,2,0,2,
Choctaw,U.S. Senate,Jim Inhofe,REP,120318,0,6,10,16,
Choctaw,U.S. Senate,Erick Paul Wyatt,REP,120318,0,3,6,9,
Choctaw,U.S. Senate,Andy Craig,REP,120318,0,0,1,1,
Choctaw,U.S. Senate,T. Shannon,REP,120318,0,3,2,5,
Choctaw,U.S. Senate,Randy Brogdon,REP,120318,0,4,4,8,
Choctaw,U.S. Senate,Eric Mccray,REP,120318,0,1,3,4,
Choctaw,U.S. Senate,Kevin Crow,REP,120318,0,0,0,0,
Choctaw,U.S. Senate,James Lankford,REP,120318,0,5,7,12,
Choctaw,U.S. Senate,Jason Weger,REP,120318,0,0,0,0,
Choctaw,U.S. House,Darrel Robertson,REP,120318,0,7,7,14,02
Choctaw,U.S. House,Markwayne Mullin,REP,120318,0,6,10,16,02
Choctaw,State Senate,Joseph Silk,REP,120318,0,7,9,16,5
Choctaw,State Senate,Brent Shain,REP,120318,0,6,8,14,5
Choctaw,Superintendent of Public Instruction,John Cox,DEM,120319,3,5,60,68,
Choctaw,Superintendent of Public Instruction,Jack Jr.,DEM,120319,1,0,13,14,
Choctaw,Superintendent of Public Instruction,Ivan Holmes,DEM,120319,0,2,3,5,
Choctaw,Superintendent of Public Instruction,Freda Deskin,DEM,120319,2,3,21,26,
Choctaw,U.S. Senate,Patrick Michael Hayes,DEM,120319,3,2,16,21,
Choctaw,U.S. Senate,Jim Rogers,DEM,120319,1,7,42,50,
Choctaw,U.S. Senate,Connie Johnson,DEM,120319,2,1,34,37,
Choctaw,U.S. House,Earl Everett,DEM,120319,4,6,54,64,02
Choctaw,U.S. House,Joshua Harris-Till,DEM,120319,2,3,32,37,02
Choctaw,Governor,Dax Ewbank,REP,120319,0,0,4,4,
Choctaw,Governor,Chad Moody,REP,120319,0,0,2,2,
Choctaw,Governor,Mary Fallin,REP,120319,0,1,6,7,
Choctaw,Superintendent of Public Instruction,Brian Kelly,REP,120319,0,1,4,5,
Choctaw,Superintendent of Public Instruction,Janet Costello Barresi,REP,120319,0,0,1,1,
Choctaw,Superintendent of Public Instruction,Joy Hofmeister,REP,120319,0,0,7,7,
Choctaw,Insurance Commissioner,Bill Viner,REP,120319,0,0,4,4,
Choctaw,Insurance Commissioner,John Doak,REP,120319,0,1,8,9,
Choctaw,Corporation Commissioner,Todd Hiett,REP,120319,0,0,6,6,
Choctaw,Corporation Commissioner,Cliff Branan,REP,120319,0,1,6,7,
Choctaw,U.S. Senate,Evelyn Rogers,REP,120319,0,0,1,1,
Choctaw,U.S. Senate,Rob Moye,REP,120319,0,0,1,1,
Choctaw,U.S. Senate,D. Jean Mcbride-Samuels,REP,120319,0,0,0,0,
Choctaw,U.S. Senate,Jim Inhofe,REP,120319,0,1,8,9,
Choctaw,U.S. Senate,Erick Paul Wyatt,REP,120319,0,0,2,2,
Choctaw,U.S. Senate,Andy Craig,REP,120319,0,0,0,0,
Choctaw,U.S. Senate,T. Shannon,REP,120319,0,0,5,5,
Choctaw,U.S. Senate,Randy Brogdon,REP,120319,0,0,1,1,
Choctaw,U.S. Senate,Eric Mccray,REP,120319,0,0,1,1,
Choctaw,U.S. Senate,Kevin Crow,REP,120319,0,0,0,0,
Choctaw,U.S. Senate,James Lankford,REP,120319,0,1,5,6,
Choctaw,U.S. Senate,Jason Weger,REP,120319,0,0,0,0,
Choctaw,U.S. House,Darrel Robertson,REP,120319,0,1,5,6,02
Choctaw,U.S. House,Markwayne Mullin,REP,120319,0,0,7,7,02
Choctaw,State Senate,Joseph Silk,REP,120319,0,0,1,1,5
Choctaw,State Senate,Brent Shain,REP,120319,0,1,11,12,5
Choctaw,Superintendent of Public Instruction,John Cox,DEM,120320,0,2,35,37,
Choctaw,Superintendent of Public Instruction,Jack Jr.,DEM,120320,0,0,4,4,
Choctaw,Superintendent of Public Instruction,Ivan Holmes,DEM,120320,0,0,4,4,
Choctaw,Superintendent of Public Instruction,Freda Deskin,DEM,120320,0,0,14,14,
Choctaw,U.S. Senate,Patrick Michael Hayes,DEM,120320,0,0,8,8,
Choctaw,U.S. Senate,Jim Rogers,DEM,120320,0,1,30,31,
Choctaw,U.S. Senate,Connie Johnson,DEM,120320,0,1,13,14,
Choctaw,U.S. House,Earl Everett,DEM,120320,0,1,31,32,02
Choctaw,U.S. House,Joshua Harris-Till,DEM,120320,0,0,19,19,02
Choctaw,Governor,Dax Ewbank,REP,120320,0,0,0,0,
Choctaw,Governor,Chad Moody,REP,120320,0,0,1,1,
Choctaw,Governor,Mary Fallin,REP,120320,0,0,12,12,
Choctaw,Superintendent of Public Instruction,Brian Kelly,REP,120320,0,0,6,6,
Choctaw,Superintendent of Public Instruction,Janet Costello Barresi,REP,120320,0,0,1,1,
Choctaw,Superintendent of Public Instruction,Joy Hofmeister,REP,120320,0,0,5,5,
Choctaw,Insurance Commissioner,Bill Viner,REP,120320,0,0,2,2,
Choctaw,Insurance Commissioner,John Doak,REP,120320,0,0,10,10,
Choctaw,Corporation Commissioner,Todd Hiett,REP,120320,0,0,8,8,
Choctaw,Corporation Commissioner,Cliff Branan,REP,120320,0,0,4,4,
Choctaw,U.S. Senate,Evelyn Rogers,REP,120320,0,0,1,1,
Choctaw,U.S. Senate,Rob Moye,REP,120320,0,0,1,1,
Choctaw,U.S. Senate,D. Jean Mcbride-Samuels,REP,120320,0,0,0,0,
Choctaw,U.S. Senate,Jim Inhofe,REP,120320,0,0,10,10,
Choctaw,U.S. Senate,Erick Paul Wyatt,REP,120320,0,0,1,1,
Choctaw,U.S. Senate,Andy Craig,REP,120320,0,0,0,0,
Choctaw,U.S. Senate,T. Shannon,REP,120320,0,0,5,5,
Choctaw,U.S. Senate,Randy Brogdon,REP,120320,0,0,0,0,
Choctaw,U.S. Senate,Eric Mccray,REP,120320,0,0,0,0,
Choctaw,U.S. Senate,Kevin Crow,REP,120320,0,0,1,1,
Choctaw,U.S. Senate,James Lankford,REP,120320,0,0,7,7,
Choctaw,U.S. Senate,Jason Weger,REP,120320,0,0,0,0,
Choctaw,U.S. House,Darrel Robertson,REP,120320,0,0,3,3,02
Choctaw,U.S. House,Markwayne Mullin,REP,120320,0,0,10,10,02
Choctaw,State Senate,Joseph Silk,REP,120320,0,0,5,5,5
Choctaw,State Senate,Brent Shain,REP,120320,0,0,8,8,5
Choctaw,Superintendent of Public Instruction,John Cox,DEM,120321,3,3,76,82,
Choctaw,Superintendent of Public Instruction,Jack Jr.,DEM,120321,0,0,18,18,
Choctaw,Superintendent of Public Instruction,Ivan Holmes,DEM,120321,0,0,9,9,
Choctaw,Superintendent of Public Instruction,Freda Deskin,DEM,120321,0,2,56,58,
Choctaw,U.S. Senate,Patrick Michael Hayes,DEM,120321,0,2,48,50,
Choctaw,U.S. Senate,Jim Rogers,DEM,120321,3,2,64,69,
Choctaw,U.S. Senate,Connie Johnson,DEM,120321,0,1,40,41,
Choctaw,U.S. House,Earl Everett,DEM,120321,1,3,92,96,02
Choctaw,U.S. House,Joshua Harris-Till,DEM,120321,2,1,59,62,02
Choctaw,Governor,Dax Ewbank,REP,120321,0,2,3,5,
Choctaw,Governor,Chad Moody,REP,120321,0,0,0,0,
Choctaw,Governor,Mary Fallin,REP,120321,2,7,16,25,
Choctaw,Superintendent of Public Instruction,Brian Kelly,REP,120321,2,3,4,9,
Choctaw,Superintendent of Public Instruction,Janet Costello Barresi,REP,120321,0,1,2,3,
Choctaw,Superintendent of Public Instruction,Joy Hofmeister,REP,120321,0,5,11,16,
Choctaw,Insurance Commissioner,Bill Viner,REP,120321,0,0,5,5,
Choctaw,Insurance Commissioner,John Doak,REP,120321,2,9,10,21,
Choctaw,Corporation Commissioner,Todd Hiett,REP,120321,2,7,9,18,
Choctaw,Corporation Commissioner,Cliff Branan,REP,120321,0,2,5,7,
Choctaw,U.S. Senate,Evelyn Rogers,REP,120321,0,0,1,1,
Choctaw,U.S. Senate,Rob Moye,REP,120321,0,0,0,0,
Choctaw,U.S. Senate,D. Jean Mcbride-Samuels,REP,120321,0,0,0,0,
Choctaw,U.S. Senate,Jim Inhofe,REP,120321,2,8,16,26,
Choctaw,U.S. Senate,Erick Paul Wyatt,REP,120321,0,1,2,3,
Choctaw,U.S. Senate,Andy Craig,REP,120321,0,0,0,0,
Choctaw,U.S. Senate,T. Shannon,REP,120321,0,2,5,7,
Choctaw,U.S. Senate,Randy Brogdon,REP,120321,0,1,4,5,
Choctaw,U.S. Senate,Eric Mccray,REP,120321,0,0,0,0,
Choctaw,U.S. Senate,Kevin Crow,REP,120321,0,2,0,2,
Choctaw,U.S. Senate,James Lankford,REP,120321,2,4,10,16,
Choctaw,U.S. Senate,Jason Weger,REP,120321,0,0,0,0,
Choctaw,U.S. House,Darrel Robertson,REP,120321,2,1,6,9,02
Choctaw,U.S. House,Markwayne Mullin,REP,120321,0,8,12,20,02
Choctaw,State Senate,Joseph Silk,REP,120321,2,2,5,9,5
Choctaw,State Senate,Brent Shain,REP,120321,0,7,11,18,5
Choctaw,Superintendent of Public Instruction,John Cox,DEM,120322,0,1,36,37,
Choctaw,Superintendent of Public Instruction,Jack Jr.,DEM,120322,0,0,5,5,
Choctaw,Superintendent of Public Instruction,Ivan Holmes,DEM,120322,0,1,2,3,
Choctaw,Superintendent of Public Instruction,Freda Deskin,DEM,120322,0,0,14,14,
Choctaw,U.S. Senate,Patrick Michael Hayes,DEM,120322,0,1,16,17,
Choctaw,U.S. Senate,Jim Rogers,DEM,120322,0,0,20,20,
Choctaw,U.S. Senate,Connie Johnson,DEM,120322,0,1,17,18,
Choctaw,U.S. House,Earl Everett,DEM,120322,0,0,25,25,02
Choctaw,U.S. House,Joshua Harris-Till,DEM,120322,0,1,24,25,02
Choctaw,Governor,Dax Ewbank,REP,120322,0,0,0,0,
Choctaw,Governor,Chad Moody,REP,120322,0,0,2,2,
Choctaw,Governor,Mary Fallin,REP,120322,0,0,14,14,
Choctaw,Superintendent of Public Instruction,Brian Kelly,REP,120322,0,0,7,7,
Choctaw,Superintendent of Public Instruction,Janet Costello Barresi,REP,120322,0,0,6,6,
Choctaw,Superintendent of Public Instruction,Joy Hofmeister,REP,120322,0,0,1,1,
Choctaw,Insurance Commissioner,Bill Viner,REP,120322,0,0,7,7,
Choctaw,Insurance Commissioner,John Doak,REP,120322,0,0,6,6,
Choctaw,Corporation Commissioner,Todd Hiett,REP,120322,0,0,7,7,
Choctaw,Corporation Commissioner,Cliff Branan,REP,120322,0,0,5,5,
Choctaw,U.S. Senate,Evelyn Rogers,REP,120322,0,0,2,2,
Choctaw,U.S. Senate,Rob Moye,REP,120322,0,0,1,1,
Choctaw,U.S. Senate,D. Jean Mcbride-Samuels,REP,120322,0,0,1,1,
Choctaw,U.S. Senate,Jim Inhofe,REP,120322,0,0,7,7,
Choctaw,U.S. Senate,Erick Paul Wyatt,REP,120322,0,0,2,2,
Choctaw,U.S. Senate,Andy Craig,REP,120322,0,0,0,0,
Choctaw,U.S. Senate,T. Shannon,REP,120322,0,0,7,7,
Choctaw,U.S. Senate,Randy Brogdon,REP,120322,0,0,2,2,
Choctaw,U.S. Senate,Eric Mccray,REP,120322,0,0,0,0,
Choctaw,U.S. Senate,Kevin Crow,REP,120322,0,0,0,0,
Choctaw,U.S. Senate,James Lankford,REP,120322,0,0,6,6,
Choctaw,U.S. Senate,Jason Weger,REP,120322,0,0,1,1,
Choctaw,U.S. House,Darrel Robertson,REP,120322,0,0,6,6,02
Choctaw,U.S. House,Markwayne Mullin,REP,120322,0,0,9,9,02
Choctaw,State Senate,Joseph Silk,REP,120322,0,0,8,8,5
Choctaw,State Senate,Brent Shain,REP,120322,0,0,7,7,5
Cimarron,Superintendent of Public Instruction,John Cox,DEM,130002,1,0,7,8,
Cimarron,Superintendent of Public Instruction,Jack Jr.,DEM,130002,0,0,3,3,
Cimarron,Superintendent of Public Instruction,Ivan Holmes,DEM,130002,0,1,1,2,
Cimarron,Superintendent of Public Instruction,Freda Deskin,DEM,130002,1,1,3,5,
Cimarron,U.S. Senate,Patrick Michael Hayes,DEM,130002,0,0,1,1,
Cimarron,U.S. Senate,Jim Rogers,DEM,130002,1,1,9,11,
Cimarron,U.S. Senate,Connie Johnson,DEM,130002,1,1,5,7,
Cimarron,Governor,Dax Ewbank,REP,130002,2,4,10,16,
Cimarron,Governor,Chad Moody,REP,130002,2,0,5,7,
Cimarron,Governor,Mary Fallin,REP,130002,3,3,38,44,
Cimarron,Superintendent of Public Instruction,Brian Kelly,REP,130002,4,1,15,20,
Cimarron,Superintendent of Public Instruction,Janet Costello Barresi,REP,130002,0,2,10,12,
Cimarron,Superintendent of Public Instruction,Joy Hofmeister,REP,130002,3,4,26,33,
Cimarron,Insurance Commissioner,Bill Viner,REP,130002,1,1,11,13,
Cimarron,Insurance Commissioner,John Doak,REP,130002,7,4,32,43,
Cimarron,Corporation Commissioner,Todd Hiett,REP,130002,8,2,20,30,
Cimarron,Corporation Commissioner,Cliff Branan,REP,130002,0,4,26,30,
Cimarron,U.S. Senate,Evelyn Rogers,REP,130002,0,1,2,3,
Cimarron,U.S. Senate,Rob Moye,REP,130002,0,0,3,3,
Cimarron,U.S. Senate,D. Jean Mcbride-Samuels,REP,130002,0,0,4,4,
Cimarron,U.S. Senate,Jim Inhofe,REP,130002,6,6,39,51,
Cimarron,U.S. Senate,Erick Paul Wyatt,REP,130002,3,0,5,8,
Cimarron,U.S. Senate,Andy Craig,REP,130002,0,0,0,0,
Cimarron,U.S. Senate,T. Shannon,REP,130002,8,5,28,41,
Cimarron,U.S. Senate,Randy Brogdon,REP,130002,0,1,5,6,
Cimarron,U.S. Senate,Eric Mccray,REP,130002,0,0,1,1,
Cimarron,U.S. Senate,Kevin Crow,REP,130002,0,0,1,1,
Cimarron,U.S. Senate,James Lankford,REP,130002,1,0,18,19,
Cimarron,U.S. Senate,Jason Weger,REP,130002,0,0,0,0,
Cimarron,U.S. House,Timothy Ray Murray,REP,130002,0,0,4,4,03
Cimarron,U.S. House,Robert Hubbard,REP,130002,2,1,12,15,03
Cimarron,U.S. House,Frank Lucas,REP,130002,7,6,36,49,03
Cimarron,State House,Casey Murdock,REP,130002,4,5,26,35,61
Cimarron,State House,David Elder,REP,130002,0,0,1,1,61
Cimarron,State House,Steve Moore,REP,130002,0,1,12,13,61
Cimarron,State House,Kenny Bob Tapp,REP,130002,5,1,14,20,61
Cimarron,State House,Larry Swager,REP,130002,0,0,1,1,61
Cimarron,Superintendent of Public Instruction,John Cox,DEM,130003,0,2,6,8,
Cimarron,Superintendent of Public Instruction,Jack Jr.,DEM,130003,0,1,4,5,
Cimarron,Superintendent of Public Instruction,Ivan Holmes,DEM,130003,0,0,0,0,
Cimarron,Superintendent of Public Instruction,Freda Deskin,DEM,130003,0,1,1,2,
Cimarron,U.S. Senate,Patrick Michael Hayes,DEM,130003,0,1,0,1,
Cimarron,U.S. Senate,Jim Rogers,DEM,130003,0,2,9,11,
Cimarron,U.S. Senate,Connie Johnson,DEM,130003,0,1,2,3,
Cimarron,Governor,Dax Ewbank,REP,130003,0,2,30,32,
Cimarron,Governor,Chad Moody,REP,130003,0,2,8,10,
Cimarron,Governor,Mary Fallin,REP,130003,2,3,29,34,
Cimarron,Superintendent of Public Instruction,Brian Kelly,REP,130003,0,2,16,18,
Cimarron,Superintendent of Public Instruction,Janet Costello Barresi,REP,130003,0,2,9,11,
Cimarron,Superintendent of Public Instruction,Joy Hofmeister,REP,130003,2,3,34,39,
Cimarron,Insurance Commissioner,Bill Viner,REP,130003,0,3,18,21,
Cimarron,Insurance Commissioner,John Doak,REP,130003,2,3,39,44,
Cimarron,Corporation Commissioner,Todd Hiett,REP,130003,2,4,35,41,
Cimarron,Corporation Commissioner,Cliff Branan,REP,130003,0,1,23,24,
Cimarron,U.S. Senate,Evelyn Rogers,REP,130003,0,0,3,3,
Cimarron,U.S. Senate,Rob Moye,REP,130003,0,0,1,1,
Cimarron,U.S. Senate,D. Jean Mcbride-Samuels,REP,130003,0,0,0,0,
Cimarron,U.S. Senate,Jim Inhofe,REP,130003,2,7,54,63,
Cimarron,U.S. Senate,Erick Paul Wyatt,REP,130003,0,0,7,7,
Cimarron,U.S. Senate,Andy Craig,REP,130003,0,0,3,3,
Cimarron,U.S. Senate,T. Shannon,REP,130003,0,6,25,31,
Cimarron,U.S. Senate,Randy Brogdon,REP,130003,0,0,17,17,
Cimarron,U.S. Senate,Eric Mccray,REP,130003,0,0,0,0,
Cimarron,U.S. Senate,Kevin Crow,REP,130003,0,0,1,1,
Cimarron,U.S. Senate,James Lankford,REP,130003,2,0,19,21,
Cimarron,U.S. Senate,Jason Weger,REP,130003,0,0,1,1,
Cimarron,U.S. House,Timothy Ray Murray,REP,130003,0,1,4,5,03
Cimarron,U.S. House,Robert Hubbard,REP,130003,0,0,20,20,03
Cimarron,U.S. House,Frank Lucas,REP,130003,2,6,42,50,03
Cimarron,State House,Casey Murdock,REP,130003,2,3,8,13,61
Cimarron,State House,David Elder,REP,130003,0,0,1,1,61
Cimarron,State House,Steve Moore,REP,130003,0,0,11,11,61
Cimarron,State House,Kenny Bob Tapp,REP,130003,0,4,44,48,61
Cimarron,State House,Larry Swager,REP,130003,0,0,3,3,61
Cimarron,Superintendent of Public Instruction,John Cox,DEM,130004,0,0,12,12,
Cimarron,Superintendent of Public Instruction,Jack Jr.,DEM,130004,0,0,2,2,
Cimarron,Superintendent of Public Instruction,Ivan Holmes,DEM,130004,0,0,2,2,
Cimarron,Superintendent of Public Instruction,Freda Deskin,DEM,130004,0,1,3,4,
Cimarron,U.S. Senate,Patrick Michael Hayes,DEM,130004,0,1,5,6,
Cimarron,U.S. Senate,Jim Rogers,DEM,130004,0,0,8,8,
Cimarron,U.S. Senate,Connie Johnson,DEM,130004,0,0,4,4,
Cimarron,Governor,Dax Ewbank,REP,130004,0,2,32,34,
Cimarron,Governor,Chad Moody,REP,130004,0,1,4,5,
Cimarron,Governor,Mary Fallin,REP,130004,1,9,35,45,
Cimarron,Superintendent of Public Instruction,Brian Kelly,REP,130004,0,4,14,18,
Cimarron,Superintendent of Public Instruction,Janet Costello Barresi,REP,130004,0,1,6,7,
Cimarron,Superintendent of Public Instruction,Joy Hofmeister,REP,130004,1,6,48,55,
Cimarron,Insurance Commissioner,Bill Viner,REP,130004,0,2,17,19,
Cimarron,Insurance Commissioner,John Doak,REP,130004,1,9,42,52,
Cimarron,Corporation Commissioner,Todd Hiett,REP,130004,0,3,31,34,
Cimarron,Corporation Commissioner,Cliff Branan,REP,130004,0,8,26,34,
Cimarron,U.S. Senate,Evelyn Rogers,REP,130004,0,1,1,2,
Cimarron,U.S. Senate,Rob Moye,REP,130004,0,0,1,1,
Cimarron,U.S. Senate,D. Jean Mcbride-Samuels,REP,130004,0,0,1,1,
Cimarron,U.S. Senate,Jim Inhofe,REP,130004,0,9,62,71,
Cimarron,U.S. Senate,Erick Paul Wyatt,REP,130004,1,1,5,7,
Cimarron,U.S. Senate,Andy Craig,REP,130004,1,0,2,3,
Cimarron,U.S. Senate,T. Shannon,REP,130004,0,4,21,25,
Cimarron,U.S. Senate,Randy Brogdon,REP,130004,0,2,14,16,
Cimarron,U.S. Senate,Eric Mccray,REP,130004,0,0,1,1,
Cimarron,U.S. Senate,Kevin Crow,REP,130004,0,0,1,1,
Cimarron,U.S. Senate,James Lankford,REP,130004,0,6,29,35,
Cimarron,U.S. Senate,Jason Weger,REP,130004,0,0,0,0,
Cimarron,U.S. House,Timothy Ray Murray,REP,130004,0,0,4,4,03
Cimarron,U.S. House,Robert Hubbard,REP,130004,0,0,10,10,03
Cimarron,U.S. House,Frank Lucas,REP,130004,0,11,58,69,03
Cimarron,State House,Casey Murdock,REP,130004,0,9,22,31,61
Cimarron,State House,David Elder,REP,130004,0,0,2,2,61
Cimarron,State House,Steve Moore,REP,130004,0,0,6,6,61
Cimarron,State House,Kenny Bob Tapp,REP,130004,1,3,38,42,61
Cimarron,State House,Larry Swager,REP,130004,0,0,4,4,61
Cimarron,Superintendent of Public Instruction,John Cox,DEM,130005,0,0,10,10,
Cimarron,Superintendent of Public Instruction,Jack Jr.,DEM,130005,0,1,3,4,
Cimarron,Superintendent of Public Instruction,Ivan Holmes,DEM,130005,0,1,1,2,
Cimarron,Superintendent of Public Instruction,Freda Deskin,DEM,130005,0,1,2,3,
Cimarron,U.S. Senate,Patrick Michael Hayes,DEM,130005,0,1,4,5,
Cimarron,U.S. Senate,Jim Rogers,DEM,130005,0,2,7,9,
Cimarron,U.S. Senate,Connie Johnson,DEM,130005,0,0,4,4,
Cimarron,Governor,Dax Ewbank,REP,130005,1,4,20,25,
Cimarron,Governor,Chad Moody,REP,130005,0,0,4,4,
Cimarron,Governor,Mary Fallin,REP,130005,4,6,25,35,
Cimarron,Superintendent of Public Instruction,Brian Kelly,REP,130005,0,1,13,14,
Cimarron,Superintendent of Public Instruction,Janet Costello Barresi,REP,130005,2,3,2,7,
Cimarron,Superintendent of Public Instruction,Joy Hofmeister,REP,130005,3,5,34,42,
Cimarron,Insurance Commissioner,Bill Viner,REP,130005,0,2,10,12,
Cimarron,Insurance Commissioner,John Doak,REP,130005,4,6,28,38,
Cimarron,Corporation Commissioner,Todd Hiett,REP,130005,4,2,21,27,
Cimarron,Corporation Commissioner,Cliff Branan,REP,130005,0,7,15,22,
Cimarron,U.S. Senate,Evelyn Rogers,REP,130005,0,0,2,2,
Cimarron,U.S. Senate,Rob Moye,REP,130005,0,1,2,3,
Cimarron,U.S. Senate,D. Jean Mcbride-Samuels,REP,130005,0,0,0,0,
Cimarron,U.S. Senate,Jim Inhofe,REP,130005,4,8,41,53,
Cimarron,U.S. Senate,Erick Paul Wyatt,REP,130005,1,0,4,5,
Cimarron,U.S. Senate,Andy Craig,REP,130005,0,0,1,1,
Cimarron,U.S. Senate,T. Shannon,REP,130005,4,4,23,31,
Cimarron,U.S. Senate,Randy Brogdon,REP,130005,0,2,9,11,
Cimarron,U.S. Senate,Eric Mccray,REP,130005,0,0,0,0,
Cimarron,U.S. Senate,Kevin Crow,REP,130005,0,0,2,2,
Cimarron,U.S. Senate,James Lankford,REP,130005,1,4,10,15,
Cimarron,U.S. Senate,Jason Weger,REP,130005,0,0,2,2,
Cimarron,U.S. House,Timothy Ray Murray,REP,130005,0,1,1,2,03
Cimarron,U.S. House,Robert Hubbard,REP,130005,1,1,9,11,03
Cimarron,U.S. House,Frank Lucas,REP,130005,4,7,40,51,03
Cimarron,State House,Casey Murdock,REP,130005,1,4,13,18,61
Cimarron,State House,David Elder,REP,130005,0,1,3,4,61
Cimarron,State House,Steve Moore,REP,130005,0,0,4,4,61
Cimarron,State House,Kenny Bob Tapp,REP,130005,4,4,28,36,61
Cimarron,State House,Larry Swager,REP,130005,0,0,4,4,61
Cimarron,Superintendent of Public Instruction,John Cox,DEM,130006,0,1,10,11,
Cimarron,Superintendent of Public Instruction,Jack Jr.,DEM,130006,1,0,2,3,
Cimarron,Superintendent of Public Instruction,Ivan Holmes,DEM,130006,0,3,5,8,
Cimarron,Superintendent of Public Instruction,Freda Deskin,DEM,130006,0,0,4,4,
Cimarron,U.S. Senate,Patrick Michael Hayes,DEM,130006,0,2,6,8,
Cimarron,U.S. Senate,Jim Rogers,DEM,130006,0,0,9,9,
Cimarron,U.S. Senate,Connie Johnson,DEM,130006,1,2,6,9,
Cimarron,Governor,Dax Ewbank,REP,130006,1,6,30,37,
Cimarron,Governor,Chad Moody,REP,130006,0,3,9,12,
Cimarron,Governor,Mary Fallin,REP,130006,2,5,55,62,
Cimarron,Superintendent of Public Instruction,Brian Kelly,REP,130006,1,8,30,39,
Cimarron,Superintendent of Public Instruction,Janet Costello Barresi,REP,130006,0,1,13,14,
Cimarron,Superintendent of Public Instruction,Joy Hofmeister,REP,130006,0,5,50,55,
Cimarron,Insurance Commissioner,Bill Viner,REP,130006,0,2,14,16,
Cimarron,Insurance Commissioner,John Doak,REP,130006,1,11,72,84,
Cimarron,Corporation Commissioner,Todd Hiett,REP,130006,1,10,47,58,
Cimarron,Corporation Commissioner,Cliff Branan,REP,130006,0,3,39,42,
Cimarron,U.S. Senate,Evelyn Rogers,REP,130006,0,0,3,3,
Cimarron,U.S. Senate,Rob Moye,REP,130006,0,0,2,2,
Cimarron,U.S. Senate,D. Jean Mcbride-Samuels,REP,130006,0,0,0,0,
Cimarron,U.S. Senate,Jim Inhofe,REP,130006,3,14,79,96,
Cimarron,U.S. Senate,Erick Paul Wyatt,REP,130006,0,0,8,8,
Cimarron,U.S. Senate,Andy Craig,REP,130006,0,0,2,2,
Cimarron,U.S. Senate,T. Shannon,REP,130006,0,7,37,44,
Cimarron,U.S. Senate,Randy Brogdon,REP,130006,1,1,10,12,
Cimarron,U.S. Senate,Eric Mccray,REP,130006,0,2,0,2,
Cimarron,U.S. Senate,Kevin Crow,REP,130006,0,0,1,1,
Cimarron,U.S. Senate,James Lankford,REP,130006,2,3,41,46,
Cimarron,U.S. Senate,Jason Weger,REP,130006,0,0,1,1,
Cimarron,U.S. House,Timothy Ray Murray,REP,130006,0,0,1,1,03
Cimarron,U.S. House,Robert Hubbard,REP,130006,1,1,16,18,03
Cimarron,U.S. House,Frank Lucas,REP,130006,2,12,78,92,03
Cimarron,State House,Casey Murdock,REP,130006,2,5,43,50,61
Cimarron,State House,David Elder,REP,130006,0,1,4,5,61
Cimarron,State House,Steve Moore,REP,130006,0,0,8,8,61
Cimarron,State House,Kenny Bob Tapp,REP,130006,1,7,32,40,61
Cimarron,State House,Larry Swager,REP,130006,0,0,8,8,61
Cimarron,Superintendent of Public Instruction,John Cox,DEM,130007,0,0,5,5,
Cimarron,Superintendent of Public Instruction,Jack Jr.,DEM,130007,0,0,0,0,
Cimarron,Superintendent of Public Instruction,Ivan Holmes,DEM,130007,0,1,0,1,
Cimarron,Superintendent of Public Instruction,Freda Deskin,DEM,130007,0,2,4,6,
Cimarron,U.S. Senate,Patrick Michael Hayes,DEM,130007,0,0,1,1,
Cimarron,U.S. Senate,Jim Rogers,DEM,130007,0,2,3,5,
Cimarron,U.S. Senate,Connie Johnson,DEM,130007,0,1,5,6,
Cimarron,Governor,Dax Ewbank,REP,130007,1,2,4,7,
Cimarron,Governor,Chad Moody,REP,130007,0,0,2,2,
Cimarron,Governor,Mary Fallin,REP,130007,2,1,13,16,
Cimarron,Superintendent of Public Instruction,Brian Kelly,REP,130007,2,0,5,7,
Cimarron,Superintendent of Public Instruction,Janet Costello Barresi,REP,130007,0,0,2,2,
Cimarron,Superintendent of Public Instruction,Joy Hofmeister,REP,130007,1,3,12,16,
Cimarron,Insurance Commissioner,Bill Viner,REP,130007,0,1,6,7,
Cimarron,Insurance Commissioner,John Doak,REP,130007,3,2,13,18,
Cimarron,Corporation Commissioner,Todd Hiett,REP,130007,3,1,12,16,
Cimarron,Corporation Commissioner,Cliff Branan,REP,130007,0,2,7,9,
Cimarron,U.S. Senate,Evelyn Rogers,REP,130007,0,0,0,0,
Cimarron,U.S. Senate,Rob Moye,REP,130007,0,0,0,0,
Cimarron,U.S. Senate,D. Jean Mcbride-Samuels,REP,130007,0,0,0,0,
Cimarron,U.S. Senate,Jim Inhofe,REP,130007,3,3,19,25,
Cimarron,U.S. Senate,Erick Paul Wyatt,REP,130007,0,0,0,0,
Cimarron,U.S. Senate,Andy Craig,REP,130007,0,0,0,0,
Cimarron,U.S. Senate,T. Shannon,REP,130007,1,1,9,11,
Cimarron,U.S. Senate,Randy Brogdon,REP,130007,0,0,3,3,
Cimarron,U.S. Senate,Eric Mccray,REP,130007,0,1,0,1,
Cimarron,U.S. Senate,Kevin Crow,REP,130007,0,0,0,0,
Cimarron,U.S. Senate,James Lankford,REP,130007,2,1,7,10,
Cimarron,U.S. Senate,Jason Weger,REP,130007,0,0,0,0,
Cimarron,U.S. House,Timothy Ray Murray,REP,130007,0,1,0,1,03
Cimarron,U.S. House,Robert Hubbard,REP,130007,0,0,0,0,03
Cimarron,U.S. House,Frank Lucas,REP,130007,3,2,20,25,03
Cimarron,State House,Casey Murdock,REP,130007,0,1,5,6,61
Cimarron,State House,David Elder,REP,130007,0,0,0,0,61
Cimarron,State House,Steve Moore,REP,130007,0,0,7,7,61
Cimarron,State House,Kenny Bob Tapp,REP,130007,2,1,6,9,61
Cimarron,State House,Larry Swager,REP,130007,1,1,1,3,61
Cleveland,Superintendent of Public Instruction,John Cox,DEM,140002,0,0,19,19,
Cleveland,Superintendent of Public Instruction,Jack Jr.,DEM,140002,0,0,12,12,
Cleveland,Superintendent of Public Instruction,Ivan Holmes,DEM,140002,0,1,5,6,
Cleveland,Superintendent of Public Instruction,Freda Deskin,DEM,140002,1,1,38,40,
Cleveland,U.S. Senate,Patrick Michael Hayes,DEM,140002,0,0,13,13,
Cleveland,U.S. Senate,Jim Rogers,DEM,140002,0,0,17,17,
Cleveland,U.S. Senate,Connie Johnson,DEM,140002,1,2,43,46,
Cleveland,U.S. House,Bert Smith,DEM,140002,1,3,44,48,04
Cleveland,U.S. House,Tae Si,DEM,140002,0,0,27,27,04
Cleveland,Governor,Dax Ewbank,REP,140002,0,0,10,10,
Cleveland,Governor,Chad Moody,REP,140002,0,0,13,13,
Cleveland,Governor,Mary Fallin,REP,140002,2,0,26,28,
Cleveland,Superintendent of Public Instruction,Brian Kelly,REP,140002,0,0,17,17,
Cleveland,Superintendent of Public Instruction,Janet Costello Barresi,REP,140002,1,0,6,7,
Cleveland,Superintendent of Public Instruction,Joy Hofmeister,REP,140002,1,0,25,26,
Cleveland,Insurance Commissioner,Bill Viner,REP,140002,0,0,16,16,
Cleveland,Insurance Commissioner,John Doak,REP,140002,2,0,31,33,
Cleveland,Corporation Commissioner,Todd Hiett,REP,140002,0,0,26,26,
Cleveland,Corporation Commissioner,Cliff Branan,REP,140002,2,0,23,25,
Cleveland,U.S. Senate,Evelyn Rogers,REP,140002,1,0,6,7,
Cleveland,U.S. Senate,Rob Moye,REP,140002,0,0,2,2,
Cleveland,U.S. Senate,D. Jean Mcbride-Samuels,REP,140002,0,0,0,0,
Cleveland,U.S. Senate,Jim Inhofe,REP,140002,1,0,34,35,
Cleveland,U.S. Senate,Erick Paul Wyatt,REP,140002,0,0,7,7,
Cleveland,U.S. Senate,Andy Craig,REP,140002,0,0,1,1,
Cleveland,U.S. Senate,T. Shannon,REP,140002,0,0,15,15,
Cleveland,U.S. Senate,Randy Brogdon,REP,140002,1,0,8,9,
Cleveland,U.S. Senate,Eric Mccray,REP,140002,0,0,1,1,
Cleveland,U.S. Senate,Kevin Crow,REP,140002,0,0,2,2,
Cleveland,U.S. Senate,James Lankford,REP,140002,0,0,23,23,
Cleveland,U.S. Senate,Jason Weger,REP,140002,1,0,0,1,
Cleveland,U.S. House,Anna Flatt,REP,140002,0,0,15,15,04
Cleveland,U.S. House,Tom Cole,REP,140002,2,0,33,35,04
Cleveland,Superintendent of Public Instruction,John Cox,DEM,140003,0,1,27,28,
Cleveland,Superintendent of Public Instruction,Jack Jr.,DEM,140003,1,0,6,7,
Cleveland,Superintendent of Public Instruction,Ivan Holmes,DEM,140003,0,0,2,2,
Cleveland,Superintendent of Public Instruction,Freda Deskin,DEM,140003,0,2,53,55,
Cleveland,U.S. Senate,Patrick Michael Hayes,DEM,140003,0,0,8,8,
Cleveland,U.S. Senate,Jim Rogers,DEM,140003,0,2,26,28,
Cleveland,U.S. Senate,Connie Johnson,DEM,140003,1,1,52,54,
Cleveland,U.S. House,Bert Smith,DEM,140003,1,2,38,41,04
Cleveland,U.S. House,Tae Si,DEM,140003,0,1,39,40,04
Cleveland,Governor,Dax Ewbank,REP,140003,0,0,15,15,
Cleveland,Governor,Chad Moody,REP,140003,0,1,26,27,
Cleveland,Governor,Mary Fallin,REP,140003,1,2,71,74,
Cleveland,Superintendent of Public Instruction,Brian Kelly,REP,140003,0,0,23,23,
Cleveland,Superintendent of Public Instruction,Janet Costello Barresi,REP,140003,1,1,29,31,
Cleveland,Superintendent of Public Instruction,Joy Hofmeister,REP,140003,0,2,60,62,
Cleveland,Insurance Commissioner,Bill Viner,REP,140003,0,0,24,24,
Cleveland,Insurance Commissioner,John Doak,REP,140003,1,3,78,82,
Cleveland,Corporation Commissioner,Todd Hiett,REP,140003,1,1,45,47,
Cleveland,Corporation Commissioner,Cliff Branan,REP,140003,0,2,52,54,
Cleveland,U.S. Senate,Evelyn Rogers,REP,140003,0,0,10,10,
Cleveland,U.S. Senate,Rob Moye,REP,140003,0,1,2,3,
Cleveland,U.S. Senate,D. Jean Mcbride-Samuels,REP,140003,0,0,3,3,
Cleveland,U.S. Senate,Jim Inhofe,REP,140003,1,2,89,92,
Cleveland,U.S. Senate,Erick Paul Wyatt,REP,140003,0,0,5,5,
Cleveland,U.S. Senate,Andy Craig,REP,140003,0,0,2,2,
Cleveland,U.S. Senate,T. Shannon,REP,140003,0,2,26,28,
Cleveland,U.S. Senate,Randy Brogdon,REP,140003,0,0,7,7,
Cleveland,U.S. Senate,Eric Mccray,REP,140003,0,0,2,2,
Cleveland,U.S. Senate,Kevin Crow,REP,140003,0,0,0,0,
Cleveland,U.S. Senate,James Lankford,REP,140003,1,1,76,78,
Cleveland,U.S. Senate,Jason Weger,REP,140003,0,0,0,0,
Cleveland,U.S. House,Anna Flatt,REP,140003,0,1,16,17,04
Cleveland,U.S. House,Tom Cole,REP,140003,1,2,96,99,04
Cleveland,Superintendent of Public Instruction,John Cox,DEM,140004,2,0,40,42,
Cleveland,Superintendent of Public Instruction,Jack Jr.,DEM,140004,3,0,9,12,
Cleveland,Superintendent of Public Instruction,Ivan Holmes,DEM,140004,1,1,7,9,
Cleveland,Superintendent of Public Instruction,Freda Deskin,DEM,140004,0,5,57,62,
Cleveland,U.S. Senate,Patrick Michael Hayes,DEM,140004,1,0,15,16,
Cleveland,U.S. Senate,Jim Rogers,DEM,140004,2,2,32,36,
Cleveland,U.S. Senate,Connie Johnson,DEM,140004,2,4,60,66,
Cleveland,U.S. House,Bert Smith,DEM,140004,6,4,84,94,04
Cleveland,U.S. House,Tae Si,DEM,140004,0,2,22,24,04
Cleveland,Governor,Dax Ewbank,REP,140004,1,0,33,34,
Cleveland,Governor,Chad Moody,REP,140004,2,7,76,85,
Cleveland,Governor,Mary Fallin,REP,140004,34,22,496,552,
Cleveland,Superintendent of Public Instruction,Brian Kelly,REP,140004,6,7,96,109,
Cleveland,Superintendent of Public Instruction,Janet Costello Barresi,REP,140004,11,7,201,219,
Cleveland,Superintendent of Public Instruction,Joy Hofmeister,REP,140004,19,14,295,328,
Cleveland,Insurance Commissioner,Bill Viner,REP,140004,2,6,130,138,
Cleveland,Insurance Commissioner,John Doak,REP,140004,32,22,413,467,
Cleveland,Corporation Commissioner,Todd Hiett,REP,140004,16,12,257,285,
Cleveland,Corporation Commissioner,Cliff Branan,REP,140004,17,17,296,330,
Cleveland,U.S. Senate,Evelyn Rogers,REP,140004,0,4,33,37,
Cleveland,U.S. Senate,Rob Moye,REP,140004,0,0,3,3,
Cleveland,U.S. Senate,D. Jean Mcbride-Samuels,REP,140004,1,0,4,5,
Cleveland,U.S. Senate,Jim Inhofe,REP,140004,37,25,537,599,
Cleveland,U.S. Senate,Erick Paul Wyatt,REP,140004,0,0,24,24,
Cleveland,U.S. Senate,Andy Craig,REP,140004,1,0,2,3,
Cleveland,U.S. Senate,T. Shannon,REP,140004,6,5,117,128,
Cleveland,U.S. Senate,Randy Brogdon,REP,140004,0,0,10,10,
Cleveland,U.S. Senate,Eric Mccray,REP,140004,0,0,1,1,
Cleveland,U.S. Senate,Kevin Crow,REP,140004,0,0,2,2,
Cleveland,U.S. Senate,James Lankford,REP,140004,32,24,478,534,
Cleveland,U.S. Senate,Jason Weger,REP,140004,0,0,2,2,
Cleveland,U.S. House,Anna Flatt,REP,140004,3,5,89,97,04
Cleveland,U.S. House,Tom Cole,REP,140004,36,24,517,577,04
Cleveland,State House,Chris Kannady,REP,140004,12,14,289,315,91
Cleveland,State House,Jon Painter,REP,140004,17,13,249,279,91
Cleveland,State House,Chad Olsen,REP,140004,2,1,48,51,91
Cleveland,State House,David Monlux,REP,140004,2,1,4,7,91
Cleveland,State House,Scott Esk,REP,140004,4,0,13,17,91
Cleveland,Superintendent of Public Instruction,John Cox,DEM,140005,1,0,41,42,
Cleveland,Superintendent of Public Instruction,Jack Jr.,DEM,140005,3,0,19,22,
Cleveland,Superintendent of Public Instruction,Ivan Holmes,DEM,140005,2,0,11,13,
Cleveland,Superintendent of Public Instruction,Freda Deskin,DEM,140005,1,2,61,64,
Cleveland,U.S. Senate,Patrick Michael Hayes,DEM,140005,2,0,35,37,
Cleveland,U.S. Senate,Jim Rogers,DEM,140005,0,2,32,34,
Cleveland,U.S. Senate,Connie Johnson,DEM,140005,5,0,61,66,
Cleveland,U.S. House,Bert Smith,DEM,140005,5,2,99,106,04
Cleveland,U.S. House,Tae Si,DEM,140005,2,0,22,24,04
Cleveland,Governor,Dax Ewbank,REP,140005,3,2,36,41,
Cleveland,Governor,Chad Moody,REP,140005,1,2,79,82,
Cleveland,Governor,Mary Fallin,REP,140005,28,10,348,386,
Cleveland,Superintendent of Public Instruction,Brian Kelly,REP,140005,7,2,98,107,
Cleveland,Superintendent of Public Instruction,Janet Costello Barresi,REP,140005,12,3,108,123,
Cleveland,Superintendent of Public Instruction,Joy Hofmeister,REP,140005,11,8,256,275,
Cleveland,Insurance Commissioner,Bill Viner,REP,140005,7,3,101,111,
Cleveland,Insurance Commissioner,John Doak,REP,140005,22,10,339,371,
Cleveland,Corporation Commissioner,Todd Hiett,REP,140005,14,5,181,200,
Cleveland,Corporation Commissioner,Cliff Branan,REP,140005,13,8,249,270,
Cleveland,U.S. Senate,Evelyn Rogers,REP,140005,2,0,23,25,
Cleveland,U.S. Senate,Rob Moye,REP,140005,0,1,7,8,
Cleveland,U.S. Senate,D. Jean Mcbride-Samuels,REP,140005,0,0,6,6,
Cleveland,U.S. Senate,Jim Inhofe,REP,140005,30,13,407,450,
Cleveland,U.S. Senate,Erick Paul Wyatt,REP,140005,0,0,20,20,
Cleveland,U.S. Senate,Andy Craig,REP,140005,0,0,3,3,
Cleveland,U.S. Senate,T. Shannon,REP,140005,8,5,144,157,
Cleveland,U.S. Senate,Randy Brogdon,REP,140005,1,1,10,12,
Cleveland,U.S. Senate,Eric Mccray,REP,140005,0,1,6,7,
Cleveland,U.S. Senate,Kevin Crow,REP,140005,0,0,4,4,
Cleveland,U.S. Senate,James Lankford,REP,140005,23,8,294,325,
Cleveland,U.S. Senate,Jason Weger,REP,140005,0,0,4,4,
Cleveland,U.S. House,Anna Flatt,REP,140005,12,1,67,80,04
Cleveland,U.S. House,Tom Cole,REP,140005,20,13,393,426,04
Cleveland,State House,Paul Wesselhoft,REP,140005,25,10,343,378,54
Cleveland,State House,Adam Graham,REP,140005,7,2,112,121,54
Cleveland,Superintendent of Public Instruction,John Cox,DEM,140006,0,0,15,15,
Cleveland,Superintendent of Public Instruction,Jack Jr.,DEM,140006,2,2,14,18,
Cleveland,Superintendent of Public Instruction,Ivan Holmes,DEM,140006,0,0,9,9,
Cleveland,Superintendent of Public Instruction,Freda Deskin,DEM,140006,2,2,100,104,
Cleveland,U.S. Senate,Patrick Michael Hayes,DEM,140006,0,1,10,11,
Cleveland,U.S. Senate,Jim Rogers,DEM,140006,0,0,20,20,
Cleveland,U.S. Senate,Connie Johnson,DEM,140006,4,3,103,110,
Cleveland,U.S. House,Bert Smith,DEM,140006,0,2,75,77,04
Cleveland,U.S. House,Tae Si,DEM,140006,3,2,49,54,04
Cleveland,Governor,Dax Ewbank,REP,140006,1,0,8,9,
Cleveland,Governor,Chad Moody,REP,140006,0,0,9,9,
Cleveland,Governor,Mary Fallin,REP,140006,3,5,44,52,
Cleveland,Superintendent of Public Instruction,Brian Kelly,REP,140006,3,1,9,13,
Cleveland,Superintendent of Public Instruction,Janet Costello Barresi,REP,140006,0,1,26,27,
Cleveland,Superintendent of Public Instruction,Joy Hofmeister,REP,140006,1,3,26,30,
Cleveland,Insurance Commissioner,Bill Viner,REP,140006,1,1,13,15,
Cleveland,Insurance Commissioner,John Doak,REP,140006,3,3,41,47,
Cleveland,Corporation Commissioner,Todd Hiett,REP,140006,2,4,20,26,
Cleveland,Corporation Commissioner,Cliff Branan,REP,140006,2,0,35,37,
Cleveland,U.S. Senate,Evelyn Rogers,REP,140006,0,0,3,3,
Cleveland,U.S. Senate,Rob Moye,REP,140006,0,0,1,1,
Cleveland,U.S. Senate,D. Jean Mcbride-Samuels,REP,140006,0,0,1,1,
Cleveland,U.S. Senate,Jim Inhofe,REP,140006,4,5,51,60,
Cleveland,U.S. Senate,Erick Paul Wyatt,REP,140006,0,0,5,5,
Cleveland,U.S. Senate,Andy Craig,REP,140006,0,0,0,0,
Cleveland,U.S. Senate,T. Shannon,REP,140006,1,0,13,14,
Cleveland,U.S. Senate,Randy Brogdon,REP,140006,0,1,1,2,
Cleveland,U.S. Senate,Eric Mccray,REP,140006,0,0,0,0,
Cleveland,U.S. Senate,Kevin Crow,REP,140006,0,0,0,0,
Cleveland,U.S. Senate,James Lankford,REP,140006,2,4,48,54,
Cleveland,U.S. Senate,Jason Weger,REP,140006,1,0,0,1,
Cleveland,U.S. House,Anna Flatt,REP,140006,0,0,9,9,04
Cleveland,U.S. House,Tom Cole,REP,140006,4,5,50,59,04
Cleveland,Superintendent of Public Instruction,John Cox,DEM,140007,1,0,14,15,
Cleveland,Superintendent of Public Instruction,Jack Jr.,DEM,140007,0,0,7,7,
Cleveland,Superintendent of Public Instruction,Ivan Holmes,DEM,140007,0,2,3,5,
Cleveland,Superintendent of Public Instruction,Freda Deskin,DEM,140007,0,0,23,23,
Cleveland,U.S. Senate,Patrick Michael Hayes,DEM,140007,1,0,10,11,
Cleveland,U.S. Senate,Jim Rogers,DEM,140007,0,0,19,19,
Cleveland,U.S. Senate,Connie Johnson,DEM,140007,0,2,18,20,
Cleveland,U.S. House,Bert Smith,DEM,140007,1,2,31,34,04
Cleveland,U.S. House,Tae Si,DEM,140007,0,0,13,13,04
Cleveland,Governor,Dax Ewbank,REP,140007,0,0,26,26,
Cleveland,Governor,Chad Moody,REP,140007,4,2,49,55,
Cleveland,Governor,Mary Fallin,REP,140007,9,6,180,195,
Cleveland,Superintendent of Public Instruction,Brian Kelly,REP,140007,1,1,57,59,
Cleveland,Superintendent of Public Instruction,Janet Costello Barresi,REP,140007,7,3,46,56,
Cleveland,Superintendent of Public Instruction,Joy Hofmeister,REP,140007,5,4,149,158,
Cleveland,Insurance Commissioner,Bill Viner,REP,140007,4,3,58,65,
Cleveland,Insurance Commissioner,John Doak,REP,140007,8,5,172,185,
Cleveland,Corporation Commissioner,Todd Hiett,REP,140007,5,3,113,121,
Cleveland,Corporation Commissioner,Cliff Branan,REP,140007,5,4,116,125,
Cleveland,U.S. Senate,Evelyn Rogers,REP,140007,0,0,9,9,
Cleveland,U.S. Senate,Rob Moye,REP,140007,0,0,4,4,
Cleveland,U.S. Senate,D. Jean Mcbride-Samuels,REP,140007,1,0,2,3,
Cleveland,U.S. Senate,Jim Inhofe,REP,140007,12,7,224,243,
Cleveland,U.S. Senate,Erick Paul Wyatt,REP,140007,0,0,11,11,
Cleveland,U.S. Senate,Andy Craig,REP,140007,0,0,2,2,
Cleveland,U.S. Senate,T. Shannon,REP,140007,5,1,65,71,
Cleveland,U.S. Senate,Randy Brogdon,REP,140007,0,0,10,10,
Cleveland,U.S. Senate,Eric Mccray,REP,140007,0,1,0,1,
Cleveland,U.S. Senate,Kevin Crow,REP,140007,0,0,0,0,
Cleveland,U.S. Senate,James Lankford,REP,140007,8,6,178,192,
Cleveland,U.S. Senate,Jason Weger,REP,140007,0,0,1,1,
Cleveland,U.S. House,Anna Flatt,REP,140007,1,0,33,34,04
Cleveland,U.S. House,Tom Cole,REP,140007,12,8,218,238,04
Cleveland,Superintendent of Public Instruction,John Cox,DEM,140008,0,1,16,17,
Cleveland,Superintendent of Public Instruction,Jack Jr.,DEM,140008,0,2,14,16,
Cleveland,Superintendent of Public Instruction,Ivan Holmes,DEM,140008,1,0,7,8,
Cleveland,Superintendent of Public Instruction,Freda Deskin,DEM,140008,0,2,94,96,
Cleveland,U.S. Senate,Patrick Michael Hayes,DEM,140008,0,0,11,11,
Cleveland,U.S. Senate,Jim Rogers,DEM,140008,0,1,12,13,
Cleveland,U.S. Senate,Connie Johnson,DEM,140008,1,5,100,106,
Cleveland,U.S. House,Bert Smith,DEM,140008,0,5,64,69,04
Cleveland,U.S. House,Tae Si,DEM,140008,1,1,55,57,04
Cleveland,Governor,Dax Ewbank,REP,140008,0,0,8,8,
Cleveland,Governor,Chad Moody,REP,140008,0,0,10,10,
Cleveland,Governor,Mary Fallin,REP,140008,3,1,26,30,
Cleveland,Superintendent of Public Instruction,Brian Kelly,REP,140008,0,0,10,10,
Cleveland,Superintendent of Public Instruction,Janet Costello Barresi,REP,140008,3,1,10,14,
Cleveland,Superintendent of Public Instruction,Joy Hofmeister,REP,140008,0,0,24,24,
Cleveland,Insurance Commissioner,Bill Viner,REP,140008,0,0,9,9,
Cleveland,Insurance Commissioner,John Doak,REP,140008,3,1,28,32,
Cleveland,Corporation Commissioner,Todd Hiett,REP,140008,2,0,21,23,
Cleveland,Corporation Commissioner,Cliff Branan,REP,140008,1,0,16,17,
Cleveland,U.S. Senate,Evelyn Rogers,REP,140008,0,0,8,8,
Cleveland,U.S. Senate,Rob Moye,REP,140008,0,0,1,1,
Cleveland,U.S. Senate,D. Jean Mcbride-Samuels,REP,140008,0,0,2,2,
Cleveland,U.S. Senate,Jim Inhofe,REP,140008,3,1,29,33,
Cleveland,U.S. Senate,Erick Paul Wyatt,REP,140008,0,0,2,2,
Cleveland,U.S. Senate,Andy Craig,REP,140008,0,0,2,2,
Cleveland,U.S. Senate,T. Shannon,REP,140008,0,1,13,14,
Cleveland,U.S. Senate,Randy Brogdon,REP,140008,0,0,2,2,
Cleveland,U.S. Senate,Eric Mccray,REP,140008,0,0,0,0,
Cleveland,U.S. Senate,Kevin Crow,REP,140008,0,0,2,2,
Cleveland,U.S. Senate,James Lankford,REP,140008,3,0,22,25,
Cleveland,U.S. Senate,Jason Weger,REP,140008,0,0,2,2,
Cleveland,U.S. House,Anna Flatt,REP,140008,0,0,13,13,04
Cleveland,U.S. House,Tom Cole,REP,140008,3,1,32,36,04
Cleveland,Superintendent of Public Instruction,John Cox,DEM,140009,0,0,15,15,
Cleveland,Superintendent of Public Instruction,Jack Jr.,DEM,140009,0,0,17,17,
Cleveland,Superintendent of Public Instruction,Ivan Holmes,DEM,140009,2,1,8,11,
Cleveland,Superintendent of Public Instruction,Freda Deskin,DEM,140009,0,0,40,40,
Cleveland,U.S. Senate,Patrick Michael Hayes,DEM,140009,0,0,20,20,
Cleveland,U.S. Senate,Jim Rogers,DEM,140009,0,1,22,23,
Cleveland,U.S. Senate,Connie Johnson,DEM,140009,2,0,37,39,
Cleveland,U.S. House,Bert Smith,DEM,140009,2,0,59,61,04
Cleveland,U.S. House,Tae Si,DEM,140009,0,1,15,16,04
Cleveland,Governor,Dax Ewbank,REP,140009,3,3,33,39,
Cleveland,Governor,Chad Moody,REP,140009,0,6,50,56,
Cleveland,Governor,Mary Fallin,REP,140009,12,13,278,303,
Cleveland,Superintendent of Public Instruction,Brian Kelly,REP,140009,3,7,77,87,
Cleveland,Superintendent of Public Instruction,Janet Costello Barresi,REP,140009,2,3,69,74,
Cleveland,Superintendent of Public Instruction,Joy Hofmeister,REP,140009,10,10,212,232,
Cleveland,Insurance Commissioner,Bill Viner,REP,140009,7,7,78,92,
Cleveland,Insurance Commissioner,John Doak,REP,140009,8,12,253,273,
Cleveland,Corporation Commissioner,Todd Hiett,REP,140009,6,11,155,172,
Cleveland,Corporation Commissioner,Cliff Branan,REP,140009,9,8,182,199,
Cleveland,U.S. Senate,Evelyn Rogers,REP,140009,1,4,17,22,
Cleveland,U.S. Senate,Rob Moye,REP,140009,0,1,9,10,
Cleveland,U.S. Senate,D. Jean Mcbride-Samuels,REP,140009,0,0,7,7,
Cleveland,U.S. Senate,Jim Inhofe,REP,140009,14,16,315,345,
Cleveland,U.S. Senate,Erick Paul Wyatt,REP,140009,0,0,10,10,
Cleveland,U.S. Senate,Andy Craig,REP,140009,0,0,2,2,
Cleveland,U.S. Senate,T. Shannon,REP,140009,8,10,102,120,
Cleveland,U.S. Senate,Randy Brogdon,REP,140009,0,0,15,15,
Cleveland,U.S. Senate,Eric Mccray,REP,140009,0,0,2,2,
Cleveland,U.S. Senate,Kevin Crow,REP,140009,0,0,4,4,
Cleveland,U.S. Senate,James Lankford,REP,140009,7,12,239,258,
Cleveland,U.S. Senate,Jason Weger,REP,140009,0,0,4,4,
Cleveland,U.S. House,Anna Flatt,REP,140009,2,6,54,62,04
Cleveland,U.S. House,Tom Cole,REP,140009,13,16,310,339,04
Cleveland,State House,Chris Kannady,REP,140009,7,17,194,218,91
Cleveland,State House,Jon Painter,REP,140009,7,2,120,129,91
Cleveland,State House,Chad Olsen,REP,140009,0,1,18,19,91
Cleveland,State House,David Monlux,REP,140009,0,0,3,3,91
Cleveland,State House,Scott Esk,REP,140009,1,1,17,19,91
Cleveland,Superintendent of Public Instruction,John Cox,DEM,140010,1,1,19,21,
Cleveland,Superintendent of Public Instruction,Jack Jr.,DEM,140010,2,0,8,10,
Cleveland,Superintendent of Public Instruction,Ivan Holmes,DEM,140010,0,0,7,7,
Cleveland,Superintendent of Public Instruction,Freda Deskin,DEM,140010,2,1,32,35,
Cleveland,U.S. Senate,Patrick Michael Hayes,DEM,140010,0,0,7,7,
Cleveland,U.S. Senate,Jim Rogers,DEM,140010,2,1,23,26,
Cleveland,U.S. Senate,Connie Johnson,DEM,140010,3,1,35,39,
Cleveland,U.S. House,Bert Smith,DEM,140010,4,1,42,47,04
Cleveland,U.S. House,Tae Si,DEM,140010,1,1,17,19,04
Cleveland,Governor,Dax Ewbank,REP,140010,0,1,19,20,
Cleveland,Governor,Chad Moody,REP,140010,0,1,20,21,
Cleveland,Governor,Mary Fallin,REP,140010,19,5,162,186,
Cleveland,Superintendent of Public Instruction,Brian Kelly,REP,140010,3,0,44,47,
Cleveland,Superintendent of Public Instruction,Janet Costello Barresi,REP,140010,2,3,53,58,
Cleveland,Superintendent of Public Instruction,Joy Hofmeister,REP,140010,14,4,99,117,
Cleveland,Insurance Commissioner,Bill Viner,REP,140010,4,0,49,53,
Cleveland,Insurance Commissioner,John Doak,REP,140010,15,7,134,156,
Cleveland,Corporation Commissioner,Todd Hiett,REP,140010,12,2,80,94,
Cleveland,Corporation Commissioner,Cliff Branan,REP,140010,7,4,97,108,
Cleveland,U.S. Senate,Evelyn Rogers,REP,140010,0,0,11,11,
Cleveland,U.S. Senate,Rob Moye,REP,140010,0,0,1,1,
Cleveland,U.S. Senate,D. Jean Mcbride-Samuels,REP,140010,1,0,2,3,
Cleveland,U.S. Senate,Jim Inhofe,REP,140010,18,7,181,206,
Cleveland,U.S. Senate,Erick Paul Wyatt,REP,140010,0,0,1,1,
Cleveland,U.S. Senate,Andy Craig,REP,140010,0,0,1,1,
Cleveland,U.S. Senate,T. Shannon,REP,140010,3,1,36,40,
Cleveland,U.S. Senate,Randy Brogdon,REP,140010,0,0,3,3,
Cleveland,U.S. Senate,Eric Mccray,REP,140010,0,0,0,0,
Cleveland,U.S. Senate,Kevin Crow,REP,140010,0,0,3,3,
Cleveland,U.S. Senate,James Lankford,REP,140010,16,6,156,178,
Cleveland,U.S. Senate,Jason Weger,REP,140010,0,0,0,0,
Cleveland,U.S. House,Anna Flatt,REP,140010,3,1,26,30,04
Cleveland,U.S. House,Tom Cole,REP,140010,16,6,163,185,04
Cleveland,State House,Paul Wesselhoft,REP,140010,16,7,156,179,54
Cleveland,State House,Adam Graham,REP,140010,3,0,42,45,54
Cleveland,Superintendent of Public Instruction,John Cox,DEM,140011,1,3,27,31,
Cleveland,Superintendent of Public Instruction,Jack Jr.,DEM,140011,0,0,27,27,
Cleveland,Superintendent of Public Instruction,Ivan Holmes,DEM,140011,0,0,9,9,
Cleveland,Superintendent of Public Instruction,Freda Deskin,DEM,140011,3,6,113,122,
Cleveland,U.S. Senate,Patrick Michael Hayes,DEM,140011,0,0,29,29,
Cleveland,U.S. Senate,Jim Rogers,DEM,140011,0,3,29,32,
Cleveland,U.S. Senate,Connie Johnson,DEM,140011,4,6,105,115,
Cleveland,U.S. House,Bert Smith,DEM,140011,4,4,74,82,04
Cleveland,U.S. House,Tae Si,DEM,140011,0,3,57,60,04
Cleveland,Governor,Dax Ewbank,REP,140011,1,2,7,10,
Cleveland,Governor,Chad Moody,REP,140011,0,1,28,29,
Cleveland,Governor,Mary Fallin,REP,140011,3,3,69,75,
Cleveland,Superintendent of Public Instruction,Brian Kelly,REP,140011,1,2,21,24,
Cleveland,Superintendent of Public Instruction,Janet Costello Barresi,REP,140011,1,2,28,31,
Cleveland,Superintendent of Public Instruction,Joy Hofmeister,REP,140011,1,2,52,55,
Cleveland,Insurance Commissioner,Bill Viner,REP,140011,1,1,28,30,
Cleveland,Insurance Commissioner,John Doak,REP,140011,3,5,66,74,
Cleveland,Corporation Commissioner,Todd Hiett,REP,140011,3,4,39,46,
Cleveland,Corporation Commissioner,Cliff Branan,REP,140011,1,2,57,60,
Cleveland,U.S. Senate,Evelyn Rogers,REP,140011,0,2,8,10,
Cleveland,U.S. Senate,Rob Moye,REP,140011,0,1,2,3,
Cleveland,U.S. Senate,D. Jean Mcbride-Samuels,REP,140011,0,0,4,4,
Cleveland,U.S. Senate,Jim Inhofe,REP,140011,4,3,86,93,
Cleveland,U.S. Senate,Erick Paul Wyatt,REP,140011,0,0,4,4,
Cleveland,U.S. Senate,Andy Craig,REP,140011,0,0,3,3,
Cleveland,U.S. Senate,T. Shannon,REP,140011,1,1,34,36,
Cleveland,U.S. Senate,Randy Brogdon,REP,140011,0,0,2,2,
Cleveland,U.S. Senate,Eric Mccray,REP,140011,0,0,1,1,
Cleveland,U.S. Senate,Kevin Crow,REP,140011,0,1,1,2,
Cleveland,U.S. Senate,James Lankford,REP,140011,3,3,60,66,
Cleveland,U.S. Senate,Jason Weger,REP,140011,0,1,2,3,
Cleveland,U.S. House,Anna Flatt,REP,140011,0,1,25,26,04
Cleveland,U.S. House,Tom Cole,REP,140011,4,5,80,89,04
Cleveland,Superintendent of Public Instruction,John Cox,DEM,140012,3,2,31,36,
Cleveland,Superintendent of Public Instruction,Jack Jr.,DEM,140012,0,0,14,14,
Cleveland,Superintendent of Public Instruction,Ivan Holmes,DEM,140012,0,0,8,8,
Cleveland,Superintendent of Public Instruction,Freda Deskin,DEM,140012,1,2,66,69,
Cleveland,U.S. Senate,Patrick Michael Hayes,DEM,140012,0,0,10,10,
Cleveland,U.S. Senate,Jim Rogers,DEM,140012,2,1,32,35,
Cleveland,U.S. Senate,Connie Johnson,DEM,140012,2,3,77,82,
Cleveland,U.S. House,Bert Smith,DEM,140012,4,2,80,86,04
Cleveland,U.S. House,Tae Si,DEM,140012,0,1,29,30,04
Cleveland,Governor,Dax Ewbank,REP,140012,0,4,26,30,
Cleveland,Governor,Chad Moody,REP,140012,0,5,42,47,
Cleveland,Governor,Mary Fallin,REP,140012,7,11,166,184,
Cleveland,Superintendent of Public Instruction,Brian Kelly,REP,140012,3,4,48,55,
Cleveland,Superintendent of Public Instruction,Janet Costello Barresi,REP,140012,2,4,53,59,
Cleveland,Superintendent of Public Instruction,Joy Hofmeister,REP,140012,2,11,129,142,
Cleveland,Insurance Commissioner,Bill Viner,REP,140012,2,3,51,56,
Cleveland,Insurance Commissioner,John Doak,REP,140012,5,16,166,187,
Cleveland,Corporation Commissioner,Todd Hiett,REP,140012,4,7,115,126,
Cleveland,Corporation Commissioner,Cliff Branan,REP,140012,3,9,96,108,
Cleveland,U.S. Senate,Evelyn Rogers,REP,140012,1,1,17,19,
Cleveland,U.S. Senate,Rob Moye,REP,140012,0,0,4,4,
Cleveland,U.S. Senate,D. Jean Mcbride-Samuels,REP,140012,0,1,4,5,
Cleveland,U.S. Senate,Jim Inhofe,REP,140012,6,15,200,221,
Cleveland,U.S. Senate,Erick Paul Wyatt,REP,140012,0,1,9,10,
Cleveland,U.S. Senate,Andy Craig,REP,140012,0,0,1,1,
Cleveland,U.S. Senate,T. Shannon,REP,140012,0,3,89,92,
Cleveland,U.S. Senate,Randy Brogdon,REP,140012,0,2,10,12,
Cleveland,U.S. Senate,Eric Mccray,REP,140012,0,2,2,4,
Cleveland,U.S. Senate,Kevin Crow,REP,140012,0,0,1,1,
Cleveland,U.S. Senate,James Lankford,REP,140012,7,12,132,151,
Cleveland,U.S. Senate,Jason Weger,REP,140012,0,0,0,0,
Cleveland,U.S. House,Anna Flatt,REP,140012,2,4,59,65,04
Cleveland,U.S. House,Tom Cole,REP,140012,5,15,174,194,04
Cleveland,Superintendent of Public Instruction,John Cox,DEM,140013,0,0,0,0,
Cleveland,Superintendent of Public Instruction,Jack Jr.,DEM,140013,1,0,2,3,
Cleveland,Superintendent of Public Instruction,Ivan Holmes,DEM,140013,0,0,1,1,
Cleveland,Superintendent of Public Instruction,Freda Deskin,DEM,140013,1,0,14,15,
Cleveland,U.S. Senate,Patrick Michael Hayes,DEM,140013,0,0,0,0,
Cleveland,U.S. Senate,Jim Rogers,DEM,140013,1,0,1,2,
Cleveland,U.S. Senate,Connie Johnson,DEM,140013,1,0,16,17,
Cleveland,U.S. House,Bert Smith,DEM,140013,2,0,9,11,04
Cleveland,U.S. House,Tae Si,DEM,140013,0,0,8,8,04
Cleveland,Governor,Dax Ewbank,REP,140013,0,0,2,2,
Cleveland,Governor,Chad Moody,REP,140013,1,0,4,5,
Cleveland,Governor,Mary Fallin,REP,140013,1,2,10,13,
Cleveland,Superintendent of Public Instruction,Brian Kelly,REP,140013,0,1,0,1,
Cleveland,Superintendent of Public Instruction,Janet Costello Barresi,REP,140013,0,0,1,1,
Cleveland,Superintendent of Public Instruction,Joy Hofmeister,REP,140013,2,1,11,14,
Cleveland,Insurance Commissioner,Bill Viner,REP,140013,0,1,3,4,
Cleveland,Insurance Commissioner,John Doak,REP,140013,2,1,9,12,
Cleveland,Corporation Commissioner,Todd Hiett,REP,140013,1,0,8,9,
Cleveland,Corporation Commissioner,Cliff Branan,REP,140013,1,2,4,7,
Cleveland,U.S. Senate,Evelyn Rogers,REP,140013,0,0,1,1,
Cleveland,U.S. Senate,Rob Moye,REP,140013,0,0,0,0,
Cleveland,U.S. Senate,D. Jean Mcbride-Samuels,REP,140013,0,0,0,0,
Cleveland,U.S. Senate,Jim Inhofe,REP,140013,2,2,12,16,
Cleveland,U.S. Senate,Erick Paul Wyatt,REP,140013,0,0,0,0,
Cleveland,U.S. Senate,Andy Craig,REP,140013,0,0,0,0,
Cleveland,U.S. Senate,T. Shannon,REP,140013,0,0,6,6,
Cleveland,U.S. Senate,Randy Brogdon,REP,140013,0,0,1,1,
Cleveland,U.S. Senate,Eric Mccray,REP,140013,0,0,1,1,
Cleveland,U.S. Senate,Kevin Crow,REP,140013,0,0,0,0,
Cleveland,U.S. Senate,James Lankford,REP,140013,1,2,8,11,
Cleveland,U.S. Senate,Jason Weger,REP,140013,1,0,0,1,
Cleveland,U.S. House,Anna Flatt,REP,140013,0,1,3,4,04
Cleveland,U.S. House,Tom Cole,REP,140013,2,1,9,12,04
Cleveland,Superintendent of Public Instruction,John Cox,DEM,140014,0,0,14,14,
Cleveland,Superintendent of Public Instruction,Jack Jr.,DEM,140014,0,0,16,16,
Cleveland,Superintendent of Public Instruction,Ivan Holmes,DEM,140014,1,0,5,6,
Cleveland,Superintendent of Public Instruction,Freda Deskin,DEM,140014,1,5,37,43,
Cleveland,U.S. Senate,Patrick Michael Hayes,DEM,140014,0,1,8,9,
Cleveland,U.S. Senate,Jim Rogers,DEM,140014,0,0,9,9,
Cleveland,U.S. Senate,Connie Johnson,DEM,140014,2,2,56,60,
Cleveland,U.S. House,Bert Smith,DEM,140014,1,2,37,40,04
Cleveland,U.S. House,Tae Si,DEM,140014,1,1,31,33,04
Cleveland,Governor,Dax Ewbank,REP,140014,0,0,8,8,
Cleveland,Governor,Chad Moody,REP,140014,0,0,10,10,
Cleveland,Governor,Mary Fallin,REP,140014,1,0,35,36,
Cleveland,Superintendent of Public Instruction,Brian Kelly,REP,140014,0,0,15,15,
Cleveland,Superintendent of Public Instruction,Janet Costello Barresi,REP,140014,0,0,9,9,
Cleveland,Superintendent of Public Instruction,Joy Hofmeister,REP,140014,1,0,27,28,
Cleveland,Insurance Commissioner,Bill Viner,REP,140014,0,0,15,15,
Cleveland,Insurance Commissioner,John Doak,REP,140014,1,0,30,31,
Cleveland,Corporation Commissioner,Todd Hiett,REP,140014,0,0,23,23,
Cleveland,Corporation Commissioner,Cliff Branan,REP,140014,1,0,25,26,
Cleveland,U.S. Senate,Evelyn Rogers,REP,140014,0,0,5,5,
Cleveland,U.S. Senate,Rob Moye,REP,140014,0,0,2,2,
Cleveland,U.S. Senate,D. Jean Mcbride-Samuels,REP,140014,0,0,1,1,
Cleveland,U.S. Senate,Jim Inhofe,REP,140014,1,0,38,39,
Cleveland,U.S. Senate,Erick Paul Wyatt,REP,140014,0,0,5,5,
Cleveland,U.S. Senate,Andy Craig,REP,140014,0,0,0,0,
Cleveland,U.S. Senate,T. Shannon,REP,140014,0,0,18,18,
Cleveland,U.S. Senate,Randy Brogdon,REP,140014,0,0,2,2,
Cleveland,U.S. Senate,Eric Mccray,REP,140014,0,0,0,0,
Cleveland,U.S. Senate,Kevin Crow,REP,140014,0,0,0,0,
Cleveland,U.S. Senate,James Lankford,REP,140014,1,0,33,34,
Cleveland,U.S. Senate,Jason Weger,REP,140014,0,0,0,0,
Cleveland,U.S. House,Anna Flatt,REP,140014,0,0,9,9,04
Cleveland,U.S. House,Tom Cole,REP,140014,1,0,44,45,04
Cleveland,Superintendent of Public Instruction,John Cox,DEM,140015,0,0,30,30,
Cleveland,Superintendent of Public Instruction,Jack Jr.,DEM,140015,0,0,19,19,
Cleveland,Superintendent of Public Instruction,Ivan Holmes,DEM,140015,2,0,8,10,
Cleveland,Superintendent of Public Instruction,Freda Deskin,DEM,140015,4,7,95,106,
Cleveland,U.S. Senate,Patrick Michael Hayes,DEM,140015,0,1,19,20,
Cleveland,U.S. Senate,Jim Rogers,DEM,140015,0,1,21,22,
Cleveland,U.S. Senate,Connie Johnson,DEM,140015,6,5,107,118,
Cleveland,U.S. House,Bert Smith,DEM,140015,3,3,79,85,04
Cleveland,U.S. House,Tae Si,DEM,140015,3,4,51,58,04
Cleveland,Governor,Dax Ewbank,REP,140015,0,3,6,9,
Cleveland,Governor,Chad Moody,REP,140015,0,2,21,23,
Cleveland,Governor,Mary Fallin,REP,140015,3,6,78,87,
Cleveland,Superintendent of Public Instruction,Brian Kelly,REP,140015,1,0,23,24,
Cleveland,Superintendent of Public Instruction,Janet Costello Barresi,REP,140015,0,4,26,30,
Cleveland,Superintendent of Public Instruction,Joy Hofmeister,REP,140015,2,7,55,64,
Cleveland,Insurance Commissioner,Bill Viner,REP,140015,0,1,18,19,
Cleveland,Insurance Commissioner,John Doak,REP,140015,3,10,76,89,
Cleveland,Corporation Commissioner,Todd Hiett,REP,140015,2,8,49,59,
Cleveland,Corporation Commissioner,Cliff Branan,REP,140015,1,3,46,50,
Cleveland,U.S. Senate,Evelyn Rogers,REP,140015,0,0,8,8,
Cleveland,U.S. Senate,Rob Moye,REP,140015,0,0,3,3,
Cleveland,U.S. Senate,D. Jean Mcbride-Samuels,REP,140015,0,0,2,2,
Cleveland,U.S. Senate,Jim Inhofe,REP,140015,3,7,90,100,
Cleveland,U.S. Senate,Erick Paul Wyatt,REP,140015,0,0,3,3,
Cleveland,U.S. Senate,Andy Craig,REP,140015,0,0,0,0,
Cleveland,U.S. Senate,T. Shannon,REP,140015,0,1,32,33,
Cleveland,U.S. Senate,Randy Brogdon,REP,140015,0,4,5,9,
Cleveland,U.S. Senate,Eric Mccray,REP,140015,0,1,3,4,
Cleveland,U.S. Senate,Kevin Crow,REP,140015,0,0,1,1,
Cleveland,U.S. Senate,James Lankford,REP,140015,3,4,64,71,
Cleveland,U.S. Senate,Jason Weger,REP,140015,0,0,1,1,
Cleveland,U.S. House,Anna Flatt,REP,140015,2,6,24,32,04
Cleveland,U.S. House,Tom Cole,REP,140015,1,4,83,88,04
Cleveland,Superintendent of Public Instruction,John Cox,DEM,140016,2,0,33,35,
Cleveland,Superintendent of Public Instruction,Jack Jr.,DEM,140016,2,0,9,11,
Cleveland,Superintendent of Public Instruction,Ivan Holmes,DEM,140016,0,0,6,6,
Cleveland,Superintendent of Public Instruction,Freda Deskin,DEM,140016,2,0,32,34,
Cleveland,U.S. Senate,Patrick Michael Hayes,DEM,140016,1,0,11,12,
Cleveland,U.S. Senate,Jim Rogers,DEM,140016,3,0,28,31,
Cleveland,U.S. Senate,Connie Johnson,DEM,140016,2,0,42,44,
Cleveland,U.S. House,Bert Smith,DEM,140016,5,0,54,59,04
Cleveland,U.S. House,Tae Si,DEM,140016,1,0,24,25,04
Cleveland,Governor,Dax Ewbank,REP,140016,0,0,26,26,
Cleveland,Governor,Chad Moody,REP,140016,1,0,34,35,
Cleveland,Governor,Mary Fallin,REP,140016,7,2,191,200,
Cleveland,Superintendent of Public Instruction,Brian Kelly,REP,140016,1,0,69,70,
Cleveland,Superintendent of Public Instruction,Janet Costello Barresi,REP,140016,4,2,42,48,
Cleveland,Superintendent of Public Instruction,Joy Hofmeister,REP,140016,3,0,139,142,
Cleveland,Insurance Commissioner,Bill Viner,REP,140016,2,1,57,60,
Cleveland,Insurance Commissioner,John Doak,REP,140016,6,1,180,187,
Cleveland,Corporation Commissioner,Todd Hiett,REP,140016,8,1,105,114,
Cleveland,Corporation Commissioner,Cliff Branan,REP,140016,0,1,136,137,
Cleveland,U.S. Senate,Evelyn Rogers,REP,140016,1,0,10,11,
Cleveland,U.S. Senate,Rob Moye,REP,140016,0,0,3,3,
Cleveland,U.S. Senate,D. Jean Mcbride-Samuels,REP,140016,1,0,3,4,
Cleveland,U.S. Senate,Jim Inhofe,REP,140016,6,2,221,229,
Cleveland,U.S. Senate,Erick Paul Wyatt,REP,140016,0,0,10,10,
Cleveland,U.S. Senate,Andy Craig,REP,140016,0,0,0,0,
Cleveland,U.S. Senate,T. Shannon,REP,140016,1,0,68,69,
Cleveland,U.S. Senate,Randy Brogdon,REP,140016,0,0,15,15,
Cleveland,U.S. Senate,Eric Mccray,REP,140016,0,0,4,4,
Cleveland,U.S. Senate,Kevin Crow,REP,140016,0,0,2,2,
Cleveland,U.S. Senate,James Lankford,REP,140016,7,2,160,169,
Cleveland,U.S. Senate,Jason Weger,REP,140016,0,0,2,2,
Cleveland,U.S. House,Anna Flatt,REP,140016,1,0,41,42,04
Cleveland,U.S. House,Tom Cole,REP,140016,7,2,211,220,04
Cleveland,State House,Paul Wesselhoft,REP,140016,6,2,184,192,54
Cleveland,State House,Adam Graham,REP,140016,2,0,64,66,54
Cleveland,Superintendent of Public Instruction,John Cox,DEM,140017,0,0,9,9,
Cleveland,Superintendent of Public Instruction,Jack Jr.,DEM,140017,1,0,1,2,
Cleveland,Superintendent of Public Instruction,Ivan Holmes,DEM,140017,0,0,1,1,
Cleveland,Superintendent of Public Instruction,Freda Deskin,DEM,140017,0,0,10,10,
Cleveland,U.S. Senate,Patrick Michael Hayes,DEM,140017,0,0,1,1,
Cleveland,U.S. Senate,Jim Rogers,DEM,140017,1,0,12,13,
Cleveland,U.S. Senate,Connie Johnson,DEM,140017,0,0,7,7,
Cleveland,U.S. House,Bert Smith,DEM,140017,1,0,18,19,04
Cleveland,U.S. House,Tae Si,DEM,140017,0,0,1,1,04
Cleveland,Governor,Dax Ewbank,REP,140017,0,0,6,6,
Cleveland,Governor,Chad Moody,REP,140017,0,0,5,5,
Cleveland,Governor,Mary Fallin,REP,140017,1,0,89,90,
Cleveland,Superintendent of Public Instruction,Brian Kelly,REP,140017,1,0,18,19,
Cleveland,Superintendent of Public Instruction,Janet Costello Barresi,REP,140017,0,0,28,28,
Cleveland,Superintendent of Public Instruction,Joy Hofmeister,REP,140017,0,0,51,51,
Cleveland,Insurance Commissioner,Bill Viner,REP,140017,0,0,20,20,
Cleveland,Insurance Commissioner,John Doak,REP,140017,1,0,73,74,
Cleveland,Corporation Commissioner,Todd Hiett,REP,140017,1,0,37,38,
Cleveland,Corporation Commissioner,Cliff Branan,REP,140017,0,0,51,51,
Cleveland,U.S. Senate,Evelyn Rogers,REP,140017,0,0,3,3,
Cleveland,U.S. Senate,Rob Moye,REP,140017,0,0,1,1,
Cleveland,U.S. Senate,D. Jean Mcbride-Samuels,REP,140017,0,0,1,1,
Cleveland,U.S. Senate,Jim Inhofe,REP,140017,1,0,86,87,
Cleveland,U.S. Senate,Erick Paul Wyatt,REP,140017,0,0,5,5,
Cleveland,U.S. Senate,Andy Craig,REP,140017,0,0,0,0,
Cleveland,U.S. Senate,T. Shannon,REP,140017,0,0,24,24,
Cleveland,U.S. Senate,Randy Brogdon,REP,140017,0,0,2,2,
Cleveland,U.S. Senate,Eric Mccray,REP,140017,0,0,0,0,
Cleveland,U.S. Senate,Kevin Crow,REP,140017,0,0,0,0,
Cleveland,U.S. Senate,James Lankford,REP,140017,1,0,72,73,
Cleveland,U.S. Senate,Jason Weger,REP,140017,0,0,0,0,
Cleveland,U.S. House,Anna Flatt,REP,140017,0,0,8,8,04
Cleveland,U.S. House,Tom Cole,REP,140017,1,0,90,91,04
Cleveland,State House,Lani Habrock,REP,140017,0,0,24,24,27
Cleveland,State House,Josh Cockroft,REP,140017,1,0,72,73,27
Cleveland,Superintendent of Public Instruction,John Cox,DEM,140018,0,2,24,26,
Cleveland,Superintendent of Public Instruction,Jack Jr.,DEM,140018,0,0,18,18,
Cleveland,Superintendent of Public Instruction,Ivan Holmes,DEM,140018,0,0,5,5,
Cleveland,Superintendent of Public Instruction,Freda Deskin,DEM,140018,2,2,60,64,
Cleveland,U.S. Senate,Patrick Michael Hayes,DEM,140018,1,0,13,14,
Cleveland,U.S. Senate,Jim Rogers,DEM,140018,0,2,27,29,
Cleveland,U.S. Senate,Connie Johnson,DEM,140018,1,2,67,70,
Cleveland,U.S. House,Bert Smith,DEM,140018,2,3,66,71,04
Cleveland,U.S. House,Tae Si,DEM,140018,0,1,33,34,04
Cleveland,Governor,Dax Ewbank,REP,140018,0,1,8,9,
Cleveland,Governor,Chad Moody,REP,140018,0,4,36,40,
Cleveland,Governor,Mary Fallin,REP,140018,0,1,46,47,
Cleveland,Superintendent of Public Instruction,Brian Kelly,REP,140018,0,2,22,24,
Cleveland,Superintendent of Public Instruction,Janet Costello Barresi,REP,140018,0,0,22,22,
Cleveland,Superintendent of Public Instruction,Joy Hofmeister,REP,140018,0,4,44,48,
Cleveland,Insurance Commissioner,Bill Viner,REP,140018,0,2,25,27,
Cleveland,Insurance Commissioner,John Doak,REP,140018,0,3,56,59,
Cleveland,Corporation Commissioner,Todd Hiett,REP,140018,0,4,41,45,
Cleveland,Corporation Commissioner,Cliff Branan,REP,140018,0,1,40,41,
Cleveland,U.S. Senate,Evelyn Rogers,REP,140018,0,2,11,13,
Cleveland,U.S. Senate,Rob Moye,REP,140018,0,1,1,2,
Cleveland,U.S. Senate,D. Jean Mcbride-Samuels,REP,140018,0,0,0,0,
Cleveland,U.S. Senate,Jim Inhofe,REP,140018,0,3,72,75,
Cleveland,U.S. Senate,Erick Paul Wyatt,REP,140018,0,0,3,3,
Cleveland,U.S. Senate,Andy Craig,REP,140018,0,0,0,0,
Cleveland,U.S. Senate,T. Shannon,REP,140018,0,1,33,34,
Cleveland,U.S. Senate,Randy Brogdon,REP,140018,0,0,2,2,
Cleveland,U.S. Senate,Eric Mccray,REP,140018,0,0,0,0,
Cleveland,U.S. Senate,Kevin Crow,REP,140018,0,3,4,7,
Cleveland,U.S. Senate,James Lankford,REP,140018,0,2,48,50,
Cleveland,U.S. Senate,Jason Weger,REP,140018,0,0,1,1,
Cleveland,U.S. House,Anna Flatt,REP,140018,0,3,19,22,04
Cleveland,U.S. House,Tom Cole,REP,140018,0,2,69,71,04
Cleveland,Superintendent of Public Instruction,John Cox,DEM,140019,1,2,52,55,
Cleveland,Superintendent of Public Instruction,Jack Jr.,DEM,140019,2,1,42,45,
Cleveland,Superintendent of Public Instruction,Ivan Holmes,DEM,140019,0,0,17,17,
Cleveland,Superintendent of Public Instruction,Freda Deskin,DEM,140019,4,5,144,153,
Cleveland,U.S. Senate,Patrick Michael Hayes,DEM,140019,1,1,40,42,
Cleveland,U.S. Senate,Jim Rogers,DEM,140019,0,1,60,61,
Cleveland,U.S. Senate,Connie Johnson,DEM,140019,5,5,144,154,
Cleveland,U.S. House,Bert Smith,DEM,140019,5,5,147,157,04
Cleveland,U.S. House,Tae Si,DEM,140019,1,1,79,81,04
Cleveland,Governor,Dax Ewbank,REP,140019,2,1,26,29,
Cleveland,Governor,Chad Moody,REP,140019,3,1,67,71,
Cleveland,Governor,Mary Fallin,REP,140019,10,8,195,213,
Cleveland,Superintendent of Public Instruction,Brian Kelly,REP,140019,3,2,80,85,
Cleveland,Superintendent of Public Instruction,Janet Costello Barresi,REP,140019,1,3,64,68,
Cleveland,Superintendent of Public Instruction,Joy Hofmeister,REP,140019,11,4,144,159,
Cleveland,Insurance Commissioner,Bill Viner,REP,140019,3,1,61,65,
Cleveland,Insurance Commissioner,John Doak,REP,140019,10,8,205,223,
Cleveland,Corporation Commissioner,Todd Hiett,REP,140019,9,3,120,132,
Cleveland,Corporation Commissioner,Cliff Branan,REP,140019,4,5,150,159,
Cleveland,U.S. Senate,Evelyn Rogers,REP,140019,3,1,16,20,
Cleveland,U.S. Senate,Rob Moye,REP,140019,1,0,7,8,
Cleveland,U.S. Senate,D. Jean Mcbride-Samuels,REP,140019,0,0,2,2,
Cleveland,U.S. Senate,Jim Inhofe,REP,140019,11,9,252,272,
Cleveland,U.S. Senate,Erick Paul Wyatt,REP,140019,0,0,13,13,
Cleveland,U.S. Senate,Andy Craig,REP,140019,0,0,3,3,
Cleveland,U.S. Senate,T. Shannon,REP,140019,1,2,73,76,
Cleveland,U.S. Senate,Randy Brogdon,REP,140019,0,0,12,12,
Cleveland,U.S. Senate,Eric Mccray,REP,140019,0,0,4,4,
Cleveland,U.S. Senate,Kevin Crow,REP,140019,0,0,4,4,
Cleveland,U.S. Senate,James Lankford,REP,140019,11,7,194,212,
Cleveland,U.S. Senate,Jason Weger,REP,140019,1,0,2,3,
Cleveland,U.S. House,Anna Flatt,REP,140019,2,1,60,63,04
Cleveland,U.S. House,Tom Cole,REP,140019,11,9,230,250,04
Cleveland,Superintendent of Public Instruction,John Cox,DEM,140020,3,2,24,29,
Cleveland,Superintendent of Public Instruction,Jack Jr.,DEM,140020,5,0,12,17,
Cleveland,Superintendent of Public Instruction,Ivan Holmes,DEM,140020,1,0,0,1,
Cleveland,Superintendent of Public Instruction,Freda Deskin,DEM,140020,1,2,58,61,
Cleveland,U.S. Senate,Patrick Michael Hayes,DEM,140020,2,0,13,15,
Cleveland,U.S. Senate,Jim Rogers,DEM,140020,2,0,26,28,
Cleveland,U.S. Senate,Connie Johnson,DEM,140020,6,4,50,60,
Cleveland,U.S. House,Bert Smith,DEM,140020,8,4,59,71,04
Cleveland,U.S. House,Tae Si,DEM,140020,2,0,24,26,04
Cleveland,Governor,Dax Ewbank,REP,140020,2,1,38,41,
Cleveland,Governor,Chad Moody,REP,140020,1,5,53,59,
Cleveland,Governor,Mary Fallin,REP,140020,28,34,462,524,
Cleveland,Superintendent of Public Instruction,Brian Kelly,REP,140020,6,4,107,117,
Cleveland,Superintendent of Public Instruction,Janet Costello Barresi,REP,140020,7,13,142,162,
Cleveland,Superintendent of Public Instruction,Joy Hofmeister,REP,140020,16,21,295,332,
Cleveland,Insurance Commissioner,Bill Viner,REP,140020,5,8,114,127,
Cleveland,Insurance Commissioner,John Doak,REP,140020,21,30,396,447,
Cleveland,Corporation Commissioner,Todd Hiett,REP,140020,14,15,234,263,
Cleveland,Corporation Commissioner,Cliff Branan,REP,140020,10,22,281,313,
Cleveland,U.S. Senate,Evelyn Rogers,REP,140020,2,0,16,18,
Cleveland,U.S. Senate,Rob Moye,REP,140020,0,0,4,4,
Cleveland,U.S. Senate,D. Jean Mcbride-Samuels,REP,140020,1,0,4,5,
Cleveland,U.S. Senate,Jim Inhofe,REP,140020,26,39,514,579,
Cleveland,U.S. Senate,Erick Paul Wyatt,REP,140020,1,1,15,17,
Cleveland,U.S. Senate,Andy Craig,REP,140020,0,0,2,2,
Cleveland,U.S. Senate,T. Shannon,REP,140020,10,5,119,134,
Cleveland,U.S. Senate,Randy Brogdon,REP,140020,0,0,12,12,
Cleveland,U.S. Senate,Eric Mccray,REP,140020,0,0,3,3,
Cleveland,U.S. Senate,Kevin Crow,REP,140020,0,0,3,3,
Cleveland,U.S. Senate,James Lankford,REP,140020,21,35,421,477,
Cleveland,U.S. Senate,Jason Weger,REP,140020,0,0,2,2,
Cleveland,U.S. House,Anna Flatt,REP,140020,4,1,57,62,04
Cleveland,U.S. House,Tom Cole,REP,140020,27,39,502,568,04
Cleveland,State House,Chris Kannady,REP,140020,17,25,269,311,91
Cleveland,State House,Jon Painter,REP,140020,9,13,234,256,91
Cleveland,State House,Chad Olsen,REP,140020,2,2,17,21,91
Cleveland,State House,David Monlux,REP,140020,0,0,4,4,91
Cleveland,State House,Scott Esk,REP,140020,0,1,27,28,91
Cleveland,Superintendent of Public Instruction,John Cox,DEM,140021,0,0,21,21,
Cleveland,Superintendent of Public Instruction,Jack Jr.,DEM,140021,1,0,5,6,
Cleveland,Superintendent of Public Instruction,Ivan Holmes,DEM,140021,0,0,3,3,
Cleveland,Superintendent of Public Instruction,Freda Deskin,DEM,140021,1,0,34,35,
Cleveland,U.S. Senate,Patrick Michael Hayes,DEM,140021,1,0,11,12,
Cleveland,U.S. Senate,Jim Rogers,DEM,140021,1,0,24,25,
Cleveland,U.S. Senate,Connie Johnson,DEM,140021,0,0,28,28,
Cleveland,U.S. House,Bert Smith,DEM,140021,2,0,49,51,04
Cleveland,U.S. House,Tae Si,DEM,140021,0,0,12,12,04
Cleveland,Governor,Dax Ewbank,REP,140021,0,0,12,12,
Cleveland,Governor,Chad Moody,REP,140021,0,0,39,39,
Cleveland,Governor,Mary Fallin,REP,140021,3,0,116,119,
Cleveland,Superintendent of Public Instruction,Brian Kelly,REP,140021,0,0,43,43,
Cleveland,Superintendent of Public Instruction,Janet Costello Barresi,REP,140021,3,0,48,51,
Cleveland,Superintendent of Public Instruction,Joy Hofmeister,REP,140021,0,0,70,70,
Cleveland,Insurance Commissioner,Bill Viner,REP,140021,1,0,42,43,
Cleveland,Insurance Commissioner,John Doak,REP,140021,2,0,115,117,
Cleveland,Corporation Commissioner,Todd Hiett,REP,140021,1,0,76,77,
Cleveland,Corporation Commissioner,Cliff Branan,REP,140021,2,0,73,75,
Cleveland,U.S. Senate,Evelyn Rogers,REP,140021,0,0,9,9,
Cleveland,U.S. Senate,Rob Moye,REP,140021,0,0,2,2,
Cleveland,U.S. Senate,D. Jean Mcbride-Samuels,REP,140021,0,0,9,9,
Cleveland,U.S. Senate,Jim Inhofe,REP,140021,3,0,132,135,
Cleveland,U.S. Senate,Erick Paul Wyatt,REP,140021,0,0,11,11,
Cleveland,U.S. Senate,Andy Craig,REP,140021,0,0,0,0,
Cleveland,U.S. Senate,T. Shannon,REP,140021,2,0,51,53,
Cleveland,U.S. Senate,Randy Brogdon,REP,140021,0,0,2,2,
Cleveland,U.S. Senate,Eric Mccray,REP,140021,0,0,3,3,
Cleveland,U.S. Senate,Kevin Crow,REP,140021,0,0,2,2,
Cleveland,U.S. Senate,James Lankford,REP,140021,1,0,106,107,
Cleveland,U.S. Senate,Jason Weger,REP,140021,0,0,2,2,
Cleveland,U.S. House,Anna Flatt,REP,140021,0,0,29,29,04
Cleveland,U.S. House,Tom Cole,REP,140021,3,0,138,141,04
Cleveland,State House,Danni Legg,REP,140021,0,0,28,28,53
Cleveland,State House,Mark Mcbride,REP,140021,2,0,132,134,53
Cleveland,Superintendent of Public Instruction,John Cox,DEM,140022,1,4,25,30,
Cleveland,Superintendent of Public Instruction,Jack Jr.,DEM,140022,1,1,12,14,
Cleveland,Superintendent of Public Instruction,Ivan Holmes,DEM,140022,0,0,3,3,
Cleveland,Superintendent of Public Instruction,Freda Deskin,DEM,140022,4,4,51,59,
Cleveland,U.S. Senate,Patrick Michael Hayes,DEM,140022,1,1,15,17,
Cleveland,U.S. Senate,Jim Rogers,DEM,140022,4,1,14,19,
Cleveland,U.S. Senate,Connie Johnson,DEM,140022,1,7,58,66,
Cleveland,U.S. House,Bert Smith,DEM,140022,5,4,64,73,04
Cleveland,U.S. House,Tae Si,DEM,140022,1,4,20,25,04
Cleveland,Governor,Dax Ewbank,REP,140022,3,3,48,54,
Cleveland,Governor,Chad Moody,REP,140022,4,3,61,68,
Cleveland,Governor,Mary Fallin,REP,140022,13,4,288,305,
Cleveland,Superintendent of Public Instruction,Brian Kelly,REP,140022,9,3,102,114,
Cleveland,Superintendent of Public Instruction,Janet Costello Barresi,REP,140022,2,0,83,85,
Cleveland,Superintendent of Public Instruction,Joy Hofmeister,REP,140022,9,8,206,223,
Cleveland,Insurance Commissioner,Bill Viner,REP,140022,7,4,97,108,
Cleveland,Insurance Commissioner,John Doak,REP,140022,13,6,279,298,
Cleveland,Corporation Commissioner,Todd Hiett,REP,140022,8,5,181,194,
Cleveland,Corporation Commissioner,Cliff Branan,REP,140022,11,5,193,209,
Cleveland,U.S. Senate,Evelyn Rogers,REP,140022,1,1,22,24,
Cleveland,U.S. Senate,Rob Moye,REP,140022,1,1,3,5,
Cleveland,U.S. Senate,D. Jean Mcbride-Samuels,REP,140022,0,0,15,15,
Cleveland,U.S. Senate,Jim Inhofe,REP,140022,17,9,327,353,
Cleveland,U.S. Senate,Erick Paul Wyatt,REP,140022,1,0,26,27,
Cleveland,U.S. Senate,Andy Craig,REP,140022,0,1,4,5,
Cleveland,U.S. Senate,T. Shannon,REP,140022,2,4,109,115,
Cleveland,U.S. Senate,Randy Brogdon,REP,140022,0,1,22,23,
Cleveland,U.S. Senate,Eric Mccray,REP,140022,0,0,6,6,
Cleveland,U.S. Senate,Kevin Crow,REP,140022,1,0,4,5,
Cleveland,U.S. Senate,James Lankford,REP,140022,16,5,248,269,
Cleveland,U.S. Senate,Jason Weger,REP,140022,1,0,3,4,
Cleveland,U.S. House,Anna Flatt,REP,140022,4,3,72,79,04
Cleveland,U.S. House,Tom Cole,REP,140022,16,7,324,347,04
Cleveland,State House,Danni Legg,REP,140022,5,4,65,74,53
Cleveland,State House,Mark Mcbride,REP,140022,15,6,328,349,53
Cleveland,Superintendent of Public Instruction,John Cox,DEM,140024,0,2,31,33,
Cleveland,Superintendent of Public Instruction,Jack Jr.,DEM,140024,2,0,6,8,
Cleveland,Superintendent of Public Instruction,Ivan Holmes,DEM,140024,2,0,6,8,
Cleveland,Superintendent of Public Instruction,Freda Deskin,DEM,140024,1,0,51,52,
Cleveland,U.S. Senate,Patrick Michael Hayes,DEM,140024,0,0,13,13,
Cleveland,U.S. Senate,Jim Rogers,DEM,140024,1,1,30,32,
Cleveland,U.S. Senate,Connie Johnson,DEM,140024,4,1,49,54,
Cleveland,U.S. House,Bert Smith,DEM,140024,4,1,71,76,04
Cleveland,U.S. House,Tae Si,DEM,140024,1,1,19,21,04
Cleveland,Governor,Dax Ewbank,REP,140024,0,1,31,32,
Cleveland,Governor,Chad Moody,REP,140024,2,0,70,72,
Cleveland,Governor,Mary Fallin,REP,140024,11,17,345,373,
Cleveland,Superintendent of Public Instruction,Brian Kelly,REP,140024,3,4,92,99,
Cleveland,Superintendent of Public Instruction,Janet Costello Barresi,REP,140024,2,1,93,96,
Cleveland,Superintendent of Public Instruction,Joy Hofmeister,REP,140024,8,13,262,283,
Cleveland,Insurance Commissioner,Bill Viner,REP,140024,3,5,84,92,
Cleveland,Insurance Commissioner,John Doak,REP,140024,9,12,338,359,
Cleveland,Corporation Commissioner,Todd Hiett,REP,140024,3,7,205,215,
Cleveland,Corporation Commissioner,Cliff Branan,REP,140024,5,8,213,226,
Cleveland,U.S. Senate,Evelyn Rogers,REP,140024,2,0,24,26,
Cleveland,U.S. Senate,Rob Moye,REP,140024,0,0,6,6,
Cleveland,U.S. Senate,D. Jean Mcbride-Samuels,REP,140024,0,0,12,12,
Cleveland,U.S. Senate,Jim Inhofe,REP,140024,11,17,392,420,
Cleveland,U.S. Senate,Erick Paul Wyatt,REP,140024,0,1,11,12,
Cleveland,U.S. Senate,Andy Craig,REP,140024,1,1,7,9,
Cleveland,U.S. Senate,T. Shannon,REP,140024,6,0,131,137,
Cleveland,U.S. Senate,Randy Brogdon,REP,140024,0,1,11,12,
Cleveland,U.S. Senate,Eric Mccray,REP,140024,0,0,2,2,
Cleveland,U.S. Senate,Kevin Crow,REP,140024,0,0,5,5,
Cleveland,U.S. Senate,James Lankford,REP,140024,6,16,287,309,
Cleveland,U.S. Senate,Jason Weger,REP,140024,0,0,2,2,
Cleveland,U.S. House,Anna Flatt,REP,140024,0,1,79,80,04
Cleveland,U.S. House,Tom Cole,REP,140024,13,17,366,396,04
Cleveland,State House,Danni Legg,REP,140024,1,4,83,88,53
Cleveland,State House,Mark Mcbride,REP,140024,10,14,357,381,53
Cleveland,Superintendent of Public Instruction,John Cox,DEM,140025,0,0,15,15,
Cleveland,Superintendent of Public Instruction,Jack Jr.,DEM,140025,0,1,11,12,
Cleveland,Superintendent of Public Instruction,Ivan Holmes,DEM,140025,0,0,4,4,
Cleveland,Superintendent of Public Instruction,Freda Deskin,DEM,140025,0,1,26,27,
Cleveland,U.S. Senate,Patrick Michael Hayes,DEM,140025,0,0,12,12,
Cleveland,U.S. Senate,Jim Rogers,DEM,140025,0,2,15,17,
Cleveland,U.S. Senate,Connie Johnson,DEM,140025,1,0,29,30,
Cleveland,U.S. House,Bert Smith,DEM,140025,1,2,36,39,04
Cleveland,U.S. House,Tae Si,DEM,140025,0,0,16,16,04
Cleveland,Governor,Dax Ewbank,REP,140025,0,0,10,10,
Cleveland,Governor,Chad Moody,REP,140025,2,1,23,26,
Cleveland,Governor,Mary Fallin,REP,140025,1,2,115,118,
Cleveland,Superintendent of Public Instruction,Brian Kelly,REP,140025,0,0,45,45,
Cleveland,Superintendent of Public Instruction,Janet Costello Barresi,REP,140025,0,0,53,53,
Cleveland,Superintendent of Public Instruction,Joy Hofmeister,REP,140025,3,3,46,52,
Cleveland,Insurance Commissioner,Bill Viner,REP,140025,1,2,34,37,
Cleveland,Insurance Commissioner,John Doak,REP,140025,2,1,103,106,
Cleveland,Corporation Commissioner,Todd Hiett,REP,140025,3,0,76,79,
Cleveland,Corporation Commissioner,Cliff Branan,REP,140025,0,3,65,68,
Cleveland,U.S. Senate,Evelyn Rogers,REP,140025,0,0,7,7,
Cleveland,U.S. Senate,Rob Moye,REP,140025,0,0,6,6,
Cleveland,U.S. Senate,D. Jean Mcbride-Samuels,REP,140025,0,1,3,4,
Cleveland,U.S. Senate,Jim Inhofe,REP,140025,3,2,123,128,
Cleveland,U.S. Senate,Erick Paul Wyatt,REP,140025,0,0,6,6,
Cleveland,U.S. Senate,Andy Craig,REP,140025,0,0,1,1,
Cleveland,U.S. Senate,T. Shannon,REP,140025,1,1,49,51,
Cleveland,U.S. Senate,Randy Brogdon,REP,140025,0,0,6,6,
Cleveland,U.S. Senate,Eric Mccray,REP,140025,0,0,0,0,
Cleveland,U.S. Senate,Kevin Crow,REP,140025,0,0,1,1,
Cleveland,U.S. Senate,James Lankford,REP,140025,2,1,90,93,
Cleveland,U.S. Senate,Jason Weger,REP,140025,0,1,1,2,
Cleveland,U.S. House,Anna Flatt,REP,140025,0,1,33,34,04
Cleveland,U.S. House,Tom Cole,REP,140025,3,2,114,119,04
Cleveland,Superintendent of Public Instruction,John Cox,DEM,140026,1,2,26,29,
Cleveland,Superintendent of Public Instruction,Jack Jr.,DEM,140026,0,1,16,17,
Cleveland,Superintendent of Public Instruction,Ivan Holmes,DEM,140026,0,0,15,15,
Cleveland,Superintendent of Public Instruction,Freda Deskin,DEM,140026,0,7,96,103,
Cleveland,U.S. Senate,Patrick Michael Hayes,DEM,140026,0,2,15,17,
Cleveland,U.S. Senate,Jim Rogers,DEM,140026,0,5,30,35,
Cleveland,U.S. Senate,Connie Johnson,DEM,140026,1,3,102,106,
Cleveland,U.S. House,Bert Smith,DEM,140026,1,7,84,92,04
Cleveland,U.S. House,Tae Si,DEM,140026,0,2,55,57,04
Cleveland,Governor,Dax Ewbank,REP,140026,0,4,22,26,
Cleveland,Governor,Chad Moody,REP,140026,1,4,50,55,
Cleveland,Governor,Mary Fallin,REP,140026,4,9,144,157,
Cleveland,Superintendent of Public Instruction,Brian Kelly,REP,140026,2,5,60,67,
Cleveland,Superintendent of Public Instruction,Janet Costello Barresi,REP,140026,1,3,57,61,
Cleveland,Superintendent of Public Instruction,Joy Hofmeister,REP,140026,2,10,100,112,
Cleveland,Insurance Commissioner,Bill Viner,REP,140026,1,3,54,58,
Cleveland,Insurance Commissioner,John Doak,REP,140026,4,14,149,167,
Cleveland,Corporation Commissioner,Todd Hiett,REP,140026,4,7,97,108,
Cleveland,Corporation Commissioner,Cliff Branan,REP,140026,0,10,106,116,
Cleveland,U.S. Senate,Evelyn Rogers,REP,140026,1,2,24,27,
Cleveland,U.S. Senate,Rob Moye,REP,140026,0,0,6,6,
Cleveland,U.S. Senate,D. Jean Mcbride-Samuels,REP,140026,0,0,4,4,
Cleveland,U.S. Senate,Jim Inhofe,REP,140026,4,13,173,190,
Cleveland,U.S. Senate,Erick Paul Wyatt,REP,140026,0,2,10,12,
Cleveland,U.S. Senate,Andy Craig,REP,140026,0,0,2,2,
Cleveland,U.S. Senate,T. Shannon,REP,140026,1,7,65,73,
Cleveland,U.S. Senate,Randy Brogdon,REP,140026,1,2,4,7,
Cleveland,U.S. Senate,Eric Mccray,REP,140026,0,0,3,3,
Cleveland,U.S. Senate,Kevin Crow,REP,140026,0,0,2,2,
Cleveland,U.S. Senate,James Lankford,REP,140026,3,9,144,156,
Cleveland,U.S. Senate,Jason Weger,REP,140026,0,0,0,0,
Cleveland,U.S. House,Anna Flatt,REP,140026,1,6,48,55,04
Cleveland,U.S. House,Tom Cole,REP,140026,4,11,171,186,04
Cleveland,Superintendent of Public Instruction,John Cox,DEM,140027,1,3,26,30,
Cleveland,Superintendent of Public Instruction,Jack Jr.,DEM,140027,3,0,28,31,
Cleveland,Superintendent of Public Instruction,Ivan Holmes,DEM,140027,0,1,8,9,
Cleveland,Superintendent of Public Instruction,Freda Deskin,DEM,140027,5,1,110,116,
Cleveland,U.S. Senate,Patrick Michael Hayes,DEM,140027,2,1,33,36,
Cleveland,U.S. Senate,Jim Rogers,DEM,140027,2,1,34,37,
Cleveland,U.S. Senate,Connie Johnson,DEM,140027,2,2,88,92,
Cleveland,U.S. House,Bert Smith,DEM,140027,4,3,106,113,04
Cleveland,U.S. House,Tae Si,DEM,140027,0,2,36,38,04
Cleveland,Governor,Dax Ewbank,REP,140027,3,2,41,46,
Cleveland,Governor,Chad Moody,REP,140027,1,0,59,60,
Cleveland,Governor,Mary Fallin,REP,140027,18,26,401,445,
Cleveland,Superintendent of Public Instruction,Brian Kelly,REP,140027,1,9,88,98,
Cleveland,Superintendent of Public Instruction,Janet Costello Barresi,REP,140027,10,9,178,197,
Cleveland,Superintendent of Public Instruction,Joy Hofmeister,REP,140027,11,10,228,249,
Cleveland,Insurance Commissioner,Bill Viner,REP,140027,1,5,76,82,
Cleveland,Insurance Commissioner,John Doak,REP,140027,21,20,384,425,
Cleveland,Corporation Commissioner,Todd Hiett,REP,140027,13,16,205,234,
Cleveland,Corporation Commissioner,Cliff Branan,REP,140027,9,10,258,277,
Cleveland,U.S. Senate,Evelyn Rogers,REP,140027,0,1,27,28,
Cleveland,U.S. Senate,Rob Moye,REP,140027,0,0,8,8,
Cleveland,U.S. Senate,D. Jean Mcbride-Samuels,REP,140027,0,0,9,9,
Cleveland,U.S. Senate,Jim Inhofe,REP,140027,22,26,441,489,
Cleveland,U.S. Senate,Erick Paul Wyatt,REP,140027,0,0,13,13,
Cleveland,U.S. Senate,Andy Craig,REP,140027,0,0,5,5,
Cleveland,U.S. Senate,T. Shannon,REP,140027,5,9,117,131,
Cleveland,U.S. Senate,Randy Brogdon,REP,140027,3,0,6,9,
Cleveland,U.S. Senate,Eric Mccray,REP,140027,0,1,1,2,
Cleveland,U.S. Senate,Kevin Crow,REP,140027,1,0,3,4,
Cleveland,U.S. Senate,James Lankford,REP,140027,13,17,367,397,
Cleveland,U.S. Senate,Jason Weger,REP,140027,0,0,3,3,
Cleveland,U.S. House,Anna Flatt,REP,140027,5,4,69,78,04
Cleveland,U.S. House,Tom Cole,REP,140027,17,22,434,473,04
Cleveland,Superintendent of Public Instruction,John Cox,DEM,140028,0,3,39,42,
Cleveland,Superintendent of Public Instruction,Jack Jr.,DEM,140028,0,0,17,17,
Cleveland,Superintendent of Public Instruction,Ivan Holmes,DEM,140028,2,1,5,8,
Cleveland,Superintendent of Public Instruction,Freda Deskin,DEM,140028,1,5,100,106,
Cleveland,U.S. Senate,Patrick Michael Hayes,DEM,140028,0,1,24,25,
Cleveland,U.S. Senate,Jim Rogers,DEM,140028,0,2,37,39,
Cleveland,U.S. Senate,Connie Johnson,DEM,140028,3,6,97,106,
Cleveland,U.S. House,Bert Smith,DEM,140028,3,5,95,103,04
Cleveland,U.S. House,Tae Si,DEM,140028,0,3,55,58,04
Cleveland,Governor,Dax Ewbank,REP,140028,0,0,15,15,
Cleveland,Governor,Chad Moody,REP,140028,0,4,38,42,
Cleveland,Governor,Mary Fallin,REP,140028,3,7,99,109,
Cleveland,Superintendent of Public Instruction,Brian Kelly,REP,140028,0,4,41,45,
Cleveland,Superintendent of Public Instruction,Janet Costello Barresi,REP,140028,3,4,36,43,
Cleveland,Superintendent of Public Instruction,Joy Hofmeister,REP,140028,0,3,71,74,
Cleveland,Insurance Commissioner,Bill Viner,REP,140028,2,3,46,51,
Cleveland,Insurance Commissioner,John Doak,REP,140028,1,8,101,110,
Cleveland,Corporation Commissioner,Todd Hiett,REP,140028,1,5,71,77,
Cleveland,Corporation Commissioner,Cliff Branan,REP,140028,2,4,71,77,
Cleveland,U.S. Senate,Evelyn Rogers,REP,140028,0,0,13,13,
Cleveland,U.S. Senate,Rob Moye,REP,140028,0,0,4,4,
Cleveland,U.S. Senate,D. Jean Mcbride-Samuels,REP,140028,0,1,7,8,
Cleveland,U.S. Senate,Jim Inhofe,REP,140028,3,10,119,132,
Cleveland,U.S. Senate,Erick Paul Wyatt,REP,140028,0,0,8,8,
Cleveland,U.S. Senate,Andy Craig,REP,140028,0,0,2,2,
Cleveland,U.S. Senate,T. Shannon,REP,140028,0,0,53,53,
Cleveland,U.S. Senate,Randy Brogdon,REP,140028,0,0,11,11,
Cleveland,U.S. Senate,Eric Mccray,REP,140028,0,1,2,3,
Cleveland,U.S. Senate,Kevin Crow,REP,140028,0,0,1,1,
Cleveland,U.S. Senate,James Lankford,REP,140028,3,10,81,94,
Cleveland,U.S. Senate,Jason Weger,REP,140028,0,0,0,0,
Cleveland,U.S. House,Anna Flatt,REP,140028,0,0,32,32,04
Cleveland,U.S. House,Tom Cole,REP,140028,3,11,120,134,04
Cleveland,Superintendent of Public Instruction,John Cox,DEM,140029,0,2,35,37,
Cleveland,Superintendent of Public Instruction,Jack Jr.,DEM,140029,0,0,17,17,
Cleveland,Superintendent of Public Instruction,Ivan Holmes,DEM,140029,1,0,8,9,
Cleveland,Superintendent of Public Instruction,Freda Deskin,DEM,140029,1,2,68,71,
Cleveland,U.S. Senate,Patrick Michael Hayes,DEM,140029,0,3,26,29,
Cleveland,U.S. Senate,Jim Rogers,DEM,140029,0,1,47,48,
Cleveland,U.S. Senate,Connie Johnson,DEM,140029,2,0,48,50,
Cleveland,U.S. House,Bert Smith,DEM,140029,2,4,102,108,04
Cleveland,U.S. House,Tae Si,DEM,140029,0,0,18,18,04
Cleveland,Governor,Dax Ewbank,REP,140029,0,2,21,23,
Cleveland,Governor,Chad Moody,REP,140029,2,1,56,59,
Cleveland,Governor,Mary Fallin,REP,140029,4,7,164,175,
Cleveland,Superintendent of Public Instruction,Brian Kelly,REP,140029,1,2,70,73,
Cleveland,Superintendent of Public Instruction,Janet Costello Barresi,REP,140029,3,4,53,60,
Cleveland,Superintendent of Public Instruction,Joy Hofmeister,REP,140029,2,4,115,121,
Cleveland,Insurance Commissioner,Bill Viner,REP,140029,2,0,67,69,
Cleveland,Insurance Commissioner,John Doak,REP,140029,4,10,160,174,
Cleveland,Corporation Commissioner,Todd Hiett,REP,140029,0,7,116,123,
Cleveland,Corporation Commissioner,Cliff Branan,REP,140029,6,2,111,119,
Cleveland,U.S. Senate,Evelyn Rogers,REP,140029,0,0,17,17,
Cleveland,U.S. Senate,Rob Moye,REP,140029,0,0,8,8,
Cleveland,U.S. Senate,D. Jean Mcbride-Samuels,REP,140029,0,0,4,4,
Cleveland,U.S. Senate,Jim Inhofe,REP,140029,6,9,202,217,
Cleveland,U.S. Senate,Erick Paul Wyatt,REP,140029,0,0,12,12,
Cleveland,U.S. Senate,Andy Craig,REP,140029,0,0,0,0,
Cleveland,U.S. Senate,T. Shannon,REP,140029,1,3,90,94,
Cleveland,U.S. Senate,Randy Brogdon,REP,140029,0,0,10,10,
Cleveland,U.S. Senate,Eric Mccray,REP,140029,0,0,1,1,
Cleveland,U.S. Senate,Kevin Crow,REP,140029,0,0,2,2,
Cleveland,U.S. Senate,James Lankford,REP,140029,5,6,140,151,
Cleveland,U.S. Senate,Jason Weger,REP,140029,0,0,0,0,
Cleveland,U.S. House,Anna Flatt,REP,140029,1,1,56,58,04
Cleveland,U.S. House,Tom Cole,REP,140029,5,9,184,198,04
Cleveland,Superintendent of Public Instruction,John Cox,DEM,140030,0,0,18,18,
Cleveland,Superintendent of Public Instruction,Jack Jr.,DEM,140030,0,0,13,13,
Cleveland,Superintendent of Public Instruction,Ivan Holmes,DEM,140030,0,1,5,6,
Cleveland,Superintendent of Public Instruction,Freda Deskin,DEM,140030,2,4,45,51,
Cleveland,U.S. Senate,Patrick Michael Hayes,DEM,140030,0,1,9,10,
Cleveland,U.S. Senate,Jim Rogers,DEM,140030,0,2,21,23,
Cleveland,U.S. Senate,Connie Johnson,DEM,140030,2,2,48,52,
Cleveland,U.S. House,Bert Smith,DEM,140030,1,5,59,65,04
Cleveland,U.S. House,Tae Si,DEM,140030,1,0,17,18,04
Cleveland,Governor,Dax Ewbank,REP,140030,0,0,8,8,
Cleveland,Governor,Chad Moody,REP,140030,0,0,29,29,
Cleveland,Governor,Mary Fallin,REP,140030,2,14,97,113,
Cleveland,Superintendent of Public Instruction,Brian Kelly,REP,140030,0,4,28,32,
Cleveland,Superintendent of Public Instruction,Janet Costello Barresi,REP,140030,0,4,35,39,
Cleveland,Superintendent of Public Instruction,Joy Hofmeister,REP,140030,2,6,59,67,
Cleveland,Insurance Commissioner,Bill Viner,REP,140030,0,1,27,28,
Cleveland,Insurance Commissioner,John Doak,REP,140030,2,13,92,107,
Cleveland,Corporation Commissioner,Todd Hiett,REP,140030,1,9,53,63,
Cleveland,Corporation Commissioner,Cliff Branan,REP,140030,0,5,66,71,
Cleveland,U.S. Senate,Evelyn Rogers,REP,140030,0,0,7,7,
Cleveland,U.S. Senate,Rob Moye,REP,140030,0,0,2,2,
Cleveland,U.S. Senate,D. Jean Mcbride-Samuels,REP,140030,0,0,2,2,
Cleveland,U.S. Senate,Jim Inhofe,REP,140030,1,13,113,127,
Cleveland,U.S. Senate,Erick Paul Wyatt,REP,140030,1,1,8,10,
Cleveland,U.S. Senate,Andy Craig,REP,140030,0,0,0,0,
Cleveland,U.S. Senate,T. Shannon,REP,140030,2,4,37,43,
Cleveland,U.S. Senate,Randy Brogdon,REP,140030,0,0,4,4,
Cleveland,U.S. Senate,Eric Mccray,REP,140030,0,0,1,1,
Cleveland,U.S. Senate,Kevin Crow,REP,140030,0,0,2,2,
Cleveland,U.S. Senate,James Lankford,REP,140030,0,10,87,97,
Cleveland,U.S. Senate,Jason Weger,REP,140030,0,0,2,2,
Cleveland,U.S. House,Anna Flatt,REP,140030,1,2,20,23,04
Cleveland,U.S. House,Tom Cole,REP,140030,1,12,109,122,04
Cleveland,Superintendent of Public Instruction,John Cox,DEM,140032,0,0,25,25,
Cleveland,Superintendent of Public Instruction,Jack Jr.,DEM,140032,0,1,17,18,
Cleveland,Superintendent of Public Instruction,Ivan Holmes,DEM,140032,1,0,7,8,
Cleveland,Superintendent of Public Instruction,Freda Deskin,DEM,140032,2,0,53,55,
Cleveland,U.S. Senate,Patrick Michael Hayes,DEM,140032,0,0,20,20,
Cleveland,U.S. Senate,Jim Rogers,DEM,140032,0,0,23,23,
Cleveland,U.S. Senate,Connie Johnson,DEM,140032,3,2,56,61,
Cleveland,U.S. House,Bert Smith,DEM,140032,2,1,64,67,04
Cleveland,U.S. House,Tae Si,DEM,140032,1,1,30,32,04
Cleveland,Governor,Dax Ewbank,REP,140032,1,2,26,29,
Cleveland,Governor,Chad Moody,REP,140032,0,0,41,41,
Cleveland,Governor,Mary Fallin,REP,140032,4,4,58,66,
Cleveland,Superintendent of Public Instruction,Brian Kelly,REP,140032,0,3,29,32,
Cleveland,Superintendent of Public Instruction,Janet Costello Barresi,REP,140032,1,2,15,18,
Cleveland,Superintendent of Public Instruction,Joy Hofmeister,REP,140032,4,1,78,83,
Cleveland,Insurance Commissioner,Bill Viner,REP,140032,0,3,31,34,
Cleveland,Insurance Commissioner,John Doak,REP,140032,5,3,83,91,
Cleveland,Corporation Commissioner,Todd Hiett,REP,140032,1,2,57,60,
Cleveland,Corporation Commissioner,Cliff Branan,REP,140032,3,4,60,67,
Cleveland,U.S. Senate,Evelyn Rogers,REP,140032,0,0,13,13,
Cleveland,U.S. Senate,Rob Moye,REP,140032,0,0,6,6,
Cleveland,U.S. Senate,D. Jean Mcbride-Samuels,REP,140032,1,0,5,6,
Cleveland,U.S. Senate,Jim Inhofe,REP,140032,4,6,92,102,
Cleveland,U.S. Senate,Erick Paul Wyatt,REP,140032,0,0,8,8,
Cleveland,U.S. Senate,Andy Craig,REP,140032,0,0,1,1,
Cleveland,U.S. Senate,T. Shannon,REP,140032,0,3,43,46,
Cleveland,U.S. Senate,Randy Brogdon,REP,140032,1,0,9,10,
Cleveland,U.S. Senate,Eric Mccray,REP,140032,0,0,2,2,
Cleveland,U.S. Senate,Kevin Crow,REP,140032,0,0,2,2,
Cleveland,U.S. Senate,James Lankford,REP,140032,4,2,69,75,
Cleveland,U.S. Senate,Jason Weger,REP,140032,0,0,1,1,
Cleveland,U.S. House,Anna Flatt,REP,140032,1,0,28,29,04
Cleveland,U.S. House,Tom Cole,REP,140032,4,6,97,107,04
Cleveland,Superintendent of Public Instruction,John Cox,DEM,140034,0,3,30,33,
Cleveland,Superintendent of Public Instruction,Jack Jr.,DEM,140034,0,0,11,11,
Cleveland,Superintendent of Public Instruction,Ivan Holmes,DEM,140034,0,0,7,7,
Cleveland,Superintendent of Public Instruction,Freda Deskin,DEM,140034,2,5,146,153,
Cleveland,U.S. Senate,Patrick Michael Hayes,DEM,140034,0,0,36,36,
Cleveland,U.S. Senate,Jim Rogers,DEM,140034,0,3,78,81,
Cleveland,U.S. Senate,Connie Johnson,DEM,140034,1,5,74,80,
Cleveland,U.S. House,Bert Smith,DEM,140034,1,8,154,163,04
Cleveland,U.S. House,Tae Si,DEM,140034,0,0,27,27,04
Cleveland,Governor,Dax Ewbank,REP,140034,0,0,35,35,
Cleveland,Governor,Chad Moody,REP,140034,0,2,59,61,
Cleveland,Governor,Mary Fallin,REP,140034,4,5,221,230,
Cleveland,Superintendent of Public Instruction,Brian Kelly,REP,140034,1,2,80,83,
Cleveland,Superintendent of Public Instruction,Janet Costello Barresi,REP,140034,3,1,60,64,
Cleveland,Superintendent of Public Instruction,Joy Hofmeister,REP,140034,0,4,173,177,
Cleveland,Insurance Commissioner,Bill Viner,REP,140034,0,2,86,88,
Cleveland,Insurance Commissioner,John Doak,REP,140034,3,3,214,220,
Cleveland,Corporation Commissioner,Todd Hiett,REP,140034,2,2,150,154,
Cleveland,Corporation Commissioner,Cliff Branan,REP,140034,0,3,153,156,
Cleveland,U.S. Senate,Evelyn Rogers,REP,140034,0,1,26,27,
Cleveland,U.S. Senate,Rob Moye,REP,140034,0,0,8,8,
Cleveland,U.S. Senate,D. Jean Mcbride-Samuels,REP,140034,0,0,3,3,
Cleveland,U.S. Senate,Jim Inhofe,REP,140034,4,5,256,265,
Cleveland,U.S. Senate,Erick Paul Wyatt,REP,140034,0,0,19,19,
Cleveland,U.S. Senate,Andy Craig,REP,140034,0,0,4,4,
Cleveland,U.S. Senate,T. Shannon,REP,140034,2,1,100,103,
Cleveland,U.S. Senate,Randy Brogdon,REP,140034,0,0,4,4,
Cleveland,U.S. Senate,Eric Mccray,REP,140034,0,0,1,1,
Cleveland,U.S. Senate,Kevin Crow,REP,140034,0,0,4,4,
Cleveland,U.S. Senate,James Lankford,REP,140034,2,6,204,212,
Cleveland,U.S. Senate,Jason Weger,REP,140034,0,0,1,1,
Cleveland,U.S. House,Anna Flatt,REP,140034,0,0,52,52,04
Cleveland,U.S. House,Tom Cole,REP,140034,4,7,265,276,04
Cleveland,Superintendent of Public Instruction,John Cox,DEM,140035,0,1,22,23,
Cleveland,Superintendent of Public Instruction,Jack Jr.,DEM,140035,1,1,13,15,
Cleveland,Superintendent of Public Instruction,Ivan Holmes,DEM,140035,1,0,10,11,
Cleveland,Superintendent of Public Instruction,Freda Deskin,DEM,140035,3,7,76,86,
Cleveland,U.S. Senate,Patrick Michael Hayes,DEM,140035,1,1,14,16,
Cleveland,U.S. Senate,Jim Rogers,DEM,140035,0,1,28,29,
Cleveland,U.S. Senate,Connie Johnson,DEM,140035,4,5,76,85,
Cleveland,U.S. House,Bert Smith,DEM,140035,3,6,69,78,04
Cleveland,U.S. House,Tae Si,DEM,140035,2,3,35,40,04
Cleveland,Governor,Dax Ewbank,REP,140035,0,0,18,18,
Cleveland,Governor,Chad Moody,REP,140035,0,1,25,26,
Cleveland,Governor,Mary Fallin,REP,140035,14,3,179,196,
Cleveland,Superintendent of Public Instruction,Brian Kelly,REP,140035,0,2,40,42,
Cleveland,Superintendent of Public Instruction,Janet Costello Barresi,REP,140035,9,1,81,91,
Cleveland,Superintendent of Public Instruction,Joy Hofmeister,REP,140035,6,1,94,101,
Cleveland,Insurance Commissioner,Bill Viner,REP,140035,0,0,42,42,
Cleveland,Insurance Commissioner,John Doak,REP,140035,14,4,158,176,
Cleveland,Corporation Commissioner,Todd Hiett,REP,140035,10,3,103,116,
Cleveland,Corporation Commissioner,Cliff Branan,REP,140035,4,1,95,100,
Cleveland,U.S. Senate,Evelyn Rogers,REP,140035,0,1,7,8,
Cleveland,U.S. Senate,Rob Moye,REP,140035,0,0,3,3,
Cleveland,U.S. Senate,D. Jean Mcbride-Samuels,REP,140035,1,0,5,6,
Cleveland,U.S. Senate,Jim Inhofe,REP,140035,14,2,201,217,
Cleveland,U.S. Senate,Erick Paul Wyatt,REP,140035,0,1,4,5,
Cleveland,U.S. Senate,Andy Craig,REP,140035,0,0,2,2,
Cleveland,U.S. Senate,T. Shannon,REP,140035,4,1,53,58,
Cleveland,U.S. Senate,Randy Brogdon,REP,140035,1,1,4,6,
Cleveland,U.S. Senate,Eric Mccray,REP,140035,0,0,2,2,
Cleveland,U.S. Senate,Kevin Crow,REP,140035,0,0,0,0,
Cleveland,U.S. Senate,James Lankford,REP,140035,10,2,159,171,
Cleveland,U.S. Senate,Jason Weger,REP,140035,0,0,1,1,
Cleveland,U.S. House,Anna Flatt,REP,140035,2,0,24,26,04
Cleveland,U.S. House,Tom Cole,REP,140035,13,4,194,211,04
Cleveland,Superintendent of Public Instruction,John Cox,DEM,140036,1,0,11,12,
Cleveland,Superintendent of Public Instruction,Jack Jr.,DEM,140036,0,0,6,6,
Cleveland,Superintendent of Public Instruction,Ivan Holmes,DEM,140036,0,2,0,2,
Cleveland,Superintendent of Public Instruction,Freda Deskin,DEM,140036,3,0,24,27,
Cleveland,U.S. Senate,Patrick Michael Hayes,DEM,140036,1,0,7,8,
Cleveland,U.S. Senate,Jim Rogers,DEM,140036,1,1,17,19,
Cleveland,U.S. Senate,Connie Johnson,DEM,140036,2,1,16,19,
Cleveland,U.S. House,Bert Smith,DEM,140036,4,1,27,32,04
Cleveland,U.S. House,Tae Si,DEM,140036,0,1,12,13,04
Cleveland,Governor,Dax Ewbank,REP,140036,1,0,21,22,
Cleveland,Governor,Chad Moody,REP,140036,1,1,20,22,
Cleveland,Governor,Mary Fallin,REP,140036,3,9,163,175,
Cleveland,Superintendent of Public Instruction,Brian Kelly,REP,140036,0,2,55,57,
Cleveland,Superintendent of Public Instruction,Janet Costello Barresi,REP,140036,1,2,57,60,
Cleveland,Superintendent of Public Instruction,Joy Hofmeister,REP,140036,4,5,93,102,
Cleveland,Insurance Commissioner,Bill Viner,REP,140036,0,2,43,45,
Cleveland,Insurance Commissioner,John Doak,REP,140036,4,7,156,167,
Cleveland,Corporation Commissioner,Todd Hiett,REP,140036,1,5,99,105,
Cleveland,Corporation Commissioner,Cliff Branan,REP,140036,3,4,94,101,
Cleveland,U.S. Senate,Evelyn Rogers,REP,140036,0,0,10,10,
Cleveland,U.S. Senate,Rob Moye,REP,140036,0,0,6,6,
Cleveland,U.S. Senate,D. Jean Mcbride-Samuels,REP,140036,0,0,4,4,
Cleveland,U.S. Senate,Jim Inhofe,REP,140036,4,10,177,191,
Cleveland,U.S. Senate,Erick Paul Wyatt,REP,140036,1,0,8,9,
Cleveland,U.S. Senate,Andy Craig,REP,140036,0,0,2,2,
Cleveland,U.S. Senate,T. Shannon,REP,140036,2,4,55,61,
Cleveland,U.S. Senate,Randy Brogdon,REP,140036,0,1,8,9,
Cleveland,U.S. Senate,Eric Mccray,REP,140036,0,0,0,0,
Cleveland,U.S. Senate,Kevin Crow,REP,140036,0,0,3,3,
Cleveland,U.S. Senate,James Lankford,REP,140036,2,5,139,146,
Cleveland,U.S. Senate,Jason Weger,REP,140036,0,0,0,0,
Cleveland,U.S. House,Anna Flatt,REP,140036,1,1,51,53,04
Cleveland,U.S. House,Tom Cole,REP,140036,4,9,156,169,04
Cleveland,State House,Lani Habrock,REP,140036,1,3,70,74,27
Cleveland,State House,Josh Cockroft,REP,140036,3,6,134,143,27
Cleveland,Superintendent of Public Instruction,John Cox,DEM,140037,0,0,20,20,
Cleveland,Superintendent of Public Instruction,Jack Jr.,DEM,140037,0,0,5,5,
Cleveland,Superintendent of Public Instruction,Ivan Holmes,DEM,140037,0,0,5,5,
Cleveland,Superintendent of Public Instruction,Freda Deskin,DEM,140037,0,0,16,16,
Cleveland,U.S. Senate,Patrick Michael Hayes,DEM,140037,0,0,5,5,
Cleveland,U.S. Senate,Jim Rogers,DEM,140037,0,0,8,8,
Cleveland,U.S. Senate,Connie Johnson,DEM,140037,0,0,33,33,
Cleveland,U.S. House,Bert Smith,DEM,140037,0,0,31,31,04
Cleveland,U.S. House,Tae Si,DEM,140037,0,0,13,13,04
Cleveland,Governor,Dax Ewbank,REP,140037,0,0,15,15,
Cleveland,Governor,Chad Moody,REP,140037,2,0,24,26,
Cleveland,Governor,Mary Fallin,REP,140037,7,3,105,115,
Cleveland,Superintendent of Public Instruction,Brian Kelly,REP,140037,1,1,31,33,
Cleveland,Superintendent of Public Instruction,Janet Costello Barresi,REP,140037,3,2,32,37,
Cleveland,Superintendent of Public Instruction,Joy Hofmeister,REP,140037,2,0,81,83,
Cleveland,Insurance Commissioner,Bill Viner,REP,140037,0,2,31,33,
Cleveland,Insurance Commissioner,John Doak,REP,140037,6,1,107,114,
Cleveland,Corporation Commissioner,Todd Hiett,REP,140037,4,3,64,71,
Cleveland,Corporation Commissioner,Cliff Branan,REP,140037,2,0,76,78,
Cleveland,U.S. Senate,Evelyn Rogers,REP,140037,0,0,7,7,
Cleveland,U.S. Senate,Rob Moye,REP,140037,1,0,3,4,
Cleveland,U.S. Senate,D. Jean Mcbride-Samuels,REP,140037,0,0,3,3,
Cleveland,U.S. Senate,Jim Inhofe,REP,140037,6,3,130,139,
Cleveland,U.S. Senate,Erick Paul Wyatt,REP,140037,1,0,3,4,
Cleveland,U.S. Senate,Andy Craig,REP,140037,0,0,0,0,
Cleveland,U.S. Senate,T. Shannon,REP,140037,4,0,59,63,
Cleveland,U.S. Senate,Randy Brogdon,REP,140037,0,0,8,8,
Cleveland,U.S. Senate,Eric Mccray,REP,140037,0,0,1,1,
Cleveland,U.S. Senate,Kevin Crow,REP,140037,0,0,0,0,
Cleveland,U.S. Senate,James Lankford,REP,140037,5,3,79,87,
Cleveland,U.S. Senate,Jason Weger,REP,140037,0,0,0,0,
Cleveland,U.S. House,Anna Flatt,REP,140037,2,0,19,21,04
Cleveland,U.S. House,Tom Cole,REP,140037,7,3,126,136,04
Cleveland,State House,Paul Wesselhoft,REP,140037,6,2,100,108,54
Cleveland,State House,Adam Graham,REP,140037,2,1,36,39,54
Cleveland,Superintendent of Public Instruction,John Cox,DEM,140038,0,1,21,22,
Cleveland,Superintendent of Public Instruction,Jack Jr.,DEM,140038,0,0,10,10,
Cleveland,Superintendent of Public Instruction,Ivan Holmes,DEM,140038,0,0,4,4,
Cleveland,Superintendent of Public Instruction,Freda Deskin,DEM,140038,0,2,47,49,
Cleveland,U.S. Senate,Patrick Michael Hayes,DEM,140038,0,1,15,16,
Cleveland,U.S. Senate,Jim Rogers,DEM,140038,0,0,24,24,
Cleveland,U.S. Senate,Connie Johnson,DEM,140038,0,2,43,45,
Cleveland,U.S. House,Bert Smith,DEM,140038,0,0,58,58,04
Cleveland,U.S. House,Tae Si,DEM,140038,0,2,21,23,04
Cleveland,Governor,Dax Ewbank,REP,140038,0,1,21,22,
Cleveland,Governor,Chad Moody,REP,140038,0,1,39,40,
Cleveland,Governor,Mary Fallin,REP,140038,0,0,102,102,
Cleveland,Superintendent of Public Instruction,Brian Kelly,REP,140038,0,1,55,56,
Cleveland,Superintendent of Public Instruction,Janet Costello Barresi,REP,140038,0,0,30,30,
Cleveland,Superintendent of Public Instruction,Joy Hofmeister,REP,140038,0,1,72,73,
Cleveland,Insurance Commissioner,Bill Viner,REP,140038,0,1,43,44,
Cleveland,Insurance Commissioner,John Doak,REP,140038,0,1,111,112,
Cleveland,Corporation Commissioner,Todd Hiett,REP,140038,0,2,77,79,
Cleveland,Corporation Commissioner,Cliff Branan,REP,140038,0,0,78,78,
Cleveland,U.S. Senate,Evelyn Rogers,REP,140038,0,0,12,12,
Cleveland,U.S. Senate,Rob Moye,REP,140038,0,1,4,5,
Cleveland,U.S. Senate,D. Jean Mcbride-Samuels,REP,140038,0,0,2,2,
Cleveland,U.S. Senate,Jim Inhofe,REP,140038,0,1,130,131,
Cleveland,U.S. Senate,Erick Paul Wyatt,REP,140038,0,0,12,12,
Cleveland,U.S. Senate,Andy Craig,REP,140038,0,0,2,2,
Cleveland,U.S. Senate,T. Shannon,REP,140038,0,1,78,79,
Cleveland,U.S. Senate,Randy Brogdon,REP,140038,0,0,8,8,
Cleveland,U.S. Senate,Eric Mccray,REP,140038,0,0,0,0,
Cleveland,U.S. Senate,Kevin Crow,REP,140038,0,0,1,1,
Cleveland,U.S. Senate,James Lankford,REP,140038,0,1,71,72,
Cleveland,U.S. Senate,Jason Weger,REP,140038,0,0,1,1,
Cleveland,U.S. House,Anna Flatt,REP,140038,0,2,44,46,04
Cleveland,U.S. House,Tom Cole,REP,140038,0,0,116,116,04
Cleveland,Superintendent of Public Instruction,John Cox,DEM,140039,1,3,21,25,
Cleveland,Superintendent of Public Instruction,Jack Jr.,DEM,140039,1,2,14,17,
Cleveland,Superintendent of Public Instruction,Ivan Holmes,DEM,140039,0,3,9,12,
Cleveland,Superintendent of Public Instruction,Freda Deskin,DEM,140039,0,2,59,61,
Cleveland,U.S. Senate,Patrick Michael Hayes,DEM,140039,2,1,14,17,
Cleveland,U.S. Senate,Jim Rogers,DEM,140039,0,1,29,30,
Cleveland,U.S. Senate,Connie Johnson,DEM,140039,0,8,56,64,
Cleveland,U.S. House,Bert Smith,DEM,140039,2,9,63,74,04
Cleveland,U.S. House,Tae Si,DEM,140039,0,1,30,31,04
Cleveland,Governor,Dax Ewbank,REP,140039,2,0,20,22,
Cleveland,Governor,Chad Moody,REP,140039,1,7,33,41,
Cleveland,Governor,Mary Fallin,REP,140039,3,6,143,152,
Cleveland,Superintendent of Public Instruction,Brian Kelly,REP,140039,5,0,40,45,
Cleveland,Superintendent of Public Instruction,Janet Costello Barresi,REP,140039,1,4,47,52,
Cleveland,Superintendent of Public Instruction,Joy Hofmeister,REP,140039,0,9,106,115,
Cleveland,Insurance Commissioner,Bill Viner,REP,140039,2,7,42,51,
Cleveland,Insurance Commissioner,John Doak,REP,140039,4,5,144,153,
Cleveland,Corporation Commissioner,Todd Hiett,REP,140039,5,2,86,93,
Cleveland,Corporation Commissioner,Cliff Branan,REP,140039,1,10,97,108,
Cleveland,U.S. Senate,Evelyn Rogers,REP,140039,1,1,14,16,
Cleveland,U.S. Senate,Rob Moye,REP,140039,0,0,7,7,
Cleveland,U.S. Senate,D. Jean Mcbride-Samuels,REP,140039,1,0,5,6,
Cleveland,U.S. Senate,Jim Inhofe,REP,140039,3,10,163,176,
Cleveland,U.S. Senate,Erick Paul Wyatt,REP,140039,1,1,4,6,
Cleveland,U.S. Senate,Andy Craig,REP,140039,0,0,2,2,
Cleveland,U.S. Senate,T. Shannon,REP,140039,3,4,66,73,
Cleveland,U.S. Senate,Randy Brogdon,REP,140039,0,1,2,3,
Cleveland,U.S. Senate,Eric Mccray,REP,140039,0,1,3,4,
Cleveland,U.S. Senate,Kevin Crow,REP,140039,0,0,3,3,
Cleveland,U.S. Senate,James Lankford,REP,140039,3,7,119,129,
Cleveland,U.S. Senate,Jason Weger,REP,140039,0,0,2,2,
Cleveland,U.S. House,Anna Flatt,REP,140039,3,2,39,44,04
Cleveland,U.S. House,Tom Cole,REP,140039,3,10,157,170,04
Cleveland,Superintendent of Public Instruction,John Cox,DEM,140040,2,1,26,29,
Cleveland,Superintendent of Public Instruction,Jack Jr.,DEM,140040,1,0,8,9,
Cleveland,Superintendent of Public Instruction,Ivan Holmes,DEM,140040,1,0,4,5,
Cleveland,Superintendent of Public Instruction,Freda Deskin,DEM,140040,0,1,32,33,
Cleveland,U.S. Senate,Patrick Michael Hayes,DEM,140040,3,0,8,11,
Cleveland,U.S. Senate,Jim Rogers,DEM,140040,0,1,13,14,
Cleveland,U.S. Senate,Connie Johnson,DEM,140040,1,0,50,51,
Cleveland,U.S. House,Bert Smith,DEM,140040,3,1,56,60,04
Cleveland,U.S. House,Tae Si,DEM,140040,1,0,11,12,04
Cleveland,Governor,Dax Ewbank,REP,140040,1,0,22,23,
Cleveland,Governor,Chad Moody,REP,140040,0,2,34,36,
Cleveland,Governor,Mary Fallin,REP,140040,11,11,251,273,
Cleveland,Superintendent of Public Instruction,Brian Kelly,REP,140040,4,3,71,78,
Cleveland,Superintendent of Public Instruction,Janet Costello Barresi,REP,140040,3,3,67,73,
Cleveland,Superintendent of Public Instruction,Joy Hofmeister,REP,140040,5,7,163,175,
Cleveland,Insurance Commissioner,Bill Viner,REP,140040,1,4,84,89,
Cleveland,Insurance Commissioner,John Doak,REP,140040,11,9,200,220,
Cleveland,Corporation Commissioner,Todd Hiett,REP,140040,8,5,131,144,
Cleveland,Corporation Commissioner,Cliff Branan,REP,140040,3,6,151,160,
Cleveland,U.S. Senate,Evelyn Rogers,REP,140040,0,1,18,19,
Cleveland,U.S. Senate,Rob Moye,REP,140040,0,0,7,7,
Cleveland,U.S. Senate,D. Jean Mcbride-Samuels,REP,140040,0,0,2,2,
Cleveland,U.S. Senate,Jim Inhofe,REP,140040,12,12,262,286,
Cleveland,U.S. Senate,Erick Paul Wyatt,REP,140040,0,0,14,14,
Cleveland,U.S. Senate,Andy Craig,REP,140040,0,1,3,4,
Cleveland,U.S. Senate,T. Shannon,REP,140040,7,4,82,93,
Cleveland,U.S. Senate,Randy Brogdon,REP,140040,0,0,11,11,
Cleveland,U.S. Senate,Eric Mccray,REP,140040,0,0,0,0,
Cleveland,U.S. Senate,Kevin Crow,REP,140040,0,0,4,4,
Cleveland,U.S. Senate,James Lankford,REP,140040,5,8,208,221,
Cleveland,U.S. Senate,Jason Weger,REP,140040,0,0,1,1,
Cleveland,U.S. House,Anna Flatt,REP,140040,4,1,47,52,04
Cleveland,U.S. House,Tom Cole,REP,140040,8,12,256,276,04
Cleveland,State House,Chris Kannady,REP,140040,10,10,162,182,91
Cleveland,State House,Jon Painter,REP,140040,2,3,107,112,91
Cleveland,State House,Chad Olsen,REP,140040,0,0,17,17,91
Cleveland,State House,David Monlux,REP,140040,0,0,3,3,91
Cleveland,State House,Scott Esk,REP,140040,0,0,10,10,91
Cleveland,Superintendent of Public Instruction,John Cox,DEM,140041,0,0,10,10,
Cleveland,Superintendent of Public Instruction,Jack Jr.,DEM,140041,0,0,3,3,
Cleveland,Superintendent of Public Instruction,Ivan Holmes,DEM,140041,1,0,5,6,
Cleveland,Superintendent of Public Instruction,Freda Deskin,DEM,140041,0,0,16,16,
Cleveland,U.S. Senate,Patrick Michael Hayes,DEM,140041,1,0,1,2,
Cleveland,U.S. Senate,Jim Rogers,DEM,140041,0,0,15,15,
Cleveland,U.S. Senate,Connie Johnson,DEM,140041,0,0,17,17,
Cleveland,U.S. House,Bert Smith,DEM,140041,1,0,19,20,04
Cleveland,U.S. House,Tae Si,DEM,140041,0,0,10,10,04
Cleveland,Governor,Dax Ewbank,REP,140041,0,0,7,7,
Cleveland,Governor,Chad Moody,REP,140041,0,0,7,7,
Cleveland,Governor,Mary Fallin,REP,140041,5,4,99,108,
Cleveland,Superintendent of Public Instruction,Brian Kelly,REP,140041,1,2,25,28,
Cleveland,Superintendent of Public Instruction,Janet Costello Barresi,REP,140041,0,1,41,42,
Cleveland,Superintendent of Public Instruction,Joy Hofmeister,REP,140041,4,1,45,50,
Cleveland,Insurance Commissioner,Bill Viner,REP,140041,0,0,22,22,
Cleveland,Insurance Commissioner,John Doak,REP,140041,4,4,80,88,
Cleveland,Corporation Commissioner,Todd Hiett,REP,140041,5,3,43,51,
Cleveland,Corporation Commissioner,Cliff Branan,REP,140041,0,1,53,54,
Cleveland,U.S. Senate,Evelyn Rogers,REP,140041,1,0,6,7,
Cleveland,U.S. Senate,Rob Moye,REP,140041,0,0,2,2,
Cleveland,U.S. Senate,D. Jean Mcbride-Samuels,REP,140041,0,0,0,0,
Cleveland,U.S. Senate,Jim Inhofe,REP,140041,4,4,102,110,
Cleveland,U.S. Senate,Erick Paul Wyatt,REP,140041,0,0,2,2,
Cleveland,U.S. Senate,Andy Craig,REP,140041,0,0,1,1,
Cleveland,U.S. Senate,T. Shannon,REP,140041,0,1,21,22,
Cleveland,U.S. Senate,Randy Brogdon,REP,140041,0,0,4,4,
Cleveland,U.S. Senate,Eric Mccray,REP,140041,0,0,2,2,
Cleveland,U.S. Senate,Kevin Crow,REP,140041,0,0,1,1,
Cleveland,U.S. Senate,James Lankford,REP,140041,5,3,83,91,
Cleveland,U.S. Senate,Jason Weger,REP,140041,0,0,1,1,
Cleveland,U.S. House,Anna Flatt,REP,140041,0,0,8,8,04
Cleveland,U.S. House,Tom Cole,REP,140041,5,4,102,111,04
Cleveland,State House,Chris Kannady,REP,140041,4,1,58,63,91
Cleveland,State House,Jon Painter,REP,140041,1,3,29,33,91
Cleveland,State House,Chad Olsen,REP,140041,0,0,6,6,91
Cleveland,State House,David Monlux,REP,140041,0,0,1,1,91
Cleveland,State House,Scott Esk,REP,140041,0,0,14,14,91
Cleveland,Superintendent of Public Instruction,John Cox,DEM,140042,0,1,18,19,
Cleveland,Superintendent of Public Instruction,Jack Jr.,DEM,140042,0,2,24,26,
Cleveland,Superintendent of Public Instruction,Ivan Holmes,DEM,140042,1,0,8,9,
Cleveland,Superintendent of Public Instruction,Freda Deskin,DEM,140042,2,1,73,76,
Cleveland,U.S. Senate,Patrick Michael Hayes,DEM,140042,0,0,8,8,
Cleveland,U.S. Senate,Jim Rogers,DEM,140042,0,3,31,34,
Cleveland,U.S. Senate,Connie Johnson,DEM,140042,2,1,78,81,
Cleveland,U.S. House,Bert Smith,DEM,140042,2,3,80,85,04
Cleveland,U.S. House,Tae Si,DEM,140042,1,1,28,30,04
Cleveland,Governor,Dax Ewbank,REP,140042,0,0,6,6,
Cleveland,Governor,Chad Moody,REP,140042,1,2,16,19,
Cleveland,Governor,Mary Fallin,REP,140042,7,7,86,100,
Cleveland,Superintendent of Public Instruction,Brian Kelly,REP,140042,0,1,21,22,
Cleveland,Superintendent of Public Instruction,Janet Costello Barresi,REP,140042,3,5,37,45,
Cleveland,Superintendent of Public Instruction,Joy Hofmeister,REP,140042,5,3,51,59,
Cleveland,Insurance Commissioner,Bill Viner,REP,140042,1,1,21,23,
Cleveland,Insurance Commissioner,John Doak,REP,140042,6,7,78,91,
Cleveland,Corporation Commissioner,Todd Hiett,REP,140042,2,6,44,52,
Cleveland,Corporation Commissioner,Cliff Branan,REP,140042,4,2,56,62,
Cleveland,U.S. Senate,Evelyn Rogers,REP,140042,0,0,9,9,
Cleveland,U.S. Senate,Rob Moye,REP,140042,0,0,0,0,
Cleveland,U.S. Senate,D. Jean Mcbride-Samuels,REP,140042,0,0,5,5,
Cleveland,U.S. Senate,Jim Inhofe,REP,140042,8,9,90,107,
Cleveland,U.S. Senate,Erick Paul Wyatt,REP,140042,0,0,1,1,
Cleveland,U.S. Senate,Andy Craig,REP,140042,0,0,1,1,
Cleveland,U.S. Senate,T. Shannon,REP,140042,1,4,31,36,
Cleveland,U.S. Senate,Randy Brogdon,REP,140042,1,0,0,1,
Cleveland,U.S. Senate,Eric Mccray,REP,140042,0,0,0,0,
Cleveland,U.S. Senate,Kevin Crow,REP,140042,0,0,1,1,
Cleveland,U.S. Senate,James Lankford,REP,140042,6,5,76,87,
Cleveland,U.S. Senate,Jason Weger,REP,140042,0,0,2,2,
Cleveland,U.S. House,Anna Flatt,REP,140042,2,0,16,18,04
Cleveland,U.S. House,Tom Cole,REP,140042,5,9,92,106,04
Cleveland,Superintendent of Public Instruction,John Cox,DEM,140043,0,0,23,23,
Cleveland,Superintendent of Public Instruction,Jack Jr.,DEM,140043,0,0,12,12,
Cleveland,Superintendent of Public Instruction,Ivan Holmes,DEM,140043,0,2,3,5,
Cleveland,Superintendent of Public Instruction,Freda Deskin,DEM,140043,2,1,48,51,
Cleveland,U.S. Senate,Patrick Michael Hayes,DEM,140043,0,0,8,8,
Cleveland,U.S. Senate,Jim Rogers,DEM,140043,0,0,32,32,
Cleveland,U.S. Senate,Connie Johnson,DEM,140043,2,3,46,51,
Cleveland,U.S. House,Bert Smith,DEM,140043,1,1,60,62,04
Cleveland,U.S. House,Tae Si,DEM,140043,1,2,23,26,04
Cleveland,Governor,Dax Ewbank,REP,140043,2,0,27,29,
Cleveland,Governor,Chad Moody,REP,140043,1,2,62,65,
Cleveland,Governor,Mary Fallin,REP,140043,12,6,214,232,
Cleveland,Superintendent of Public Instruction,Brian Kelly,REP,140043,0,4,61,65,
Cleveland,Superintendent of Public Instruction,Janet Costello Barresi,REP,140043,9,0,58,67,
Cleveland,Superintendent of Public Instruction,Joy Hofmeister,REP,140043,6,4,187,197,
Cleveland,Insurance Commissioner,Bill Viner,REP,140043,1,1,69,71,
Cleveland,Insurance Commissioner,John Doak,REP,140043,14,7,217,238,
Cleveland,Corporation Commissioner,Todd Hiett,REP,140043,7,5,147,159,
Cleveland,Corporation Commissioner,Cliff Branan,REP,140043,8,3,145,156,
Cleveland,U.S. Senate,Evelyn Rogers,REP,140043,1,1,9,11,
Cleveland,U.S. Senate,Rob Moye,REP,140043,2,0,8,10,
Cleveland,U.S. Senate,D. Jean Mcbride-Samuels,REP,140043,2,0,6,8,
Cleveland,U.S. Senate,Jim Inhofe,REP,140043,10,7,265,282,
Cleveland,U.S. Senate,Erick Paul Wyatt,REP,140043,0,0,18,18,
Cleveland,U.S. Senate,Andy Craig,REP,140043,0,0,3,3,
Cleveland,U.S. Senate,T. Shannon,REP,140043,0,0,120,120,
Cleveland,U.S. Senate,Randy Brogdon,REP,140043,0,0,6,6,
Cleveland,U.S. Senate,Eric Mccray,REP,140043,0,0,5,5,
Cleveland,U.S. Senate,Kevin Crow,REP,140043,0,0,2,2,
Cleveland,U.S. Senate,James Lankford,REP,140043,15,8,172,195,
Cleveland,U.S. Senate,Jason Weger,REP,140043,0,0,3,3,
Cleveland,U.S. House,Anna Flatt,REP,140043,4,2,53,59,04
Cleveland,U.S. House,Tom Cole,REP,140043,11,6,254,271,04
Cleveland,State House,Danni Legg,REP,140043,2,2,43,47,53
Cleveland,State House,Mark Mcbride,REP,140043,13,6,252,271,53
Cleveland,Superintendent of Public Instruction,John Cox,DEM,140044,1,1,34,36,
Cleveland,Superintendent of Public Instruction,Jack Jr.,DEM,140044,0,0,11,11,
Cleveland,Superintendent of Public Instruction,Ivan Holmes,DEM,140044,1,0,6,7,
Cleveland,Superintendent of Public Instruction,Freda Deskin,DEM,140044,0,0,39,39,
Cleveland,U.S. Senate,Patrick Michael Hayes,DEM,140044,0,0,21,21,
Cleveland,U.S. Senate,Jim Rogers,DEM,140044,1,0,20,21,
Cleveland,U.S. Senate,Connie Johnson,DEM,140044,1,1,48,50,
Cleveland,U.S. House,Bert Smith,DEM,140044,2,1,69,72,04
Cleveland,U.S. House,Tae Si,DEM,140044,0,0,13,13,04
Cleveland,Governor,Dax Ewbank,REP,140044,0,0,34,34,
Cleveland,Governor,Chad Moody,REP,140044,0,3,49,52,
Cleveland,Governor,Mary Fallin,REP,140044,10,5,179,194,
Cleveland,Superintendent of Public Instruction,Brian Kelly,REP,140044,1,1,75,77,
Cleveland,Superintendent of Public Instruction,Janet Costello Barresi,REP,140044,3,0,34,37,
Cleveland,Superintendent of Public Instruction,Joy Hofmeister,REP,140044,5,7,147,159,
Cleveland,Insurance Commissioner,Bill Viner,REP,140044,4,1,58,63,
Cleveland,Insurance Commissioner,John Doak,REP,140044,6,7,187,200,
Cleveland,Corporation Commissioner,Todd Hiett,REP,140044,5,5,126,136,
Cleveland,Corporation Commissioner,Cliff Branan,REP,140044,5,3,123,131,
Cleveland,U.S. Senate,Evelyn Rogers,REP,140044,0,0,13,13,
Cleveland,U.S. Senate,Rob Moye,REP,140044,0,0,6,6,
Cleveland,U.S. Senate,D. Jean Mcbride-Samuels,REP,140044,0,0,6,6,
Cleveland,U.S. Senate,Jim Inhofe,REP,140044,10,8,217,235,
Cleveland,U.S. Senate,Erick Paul Wyatt,REP,140044,0,0,20,20,
Cleveland,U.S. Senate,Andy Craig,REP,140044,0,0,3,3,
Cleveland,U.S. Senate,T. Shannon,REP,140044,3,0,78,81,
Cleveland,U.S. Senate,Randy Brogdon,REP,140044,0,0,8,8,
Cleveland,U.S. Senate,Eric Mccray,REP,140044,0,0,2,2,
Cleveland,U.S. Senate,Kevin Crow,REP,140044,0,0,2,2,
Cleveland,U.S. Senate,James Lankford,REP,140044,7,8,165,180,
Cleveland,U.S. Senate,Jason Weger,REP,140044,0,0,4,4,
Cleveland,U.S. House,Anna Flatt,REP,140044,0,0,42,42,04
Cleveland,U.S. House,Tom Cole,REP,140044,10,8,219,237,04
Cleveland,State House,Danni Legg,REP,140044,1,2,49,52,53
Cleveland,State House,Mark Mcbride,REP,140044,9,6,206,221,53
Cleveland,Superintendent of Public Instruction,John Cox,DEM,140045,0,0,14,14,
Cleveland,Superintendent of Public Instruction,Jack Jr.,DEM,140045,0,0,5,5,
Cleveland,Superintendent of Public Instruction,Ivan Holmes,DEM,140045,0,0,2,2,
Cleveland,Superintendent of Public Instruction,Freda Deskin,DEM,140045,0,1,30,31,
Cleveland,U.S. Senate,Patrick Michael Hayes,DEM,140045,0,0,7,7,
Cleveland,U.S. Senate,Jim Rogers,DEM,140045,0,0,18,18,
Cleveland,U.S. Senate,Connie Johnson,DEM,140045,0,1,26,27,
Cleveland,U.S. House,Bert Smith,DEM,140045,0,0,38,38,04
Cleveland,U.S. House,Tae Si,DEM,140045,0,1,10,11,04
Cleveland,Governor,Dax Ewbank,REP,140045,1,2,16,19,
Cleveland,Governor,Chad Moody,REP,140045,0,1,16,17,
Cleveland,Governor,Mary Fallin,REP,140045,0,1,69,70,
Cleveland,Superintendent of Public Instruction,Brian Kelly,REP,140045,0,3,22,25,
Cleveland,Superintendent of Public Instruction,Janet Costello Barresi,REP,140045,0,0,21,21,
Cleveland,Superintendent of Public Instruction,Joy Hofmeister,REP,140045,1,1,55,57,
Cleveland,Insurance Commissioner,Bill Viner,REP,140045,0,1,30,31,
Cleveland,Insurance Commissioner,John Doak,REP,140045,1,3,68,72,
Cleveland,Corporation Commissioner,Todd Hiett,REP,140045,0,2,44,46,
Cleveland,Corporation Commissioner,Cliff Branan,REP,140045,1,2,51,54,
Cleveland,U.S. Senate,Evelyn Rogers,REP,140045,0,2,4,6,
Cleveland,U.S. Senate,Rob Moye,REP,140045,1,0,3,4,
Cleveland,U.S. Senate,D. Jean Mcbride-Samuels,REP,140045,0,0,1,1,
Cleveland,U.S. Senate,Jim Inhofe,REP,140045,0,2,88,90,
Cleveland,U.S. Senate,Erick Paul Wyatt,REP,140045,0,0,6,6,
Cleveland,U.S. Senate,Andy Craig,REP,140045,0,1,3,4,
Cleveland,U.S. Senate,T. Shannon,REP,140045,0,0,36,36,
Cleveland,U.S. Senate,Randy Brogdon,REP,140045,1,0,5,6,
Cleveland,U.S. Senate,Eric Mccray,REP,140045,0,0,0,0,
Cleveland,U.S. Senate,Kevin Crow,REP,140045,0,0,0,0,
Cleveland,U.S. Senate,James Lankford,REP,140045,0,3,58,61,
Cleveland,U.S. Senate,Jason Weger,REP,140045,0,0,0,0,
Cleveland,U.S. House,Anna Flatt,REP,140045,1,0,28,29,04
Cleveland,U.S. House,Tom Cole,REP,140045,0,4,73,77,04
Cleveland,Superintendent of Public Instruction,John Cox,DEM,140047,0,0,31,31,
Cleveland,Superintendent of Public Instruction,Jack Jr.,DEM,140047,0,0,9,9,
Cleveland,Superintendent of Public Instruction,Ivan Holmes,DEM,140047,1,0,3,4,
Cleveland,Superintendent of Public Instruction,Freda Deskin,DEM,140047,0,0,42,42,
Cleveland,U.S. Senate,Patrick Michael Hayes,DEM,140047,0,0,18,18,
Cleveland,U.S. Senate,Jim Rogers,DEM,140047,0,0,27,27,
Cleveland,U.S. Senate,Connie Johnson,DEM,140047,1,0,38,39,
Cleveland,U.S. House,Bert Smith,DEM,140047,1,0,63,64,04
Cleveland,U.S. House,Tae Si,DEM,140047,0,0,17,17,04
Cleveland,Governor,Dax Ewbank,REP,140047,2,0,17,19,
Cleveland,Governor,Chad Moody,REP,140047,0,0,40,40,
Cleveland,Governor,Mary Fallin,REP,140047,4,6,125,135,
Cleveland,Superintendent of Public Instruction,Brian Kelly,REP,140047,1,1,66,68,
Cleveland,Superintendent of Public Instruction,Janet Costello Barresi,REP,140047,0,2,27,29,
Cleveland,Superintendent of Public Instruction,Joy Hofmeister,REP,140047,5,3,90,98,
Cleveland,Insurance Commissioner,Bill Viner,REP,140047,3,1,42,46,
Cleveland,Insurance Commissioner,John Doak,REP,140047,3,4,133,140,
Cleveland,Corporation Commissioner,Todd Hiett,REP,140047,3,4,79,86,
Cleveland,Corporation Commissioner,Cliff Branan,REP,140047,3,1,95,99,
Cleveland,U.S. Senate,Evelyn Rogers,REP,140047,1,0,9,10,
Cleveland,U.S. Senate,Rob Moye,REP,140047,0,0,3,3,
Cleveland,U.S. Senate,D. Jean Mcbride-Samuels,REP,140047,0,0,1,1,
Cleveland,U.S. Senate,Jim Inhofe,REP,140047,5,6,156,167,
Cleveland,U.S. Senate,Erick Paul Wyatt,REP,140047,0,0,11,11,
Cleveland,U.S. Senate,Andy Craig,REP,140047,0,0,1,1,
Cleveland,U.S. Senate,T. Shannon,REP,140047,3,3,59,65,
Cleveland,U.S. Senate,Randy Brogdon,REP,140047,0,0,7,7,
Cleveland,U.S. Senate,Eric Mccray,REP,140047,0,0,3,3,
Cleveland,U.S. Senate,Kevin Crow,REP,140047,0,0,2,2,
Cleveland,U.S. Senate,James Lankford,REP,140047,3,2,114,119,
Cleveland,U.S. Senate,Jason Weger,REP,140047,0,0,0,0,
Cleveland,U.S. House,Anna Flatt,REP,140047,1,1,31,33,04
Cleveland,U.S. House,Tom Cole,REP,140047,5,5,153,163,04
Cleveland,State House,Paul Wesselhoft,REP,140047,5,5,128,138,54
Cleveland,State House,Adam Graham,REP,140047,1,0,54,55,54
Cleveland,Superintendent of Public Instruction,John Cox,DEM,140048,1,1,8,10,
Cleveland,Superintendent of Public Instruction,Jack Jr.,DEM,140048,0,0,2,2,
Cleveland,Superintendent of Public Instruction,Ivan Holmes,DEM,140048,0,0,1,1,
Cleveland,Superintendent of Public Instruction,Freda Deskin,DEM,140048,1,1,13,15,
Cleveland,U.S. Senate,Patrick Michael Hayes,DEM,140048,0,0,6,6,
Cleveland,U.S. Senate,Jim Rogers,DEM,140048,0,0,5,5,
Cleveland,U.S. Senate,Connie Johnson,DEM,140048,2,2,10,14,
Cleveland,U.S. House,Bert Smith,DEM,140048,2,1,19,22,04
Cleveland,U.S. House,Tae Si,DEM,140048,0,1,4,5,04
Cleveland,Governor,Dax Ewbank,REP,140048,1,2,13,16,
Cleveland,Governor,Chad Moody,REP,140048,0,1,25,26,
Cleveland,Governor,Mary Fallin,REP,140048,1,1,77,79,
Cleveland,Superintendent of Public Instruction,Brian Kelly,REP,140048,0,1,45,46,
Cleveland,Superintendent of Public Instruction,Janet Costello Barresi,REP,140048,1,1,10,12,
Cleveland,Superintendent of Public Instruction,Joy Hofmeister,REP,140048,1,2,58,61,
Cleveland,Insurance Commissioner,Bill Viner,REP,140048,0,2,27,29,
Cleveland,Insurance Commissioner,John Doak,REP,140048,2,2,80,84,
Cleveland,Corporation Commissioner,Todd Hiett,REP,140048,0,3,49,52,
Cleveland,Corporation Commissioner,Cliff Branan,REP,140048,2,1,57,60,
Cleveland,U.S. Senate,Evelyn Rogers,REP,140048,0,0,9,9,
Cleveland,U.S. Senate,Rob Moye,REP,140048,0,0,1,1,
Cleveland,U.S. Senate,D. Jean Mcbride-Samuels,REP,140048,0,1,3,4,
Cleveland,U.S. Senate,Jim Inhofe,REP,140048,2,3,93,98,
Cleveland,U.S. Senate,Erick Paul Wyatt,REP,140048,0,0,5,5,
Cleveland,U.S. Senate,Andy Craig,REP,140048,0,0,2,2,
Cleveland,U.S. Senate,T. Shannon,REP,140048,0,3,48,51,
Cleveland,U.S. Senate,Randy Brogdon,REP,140048,1,0,8,9,
Cleveland,U.S. Senate,Eric Mccray,REP,140048,0,0,1,1,
Cleveland,U.S. Senate,Kevin Crow,REP,140048,0,0,1,1,
Cleveland,U.S. Senate,James Lankford,REP,140048,1,1,57,59,
Cleveland,U.S. Senate,Jason Weger,REP,140048,0,0,0,0,
Cleveland,U.S. House,Anna Flatt,REP,140048,1,2,14,17,04
Cleveland,U.S. House,Tom Cole,REP,140048,1,2,101,104,04
Cleveland,State House,Danni Legg,REP,140048,0,2,25,27,53
Cleveland,State House,Mark Mcbride,REP,140048,2,2,88,92,53
Cleveland,Superintendent of Public Instruction,John Cox,DEM,140049,0,0,22,22,
Cleveland,Superintendent of Public Instruction,Jack Jr.,DEM,140049,0,2,11,13,
Cleveland,Superintendent of Public Instruction,Ivan Holmes,DEM,140049,0,0,2,2,
Cleveland,Superintendent of Public Instruction,Freda Deskin,DEM,140049,1,1,27,29,
Cleveland,U.S. Senate,Patrick Michael Hayes,DEM,140049,0,0,13,13,
Cleveland,U.S. Senate,Jim Rogers,DEM,140049,1,1,23,25,
Cleveland,U.S. Senate,Connie Johnson,DEM,140049,0,2,26,28,
Cleveland,U.S. House,Bert Smith,DEM,140049,1,2,47,50,04
Cleveland,U.S. House,Tae Si,DEM,140049,0,1,13,14,04
Cleveland,Governor,Dax Ewbank,REP,140049,1,0,10,11,
Cleveland,Governor,Chad Moody,REP,140049,1,0,14,15,
Cleveland,Governor,Mary Fallin,REP,140049,3,0,78,81,
Cleveland,Superintendent of Public Instruction,Brian Kelly,REP,140049,1,0,26,27,
Cleveland,Superintendent of Public Instruction,Janet Costello Barresi,REP,140049,1,0,26,27,
Cleveland,Superintendent of Public Instruction,Joy Hofmeister,REP,140049,3,0,51,54,
Cleveland,Insurance Commissioner,Bill Viner,REP,140049,1,0,21,22,
Cleveland,Insurance Commissioner,John Doak,REP,140049,4,0,77,81,
Cleveland,Corporation Commissioner,Todd Hiett,REP,140049,3,0,48,51,
Cleveland,Corporation Commissioner,Cliff Branan,REP,140049,1,0,44,45,
Cleveland,U.S. Senate,Evelyn Rogers,REP,140049,0,0,5,5,
Cleveland,U.S. Senate,Rob Moye,REP,140049,0,0,1,1,
Cleveland,U.S. Senate,D. Jean Mcbride-Samuels,REP,140049,0,0,0,0,
Cleveland,U.S. Senate,Jim Inhofe,REP,140049,5,0,90,95,
Cleveland,U.S. Senate,Erick Paul Wyatt,REP,140049,0,0,6,6,
Cleveland,U.S. Senate,Andy Craig,REP,140049,0,0,0,0,
Cleveland,U.S. Senate,T. Shannon,REP,140049,2,0,40,42,
Cleveland,U.S. Senate,Randy Brogdon,REP,140049,0,0,2,2,
Cleveland,U.S. Senate,Eric Mccray,REP,140049,1,0,0,1,
Cleveland,U.S. Senate,Kevin Crow,REP,140049,0,0,1,1,
Cleveland,U.S. Senate,James Lankford,REP,140049,2,0,61,63,
Cleveland,U.S. Senate,Jason Weger,REP,140049,0,0,0,0,
Cleveland,U.S. House,Anna Flatt,REP,140049,2,0,17,19,04
Cleveland,U.S. House,Tom Cole,REP,140049,3,0,84,87,04
Cleveland,State House,Lani Habrock,REP,140049,0,0,36,36,27
Cleveland,State House,Josh Cockroft,REP,140049,5,0,67,72,27
Cleveland,Superintendent of Public Instruction,John Cox,DEM,140050,0,0,38,38,
Cleveland,Superintendent of Public Instruction,Jack Jr.,DEM,140050,0,0,17,17,
Cleveland,Superintendent of Public Instruction,Ivan Holmes,DEM,140050,1,0,10,11,
Cleveland,Superintendent of Public Instruction,Freda Deskin,DEM,140050,1,2,53,56,
Cleveland,U.S. Senate,Patrick Michael Hayes,DEM,140050,0,0,32,32,
Cleveland,U.S. Senate,Jim Rogers,DEM,140050,1,1,34,36,
Cleveland,U.S. Senate,Connie Johnson,DEM,140050,1,1,50,52,
Cleveland,U.S. House,Bert Smith,DEM,140050,1,1,83,85,04
Cleveland,U.S. House,Tae Si,DEM,140050,0,1,27,28,04
Cleveland,Governor,Dax Ewbank,REP,140050,1,1,24,26,
Cleveland,Governor,Chad Moody,REP,140050,2,0,63,65,
Cleveland,Governor,Mary Fallin,REP,140050,8,5,321,334,
Cleveland,Superintendent of Public Instruction,Brian Kelly,REP,140050,1,0,90,91,
Cleveland,Superintendent of Public Instruction,Janet Costello Barresi,REP,140050,6,0,109,115,
Cleveland,Superintendent of Public Instruction,Joy Hofmeister,REP,140050,5,7,195,207,
Cleveland,Insurance Commissioner,Bill Viner,REP,140050,3,0,100,103,
Cleveland,Insurance Commissioner,John Doak,REP,140050,8,6,271,285,
Cleveland,Corporation Commissioner,Todd Hiett,REP,140050,9,3,160,172,
Cleveland,Corporation Commissioner,Cliff Branan,REP,140050,2,3,210,215,
Cleveland,U.S. Senate,Evelyn Rogers,REP,140050,0,0,28,28,
Cleveland,U.S. Senate,Rob Moye,REP,140050,0,0,10,10,
Cleveland,U.S. Senate,D. Jean Mcbride-Samuels,REP,140050,0,0,3,3,
Cleveland,U.S. Senate,Jim Inhofe,REP,140050,11,7,345,363,
Cleveland,U.S. Senate,Erick Paul Wyatt,REP,140050,1,0,14,15,
Cleveland,U.S. Senate,Andy Craig,REP,140050,1,0,4,5,
Cleveland,U.S. Senate,T. Shannon,REP,140050,4,1,111,116,
Cleveland,U.S. Senate,Randy Brogdon,REP,140050,2,0,10,12,
Cleveland,U.S. Senate,Eric Mccray,REP,140050,0,0,3,3,
Cleveland,U.S. Senate,Kevin Crow,REP,140050,0,0,8,8,
Cleveland,U.S. Senate,James Lankford,REP,140050,5,6,273,284,
Cleveland,U.S. Senate,Jason Weger,REP,140050,0,0,1,1,
Cleveland,U.S. House,Anna Flatt,REP,140050,3,0,76,79,04
Cleveland,U.S. House,Tom Cole,REP,140050,9,7,326,342,04
Cleveland,State House,Chris Kannady,REP,140050,6,5,240,251,91
Cleveland,State House,Jon Painter,REP,140050,0,2,93,95,91
Cleveland,State House,Chad Olsen,REP,140050,1,0,19,20,91
Cleveland,State House,David Monlux,REP,140050,0,0,6,6,91
Cleveland,State House,Scott Esk,REP,140050,4,0,43,47,91
Cleveland,Superintendent of Public Instruction,John Cox,DEM,140051,0,0,19,19,
Cleveland,Superintendent of Public Instruction,Jack Jr.,DEM,140051,0,0,17,17,
Cleveland,Superintendent of Public Instruction,Ivan Holmes,DEM,140051,0,0,6,6,
Cleveland,Superintendent of Public Instruction,Freda Deskin,DEM,140051,1,3,61,65,
Cleveland,U.S. Senate,Patrick Michael Hayes,DEM,140051,0,0,15,15,
Cleveland,U.S. Senate,Jim Rogers,DEM,140051,0,0,22,22,
Cleveland,U.S. Senate,Connie Johnson,DEM,140051,1,3,60,64,
Cleveland,U.S. House,Bert Smith,DEM,140051,0,2,49,51,04
Cleveland,U.S. House,Tae Si,DEM,140051,0,1,36,37,04
Cleveland,Governor,Dax Ewbank,REP,140051,0,0,11,11,
Cleveland,Governor,Chad Moody,REP,140051,1,1,15,17,
Cleveland,Governor,Mary Fallin,REP,140051,5,4,77,86,
Cleveland,Superintendent of Public Instruction,Brian Kelly,REP,140051,1,3,25,29,
Cleveland,Superintendent of Public Instruction,Janet Costello Barresi,REP,140051,3,2,30,35,
Cleveland,Superintendent of Public Instruction,Joy Hofmeister,REP,140051,2,0,39,41,
Cleveland,Insurance Commissioner,Bill Viner,REP,140051,1,1,23,25,
Cleveland,Insurance Commissioner,John Doak,REP,140051,4,4,72,80,
Cleveland,Corporation Commissioner,Todd Hiett,REP,140051,3,2,47,52,
Cleveland,Corporation Commissioner,Cliff Branan,REP,140051,3,3,43,49,
Cleveland,U.S. Senate,Evelyn Rogers,REP,140051,1,2,2,5,
Cleveland,U.S. Senate,Rob Moye,REP,140051,0,0,3,3,
Cleveland,U.S. Senate,D. Jean Mcbride-Samuels,REP,140051,0,0,1,1,
Cleveland,U.S. Senate,Jim Inhofe,REP,140051,5,2,90,97,
Cleveland,U.S. Senate,Erick Paul Wyatt,REP,140051,0,1,3,4,
Cleveland,U.S. Senate,Andy Craig,REP,140051,1,0,1,2,
Cleveland,U.S. Senate,T. Shannon,REP,140051,0,3,32,35,
Cleveland,U.S. Senate,Randy Brogdon,REP,140051,0,0,1,1,
Cleveland,U.S. Senate,Eric Mccray,REP,140051,0,0,1,1,
Cleveland,U.S. Senate,Kevin Crow,REP,140051,2,0,1,3,
Cleveland,U.S. Senate,James Lankford,REP,140051,3,2,64,69,
Cleveland,U.S. Senate,Jason Weger,REP,140051,0,0,1,1,
Cleveland,U.S. House,Anna Flatt,REP,140051,0,2,13,15,04
Cleveland,U.S. House,Tom Cole,REP,140051,6,3,87,96,04
Cleveland,Superintendent of Public Instruction,John Cox,DEM,140053,0,1,35,36,
Cleveland,Superintendent of Public Instruction,Jack Jr.,DEM,140053,0,0,27,27,
Cleveland,Superintendent of Public Instruction,Ivan Holmes,DEM,140053,0,0,8,8,
Cleveland,Superintendent of Public Instruction,Freda Deskin,DEM,140053,6,9,99,114,
Cleveland,U.S. Senate,Patrick Michael Hayes,DEM,140053,0,2,22,24,
Cleveland,U.S. Senate,Jim Rogers,DEM,140053,0,1,38,39,
Cleveland,U.S. Senate,Connie Johnson,DEM,140053,4,7,104,115,
Cleveland,U.S. House,Bert Smith,DEM,140053,4,7,106,117,04
Cleveland,U.S. House,Tae Si,DEM,140053,2,2,48,52,04
Cleveland,Governor,Dax Ewbank,REP,140053,1,3,49,53,
Cleveland,Governor,Chad Moody,REP,140053,2,8,83,93,
Cleveland,Governor,Mary Fallin,REP,140053,11,19,348,378,
Cleveland,Superintendent of Public Instruction,Brian Kelly,REP,140053,2,7,97,106,
Cleveland,Superintendent of Public Instruction,Janet Costello Barresi,REP,140053,5,13,123,141,
Cleveland,Superintendent of Public Instruction,Joy Hofmeister,REP,140053,6,12,246,264,
Cleveland,Insurance Commissioner,Bill Viner,REP,140053,5,4,88,97,
Cleveland,Insurance Commissioner,John Doak,REP,140053,8,26,347,381,
Cleveland,Corporation Commissioner,Todd Hiett,REP,140053,8,16,195,219,
Cleveland,Corporation Commissioner,Cliff Branan,REP,140053,4,13,243,260,
Cleveland,U.S. Senate,Evelyn Rogers,REP,140053,3,3,31,37,
Cleveland,U.S. Senate,Rob Moye,REP,140053,0,1,5,6,
Cleveland,U.S. Senate,D. Jean Mcbride-Samuels,REP,140053,0,0,3,3,
Cleveland,U.S. Senate,Jim Inhofe,REP,140053,11,26,412,449,
Cleveland,U.S. Senate,Erick Paul Wyatt,REP,140053,0,1,26,27,
Cleveland,U.S. Senate,Andy Craig,REP,140053,0,1,5,6,
Cleveland,U.S. Senate,T. Shannon,REP,140053,1,6,156,163,
Cleveland,U.S. Senate,Randy Brogdon,REP,140053,0,1,6,7,
Cleveland,U.S. Senate,Eric Mccray,REP,140053,0,0,1,1,
Cleveland,U.S. Senate,Kevin Crow,REP,140053,0,1,3,4,
Cleveland,U.S. Senate,James Lankford,REP,140053,13,20,304,337,
Cleveland,U.S. Senate,Jason Weger,REP,140053,0,3,5,8,
Cleveland,U.S. House,Anna Flatt,REP,140053,2,4,67,73,04
Cleveland,U.S. House,Tom Cole,REP,140053,12,27,411,450,04
Cleveland,Superintendent of Public Instruction,John Cox,DEM,140054,0,0,15,15,
Cleveland,Superintendent of Public Instruction,Jack Jr.,DEM,140054,1,1,6,8,
Cleveland,Superintendent of Public Instruction,Ivan Holmes,DEM,140054,0,0,4,4,
Cleveland,Superintendent of Public Instruction,Freda Deskin,DEM,140054,0,0,17,17,
Cleveland,U.S. Senate,Patrick Michael Hayes,DEM,140054,0,0,6,6,
Cleveland,U.S. Senate,Jim Rogers,DEM,140054,0,0,16,16,
Cleveland,U.S. Senate,Connie Johnson,DEM,140054,1,1,20,22,
Cleveland,U.S. House,Bert Smith,DEM,140054,1,0,31,32,04
Cleveland,U.S. House,Tae Si,DEM,140054,0,1,11,12,04
Cleveland,Governor,Dax Ewbank,REP,140054,0,0,14,14,
Cleveland,Governor,Chad Moody,REP,140054,3,2,25,30,
Cleveland,Governor,Mary Fallin,REP,140054,0,0,95,95,
Cleveland,Superintendent of Public Instruction,Brian Kelly,REP,140054,2,1,34,37,
Cleveland,Superintendent of Public Instruction,Janet Costello Barresi,REP,140054,0,0,30,30,
Cleveland,Superintendent of Public Instruction,Joy Hofmeister,REP,140054,1,1,70,72,
Cleveland,Insurance Commissioner,Bill Viner,REP,140054,0,1,23,24,
Cleveland,Insurance Commissioner,John Doak,REP,140054,3,1,106,110,
Cleveland,Corporation Commissioner,Todd Hiett,REP,140054,2,0,69,71,
Cleveland,Corporation Commissioner,Cliff Branan,REP,140054,1,2,59,62,
Cleveland,U.S. Senate,Evelyn Rogers,REP,140054,0,0,9,9,
Cleveland,U.S. Senate,Rob Moye,REP,140054,0,0,1,1,
Cleveland,U.S. Senate,D. Jean Mcbride-Samuels,REP,140054,0,0,3,3,
Cleveland,U.S. Senate,Jim Inhofe,REP,140054,3,1,117,121,
Cleveland,U.S. Senate,Erick Paul Wyatt,REP,140054,0,1,4,5,
Cleveland,U.S. Senate,Andy Craig,REP,140054,0,0,0,0,
Cleveland,U.S. Senate,T. Shannon,REP,140054,0,1,36,37,
Cleveland,U.S. Senate,Randy Brogdon,REP,140054,0,0,9,9,
Cleveland,U.S. Senate,Eric Mccray,REP,140054,0,0,1,1,
Cleveland,U.S. Senate,Kevin Crow,REP,140054,1,0,1,2,
Cleveland,U.S. Senate,James Lankford,REP,140054,2,1,87,90,
Cleveland,U.S. Senate,Jason Weger,REP,140054,0,0,3,3,
Cleveland,U.S. House,Anna Flatt,REP,140054,1,2,27,30,04
Cleveland,U.S. House,Tom Cole,REP,140054,2,0,111,113,04
Cleveland,State House,Paul Wesselhoft,REP,140054,1,0,103,104,54
Cleveland,State House,Adam Graham,REP,140054,2,2,29,33,54
Cleveland,Superintendent of Public Instruction,John Cox,DEM,140055,2,3,49,54,
Cleveland,Superintendent of Public Instruction,Jack Jr.,DEM,140055,0,3,34,37,
Cleveland,Superintendent of Public Instruction,Ivan Holmes,DEM,140055,0,1,7,8,
Cleveland,Superintendent of Public Instruction,Freda Deskin,DEM,140055,4,11,136,151,
Cleveland,U.S. Senate,Patrick Michael Hayes,DEM,140055,1,0,30,31,
Cleveland,U.S. Senate,Jim Rogers,DEM,140055,1,6,42,49,
Cleveland,U.S. Senate,Connie Johnson,DEM,140055,4,10,147,161,
Cleveland,U.S. House,Bert Smith,DEM,140055,5,13,134,152,04
Cleveland,U.S. House,Tae Si,DEM,140055,1,4,76,81,04
Cleveland,Governor,Dax Ewbank,REP,140055,1,5,48,54,
Cleveland,Governor,Chad Moody,REP,140055,2,5,82,89,
Cleveland,Governor,Mary Fallin,REP,140055,10,33,336,379,
Cleveland,Superintendent of Public Instruction,Brian Kelly,REP,140055,1,9,95,105,
Cleveland,Superintendent of Public Instruction,Janet Costello Barresi,REP,140055,6,9,113,128,
Cleveland,Superintendent of Public Instruction,Joy Hofmeister,REP,140055,4,23,255,282,
Cleveland,Insurance Commissioner,Bill Viner,REP,140055,3,6,105,114,
Cleveland,Insurance Commissioner,John Doak,REP,140055,9,33,323,365,
Cleveland,Corporation Commissioner,Todd Hiett,REP,140055,8,25,211,244,
Cleveland,Corporation Commissioner,Cliff Branan,REP,140055,4,14,214,232,
Cleveland,U.S. Senate,Evelyn Rogers,REP,140055,1,4,30,35,
Cleveland,U.S. Senate,Rob Moye,REP,140055,0,0,5,5,
Cleveland,U.S. Senate,D. Jean Mcbride-Samuels,REP,140055,1,0,7,8,
Cleveland,U.S. Senate,Jim Inhofe,REP,140055,11,35,394,440,
Cleveland,U.S. Senate,Erick Paul Wyatt,REP,140055,0,2,26,28,
Cleveland,U.S. Senate,Andy Craig,REP,140055,0,0,5,5,
Cleveland,U.S. Senate,T. Shannon,REP,140055,1,8,147,156,
Cleveland,U.S. Senate,Randy Brogdon,REP,140055,0,1,19,20,
Cleveland,U.S. Senate,Eric Mccray,REP,140055,0,0,2,2,
Cleveland,U.S. Senate,Kevin Crow,REP,140055,1,1,1,3,
Cleveland,U.S. Senate,James Lankford,REP,140055,11,31,289,331,
Cleveland,U.S. Senate,Jason Weger,REP,140055,0,0,5,5,
Cleveland,U.S. House,Anna Flatt,REP,140055,3,7,88,98,04
Cleveland,U.S. House,Tom Cole,REP,140055,10,34,377,421,04
Cleveland,Superintendent of Public Instruction,John Cox,DEM,140056,1,1,41,43,
Cleveland,Superintendent of Public Instruction,Jack Jr.,DEM,140056,4,1,35,40,
Cleveland,Superintendent of Public Instruction,Ivan Holmes,DEM,140056,0,4,3,7,
Cleveland,Superintendent of Public Instruction,Freda Deskin,DEM,140056,2,3,150,155,
Cleveland,U.S. Senate,Patrick Michael Hayes,DEM,140056,1,0,31,32,
Cleveland,U.S. Senate,Jim Rogers,DEM,140056,0,2,37,39,
Cleveland,U.S. Senate,Connie Johnson,DEM,140056,6,4,140,150,
Cleveland,U.S. House,Bert Smith,DEM,140056,6,5,127,138,04
Cleveland,U.S. House,Tae Si,DEM,140056,0,0,57,57,04
Cleveland,Governor,Dax Ewbank,REP,140056,0,3,16,19,
Cleveland,Governor,Chad Moody,REP,140056,0,3,47,50,
Cleveland,Governor,Mary Fallin,REP,140056,6,9,162,177,
Cleveland,Superintendent of Public Instruction,Brian Kelly,REP,140056,1,5,51,57,
Cleveland,Superintendent of Public Instruction,Janet Costello Barresi,REP,140056,5,3,78,86,
Cleveland,Superintendent of Public Instruction,Joy Hofmeister,REP,140056,0,7,93,100,
Cleveland,Insurance Commissioner,Bill Viner,REP,140056,1,5,48,54,
Cleveland,Insurance Commissioner,John Doak,REP,140056,5,10,161,176,
Cleveland,Corporation Commissioner,Todd Hiett,REP,140056,1,8,110,119,
Cleveland,Corporation Commissioner,Cliff Branan,REP,140056,5,6,94,105,
Cleveland,U.S. Senate,Evelyn Rogers,REP,140056,0,3,9,12,
Cleveland,U.S. Senate,Rob Moye,REP,140056,0,0,3,3,
Cleveland,U.S. Senate,D. Jean Mcbride-Samuels,REP,140056,0,0,5,5,
Cleveland,U.S. Senate,Jim Inhofe,REP,140056,6,10,202,218,
Cleveland,U.S. Senate,Erick Paul Wyatt,REP,140056,0,1,9,10,
Cleveland,U.S. Senate,Andy Craig,REP,140056,0,0,0,0,
Cleveland,U.S. Senate,T. Shannon,REP,140056,2,6,72,80,
Cleveland,U.S. Senate,Randy Brogdon,REP,140056,0,2,7,9,
Cleveland,U.S. Senate,Eric Mccray,REP,140056,0,0,3,3,
Cleveland,U.S. Senate,Kevin Crow,REP,140056,0,1,5,6,
Cleveland,U.S. Senate,James Lankford,REP,140056,4,6,141,151,
Cleveland,U.S. Senate,Jason Weger,REP,140056,0,0,0,0,
Cleveland,U.S. House,Anna Flatt,REP,140056,0,2,35,37,04
Cleveland,U.S. House,Tom Cole,REP,140056,5,13,188,206,04
Cleveland,Superintendent of Public Instruction,John Cox,DEM,140057,0,0,33,33,
Cleveland,Superintendent of Public Instruction,Jack Jr.,DEM,140057,0,1,29,30,
Cleveland,Superintendent of Public Instruction,Ivan Holmes,DEM,140057,1,0,13,14,
Cleveland,Superintendent of Public Instruction,Freda Deskin,DEM,140057,1,3,78,82,
Cleveland,U.S. Senate,Patrick Michael Hayes,DEM,140057,0,0,37,37,
Cleveland,U.S. Senate,Jim Rogers,DEM,140057,1,1,48,50,
Cleveland,U.S. Senate,Connie Johnson,DEM,140057,1,3,65,69,
Cleveland,U.S. House,Bert Smith,DEM,140057,1,3,125,129,04
Cleveland,U.S. House,Tae Si,DEM,140057,1,1,21,23,04
Cleveland,Governor,Dax Ewbank,REP,140057,1,3,33,37,
Cleveland,Governor,Chad Moody,REP,140057,1,4,67,72,
Cleveland,Governor,Mary Fallin,REP,140057,6,9,190,205,
Cleveland,Superintendent of Public Instruction,Brian Kelly,REP,140057,2,7,74,83,
Cleveland,Superintendent of Public Instruction,Janet Costello Barresi,REP,140057,4,1,41,46,
Cleveland,Superintendent of Public Instruction,Joy Hofmeister,REP,140057,2,8,171,181,
Cleveland,Insurance Commissioner,Bill Viner,REP,140057,1,4,77,82,
Cleveland,Insurance Commissioner,John Doak,REP,140057,6,10,194,210,
Cleveland,Corporation Commissioner,Todd Hiett,REP,140057,4,6,149,159,
Cleveland,Corporation Commissioner,Cliff Branan,REP,140057,4,9,115,128,
Cleveland,U.S. Senate,Evelyn Rogers,REP,140057,1,1,13,15,
Cleveland,U.S. Senate,Rob Moye,REP,140057,0,0,7,7,
Cleveland,U.S. Senate,D. Jean Mcbride-Samuels,REP,140057,0,0,5,5,
Cleveland,U.S. Senate,Jim Inhofe,REP,140057,7,15,239,261,
Cleveland,U.S. Senate,Erick Paul Wyatt,REP,140057,0,0,21,21,
Cleveland,U.S. Senate,Andy Craig,REP,140057,0,0,6,6,
Cleveland,U.S. Senate,T. Shannon,REP,140057,3,8,103,114,
Cleveland,U.S. Senate,Randy Brogdon,REP,140057,0,0,8,8,
Cleveland,U.S. Senate,Eric Mccray,REP,140057,0,0,1,1,
Cleveland,U.S. Senate,Kevin Crow,REP,140057,0,1,0,1,
Cleveland,U.S. Senate,James Lankford,REP,140057,5,7,171,183,
Cleveland,U.S. Senate,Jason Weger,REP,140057,0,0,4,4,
Cleveland,U.S. House,Anna Flatt,REP,140057,0,1,45,46,04
Cleveland,U.S. House,Tom Cole,REP,140057,8,15,247,270,04
Cleveland,Superintendent of Public Instruction,John Cox,DEM,140058,3,0,21,24,
Cleveland,Superintendent of Public Instruction,Jack Jr.,DEM,140058,2,0,14,16,
Cleveland,Superintendent of Public Instruction,Ivan Holmes,DEM,140058,2,0,1,3,
Cleveland,Superintendent of Public Instruction,Freda Deskin,DEM,140058,1,0,32,33,
Cleveland,U.S. Senate,Patrick Michael Hayes,DEM,140058,3,0,11,14,
Cleveland,U.S. Senate,Jim Rogers,DEM,140058,2,0,19,21,
Cleveland,U.S. Senate,Connie Johnson,DEM,140058,3,0,38,41,
Cleveland,U.S. House,Bert Smith,DEM,140058,5,0,54,59,04
Cleveland,U.S. House,Tae Si,DEM,140058,2,0,13,15,04
Cleveland,Governor,Dax Ewbank,REP,140058,2,0,29,31,
Cleveland,Governor,Chad Moody,REP,140058,0,0,51,51,
Cleveland,Governor,Mary Fallin,REP,140058,5,11,191,207,
Cleveland,Superintendent of Public Instruction,Brian Kelly,REP,140058,0,1,70,71,
Cleveland,Superintendent of Public Instruction,Janet Costello Barresi,REP,140058,4,3,61,68,
Cleveland,Superintendent of Public Instruction,Joy Hofmeister,REP,140058,3,7,141,151,
Cleveland,Insurance Commissioner,Bill Viner,REP,140058,2,4,67,73,
Cleveland,Insurance Commissioner,John Doak,REP,140058,5,7,193,205,
Cleveland,Corporation Commissioner,Todd Hiett,REP,140058,3,5,121,129,
Cleveland,Corporation Commissioner,Cliff Branan,REP,140058,3,6,136,145,
Cleveland,U.S. Senate,Evelyn Rogers,REP,140058,0,0,13,13,
Cleveland,U.S. Senate,Rob Moye,REP,140058,0,0,6,6,
Cleveland,U.S. Senate,D. Jean Mcbride-Samuels,REP,140058,0,0,9,9,
Cleveland,U.S. Senate,Jim Inhofe,REP,140058,7,11,232,250,
Cleveland,U.S. Senate,Erick Paul Wyatt,REP,140058,0,0,10,10,
Cleveland,U.S. Senate,Andy Craig,REP,140058,0,0,3,3,
Cleveland,U.S. Senate,T. Shannon,REP,140058,0,2,59,61,
Cleveland,U.S. Senate,Randy Brogdon,REP,140058,1,0,9,10,
Cleveland,U.S. Senate,Eric Mccray,REP,140058,0,0,1,1,
Cleveland,U.S. Senate,Kevin Crow,REP,140058,0,0,4,4,
Cleveland,U.S. Senate,James Lankford,REP,140058,6,9,194,209,
Cleveland,U.S. Senate,Jason Weger,REP,140058,0,0,4,4,
Cleveland,U.S. House,Anna Flatt,REP,140058,1,2,35,38,04
Cleveland,U.S. House,Tom Cole,REP,140058,6,9,235,250,04
Cleveland,State House,Paul Wesselhoft,REP,140058,6,9,196,211,54
Cleveland,State House,Adam Graham,REP,140058,1,2,72,75,54
Cleveland,Superintendent of Public Instruction,John Cox,DEM,140059,4,1,26,31,
Cleveland,Superintendent of Public Instruction,Jack Jr.,DEM,140059,1,0,10,11,
Cleveland,Superintendent of Public Instruction,Ivan Holmes,DEM,140059,2,0,4,6,
Cleveland,Superintendent of Public Instruction,Freda Deskin,DEM,140059,2,1,48,51,
Cleveland,U.S. Senate,Patrick Michael Hayes,DEM,140059,3,1,8,12,
Cleveland,U.S. Senate,Jim Rogers,DEM,140059,1,0,18,19,
Cleveland,U.S. Senate,Connie Johnson,DEM,140059,5,1,56,62,
Cleveland,U.S. House,Bert Smith,DEM,140059,4,2,49,55,04
Cleveland,U.S. House,Tae Si,DEM,140059,3,0,26,29,04
Cleveland,Governor,Dax Ewbank,REP,140059,0,0,6,6,
Cleveland,Governor,Chad Moody,REP,140059,2,0,22,24,
Cleveland,Governor,Mary Fallin,REP,140059,0,1,58,59,
Cleveland,Superintendent of Public Instruction,Brian Kelly,REP,140059,0,0,20,20,
Cleveland,Superintendent of Public Instruction,Janet Costello Barresi,REP,140059,0,1,25,26,
Cleveland,Superintendent of Public Instruction,Joy Hofmeister,REP,140059,2,0,42,44,
Cleveland,Insurance Commissioner,Bill Viner,REP,140059,0,0,17,17,
Cleveland,Insurance Commissioner,John Doak,REP,140059,2,1,62,65,
Cleveland,Corporation Commissioner,Todd Hiett,REP,140059,1,1,44,46,
Cleveland,Corporation Commissioner,Cliff Branan,REP,140059,0,0,37,37,
Cleveland,U.S. Senate,Evelyn Rogers,REP,140059,0,0,6,6,
Cleveland,U.S. Senate,Rob Moye,REP,140059,0,0,3,3,
Cleveland,U.S. Senate,D. Jean Mcbride-Samuels,REP,140059,0,0,3,3,
Cleveland,U.S. Senate,Jim Inhofe,REP,140059,1,1,73,75,
Cleveland,U.S. Senate,Erick Paul Wyatt,REP,140059,0,0,3,3,
Cleveland,U.S. Senate,Andy Craig,REP,140059,0,0,4,4,
Cleveland,U.S. Senate,T. Shannon,REP,140059,0,0,20,20,
Cleveland,U.S. Senate,Randy Brogdon,REP,140059,0,0,3,3,
Cleveland,U.S. Senate,Eric Mccray,REP,140059,0,0,1,1,
Cleveland,U.S. Senate,Kevin Crow,REP,140059,0,0,0,0,
Cleveland,U.S. Senate,James Lankford,REP,140059,1,1,59,61,
Cleveland,U.S. Senate,Jason Weger,REP,140059,0,0,0,0,
Cleveland,U.S. House,Anna Flatt,REP,140059,0,0,16,16,04
Cleveland,U.S. House,Tom Cole,REP,140059,2,1,72,75,04
Cleveland,Superintendent of Public Instruction,John Cox,DEM,140060,1,1,48,50,
Cleveland,Superintendent of Public Instruction,Jack Jr.,DEM,140060,0,0,16,16,
Cleveland,Superintendent of Public Instruction,Ivan Holmes,DEM,140060,1,0,12,13,
Cleveland,Superintendent of Public Instruction,Freda Deskin,DEM,140060,1,3,42,46,
Cleveland,U.S. Senate,Patrick Michael Hayes,DEM,140060,0,1,12,13,
Cleveland,U.S. Senate,Jim Rogers,DEM,140060,0,2,41,43,
Cleveland,U.S. Senate,Connie Johnson,DEM,140060,3,1,64,68,
Cleveland,U.S. House,Bert Smith,DEM,140060,2,2,78,82,04
Cleveland,U.S. House,Tae Si,DEM,140060,1,2,32,35,04
Cleveland,Governor,Dax Ewbank,REP,140060,5,3,45,53,
Cleveland,Governor,Chad Moody,REP,140060,1,0,66,67,
Cleveland,Governor,Mary Fallin,REP,140060,23,5,377,405,
Cleveland,Superintendent of Public Instruction,Brian Kelly,REP,140060,3,2,122,127,
Cleveland,Superintendent of Public Instruction,Janet Costello Barresi,REP,140060,6,0,97,103,
Cleveland,Superintendent of Public Instruction,Joy Hofmeister,REP,140060,15,6,262,283,
Cleveland,Insurance Commissioner,Bill Viner,REP,140060,8,2,117,127,
Cleveland,Insurance Commissioner,John Doak,REP,140060,18,5,345,368,
Cleveland,Corporation Commissioner,Todd Hiett,REP,140060,13,4,218,235,
Cleveland,Corporation Commissioner,Cliff Branan,REP,140060,12,3,242,257,
Cleveland,U.S. Senate,Evelyn Rogers,REP,140060,0,0,20,20,
Cleveland,U.S. Senate,Rob Moye,REP,140060,0,0,9,9,
Cleveland,U.S. Senate,D. Jean Mcbride-Samuels,REP,140060,0,0,3,3,
Cleveland,U.S. Senate,Jim Inhofe,REP,140060,22,7,430,459,
Cleveland,U.S. Senate,Erick Paul Wyatt,REP,140060,6,1,27,34,
Cleveland,U.S. Senate,Andy Craig,REP,140060,0,0,5,5,
Cleveland,U.S. Senate,T. Shannon,REP,140060,3,4,113,120,
Cleveland,U.S. Senate,Randy Brogdon,REP,140060,1,1,22,24,
Cleveland,U.S. Senate,Eric Mccray,REP,140060,0,0,5,5,
Cleveland,U.S. Senate,Kevin Crow,REP,140060,0,0,1,1,
Cleveland,U.S. Senate,James Lankford,REP,140060,25,3,346,374,
Cleveland,U.S. Senate,Jason Weger,REP,140060,0,0,0,0,
Cleveland,U.S. House,Anna Flatt,REP,140060,10,2,87,99,04
Cleveland,U.S. House,Tom Cole,REP,140060,19,5,401,425,04
Cleveland,State House,Paul Wesselhoft,REP,140060,22,5,383,410,54
Cleveland,State House,Adam Graham,REP,140060,6,1,91,98,54
Cleveland,Superintendent of Public Instruction,John Cox,DEM,140061,3,2,24,29,
Cleveland,Superintendent of Public Instruction,Jack Jr.,DEM,140061,1,0,12,13,
Cleveland,Superintendent of Public Instruction,Ivan Holmes,DEM,140061,2,1,3,6,
Cleveland,Superintendent of Public Instruction,Freda Deskin,DEM,140061,1,2,31,34,
Cleveland,U.S. Senate,Patrick Michael Hayes,DEM,140061,2,1,11,14,
Cleveland,U.S. Senate,Jim Rogers,DEM,140061,1,1,25,27,
Cleveland,U.S. Senate,Connie Johnson,DEM,140061,3,3,36,42,
Cleveland,U.S. House,Bert Smith,DEM,140061,4,5,55,64,04
Cleveland,U.S. House,Tae Si,DEM,140061,2,0,15,17,04
Cleveland,Governor,Dax Ewbank,REP,140061,0,0,24,24,
Cleveland,Governor,Chad Moody,REP,140061,2,0,60,62,
Cleveland,Governor,Mary Fallin,REP,140061,34,11,403,448,
Cleveland,Superintendent of Public Instruction,Brian Kelly,REP,140061,10,3,139,152,
Cleveland,Superintendent of Public Instruction,Janet Costello Barresi,REP,140061,11,3,128,142,
Cleveland,Superintendent of Public Instruction,Joy Hofmeister,REP,140061,13,6,211,230,
Cleveland,Insurance Commissioner,Bill Viner,REP,140061,4,3,113,120,
Cleveland,Insurance Commissioner,John Doak,REP,140061,29,8,335,372,
Cleveland,Corporation Commissioner,Todd Hiett,REP,140061,15,3,221,239,
Cleveland,Corporation Commissioner,Cliff Branan,REP,140061,20,7,226,253,
Cleveland,U.S. Senate,Evelyn Rogers,REP,140061,1,2,22,25,
Cleveland,U.S. Senate,Rob Moye,REP,140061,0,0,6,6,
Cleveland,U.S. Senate,D. Jean Mcbride-Samuels,REP,140061,0,0,2,2,
Cleveland,U.S. Senate,Jim Inhofe,REP,140061,34,9,442,485,
Cleveland,U.S. Senate,Erick Paul Wyatt,REP,140061,0,0,9,9,
Cleveland,U.S. Senate,Andy Craig,REP,140061,0,0,2,2,
Cleveland,U.S. Senate,T. Shannon,REP,140061,10,4,128,142,
Cleveland,U.S. Senate,Randy Brogdon,REP,140061,0,0,6,6,
Cleveland,U.S. Senate,Eric Mccray,REP,140061,0,0,3,3,
Cleveland,U.S. Senate,Kevin Crow,REP,140061,0,0,5,5,
Cleveland,U.S. Senate,James Lankford,REP,140061,26,8,346,380,
Cleveland,U.S. Senate,Jason Weger,REP,140061,0,0,1,1,
Cleveland,U.S. House,Anna Flatt,REP,140061,5,0,60,65,04
Cleveland,U.S. House,Tom Cole,REP,140061,31,12,424,467,04
Cleveland,State House,Chris Kannady,REP,140061,14,10,253,277,91
Cleveland,State House,Jon Painter,REP,140061,18,2,174,194,91
Cleveland,State House,Chad Olsen,REP,140061,1,0,26,27,91
Cleveland,State House,David Monlux,REP,140061,1,0,5,6,91
Cleveland,State House,Scott Esk,REP,140061,1,0,24,25,91
Cleveland,Superintendent of Public Instruction,John Cox,DEM,140063,0,0,7,7,
Cleveland,Superintendent of Public Instruction,Jack Jr.,DEM,140063,0,0,2,2,
Cleveland,Superintendent of Public Instruction,Ivan Holmes,DEM,140063,0,0,1,1,
Cleveland,Superintendent of Public Instruction,Freda Deskin,DEM,140063,0,0,12,12,
Cleveland,U.S. Senate,Patrick Michael Hayes,DEM,140063,0,0,4,4,
Cleveland,U.S. Senate,Jim Rogers,DEM,140063,0,0,4,4,
Cleveland,U.S. Senate,Connie Johnson,DEM,140063,0,0,13,13,
Cleveland,U.S. House,Bert Smith,DEM,140063,0,0,17,17,04
Cleveland,U.S. House,Tae Si,DEM,140063,0,0,4,4,04
Cleveland,Governor,Dax Ewbank,REP,140063,0,0,13,13,
Cleveland,Governor,Chad Moody,REP,140063,1,0,16,17,
Cleveland,Governor,Mary Fallin,REP,140063,5,1,77,83,
Cleveland,Superintendent of Public Instruction,Brian Kelly,REP,140063,2,0,31,33,
Cleveland,Superintendent of Public Instruction,Janet Costello Barresi,REP,140063,3,0,21,24,
Cleveland,Superintendent of Public Instruction,Joy Hofmeister,REP,140063,0,1,48,49,
Cleveland,Insurance Commissioner,Bill Viner,REP,140063,5,1,21,27,
Cleveland,Insurance Commissioner,John Doak,REP,140063,1,0,74,75,
Cleveland,Corporation Commissioner,Todd Hiett,REP,140063,1,1,56,58,
Cleveland,Corporation Commissioner,Cliff Branan,REP,140063,4,0,37,41,
Cleveland,U.S. Senate,Evelyn Rogers,REP,140063,1,0,2,3,
Cleveland,U.S. Senate,Rob Moye,REP,140063,0,0,3,3,
Cleveland,U.S. Senate,D. Jean Mcbride-Samuels,REP,140063,0,0,2,2,
Cleveland,U.S. Senate,Jim Inhofe,REP,140063,5,1,89,95,
Cleveland,U.S. Senate,Erick Paul Wyatt,REP,140063,0,0,9,9,
Cleveland,U.S. Senate,Andy Craig,REP,140063,1,0,1,2,
Cleveland,U.S. Senate,T. Shannon,REP,140063,2,0,32,34,
Cleveland,U.S. Senate,Randy Brogdon,REP,140063,0,0,3,3,
Cleveland,U.S. Senate,Eric Mccray,REP,140063,0,0,0,0,
Cleveland,U.S. Senate,Kevin Crow,REP,140063,0,0,1,1,
Cleveland,U.S. Senate,James Lankford,REP,140063,3,1,67,71,
Cleveland,U.S. Senate,Jason Weger,REP,140063,0,0,1,1,
Cleveland,U.S. House,Anna Flatt,REP,140063,1,0,22,23,04
Cleveland,U.S. House,Tom Cole,REP,140063,5,1,84,90,04
Cleveland,State House,Lani Habrock,REP,140063,0,0,23,23,27
Cleveland,State House,Josh Cockroft,REP,140063,6,1,73,80,27
Cleveland,Superintendent of Public Instruction,John Cox,DEM,140064,0,0,20,20,
Cleveland,Superintendent of Public Instruction,Jack Jr.,DEM,140064,0,0,3,3,
Cleveland,Superintendent of Public Instruction,Ivan Holmes,DEM,140064,1,0,2,3,
Cleveland,Superintendent of Public Instruction,Freda Deskin,DEM,140064,4,0,20,24,
Cleveland,U.S. Senate,Patrick Michael Hayes,DEM,140064,0,0,6,6,
Cleveland,U.S. Senate,Jim Rogers,DEM,140064,0,0,16,16,
Cleveland,U.S. Senate,Connie Johnson,DEM,140064,5,0,23,28,
Cleveland,U.S. House,Bert Smith,DEM,140064,4,0,34,38,04
Cleveland,U.S. House,Tae Si,DEM,140064,1,0,8,9,04
Cleveland,Governor,Dax Ewbank,REP,140064,3,0,12,15,
Cleveland,Governor,Chad Moody,REP,140064,2,1,34,37,
Cleveland,Governor,Mary Fallin,REP,140064,16,3,161,180,
Cleveland,Superintendent of Public Instruction,Brian Kelly,REP,140064,5,2,56,63,
Cleveland,Superintendent of Public Instruction,Janet Costello Barresi,REP,140064,8,1,43,52,
Cleveland,Superintendent of Public Instruction,Joy Hofmeister,REP,140064,7,1,99,107,
Cleveland,Insurance Commissioner,Bill Viner,REP,140064,1,3,48,52,
Cleveland,Insurance Commissioner,John Doak,REP,140064,18,1,144,163,
Cleveland,Corporation Commissioner,Todd Hiett,REP,140064,11,3,90,104,
Cleveland,Corporation Commissioner,Cliff Branan,REP,140064,6,1,93,100,
Cleveland,U.S. Senate,Evelyn Rogers,REP,140064,1,2,2,5,
Cleveland,U.S. Senate,Rob Moye,REP,140064,0,0,9,9,
Cleveland,U.S. Senate,D. Jean Mcbride-Samuels,REP,140064,0,0,3,3,
Cleveland,U.S. Senate,Jim Inhofe,REP,140064,19,2,182,203,
Cleveland,U.S. Senate,Erick Paul Wyatt,REP,140064,0,0,10,10,
Cleveland,U.S. Senate,Andy Craig,REP,140064,0,0,0,0,
Cleveland,U.S. Senate,T. Shannon,REP,140064,3,0,65,68,
Cleveland,U.S. Senate,Randy Brogdon,REP,140064,2,0,6,8,
Cleveland,U.S. Senate,Eric Mccray,REP,140064,1,0,0,1,
Cleveland,U.S. Senate,Kevin Crow,REP,140064,0,0,3,3,
Cleveland,U.S. Senate,James Lankford,REP,140064,15,4,134,153,
Cleveland,U.S. Senate,Jason Weger,REP,140064,0,0,0,0,
Cleveland,U.S. House,Anna Flatt,REP,140064,6,1,31,38,04
Cleveland,U.S. House,Tom Cole,REP,140064,14,3,173,190,04
Cleveland,State House,Lani Habrock,REP,140064,5,2,59,66,27
Cleveland,State House,Josh Cockroft,REP,140064,14,2,147,163,27
Cleveland,Superintendent of Public Instruction,John Cox,DEM,140065,1,0,8,9,
Cleveland,Superintendent of Public Instruction,Jack Jr.,DEM,140065,0,0,7,7,
Cleveland,Superintendent of Public Instruction,Ivan Holmes,DEM,140065,1,0,4,5,
Cleveland,Superintendent of Public Instruction,Freda Deskin,DEM,140065,3,0,23,26,
Cleveland,U.S. Senate,Patrick Michael Hayes,DEM,140065,0,0,6,6,
Cleveland,U.S. Senate,Jim Rogers,DEM,140065,1,0,9,10,
Cleveland,U.S. Senate,Connie Johnson,DEM,140065,4,0,24,28,
Cleveland,U.S. House,Bert Smith,DEM,140065,5,0,31,36,04
Cleveland,U.S. House,Tae Si,DEM,140065,0,0,6,6,04
Cleveland,Governor,Dax Ewbank,REP,140065,2,0,12,14,
Cleveland,Governor,Chad Moody,REP,140065,1,1,32,34,
Cleveland,Governor,Mary Fallin,REP,140065,2,0,82,84,
Cleveland,Superintendent of Public Instruction,Brian Kelly,REP,140065,2,0,44,46,
Cleveland,Superintendent of Public Instruction,Janet Costello Barresi,REP,140065,1,0,27,28,
Cleveland,Superintendent of Public Instruction,Joy Hofmeister,REP,140065,2,1,54,57,
Cleveland,Insurance Commissioner,Bill Viner,REP,140065,2,0,22,24,
Cleveland,Insurance Commissioner,John Doak,REP,140065,3,1,99,103,
Cleveland,Corporation Commissioner,Todd Hiett,REP,140065,4,0,49,53,
Cleveland,Corporation Commissioner,Cliff Branan,REP,140065,1,1,74,76,
Cleveland,U.S. Senate,Evelyn Rogers,REP,140065,1,0,5,6,
Cleveland,U.S. Senate,Rob Moye,REP,140065,0,0,3,3,
Cleveland,U.S. Senate,D. Jean Mcbride-Samuels,REP,140065,0,0,0,0,
Cleveland,U.S. Senate,Jim Inhofe,REP,140065,4,1,114,119,
Cleveland,U.S. Senate,Erick Paul Wyatt,REP,140065,0,0,5,5,
Cleveland,U.S. Senate,Andy Craig,REP,140065,1,0,1,2,
Cleveland,U.S. Senate,T. Shannon,REP,140065,1,1,46,48,
Cleveland,U.S. Senate,Randy Brogdon,REP,140065,0,0,4,4,
Cleveland,U.S. Senate,Eric Mccray,REP,140065,0,0,2,2,
Cleveland,U.S. Senate,Kevin Crow,REP,140065,0,0,0,0,
Cleveland,U.S. Senate,James Lankford,REP,140065,3,0,73,76,
Cleveland,U.S. Senate,Jason Weger,REP,140065,0,0,2,2,
Cleveland,U.S. House,Anna Flatt,REP,140065,0,0,29,29,04
Cleveland,U.S. House,Tom Cole,REP,140065,5,1,97,103,04
Cleveland,State House,Lani Habrock,REP,140065,3,0,22,25,27
Cleveland,State House,Josh Cockroft,REP,140065,2,1,104,107,27
Cleveland,Superintendent of Public Instruction,John Cox,DEM,140067,1,0,21,22,
Cleveland,Superintendent of Public Instruction,Jack Jr.,DEM,140067,0,1,6,7,
Cleveland,Superintendent of Public Instruction,Ivan Holmes,DEM,140067,0,0,1,1,
Cleveland,Superintendent of Public Instruction,Freda Deskin,DEM,140067,0,3,42,45,
Cleveland,U.S. Senate,Patrick Michael Hayes,DEM,140067,0,0,14,14,
Cleveland,U.S. Senate,Jim Rogers,DEM,140067,1,1,9,11,
Cleveland,U.S. Senate,Connie Johnson,DEM,140067,0,3,45,48,
Cleveland,U.S. House,Bert Smith,DEM,140067,1,2,50,53,04
Cleveland,U.S. House,Tae Si,DEM,140067,0,1,16,17,04
Cleveland,Governor,Dax Ewbank,REP,140067,0,2,17,19,
Cleveland,Governor,Chad Moody,REP,140067,1,2,28,31,
Cleveland,Governor,Mary Fallin,REP,140067,3,3,96,102,
Cleveland,Superintendent of Public Instruction,Brian Kelly,REP,140067,4,2,51,57,
Cleveland,Superintendent of Public Instruction,Janet Costello Barresi,REP,140067,0,1,18,19,
Cleveland,Superintendent of Public Instruction,Joy Hofmeister,REP,140067,0,5,71,76,
Cleveland,Insurance Commissioner,Bill Viner,REP,140067,0,1,30,31,
Cleveland,Insurance Commissioner,John Doak,REP,140067,4,6,99,109,
Cleveland,Corporation Commissioner,Todd Hiett,REP,140067,1,0,54,55,
Cleveland,Corporation Commissioner,Cliff Branan,REP,140067,3,6,76,85,
Cleveland,U.S. Senate,Evelyn Rogers,REP,140067,0,0,6,6,
Cleveland,U.S. Senate,Rob Moye,REP,140067,0,0,3,3,
Cleveland,U.S. Senate,D. Jean Mcbride-Samuels,REP,140067,0,0,2,2,
Cleveland,U.S. Senate,Jim Inhofe,REP,140067,4,8,124,136,
Cleveland,U.S. Senate,Erick Paul Wyatt,REP,140067,0,0,9,9,
Cleveland,U.S. Senate,Andy Craig,REP,140067,0,0,2,2,
Cleveland,U.S. Senate,T. Shannon,REP,140067,2,2,45,49,
Cleveland,U.S. Senate,Randy Brogdon,REP,140067,0,0,6,6,
Cleveland,U.S. Senate,Eric Mccray,REP,140067,0,0,2,2,
Cleveland,U.S. Senate,Kevin Crow,REP,140067,0,0,4,4,
Cleveland,U.S. Senate,James Lankford,REP,140067,2,5,87,94,
Cleveland,U.S. Senate,Jason Weger,REP,140067,0,0,0,0,
Cleveland,U.S. House,Anna Flatt,REP,140067,0,2,27,29,04
Cleveland,U.S. House,Tom Cole,REP,140067,4,7,115,126,04
Cleveland,Superintendent of Public Instruction,John Cox,DEM,140068,0,3,19,22,
Cleveland,Superintendent of Public Instruction,Jack Jr.,DEM,140068,0,0,17,17,
Cleveland,Superintendent of Public Instruction,Ivan Holmes,DEM,140068,0,0,1,1,
Cleveland,Superintendent of Public Instruction,Freda Deskin,DEM,140068,2,2,45,49,
Cleveland,U.S. Senate,Patrick Michael Hayes,DEM,140068,0,0,11,11,
Cleveland,U.S. Senate,Jim Rogers,DEM,140068,0,0,15,15,
Cleveland,U.S. Senate,Connie Johnson,DEM,140068,2,5,55,62,
Cleveland,U.S. House,Bert Smith,DEM,140068,1,1,53,55,04
Cleveland,U.S. House,Tae Si,DEM,140068,1,4,24,29,04
Cleveland,Governor,Dax Ewbank,REP,140068,1,1,19,21,
Cleveland,Governor,Chad Moody,REP,140068,0,2,22,24,
Cleveland,Governor,Mary Fallin,REP,140068,1,4,88,93,
Cleveland,Superintendent of Public Instruction,Brian Kelly,REP,140068,1,2,32,35,
Cleveland,Superintendent of Public Instruction,Janet Costello Barresi,REP,140068,0,1,31,32,
Cleveland,Superintendent of Public Instruction,Joy Hofmeister,REP,140068,0,6,67,73,
Cleveland,Insurance Commissioner,Bill Viner,REP,140068,0,1,26,27,
Cleveland,Insurance Commissioner,John Doak,REP,140068,2,5,91,98,
Cleveland,Corporation Commissioner,Todd Hiett,REP,140068,2,3,51,56,
Cleveland,Corporation Commissioner,Cliff Branan,REP,140068,0,3,67,70,
Cleveland,U.S. Senate,Evelyn Rogers,REP,140068,0,1,7,8,
Cleveland,U.S. Senate,Rob Moye,REP,140068,0,1,4,5,
Cleveland,U.S. Senate,D. Jean Mcbride-Samuels,REP,140068,0,0,3,3,
Cleveland,U.S. Senate,Jim Inhofe,REP,140068,1,5,111,117,
Cleveland,U.S. Senate,Erick Paul Wyatt,REP,140068,1,0,6,7,
Cleveland,U.S. Senate,Andy Craig,REP,140068,0,0,1,1,
Cleveland,U.S. Senate,T. Shannon,REP,140068,0,5,61,66,
Cleveland,U.S. Senate,Randy Brogdon,REP,140068,0,0,3,3,
Cleveland,U.S. Senate,Eric Mccray,REP,140068,0,0,2,2,
Cleveland,U.S. Senate,Kevin Crow,REP,140068,0,0,2,2,
Cleveland,U.S. Senate,James Lankford,REP,140068,2,3,61,66,
Cleveland,U.S. Senate,Jason Weger,REP,140068,0,0,2,2,
Cleveland,U.S. House,Anna Flatt,REP,140068,0,2,24,26,04
Cleveland,U.S. House,Tom Cole,REP,140068,2,4,105,111,04
Cleveland,Superintendent of Public Instruction,John Cox,DEM,140069,2,3,43,48,
Cleveland,Superintendent of Public Instruction,Jack Jr.,DEM,140069,1,1,19,21,
Cleveland,Superintendent of Public Instruction,Ivan Holmes,DEM,140069,0,0,13,13,
Cleveland,Superintendent of Public Instruction,Freda Deskin,DEM,140069,1,0,51,52,
Cleveland,U.S. Senate,Patrick Michael Hayes,DEM,140069,3,1,9,13,
Cleveland,U.S. Senate,Jim Rogers,DEM,140069,1,0,47,48,
Cleveland,U.S. Senate,Connie Johnson,DEM,140069,0,3,69,72,
Cleveland,U.S. House,Bert Smith,DEM,140069,2,4,94,100,04
Cleveland,U.S. House,Tae Si,DEM,140069,0,0,28,28,04
Cleveland,Governor,Dax Ewbank,REP,140069,1,0,22,23,
Cleveland,Governor,Chad Moody,REP,140069,1,1,63,65,
Cleveland,Governor,Mary Fallin,REP,140069,12,12,332,356,
Cleveland,Superintendent of Public Instruction,Brian Kelly,REP,140069,1,3,107,111,
Cleveland,Superintendent of Public Instruction,Janet Costello Barresi,REP,140069,3,2,102,107,
Cleveland,Superintendent of Public Instruction,Joy Hofmeister,REP,140069,10,7,197,214,
Cleveland,Insurance Commissioner,Bill Viner,REP,140069,0,1,74,75,
Cleveland,Insurance Commissioner,John Doak,REP,140069,14,13,315,342,
Cleveland,Corporation Commissioner,Todd Hiett,REP,140069,5,4,189,198,
Cleveland,Corporation Commissioner,Cliff Branan,REP,140069,6,9,199,214,
Cleveland,U.S. Senate,Evelyn Rogers,REP,140069,0,1,25,26,
Cleveland,U.S. Senate,Rob Moye,REP,140069,0,0,4,4,
Cleveland,U.S. Senate,D. Jean Mcbride-Samuels,REP,140069,0,0,3,3,
Cleveland,U.S. Senate,Jim Inhofe,REP,140069,14,13,374,401,
Cleveland,U.S. Senate,Erick Paul Wyatt,REP,140069,1,0,7,8,
Cleveland,U.S. Senate,Andy Craig,REP,140069,0,0,8,8,
Cleveland,U.S. Senate,T. Shannon,REP,140069,4,5,123,132,
Cleveland,U.S. Senate,Randy Brogdon,REP,140069,0,0,7,7,
Cleveland,U.S. Senate,Eric Mccray,REP,140069,0,0,4,4,
Cleveland,U.S. Senate,Kevin Crow,REP,140069,0,0,3,3,
Cleveland,U.S. Senate,James Lankford,REP,140069,10,9,274,293,
Cleveland,U.S. Senate,Jason Weger,REP,140069,0,0,1,1,
Cleveland,U.S. House,Anna Flatt,REP,140069,1,2,58,61,04
Cleveland,U.S. House,Tom Cole,REP,140069,14,12,355,381,04
Cleveland,State House,Chris Kannady,REP,140069,7,13,272,292,91
Cleveland,State House,Jon Painter,REP,140069,3,0,80,83,91
Cleveland,State House,Chad Olsen,REP,140069,0,1,17,18,91
Cleveland,State House,David Monlux,REP,140069,1,0,2,3,91
Cleveland,State House,Scott Esk,REP,140069,3,0,41,44,91
Cleveland,Superintendent of Public Instruction,John Cox,DEM,140070,1,0,23,24,
Cleveland,Superintendent of Public Instruction,Jack Jr.,DEM,140070,0,1,7,8,
Cleveland,Superintendent of Public Instruction,Ivan Holmes,DEM,140070,1,0,5,6,
Cleveland,Superintendent of Public Instruction,Freda Deskin,DEM,140070,0,1,44,45,
Cleveland,U.S. Senate,Patrick Michael Hayes,DEM,140070,2,1,14,17,
Cleveland,U.S. Senate,Jim Rogers,DEM,140070,0,0,19,19,
Cleveland,U.S. Senate,Connie Johnson,DEM,140070,0,1,46,47,
Cleveland,U.S. House,Bert Smith,DEM,140070,2,2,50,54,04
Cleveland,U.S. House,Tae Si,DEM,140070,0,0,27,27,04
Cleveland,Governor,Dax Ewbank,REP,140070,0,1,15,16,
Cleveland,Governor,Chad Moody,REP,140070,0,0,49,49,
Cleveland,Governor,Mary Fallin,REP,140070,7,4,171,182,
Cleveland,Superintendent of Public Instruction,Brian Kelly,REP,140070,3,3,45,51,
Cleveland,Superintendent of Public Instruction,Janet Costello Barresi,REP,140070,3,0,63,66,
Cleveland,Superintendent of Public Instruction,Joy Hofmeister,REP,140070,1,2,125,128,
Cleveland,Insurance Commissioner,Bill Viner,REP,140070,2,3,42,47,
Cleveland,Insurance Commissioner,John Doak,REP,140070,5,2,180,187,
Cleveland,Corporation Commissioner,Todd Hiett,REP,140070,2,2,94,98,
Cleveland,Corporation Commissioner,Cliff Branan,REP,140070,5,2,121,128,
Cleveland,U.S. Senate,Evelyn Rogers,REP,140070,0,1,8,9,
Cleveland,U.S. Senate,Rob Moye,REP,140070,0,0,3,3,
Cleveland,U.S. Senate,D. Jean Mcbride-Samuels,REP,140070,0,0,8,8,
Cleveland,U.S. Senate,Jim Inhofe,REP,140070,6,4,202,212,
Cleveland,U.S. Senate,Erick Paul Wyatt,REP,140070,1,0,10,11,
Cleveland,U.S. Senate,Andy Craig,REP,140070,1,0,3,4,
Cleveland,U.S. Senate,T. Shannon,REP,140070,0,2,65,67,
Cleveland,U.S. Senate,Randy Brogdon,REP,140070,0,0,8,8,
Cleveland,U.S. Senate,Eric Mccray,REP,140070,0,0,2,2,
Cleveland,U.S. Senate,Kevin Crow,REP,140070,0,0,0,0,
Cleveland,U.S. Senate,James Lankford,REP,140070,6,3,159,168,
Cleveland,U.S. Senate,Jason Weger,REP,140070,0,0,0,0,
Cleveland,U.S. House,Anna Flatt,REP,140070,2,1,34,37,04
Cleveland,U.S. House,Tom Cole,REP,140070,5,4,201,210,04
Cleveland,State House,Danni Legg,REP,140070,1,2,55,58,53
Cleveland,State House,Mark Mcbride,REP,140070,5,2,174,181,53
Cleveland,Superintendent of Public Instruction,John Cox,DEM,140071,0,0,14,14,
Cleveland,Superintendent of Public Instruction,Jack Jr.,DEM,140071,3,0,13,16,
Cleveland,Superintendent of Public Instruction,Ivan Holmes,DEM,140071,0,0,2,2,
Cleveland,Superintendent of Public Instruction,Freda Deskin,DEM,140071,3,1,45,49,
Cleveland,U.S. Senate,Patrick Michael Hayes,DEM,140071,1,0,9,10,
Cleveland,U.S. Senate,Jim Rogers,DEM,140071,2,0,12,14,
Cleveland,U.S. Senate,Connie Johnson,DEM,140071,2,1,49,52,
Cleveland,U.S. House,Bert Smith,DEM,140071,4,1,47,52,04
Cleveland,U.S. House,Tae Si,DEM,140071,2,0,20,22,04
Cleveland,Governor,Dax Ewbank,REP,140071,0,0,8,8,
Cleveland,Governor,Chad Moody,REP,140071,0,0,14,14,
Cleveland,Governor,Mary Fallin,REP,140071,6,4,116,126,
Cleveland,Superintendent of Public Instruction,Brian Kelly,REP,140071,0,0,23,23,
Cleveland,Superintendent of Public Instruction,Janet Costello Barresi,REP,140071,4,2,53,59,
Cleveland,Superintendent of Public Instruction,Joy Hofmeister,REP,140071,1,2,57,60,
Cleveland,Insurance Commissioner,Bill Viner,REP,140071,0,2,30,32,
Cleveland,Insurance Commissioner,John Doak,REP,140071,6,2,86,94,
Cleveland,Corporation Commissioner,Todd Hiett,REP,140071,4,3,48,55,
Cleveland,Corporation Commissioner,Cliff Branan,REP,140071,1,1,72,74,
Cleveland,U.S. Senate,Evelyn Rogers,REP,140071,0,0,9,9,
Cleveland,U.S. Senate,Rob Moye,REP,140071,0,0,1,1,
Cleveland,U.S. Senate,D. Jean Mcbride-Samuels,REP,140071,0,0,2,2,
Cleveland,U.S. Senate,Jim Inhofe,REP,140071,6,4,122,132,
Cleveland,U.S. Senate,Erick Paul Wyatt,REP,140071,0,0,2,2,
Cleveland,U.S. Senate,Andy Craig,REP,140071,0,0,0,0,
Cleveland,U.S. Senate,T. Shannon,REP,140071,1,0,31,32,
Cleveland,U.S. Senate,Randy Brogdon,REP,140071,0,0,1,1,
Cleveland,U.S. Senate,Eric Mccray,REP,140071,0,0,0,0,
Cleveland,U.S. Senate,Kevin Crow,REP,140071,0,0,1,1,
Cleveland,U.S. Senate,James Lankford,REP,140071,5,4,104,113,
Cleveland,U.S. Senate,Jason Weger,REP,140071,0,0,1,1,
Cleveland,U.S. House,Anna Flatt,REP,140071,0,0,21,21,04
Cleveland,U.S. House,Tom Cole,REP,140071,6,4,114,124,04
Cleveland,Superintendent of Public Instruction,John Cox,DEM,140072,0,1,21,22,
Cleveland,Superintendent of Public Instruction,Jack Jr.,DEM,140072,2,2,7,11,
Cleveland,Superintendent of Public Instruction,Ivan Holmes,DEM,140072,0,0,6,6,
Cleveland,Superintendent of Public Instruction,Freda Deskin,DEM,140072,3,5,32,40,
Cleveland,U.S. Senate,Patrick Michael Hayes,DEM,140072,1,1,11,13,
Cleveland,U.S. Senate,Jim Rogers,DEM,140072,0,2,15,17,
Cleveland,U.S. Senate,Connie Johnson,DEM,140072,4,5,37,46,
Cleveland,U.S. House,Bert Smith,DEM,140072,4,7,48,59,04
Cleveland,U.S. House,Tae Si,DEM,140072,1,1,14,16,04
Cleveland,Governor,Dax Ewbank,REP,140072,0,0,47,47,
Cleveland,Governor,Chad Moody,REP,140072,5,3,35,43,
Cleveland,Governor,Mary Fallin,REP,140072,13,6,242,261,
Cleveland,Superintendent of Public Instruction,Brian Kelly,REP,140072,8,0,84,92,
Cleveland,Superintendent of Public Instruction,Janet Costello Barresi,REP,140072,6,4,68,78,
Cleveland,Superintendent of Public Instruction,Joy Hofmeister,REP,140072,3,5,170,178,
Cleveland,Insurance Commissioner,Bill Viner,REP,140072,4,2,67,73,
Cleveland,Insurance Commissioner,John Doak,REP,140072,15,6,230,251,
Cleveland,Corporation Commissioner,Todd Hiett,REP,140072,10,5,150,165,
Cleveland,Corporation Commissioner,Cliff Branan,REP,140072,8,4,140,152,
Cleveland,U.S. Senate,Evelyn Rogers,REP,140072,0,0,6,6,
Cleveland,U.S. Senate,Rob Moye,REP,140072,0,1,9,10,
Cleveland,U.S. Senate,D. Jean Mcbride-Samuels,REP,140072,2,0,6,8,
Cleveland,U.S. Senate,Jim Inhofe,REP,140072,15,8,292,315,
Cleveland,U.S. Senate,Erick Paul Wyatt,REP,140072,2,0,8,10,
Cleveland,U.S. Senate,Andy Craig,REP,140072,0,0,2,2,
Cleveland,U.S. Senate,T. Shannon,REP,140072,4,4,93,101,
Cleveland,U.S. Senate,Randy Brogdon,REP,140072,1,0,7,8,
Cleveland,U.S. Senate,Eric Mccray,REP,140072,0,0,2,2,
Cleveland,U.S. Senate,Kevin Crow,REP,140072,0,0,2,2,
Cleveland,U.S. Senate,James Lankford,REP,140072,13,5,219,237,
Cleveland,U.S. Senate,Jason Weger,REP,140072,0,0,2,2,
Cleveland,U.S. House,Anna Flatt,REP,140072,4,1,53,58,04
Cleveland,U.S. House,Tom Cole,REP,140072,15,8,270,293,04
Cleveland,State House,Danni Legg,REP,140072,3,2,61,66,53
Cleveland,State House,Mark Mcbride,REP,140072,16,6,254,276,53
Cleveland,Superintendent of Public Instruction,John Cox,DEM,140073,0,2,53,55,
Cleveland,Superintendent of Public Instruction,Jack Jr.,DEM,140073,2,0,30,32,
Cleveland,Superintendent of Public Instruction,Ivan Holmes,DEM,140073,0,0,6,6,
Cleveland,Superintendent of Public Instruction,Freda Deskin,DEM,140073,8,2,110,120,
Cleveland,U.S. Senate,Patrick Michael Hayes,DEM,140073,1,0,20,21,
Cleveland,U.S. Senate,Jim Rogers,DEM,140073,1,2,49,52,
Cleveland,U.S. Senate,Connie Johnson,DEM,140073,8,2,115,125,
Cleveland,U.S. House,Bert Smith,DEM,140073,8,4,133,145,04
Cleveland,U.S. House,Tae Si,DEM,140073,2,0,50,52,04
Cleveland,Governor,Dax Ewbank,REP,140073,0,2,39,41,
Cleveland,Governor,Chad Moody,REP,140073,5,4,95,104,
Cleveland,Governor,Mary Fallin,REP,140073,11,10,411,432,
Cleveland,Superintendent of Public Instruction,Brian Kelly,REP,140073,4,2,105,111,
Cleveland,Superintendent of Public Instruction,Janet Costello Barresi,REP,140073,9,7,140,156,
Cleveland,Superintendent of Public Instruction,Joy Hofmeister,REP,140073,2,7,301,310,
Cleveland,Insurance Commissioner,Bill Viner,REP,140073,2,2,96,100,
Cleveland,Insurance Commissioner,John Doak,REP,140073,12,12,408,432,
Cleveland,Corporation Commissioner,Todd Hiett,REP,140073,6,6,230,242,
Cleveland,Corporation Commissioner,Cliff Branan,REP,140073,7,5,261,273,
Cleveland,U.S. Senate,Evelyn Rogers,REP,140073,0,2,23,25,
Cleveland,U.S. Senate,Rob Moye,REP,140073,1,0,10,11,
Cleveland,U.S. Senate,D. Jean Mcbride-Samuels,REP,140073,0,1,4,5,
Cleveland,U.S. Senate,Jim Inhofe,REP,140073,13,13,490,516,
Cleveland,U.S. Senate,Erick Paul Wyatt,REP,140073,2,0,19,21,
Cleveland,U.S. Senate,Andy Craig,REP,140073,1,0,4,5,
Cleveland,U.S. Senate,T. Shannon,REP,140073,8,3,182,193,
Cleveland,U.S. Senate,Randy Brogdon,REP,140073,1,1,17,19,
Cleveland,U.S. Senate,Eric Mccray,REP,140073,0,0,4,4,
Cleveland,U.S. Senate,Kevin Crow,REP,140073,0,0,3,3,
Cleveland,U.S. Senate,James Lankford,REP,140073,6,11,346,363,
Cleveland,U.S. Senate,Jason Weger,REP,140073,0,0,1,1,
Cleveland,U.S. House,Anna Flatt,REP,140073,2,0,72,74,04
Cleveland,U.S. House,Tom Cole,REP,140073,14,15,483,512,04
Cleveland,Superintendent of Public Instruction,John Cox,DEM,140074,2,0,7,9,
Cleveland,Superintendent of Public Instruction,Jack Jr.,DEM,140074,0,1,14,15,
Cleveland,Superintendent of Public Instruction,Ivan Holmes,DEM,140074,0,0,2,2,
Cleveland,Superintendent of Public Instruction,Freda Deskin,DEM,140074,2,0,51,53,
Cleveland,U.S. Senate,Patrick Michael Hayes,DEM,140074,0,0,9,9,
Cleveland,U.S. Senate,Jim Rogers,DEM,140074,0,1,13,14,
Cleveland,U.S. Senate,Connie Johnson,DEM,140074,4,0,50,54,
Cleveland,U.S. House,Bert Smith,DEM,140074,4,1,39,44,04
Cleveland,U.S. House,Tae Si,DEM,140074,0,0,32,32,04
Cleveland,Governor,Dax Ewbank,REP,140074,0,1,25,26,
Cleveland,Governor,Chad Moody,REP,140074,1,1,32,34,
Cleveland,Governor,Mary Fallin,REP,140074,2,17,146,165,
Cleveland,Superintendent of Public Instruction,Brian Kelly,REP,140074,1,0,38,39,
Cleveland,Superintendent of Public Instruction,Janet Costello Barresi,REP,140074,0,9,56,65,
Cleveland,Superintendent of Public Instruction,Joy Hofmeister,REP,140074,2,10,106,118,
Cleveland,Insurance Commissioner,Bill Viner,REP,140074,0,2,50,52,
Cleveland,Insurance Commissioner,John Doak,REP,140074,3,15,136,154,
Cleveland,Corporation Commissioner,Todd Hiett,REP,140074,2,7,85,94,
Cleveland,Corporation Commissioner,Cliff Branan,REP,140074,1,8,95,104,
Cleveland,U.S. Senate,Evelyn Rogers,REP,140074,0,1,9,10,
Cleveland,U.S. Senate,Rob Moye,REP,140074,0,0,8,8,
Cleveland,U.S. Senate,D. Jean Mcbride-Samuels,REP,140074,0,0,3,3,
Cleveland,U.S. Senate,Jim Inhofe,REP,140074,3,17,175,195,
Cleveland,U.S. Senate,Erick Paul Wyatt,REP,140074,0,1,8,9,
Cleveland,U.S. Senate,Andy Craig,REP,140074,0,0,0,0,
Cleveland,U.S. Senate,T. Shannon,REP,140074,1,5,49,55,
Cleveland,U.S. Senate,Randy Brogdon,REP,140074,0,0,9,9,
Cleveland,U.S. Senate,Eric Mccray,REP,140074,0,0,2,2,
Cleveland,U.S. Senate,Kevin Crow,REP,140074,0,0,0,0,
Cleveland,U.S. Senate,James Lankford,REP,140074,2,14,145,161,
Cleveland,U.S. Senate,Jason Weger,REP,140074,0,0,1,1,
Cleveland,U.S. House,Anna Flatt,REP,140074,0,1,32,33,04
Cleveland,U.S. House,Tom Cole,REP,140074,3,18,170,191,04
Cleveland,Superintendent of Public Instruction,John Cox,DEM,140076,0,1,10,11,
Cleveland,Superintendent of Public Instruction,Jack Jr.,DEM,140076,0,2,10,12,
Cleveland,Superintendent of Public Instruction,Ivan Holmes,DEM,140076,0,0,5,5,
Cleveland,Superintendent of Public Instruction,Freda Deskin,DEM,140076,3,2,44,49,
Cleveland,U.S. Senate,Patrick Michael Hayes,DEM,140076,0,0,9,9,
Cleveland,U.S. Senate,Jim Rogers,DEM,140076,0,0,14,14,
Cleveland,U.S. Senate,Connie Johnson,DEM,140076,3,5,46,54,
Cleveland,U.S. House,Bert Smith,DEM,140076,2,5,43,50,04
Cleveland,U.S. House,Tae Si,DEM,140076,1,0,23,24,04
Cleveland,Governor,Dax Ewbank,REP,140076,0,2,14,16,
Cleveland,Governor,Chad Moody,REP,140076,0,1,34,35,
Cleveland,Governor,Mary Fallin,REP,140076,3,10,102,115,
Cleveland,Superintendent of Public Instruction,Brian Kelly,REP,140076,1,2,33,36,
Cleveland,Superintendent of Public Instruction,Janet Costello Barresi,REP,140076,0,6,43,49,
Cleveland,Superintendent of Public Instruction,Joy Hofmeister,REP,140076,0,7,73,80,
Cleveland,Insurance Commissioner,Bill Viner,REP,140076,0,1,23,24,
Cleveland,Insurance Commissioner,John Doak,REP,140076,1,12,117,130,
Cleveland,Corporation Commissioner,Todd Hiett,REP,140076,0,8,73,81,
Cleveland,Corporation Commissioner,Cliff Branan,REP,140076,1,6,67,74,
Cleveland,U.S. Senate,Evelyn Rogers,REP,140076,0,3,8,11,
Cleveland,U.S. Senate,Rob Moye,REP,140076,0,0,5,5,
Cleveland,U.S. Senate,D. Jean Mcbride-Samuels,REP,140076,0,0,4,4,
Cleveland,U.S. Senate,Jim Inhofe,REP,140076,3,12,120,135,
Cleveland,U.S. Senate,Erick Paul Wyatt,REP,140076,0,0,10,10,
Cleveland,U.S. Senate,Andy Craig,REP,140076,0,0,0,0,
Cleveland,U.S. Senate,T. Shannon,REP,140076,2,6,46,54,
Cleveland,U.S. Senate,Randy Brogdon,REP,140076,0,1,7,8,
Cleveland,U.S. Senate,Eric Mccray,REP,140076,0,0,1,1,
Cleveland,U.S. Senate,Kevin Crow,REP,140076,0,0,1,1,
Cleveland,U.S. Senate,James Lankford,REP,140076,1,8,93,102,
Cleveland,U.S. Senate,Jason Weger,REP,140076,0,0,2,2,
Cleveland,U.S. House,Anna Flatt,REP,140076,0,3,33,36,04
Cleveland,U.S. House,Tom Cole,REP,140076,3,12,115,130,04
Cleveland,Superintendent of Public Instruction,John Cox,DEM,140077,0,0,6,6,
Cleveland,Superintendent of Public Instruction,Jack Jr.,DEM,140077,0,0,6,6,
Cleveland,Superintendent of Public Instruction,Ivan Holmes,DEM,140077,0,0,3,3,
Cleveland,Superintendent of Public Instruction,Freda Deskin,DEM,140077,1,0,20,21,
Cleveland,U.S. Senate,Patrick Michael Hayes,DEM,140077,0,0,6,6,
Cleveland,U.S. Senate,Jim Rogers,DEM,140077,0,0,10,10,
Cleveland,U.S. Senate,Connie Johnson,DEM,140077,1,0,19,20,
Cleveland,U.S. House,Bert Smith,DEM,140077,1,0,21,22,04
Cleveland,U.S. House,Tae Si,DEM,140077,0,0,13,13,04
Cleveland,Governor,Dax Ewbank,REP,140077,0,0,5,5,
Cleveland,Governor,Chad Moody,REP,140077,0,0,6,6,
Cleveland,Governor,Mary Fallin,REP,140077,0,0,22,22,
Cleveland,Superintendent of Public Instruction,Brian Kelly,REP,140077,0,0,8,8,
Cleveland,Superintendent of Public Instruction,Janet Costello Barresi,REP,140077,0,0,9,9,
Cleveland,Superintendent of Public Instruction,Joy Hofmeister,REP,140077,0,0,15,15,
Cleveland,Insurance Commissioner,Bill Viner,REP,140077,0,0,6,6,
Cleveland,Insurance Commissioner,John Doak,REP,140077,0,0,23,23,
Cleveland,Corporation Commissioner,Todd Hiett,REP,140077,0,0,18,18,
Cleveland,Corporation Commissioner,Cliff Branan,REP,140077,0,0,13,13,
Cleveland,U.S. Senate,Evelyn Rogers,REP,140077,0,0,4,4,
Cleveland,U.S. Senate,Rob Moye,REP,140077,0,0,0,0,
Cleveland,U.S. Senate,D. Jean Mcbride-Samuels,REP,140077,0,0,1,1,
Cleveland,U.S. Senate,Jim Inhofe,REP,140077,0,0,26,26,
Cleveland,U.S. Senate,Erick Paul Wyatt,REP,140077,0,0,1,1,
Cleveland,U.S. Senate,Andy Craig,REP,140077,0,0,0,0,
Cleveland,U.S. Senate,T. Shannon,REP,140077,0,0,12,12,
Cleveland,U.S. Senate,Randy Brogdon,REP,140077,0,0,1,1,
Cleveland,U.S. Senate,Eric Mccray,REP,140077,0,0,0,0,
Cleveland,U.S. Senate,Kevin Crow,REP,140077,0,0,1,1,
Cleveland,U.S. Senate,James Lankford,REP,140077,0,0,19,19,
Cleveland,U.S. Senate,Jason Weger,REP,140077,0,0,0,0,
Cleveland,U.S. House,Anna Flatt,REP,140077,0,0,9,9,04
Cleveland,U.S. House,Tom Cole,REP,140077,0,0,24,24,04
Cleveland,Superintendent of Public Instruction,John Cox,DEM,140078,2,0,22,24,
Cleveland,Superintendent of Public Instruction,Jack Jr.,DEM,140078,1,0,6,7,
Cleveland,Superintendent of Public Instruction,Ivan Holmes,DEM,140078,2,0,4,6,
Cleveland,Superintendent of Public Instruction,Freda Deskin,DEM,140078,0,0,31,31,
Cleveland,U.S. Senate,Patrick Michael Hayes,DEM,140078,0,0,10,10,
Cleveland,U.S. Senate,Jim Rogers,DEM,140078,0,0,24,24,
Cleveland,U.S. Senate,Connie Johnson,DEM,140078,5,0,29,34,
Cleveland,U.S. House,Bert Smith,DEM,140078,3,0,49,52,04
Cleveland,U.S. House,Tae Si,DEM,140078,1,0,11,12,04
Cleveland,Governor,Dax Ewbank,REP,140078,0,1,27,28,
Cleveland,Governor,Chad Moody,REP,140078,2,1,28,31,
Cleveland,Governor,Mary Fallin,REP,140078,15,4,244,263,
Cleveland,Superintendent of Public Instruction,Brian Kelly,REP,140078,5,0,77,82,
Cleveland,Superintendent of Public Instruction,Janet Costello Barresi,REP,140078,1,2,71,74,
Cleveland,Superintendent of Public Instruction,Joy Hofmeister,REP,140078,11,4,147,162,
Cleveland,Insurance Commissioner,Bill Viner,REP,140078,3,1,70,74,
Cleveland,Insurance Commissioner,John Doak,REP,140078,13,5,211,229,
Cleveland,Corporation Commissioner,Todd Hiett,REP,140078,7,2,155,164,
Cleveland,Corporation Commissioner,Cliff Branan,REP,140078,9,4,121,134,
Cleveland,U.S. Senate,Evelyn Rogers,REP,140078,1,0,11,12,
Cleveland,U.S. Senate,Rob Moye,REP,140078,0,0,4,4,
Cleveland,U.S. Senate,D. Jean Mcbride-Samuels,REP,140078,0,0,4,4,
Cleveland,U.S. Senate,Jim Inhofe,REP,140078,14,6,268,288,
Cleveland,U.S. Senate,Erick Paul Wyatt,REP,140078,2,0,14,16,
Cleveland,U.S. Senate,Andy Craig,REP,140078,1,0,3,4,
Cleveland,U.S. Senate,T. Shannon,REP,140078,3,4,83,90,
Cleveland,U.S. Senate,Randy Brogdon,REP,140078,0,1,12,13,
Cleveland,U.S. Senate,Eric Mccray,REP,140078,0,0,0,0,
Cleveland,U.S. Senate,Kevin Crow,REP,140078,1,0,1,2,
Cleveland,U.S. Senate,James Lankford,REP,140078,12,1,202,215,
Cleveland,U.S. Senate,Jason Weger,REP,140078,0,0,0,0,
Cleveland,U.S. House,Anna Flatt,REP,140078,3,0,61,64,04
Cleveland,U.S. House,Tom Cole,REP,140078,14,6,239,259,04
Cleveland,State House,Lani Habrock,REP,140078,6,3,90,99,27
Cleveland,State House,Josh Cockroft,REP,140078,10,3,207,220,27
Cleveland,Superintendent of Public Instruction,John Cox,DEM,140080,0,0,8,8,
Cleveland,Superintendent of Public Instruction,Jack Jr.,DEM,140080,1,0,1,2,
Cleveland,Superintendent of Public Instruction,Ivan Holmes,DEM,140080,0,0,1,1,
Cleveland,Superintendent of Public Instruction,Freda Deskin,DEM,140080,0,0,9,9,
Cleveland,U.S. Senate,Patrick Michael Hayes,DEM,140080,1,0,2,3,
Cleveland,U.S. Senate,Jim Rogers,DEM,140080,0,0,4,4,
Cleveland,U.S. Senate,Connie Johnson,DEM,140080,0,0,12,12,
Cleveland,U.S. House,Bert Smith,DEM,140080,1,0,14,15,04
Cleveland,U.S. House,Tae Si,DEM,140080,0,0,4,4,04
Cleveland,Governor,Dax Ewbank,REP,140080,1,0,9,10,
Cleveland,Governor,Chad Moody,REP,140080,1,0,18,19,
Cleveland,Governor,Mary Fallin,REP,140080,2,4,52,58,
Cleveland,Superintendent of Public Instruction,Brian Kelly,REP,140080,3,1,24,28,
Cleveland,Superintendent of Public Instruction,Janet Costello Barresi,REP,140080,1,2,12,15,
Cleveland,Superintendent of Public Instruction,Joy Hofmeister,REP,140080,0,1,45,46,
Cleveland,Insurance Commissioner,Bill Viner,REP,140080,1,2,19,22,
Cleveland,Insurance Commissioner,John Doak,REP,140080,3,2,62,67,
Cleveland,Corporation Commissioner,Todd Hiett,REP,140080,1,1,37,39,
Cleveland,Corporation Commissioner,Cliff Branan,REP,140080,3,3,42,48,
Cleveland,U.S. Senate,Evelyn Rogers,REP,140080,0,0,2,2,
Cleveland,U.S. Senate,Rob Moye,REP,140080,0,0,2,2,
Cleveland,U.S. Senate,D. Jean Mcbride-Samuels,REP,140080,0,0,2,2,
Cleveland,U.S. Senate,Jim Inhofe,REP,140080,3,4,70,77,
Cleveland,U.S. Senate,Erick Paul Wyatt,REP,140080,1,0,6,7,
Cleveland,U.S. Senate,Andy Craig,REP,140080,0,0,2,2,
Cleveland,U.S. Senate,T. Shannon,REP,140080,1,2,19,22,
Cleveland,U.S. Senate,Randy Brogdon,REP,140080,0,0,1,1,
Cleveland,U.S. Senate,Eric Mccray,REP,140080,0,0,1,1,
Cleveland,U.S. Senate,Kevin Crow,REP,140080,0,0,1,1,
Cleveland,U.S. Senate,James Lankford,REP,140080,3,2,57,62,
Cleveland,U.S. Senate,Jason Weger,REP,140080,0,0,0,0,
Cleveland,U.S. House,Anna Flatt,REP,140080,2,0,20,22,04
Cleveland,U.S. House,Tom Cole,REP,140080,2,4,62,68,04
Cleveland,State House,Paul Wesselhoft,REP,140080,4,4,60,68,54
Cleveland,State House,Adam Graham,REP,140080,0,0,21,21,54
Cleveland,Superintendent of Public Instruction,John Cox,DEM,140081,1,1,46,48,
Cleveland,Superintendent of Public Instruction,Jack Jr.,DEM,140081,4,0,19,23,
Cleveland,Superintendent of Public Instruction,Ivan Holmes,DEM,140081,1,0,8,9,
Cleveland,Superintendent of Public Instruction,Freda Deskin,DEM,140081,5,6,86,97,
Cleveland,U.S. Senate,Patrick Michael Hayes,DEM,140081,1,2,22,25,
Cleveland,U.S. Senate,Jim Rogers,DEM,140081,4,1,42,47,
Cleveland,U.S. Senate,Connie Johnson,DEM,140081,8,3,89,100,
Cleveland,U.S. House,Bert Smith,DEM,140081,8,5,99,112,04
Cleveland,U.S. House,Tae Si,DEM,140081,5,1,46,52,04
Cleveland,Governor,Dax Ewbank,REP,140081,3,1,29,33,
Cleveland,Governor,Chad Moody,REP,140081,5,2,44,51,
Cleveland,Governor,Mary Fallin,REP,140081,8,6,142,156,
Cleveland,Superintendent of Public Instruction,Brian Kelly,REP,140081,7,1,52,60,
Cleveland,Superintendent of Public Instruction,Janet Costello Barresi,REP,140081,6,2,55,63,
Cleveland,Superintendent of Public Instruction,Joy Hofmeister,REP,140081,3,6,105,114,
Cleveland,Insurance Commissioner,Bill Viner,REP,140081,8,4,40,52,
Cleveland,Insurance Commissioner,John Doak,REP,140081,4,5,157,166,
Cleveland,Corporation Commissioner,Todd Hiett,REP,140081,6,6,109,121,
Cleveland,Corporation Commissioner,Cliff Branan,REP,140081,8,3,90,101,
Cleveland,U.S. Senate,Evelyn Rogers,REP,140081,4,0,13,17,
Cleveland,U.S. Senate,Rob Moye,REP,140081,1,0,10,11,
Cleveland,U.S. Senate,D. Jean Mcbride-Samuels,REP,140081,0,0,3,3,
Cleveland,U.S. Senate,Jim Inhofe,REP,140081,10,8,178,196,
Cleveland,U.S. Senate,Erick Paul Wyatt,REP,140081,0,1,9,10,
Cleveland,U.S. Senate,Andy Craig,REP,140081,1,0,3,4,
Cleveland,U.S. Senate,T. Shannon,REP,140081,7,4,80,91,
Cleveland,U.S. Senate,Randy Brogdon,REP,140081,2,1,8,11,
Cleveland,U.S. Senate,Eric Mccray,REP,140081,0,1,2,3,
Cleveland,U.S. Senate,Kevin Crow,REP,140081,0,0,5,5,
Cleveland,U.S. Senate,James Lankford,REP,140081,4,3,115,122,
Cleveland,U.S. Senate,Jason Weger,REP,140081,1,0,2,3,
Cleveland,U.S. House,Anna Flatt,REP,140081,5,3,34,42,04
Cleveland,U.S. House,Tom Cole,REP,140081,10,6,179,195,04
Cleveland,Superintendent of Public Instruction,John Cox,DEM,140082,0,4,32,36,
Cleveland,Superintendent of Public Instruction,Jack Jr.,DEM,140082,1,3,26,30,
Cleveland,Superintendent of Public Instruction,Ivan Holmes,DEM,140082,0,1,7,8,
Cleveland,Superintendent of Public Instruction,Freda Deskin,DEM,140082,3,3,63,69,
Cleveland,U.S. Senate,Patrick Michael Hayes,DEM,140082,0,2,22,24,
Cleveland,U.S. Senate,Jim Rogers,DEM,140082,1,1,26,28,
Cleveland,U.S. Senate,Connie Johnson,DEM,140082,3,8,76,87,
Cleveland,U.S. House,Bert Smith,DEM,140082,2,8,76,86,04
Cleveland,U.S. House,Tae Si,DEM,140082,2,3,35,40,04
Cleveland,Governor,Dax Ewbank,REP,140082,0,3,23,26,
Cleveland,Governor,Chad Moody,REP,140082,2,5,64,71,
Cleveland,Governor,Mary Fallin,REP,140082,8,13,201,222,
Cleveland,Superintendent of Public Instruction,Brian Kelly,REP,140082,1,4,63,68,
Cleveland,Superintendent of Public Instruction,Janet Costello Barresi,REP,140082,5,3,84,92,
Cleveland,Superintendent of Public Instruction,Joy Hofmeister,REP,140082,4,14,138,156,
Cleveland,Insurance Commissioner,Bill Viner,REP,140082,2,3,57,62,
Cleveland,Insurance Commissioner,John Doak,REP,140082,8,16,197,221,
Cleveland,Corporation Commissioner,Todd Hiett,REP,140082,6,12,134,152,
Cleveland,Corporation Commissioner,Cliff Branan,REP,140082,4,8,122,134,
Cleveland,U.S. Senate,Evelyn Rogers,REP,140082,0,0,18,18,
Cleveland,U.S. Senate,Rob Moye,REP,140082,0,1,4,5,
Cleveland,U.S. Senate,D. Jean Mcbride-Samuels,REP,140082,0,0,7,7,
Cleveland,U.S. Senate,Jim Inhofe,REP,140082,9,18,245,272,
Cleveland,U.S. Senate,Erick Paul Wyatt,REP,140082,1,2,5,8,
Cleveland,U.S. Senate,Andy Craig,REP,140082,0,0,4,4,
Cleveland,U.S. Senate,T. Shannon,REP,140082,3,8,90,101,
Cleveland,U.S. Senate,Randy Brogdon,REP,140082,1,2,11,14,
Cleveland,U.S. Senate,Eric Mccray,REP,140082,1,1,2,4,
Cleveland,U.S. Senate,Kevin Crow,REP,140082,0,0,0,0,
Cleveland,U.S. Senate,James Lankford,REP,140082,5,10,175,190,
Cleveland,U.S. Senate,Jason Weger,REP,140082,0,0,2,2,
Cleveland,U.S. House,Anna Flatt,REP,140082,2,5,46,53,04
Cleveland,U.S. House,Tom Cole,REP,140082,8,16,233,257,04
Cleveland,Superintendent of Public Instruction,John Cox,DEM,140083,1,0,20,21,
Cleveland,Superintendent of Public Instruction,Jack Jr.,DEM,140083,0,0,3,3,
Cleveland,Superintendent of Public Instruction,Ivan Holmes,DEM,140083,0,0,3,3,
Cleveland,Superintendent of Public Instruction,Freda Deskin,DEM,140083,0,1,31,32,
Cleveland,U.S. Senate,Patrick Michael Hayes,DEM,140083,0,0,10,10,
Cleveland,U.S. Senate,Jim Rogers,DEM,140083,0,0,12,12,
Cleveland,U.S. Senate,Connie Johnson,DEM,140083,1,1,34,36,
Cleveland,U.S. House,Bert Smith,DEM,140083,0,1,40,41,04
Cleveland,U.S. House,Tae Si,DEM,140083,1,0,11,12,04
Cleveland,Governor,Dax Ewbank,REP,140083,0,1,9,10,
Cleveland,Governor,Chad Moody,REP,140083,0,0,14,14,
Cleveland,Governor,Mary Fallin,REP,140083,0,0,57,57,
Cleveland,Superintendent of Public Instruction,Brian Kelly,REP,140083,0,0,23,23,
Cleveland,Superintendent of Public Instruction,Janet Costello Barresi,REP,140083,0,0,11,11,
Cleveland,Superintendent of Public Instruction,Joy Hofmeister,REP,140083,0,1,45,46,
Cleveland,Insurance Commissioner,Bill Viner,REP,140083,0,1,18,19,
Cleveland,Insurance Commissioner,John Doak,REP,140083,0,0,53,53,
Cleveland,Corporation Commissioner,Todd Hiett,REP,140083,0,1,30,31,
Cleveland,Corporation Commissioner,Cliff Branan,REP,140083,0,0,42,42,
Cleveland,U.S. Senate,Evelyn Rogers,REP,140083,0,0,4,4,
Cleveland,U.S. Senate,Rob Moye,REP,140083,0,0,2,2,
Cleveland,U.S. Senate,D. Jean Mcbride-Samuels,REP,140083,0,0,4,4,
Cleveland,U.S. Senate,Jim Inhofe,REP,140083,0,1,64,65,
Cleveland,U.S. Senate,Erick Paul Wyatt,REP,140083,0,0,4,4,
Cleveland,U.S. Senate,Andy Craig,REP,140083,0,0,1,1,
Cleveland,U.S. Senate,T. Shannon,REP,140083,0,1,27,28,
Cleveland,U.S. Senate,Randy Brogdon,REP,140083,0,0,1,1,
Cleveland,U.S. Senate,Eric Mccray,REP,140083,0,0,1,1,
Cleveland,U.S. Senate,Kevin Crow,REP,140083,0,0,1,1,
Cleveland,U.S. Senate,James Lankford,REP,140083,0,0,48,48,
Cleveland,U.S. Senate,Jason Weger,REP,140083,0,0,0,0,
Cleveland,U.S. House,Anna Flatt,REP,140083,0,0,10,10,04
Cleveland,U.S. House,Tom Cole,REP,140083,0,1,69,70,04
Cleveland,Superintendent of Public Instruction,John Cox,DEM,140086,0,5,29,34,
Cleveland,Superintendent of Public Instruction,Jack Jr.,DEM,140086,0,2,17,19,
Cleveland,Superintendent of Public Instruction,Ivan Holmes,DEM,140086,0,0,4,4,
Cleveland,Superintendent of Public Instruction,Freda Deskin,DEM,140086,2,1,41,44,
Cleveland,U.S. Senate,Patrick Michael Hayes,DEM,140086,0,2,20,22,
Cleveland,U.S. Senate,Jim Rogers,DEM,140086,0,1,30,31,
Cleveland,U.S. Senate,Connie Johnson,DEM,140086,2,5,41,48,
Cleveland,U.S. House,Bert Smith,DEM,140086,2,7,75,84,04
Cleveland,U.S. House,Tae Si,DEM,140086,0,0,10,10,04
Cleveland,Governor,Dax Ewbank,REP,140086,1,0,30,31,
Cleveland,Governor,Chad Moody,REP,140086,1,3,66,70,
Cleveland,Governor,Mary Fallin,REP,140086,16,15,300,331,
Cleveland,Superintendent of Public Instruction,Brian Kelly,REP,140086,5,5,75,85,
Cleveland,Superintendent of Public Instruction,Janet Costello Barresi,REP,140086,9,2,85,96,
Cleveland,Superintendent of Public Instruction,Joy Hofmeister,REP,140086,4,11,234,249,
Cleveland,Insurance Commissioner,Bill Viner,REP,140086,2,9,83,94,
Cleveland,Insurance Commissioner,John Doak,REP,140086,14,9,287,310,
Cleveland,Corporation Commissioner,Todd Hiett,REP,140086,10,11,171,192,
Cleveland,Corporation Commissioner,Cliff Branan,REP,140086,6,7,196,209,
Cleveland,U.S. Senate,Evelyn Rogers,REP,140086,2,2,17,21,
Cleveland,U.S. Senate,Rob Moye,REP,140086,0,1,7,8,
Cleveland,U.S. Senate,D. Jean Mcbride-Samuels,REP,140086,0,0,9,9,
Cleveland,U.S. Senate,Jim Inhofe,REP,140086,16,15,346,377,
Cleveland,U.S. Senate,Erick Paul Wyatt,REP,140086,0,0,19,19,
Cleveland,U.S. Senate,Andy Craig,REP,140086,0,1,2,3,
Cleveland,U.S. Senate,T. Shannon,REP,140086,2,3,121,126,
Cleveland,U.S. Senate,Randy Brogdon,REP,140086,0,0,2,2,
Cleveland,U.S. Senate,Eric Mccray,REP,140086,1,0,4,5,
Cleveland,U.S. Senate,Kevin Crow,REP,140086,0,1,0,1,
Cleveland,U.S. Senate,James Lankford,REP,140086,15,13,274,302,
Cleveland,U.S. Senate,Jason Weger,REP,140086,0,0,1,1,
Cleveland,U.S. House,Anna Flatt,REP,140086,1,1,56,58,04
Cleveland,U.S. House,Tom Cole,REP,140086,17,17,344,378,04
Cleveland,State House,Chris Kannady,REP,140086,6,9,207,222,91
Cleveland,State House,Jon Painter,REP,140086,9,10,168,187,91
Cleveland,State House,Chad Olsen,REP,140086,3,0,14,17,91
Cleveland,State House,David Monlux,REP,140086,0,0,3,3,91
Cleveland,State House,Scott Esk,REP,140086,0,0,7,7,91
Cleveland,Superintendent of Public Instruction,John Cox,DEM,140087,0,0,4,4,
Cleveland,Superintendent of Public Instruction,Jack Jr.,DEM,140087,1,0,0,1,
Cleveland,Superintendent of Public Instruction,Ivan Holmes,DEM,140087,0,0,3,3,
Cleveland,Superintendent of Public Instruction,Freda Deskin,DEM,140087,1,0,10,11,
Cleveland,U.S. Senate,Patrick Michael Hayes,DEM,140087,0,0,2,2,
Cleveland,U.S. Senate,Jim Rogers,DEM,140087,2,0,4,6,
Cleveland,U.S. Senate,Connie Johnson,DEM,140087,0,0,11,11,
Cleveland,U.S. House,Bert Smith,DEM,140087,2,0,12,14,04
Cleveland,U.S. House,Tae Si,DEM,140087,0,0,5,5,04
Cleveland,Governor,Dax Ewbank,REP,140087,0,0,10,10,
Cleveland,Governor,Chad Moody,REP,140087,0,1,16,17,
Cleveland,Governor,Mary Fallin,REP,140087,6,2,121,129,
Cleveland,Superintendent of Public Instruction,Brian Kelly,REP,140087,2,2,34,38,
Cleveland,Superintendent of Public Instruction,Janet Costello Barresi,REP,140087,4,1,38,43,
Cleveland,Superintendent of Public Instruction,Joy Hofmeister,REP,140087,0,0,70,70,
Cleveland,Insurance Commissioner,Bill Viner,REP,140087,2,0,35,37,
Cleveland,Insurance Commissioner,John Doak,REP,140087,3,3,92,98,
Cleveland,Corporation Commissioner,Todd Hiett,REP,140087,4,0,62,66,
Cleveland,Corporation Commissioner,Cliff Branan,REP,140087,0,3,70,73,
Cleveland,U.S. Senate,Evelyn Rogers,REP,140087,0,0,7,7,
Cleveland,U.S. Senate,Rob Moye,REP,140087,0,0,1,1,
Cleveland,U.S. Senate,D. Jean Mcbride-Samuels,REP,140087,0,0,2,2,
Cleveland,U.S. Senate,Jim Inhofe,REP,140087,5,3,133,141,
Cleveland,U.S. Senate,Erick Paul Wyatt,REP,140087,0,0,6,6,
Cleveland,U.S. Senate,Andy Craig,REP,140087,1,0,0,1,
Cleveland,U.S. Senate,T. Shannon,REP,140087,0,2,33,35,
Cleveland,U.S. Senate,Randy Brogdon,REP,140087,0,0,2,2,
Cleveland,U.S. Senate,Eric Mccray,REP,140087,0,0,0,0,
Cleveland,U.S. Senate,Kevin Crow,REP,140087,0,0,3,3,
Cleveland,U.S. Senate,James Lankford,REP,140087,5,1,110,116,
Cleveland,U.S. Senate,Jason Weger,REP,140087,0,0,2,2,
Cleveland,U.S. House,Anna Flatt,REP,140087,0,1,31,32,04
Cleveland,U.S. House,Tom Cole,REP,140087,6,2,117,125,04
Cleveland,State House,Lani Habrock,REP,140087,2,2,40,44,27
Cleveland,State House,Josh Cockroft,REP,140087,1,1,102,104,27
Cleveland,Superintendent of Public Instruction,John Cox,DEM,140088,1,3,31,35,
Cleveland,Superintendent of Public Instruction,Jack Jr.,DEM,140088,1,0,16,17,
Cleveland,Superintendent of Public Instruction,Ivan Holmes,DEM,140088,2,0,4,6,
Cleveland,Superintendent of Public Instruction,Freda Deskin,DEM,140088,1,1,50,52,
Cleveland,U.S. Senate,Patrick Michael Hayes,DEM,140088,2,1,18,21,
Cleveland,U.S. Senate,Jim Rogers,DEM,140088,2,0,30,32,
Cleveland,U.S. Senate,Connie Johnson,DEM,140088,1,2,49,52,
Cleveland,U.S. House,Bert Smith,DEM,140088,2,4,72,78,04
Cleveland,U.S. House,Tae Si,DEM,140088,3,0,21,24,04
Cleveland,Governor,Dax Ewbank,REP,140088,1,1,27,29,
Cleveland,Governor,Chad Moody,REP,140088,3,7,71,81,
Cleveland,Governor,Mary Fallin,REP,140088,8,16,384,408,
Cleveland,Superintendent of Public Instruction,Brian Kelly,REP,140088,2,4,86,92,
Cleveland,Superintendent of Public Instruction,Janet Costello Barresi,REP,140088,2,5,92,99,
Cleveland,Superintendent of Public Instruction,Joy Hofmeister,REP,140088,6,17,300,323,
Cleveland,Insurance Commissioner,Bill Viner,REP,140088,4,4,95,103,
Cleveland,Insurance Commissioner,John Doak,REP,140088,5,21,344,370,
Cleveland,Corporation Commissioner,Todd Hiett,REP,140088,5,14,190,209,
Cleveland,Corporation Commissioner,Cliff Branan,REP,140088,4,12,252,268,
Cleveland,U.S. Senate,Evelyn Rogers,REP,140088,2,1,20,23,
Cleveland,U.S. Senate,Rob Moye,REP,140088,0,0,8,8,
Cleveland,U.S. Senate,D. Jean Mcbride-Samuels,REP,140088,0,1,6,7,
Cleveland,U.S. Senate,Jim Inhofe,REP,140088,10,24,431,465,
Cleveland,U.S. Senate,Erick Paul Wyatt,REP,140088,0,0,16,16,
Cleveland,U.S. Senate,Andy Craig,REP,140088,0,1,4,5,
Cleveland,U.S. Senate,T. Shannon,REP,140088,2,5,118,125,
Cleveland,U.S. Senate,Randy Brogdon,REP,140088,0,1,6,7,
Cleveland,U.S. Senate,Eric Mccray,REP,140088,0,0,3,3,
Cleveland,U.S. Senate,Kevin Crow,REP,140088,0,0,8,8,
Cleveland,U.S. Senate,James Lankford,REP,140088,10,19,349,378,
Cleveland,U.S. Senate,Jason Weger,REP,140088,0,0,0,0,
Cleveland,U.S. House,Anna Flatt,REP,140088,0,3,72,75,04
Cleveland,U.S. House,Tom Cole,REP,140088,11,23,410,444,04
Cleveland,State House,Chris Kannady,REP,140088,4,14,238,256,91
Cleveland,State House,Jon Painter,REP,140088,5,11,199,215,91
Cleveland,State House,Chad Olsen,REP,140088,3,0,22,25,91
Cleveland,State House,David Monlux,REP,140088,0,1,1,2,91
Cleveland,State House,Scott Esk,REP,140088,0,0,20,20,91
Cleveland,Superintendent of Public Instruction,John Cox,DEM,140089,0,2,28,30,
Cleveland,Superintendent of Public Instruction,Jack Jr.,DEM,140089,1,1,11,13,
Cleveland,Superintendent of Public Instruction,Ivan Holmes,DEM,140089,0,0,5,5,
Cleveland,Superintendent of Public Instruction,Freda Deskin,DEM,140089,3,0,33,36,
Cleveland,U.S. Senate,Patrick Michael Hayes,DEM,140089,1,1,12,14,
Cleveland,U.S. Senate,Jim Rogers,DEM,140089,1,1,15,17,
Cleveland,U.S. Senate,Connie Johnson,DEM,140089,2,1,49,52,
Cleveland,U.S. House,Bert Smith,DEM,140089,4,1,58,63,04
Cleveland,U.S. House,Tae Si,DEM,140089,0,2,13,15,04
Cleveland,Governor,Dax Ewbank,REP,140089,0,2,28,30,
Cleveland,Governor,Chad Moody,REP,140089,6,3,56,65,
Cleveland,Governor,Mary Fallin,REP,140089,10,11,279,300,
Cleveland,Superintendent of Public Instruction,Brian Kelly,REP,140089,7,2,84,93,
Cleveland,Superintendent of Public Instruction,Janet Costello Barresi,REP,140089,2,2,72,76,
Cleveland,Superintendent of Public Instruction,Joy Hofmeister,REP,140089,7,12,200,219,
Cleveland,Insurance Commissioner,Bill Viner,REP,140089,1,3,68,72,
Cleveland,Insurance Commissioner,John Doak,REP,140089,14,13,266,293,
Cleveland,Corporation Commissioner,Todd Hiett,REP,140089,11,11,154,176,
Cleveland,Corporation Commissioner,Cliff Branan,REP,140089,3,5,185,193,
Cleveland,U.S. Senate,Evelyn Rogers,REP,140089,0,0,17,17,
Cleveland,U.S. Senate,Rob Moye,REP,140089,0,0,9,9,
Cleveland,U.S. Senate,D. Jean Mcbride-Samuels,REP,140089,0,1,9,10,
Cleveland,U.S. Senate,Jim Inhofe,REP,140089,14,13,317,344,
Cleveland,U.S. Senate,Erick Paul Wyatt,REP,140089,2,2,12,16,
Cleveland,U.S. Senate,Andy Craig,REP,140089,0,0,3,3,
Cleveland,U.S. Senate,T. Shannon,REP,140089,2,1,132,135,
Cleveland,U.S. Senate,Randy Brogdon,REP,140089,0,1,8,9,
Cleveland,U.S. Senate,Eric Mccray,REP,140089,0,0,2,2,
Cleveland,U.S. Senate,Kevin Crow,REP,140089,0,0,0,0,
Cleveland,U.S. Senate,James Lankford,REP,140089,13,14,223,250,
Cleveland,U.S. Senate,Jason Weger,REP,140089,1,0,0,1,
Cleveland,U.S. House,Anna Flatt,REP,140089,4,2,53,59,04
Cleveland,U.S. House,Tom Cole,REP,140089,12,14,314,340,04
Cleveland,State House,Danni Legg,REP,140089,2,1,53,56,53
Cleveland,State House,Mark Mcbride,REP,140089,14,15,306,335,53
Cleveland,Superintendent of Public Instruction,John Cox,DEM,140090,0,0,0,0,
Cleveland,Superintendent of Public Instruction,Jack Jr.,DEM,140090,0,0,1,1,
Cleveland,Superintendent of Public Instruction,Ivan Holmes,DEM,140090,0,0,0,0,
Cleveland,Superintendent of Public Instruction,Freda Deskin,DEM,140090,0,0,0,0,
Cleveland,U.S. Senate,Patrick Michael Hayes,DEM,140090,0,0,0,0,
Cleveland,U.S. Senate,Jim Rogers,DEM,140090,0,0,1,1,
Cleveland,U.S. Senate,Connie Johnson,DEM,140090,0,0,0,0,
Cleveland,U.S. House,Bert Smith,DEM,140090,0,0,1,1,04
Cleveland,U.S. House,Tae Si,DEM,140090,0,0,0,0,04
Cleveland,Governor,Dax Ewbank,REP,140090,0,0,0,0,
Cleveland,Governor,Chad Moody,REP,140090,0,0,0,0,
Cleveland,Governor,Mary Fallin,REP,140090,0,0,0,0,
Cleveland,Superintendent of Public Instruction,Brian Kelly,REP,140090,0,0,0,0,
Cleveland,Superintendent of Public Instruction,Janet Costello Barresi,REP,140090,0,0,0,0,
Cleveland,Superintendent of Public Instruction,Joy Hofmeister,REP,140090,0,0,0,0,
Cleveland,Insurance Commissioner,Bill Viner,REP,140090,0,0,0,0,
Cleveland,Insurance Commissioner,John Doak,REP,140090,0,0,0,0,
Cleveland,Corporation Commissioner,Todd Hiett,REP,140090,0,0,0,0,
Cleveland,Corporation Commissioner,Cliff Branan,REP,140090,0,0,0,0,
Cleveland,U.S. Senate,Evelyn Rogers,REP,140090,0,0,0,0,
Cleveland,U.S. Senate,Rob Moye,REP,140090,0,0,0,0,
Cleveland,U.S. Senate,D. Jean Mcbride-Samuels,REP,140090,0,0,0,0,
Cleveland,U.S. Senate,Jim Inhofe,REP,140090,0,0,0,0,
Cleveland,U.S. Senate,Erick Paul Wyatt,REP,140090,0,0,0,0,
Cleveland,U.S. Senate,Andy Craig,REP,140090,0,0,0,0,
Cleveland,U.S. Senate,T. Shannon,REP,140090,0,0,0,0,
Cleveland,U.S. Senate,Randy Brogdon,REP,140090,0,0,0,0,
Cleveland,U.S. Senate,Eric Mccray,REP,140090,0,0,0,0,
Cleveland,U.S. Senate,Kevin Crow,REP,140090,0,0,0,0,
Cleveland,U.S. Senate,James Lankford,REP,140090,0,0,0,0,
Cleveland,U.S. Senate,Jason Weger,REP,140090,0,0,0,0,
Cleveland,U.S. House,Anna Flatt,REP,140090,0,0,0,0,04
Cleveland,U.S. House,Tom Cole,REP,140090,0,0,0,0,04
Cleveland,State House,Paul Wesselhoft,REP,140090,0,0,0,0,54
Cleveland,State House,Adam Graham,REP,140090,0,0,0,0,54
Cleveland,Superintendent of Public Instruction,John Cox,DEM,140091,0,0,2,2,
Cleveland,Superintendent of Public Instruction,Jack Jr.,DEM,140091,0,0,2,2,
Cleveland,Superintendent of Public Instruction,Ivan Holmes,DEM,140091,0,0,1,1,
Cleveland,Superintendent of Public Instruction,Freda Deskin,DEM,140091,1,0,7,8,
Cleveland,U.S. Senate,Patrick Michael Hayes,DEM,140091,0,0,1,1,
Cleveland,U.S. Senate,Jim Rogers,DEM,140091,0,0,3,3,
Cleveland,U.S. Senate,Connie Johnson,DEM,140091,1,0,7,8,
Cleveland,U.S. House,Bert Smith,DEM,140091,0,0,8,8,04
Cleveland,U.S. House,Tae Si,DEM,140091,0,0,2,2,04
Cleveland,Governor,Dax Ewbank,REP,140091,0,2,2,4,
Cleveland,Governor,Chad Moody,REP,140091,0,1,7,8,
Cleveland,Governor,Mary Fallin,REP,140091,0,0,29,29,
Cleveland,Superintendent of Public Instruction,Brian Kelly,REP,140091,0,0,8,8,
Cleveland,Superintendent of Public Instruction,Janet Costello Barresi,REP,140091,0,0,11,11,
Cleveland,Superintendent of Public Instruction,Joy Hofmeister,REP,140091,0,3,19,22,
Cleveland,Insurance Commissioner,Bill Viner,REP,140091,0,2,4,6,
Cleveland,Insurance Commissioner,John Doak,REP,140091,0,1,32,33,
Cleveland,Corporation Commissioner,Todd Hiett,REP,140091,0,1,17,18,
Cleveland,Corporation Commissioner,Cliff Branan,REP,140091,0,2,19,21,
Cleveland,U.S. Senate,Evelyn Rogers,REP,140091,0,0,2,2,
Cleveland,U.S. Senate,Rob Moye,REP,140091,0,0,0,0,
Cleveland,U.S. Senate,D. Jean Mcbride-Samuels,REP,140091,0,0,0,0,
Cleveland,U.S. Senate,Jim Inhofe,REP,140091,0,3,35,38,
Cleveland,U.S. Senate,Erick Paul Wyatt,REP,140091,0,0,2,2,
Cleveland,U.S. Senate,Andy Craig,REP,140091,0,0,0,0,
Cleveland,U.S. Senate,T. Shannon,REP,140091,0,0,9,9,
Cleveland,U.S. Senate,Randy Brogdon,REP,140091,0,0,2,2,
Cleveland,U.S. Senate,Eric Mccray,REP,140091,0,0,0,0,
Cleveland,U.S. Senate,Kevin Crow,REP,140091,0,1,0,1,
Cleveland,U.S. Senate,James Lankford,REP,140091,0,2,27,29,
Cleveland,U.S. Senate,Jason Weger,REP,140091,0,0,1,1,
Cleveland,U.S. House,Anna Flatt,REP,140091,0,1,3,4,04
Cleveland,U.S. House,Tom Cole,REP,140091,0,2,35,37,04
Cleveland,Superintendent of Public Instruction,John Cox,DEM,140092,0,0,0,0,
Cleveland,Superintendent of Public Instruction,Jack Jr.,DEM,140092,0,0,1,1,
Cleveland,Superintendent of Public Instruction,Ivan Holmes,DEM,140092,0,0,0,0,
Cleveland,Superintendent of Public Instruction,Freda Deskin,DEM,140092,0,0,0,0,
Cleveland,U.S. Senate,Patrick Michael Hayes,DEM,140092,0,0,0,0,
Cleveland,U.S. Senate,Jim Rogers,DEM,140092,0,0,1,1,
Cleveland,U.S. Senate,Connie Johnson,DEM,140092,0,0,0,0,
Cleveland,U.S. House,Bert Smith,DEM,140092,0,0,1,1,04
Cleveland,U.S. House,Tae Si,DEM,140092,0,0,0,0,04
Cleveland,Governor,Dax Ewbank,REP,140092,0,0,0,0,
Cleveland,Governor,Chad Moody,REP,140092,0,0,0,0,
Cleveland,Governor,Mary Fallin,REP,140092,0,0,0,0,
Cleveland,Superintendent of Public Instruction,Brian Kelly,REP,140092,0,0,0,0,
Cleveland,Superintendent of Public Instruction,Janet Costello Barresi,REP,140092,0,0,0,0,
Cleveland,Superintendent of Public Instruction,Joy Hofmeister,REP,140092,0,0,0,0,
Cleveland,Insurance Commissioner,Bill Viner,REP,140092,0,0,0,0,
Cleveland,Insurance Commissioner,John Doak,REP,140092,0,0,0,0,
Cleveland,Corporation Commissioner,Todd Hiett,REP,140092,0,0,0,0,
Cleveland,Corporation Commissioner,Cliff Branan,REP,140092,0,0,0,0,
Cleveland,U.S. Senate,Evelyn Rogers,REP,140092,0,0,0,0,
Cleveland,U.S. Senate,Rob Moye,REP,140092,0,0,0,0,
Cleveland,U.S. Senate,D. Jean Mcbride-Samuels,REP,140092,0,0,0,0,
Cleveland,U.S. Senate,Jim Inhofe,REP,140092,0,0,0,0,
Cleveland,U.S. Senate,Erick Paul Wyatt,REP,140092,0,0,0,0,
Cleveland,U.S. Senate,Andy Craig,REP,140092,0,0,0,0,
Cleveland,U.S. Senate,T. Shannon,REP,140092,0,0,0,0,
Cleveland,U.S. Senate,Randy Brogdon,REP,140092,0,0,0,0,
Cleveland,U.S. Senate,Eric Mccray,REP,140092,0,0,0,0,
Cleveland,U.S. Senate,Kevin Crow,REP,140092,0,0,0,0,
Cleveland,U.S. Senate,James Lankford,REP,140092,0,0,0,0,
Cleveland,U.S. Senate,Jason Weger,REP,140092,0,0,0,0,
Cleveland,U.S. House,Anna Flatt,REP,140092,0,0,0,0,04
Cleveland,U.S. House,Tom Cole,REP,140092,0,0,0,0,04
Cleveland,Superintendent of Public Instruction,John Cox,DEM,140093,0,0,14,14,
Cleveland,Superintendent of Public Instruction,Jack Jr.,DEM,140093,0,0,12,12,
Cleveland,Superintendent of Public Instruction,Ivan Holmes,DEM,140093,0,0,4,4,
Cleveland,Superintendent of Public Instruction,Freda Deskin,DEM,140093,5,3,38,46,
Cleveland,U.S. Senate,Patrick Michael Hayes,DEM,140093,0,0,12,12,
Cleveland,U.S. Senate,Jim Rogers,DEM,140093,2,0,16,18,
Cleveland,U.S. Senate,Connie Johnson,DEM,140093,3,2,38,43,
Cleveland,U.S. House,Bert Smith,DEM,140093,5,1,37,43,04
Cleveland,U.S. House,Tae Si,DEM,140093,0,1,16,17,04
Cleveland,Governor,Dax Ewbank,REP,140093,0,0,7,7,
Cleveland,Governor,Chad Moody,REP,140093,1,0,14,15,
Cleveland,Governor,Mary Fallin,REP,140093,3,3,52,58,
Cleveland,Superintendent of Public Instruction,Brian Kelly,REP,140093,1,0,12,13,
Cleveland,Superintendent of Public Instruction,Janet Costello Barresi,REP,140093,3,0,19,22,
Cleveland,Superintendent of Public Instruction,Joy Hofmeister,REP,140093,0,3,43,46,
Cleveland,Insurance Commissioner,Bill Viner,REP,140093,1,0,14,15,
Cleveland,Insurance Commissioner,John Doak,REP,140093,3,2,53,58,
Cleveland,Corporation Commissioner,Todd Hiett,REP,140093,2,2,32,36,
Cleveland,Corporation Commissioner,Cliff Branan,REP,140093,2,0,37,39,
Cleveland,U.S. Senate,Evelyn Rogers,REP,140093,0,0,3,3,
Cleveland,U.S. Senate,Rob Moye,REP,140093,0,0,3,3,
Cleveland,U.S. Senate,D. Jean Mcbride-Samuels,REP,140093,0,0,1,1,
Cleveland,U.S. Senate,Jim Inhofe,REP,140093,4,3,64,71,
Cleveland,U.S. Senate,Erick Paul Wyatt,REP,140093,0,0,2,2,
Cleveland,U.S. Senate,Andy Craig,REP,140093,0,0,2,2,
Cleveland,U.S. Senate,T. Shannon,REP,140093,2,1,19,22,
Cleveland,U.S. Senate,Randy Brogdon,REP,140093,0,0,2,2,
Cleveland,U.S. Senate,Eric Mccray,REP,140093,0,0,0,0,
Cleveland,U.S. Senate,Kevin Crow,REP,140093,0,0,0,0,
Cleveland,U.S. Senate,James Lankford,REP,140093,2,2,49,53,
Cleveland,U.S. Senate,Jason Weger,REP,140093,0,0,3,3,
Cleveland,U.S. House,Anna Flatt,REP,140093,0,1,9,10,04
Cleveland,U.S. House,Tom Cole,REP,140093,4,2,66,72,04
Cleveland,Superintendent of Public Instruction,John Cox,DEM,140094,0,0,6,6,
Cleveland,Superintendent of Public Instruction,Jack Jr.,DEM,140094,0,0,3,3,
Cleveland,Superintendent of Public Instruction,Ivan Holmes,DEM,140094,1,0,1,2,
Cleveland,Superintendent of Public Instruction,Freda Deskin,DEM,140094,0,0,21,21,
Cleveland,U.S. Senate,Patrick Michael Hayes,DEM,140094,0,0,5,5,
Cleveland,U.S. Senate,Jim Rogers,DEM,140094,0,0,5,5,
Cleveland,U.S. Senate,Connie Johnson,DEM,140094,1,0,20,21,
Cleveland,U.S. House,Bert Smith,DEM,140094,1,0,23,24,04
Cleveland,U.S. House,Tae Si,DEM,140094,0,0,5,5,04
Cleveland,Governor,Dax Ewbank,REP,140094,0,0,9,9,
Cleveland,Governor,Chad Moody,REP,140094,1,3,12,16,
Cleveland,Governor,Mary Fallin,REP,140094,3,4,26,33,
Cleveland,Superintendent of Public Instruction,Brian Kelly,REP,140094,0,1,12,13,
Cleveland,Superintendent of Public Instruction,Janet Costello Barresi,REP,140094,1,2,12,15,
Cleveland,Superintendent of Public Instruction,Joy Hofmeister,REP,140094,3,4,22,29,
Cleveland,Insurance Commissioner,Bill Viner,REP,140094,0,2,12,14,
Cleveland,Insurance Commissioner,John Doak,REP,140094,4,4,32,40,
Cleveland,Corporation Commissioner,Todd Hiett,REP,140094,1,1,19,21,
Cleveland,Corporation Commissioner,Cliff Branan,REP,140094,3,6,25,34,
Cleveland,U.S. Senate,Evelyn Rogers,REP,140094,1,2,5,8,
Cleveland,U.S. Senate,Rob Moye,REP,140094,0,0,0,0,
Cleveland,U.S. Senate,D. Jean Mcbride-Samuels,REP,140094,0,0,1,1,
Cleveland,U.S. Senate,Jim Inhofe,REP,140094,3,5,35,43,
Cleveland,U.S. Senate,Erick Paul Wyatt,REP,140094,0,0,2,2,
Cleveland,U.S. Senate,Andy Craig,REP,140094,0,0,0,0,
Cleveland,U.S. Senate,T. Shannon,REP,140094,1,6,14,21,
Cleveland,U.S. Senate,Randy Brogdon,REP,140094,0,0,4,4,
Cleveland,U.S. Senate,Eric Mccray,REP,140094,0,0,0,0,
Cleveland,U.S. Senate,Kevin Crow,REP,140094,0,0,1,1,
Cleveland,U.S. Senate,James Lankford,REP,140094,2,1,27,30,
Cleveland,U.S. Senate,Jason Weger,REP,140094,0,0,1,1,
Cleveland,U.S. House,Anna Flatt,REP,140094,0,2,18,20,04
Cleveland,U.S. House,Tom Cole,REP,140094,4,5,27,36,04
Cleveland,Superintendent of Public Instruction,John Cox,DEM,140095,0,0,12,12,
Cleveland,Superintendent of Public Instruction,Jack Jr.,DEM,140095,1,0,5,6,
Cleveland,Superintendent of Public Instruction,Ivan Holmes,DEM,140095,0,0,4,4,
Cleveland,Superintendent of Public Instruction,Freda Deskin,DEM,140095,0,0,18,18,
Cleveland,U.S. Senate,Patrick Michael Hayes,DEM,140095,0,0,11,11,
Cleveland,U.S. Senate,Jim Rogers,DEM,140095,0,0,8,8,
Cleveland,U.S. Senate,Connie Johnson,DEM,140095,1,0,21,22,
Cleveland,U.S. House,Bert Smith,DEM,140095,1,0,25,26,04
Cleveland,U.S. House,Tae Si,DEM,140095,0,0,14,14,04
Cleveland,Governor,Dax Ewbank,REP,140095,0,0,3,3,
Cleveland,Governor,Chad Moody,REP,140095,1,0,11,12,
Cleveland,Governor,Mary Fallin,REP,140095,4,0,60,64,
Cleveland,Superintendent of Public Instruction,Brian Kelly,REP,140095,2,0,16,18,
Cleveland,Superintendent of Public Instruction,Janet Costello Barresi,REP,140095,1,0,17,18,
Cleveland,Superintendent of Public Instruction,Joy Hofmeister,REP,140095,2,0,39,41,
Cleveland,Insurance Commissioner,Bill Viner,REP,140095,2,0,13,15,
Cleveland,Insurance Commissioner,John Doak,REP,140095,3,0,56,59,
Cleveland,Corporation Commissioner,Todd Hiett,REP,140095,1,0,27,28,
Cleveland,Corporation Commissioner,Cliff Branan,REP,140095,4,0,43,47,
Cleveland,U.S. Senate,Evelyn Rogers,REP,140095,1,0,4,5,
Cleveland,U.S. Senate,Rob Moye,REP,140095,0,0,1,1,
Cleveland,U.S. Senate,D. Jean Mcbride-Samuels,REP,140095,0,0,2,2,
Cleveland,U.S. Senate,Jim Inhofe,REP,140095,4,0,66,70,
Cleveland,U.S. Senate,Erick Paul Wyatt,REP,140095,0,0,0,0,
Cleveland,U.S. Senate,Andy Craig,REP,140095,0,0,0,0,
Cleveland,U.S. Senate,T. Shannon,REP,140095,0,0,17,17,
Cleveland,U.S. Senate,Randy Brogdon,REP,140095,0,0,3,3,
Cleveland,U.S. Senate,Eric Mccray,REP,140095,0,0,1,1,
Cleveland,U.S. Senate,Kevin Crow,REP,140095,0,0,0,0,
Cleveland,U.S. Senate,James Lankford,REP,140095,5,0,52,57,
Cleveland,U.S. Senate,Jason Weger,REP,140095,0,0,1,1,
Cleveland,U.S. House,Anna Flatt,REP,140095,2,0,11,13,04
Cleveland,U.S. House,Tom Cole,REP,140095,3,0,63,66,04
Coal,Superintendent of Public Instruction,John Cox,DEM,150002,1,5,99,105,
Coal,Superintendent of Public Instruction,Jack Jr.,DEM,150002,0,3,62,65,
Coal,Superintendent of Public Instruction,Ivan Holmes,DEM,150002,0,0,16,16,
Coal,Superintendent of Public Instruction,Freda Deskin,DEM,150002,0,0,76,76,
Coal,U.S. Senate,Patrick Michael Hayes,DEM,150002,1,1,54,56,
Coal,U.S. Senate,Jim Rogers,DEM,150002,0,6,132,138,
Coal,U.S. Senate,Connie Johnson,DEM,150002,0,1,55,56,
Coal,U.S. House,Earl Everett,DEM,150002,0,5,142,147,02
Coal,U.S. House,Joshua Harris-Till,DEM,150002,1,3,94,98,02
Coal,Governor,Dax Ewbank,REP,150002,0,0,4,4,
Coal,Governor,Chad Moody,REP,150002,0,0,6,6,
Coal,Governor,Mary Fallin,REP,150002,0,0,18,18,
Coal,Superintendent of Public Instruction,Brian Kelly,REP,150002,0,0,10,10,
Coal,Superintendent of Public Instruction,Janet Costello Barresi,REP,150002,0,0,5,5,
Coal,Superintendent of Public Instruction,Joy Hofmeister,REP,150002,0,0,13,13,
Coal,Insurance Commissioner,Bill Viner,REP,150002,0,0,6,6,
Coal,Insurance Commissioner,John Doak,REP,150002,0,0,20,20,
Coal,Corporation Commissioner,Todd Hiett,REP,150002,0,0,14,14,
Coal,Corporation Commissioner,Cliff Branan,REP,150002,0,0,15,15,
Coal,U.S. Senate,Evelyn Rogers,REP,150002,0,0,1,1,
Coal,U.S. Senate,Rob Moye,REP,150002,0,0,1,1,
Coal,U.S. Senate,D. Jean Mcbride-Samuels,REP,150002,0,0,1,1,
Coal,U.S. Senate,Jim Inhofe,REP,150002,0,0,22,22,
Coal,U.S. Senate,Erick Paul Wyatt,REP,150002,0,0,3,3,
Coal,U.S. Senate,Andy Craig,REP,150002,0,0,0,0,
Coal,U.S. Senate,T. Shannon,REP,150002,0,0,13,13,
Coal,U.S. Senate,Randy Brogdon,REP,150002,0,0,3,3,
Coal,U.S. Senate,Eric Mccray,REP,150002,0,0,1,1,
Coal,U.S. Senate,Kevin Crow,REP,150002,0,0,1,1,
Coal,U.S. Senate,James Lankford,REP,150002,0,0,9,9,
Coal,U.S. Senate,Jason Weger,REP,150002,0,0,2,2,
Coal,U.S. House,Darrel Robertson,REP,150002,0,0,7,7,02
Coal,U.S. House,Markwayne Mullin,REP,150002,0,0,21,21,02
Coal,Superintendent of Public Instruction,John Cox,DEM,150003,1,7,45,53,
Coal,Superintendent of Public Instruction,Jack Jr.,DEM,150003,1,0,19,20,
Coal,Superintendent of Public Instruction,Ivan Holmes,DEM,150003,0,0,2,2,
Coal,Superintendent of Public Instruction,Freda Deskin,DEM,150003,0,3,36,39,
Coal,U.S. Senate,Patrick Michael Hayes,DEM,150003,0,1,29,30,
Coal,U.S. Senate,Jim Rogers,DEM,150003,2,8,32,42,
Coal,U.S. Senate,Connie Johnson,DEM,150003,0,1,37,38,
Coal,U.S. House,Earl Everett,DEM,150003,2,6,50,58,02
Coal,U.S. House,Joshua Harris-Till,DEM,150003,0,3,42,45,02
Coal,Governor,Dax Ewbank,REP,150003,1,0,3,4,
Coal,Governor,Chad Moody,REP,150003,1,0,1,2,
Coal,Governor,Mary Fallin,REP,150003,1,1,6,8,
Coal,Superintendent of Public Instruction,Brian Kelly,REP,150003,0,0,4,4,
Coal,Superintendent of Public Instruction,Janet Costello Barresi,REP,150003,0,0,0,0,
Coal,Superintendent of Public Instruction,Joy Hofmeister,REP,150003,2,1,5,8,
Coal,Insurance Commissioner,Bill Viner,REP,150003,2,1,2,5,
Coal,Insurance Commissioner,John Doak,REP,150003,0,0,7,7,
Coal,Corporation Commissioner,Todd Hiett,REP,150003,2,0,5,7,
Coal,Corporation Commissioner,Cliff Branan,REP,150003,0,1,3,4,
Coal,U.S. Senate,Evelyn Rogers,REP,150003,0,0,0,0,
Coal,U.S. Senate,Rob Moye,REP,150003,1,0,1,2,
Coal,U.S. Senate,D. Jean Mcbride-Samuels,REP,150003,0,0,0,0,
Coal,U.S. Senate,Jim Inhofe,REP,150003,2,1,8,11,
Coal,U.S. Senate,Erick Paul Wyatt,REP,150003,0,0,0,0,
Coal,U.S. Senate,Andy Craig,REP,150003,0,0,0,0,
Coal,U.S. Senate,T. Shannon,REP,150003,0,0,2,2,
Coal,U.S. Senate,Randy Brogdon,REP,150003,0,0,2,2,
Coal,U.S. Senate,Eric Mccray,REP,150003,0,0,0,0,
Coal,U.S. Senate,Kevin Crow,REP,150003,0,0,0,0,
Coal,U.S. Senate,James Lankford,REP,150003,2,1,5,8,
Coal,U.S. Senate,Jason Weger,REP,150003,1,0,0,1,
Coal,U.S. House,Darrel Robertson,REP,150003,0,1,4,5,02
Coal,U.S. House,Markwayne Mullin,REP,150003,3,0,5,8,02
Coal,Superintendent of Public Instruction,John Cox,DEM,150004,2,9,50,61,
Coal,Superintendent of Public Instruction,Jack Jr.,DEM,150004,0,2,9,11,
Coal,Superintendent of Public Instruction,Ivan Holmes,DEM,150004,0,0,3,3,
Coal,Superintendent of Public Instruction,Freda Deskin,DEM,150004,0,4,21,25,
Coal,U.S. Senate,Patrick Michael Hayes,DEM,150004,0,1,23,24,
Coal,U.S. Senate,Jim Rogers,DEM,150004,2,11,34,47,
Coal,U.S. Senate,Connie Johnson,DEM,150004,0,3,21,24,
Coal,U.S. House,Earl Everett,DEM,150004,0,12,43,55,02
Coal,U.S. House,Joshua Harris-Till,DEM,150004,2,3,31,36,02
Coal,Governor,Dax Ewbank,REP,150004,0,0,3,3,
Coal,Governor,Chad Moody,REP,150004,1,3,2,6,
Coal,Governor,Mary Fallin,REP,150004,0,2,8,10,
Coal,Superintendent of Public Instruction,Brian Kelly,REP,150004,0,3,3,6,
Coal,Superintendent of Public Instruction,Janet Costello Barresi,REP,150004,0,2,3,5,
Coal,Superintendent of Public Instruction,Joy Hofmeister,REP,150004,1,0,7,8,
Coal,Insurance Commissioner,Bill Viner,REP,150004,0,3,0,3,
Coal,Insurance Commissioner,John Doak,REP,150004,1,2,13,16,
Coal,Corporation Commissioner,Todd Hiett,REP,150004,0,5,10,15,
Coal,Corporation Commissioner,Cliff Branan,REP,150004,1,0,3,4,
Coal,U.S. Senate,Evelyn Rogers,REP,150004,0,0,0,0,
Coal,U.S. Senate,Rob Moye,REP,150004,0,0,0,0,
Coal,U.S. Senate,D. Jean Mcbride-Samuels,REP,150004,0,0,1,1,
Coal,U.S. Senate,Jim Inhofe,REP,150004,1,5,12,18,
Coal,U.S. Senate,Erick Paul Wyatt,REP,150004,0,0,0,0,
Coal,U.S. Senate,Andy Craig,REP,150004,0,0,2,2,
Coal,U.S. Senate,T. Shannon,REP,150004,1,4,6,11,
Coal,U.S. Senate,Randy Brogdon,REP,150004,0,0,0,0,
Coal,U.S. Senate,Eric Mccray,REP,150004,0,0,0,0,
Coal,U.S. Senate,Kevin Crow,REP,150004,0,0,0,0,
Coal,U.S. Senate,James Lankford,REP,150004,0,1,5,6,
Coal,U.S. Senate,Jason Weger,REP,150004,0,0,0,0,
Coal,U.S. House,Darrel Robertson,REP,150004,0,0,4,4,02
Coal,U.S. House,Markwayne Mullin,REP,150004,1,5,9,15,02
Coal,Superintendent of Public Instruction,John Cox,DEM,150005,0,11,46,57,
Coal,Superintendent of Public Instruction,Jack Jr.,DEM,150005,0,1,10,11,
Coal,Superintendent of Public Instruction,Ivan Holmes,DEM,150005,0,3,4,7,
Coal,Superintendent of Public Instruction,Freda Deskin,DEM,150005,1,4,30,35,
Coal,U.S. Senate,Patrick Michael Hayes,DEM,150005,0,4,18,22,
Coal,U.S. Senate,Jim Rogers,DEM,150005,1,7,54,62,
Coal,U.S. Senate,Connie Johnson,DEM,150005,0,8,17,25,
Coal,U.S. House,Earl Everett,DEM,150005,0,12,56,68,02
Coal,U.S. House,Joshua Harris-Till,DEM,150005,0,6,31,37,02
Coal,Governor,Dax Ewbank,REP,150005,0,1,4,5,
Coal,Governor,Chad Moody,REP,150005,0,3,2,5,
Coal,Governor,Mary Fallin,REP,150005,0,4,18,22,
Coal,Superintendent of Public Instruction,Brian Kelly,REP,150005,0,3,9,12,
Coal,Superintendent of Public Instruction,Janet Costello Barresi,REP,150005,0,3,1,4,
Coal,Superintendent of Public Instruction,Joy Hofmeister,REP,150005,0,2,14,16,
Coal,Insurance Commissioner,Bill Viner,REP,150005,0,4,3,7,
Coal,Insurance Commissioner,John Doak,REP,150005,0,4,20,24,
Coal,Corporation Commissioner,Todd Hiett,REP,150005,0,4,16,20,
Coal,Corporation Commissioner,Cliff Branan,REP,150005,0,4,7,11,
Coal,U.S. Senate,Evelyn Rogers,REP,150005,0,2,1,3,
Coal,U.S. Senate,Rob Moye,REP,150005,0,0,1,1,
Coal,U.S. Senate,D. Jean Mcbride-Samuels,REP,150005,0,0,0,0,
Coal,U.S. Senate,Jim Inhofe,REP,150005,0,5,18,23,
Coal,U.S. Senate,Erick Paul Wyatt,REP,150005,0,1,4,5,
Coal,U.S. Senate,Andy Craig,REP,150005,0,0,1,1,
Coal,U.S. Senate,T. Shannon,REP,150005,0,4,9,13,
Coal,U.S. Senate,Randy Brogdon,REP,150005,0,0,2,2,
Coal,U.S. Senate,Eric Mccray,REP,150005,0,0,2,2,
Coal,U.S. Senate,Kevin Crow,REP,150005,0,1,1,2,
Coal,U.S. Senate,James Lankford,REP,150005,0,3,9,12,
Coal,U.S. Senate,Jason Weger,REP,150005,0,0,0,0,
Coal,U.S. House,Darrel Robertson,REP,150005,0,4,9,13,02
Coal,U.S. House,Markwayne Mullin,REP,150005,0,4,15,19,02
Coal,Superintendent of Public Instruction,John Cox,DEM,150006,1,3,25,29,
Coal,Superintendent of Public Instruction,Jack Jr.,DEM,150006,0,3,3,6,
Coal,Superintendent of Public Instruction,Ivan Holmes,DEM,150006,1,1,2,4,
Coal,Superintendent of Public Instruction,Freda Deskin,DEM,150006,0,7,17,24,
Coal,U.S. Senate,Patrick Michael Hayes,DEM,150006,0,5,11,16,
Coal,U.S. Senate,Jim Rogers,DEM,150006,1,3,20,24,
Coal,U.S. Senate,Connie Johnson,DEM,150006,1,5,11,17,
Coal,U.S. House,Earl Everett,DEM,150006,1,8,17,26,02
Coal,U.S. House,Joshua Harris-Till,DEM,150006,1,5,23,29,02
Coal,Governor,Dax Ewbank,REP,150006,0,0,1,1,
Coal,Governor,Chad Moody,REP,150006,0,0,4,4,
Coal,Governor,Mary Fallin,REP,150006,0,6,8,14,
Coal,Superintendent of Public Instruction,Brian Kelly,REP,150006,0,1,5,6,
Coal,Superintendent of Public Instruction,Janet Costello Barresi,REP,150006,0,1,0,1,
Coal,Superintendent of Public Instruction,Joy Hofmeister,REP,150006,0,2,7,9,
Coal,Insurance Commissioner,Bill Viner,REP,150006,0,1,2,3,
Coal,Insurance Commissioner,John Doak,REP,150006,0,4,10,14,
Coal,Corporation Commissioner,Todd Hiett,REP,150006,0,3,6,9,
Coal,Corporation Commissioner,Cliff Branan,REP,150006,0,2,6,8,
Coal,U.S. Senate,Evelyn Rogers,REP,150006,0,0,0,0,
Coal,U.S. Senate,Rob Moye,REP,150006,0,0,0,0,
Coal,U.S. Senate,D. Jean Mcbride-Samuels,REP,150006,0,0,0,0,
Coal,U.S. Senate,Jim Inhofe,REP,150006,0,5,9,14,
Coal,U.S. Senate,Erick Paul Wyatt,REP,150006,0,0,3,3,
Coal,U.S. Senate,Andy Craig,REP,150006,0,0,0,0,
Coal,U.S. Senate,T. Shannon,REP,150006,0,1,2,3,
Coal,U.S. Senate,Randy Brogdon,REP,150006,0,0,3,3,
Coal,U.S. Senate,Eric Mccray,REP,150006,0,0,0,0,
Coal,U.S. Senate,Kevin Crow,REP,150006,0,0,0,0,
Coal,U.S. Senate,James Lankford,REP,150006,0,4,7,11,
Coal,U.S. Senate,Jason Weger,REP,150006,0,0,0,0,
Coal,U.S. House,Darrel Robertson,REP,150006,0,1,5,6,02
Coal,U.S. House,Markwayne Mullin,REP,150006,0,5,8,13,02
Coal,Superintendent of Public Instruction,John Cox,DEM,150007,3,18,41,62,
Coal,Superintendent of Public Instruction,Jack Jr.,DEM,150007,0,3,10,13,
Coal,Superintendent of Public Instruction,Ivan Holmes,DEM,150007,0,2,3,5,
Coal,Superintendent of Public Instruction,Freda Deskin,DEM,150007,1,9,38,48,
Coal,U.S. Senate,Patrick Michael Hayes,DEM,150007,1,11,31,43,
Coal,U.S. Senate,Jim Rogers,DEM,150007,2,13,39,54,
Coal,U.S. Senate,Connie Johnson,DEM,150007,1,7,19,27,
Coal,U.S. House,Earl Everett,DEM,150007,4,18,55,77,02
Coal,U.S. House,Joshua Harris-Till,DEM,150007,0,11,27,38,02
Coal,Governor,Dax Ewbank,REP,150007,0,1,1,2,
Coal,Governor,Chad Moody,REP,150007,0,2,1,3,
Coal,Governor,Mary Fallin,REP,150007,1,5,10,16,
Coal,Superintendent of Public Instruction,Brian Kelly,REP,150007,1,2,1,4,
Coal,Superintendent of Public Instruction,Janet Costello Barresi,REP,150007,0,1,5,6,
Coal,Superintendent of Public Instruction,Joy Hofmeister,REP,150007,0,4,5,9,
Coal,Insurance Commissioner,Bill Viner,REP,150007,0,0,3,3,
Coal,Insurance Commissioner,John Doak,REP,150007,1,8,8,17,
Coal,Corporation Commissioner,Todd Hiett,REP,150007,0,6,8,14,
Coal,Corporation Commissioner,Cliff Branan,REP,150007,1,2,3,6,
Coal,U.S. Senate,Evelyn Rogers,REP,150007,0,1,1,2,
Coal,U.S. Senate,Rob Moye,REP,150007,0,0,0,0,
Coal,U.S. Senate,D. Jean Mcbride-Samuels,REP,150007,0,0,0,0,
Coal,U.S. Senate,Jim Inhofe,REP,150007,1,5,10,16,
Coal,U.S. Senate,Erick Paul Wyatt,REP,150007,0,2,0,2,
Coal,U.S. Senate,Andy Craig,REP,150007,0,0,0,0,
Coal,U.S. Senate,T. Shannon,REP,150007,0,1,4,5,
Coal,U.S. Senate,Randy Brogdon,REP,150007,0,0,1,1,
Coal,U.S. Senate,Eric Mccray,REP,150007,0,1,1,2,
Coal,U.S. Senate,Kevin Crow,REP,150007,0,0,0,0,
Coal,U.S. Senate,James Lankford,REP,150007,1,5,4,10,
Coal,U.S. Senate,Jason Weger,REP,150007,0,1,1,2,
Coal,U.S. House,Darrel Robertson,REP,150007,0,0,3,3,02
Coal,U.S. House,Markwayne Mullin,REP,150007,1,8,8,17,02
Coal,Superintendent of Public Instruction,John Cox,DEM,150009,0,3,17,20,
Coal,Superintendent of Public Instruction,Jack Jr.,DEM,150009,0,1,4,5,
Coal,Superintendent of Public Instruction,Ivan Holmes,DEM,150009,0,0,3,3,
Coal,Superintendent of Public Instruction,Freda Deskin,DEM,150009,0,1,20,21,
Coal,U.S. Senate,Patrick Michael Hayes,DEM,150009,0,0,8,8,
Coal,U.S. Senate,Jim Rogers,DEM,150009,0,3,17,20,
Coal,U.S. Senate,Connie Johnson,DEM,150009,0,2,11,13,
Coal,U.S. House,Earl Everett,DEM,150009,0,5,22,27,02
Coal,U.S. House,Joshua Harris-Till,DEM,150009,0,0,13,13,02
Coal,Governor,Dax Ewbank,REP,150009,0,0,1,1,
Coal,Governor,Chad Moody,REP,150009,0,0,0,0,
Coal,Governor,Mary Fallin,REP,150009,0,0,9,9,
Coal,Superintendent of Public Instruction,Brian Kelly,REP,150009,0,0,4,4,
Coal,Superintendent of Public Instruction,Janet Costello Barresi,REP,150009,0,0,0,0,
Coal,Superintendent of Public Instruction,Joy Hofmeister,REP,150009,0,0,3,3,
Coal,Insurance Commissioner,Bill Viner,REP,150009,0,0,2,2,
Coal,Insurance Commissioner,John Doak,REP,150009,0,0,5,5,
Coal,Corporation Commissioner,Todd Hiett,REP,150009,0,0,2,2,
Coal,Corporation Commissioner,Cliff Branan,REP,150009,0,0,5,5,
Coal,U.S. Senate,Evelyn Rogers,REP,150009,0,0,1,1,
Coal,U.S. Senate,Rob Moye,REP,150009,0,0,1,1,
Coal,U.S. Senate,D. Jean Mcbride-Samuels,REP,150009,0,0,0,0,
Coal,U.S. Senate,Jim Inhofe,REP,150009,0,0,6,6,
Coal,U.S. Senate,Erick Paul Wyatt,REP,150009,0,0,1,1,
Coal,U.S. Senate,Andy Craig,REP,150009,0,0,0,0,
Coal,U.S. Senate,T. Shannon,REP,150009,0,0,3,3,
Coal,U.S. Senate,Randy Brogdon,REP,150009,0,0,1,1,
Coal,U.S. Senate,Eric Mccray,REP,150009,0,0,0,0,
Coal,U.S. Senate,Kevin Crow,REP,150009,0,0,0,0,
Coal,U.S. Senate,James Lankford,REP,150009,0,0,4,4,
Coal,U.S. Senate,Jason Weger,REP,150009,0,0,1,1,
Coal,U.S. House,Darrel Robertson,REP,150009,0,0,4,4,02
Coal,U.S. House,Markwayne Mullin,REP,150009,1,0,5,6,02
Coal,Superintendent of Public Instruction,John Cox,DEM,150010,0,1,23,24,
Coal,Superintendent of Public Instruction,Jack Jr.,DEM,150010,0,1,7,8,
Coal,Superintendent of Public Instruction,Ivan Holmes,DEM,150010,0,0,4,4,
Coal,Superintendent of Public Instruction,Freda Deskin,DEM,150010,0,1,21,22,
Coal,U.S. Senate,Patrick Michael Hayes,DEM,150010,0,1,20,21,
Coal,U.S. Senate,Jim Rogers,DEM,150010,0,1,22,23,
Coal,U.S. Senate,Connie Johnson,DEM,150010,0,0,13,13,
Coal,U.S. House,Earl Everett,DEM,150010,0,1,31,32,02
Coal,U.S. House,Joshua Harris-Till,DEM,150010,0,1,23,24,02
Coal,Governor,Dax Ewbank,REP,150010,0,0,3,3,
Coal,Governor,Chad Moody,REP,150010,0,0,0,0,
Coal,Governor,Mary Fallin,REP,150010,0,0,13,13,
Coal,Superintendent of Public Instruction,Brian Kelly,REP,150010,0,0,0,0,
Coal,Superintendent of Public Instruction,Janet Costello Barresi,REP,150010,0,0,9,9,
Coal,Superintendent of Public Instruction,Joy Hofmeister,REP,150010,0,0,6,6,
Coal,Insurance Commissioner,Bill Viner,REP,150010,0,0,3,3,
Coal,Insurance Commissioner,John Doak,REP,150010,0,0,11,11,
Coal,Corporation Commissioner,Todd Hiett,REP,150010,0,0,14,14,
Coal,Corporation Commissioner,Cliff Branan,REP,150010,0,0,1,1,
Coal,U.S. Senate,Evelyn Rogers,REP,150010,0,0,0,0,
Coal,U.S. Senate,Rob Moye,REP,150010,0,0,0,0,
Coal,U.S. Senate,D. Jean Mcbride-Samuels,REP,150010,0,0,1,1,
Coal,U.S. Senate,Jim Inhofe,REP,150010,0,0,14,14,
Coal,U.S. Senate,Erick Paul Wyatt,REP,150010,0,0,0,0,
Coal,U.S. Senate,Andy Craig,REP,150010,0,0,0,0,
Coal,U.S. Senate,T. Shannon,REP,150010,0,0,3,3,
Coal,U.S. Senate,Randy Brogdon,REP,150010,0,0,0,0,
Coal,U.S. Senate,Eric Mccray,REP,150010,0,0,0,0,
Coal,U.S. Senate,Kevin Crow,REP,150010,0,0,0,0,
Coal,U.S. Senate,James Lankford,REP,150010,0,0,13,13,
Coal,U.S. Senate,Jason Weger,REP,150010,0,0,0,0,
Coal,U.S. House,Darrel Robertson,REP,150010,0,0,6,6,02
Coal,U.S. House,Markwayne Mullin,REP,150010,0,0,9,9,02
Coal,Superintendent of Public Instruction,John Cox,DEM,150011,5,18,71,94,
Coal,Superintendent of Public Instruction,Jack Jr.,DEM,150011,0,6,18,24,
Coal,Superintendent of Public Instruction,Ivan Holmes,DEM,150011,1,6,8,15,
Coal,Superintendent of Public Instruction,Freda Deskin,DEM,150011,0,7,60,67,
Coal,U.S. Senate,Patrick Michael Hayes,DEM,150011,2,8,33,43,
Coal,U.S. Senate,Jim Rogers,DEM,150011,1,21,83,105,
Coal,U.S. Senate,Connie Johnson,DEM,150011,1,7,36,44,
Coal,U.S. House,Earl Everett,DEM,150011,2,23,85,110,02
Coal,U.S. House,Joshua Harris-Till,DEM,150011,1,10,63,74,02
Coal,Governor,Dax Ewbank,REP,150011,0,0,1,1,
Coal,Governor,Chad Moody,REP,150011,0,0,3,3,
Coal,Governor,Mary Fallin,REP,150011,0,0,4,4,
Coal,Superintendent of Public Instruction,Brian Kelly,REP,150011,0,0,5,5,
Coal,Superintendent of Public Instruction,Janet Costello Barresi,REP,150011,0,0,1,1,
Coal,Superintendent of Public Instruction,Joy Hofmeister,REP,150011,0,0,3,3,
Coal,Insurance Commissioner,Bill Viner,REP,150011,0,0,2,2,
Coal,Insurance Commissioner,John Doak,REP,150011,0,0,6,6,
Coal,Corporation Commissioner,Todd Hiett,REP,150011,0,0,5,5,
Coal,Corporation Commissioner,Cliff Branan,REP,150011,0,0,4,4,
Coal,U.S. Senate,Evelyn Rogers,REP,150011,0,0,0,0,
Coal,U.S. Senate,Rob Moye,REP,150011,0,0,0,0,
Coal,U.S. Senate,D. Jean Mcbride-Samuels,REP,150011,0,0,1,1,
Coal,U.S. Senate,Jim Inhofe,REP,150011,0,0,5,5,
Coal,U.S. Senate,Erick Paul Wyatt,REP,150011,0,0,3,3,
Coal,U.S. Senate,Andy Craig,REP,150011,0,0,0,0,
Coal,U.S. Senate,T. Shannon,REP,150011,0,0,3,3,
Coal,U.S. Senate,Randy Brogdon,REP,150011,0,0,0,0,
Coal,U.S. Senate,Eric Mccray,REP,150011,0,0,0,0,
Coal,U.S. Senate,Kevin Crow,REP,150011,0,0,0,0,
Coal,U.S. Senate,James Lankford,REP,150011,0,0,3,3,
Coal,U.S. Senate,Jason Weger,REP,150011,0,0,3,3,
Coal,U.S. House,Darrel Robertson,REP,150011,0,0,4,4,02
Coal,U.S. House,Markwayne Mullin,REP,150011,0,0,5,5,02
Comanche,Superintendent of Public Instruction,John Cox,DEM,160001,1,4,80,85,
Comanche,Superintendent of Public Instruction,Jack Jr.,DEM,160001,1,4,47,52,
Comanche,Superintendent of Public Instruction,Ivan Holmes,DEM,160001,3,1,17,21,
Comanche,Superintendent of Public Instruction,Freda Deskin,DEM,160001,8,3,42,53,
Comanche,U.S. Senate,Patrick Michael Hayes,DEM,160001,3,2,43,48,
Comanche,U.S. Senate,Jim Rogers,DEM,160001,3,9,69,81,
Comanche,U.S. Senate,Connie Johnson,DEM,160001,7,1,72,80,
Comanche,U.S. House,Bert Smith,DEM,160001,11,11,162,184,04
Comanche,U.S. House,Tae Si,DEM,160001,2,1,23,26,04
Comanche,Governor,Dax Ewbank,REP,160001,0,1,11,12,
Comanche,Governor,Chad Moody,REP,160001,1,7,39,47,
Comanche,Governor,Mary Fallin,REP,160001,12,6,170,188,
Comanche,Superintendent of Public Instruction,Brian Kelly,REP,160001,2,4,47,53,
Comanche,Superintendent of Public Instruction,Janet Costello Barresi,REP,160001,5,3,79,87,
Comanche,Superintendent of Public Instruction,Joy Hofmeister,REP,160001,5,7,93,105,
Comanche,Insurance Commissioner,Bill Viner,REP,160001,4,2,55,61,
Comanche,Insurance Commissioner,John Doak,REP,160001,8,12,149,169,
Comanche,Corporation Commissioner,Todd Hiett,REP,160001,5,9,128,142,
Comanche,Corporation Commissioner,Cliff Branan,REP,160001,7,5,79,91,
Comanche,U.S. Senate,Evelyn Rogers,REP,160001,1,0,11,12,
Comanche,U.S. Senate,Rob Moye,REP,160001,2,1,3,6,
Comanche,U.S. Senate,D. Jean Mcbride-Samuels,REP,160001,0,0,4,4,
Comanche,U.S. Senate,Jim Inhofe,REP,160001,9,13,194,216,
Comanche,U.S. Senate,Erick Paul Wyatt,REP,160001,1,0,6,7,
Comanche,U.S. Senate,Andy Craig,REP,160001,0,0,1,1,
Comanche,U.S. Senate,T. Shannon,REP,160001,7,4,166,177,
Comanche,U.S. Senate,Randy Brogdon,REP,160001,0,1,4,5,
Comanche,U.S. Senate,Eric Mccray,REP,160001,0,0,2,2,
Comanche,U.S. Senate,Kevin Crow,REP,160001,1,0,2,3,
Comanche,U.S. Senate,James Lankford,REP,160001,3,7,47,57,
Comanche,U.S. Senate,Jason Weger,REP,160001,2,2,0,4,
Comanche,U.S. House,Anna Flatt,REP,160001,4,2,41,47,04
Comanche,U.S. House,Tom Cole,REP,160001,9,12,177,198,04
Comanche,State House,Jesse Robert Cross,REP,160001,5,8,96,109,62
Comanche,State House,John Michael Montgomery,REP,160001,6,6,117,129,62
Comanche,Superintendent of Public Instruction,John Cox,DEM,160002,1,4,46,51,
Comanche,Superintendent of Public Instruction,Jack Jr.,DEM,160002,0,1,21,22,
Comanche,Superintendent of Public Instruction,Ivan Holmes,DEM,160002,1,1,13,15,
Comanche,Superintendent of Public Instruction,Freda Deskin,DEM,160002,2,2,55,59,
Comanche,U.S. Senate,Patrick Michael Hayes,DEM,160002,0,2,31,33,
Comanche,U.S. Senate,Jim Rogers,DEM,160002,1,4,40,45,
Comanche,U.S. Senate,Connie Johnson,DEM,160002,3,2,65,70,
Comanche,U.S. House,Bert Smith,DEM,160002,2,6,106,114,04
Comanche,U.S. House,Tae Si,DEM,160002,2,2,27,31,04
Comanche,Governor,Dax Ewbank,REP,160002,1,1,10,12,
Comanche,Governor,Chad Moody,REP,160002,0,1,25,26,
Comanche,Governor,Mary Fallin,REP,160002,2,8,101,111,
Comanche,Superintendent of Public Instruction,Brian Kelly,REP,160002,0,3,36,39,
Comanche,Superintendent of Public Instruction,Janet Costello Barresi,REP,160002,1,6,47,54,
Comanche,Superintendent of Public Instruction,Joy Hofmeister,REP,160002,2,1,50,53,
Comanche,Insurance Commissioner,Bill Viner,REP,160002,2,3,33,38,
Comanche,Insurance Commissioner,John Doak,REP,160002,1,7,92,100,
Comanche,Corporation Commissioner,Todd Hiett,REP,160002,2,7,73,82,
Comanche,Corporation Commissioner,Cliff Branan,REP,160002,1,3,53,57,
Comanche,U.S. Senate,Evelyn Rogers,REP,160002,0,0,6,6,
Comanche,U.S. Senate,Rob Moye,REP,160002,0,0,1,1,
Comanche,U.S. Senate,D. Jean Mcbride-Samuels,REP,160002,0,0,2,2,
Comanche,U.S. Senate,Jim Inhofe,REP,160002,2,9,123,134,
Comanche,U.S. Senate,Erick Paul Wyatt,REP,160002,1,1,4,6,
Comanche,U.S. Senate,Andy Craig,REP,160002,0,0,0,0,
Comanche,U.S. Senate,T. Shannon,REP,160002,3,7,91,101,
Comanche,U.S. Senate,Randy Brogdon,REP,160002,0,0,3,3,
Comanche,U.S. Senate,Eric Mccray,REP,160002,0,0,1,1,
Comanche,U.S. Senate,Kevin Crow,REP,160002,0,1,4,5,
Comanche,U.S. Senate,James Lankford,REP,160002,0,2,36,38,
Comanche,U.S. Senate,Jason Weger,REP,160002,0,0,3,3,
Comanche,U.S. House,Anna Flatt,REP,160002,1,2,20,23,04
Comanche,U.S. House,Tom Cole,REP,160002,2,8,116,126,04
Comanche,State House,Jesse Robert Cross,REP,160002,3,7,52,62,62
Comanche,State House,John Michael Montgomery,REP,160002,0,3,82,85,62
Comanche,Superintendent of Public Instruction,John Cox,DEM,160003,1,0,25,26,
Comanche,Superintendent of Public Instruction,Jack Jr.,DEM,160003,0,1,20,21,
Comanche,Superintendent of Public Instruction,Ivan Holmes,DEM,160003,0,1,15,16,
Comanche,Superintendent of Public Instruction,Freda Deskin,DEM,160003,0,5,26,31,
Comanche,U.S. Senate,Patrick Michael Hayes,DEM,160003,0,0,19,19,
Comanche,U.S. Senate,Jim Rogers,DEM,160003,1,1,19,21,
Comanche,U.S. Senate,Connie Johnson,DEM,160003,1,6,48,55,
Comanche,U.S. House,Bert Smith,DEM,160003,2,5,60,67,04
Comanche,U.S. House,Tae Si,DEM,160003,0,2,25,27,04
Comanche,Governor,Dax Ewbank,REP,160003,0,2,10,12,
Comanche,Governor,Chad Moody,REP,160003,0,3,20,23,
Comanche,Governor,Mary Fallin,REP,160003,0,8,71,79,
Comanche,Superintendent of Public Instruction,Brian Kelly,REP,160003,0,6,29,35,
Comanche,Superintendent of Public Instruction,Janet Costello Barresi,REP,160003,0,3,28,31,
Comanche,Superintendent of Public Instruction,Joy Hofmeister,REP,160003,0,4,41,45,
Comanche,Insurance Commissioner,Bill Viner,REP,160003,0,3,25,28,
Comanche,Insurance Commissioner,John Doak,REP,160003,0,9,65,74,
Comanche,Corporation Commissioner,Todd Hiett,REP,160003,0,4,42,46,
Comanche,Corporation Commissioner,Cliff Branan,REP,160003,0,8,51,59,
Comanche,U.S. Senate,Evelyn Rogers,REP,160003,0,1,3,4,
Comanche,U.S. Senate,Rob Moye,REP,160003,0,0,1,1,
Comanche,U.S. Senate,D. Jean Mcbride-Samuels,REP,160003,0,0,1,1,
Comanche,U.S. Senate,Jim Inhofe,REP,160003,0,10,87,97,
Comanche,U.S. Senate,Erick Paul Wyatt,REP,160003,0,2,7,9,
Comanche,U.S. Senate,Andy Craig,REP,160003,0,0,0,0,
Comanche,U.S. Senate,T. Shannon,REP,160003,0,10,76,86,
Comanche,U.S. Senate,Randy Brogdon,REP,160003,0,1,5,6,
Comanche,U.S. Senate,Eric Mccray,REP,160003,0,0,2,2,
Comanche,U.S. Senate,Kevin Crow,REP,160003,0,0,2,2,
Comanche,U.S. Senate,James Lankford,REP,160003,0,2,16,18,
Comanche,U.S. Senate,Jason Weger,REP,160003,0,0,0,0,
Comanche,U.S. House,Anna Flatt,REP,160003,0,4,13,17,04
Comanche,U.S. House,Tom Cole,REP,160003,0,9,86,95,04
Comanche,State House,Jesse Robert Cross,REP,160003,0,7,45,52,62
Comanche,State House,John Michael Montgomery,REP,160003,0,6,49,55,62
Comanche,Superintendent of Public Instruction,John Cox,DEM,160007,2,4,46,52,
Comanche,Superintendent of Public Instruction,Jack Jr.,DEM,160007,0,1,23,24,
Comanche,Superintendent of Public Instruction,Ivan Holmes,DEM,160007,1,0,11,12,
Comanche,Superintendent of Public Instruction,Freda Deskin,DEM,160007,0,4,33,37,
Comanche,U.S. Senate,Patrick Michael Hayes,DEM,160007,0,2,25,27,
Comanche,U.S. Senate,Jim Rogers,DEM,160007,1,2,27,30,
Comanche,U.S. Senate,Connie Johnson,DEM,160007,2,5,63,70,
Comanche,U.S. House,Bert Smith,DEM,160007,2,5,99,106,04
Comanche,U.S. House,Tae Si,DEM,160007,1,4,18,23,04
Comanche,Governor,Dax Ewbank,REP,160007,0,0,8,8,
Comanche,Governor,Chad Moody,REP,160007,0,1,29,30,
Comanche,Governor,Mary Fallin,REP,160007,4,4,117,125,
Comanche,Superintendent of Public Instruction,Brian Kelly,REP,160007,0,0,43,43,
Comanche,Superintendent of Public Instruction,Janet Costello Barresi,REP,160007,4,1,45,50,
Comanche,Superintendent of Public Instruction,Joy Hofmeister,REP,160007,0,5,61,66,
Comanche,Insurance Commissioner,Bill Viner,REP,160007,2,2,33,37,
Comanche,Insurance Commissioner,John Doak,REP,160007,2,4,108,114,
Comanche,Corporation Commissioner,Todd Hiett,REP,160007,2,3,74,79,
Comanche,Corporation Commissioner,Cliff Branan,REP,160007,2,2,66,70,
Comanche,U.S. Senate,Evelyn Rogers,REP,160007,0,0,8,8,
Comanche,U.S. Senate,Rob Moye,REP,160007,0,1,3,4,
Comanche,U.S. Senate,D. Jean Mcbride-Samuels,REP,160007,0,0,6,6,
Comanche,U.S. Senate,Jim Inhofe,REP,160007,4,4,125,133,
Comanche,U.S. Senate,Erick Paul Wyatt,REP,160007,0,0,9,9,
Comanche,U.S. Senate,Andy Craig,REP,160007,0,1,1,2,
Comanche,U.S. Senate,T. Shannon,REP,160007,2,4,126,132,
Comanche,U.S. Senate,Randy Brogdon,REP,160007,1,0,2,3,
Comanche,U.S. Senate,Eric Mccray,REP,160007,0,0,3,3,
Comanche,U.S. Senate,Kevin Crow,REP,160007,0,0,1,1,
Comanche,U.S. Senate,James Lankford,REP,160007,1,1,19,21,
Comanche,U.S. Senate,Jason Weger,REP,160007,0,0,2,2,
Comanche,U.S. House,Anna Flatt,REP,160007,1,1,27,29,04
Comanche,U.S. House,Tom Cole,REP,160007,3,5,126,134,04
Comanche,State House,Jesse Robert Cross,REP,160007,1,2,70,73,62
Comanche,State House,John Michael Montgomery,REP,160007,3,4,75,82,62
Comanche,Superintendent of Public Instruction,John Cox,DEM,160008,0,6,66,72,
Comanche,Superintendent of Public Instruction,Jack Jr.,DEM,160008,0,3,48,51,
Comanche,Superintendent of Public Instruction,Ivan Holmes,DEM,160008,0,5,21,26,
Comanche,Superintendent of Public Instruction,Freda Deskin,DEM,160008,3,7,49,59,
Comanche,U.S. Senate,Patrick Michael Hayes,DEM,160008,0,3,56,59,
Comanche,U.S. Senate,Jim Rogers,DEM,160008,0,8,45,53,
Comanche,U.S. Senate,Connie Johnson,DEM,160008,3,10,78,91,
Comanche,U.S. House,Bert Smith,DEM,160008,1,16,140,157,04
Comanche,U.S. House,Tae Si,DEM,160008,2,4,40,46,04
Comanche,Governor,Dax Ewbank,REP,160008,1,2,8,11,
Comanche,Governor,Chad Moody,REP,160008,0,2,17,19,
Comanche,Governor,Mary Fallin,REP,160008,9,21,159,189,
Comanche,Superintendent of Public Instruction,Brian Kelly,REP,160008,0,5,32,37,
Comanche,Superintendent of Public Instruction,Janet Costello Barresi,REP,160008,9,11,83,103,
Comanche,Superintendent of Public Instruction,Joy Hofmeister,REP,160008,1,9,70,80,
Comanche,Insurance Commissioner,Bill Viner,REP,160008,2,3,43,48,
Comanche,Insurance Commissioner,John Doak,REP,160008,8,21,133,162,
Comanche,Corporation Commissioner,Todd Hiett,REP,160008,8,12,100,120,
Comanche,Corporation Commissioner,Cliff Branan,REP,160008,2,11,82,95,
Comanche,U.S. Senate,Evelyn Rogers,REP,160008,0,1,6,7,
Comanche,U.S. Senate,Rob Moye,REP,160008,0,1,6,7,
Comanche,U.S. Senate,D. Jean Mcbride-Samuels,REP,160008,0,0,3,3,
Comanche,U.S. Senate,Jim Inhofe,REP,160008,10,23,167,200,
Comanche,U.S. Senate,Erick Paul Wyatt,REP,160008,0,1,5,6,
Comanche,U.S. Senate,Andy Craig,REP,160008,0,0,0,0,
Comanche,U.S. Senate,T. Shannon,REP,160008,8,18,139,165,
Comanche,U.S. Senate,Randy Brogdon,REP,160008,1,0,3,4,
Comanche,U.S. Senate,Eric Mccray,REP,160008,0,0,1,1,
Comanche,U.S. Senate,Kevin Crow,REP,160008,0,0,4,4,
Comanche,U.S. Senate,James Lankford,REP,160008,1,8,38,47,
Comanche,U.S. Senate,Jason Weger,REP,160008,0,0,2,2,
Comanche,U.S. House,Anna Flatt,REP,160008,4,2,19,25,04
Comanche,U.S. House,Tom Cole,REP,160008,6,24,169,199,04
Comanche,State House,Jesse Robert Cross,REP,160008,2,7,103,112,62
Comanche,State House,John Michael Montgomery,REP,160008,6,17,77,100,62
Comanche,Superintendent of Public Instruction,John Cox,DEM,160009,0,4,47,51,
Comanche,Superintendent of Public Instruction,Jack Jr.,DEM,160009,0,1,28,29,
Comanche,Superintendent of Public Instruction,Ivan Holmes,DEM,160009,0,2,20,22,
Comanche,Superintendent of Public Instruction,Freda Deskin,DEM,160009,1,7,40,48,
Comanche,U.S. Senate,Patrick Michael Hayes,DEM,160009,0,2,27,29,
Comanche,U.S. Senate,Jim Rogers,DEM,160009,0,1,33,34,
Comanche,U.S. Senate,Connie Johnson,DEM,160009,1,11,74,86,
Comanche,U.S. House,Bert Smith,DEM,160009,0,10,100,110,04
Comanche,U.S. House,Tae Si,DEM,160009,1,4,33,38,04
Comanche,Governor,Dax Ewbank,REP,160009,1,1,9,11,
Comanche,Governor,Chad Moody,REP,160009,1,4,31,36,
Comanche,Governor,Mary Fallin,REP,160009,5,12,106,123,
Comanche,Superintendent of Public Instruction,Brian Kelly,REP,160009,2,4,34,40,
Comanche,Superintendent of Public Instruction,Janet Costello Barresi,REP,160009,1,9,42,52,
Comanche,Superintendent of Public Instruction,Joy Hofmeister,REP,160009,4,3,64,71,
Comanche,Insurance Commissioner,Bill Viner,REP,160009,2,2,29,33,
Comanche,Insurance Commissioner,John Doak,REP,160009,5,13,100,118,
Comanche,Corporation Commissioner,Todd Hiett,REP,160009,4,11,79,94,
Comanche,Corporation Commissioner,Cliff Branan,REP,160009,2,5,57,64,
Comanche,U.S. Senate,Evelyn Rogers,REP,160009,0,1,7,8,
Comanche,U.S. Senate,Rob Moye,REP,160009,0,0,2,2,
Comanche,U.S. Senate,D. Jean Mcbride-Samuels,REP,160009,0,0,1,1,
Comanche,U.S. Senate,Jim Inhofe,REP,160009,7,16,129,152,
Comanche,U.S. Senate,Erick Paul Wyatt,REP,160009,0,0,7,7,
Comanche,U.S. Senate,Andy Craig,REP,160009,0,0,1,1,
Comanche,U.S. Senate,T. Shannon,REP,160009,3,13,98,114,
Comanche,U.S. Senate,Randy Brogdon,REP,160009,1,0,4,5,
Comanche,U.S. Senate,Eric Mccray,REP,160009,0,0,3,3,
Comanche,U.S. Senate,Kevin Crow,REP,160009,0,0,1,1,
Comanche,U.S. Senate,James Lankford,REP,160009,2,4,39,45,
Comanche,U.S. Senate,Jason Weger,REP,160009,1,0,1,2,
Comanche,U.S. House,Anna Flatt,REP,160009,1,0,18,19,04
Comanche,U.S. House,Tom Cole,REP,160009,6,17,127,150,04
Comanche,State House,Jesse Robert Cross,REP,160009,2,7,66,75,62
Comanche,State House,John Michael Montgomery,REP,160009,5,8,75,88,62
Comanche,Superintendent of Public Instruction,John Cox,DEM,160011,1,4,25,30,
Comanche,Superintendent of Public Instruction,Jack Jr.,DEM,160011,0,0,17,17,
Comanche,Superintendent of Public Instruction,Ivan Holmes,DEM,160011,0,1,5,6,
Comanche,Superintendent of Public Instruction,Freda Deskin,DEM,160011,0,1,29,30,
Comanche,U.S. Senate,Patrick Michael Hayes,DEM,160011,1,1,16,18,
Comanche,U.S. Senate,Jim Rogers,DEM,160011,0,1,19,20,
Comanche,U.S. Senate,Connie Johnson,DEM,160011,0,4,42,46,
Comanche,U.S. House,Bert Smith,DEM,160011,0,4,57,61,04
Comanche,U.S. House,Tae Si,DEM,160011,1,2,18,21,04
Comanche,Governor,Dax Ewbank,REP,160011,0,0,5,5,
Comanche,Governor,Chad Moody,REP,160011,1,1,26,28,
Comanche,Governor,Mary Fallin,REP,160011,6,5,72,83,
Comanche,Superintendent of Public Instruction,Brian Kelly,REP,160011,0,2,24,26,
Comanche,Superintendent of Public Instruction,Janet Costello Barresi,REP,160011,2,2,32,36,
Comanche,Superintendent of Public Instruction,Joy Hofmeister,REP,160011,5,2,47,54,
Comanche,Insurance Commissioner,Bill Viner,REP,160011,1,3,29,33,
Comanche,Insurance Commissioner,John Doak,REP,160011,2,3,68,73,
Comanche,Corporation Commissioner,Todd Hiett,REP,160011,3,5,55,63,
Comanche,Corporation Commissioner,Cliff Branan,REP,160011,0,1,44,45,
Comanche,U.S. Senate,Evelyn Rogers,REP,160011,2,0,7,9,
Comanche,U.S. Senate,Rob Moye,REP,160011,0,0,0,0,
Comanche,U.S. Senate,D. Jean Mcbride-Samuels,REP,160011,0,0,1,1,
Comanche,U.S. Senate,Jim Inhofe,REP,160011,5,5,92,102,
Comanche,U.S. Senate,Erick Paul Wyatt,REP,160011,0,1,3,4,
Comanche,U.S. Senate,Andy Craig,REP,160011,0,0,0,0,
Comanche,U.S. Senate,T. Shannon,REP,160011,5,3,85,93,
Comanche,U.S. Senate,Randy Brogdon,REP,160011,1,0,1,2,
Comanche,U.S. Senate,Eric Mccray,REP,160011,0,0,0,0,
Comanche,U.S. Senate,Kevin Crow,REP,160011,0,0,0,0,
Comanche,U.S. Senate,James Lankford,REP,160011,1,3,17,21,
Comanche,U.S. Senate,Jason Weger,REP,160011,0,0,2,2,
Comanche,U.S. House,Anna Flatt,REP,160011,1,0,19,20,04
Comanche,U.S. House,Tom Cole,REP,160011,5,6,87,98,04
Comanche,State House,Jesse Robert Cross,REP,160011,3,3,60,66,62
Comanche,State House,John Michael Montgomery,REP,160011,3,3,42,48,62
Comanche,Superintendent of Public Instruction,John Cox,DEM,160013,2,4,44,50,
Comanche,Superintendent of Public Instruction,Jack Jr.,DEM,160013,4,1,24,29,
Comanche,Superintendent of Public Instruction,Ivan Holmes,DEM,160013,0,0,14,14,
Comanche,Superintendent of Public Instruction,Freda Deskin,DEM,160013,5,2,41,48,
Comanche,U.S. Senate,Patrick Michael Hayes,DEM,160013,1,2,27,30,
Comanche,U.S. Senate,Jim Rogers,DEM,160013,4,4,37,45,
Comanche,U.S. Senate,Connie Johnson,DEM,160013,6,1,60,67,
Comanche,U.S. House,Bert Smith,DEM,160013,10,6,105,121,04
Comanche,U.S. House,Tae Si,DEM,160013,2,1,23,26,04
Comanche,Governor,Dax Ewbank,REP,160013,0,2,10,12,
Comanche,Governor,Chad Moody,REP,160013,1,4,19,24,
Comanche,Governor,Mary Fallin,REP,160013,4,5,91,100,
Comanche,Superintendent of Public Instruction,Brian Kelly,REP,160013,0,3,32,35,
Comanche,Superintendent of Public Instruction,Janet Costello Barresi,REP,160013,5,4,51,60,
Comanche,Superintendent of Public Instruction,Joy Hofmeister,REP,160013,1,4,33,38,
Comanche,Insurance Commissioner,Bill Viner,REP,160013,0,4,34,38,
Comanche,Insurance Commissioner,John Doak,REP,160013,6,7,75,88,
Comanche,Corporation Commissioner,Todd Hiett,REP,160013,6,3,54,63,
Comanche,Corporation Commissioner,Cliff Branan,REP,160013,0,8,56,64,
Comanche,U.S. Senate,Evelyn Rogers,REP,160013,0,2,1,3,
Comanche,U.S. Senate,Rob Moye,REP,160013,0,0,4,4,
Comanche,U.S. Senate,D. Jean Mcbride-Samuels,REP,160013,0,0,3,3,
Comanche,U.S. Senate,Jim Inhofe,REP,160013,6,10,110,126,
Comanche,U.S. Senate,Erick Paul Wyatt,REP,160013,1,0,1,2,
Comanche,U.S. Senate,Andy Craig,REP,160013,0,0,0,0,
Comanche,U.S. Senate,T. Shannon,REP,160013,5,6,96,107,
Comanche,U.S. Senate,Randy Brogdon,REP,160013,0,1,5,6,
Comanche,U.S. Senate,Eric Mccray,REP,160013,0,2,1,3,
Comanche,U.S. Senate,Kevin Crow,REP,160013,0,0,2,2,
Comanche,U.S. Senate,James Lankford,REP,160013,2,3,14,19,
Comanche,U.S. Senate,Jason Weger,REP,160013,0,0,1,1,
Comanche,U.S. House,Anna Flatt,REP,160013,0,4,13,17,04
Comanche,U.S. House,Tom Cole,REP,160013,7,8,105,120,04
Comanche,Superintendent of Public Instruction,John Cox,DEM,160014,0,0,0,0,
Comanche,Superintendent of Public Instruction,Jack Jr.,DEM,160014,0,0,0,0,
Comanche,Superintendent of Public Instruction,Ivan Holmes,DEM,160014,0,0,0,0,
Comanche,Superintendent of Public Instruction,Freda Deskin,DEM,160014,0,0,0,0,
Comanche,U.S. Senate,Patrick Michael Hayes,DEM,160014,0,0,0,0,
Comanche,U.S. Senate,Jim Rogers,DEM,160014,0,0,0,0,
Comanche,U.S. Senate,Connie Johnson,DEM,160014,0,0,0,0,
Comanche,U.S. House,Bert Smith,DEM,160014,0,0,0,0,04
Comanche,U.S. House,Tae Si,DEM,160014,0,0,0,0,04
Comanche,Governor,Dax Ewbank,REP,160014,0,0,0,0,
Comanche,Governor,Chad Moody,REP,160014,0,0,0,0,
Comanche,Governor,Mary Fallin,REP,160014,1,0,0,1,
Comanche,Superintendent of Public Instruction,Brian Kelly,REP,160014,1,0,0,1,
Comanche,Superintendent of Public Instruction,Janet Costello Barresi,REP,160014,0,0,0,0,
Comanche,Superintendent of Public Instruction,Joy Hofmeister,REP,160014,0,0,0,0,
Comanche,Insurance Commissioner,Bill Viner,REP,160014,0,0,0,0,
Comanche,Insurance Commissioner,John Doak,REP,160014,1,0,0,1,
Comanche,Corporation Commissioner,Todd Hiett,REP,160014,1,0,0,1,
Comanche,Corporation Commissioner,Cliff Branan,REP,160014,0,0,0,0,
Comanche,U.S. Senate,Evelyn Rogers,REP,160014,0,0,0,0,
Comanche,U.S. Senate,Rob Moye,REP,160014,0,0,0,0,
Comanche,U.S. Senate,D. Jean Mcbride-Samuels,REP,160014,0,0,0,0,
Comanche,U.S. Senate,Jim Inhofe,REP,160014,1,0,0,1,
Comanche,U.S. Senate,Erick Paul Wyatt,REP,160014,0,0,0,0,
Comanche,U.S. Senate,Andy Craig,REP,160014,0,0,0,0,
Comanche,U.S. Senate,T. Shannon,REP,160014,0,0,0,0,
Comanche,U.S. Senate,Randy Brogdon,REP,160014,1,0,0,1,
Comanche,U.S. Senate,Eric Mccray,REP,160014,0,0,0,0,
Comanche,U.S. Senate,Kevin Crow,REP,160014,0,0,0,0,
Comanche,U.S. Senate,James Lankford,REP,160014,0,0,0,0,
Comanche,U.S. Senate,Jason Weger,REP,160014,0,0,0,0,
Comanche,U.S. House,Anna Flatt,REP,160014,0,0,0,0,04
Comanche,U.S. House,Tom Cole,REP,160014,1,0,0,1,04
Comanche,State House,Renae Sexton,REP,160014,0,0,0,0,65
Comanche,State House,Scott Hayes,REP,160014,1,0,0,1,65
Comanche,State House,Scooter Park,REP,160014,0,0,0,0,65
Comanche,State House,Stephen Mills,REP,160014,0,0,0,0,65
Comanche,Superintendent of Public Instruction,John Cox,DEM,160015,0,5,46,51,
Comanche,Superintendent of Public Instruction,Jack Jr.,DEM,160015,0,2,19,21,
Comanche,Superintendent of Public Instruction,Ivan Holmes,DEM,160015,0,4,21,25,
Comanche,Superintendent of Public Instruction,Freda Deskin,DEM,160015,0,4,36,40,
Comanche,U.S. Senate,Patrick Michael Hayes,DEM,160015,0,1,22,23,
Comanche,U.S. Senate,Jim Rogers,DEM,160015,0,5,35,40,
Comanche,U.S. Senate,Connie Johnson,DEM,160015,0,8,64,72,
Comanche,U.S. House,Bert Smith,DEM,160015,0,10,103,113,04
Comanche,U.S. House,Tae Si,DEM,160015,0,5,21,26,04
Comanche,Governor,Dax Ewbank,REP,160015,0,1,8,9,
Comanche,Governor,Chad Moody,REP,160015,0,1,19,20,
Comanche,Governor,Mary Fallin,REP,160015,2,18,99,119,
Comanche,Superintendent of Public Instruction,Brian Kelly,REP,160015,0,4,19,23,
Comanche,Superintendent of Public Instruction,Janet Costello Barresi,REP,160015,1,8,49,58,
Comanche,Superintendent of Public Instruction,Joy Hofmeister,REP,160015,1,8,59,68,
Comanche,Insurance Commissioner,Bill Viner,REP,160015,1,2,28,31,
Comanche,Insurance Commissioner,John Doak,REP,160015,1,16,91,108,
Comanche,Corporation Commissioner,Todd Hiett,REP,160015,2,12,55,69,
Comanche,Corporation Commissioner,Cliff Branan,REP,160015,0,7,62,69,
Comanche,U.S. Senate,Evelyn Rogers,REP,160015,0,0,3,3,
Comanche,U.S. Senate,Rob Moye,REP,160015,0,0,0,0,
Comanche,U.S. Senate,D. Jean Mcbride-Samuels,REP,160015,0,0,0,0,
Comanche,U.S. Senate,Jim Inhofe,REP,160015,2,19,120,141,
Comanche,U.S. Senate,Erick Paul Wyatt,REP,160015,0,1,3,4,
Comanche,U.S. Senate,Andy Craig,REP,160015,0,0,1,1,
Comanche,U.S. Senate,T. Shannon,REP,160015,1,13,89,103,
Comanche,U.S. Senate,Randy Brogdon,REP,160015,0,2,6,8,
Comanche,U.S. Senate,Eric Mccray,REP,160015,0,0,1,1,
Comanche,U.S. Senate,Kevin Crow,REP,160015,1,0,0,1,
Comanche,U.S. Senate,James Lankford,REP,160015,0,5,30,35,
Comanche,U.S. Senate,Jason Weger,REP,160015,0,0,1,1,
Comanche,U.S. House,Anna Flatt,REP,160015,0,1,16,17,04
Comanche,U.S. House,Tom Cole,REP,160015,2,19,111,132,04
Comanche,Superintendent of Public Instruction,John Cox,DEM,160017,2,2,69,73,
Comanche,Superintendent of Public Instruction,Jack Jr.,DEM,160017,2,3,25,30,
Comanche,Superintendent of Public Instruction,Ivan Holmes,DEM,160017,0,1,9,10,
Comanche,Superintendent of Public Instruction,Freda Deskin,DEM,160017,2,10,60,72,
Comanche,U.S. Senate,Patrick Michael Hayes,DEM,160017,1,4,30,35,
Comanche,U.S. Senate,Jim Rogers,DEM,160017,3,2,57,62,
Comanche,U.S. Senate,Connie Johnson,DEM,160017,2,10,78,90,
Comanche,U.S. House,Bert Smith,DEM,160017,6,12,126,144,04
Comanche,U.S. House,Tae Si,DEM,160017,0,4,38,42,04
Comanche,Governor,Dax Ewbank,REP,160017,2,0,7,9,
Comanche,Governor,Chad Moody,REP,160017,0,3,26,29,
Comanche,Governor,Mary Fallin,REP,160017,3,5,105,113,
Comanche,Superintendent of Public Instruction,Brian Kelly,REP,160017,0,2,23,25,
Comanche,Superintendent of Public Instruction,Janet Costello Barresi,REP,160017,2,3,41,46,
Comanche,Superintendent of Public Instruction,Joy Hofmeister,REP,160017,3,3,68,74,
Comanche,Insurance Commissioner,Bill Viner,REP,160017,2,1,30,33,
Comanche,Insurance Commissioner,John Doak,REP,160017,3,7,92,102,
Comanche,Corporation Commissioner,Todd Hiett,REP,160017,2,7,69,78,
Comanche,Corporation Commissioner,Cliff Branan,REP,160017,3,1,60,64,
Comanche,U.S. Senate,Evelyn Rogers,REP,160017,1,0,6,7,
Comanche,U.S. Senate,Rob Moye,REP,160017,0,0,3,3,
Comanche,U.S. Senate,D. Jean Mcbride-Samuels,REP,160017,0,0,3,3,
Comanche,U.S. Senate,Jim Inhofe,REP,160017,2,8,122,132,
Comanche,U.S. Senate,Erick Paul Wyatt,REP,160017,2,0,5,7,
Comanche,U.S. Senate,Andy Craig,REP,160017,0,1,2,3,
Comanche,U.S. Senate,T. Shannon,REP,160017,2,7,99,108,
Comanche,U.S. Senate,Randy Brogdon,REP,160017,0,0,2,2,
Comanche,U.S. Senate,Eric Mccray,REP,160017,0,0,1,1,
Comanche,U.S. Senate,Kevin Crow,REP,160017,0,0,2,2,
Comanche,U.S. Senate,James Lankford,REP,160017,2,0,34,36,
Comanche,U.S. Senate,Jason Weger,REP,160017,0,0,1,1,
Comanche,U.S. House,Anna Flatt,REP,160017,2,0,15,17,04
Comanche,U.S. House,Tom Cole,REP,160017,3,8,123,134,04
Comanche,Superintendent of Public Instruction,John Cox,DEM,160019,0,4,30,34,
Comanche,Superintendent of Public Instruction,Jack Jr.,DEM,160019,2,3,38,43,
Comanche,Superintendent of Public Instruction,Ivan Holmes,DEM,160019,0,2,5,7,
Comanche,Superintendent of Public Instruction,Freda Deskin,DEM,160019,0,5,20,25,
Comanche,U.S. Senate,Patrick Michael Hayes,DEM,160019,1,2,23,26,
Comanche,U.S. Senate,Jim Rogers,DEM,160019,0,5,34,39,
Comanche,U.S. Senate,Connie Johnson,DEM,160019,1,8,35,44,
Comanche,U.S. House,Bert Smith,DEM,160019,2,7,84,93,04
Comanche,U.S. House,Tae Si,DEM,160019,0,7,11,18,04
Comanche,Governor,Dax Ewbank,REP,160019,0,0,12,12,
Comanche,Governor,Chad Moody,REP,160019,0,3,16,19,
Comanche,Governor,Mary Fallin,REP,160019,0,4,69,73,
Comanche,Superintendent of Public Instruction,Brian Kelly,REP,160019,0,1,18,19,
Comanche,Superintendent of Public Instruction,Janet Costello Barresi,REP,160019,0,1,25,26,
Comanche,Superintendent of Public Instruction,Joy Hofmeister,REP,160019,0,5,53,58,
Comanche,Insurance Commissioner,Bill Viner,REP,160019,0,2,17,19,
Comanche,Insurance Commissioner,John Doak,REP,160019,0,5,72,77,
Comanche,Corporation Commissioner,Todd Hiett,REP,160019,0,4,53,57,
Comanche,Corporation Commissioner,Cliff Branan,REP,160019,0,2,33,35,
Comanche,U.S. Senate,Evelyn Rogers,REP,160019,0,0,2,2,
Comanche,U.S. Senate,Rob Moye,REP,160019,0,0,5,5,
Comanche,U.S. Senate,D. Jean Mcbride-Samuels,REP,160019,0,0,1,1,
Comanche,U.S. Senate,Jim Inhofe,REP,160019,0,6,85,91,
Comanche,U.S. Senate,Erick Paul Wyatt,REP,160019,0,1,3,4,
Comanche,U.S. Senate,Andy Craig,REP,160019,0,0,0,0,
Comanche,U.S. Senate,T. Shannon,REP,160019,0,4,75,79,
Comanche,U.S. Senate,Randy Brogdon,REP,160019,0,0,4,4,
Comanche,U.S. Senate,Eric Mccray,REP,160019,0,0,1,1,
Comanche,U.S. Senate,Kevin Crow,REP,160019,0,0,0,0,
Comanche,U.S. Senate,James Lankford,REP,160019,0,3,17,20,
Comanche,U.S. Senate,Jason Weger,REP,160019,0,0,1,1,
Comanche,U.S. House,Anna Flatt,REP,160019,0,5,16,21,04
Comanche,U.S. House,Tom Cole,REP,160019,0,2,82,84,04
Comanche,Superintendent of Public Instruction,John Cox,DEM,160020,0,2,21,23,
Comanche,Superintendent of Public Instruction,Jack Jr.,DEM,160020,0,2,13,15,
Comanche,Superintendent of Public Instruction,Ivan Holmes,DEM,160020,0,0,12,12,
Comanche,Superintendent of Public Instruction,Freda Deskin,DEM,160020,2,3,30,35,
Comanche,U.S. Senate,Patrick Michael Hayes,DEM,160020,0,2,14,16,
Comanche,U.S. Senate,Jim Rogers,DEM,160020,2,2,21,25,
Comanche,U.S. Senate,Connie Johnson,DEM,160020,0,3,41,44,
Comanche,U.S. House,Bert Smith,DEM,160020,2,5,57,64,04
Comanche,U.S. House,Tae Si,DEM,160020,0,2,20,22,04
Comanche,Governor,Dax Ewbank,REP,160020,0,0,3,3,
Comanche,Governor,Chad Moody,REP,160020,0,0,19,19,
Comanche,Governor,Mary Fallin,REP,160020,6,4,55,65,
Comanche,Superintendent of Public Instruction,Brian Kelly,REP,160020,3,0,18,21,
Comanche,Superintendent of Public Instruction,Janet Costello Barresi,REP,160020,2,2,22,26,
Comanche,Superintendent of Public Instruction,Joy Hofmeister,REP,160020,1,1,34,36,
Comanche,Insurance Commissioner,Bill Viner,REP,160020,3,0,23,26,
Comanche,Insurance Commissioner,John Doak,REP,160020,3,3,50,56,
Comanche,Corporation Commissioner,Todd Hiett,REP,160020,2,1,37,40,
Comanche,Corporation Commissioner,Cliff Branan,REP,160020,4,2,38,44,
Comanche,U.S. Senate,Evelyn Rogers,REP,160020,0,0,3,3,
Comanche,U.S. Senate,Rob Moye,REP,160020,2,0,1,3,
Comanche,U.S. Senate,D. Jean Mcbride-Samuels,REP,160020,0,0,0,0,
Comanche,U.S. Senate,Jim Inhofe,REP,160020,4,4,64,72,
Comanche,U.S. Senate,Erick Paul Wyatt,REP,160020,0,0,9,9,
Comanche,U.S. Senate,Andy Craig,REP,160020,0,0,0,0,
Comanche,U.S. Senate,T. Shannon,REP,160020,4,2,57,63,
Comanche,U.S. Senate,Randy Brogdon,REP,160020,0,0,1,1,
Comanche,U.S. Senate,Eric Mccray,REP,160020,1,0,1,2,
Comanche,U.S. Senate,Kevin Crow,REP,160020,1,0,0,1,
Comanche,U.S. Senate,James Lankford,REP,160020,0,2,18,20,
Comanche,U.S. Senate,Jason Weger,REP,160020,0,0,0,0,
Comanche,U.S. House,Anna Flatt,REP,160020,1,0,7,8,04
Comanche,U.S. House,Tom Cole,REP,160020,5,4,70,79,04
Comanche,Superintendent of Public Instruction,John Cox,DEM,160021,0,4,20,24,
Comanche,Superintendent of Public Instruction,Jack Jr.,DEM,160021,0,3,22,25,
Comanche,Superintendent of Public Instruction,Ivan Holmes,DEM,160021,0,1,11,12,
Comanche,Superintendent of Public Instruction,Freda Deskin,DEM,160021,1,2,23,26,
Comanche,U.S. Senate,Patrick Michael Hayes,DEM,160021,0,1,10,11,
Comanche,U.S. Senate,Jim Rogers,DEM,160021,0,2,29,31,
Comanche,U.S. Senate,Connie Johnson,DEM,160021,0,7,36,43,
Comanche,U.S. House,Bert Smith,DEM,160021,0,9,49,58,04
Comanche,U.S. House,Tae Si,DEM,160021,0,1,27,28,04
Comanche,Governor,Dax Ewbank,REP,160021,0,2,7,9,
Comanche,Governor,Chad Moody,REP,160021,0,0,12,12,
Comanche,Governor,Mary Fallin,REP,160021,0,5,44,49,
Comanche,Superintendent of Public Instruction,Brian Kelly,REP,160021,0,3,22,25,
Comanche,Superintendent of Public Instruction,Janet Costello Barresi,REP,160021,0,2,19,21,
Comanche,Superintendent of Public Instruction,Joy Hofmeister,REP,160021,0,2,20,22,
Comanche,Insurance Commissioner,Bill Viner,REP,160021,0,2,19,21,
Comanche,Insurance Commissioner,John Doak,REP,160021,0,5,38,43,
Comanche,Corporation Commissioner,Todd Hiett,REP,160021,0,5,32,37,
Comanche,Corporation Commissioner,Cliff Branan,REP,160021,0,1,23,24,
Comanche,U.S. Senate,Evelyn Rogers,REP,160021,0,1,5,6,
Comanche,U.S. Senate,Rob Moye,REP,160021,0,0,1,1,
Comanche,U.S. Senate,D. Jean Mcbride-Samuels,REP,160021,0,0,0,0,
Comanche,U.S. Senate,Jim Inhofe,REP,160021,0,4,53,57,
Comanche,U.S. Senate,Erick Paul Wyatt,REP,160021,0,2,2,4,
Comanche,U.S. Senate,Andy Craig,REP,160021,0,0,0,0,
Comanche,U.S. Senate,T. Shannon,REP,160021,0,4,47,51,
Comanche,U.S. Senate,Randy Brogdon,REP,160021,0,0,2,2,
Comanche,U.S. Senate,Eric Mccray,REP,160021,0,0,1,1,
Comanche,U.S. Senate,Kevin Crow,REP,160021,0,1,0,1,
Comanche,U.S. Senate,James Lankford,REP,160021,0,2,12,14,
Comanche,U.S. Senate,Jason Weger,REP,160021,0,0,0,0,
Comanche,U.S. House,Anna Flatt,REP,160021,0,3,11,14,04
Comanche,U.S. House,Tom Cole,REP,160021,0,4,51,55,04
Comanche,Superintendent of Public Instruction,John Cox,DEM,160025,1,0,19,20,
Comanche,Superintendent of Public Instruction,Jack Jr.,DEM,160025,0,0,19,19,
Comanche,Superintendent of Public Instruction,Ivan Holmes,DEM,160025,1,0,17,18,
Comanche,Superintendent of Public Instruction,Freda Deskin,DEM,160025,0,1,15,16,
Comanche,U.S. Senate,Patrick Michael Hayes,DEM,160025,0,0,12,12,
Comanche,U.S. Senate,Jim Rogers,DEM,160025,1,1,16,18,
Comanche,U.S. Senate,Connie Johnson,DEM,160025,1,0,44,45,
Comanche,U.S. House,Bert Smith,DEM,160025,2,0,53,55,04
Comanche,U.S. House,Tae Si,DEM,160025,0,1,12,13,04
Comanche,Governor,Dax Ewbank,REP,160025,0,0,0,0,
Comanche,Governor,Chad Moody,REP,160025,0,0,2,2,
Comanche,Governor,Mary Fallin,REP,160025,0,0,9,9,
Comanche,Superintendent of Public Instruction,Brian Kelly,REP,160025,0,0,4,4,
Comanche,Superintendent of Public Instruction,Janet Costello Barresi,REP,160025,0,0,1,1,
Comanche,Superintendent of Public Instruction,Joy Hofmeister,REP,160025,0,0,6,6,
Comanche,Insurance Commissioner,Bill Viner,REP,160025,0,0,4,4,
Comanche,Insurance Commissioner,John Doak,REP,160025,0,0,7,7,
Comanche,Corporation Commissioner,Todd Hiett,REP,160025,0,0,2,2,
Comanche,Corporation Commissioner,Cliff Branan,REP,160025,0,0,9,9,
Comanche,U.S. Senate,Evelyn Rogers,REP,160025,0,0,0,0,
Comanche,U.S. Senate,Rob Moye,REP,160025,0,0,1,1,
Comanche,U.S. Senate,D. Jean Mcbride-Samuels,REP,160025,0,0,0,0,
Comanche,U.S. Senate,Jim Inhofe,REP,160025,0,0,9,9,
Comanche,U.S. Senate,Erick Paul Wyatt,REP,160025,0,0,1,1,
Comanche,U.S. Senate,Andy Craig,REP,160025,0,0,0,0,
Comanche,U.S. Senate,T. Shannon,REP,160025,0,0,8,8,
Comanche,U.S. Senate,Randy Brogdon,REP,160025,0,0,0,0,
Comanche,U.S. Senate,Eric Mccray,REP,160025,0,0,1,1,
Comanche,U.S. Senate,Kevin Crow,REP,160025,0,0,0,0,
Comanche,U.S. Senate,James Lankford,REP,160025,0,0,2,2,
Comanche,U.S. Senate,Jason Weger,REP,160025,0,0,0,0,
Comanche,U.S. House,Anna Flatt,REP,160025,0,0,1,1,04
Comanche,U.S. House,Tom Cole,REP,160025,0,0,10,10,04
Comanche,State House,Jesse Robert Cross,REP,160025,0,0,2,2,62
Comanche,State House,John Michael Montgomery,REP,160025,0,0,9,9,62
Comanche,Superintendent of Public Instruction,John Cox,DEM,160026,0,1,22,23,
Comanche,Superintendent of Public Instruction,Jack Jr.,DEM,160026,0,0,11,11,
Comanche,Superintendent of Public Instruction,Ivan Holmes,DEM,160026,0,0,5,5,
Comanche,Superintendent of Public Instruction,Freda Deskin,DEM,160026,0,2,14,16,
Comanche,U.S. Senate,Patrick Michael Hayes,DEM,160026,0,0,7,7,
Comanche,U.S. Senate,Jim Rogers,DEM,160026,0,1,22,23,
Comanche,U.S. Senate,Connie Johnson,DEM,160026,0,2,23,25,
Comanche,U.S. House,Bert Smith,DEM,160026,0,3,41,44,04
Comanche,U.S. House,Tae Si,DEM,160026,0,0,9,9,04
Comanche,State House,B. L. Cozad Jr,DEM,160026,0,0,23,23,63
Comanche,State House,Juan Rodriguez,DEM,160026,0,3,24,27,63
Comanche,Governor,Dax Ewbank,REP,160026,0,0,3,3,
Comanche,Governor,Chad Moody,REP,160026,0,0,14,14,
Comanche,Governor,Mary Fallin,REP,160026,0,1,29,30,
Comanche,Superintendent of Public Instruction,Brian Kelly,REP,160026,0,0,16,16,
Comanche,Superintendent of Public Instruction,Janet Costello Barresi,REP,160026,0,1,16,17,
Comanche,Superintendent of Public Instruction,Joy Hofmeister,REP,160026,0,0,14,14,
Comanche,Insurance Commissioner,Bill Viner,REP,160026,0,0,9,9,
Comanche,Insurance Commissioner,John Doak,REP,160026,0,1,31,32,
Comanche,Corporation Commissioner,Todd Hiett,REP,160026,0,0,19,19,
Comanche,Corporation Commissioner,Cliff Branan,REP,160026,0,1,22,23,
Comanche,U.S. Senate,Evelyn Rogers,REP,160026,0,0,2,2,
Comanche,U.S. Senate,Rob Moye,REP,160026,0,0,0,0,
Comanche,U.S. Senate,D. Jean Mcbride-Samuels,REP,160026,0,0,2,2,
Comanche,U.S. Senate,Jim Inhofe,REP,160026,0,1,37,38,
Comanche,U.S. Senate,Erick Paul Wyatt,REP,160026,0,0,4,4,
Comanche,U.S. Senate,Andy Craig,REP,160026,0,0,0,0,
Comanche,U.S. Senate,T. Shannon,REP,160026,0,0,34,34,
Comanche,U.S. Senate,Randy Brogdon,REP,160026,0,0,0,0,
Comanche,U.S. Senate,Eric Mccray,REP,160026,0,1,0,1,
Comanche,U.S. Senate,Kevin Crow,REP,160026,0,0,2,2,
Comanche,U.S. Senate,James Lankford,REP,160026,0,0,8,8,
Comanche,U.S. Senate,Jason Weger,REP,160026,0,0,0,0,
Comanche,U.S. House,Anna Flatt,REP,160026,0,0,5,5,04
Comanche,U.S. House,Tom Cole,REP,160026,0,1,40,41,04
Comanche,State House,Jeff Coody,REP,160026,0,0,32,32,63
Comanche,State House,Hurchel Trey Caldwell,REP,160026,0,1,6,7,63
Comanche,State House,Greg Howard,REP,160026,0,0,5,5,63
Comanche,Superintendent of Public Instruction,John Cox,DEM,160027,0,1,10,11,
Comanche,Superintendent of Public Instruction,Jack Jr.,DEM,160027,0,3,4,7,
Comanche,Superintendent of Public Instruction,Ivan Holmes,DEM,160027,0,1,6,7,
Comanche,Superintendent of Public Instruction,Freda Deskin,DEM,160027,1,2,10,13,
Comanche,U.S. Senate,Patrick Michael Hayes,DEM,160027,0,5,9,14,
Comanche,U.S. Senate,Jim Rogers,DEM,160027,0,1,14,15,
Comanche,U.S. Senate,Connie Johnson,DEM,160027,1,1,10,12,
Comanche,U.S. House,Bert Smith,DEM,160027,0,5,29,34,04
Comanche,U.S. House,Tae Si,DEM,160027,1,2,5,8,04
Comanche,Governor,Dax Ewbank,REP,160027,0,0,4,4,
Comanche,Governor,Chad Moody,REP,160027,0,0,7,7,
Comanche,Governor,Mary Fallin,REP,160027,2,2,14,18,
Comanche,Superintendent of Public Instruction,Brian Kelly,REP,160027,0,1,5,6,
Comanche,Superintendent of Public Instruction,Janet Costello Barresi,REP,160027,1,1,7,9,
Comanche,Superintendent of Public Instruction,Joy Hofmeister,REP,160027,1,0,12,13,
Comanche,Insurance Commissioner,Bill Viner,REP,160027,0,2,7,9,
Comanche,Insurance Commissioner,John Doak,REP,160027,2,0,15,17,
Comanche,Corporation Commissioner,Todd Hiett,REP,160027,1,2,12,15,
Comanche,Corporation Commissioner,Cliff Branan,REP,160027,1,0,9,10,
Comanche,U.S. Senate,Evelyn Rogers,REP,160027,0,0,2,2,
Comanche,U.S. Senate,Rob Moye,REP,160027,0,0,0,0,
Comanche,U.S. Senate,D. Jean Mcbride-Samuels,REP,160027,0,0,0,0,
Comanche,U.S. Senate,Jim Inhofe,REP,160027,1,2,21,24,
Comanche,U.S. Senate,Erick Paul Wyatt,REP,160027,1,0,3,4,
Comanche,U.S. Senate,Andy Craig,REP,160027,0,0,0,0,
Comanche,U.S. Senate,T. Shannon,REP,160027,2,1,19,22,
Comanche,U.S. Senate,Randy Brogdon,REP,160027,0,0,0,0,
Comanche,U.S. Senate,Eric Mccray,REP,160027,0,0,3,3,
Comanche,U.S. Senate,Kevin Crow,REP,160027,0,0,0,0,
Comanche,U.S. Senate,James Lankford,REP,160027,0,1,3,4,
Comanche,U.S. Senate,Jason Weger,REP,160027,0,0,0,0,
Comanche,U.S. House,Anna Flatt,REP,160027,0,0,5,5,04
Comanche,U.S. House,Tom Cole,REP,160027,2,2,19,23,04
Comanche,Superintendent of Public Instruction,John Cox,DEM,160029,0,0,25,25,
Comanche,Superintendent of Public Instruction,Jack Jr.,DEM,160029,0,0,9,9,
Comanche,Superintendent of Public Instruction,Ivan Holmes,DEM,160029,0,0,14,14,
Comanche,Superintendent of Public Instruction,Freda Deskin,DEM,160029,0,0,23,23,
Comanche,U.S. Senate,Patrick Michael Hayes,DEM,160029,0,0,13,13,
Comanche,U.S. Senate,Jim Rogers,DEM,160029,0,0,16,16,
Comanche,U.S. Senate,Connie Johnson,DEM,160029,0,0,48,48,
Comanche,U.S. House,Bert Smith,DEM,160029,0,0,49,49,04
Comanche,U.S. House,Tae Si,DEM,160029,0,0,19,19,04
Comanche,State House,B. L. Cozad Jr,DEM,160029,0,0,25,25,63
Comanche,State House,Juan Rodriguez,DEM,160029,0,0,44,44,63
Comanche,Governor,Dax Ewbank,REP,160029,0,1,0,1,
Comanche,Governor,Chad Moody,REP,160029,0,0,3,3,
Comanche,Governor,Mary Fallin,REP,160029,0,2,9,11,
Comanche,Superintendent of Public Instruction,Brian Kelly,REP,160029,0,1,4,5,
Comanche,Superintendent of Public Instruction,Janet Costello Barresi,REP,160029,0,2,0,2,
Comanche,Superintendent of Public Instruction,Joy Hofmeister,REP,160029,0,0,7,7,
Comanche,Insurance Commissioner,Bill Viner,REP,160029,0,0,1,1,
Comanche,Insurance Commissioner,John Doak,REP,160029,0,2,11,13,
Comanche,Corporation Commissioner,Todd Hiett,REP,160029,0,2,8,10,
Comanche,Corporation Commissioner,Cliff Branan,REP,160029,0,0,2,2,
Comanche,U.S. Senate,Evelyn Rogers,REP,160029,0,0,0,0,
Comanche,U.S. Senate,Rob Moye,REP,160029,0,0,0,0,
Comanche,U.S. Senate,D. Jean Mcbride-Samuels,REP,160029,0,0,0,0,
Comanche,U.S. Senate,Jim Inhofe,REP,160029,0,2,11,13,
Comanche,U.S. Senate,Erick Paul Wyatt,REP,160029,0,1,0,1,
Comanche,U.S. Senate,Andy Craig,REP,160029,0,0,0,0,
Comanche,U.S. Senate,T. Shannon,REP,160029,0,3,5,8,
Comanche,U.S. Senate,Randy Brogdon,REP,160029,0,0,1,1,
Comanche,U.S. Senate,Eric Mccray,REP,160029,0,0,0,0,
Comanche,U.S. Senate,Kevin Crow,REP,160029,0,0,0,0,
Comanche,U.S. Senate,James Lankford,REP,160029,0,0,5,5,
Comanche,U.S. Senate,Jason Weger,REP,160029,0,0,0,0,
Comanche,U.S. House,Anna Flatt,REP,160029,0,0,1,1,04
Comanche,U.S. House,Tom Cole,REP,160029,0,3,11,14,04
Comanche,State House,Jeff Coody,REP,160029,0,2,9,11,63
Comanche,State House,Hurchel Trey Caldwell,REP,160029,0,1,1,2,63
Comanche,State House,Greg Howard,REP,160029,0,0,2,2,63
Comanche,Superintendent of Public Instruction,John Cox,DEM,160030,0,0,8,8,
Comanche,Superintendent of Public Instruction,Jack Jr.,DEM,160030,0,0,8,8,
Comanche,Superintendent of Public Instruction,Ivan Holmes,DEM,160030,0,0,2,2,
Comanche,Superintendent of Public Instruction,Freda Deskin,DEM,160030,0,1,22,23,
Comanche,U.S. Senate,Patrick Michael Hayes,DEM,160030,0,0,9,9,
Comanche,U.S. Senate,Jim Rogers,DEM,160030,0,0,6,6,
Comanche,U.S. Senate,Connie Johnson,DEM,160030,0,0,27,27,
Comanche,U.S. House,Bert Smith,DEM,160030,0,1,31,32,04
Comanche,U.S. House,Tae Si,DEM,160030,0,0,11,11,04
Comanche,Governor,Dax Ewbank,REP,160030,0,0,1,1,
Comanche,Governor,Chad Moody,REP,160030,0,0,7,7,
Comanche,Governor,Mary Fallin,REP,160030,0,3,21,24,
Comanche,Superintendent of Public Instruction,Brian Kelly,REP,160030,0,0,2,2,
Comanche,Superintendent of Public Instruction,Janet Costello Barresi,REP,160030,0,1,8,9,
Comanche,Superintendent of Public Instruction,Joy Hofmeister,REP,160030,0,2,19,21,
Comanche,Insurance Commissioner,Bill Viner,REP,160030,0,1,5,6,
Comanche,Insurance Commissioner,John Doak,REP,160030,0,2,23,25,
Comanche,Corporation Commissioner,Todd Hiett,REP,160030,0,2,15,17,
Comanche,Corporation Commissioner,Cliff Branan,REP,160030,0,1,13,14,
Comanche,U.S. Senate,Evelyn Rogers,REP,160030,0,0,2,2,
Comanche,U.S. Senate,Rob Moye,REP,160030,0,0,0,0,
Comanche,U.S. Senate,D. Jean Mcbride-Samuels,REP,160030,0,0,0,0,
Comanche,U.S. Senate,Jim Inhofe,REP,160030,0,3,26,29,
Comanche,U.S. Senate,Erick Paul Wyatt,REP,160030,0,0,0,0,
Comanche,U.S. Senate,Andy Craig,REP,160030,0,0,0,0,
Comanche,U.S. Senate,T. Shannon,REP,160030,0,3,25,28,
Comanche,U.S. Senate,Randy Brogdon,REP,160030,0,0,0,0,
Comanche,U.S. Senate,Eric Mccray,REP,160030,0,0,0,0,
Comanche,U.S. Senate,Kevin Crow,REP,160030,0,0,0,0,
Comanche,U.S. Senate,James Lankford,REP,160030,0,0,3,3,
Comanche,U.S. Senate,Jason Weger,REP,160030,0,0,1,1,
Comanche,U.S. House,Anna Flatt,REP,160030,0,0,2,2,04
Comanche,U.S. House,Tom Cole,REP,160030,0,3,27,30,04
Comanche,State House,Renae Sexton,REP,160030,0,0,11,11,65
Comanche,State House,Scott Hayes,REP,160030,0,2,5,7,65
Comanche,State House,Scooter Park,REP,160030,0,1,13,14,65
Comanche,State House,Stephen Mills,REP,160030,0,0,0,0,65
Comanche,Superintendent of Public Instruction,John Cox,DEM,160031,1,12,74,87,
Comanche,Superintendent of Public Instruction,Jack Jr.,DEM,160031,1,6,52,59,
Comanche,Superintendent of Public Instruction,Ivan Holmes,DEM,160031,1,8,23,32,
Comanche,Superintendent of Public Instruction,Freda Deskin,DEM,160031,3,7,79,89,
Comanche,U.S. Senate,Patrick Michael Hayes,DEM,160031,0,9,48,57,
Comanche,U.S. Senate,Jim Rogers,DEM,160031,2,11,69,82,
Comanche,U.S. Senate,Connie Johnson,DEM,160031,4,15,110,129,
Comanche,U.S. House,Bert Smith,DEM,160031,4,28,178,210,04
Comanche,U.S. House,Tae Si,DEM,160031,2,7,45,54,04
Comanche,Governor,Dax Ewbank,REP,160031,2,2,24,28,
Comanche,Governor,Chad Moody,REP,160031,2,13,68,83,
Comanche,Governor,Mary Fallin,REP,160031,6,62,308,376,
Comanche,Superintendent of Public Instruction,Brian Kelly,REP,160031,0,11,102,113,
Comanche,Superintendent of Public Instruction,Janet Costello Barresi,REP,160031,1,20,95,116,
Comanche,Superintendent of Public Instruction,Joy Hofmeister,REP,160031,9,45,188,242,
Comanche,Insurance Commissioner,Bill Viner,REP,160031,2,11,93,106,
Comanche,Insurance Commissioner,John Doak,REP,160031,8,62,272,342,
Comanche,Corporation Commissioner,Todd Hiett,REP,160031,5,53,218,276,
Comanche,Corporation Commissioner,Cliff Branan,REP,160031,5,20,153,178,
Comanche,U.S. Senate,Evelyn Rogers,REP,160031,0,3,16,19,
Comanche,U.S. Senate,Rob Moye,REP,160031,0,0,4,4,
Comanche,U.S. Senate,D. Jean Mcbride-Samuels,REP,160031,1,1,6,8,
Comanche,U.S. Senate,Jim Inhofe,REP,160031,8,72,353,433,
Comanche,U.S. Senate,Erick Paul Wyatt,REP,160031,1,3,21,25,
Comanche,U.S. Senate,Andy Craig,REP,160031,0,0,1,1,
Comanche,U.S. Senate,T. Shannon,REP,160031,3,44,264,311,
Comanche,U.S. Senate,Randy Brogdon,REP,160031,0,2,8,10,
Comanche,U.S. Senate,Eric Mccray,REP,160031,0,1,1,2,
Comanche,U.S. Senate,Kevin Crow,REP,160031,0,2,1,3,
Comanche,U.S. Senate,James Lankford,REP,160031,7,30,126,163,
Comanche,U.S. Senate,Jason Weger,REP,160031,0,0,3,3,
Comanche,U.S. House,Anna Flatt,REP,160031,2,7,46,55,04
Comanche,U.S. House,Tom Cole,REP,160031,8,71,353,432,04
Comanche,Superintendent of Public Instruction,John Cox,DEM,160032,0,0,11,11,
Comanche,Superintendent of Public Instruction,Jack Jr.,DEM,160032,0,0,4,4,
Comanche,Superintendent of Public Instruction,Ivan Holmes,DEM,160032,0,0,6,6,
Comanche,Superintendent of Public Instruction,Freda Deskin,DEM,160032,0,1,10,11,
Comanche,U.S. Senate,Patrick Michael Hayes,DEM,160032,0,0,2,2,
Comanche,U.S. Senate,Jim Rogers,DEM,160032,0,1,7,8,
Comanche,U.S. Senate,Connie Johnson,DEM,160032,0,0,26,26,
Comanche,U.S. House,Bert Smith,DEM,160032,0,1,20,21,04
Comanche,U.S. House,Tae Si,DEM,160032,0,0,12,12,04
Comanche,Governor,Dax Ewbank,REP,160032,0,0,0,0,
Comanche,Governor,Chad Moody,REP,160032,0,0,1,1,
Comanche,Governor,Mary Fallin,REP,160032,0,0,0,0,
Comanche,Superintendent of Public Instruction,Brian Kelly,REP,160032,0,0,0,0,
Comanche,Superintendent of Public Instruction,Janet Costello Barresi,REP,160032,0,0,0,0,
Comanche,Superintendent of Public Instruction,Joy Hofmeister,REP,160032,0,0,1,1,
Comanche,Insurance Commissioner,Bill Viner,REP,160032,0,0,0,0,
Comanche,Insurance Commissioner,John Doak,REP,160032,0,0,1,1,
Comanche,Corporation Commissioner,Todd Hiett,REP,160032,0,0,1,1,
Comanche,Corporation Commissioner,Cliff Branan,REP,160032,0,0,0,0,
Comanche,U.S. Senate,Evelyn Rogers,REP,160032,0,0,0,0,
Comanche,U.S. Senate,Rob Moye,REP,160032,0,0,0,0,
Comanche,U.S. Senate,D. Jean Mcbride-Samuels,REP,160032,0,0,0,0,
Comanche,U.S. Senate,Jim Inhofe,REP,160032,0,0,1,1,
Comanche,U.S. Senate,Erick Paul Wyatt,REP,160032,0,0,0,0,
Comanche,U.S. Senate,Andy Craig,REP,160032,0,0,0,0,
Comanche,U.S. Senate,T. Shannon,REP,160032,0,0,1,1,
Comanche,U.S. Senate,Randy Brogdon,REP,160032,0,0,0,0,
Comanche,U.S. Senate,Eric Mccray,REP,160032,0,0,0,0,
Comanche,U.S. Senate,Kevin Crow,REP,160032,0,0,0,0,
Comanche,U.S. Senate,James Lankford,REP,160032,0,0,0,0,
Comanche,U.S. Senate,Jason Weger,REP,160032,0,0,0,0,
Comanche,U.S. House,Anna Flatt,REP,160032,0,0,0,0,04
Comanche,U.S. House,Tom Cole,REP,160032,0,0,1,1,04
Comanche,Superintendent of Public Instruction,John Cox,DEM,160033,2,0,11,13,
Comanche,Superintendent of Public Instruction,Jack Jr.,DEM,160033,2,0,8,10,
Comanche,Superintendent of Public Instruction,Ivan Holmes,DEM,160033,1,0,6,7,
Comanche,Superintendent of Public Instruction,Freda Deskin,DEM,160033,3,0,16,19,
Comanche,U.S. Senate,Patrick Michael Hayes,DEM,160033,2,0,10,12,
Comanche,U.S. Senate,Jim Rogers,DEM,160033,2,0,8,10,
Comanche,U.S. Senate,Connie Johnson,DEM,160033,4,0,24,28,
Comanche,U.S. House,Bert Smith,DEM,160033,7,0,34,41,04
Comanche,U.S. House,Tae Si,DEM,160033,1,0,8,9,04
Comanche,Governor,Dax Ewbank,REP,160033,0,1,5,6,
Comanche,Governor,Chad Moody,REP,160033,0,0,10,10,
Comanche,Governor,Mary Fallin,REP,160033,3,4,50,57,
Comanche,Superintendent of Public Instruction,Brian Kelly,REP,160033,1,0,15,16,
Comanche,Superintendent of Public Instruction,Janet Costello Barresi,REP,160033,2,3,17,22,
Comanche,Superintendent of Public Instruction,Joy Hofmeister,REP,160033,0,2,29,31,
Comanche,Insurance Commissioner,Bill Viner,REP,160033,1,2,13,16,
Comanche,Insurance Commissioner,John Doak,REP,160033,2,3,47,52,
Comanche,Corporation Commissioner,Todd Hiett,REP,160033,1,3,30,34,
Comanche,Corporation Commissioner,Cliff Branan,REP,160033,1,1,27,29,
Comanche,U.S. Senate,Evelyn Rogers,REP,160033,0,1,0,1,
Comanche,U.S. Senate,Rob Moye,REP,160033,0,0,3,3,
Comanche,U.S. Senate,D. Jean Mcbride-Samuels,REP,160033,0,0,2,2,
Comanche,U.S. Senate,Jim Inhofe,REP,160033,3,3,60,66,
Comanche,U.S. Senate,Erick Paul Wyatt,REP,160033,0,1,0,1,
Comanche,U.S. Senate,Andy Craig,REP,160033,0,0,0,0,
Comanche,U.S. Senate,T. Shannon,REP,160033,2,3,44,49,
Comanche,U.S. Senate,Randy Brogdon,REP,160033,0,0,2,2,
Comanche,U.S. Senate,Eric Mccray,REP,160033,0,0,1,1,
Comanche,U.S. Senate,Kevin Crow,REP,160033,0,0,0,0,
Comanche,U.S. Senate,James Lankford,REP,160033,1,2,17,20,
Comanche,U.S. Senate,Jason Weger,REP,160033,0,0,1,1,
Comanche,U.S. House,Anna Flatt,REP,160033,0,1,14,15,04
Comanche,U.S. House,Tom Cole,REP,160033,3,4,51,58,04
Comanche,Superintendent of Public Instruction,John Cox,DEM,160034,2,5,52,59,
Comanche,Superintendent of Public Instruction,Jack Jr.,DEM,160034,0,1,35,36,
Comanche,Superintendent of Public Instruction,Ivan Holmes,DEM,160034,0,1,17,18,
Comanche,Superintendent of Public Instruction,Freda Deskin,DEM,160034,1,7,42,50,
Comanche,U.S. Senate,Patrick Michael Hayes,DEM,160034,1,2,26,29,
Comanche,U.S. Senate,Jim Rogers,DEM,160034,1,7,46,54,
Comanche,U.S. Senate,Connie Johnson,DEM,160034,1,6,75,82,
Comanche,U.S. House,Bert Smith,DEM,160034,3,15,108,126,04
Comanche,U.S. House,Tae Si,DEM,160034,0,0,38,38,04
Comanche,State House,B. L. Cozad Jr,DEM,160034,2,4,51,57,63
Comanche,State House,Juan Rodriguez,DEM,160034,1,8,88,97,63
Comanche,Governor,Dax Ewbank,REP,160034,0,1,8,9,
Comanche,Governor,Chad Moody,REP,160034,2,2,36,40,
Comanche,Governor,Mary Fallin,REP,160034,1,26,166,193,
Comanche,Superintendent of Public Instruction,Brian Kelly,REP,160034,2,6,56,64,
Comanche,Superintendent of Public Instruction,Janet Costello Barresi,REP,160034,0,5,59,64,
Comanche,Superintendent of Public Instruction,Joy Hofmeister,REP,160034,1,16,90,107,
Comanche,Insurance Commissioner,Bill Viner,REP,160034,2,4,56,62,
Comanche,Insurance Commissioner,John Doak,REP,160034,0,23,141,164,
Comanche,Corporation Commissioner,Todd Hiett,REP,160034,0,16,114,130,
Comanche,Corporation Commissioner,Cliff Branan,REP,160034,2,12,82,96,
Comanche,U.S. Senate,Evelyn Rogers,REP,160034,0,1,12,13,
Comanche,U.S. Senate,Rob Moye,REP,160034,0,1,3,4,
Comanche,U.S. Senate,D. Jean Mcbride-Samuels,REP,160034,0,0,3,3,
Comanche,U.S. Senate,Jim Inhofe,REP,160034,3,26,185,214,
Comanche,U.S. Senate,Erick Paul Wyatt,REP,160034,0,0,3,3,
Comanche,U.S. Senate,Andy Craig,REP,160034,0,0,1,1,
Comanche,U.S. Senate,T. Shannon,REP,160034,3,17,140,160,
Comanche,U.S. Senate,Randy Brogdon,REP,160034,0,1,4,5,
Comanche,U.S. Senate,Eric Mccray,REP,160034,0,0,3,3,
Comanche,U.S. Senate,Kevin Crow,REP,160034,0,0,2,2,
Comanche,U.S. Senate,James Lankford,REP,160034,0,11,58,69,
Comanche,U.S. Senate,Jason Weger,REP,160034,0,0,2,2,
Comanche,U.S. House,Anna Flatt,REP,160034,0,5,34,39,04
Comanche,U.S. House,Tom Cole,REP,160034,3,24,173,200,04
Comanche,State House,Jeff Coody,REP,160034,2,22,123,147,63
Comanche,State House,Hurchel Trey Caldwell,REP,160034,0,2,40,42,63
Comanche,State House,Greg Howard,REP,160034,0,4,40,44,63
Comanche,Superintendent of Public Instruction,John Cox,DEM,160035,0,1,17,18,
Comanche,Superintendent of Public Instruction,Jack Jr.,DEM,160035,0,2,14,16,
Comanche,Superintendent of Public Instruction,Ivan Holmes,DEM,160035,0,0,2,2,
Comanche,Superintendent of Public Instruction,Freda Deskin,DEM,160035,0,1,22,23,
Comanche,U.S. Senate,Patrick Michael Hayes,DEM,160035,0,2,19,21,
Comanche,U.S. Senate,Jim Rogers,DEM,160035,0,1,11,12,
Comanche,U.S. Senate,Connie Johnson,DEM,160035,0,1,24,25,
Comanche,U.S. House,Bert Smith,DEM,160035,0,4,36,40,04
Comanche,U.S. House,Tae Si,DEM,160035,0,0,18,18,04
Comanche,State House,B. L. Cozad Jr,DEM,160035,0,1,16,17,63
Comanche,State House,Juan Rodriguez,DEM,160035,0,2,39,41,63
Comanche,Governor,Dax Ewbank,REP,160035,0,0,5,5,
Comanche,Governor,Chad Moody,REP,160035,1,0,12,13,
Comanche,Governor,Mary Fallin,REP,160035,1,6,53,60,
Comanche,Superintendent of Public Instruction,Brian Kelly,REP,160035,2,1,20,23,
Comanche,Superintendent of Public Instruction,Janet Costello Barresi,REP,160035,0,3,18,21,
Comanche,Superintendent of Public Instruction,Joy Hofmeister,REP,160035,0,1,26,27,
Comanche,Insurance Commissioner,Bill Viner,REP,160035,1,1,19,21,
Comanche,Insurance Commissioner,John Doak,REP,160035,1,4,39,44,
Comanche,Corporation Commissioner,Todd Hiett,REP,160035,0,3,39,42,
Comanche,Corporation Commissioner,Cliff Branan,REP,160035,2,2,24,28,
Comanche,U.S. Senate,Evelyn Rogers,REP,160035,0,0,3,3,
Comanche,U.S. Senate,Rob Moye,REP,160035,0,0,1,1,
Comanche,U.S. Senate,D. Jean Mcbride-Samuels,REP,160035,0,0,2,2,
Comanche,U.S. Senate,Jim Inhofe,REP,160035,2,6,59,67,
Comanche,U.S. Senate,Erick Paul Wyatt,REP,160035,0,0,5,5,
Comanche,U.S. Senate,Andy Craig,REP,160035,1,0,0,1,
Comanche,U.S. Senate,T. Shannon,REP,160035,0,5,54,59,
Comanche,U.S. Senate,Randy Brogdon,REP,160035,0,0,5,5,
Comanche,U.S. Senate,Eric Mccray,REP,160035,0,0,0,0,
Comanche,U.S. Senate,Kevin Crow,REP,160035,0,0,1,1,
Comanche,U.S. Senate,James Lankford,REP,160035,1,0,11,12,
Comanche,U.S. Senate,Jason Weger,REP,160035,0,0,1,1,
Comanche,U.S. House,Anna Flatt,REP,160035,0,0,14,14,04
Comanche,U.S. House,Tom Cole,REP,160035,2,6,57,65,04
Comanche,State House,Jeff Coody,REP,160035,0,4,55,59,63
Comanche,State House,Hurchel Trey Caldwell,REP,160035,0,1,6,7,63
Comanche,State House,Greg Howard,REP,160035,2,0,12,14,63
Comanche,Superintendent of Public Instruction,John Cox,DEM,160036,0,0,15,15,
Comanche,Superintendent of Public Instruction,Jack Jr.,DEM,160036,0,0,3,3,
Comanche,Superintendent of Public Instruction,Ivan Holmes,DEM,160036,0,1,2,3,
Comanche,Superintendent of Public Instruction,Freda Deskin,DEM,160036,0,0,13,13,
Comanche,U.S. Senate,Patrick Michael Hayes,DEM,160036,0,0,7,7,
Comanche,U.S. Senate,Jim Rogers,DEM,160036,0,0,8,8,
Comanche,U.S. Senate,Connie Johnson,DEM,160036,0,1,18,19,
Comanche,U.S. House,Bert Smith,DEM,160036,0,0,21,21,04
Comanche,U.S. House,Tae Si,DEM,160036,0,1,14,15,04
Comanche,State House,B. L. Cozad Jr,DEM,160036,0,0,5,5,63
Comanche,State House,Juan Rodriguez,DEM,160036,0,1,29,30,63
Comanche,Governor,Dax Ewbank,REP,160036,2,0,1,3,
Comanche,Governor,Chad Moody,REP,160036,0,0,10,10,
Comanche,Governor,Mary Fallin,REP,160036,1,0,60,61,
Comanche,Superintendent of Public Instruction,Brian Kelly,REP,160036,0,0,19,19,
Comanche,Superintendent of Public Instruction,Janet Costello Barresi,REP,160036,0,0,24,24,
Comanche,Superintendent of Public Instruction,Joy Hofmeister,REP,160036,3,0,29,32,
Comanche,Insurance Commissioner,Bill Viner,REP,160036,1,0,15,16,
Comanche,Insurance Commissioner,John Doak,REP,160036,2,0,49,51,
Comanche,Corporation Commissioner,Todd Hiett,REP,160036,1,0,32,33,
Comanche,Corporation Commissioner,Cliff Branan,REP,160036,2,0,33,35,
Comanche,U.S. Senate,Evelyn Rogers,REP,160036,0,0,8,8,
Comanche,U.S. Senate,Rob Moye,REP,160036,0,0,1,1,
Comanche,U.S. Senate,D. Jean Mcbride-Samuels,REP,160036,0,0,2,2,
Comanche,U.S. Senate,Jim Inhofe,REP,160036,3,0,59,62,
Comanche,U.S. Senate,Erick Paul Wyatt,REP,160036,0,0,2,2,
Comanche,U.S. Senate,Andy Craig,REP,160036,0,0,0,0,
Comanche,U.S. Senate,T. Shannon,REP,160036,2,0,54,56,
Comanche,U.S. Senate,Randy Brogdon,REP,160036,0,0,2,2,
Comanche,U.S. Senate,Eric Mccray,REP,160036,0,0,0,0,
Comanche,U.S. Senate,Kevin Crow,REP,160036,0,0,0,0,
Comanche,U.S. Senate,James Lankford,REP,160036,1,0,15,16,
Comanche,U.S. Senate,Jason Weger,REP,160036,0,0,1,1,
Comanche,U.S. House,Anna Flatt,REP,160036,0,0,18,18,04
Comanche,U.S. House,Tom Cole,REP,160036,3,0,54,57,04
Comanche,State House,Jeff Coody,REP,160036,1,0,37,38,63
Comanche,State House,Hurchel Trey Caldwell,REP,160036,0,0,12,12,63
Comanche,State House,Greg Howard,REP,160036,2,0,24,26,63
Comanche,Superintendent of Public Instruction,John Cox,DEM,160037,0,0,20,20,
Comanche,Superintendent of Public Instruction,Jack Jr.,DEM,160037,0,0,6,6,
Comanche,Superintendent of Public Instruction,Ivan Holmes,DEM,160037,0,0,6,6,
Comanche,Superintendent of Public Instruction,Freda Deskin,DEM,160037,0,0,9,9,
Comanche,U.S. Senate,Patrick Michael Hayes,DEM,160037,0,0,17,17,
Comanche,U.S. Senate,Jim Rogers,DEM,160037,0,0,15,15,
Comanche,U.S. Senate,Connie Johnson,DEM,160037,0,0,7,7,
Comanche,U.S. House,Bert Smith,DEM,160037,0,0,37,37,04
Comanche,U.S. House,Tae Si,DEM,160037,0,0,4,4,04
Comanche,State House,B. L. Cozad Jr,DEM,160037,0,0,19,19,63
Comanche,State House,Juan Rodriguez,DEM,160037,0,0,19,19,63
Comanche,Governor,Dax Ewbank,REP,160037,0,0,8,8,
Comanche,Governor,Chad Moody,REP,160037,0,0,6,6,
Comanche,Governor,Mary Fallin,REP,160037,0,1,30,31,
Comanche,Superintendent of Public Instruction,Brian Kelly,REP,160037,0,0,14,14,
Comanche,Superintendent of Public Instruction,Janet Costello Barresi,REP,160037,0,0,8,8,
Comanche,Superintendent of Public Instruction,Joy Hofmeister,REP,160037,0,1,22,23,
Comanche,Insurance Commissioner,Bill Viner,REP,160037,0,0,14,14,
Comanche,Insurance Commissioner,John Doak,REP,160037,0,1,28,29,
Comanche,Corporation Commissioner,Todd Hiett,REP,160037,0,1,25,26,
Comanche,Corporation Commissioner,Cliff Branan,REP,160037,0,0,18,18,
Comanche,U.S. Senate,Evelyn Rogers,REP,160037,0,0,3,3,
Comanche,U.S. Senate,Rob Moye,REP,160037,0,0,1,1,
Comanche,U.S. Senate,D. Jean Mcbride-Samuels,REP,160037,0,0,1,1,
Comanche,U.S. Senate,Jim Inhofe,REP,160037,0,1,38,39,
Comanche,U.S. Senate,Erick Paul Wyatt,REP,160037,0,0,2,2,
Comanche,U.S. Senate,Andy Craig,REP,160037,0,0,0,0,
Comanche,U.S. Senate,T. Shannon,REP,160037,0,1,28,29,
Comanche,U.S. Senate,Randy Brogdon,REP,160037,0,0,4,4,
Comanche,U.S. Senate,Eric Mccray,REP,160037,0,0,1,1,
Comanche,U.S. Senate,Kevin Crow,REP,160037,0,0,1,1,
Comanche,U.S. Senate,James Lankford,REP,160037,0,0,12,12,
Comanche,U.S. Senate,Jason Weger,REP,160037,0,0,0,0,
Comanche,U.S. House,Anna Flatt,REP,160037,0,0,5,5,04
Comanche,U.S. House,Tom Cole,REP,160037,0,1,40,41,04
Comanche,State House,Jeff Coody,REP,160037,0,1,29,30,63
Comanche,State House,Hurchel Trey Caldwell,REP,160037,0,0,8,8,63
Comanche,State House,Greg Howard,REP,160037,0,0,8,8,63
Comanche,Superintendent of Public Instruction,John Cox,DEM,160038,3,9,98,110,
Comanche,Superintendent of Public Instruction,Jack Jr.,DEM,160038,1,3,56,60,
Comanche,Superintendent of Public Instruction,Ivan Holmes,DEM,160038,0,2,19,21,
Comanche,Superintendent of Public Instruction,Freda Deskin,DEM,160038,0,2,53,55,
Comanche,U.S. Senate,Patrick Michael Hayes,DEM,160038,0,5,95,100,
Comanche,U.S. Senate,Jim Rogers,DEM,160038,2,5,58,65,
Comanche,U.S. Senate,Connie Johnson,DEM,160038,2,7,71,80,
Comanche,U.S. House,Bert Smith,DEM,160038,4,14,198,216,04
Comanche,U.S. House,Tae Si,DEM,160038,0,2,22,24,04
Comanche,Governor,Dax Ewbank,REP,160038,1,0,16,17,
Comanche,Governor,Chad Moody,REP,160038,0,2,89,91,
Comanche,Governor,Mary Fallin,REP,160038,5,21,271,297,
Comanche,Superintendent of Public Instruction,Brian Kelly,REP,160038,2,4,97,103,
Comanche,Superintendent of Public Instruction,Janet Costello Barresi,REP,160038,0,3,77,80,
Comanche,Superintendent of Public Instruction,Joy Hofmeister,REP,160038,2,17,181,200,
Comanche,Insurance Commissioner,Bill Viner,REP,160038,1,6,117,124,
Comanche,Insurance Commissioner,John Doak,REP,160038,4,17,211,232,
Comanche,Corporation Commissioner,Todd Hiett,REP,160038,4,13,196,213,
Comanche,Corporation Commissioner,Cliff Branan,REP,160038,1,9,133,143,
Comanche,U.S. Senate,Evelyn Rogers,REP,160038,0,1,25,26,
Comanche,U.S. Senate,Rob Moye,REP,160038,0,0,10,10,
Comanche,U.S. Senate,D. Jean Mcbride-Samuels,REP,160038,0,0,8,8,
Comanche,U.S. Senate,Jim Inhofe,REP,160038,6,22,316,344,
Comanche,U.S. Senate,Erick Paul Wyatt,REP,160038,0,0,10,10,
Comanche,U.S. Senate,Andy Craig,REP,160038,0,0,5,5,
Comanche,U.S. Senate,T. Shannon,REP,160038,4,12,261,277,
Comanche,U.S. Senate,Randy Brogdon,REP,160038,1,0,10,11,
Comanche,U.S. Senate,Eric Mccray,REP,160038,0,0,3,3,
Comanche,U.S. Senate,Kevin Crow,REP,160038,0,0,4,4,
Comanche,U.S. Senate,James Lankford,REP,160038,1,11,86,98,
Comanche,U.S. Senate,Jason Weger,REP,160038,0,0,2,2,
Comanche,U.S. House,Anna Flatt,REP,160038,1,2,56,59,04
Comanche,U.S. House,Tom Cole,REP,160038,5,21,315,341,04
Comanche,State House,Renae Sexton,REP,160038,1,9,70,80,65
Comanche,State House,Scott Hayes,REP,160038,5,4,217,226,65
Comanche,State House,Scooter Park,REP,160038,0,7,45,52,65
Comanche,State House,Stephen Mills,REP,160038,0,4,43,47,65
Comanche,Superintendent of Public Instruction,John Cox,DEM,160039,0,2,33,35,
Comanche,Superintendent of Public Instruction,Jack Jr.,DEM,160039,0,0,25,25,
Comanche,Superintendent of Public Instruction,Ivan Holmes,DEM,160039,0,0,10,10,
Comanche,Superintendent of Public Instruction,Freda Deskin,DEM,160039,0,3,38,41,
Comanche,U.S. Senate,Patrick Michael Hayes,DEM,160039,0,4,42,46,
Comanche,U.S. Senate,Jim Rogers,DEM,160039,0,0,37,37,
Comanche,U.S. Senate,Connie Johnson,DEM,160039,0,1,28,29,
Comanche,U.S. House,Bert Smith,DEM,160039,0,5,94,99,04
Comanche,U.S. House,Tae Si,DEM,160039,0,0,11,11,04
Comanche,Governor,Dax Ewbank,REP,160039,1,0,11,12,
Comanche,Governor,Chad Moody,REP,160039,1,3,43,47,
Comanche,Governor,Mary Fallin,REP,160039,0,9,115,124,
Comanche,Superintendent of Public Instruction,Brian Kelly,REP,160039,1,2,37,40,
Comanche,Superintendent of Public Instruction,Janet Costello Barresi,REP,160039,0,2,48,50,
Comanche,Superintendent of Public Instruction,Joy Hofmeister,REP,160039,1,7,78,86,
Comanche,Insurance Commissioner,Bill Viner,REP,160039,0,3,41,44,
Comanche,Insurance Commissioner,John Doak,REP,160039,2,8,110,120,
Comanche,Corporation Commissioner,Todd Hiett,REP,160039,2,7,75,84,
Comanche,Corporation Commissioner,Cliff Branan,REP,160039,0,5,74,79,
Comanche,U.S. Senate,Evelyn Rogers,REP,160039,0,2,9,11,
Comanche,U.S. Senate,Rob Moye,REP,160039,0,0,5,5,
Comanche,U.S. Senate,D. Jean Mcbride-Samuels,REP,160039,0,0,3,3,
Comanche,U.S. Senate,Jim Inhofe,REP,160039,2,10,136,148,
Comanche,U.S. Senate,Erick Paul Wyatt,REP,160039,0,0,12,12,
Comanche,U.S. Senate,Andy Craig,REP,160039,0,1,1,2,
Comanche,U.S. Senate,T. Shannon,REP,160039,0,7,115,122,
Comanche,U.S. Senate,Randy Brogdon,REP,160039,0,0,4,4,
Comanche,U.S. Senate,Eric Mccray,REP,160039,0,1,3,4,
Comanche,U.S. Senate,Kevin Crow,REP,160039,0,0,3,3,
Comanche,U.S. Senate,James Lankford,REP,160039,2,3,40,45,
Comanche,U.S. Senate,Jason Weger,REP,160039,0,0,3,3,
Comanche,U.S. House,Anna Flatt,REP,160039,0,3,28,31,04
Comanche,U.S. House,Tom Cole,REP,160039,2,9,137,148,04
Comanche,State House,Renae Sexton,REP,160039,0,4,35,39,65
Comanche,State House,Scott Hayes,REP,160039,2,6,88,96,65
Comanche,State House,Scooter Park,REP,160039,0,0,29,29,65
Comanche,State House,Stephen Mills,REP,160039,0,2,18,20,65
Comanche,Superintendent of Public Instruction,John Cox,DEM,160040,0,2,57,59,
Comanche,Superintendent of Public Instruction,Jack Jr.,DEM,160040,1,1,42,44,
Comanche,Superintendent of Public Instruction,Ivan Holmes,DEM,160040,0,3,14,17,
Comanche,Superintendent of Public Instruction,Freda Deskin,DEM,160040,2,0,42,44,
Comanche,U.S. Senate,Patrick Michael Hayes,DEM,160040,1,0,58,59,
Comanche,U.S. Senate,Jim Rogers,DEM,160040,0,4,51,55,
Comanche,U.S. Senate,Connie Johnson,DEM,160040,2,2,46,50,
Comanche,U.S. House,Bert Smith,DEM,160040,1,5,133,139,04
Comanche,U.S. House,Tae Si,DEM,160040,2,1,18,21,04
Comanche,Governor,Dax Ewbank,REP,160040,1,0,15,16,
Comanche,Governor,Chad Moody,REP,160040,1,1,32,34,
Comanche,Governor,Mary Fallin,REP,160040,0,1,84,85,
Comanche,Superintendent of Public Instruction,Brian Kelly,REP,160040,1,0,23,24,
Comanche,Superintendent of Public Instruction,Janet Costello Barresi,REP,160040,0,0,25,25,
Comanche,Superintendent of Public Instruction,Joy Hofmeister,REP,160040,1,2,85,88,
Comanche,Insurance Commissioner,Bill Viner,REP,160040,0,0,20,20,
Comanche,Insurance Commissioner,John Doak,REP,160040,2,2,100,104,
Comanche,Corporation Commissioner,Todd Hiett,REP,160040,0,0,57,57,
Comanche,Corporation Commissioner,Cliff Branan,REP,160040,2,2,65,69,
Comanche,U.S. Senate,Evelyn Rogers,REP,160040,0,1,2,3,
Comanche,U.S. Senate,Rob Moye,REP,160040,0,0,1,1,
Comanche,U.S. Senate,D. Jean Mcbride-Samuels,REP,160040,1,0,4,5,
Comanche,U.S. Senate,Jim Inhofe,REP,160040,1,1,121,123,
Comanche,U.S. Senate,Erick Paul Wyatt,REP,160040,0,0,3,3,
Comanche,U.S. Senate,Andy Craig,REP,160040,0,0,1,1,
Comanche,U.S. Senate,T. Shannon,REP,160040,0,2,97,99,
Comanche,U.S. Senate,Randy Brogdon,REP,160040,0,0,2,2,
Comanche,U.S. Senate,Eric Mccray,REP,160040,0,0,1,1,
Comanche,U.S. Senate,Kevin Crow,REP,160040,1,0,1,2,
Comanche,U.S. Senate,James Lankford,REP,160040,1,0,32,33,
Comanche,U.S. Senate,Jason Weger,REP,160040,0,0,0,0,
Comanche,U.S. House,Anna Flatt,REP,160040,0,0,11,11,04
Comanche,U.S. House,Tom Cole,REP,160040,2,1,121,124,04
Comanche,State House,Renae Sexton,REP,160040,0,0,31,31,65
Comanche,State House,Scott Hayes,REP,160040,0,1,65,66,65
Comanche,State House,Scooter Park,REP,160040,2,1,22,25,65
Comanche,State House,Stephen Mills,REP,160040,0,0,14,14,65
Comanche,Superintendent of Public Instruction,John Cox,DEM,160041,0,1,31,32,
Comanche,Superintendent of Public Instruction,Jack Jr.,DEM,160041,0,0,17,17,
Comanche,Superintendent of Public Instruction,Ivan Holmes,DEM,160041,0,0,13,13,
Comanche,Superintendent of Public Instruction,Freda Deskin,DEM,160041,0,0,23,23,
Comanche,U.S. Senate,Patrick Michael Hayes,DEM,160041,0,1,16,17,
Comanche,U.S. Senate,Jim Rogers,DEM,160041,0,0,47,47,
Comanche,U.S. Senate,Connie Johnson,DEM,160041,0,0,19,19,
Comanche,U.S. House,Bert Smith,DEM,160041,0,1,74,75,04
Comanche,U.S. House,Tae Si,DEM,160041,0,0,8,8,04
Comanche,State House,B. L. Cozad Jr,DEM,160041,0,0,39,39,63
Comanche,State House,Juan Rodriguez,DEM,160041,0,1,49,50,63
Comanche,Governor,Dax Ewbank,REP,160041,0,0,7,7,
Comanche,Governor,Chad Moody,REP,160041,0,0,10,10,
Comanche,Governor,Mary Fallin,REP,160041,1,2,50,53,
Comanche,Superintendent of Public Instruction,Brian Kelly,REP,160041,0,0,17,17,
Comanche,Superintendent of Public Instruction,Janet Costello Barresi,REP,160041,1,0,17,18,
Comanche,Superintendent of Public Instruction,Joy Hofmeister,REP,160041,0,2,30,32,
Comanche,Insurance Commissioner,Bill Viner,REP,160041,0,0,20,20,
Comanche,Insurance Commissioner,John Doak,REP,160041,1,2,41,44,
Comanche,Corporation Commissioner,Todd Hiett,REP,160041,0,1,39,40,
Comanche,Corporation Commissioner,Cliff Branan,REP,160041,1,1,23,25,
Comanche,U.S. Senate,Evelyn Rogers,REP,160041,0,0,5,5,
Comanche,U.S. Senate,Rob Moye,REP,160041,0,0,0,0,
Comanche,U.S. Senate,D. Jean Mcbride-Samuels,REP,160041,0,0,2,2,
Comanche,U.S. Senate,Jim Inhofe,REP,160041,1,2,56,59,
Comanche,U.S. Senate,Erick Paul Wyatt,REP,160041,0,0,2,2,
Comanche,U.S. Senate,Andy Craig,REP,160041,0,0,1,1,
Comanche,U.S. Senate,T. Shannon,REP,160041,1,2,50,53,
Comanche,U.S. Senate,Randy Brogdon,REP,160041,0,0,0,0,
Comanche,U.S. Senate,Eric Mccray,REP,160041,0,0,1,1,
Comanche,U.S. Senate,Kevin Crow,REP,160041,0,0,1,1,
Comanche,U.S. Senate,James Lankford,REP,160041,0,0,13,13,
Comanche,U.S. Senate,Jason Weger,REP,160041,0,0,0,0,
Comanche,U.S. House,Anna Flatt,REP,160041,1,0,19,20,04
Comanche,U.S. House,Tom Cole,REP,160041,0,2,49,51,04
Comanche,State House,Jeff Coody,REP,160041,0,2,40,42,63
Comanche,State House,Hurchel Trey Caldwell,REP,160041,0,0,5,5,63
Comanche,State House,Greg Howard,REP,160041,0,0,23,23,63
Comanche,Superintendent of Public Instruction,John Cox,DEM,160042,4,6,90,100,
Comanche,Superintendent of Public Instruction,Jack Jr.,DEM,160042,0,3,38,41,
Comanche,Superintendent of Public Instruction,Ivan Holmes,DEM,160042,0,4,17,21,
Comanche,Superintendent of Public Instruction,Freda Deskin,DEM,160042,2,2,50,54,
Comanche,U.S. Senate,Patrick Michael Hayes,DEM,160042,3,0,37,40,
Comanche,U.S. Senate,Jim Rogers,DEM,160042,1,5,76,82,
Comanche,U.S. Senate,Connie Johnson,DEM,160042,2,10,78,90,
Comanche,U.S. House,Bert Smith,DEM,160042,6,11,164,181,04
Comanche,U.S. House,Tae Si,DEM,160042,0,5,25,30,04
Comanche,State House,B. L. Cozad Jr,DEM,160042,6,3,67,76,63
Comanche,State House,Juan Rodriguez,DEM,160042,1,13,132,146,63
Comanche,Governor,Dax Ewbank,REP,160042,4,3,29,36,
Comanche,Governor,Chad Moody,REP,160042,2,4,55,61,
Comanche,Governor,Mary Fallin,REP,160042,11,35,241,287,
Comanche,Superintendent of Public Instruction,Brian Kelly,REP,160042,5,5,67,77,
Comanche,Superintendent of Public Instruction,Janet Costello Barresi,REP,160042,3,15,105,123,
Comanche,Superintendent of Public Instruction,Joy Hofmeister,REP,160042,9,22,146,177,
Comanche,Insurance Commissioner,Bill Viner,REP,160042,7,5,88,100,
Comanche,Insurance Commissioner,John Doak,REP,160042,8,37,212,257,
Comanche,Corporation Commissioner,Todd Hiett,REP,160042,7,33,207,247,
Comanche,Corporation Commissioner,Cliff Branan,REP,160042,7,9,97,113,
Comanche,U.S. Senate,Evelyn Rogers,REP,160042,1,2,9,12,
Comanche,U.S. Senate,Rob Moye,REP,160042,0,0,3,3,
Comanche,U.S. Senate,D. Jean Mcbride-Samuels,REP,160042,1,0,4,5,
Comanche,U.S. Senate,Jim Inhofe,REP,160042,14,41,298,353,
Comanche,U.S. Senate,Erick Paul Wyatt,REP,160042,1,0,11,12,
Comanche,U.S. Senate,Andy Craig,REP,160042,0,0,4,4,
Comanche,U.S. Senate,T. Shannon,REP,160042,12,28,250,290,
Comanche,U.S. Senate,Randy Brogdon,REP,160042,0,1,8,9,
Comanche,U.S. Senate,Eric Mccray,REP,160042,1,0,0,1,
Comanche,U.S. Senate,Kevin Crow,REP,160042,1,0,4,5,
Comanche,U.S. Senate,James Lankford,REP,160042,3,14,64,81,
Comanche,U.S. Senate,Jason Weger,REP,160042,0,0,1,1,
Comanche,U.S. House,Anna Flatt,REP,160042,5,8,38,51,04
Comanche,U.S. House,Tom Cole,REP,160042,12,35,291,338,04
Comanche,State House,Jeff Coody,REP,160042,8,30,193,231,63
Comanche,State House,Hurchel Trey Caldwell,REP,160042,2,2,32,36,63
Comanche,State House,Greg Howard,REP,160042,7,11,102,120,63
Comanche,Superintendent of Public Instruction,John Cox,DEM,160043,0,0,32,32,
Comanche,Superintendent of Public Instruction,Jack Jr.,DEM,160043,0,0,9,9,
Comanche,Superintendent of Public Instruction,Ivan Holmes,DEM,160043,0,0,12,12,
Comanche,Superintendent of Public Instruction,Freda Deskin,DEM,160043,0,1,7,8,
Comanche,U.S. Senate,Patrick Michael Hayes,DEM,160043,0,0,18,18,
Comanche,U.S. Senate,Jim Rogers,DEM,160043,0,0,27,27,
Comanche,U.S. Senate,Connie Johnson,DEM,160043,0,1,14,15,
Comanche,U.S. House,Bert Smith,DEM,160043,0,1,56,57,04
Comanche,U.S. House,Tae Si,DEM,160043,0,0,4,4,04
Comanche,State House,B. L. Cozad Jr,DEM,160043,0,0,23,23,63
Comanche,State House,Juan Rodriguez,DEM,160043,0,1,35,36,63
Comanche,Governor,Dax Ewbank,REP,160043,0,0,4,4,
Comanche,Governor,Chad Moody,REP,160043,0,0,9,9,
Comanche,Governor,Mary Fallin,REP,160043,2,7,61,70,
Comanche,Superintendent of Public Instruction,Brian Kelly,REP,160043,0,1,15,16,
Comanche,Superintendent of Public Instruction,Janet Costello Barresi,REP,160043,0,3,14,17,
Comanche,Superintendent of Public Instruction,Joy Hofmeister,REP,160043,3,1,43,47,
Comanche,Insurance Commissioner,Bill Viner,REP,160043,2,2,10,14,
Comanche,Insurance Commissioner,John Doak,REP,160043,1,4,55,60,
Comanche,Corporation Commissioner,Todd Hiett,REP,160043,3,5,44,52,
Comanche,Corporation Commissioner,Cliff Branan,REP,160043,0,1,21,22,
Comanche,U.S. Senate,Evelyn Rogers,REP,160043,0,0,2,2,
Comanche,U.S. Senate,Rob Moye,REP,160043,1,0,1,2,
Comanche,U.S. Senate,D. Jean Mcbride-Samuels,REP,160043,0,0,1,1,
Comanche,U.S. Senate,Jim Inhofe,REP,160043,0,6,66,72,
Comanche,U.S. Senate,Erick Paul Wyatt,REP,160043,1,0,3,4,
Comanche,U.S. Senate,Andy Craig,REP,160043,0,0,1,1,
Comanche,U.S. Senate,T. Shannon,REP,160043,2,7,54,63,
Comanche,U.S. Senate,Randy Brogdon,REP,160043,0,0,0,0,
Comanche,U.S. Senate,Eric Mccray,REP,160043,0,0,0,0,
Comanche,U.S. Senate,Kevin Crow,REP,160043,0,0,0,0,
Comanche,U.S. Senate,James Lankford,REP,160043,0,0,22,22,
Comanche,U.S. Senate,Jason Weger,REP,160043,0,0,0,0,
Comanche,U.S. House,Anna Flatt,REP,160043,0,1,8,9,04
Comanche,U.S. House,Tom Cole,REP,160043,2,6,66,74,04
Comanche,State House,Jeff Coody,REP,160043,0,5,47,52,63
Comanche,State House,Hurchel Trey Caldwell,REP,160043,1,2,19,22,63
Comanche,State House,Greg Howard,REP,160043,2,0,11,13,63
Comanche,Superintendent of Public Instruction,John Cox,DEM,160045,2,10,32,44,
Comanche,Superintendent of Public Instruction,Jack Jr.,DEM,160045,0,0,13,13,
Comanche,Superintendent of Public Instruction,Ivan Holmes,DEM,160045,1,1,10,12,
Comanche,Superintendent of Public Instruction,Freda Deskin,DEM,160045,0,1,12,13,
Comanche,U.S. Senate,Patrick Michael Hayes,DEM,160045,0,3,22,25,
Comanche,U.S. Senate,Jim Rogers,DEM,160045,2,5,22,29,
Comanche,U.S. Senate,Connie Johnson,DEM,160045,1,4,22,27,
Comanche,U.S. House,Bert Smith,DEM,160045,3,10,62,75,04
Comanche,U.S. House,Tae Si,DEM,160045,0,2,5,7,04
Comanche,State House,B. L. Cozad Jr,DEM,160045,1,1,23,25,63
Comanche,State House,Juan Rodriguez,DEM,160045,2,11,47,60,63
Comanche,Governor,Dax Ewbank,REP,160045,2,0,7,9,
Comanche,Governor,Chad Moody,REP,160045,0,6,24,30,
Comanche,Governor,Mary Fallin,REP,160045,0,14,107,121,
Comanche,Superintendent of Public Instruction,Brian Kelly,REP,160045,0,1,27,28,
Comanche,Superintendent of Public Instruction,Janet Costello Barresi,REP,160045,0,4,31,35,
Comanche,Superintendent of Public Instruction,Joy Hofmeister,REP,160045,2,15,79,96,
Comanche,Insurance Commissioner,Bill Viner,REP,160045,0,1,26,27,
Comanche,Insurance Commissioner,John Doak,REP,160045,2,17,103,122,
Comanche,Corporation Commissioner,Todd Hiett,REP,160045,2,13,86,101,
Comanche,Corporation Commissioner,Cliff Branan,REP,160045,0,5,46,51,
Comanche,U.S. Senate,Evelyn Rogers,REP,160045,0,0,8,8,
Comanche,U.S. Senate,Rob Moye,REP,160045,0,0,2,2,
Comanche,U.S. Senate,D. Jean Mcbride-Samuels,REP,160045,0,0,1,1,
Comanche,U.S. Senate,Jim Inhofe,REP,160045,2,20,118,140,
Comanche,U.S. Senate,Erick Paul Wyatt,REP,160045,0,0,9,9,
Comanche,U.S. Senate,Andy Craig,REP,160045,0,0,0,0,
Comanche,U.S. Senate,T. Shannon,REP,160045,2,15,99,116,
Comanche,U.S. Senate,Randy Brogdon,REP,160045,0,0,4,4,
Comanche,U.S. Senate,Eric Mccray,REP,160045,0,0,1,1,
Comanche,U.S. Senate,Kevin Crow,REP,160045,0,0,3,3,
Comanche,U.S. Senate,James Lankford,REP,160045,0,5,31,36,
Comanche,U.S. Senate,Jason Weger,REP,160045,0,0,0,0,
Comanche,U.S. House,Anna Flatt,REP,160045,0,2,23,25,04
Comanche,U.S. House,Tom Cole,REP,160045,2,20,115,137,04
Comanche,State House,Jeff Coody,REP,160045,2,11,81,94,63
Comanche,State House,Hurchel Trey Caldwell,REP,160045,0,4,20,24,63
Comanche,State House,Greg Howard,REP,160045,0,4,36,40,63
Comanche,Superintendent of Public Instruction,John Cox,DEM,160046,0,0,16,16,
Comanche,Superintendent of Public Instruction,Jack Jr.,DEM,160046,0,1,10,11,
Comanche,Superintendent of Public Instruction,Ivan Holmes,DEM,160046,0,0,3,3,
Comanche,Superintendent of Public Instruction,Freda Deskin,DEM,160046,0,1,13,14,
Comanche,U.S. Senate,Patrick Michael Hayes,DEM,160046,0,0,4,4,
Comanche,U.S. Senate,Jim Rogers,DEM,160046,0,0,30,30,
Comanche,U.S. Senate,Connie Johnson,DEM,160046,0,2,8,10,
Comanche,U.S. House,Bert Smith,DEM,160046,0,1,39,40,04
Comanche,U.S. House,Tae Si,DEM,160046,0,1,4,5,04
Comanche,State House,B. L. Cozad Jr,DEM,160046,0,0,18,18,63
Comanche,State House,Juan Rodriguez,DEM,160046,0,2,26,28,63
Comanche,Governor,Dax Ewbank,REP,160046,0,3,7,10,
Comanche,Governor,Chad Moody,REP,160046,1,1,15,17,
Comanche,Governor,Mary Fallin,REP,160046,0,6,52,58,
Comanche,Superintendent of Public Instruction,Brian Kelly,REP,160046,0,1,14,15,
Comanche,Superintendent of Public Instruction,Janet Costello Barresi,REP,160046,0,1,13,14,
Comanche,Superintendent of Public Instruction,Joy Hofmeister,REP,160046,1,8,47,56,
Comanche,Insurance Commissioner,Bill Viner,REP,160046,0,2,10,12,
Comanche,Insurance Commissioner,John Doak,REP,160046,1,8,59,68,
Comanche,Corporation Commissioner,Todd Hiett,REP,160046,1,7,43,51,
Comanche,Corporation Commissioner,Cliff Branan,REP,160046,0,3,29,32,
Comanche,U.S. Senate,Evelyn Rogers,REP,160046,0,0,3,3,
Comanche,U.S. Senate,Rob Moye,REP,160046,0,0,1,1,
Comanche,U.S. Senate,D. Jean Mcbride-Samuels,REP,160046,0,0,2,2,
Comanche,U.S. Senate,Jim Inhofe,REP,160046,1,9,63,73,
Comanche,U.S. Senate,Erick Paul Wyatt,REP,160046,0,1,3,4,
Comanche,U.S. Senate,Andy Craig,REP,160046,0,0,0,0,
Comanche,U.S. Senate,T. Shannon,REP,160046,0,3,55,58,
Comanche,U.S. Senate,Randy Brogdon,REP,160046,0,0,3,3,
Comanche,U.S. Senate,Eric Mccray,REP,160046,0,0,0,0,
Comanche,U.S. Senate,Kevin Crow,REP,160046,0,1,0,1,
Comanche,U.S. Senate,James Lankford,REP,160046,1,6,18,25,
Comanche,U.S. Senate,Jason Weger,REP,160046,0,0,0,0,
Comanche,U.S. House,Anna Flatt,REP,160046,0,1,7,8,04
Comanche,U.S. House,Tom Cole,REP,160046,1,9,66,76,04
Comanche,State House,Jeff Coody,REP,160046,0,1,31,32,63
Comanche,State House,Hurchel Trey Caldwell,REP,160046,0,3,21,24,63
Comanche,State House,Greg Howard,REP,160046,1,5,24,30,63
Comanche,Superintendent of Public Instruction,John Cox,DEM,160048,0,1,47,48,
Comanche,Superintendent of Public Instruction,Jack Jr.,DEM,160048,0,0,30,30,
Comanche,Superintendent of Public Instruction,Ivan Holmes,DEM,160048,0,0,10,10,
Comanche,Superintendent of Public Instruction,Freda Deskin,DEM,160048,0,5,20,25,
Comanche,U.S. Senate,Patrick Michael Hayes,DEM,160048,0,1,33,34,
Comanche,U.S. Senate,Jim Rogers,DEM,160048,0,1,38,39,
Comanche,U.S. Senate,Connie Johnson,DEM,160048,0,4,35,39,
Comanche,U.S. House,Bert Smith,DEM,160048,0,6,96,102,04
Comanche,U.S. House,Tae Si,DEM,160048,0,0,13,13,04
Comanche,State House,B. L. Cozad Jr,DEM,160048,0,2,22,24,63
Comanche,State House,Juan Rodriguez,DEM,160048,0,3,87,90,63
Comanche,Governor,Dax Ewbank,REP,160048,0,0,6,6,
Comanche,Governor,Chad Moody,REP,160048,0,2,20,22,
Comanche,Governor,Mary Fallin,REP,160048,3,8,82,93,
Comanche,Superintendent of Public Instruction,Brian Kelly,REP,160048,0,4,26,30,
Comanche,Superintendent of Public Instruction,Janet Costello Barresi,REP,160048,0,1,25,26,
Comanche,Superintendent of Public Instruction,Joy Hofmeister,REP,160048,3,5,56,64,
Comanche,Insurance Commissioner,Bill Viner,REP,160048,1,0,27,28,
Comanche,Insurance Commissioner,John Doak,REP,160048,2,9,74,85,
Comanche,Corporation Commissioner,Todd Hiett,REP,160048,2,7,56,65,
Comanche,Corporation Commissioner,Cliff Branan,REP,160048,1,1,47,49,
Comanche,U.S. Senate,Evelyn Rogers,REP,160048,0,0,4,4,
Comanche,U.S. Senate,Rob Moye,REP,160048,0,0,2,2,
Comanche,U.S. Senate,D. Jean Mcbride-Samuels,REP,160048,0,0,3,3,
Comanche,U.S. Senate,Jim Inhofe,REP,160048,3,9,89,101,
Comanche,U.S. Senate,Erick Paul Wyatt,REP,160048,0,1,9,10,
Comanche,U.S. Senate,Andy Craig,REP,160048,0,0,0,0,
Comanche,U.S. Senate,T. Shannon,REP,160048,1,6,82,89,
Comanche,U.S. Senate,Randy Brogdon,REP,160048,0,1,1,2,
Comanche,U.S. Senate,Eric Mccray,REP,160048,0,0,0,0,
Comanche,U.S. Senate,Kevin Crow,REP,160048,0,0,3,3,
Comanche,U.S. Senate,James Lankford,REP,160048,2,3,21,26,
Comanche,U.S. Senate,Jason Weger,REP,160048,0,0,1,1,
Comanche,U.S. House,Anna Flatt,REP,160048,0,0,16,16,04
Comanche,U.S. House,Tom Cole,REP,160048,3,10,92,105,04
Comanche,State House,Jeff Coody,REP,160048,1,6,58,65,63
Comanche,State House,Hurchel Trey Caldwell,REP,160048,2,1,14,17,63
Comanche,State House,Greg Howard,REP,160048,0,3,34,37,63
Comanche,Superintendent of Public Instruction,John Cox,DEM,160049,0,6,41,47,
Comanche,Superintendent of Public Instruction,Jack Jr.,DEM,160049,0,5,30,35,
Comanche,Superintendent of Public Instruction,Ivan Holmes,DEM,160049,0,1,11,12,
Comanche,Superintendent of Public Instruction,Freda Deskin,DEM,160049,0,1,34,35,
Comanche,U.S. Senate,Patrick Michael Hayes,DEM,160049,0,2,29,31,
Comanche,U.S. Senate,Jim Rogers,DEM,160049,0,8,42,50,
Comanche,U.S. Senate,Connie Johnson,DEM,160049,0,4,42,46,
Comanche,U.S. House,Bert Smith,DEM,160049,0,14,98,112,04
Comanche,U.S. House,Tae Si,DEM,160049,0,0,15,15,04
Comanche,Governor,Dax Ewbank,REP,160049,0,0,12,12,
Comanche,Governor,Chad Moody,REP,160049,0,5,9,14,
Comanche,Governor,Mary Fallin,REP,160049,6,11,87,104,
Comanche,Superintendent of Public Instruction,Brian Kelly,REP,160049,0,3,15,18,
Comanche,Superintendent of Public Instruction,Janet Costello Barresi,REP,160049,5,1,34,40,
Comanche,Superintendent of Public Instruction,Joy Hofmeister,REP,160049,1,12,58,71,
Comanche,Insurance Commissioner,Bill Viner,REP,160049,0,3,14,17,
Comanche,Insurance Commissioner,John Doak,REP,160049,6,10,90,106,
Comanche,Corporation Commissioner,Todd Hiett,REP,160049,5,9,57,71,
Comanche,Corporation Commissioner,Cliff Branan,REP,160049,1,6,46,53,
Comanche,U.S. Senate,Evelyn Rogers,REP,160049,0,0,2,2,
Comanche,U.S. Senate,Rob Moye,REP,160049,0,1,1,2,
Comanche,U.S. Senate,D. Jean Mcbride-Samuels,REP,160049,0,0,3,3,
Comanche,U.S. Senate,Jim Inhofe,REP,160049,6,14,96,116,
Comanche,U.S. Senate,Erick Paul Wyatt,REP,160049,0,0,7,7,
Comanche,U.S. Senate,Andy Craig,REP,160049,0,0,2,2,
Comanche,U.S. Senate,T. Shannon,REP,160049,5,6,63,74,
Comanche,U.S. Senate,Randy Brogdon,REP,160049,1,0,2,3,
Comanche,U.S. Senate,Eric Mccray,REP,160049,0,0,0,0,
Comanche,U.S. Senate,Kevin Crow,REP,160049,0,0,1,1,
Comanche,U.S. Senate,James Lankford,REP,160049,0,9,41,50,
Comanche,U.S. Senate,Jason Weger,REP,160049,0,0,0,0,
Comanche,U.S. House,Anna Flatt,REP,160049,0,2,16,18,04
Comanche,U.S. House,Tom Cole,REP,160049,6,13,93,112,04
Comanche,State House,Renae Sexton,REP,160049,3,3,30,36,65
Comanche,State House,Scott Hayes,REP,160049,0,3,32,35,65
Comanche,State House,Scooter Park,REP,160049,1,5,23,29,65
Comanche,State House,Stephen Mills,REP,160049,2,4,22,28,65
Comanche,Superintendent of Public Instruction,John Cox,DEM,160050,4,4,95,103,
Comanche,Superintendent of Public Instruction,Jack Jr.,DEM,160050,0,4,46,50,
Comanche,Superintendent of Public Instruction,Ivan Holmes,DEM,160050,0,7,20,27,
Comanche,Superintendent of Public Instruction,Freda Deskin,DEM,160050,0,6,71,77,
Comanche,U.S. Senate,Patrick Michael Hayes,DEM,160050,0,3,64,67,
Comanche,U.S. Senate,Jim Rogers,DEM,160050,3,6,52,61,
Comanche,U.S. Senate,Connie Johnson,DEM,160050,2,13,109,124,
Comanche,U.S. House,Bert Smith,DEM,160050,4,17,192,213,04
Comanche,U.S. House,Tae Si,DEM,160050,1,4,36,41,04
Comanche,Governor,Dax Ewbank,REP,160050,1,4,13,18,
Comanche,Governor,Chad Moody,REP,160050,1,8,53,62,
Comanche,Governor,Mary Fallin,REP,160050,16,34,290,340,
Comanche,Superintendent of Public Instruction,Brian Kelly,REP,160050,4,14,72,90,
Comanche,Superintendent of Public Instruction,Janet Costello Barresi,REP,160050,6,11,105,122,
Comanche,Superintendent of Public Instruction,Joy Hofmeister,REP,160050,5,20,174,199,
Comanche,Insurance Commissioner,Bill Viner,REP,160050,1,5,74,80,
Comanche,Insurance Commissioner,John Doak,REP,160050,14,36,251,301,
Comanche,Corporation Commissioner,Todd Hiett,REP,160050,7,25,208,240,
Comanche,Corporation Commissioner,Cliff Branan,REP,160050,7,17,118,142,
Comanche,U.S. Senate,Evelyn Rogers,REP,160050,0,2,10,12,
Comanche,U.S. Senate,Rob Moye,REP,160050,0,0,7,7,
Comanche,U.S. Senate,D. Jean Mcbride-Samuels,REP,160050,0,1,1,2,
Comanche,U.S. Senate,Jim Inhofe,REP,160050,18,39,331,388,
Comanche,U.S. Senate,Erick Paul Wyatt,REP,160050,0,2,6,8,
Comanche,U.S. Senate,Andy Craig,REP,160050,0,0,1,1,
Comanche,U.S. Senate,T. Shannon,REP,160050,12,33,267,312,
Comanche,U.S. Senate,Randy Brogdon,REP,160050,1,0,3,4,
Comanche,U.S. Senate,Eric Mccray,REP,160050,0,1,4,5,
Comanche,U.S. Senate,Kevin Crow,REP,160050,0,0,1,1,
Comanche,U.S. Senate,James Lankford,REP,160050,5,11,77,93,
Comanche,U.S. Senate,Jason Weger,REP,160050,0,0,5,5,
Comanche,U.S. House,Anna Flatt,REP,160050,1,2,38,41,04
Comanche,U.S. House,Tom Cole,REP,160050,15,43,318,376,04
Comanche,State House,Jesse Robert Cross,REP,160050,2,29,152,183,62
Comanche,State House,John Michael Montgomery,REP,160050,14,15,198,227,62
Comanche,Superintendent of Public Instruction,John Cox,DEM,160051,0,1,44,45,
Comanche,Superintendent of Public Instruction,Jack Jr.,DEM,160051,0,2,15,17,
Comanche,Superintendent of Public Instruction,Ivan Holmes,DEM,160051,0,0,5,5,
Comanche,Superintendent of Public Instruction,Freda Deskin,DEM,160051,0,0,24,24,
Comanche,U.S. Senate,Patrick Michael Hayes,DEM,160051,0,1,30,31,
Comanche,U.S. Senate,Jim Rogers,DEM,160051,0,2,23,25,
Comanche,U.S. Senate,Connie Johnson,DEM,160051,0,0,34,34,
Comanche,U.S. House,Bert Smith,DEM,160051,0,3,75,78,04
Comanche,U.S. House,Tae Si,DEM,160051,0,0,11,11,04
Comanche,State House,B. L. Cozad Jr,DEM,160051,0,1,35,36,63
Comanche,State House,Juan Rodriguez,DEM,160051,0,2,50,52,63
Comanche,Governor,Dax Ewbank,REP,160051,0,0,10,10,
Comanche,Governor,Chad Moody,REP,160051,0,1,22,23,
Comanche,Governor,Mary Fallin,REP,160051,6,10,170,186,
Comanche,Superintendent of Public Instruction,Brian Kelly,REP,160051,1,3,29,33,
Comanche,Superintendent of Public Instruction,Janet Costello Barresi,REP,160051,1,5,77,83,
Comanche,Superintendent of Public Instruction,Joy Hofmeister,REP,160051,3,3,89,95,
Comanche,Insurance Commissioner,Bill Viner,REP,160051,1,2,53,56,
Comanche,Insurance Commissioner,John Doak,REP,160051,4,9,132,145,
Comanche,Corporation Commissioner,Todd Hiett,REP,160051,3,5,105,113,
Comanche,Corporation Commissioner,Cliff Branan,REP,160051,2,6,78,86,
Comanche,U.S. Senate,Evelyn Rogers,REP,160051,0,1,6,7,
Comanche,U.S. Senate,Rob Moye,REP,160051,0,0,2,2,
Comanche,U.S. Senate,D. Jean Mcbride-Samuels,REP,160051,0,0,5,5,
Comanche,U.S. Senate,Jim Inhofe,REP,160051,5,10,181,196,
Comanche,U.S. Senate,Erick Paul Wyatt,REP,160051,0,0,6,6,
Comanche,U.S. Senate,Andy Craig,REP,160051,0,1,1,2,
Comanche,U.S. Senate,T. Shannon,REP,160051,4,6,134,144,
Comanche,U.S. Senate,Randy Brogdon,REP,160051,0,0,4,4,
Comanche,U.S. Senate,Eric Mccray,REP,160051,0,0,4,4,
Comanche,U.S. Senate,Kevin Crow,REP,160051,0,0,3,3,
Comanche,U.S. Senate,James Lankford,REP,160051,2,4,52,58,
Comanche,U.S. Senate,Jason Weger,REP,160051,0,0,2,2,
Comanche,U.S. House,Anna Flatt,REP,160051,1,2,26,29,04
Comanche,U.S. House,Tom Cole,REP,160051,5,9,176,190,04
Comanche,State House,Jeff Coody,REP,160051,4,6,145,155,63
Comanche,State House,Hurchel Trey Caldwell,REP,160051,0,4,17,21,63
Comanche,State House,Greg Howard,REP,160051,2,1,39,42,63
Comanche,Superintendent of Public Instruction,John Cox,DEM,160053,0,0,0,0,
Comanche,Superintendent of Public Instruction,Jack Jr.,DEM,160053,0,0,0,0,
Comanche,Superintendent of Public Instruction,Ivan Holmes,DEM,160053,0,0,0,0,
Comanche,Superintendent of Public Instruction,Freda Deskin,DEM,160053,0,0,0,0,
Comanche,U.S. Senate,Patrick Michael Hayes,DEM,160053,0,0,0,0,
Comanche,U.S. Senate,Jim Rogers,DEM,160053,0,0,0,0,
Comanche,U.S. Senate,Connie Johnson,DEM,160053,0,0,0,0,
Comanche,U.S. House,Bert Smith,DEM,160053,0,0,0,0,04
Comanche,U.S. House,Tae Si,DEM,160053,0,0,0,0,04
Comanche,Governor,Dax Ewbank,REP,160053,0,0,0,0,
Comanche,Governor,Chad Moody,REP,160053,0,0,0,0,
Comanche,Governor,Mary Fallin,REP,160053,0,0,0,0,
Comanche,Superintendent of Public Instruction,Brian Kelly,REP,160053,0,0,0,0,
Comanche,Superintendent of Public Instruction,Janet Costello Barresi,REP,160053,0,0,0,0,
Comanche,Superintendent of Public Instruction,Joy Hofmeister,REP,160053,0,0,0,0,
Comanche,Insurance Commissioner,Bill Viner,REP,160053,0,0,0,0,
Comanche,Insurance Commissioner,John Doak,REP,160053,0,0,0,0,
Comanche,Corporation Commissioner,Todd Hiett,REP,160053,0,0,0,0,
Comanche,Corporation Commissioner,Cliff Branan,REP,160053,0,0,0,0,
Comanche,U.S. Senate,Evelyn Rogers,REP,160053,0,0,0,0,
Comanche,U.S. Senate,Rob Moye,REP,160053,0,0,0,0,
Comanche,U.S. Senate,D. Jean Mcbride-Samuels,REP,160053,0,0,0,0,
Comanche,U.S. Senate,Jim Inhofe,REP,160053,0,0,0,0,
Comanche,U.S. Senate,Erick Paul Wyatt,REP,160053,0,0,0,0,
Comanche,U.S. Senate,Andy Craig,REP,160053,0,0,0,0,
Comanche,U.S. Senate,T. Shannon,REP,160053,0,0,0,0,
Comanche,U.S. Senate,Randy Brogdon,REP,160053,0,0,0,0,
Comanche,U.S. Senate,Eric Mccray,REP,160053,0,0,0,0,
Comanche,U.S. Senate,Kevin Crow,REP,160053,0,0,0,0,
Comanche,U.S. Senate,James Lankford,REP,160053,0,0,0,0,
Comanche,U.S. Senate,Jason Weger,REP,160053,0,0,0,0,
Comanche,U.S. House,Anna Flatt,REP,160053,0,0,0,0,04
Comanche,U.S. House,Tom Cole,REP,160053,0,0,0,0,04
Comanche,State House,Renae Sexton,REP,160053,0,0,0,0,65
Comanche,State House,Scott Hayes,REP,160053,0,0,0,0,65
Comanche,State House,Scooter Park,REP,160053,0,0,0,0,65
Comanche,State House,Stephen Mills,REP,160053,0,0,0,0,65
Cotton,Superintendent of Public Instruction,John Cox,DEM,170001,0,2,10,12,
Cotton,Superintendent of Public Instruction,Jack Jr.,DEM,170001,1,0,6,7,
Cotton,Superintendent of Public Instruction,Ivan Holmes,DEM,170001,0,1,2,3,
Cotton,Superintendent of Public Instruction,Freda Deskin,DEM,170001,0,2,9,11,
Cotton,U.S. Senate,Patrick Michael Hayes,DEM,170001,0,3,5,8,
Cotton,U.S. Senate,Jim Rogers,DEM,170001,0,0,11,11,
Cotton,U.S. Senate,Connie Johnson,DEM,170001,1,2,14,17,
Cotton,U.S. House,Bert Smith,DEM,170001,1,4,24,29,04
Cotton,U.S. House,Tae Si,DEM,170001,0,1,6,7,04
Cotton,Governor,Dax Ewbank,REP,170001,0,0,2,2,
Cotton,Governor,Chad Moody,REP,170001,0,0,2,2,
Cotton,Governor,Mary Fallin,REP,170001,1,0,3,4,
Cotton,Superintendent of Public Instruction,Brian Kelly,REP,170001,0,0,2,2,
Cotton,Superintendent of Public Instruction,Janet Costello Barresi,REP,170001,0,0,1,1,
Cotton,Superintendent of Public Instruction,Joy Hofmeister,REP,170001,0,0,4,4,
Cotton,Insurance Commissioner,Bill Viner,REP,170001,0,0,2,2,
Cotton,Insurance Commissioner,John Doak,REP,170001,1,0,5,6,
Cotton,Corporation Commissioner,Todd Hiett,REP,170001,0,0,4,4,
Cotton,Corporation Commissioner,Cliff Branan,REP,170001,1,0,3,4,
Cotton,U.S. Senate,Evelyn Rogers,REP,170001,0,0,1,1,
Cotton,U.S. Senate,Rob Moye,REP,170001,0,0,1,1,
Cotton,U.S. Senate,D. Jean Mcbride-Samuels,REP,170001,0,0,0,0,
Cotton,U.S. Senate,Jim Inhofe,REP,170001,1,0,4,5,
Cotton,U.S. Senate,Erick Paul Wyatt,REP,170001,0,0,1,1,
Cotton,U.S. Senate,Andy Craig,REP,170001,0,0,0,0,
Cotton,U.S. Senate,T. Shannon,REP,170001,0,0,4,4,
Cotton,U.S. Senate,Randy Brogdon,REP,170001,1,0,0,1,
Cotton,U.S. Senate,Eric Mccray,REP,170001,0,0,0,0,
Cotton,U.S. Senate,Kevin Crow,REP,170001,0,0,0,0,
Cotton,U.S. Senate,James Lankford,REP,170001,0,0,2,2,
Cotton,U.S. Senate,Jason Weger,REP,170001,0,0,1,1,
Cotton,U.S. House,Anna Flatt,REP,170001,0,0,2,2,04
Cotton,U.S. House,Tom Cole,REP,170001,1,0,5,6,04
Cotton,State House,Renae Sexton,REP,170001,0,0,0,0,65
Cotton,State House,Scott Hayes,REP,170001,0,0,0,0,65
Cotton,State House,Scooter Park,REP,170001,1,0,6,7,65
Cotton,State House,Stephen Mills,REP,170001,0,0,1,1,65
Cotton,Superintendent of Public Instruction,John Cox,DEM,170003,2,3,34,39,
Cotton,Superintendent of Public Instruction,Jack Jr.,DEM,170003,0,1,25,26,
Cotton,Superintendent of Public Instruction,Ivan Holmes,DEM,170003,0,1,7,8,
Cotton,Superintendent of Public Instruction,Freda Deskin,DEM,170003,0,0,25,25,
Cotton,U.S. Senate,Patrick Michael Hayes,DEM,170003,0,2,26,28,
Cotton,U.S. Senate,Jim Rogers,DEM,170003,0,1,32,33,
Cotton,U.S. Senate,Connie Johnson,DEM,170003,2,2,27,31,
Cotton,U.S. House,Bert Smith,DEM,170003,1,5,80,86,04
Cotton,U.S. House,Tae Si,DEM,170003,1,0,9,10,04
Cotton,Governor,Dax Ewbank,REP,170003,0,6,3,9,
Cotton,Governor,Chad Moody,REP,170003,1,0,7,8,
Cotton,Governor,Mary Fallin,REP,170003,7,5,39,51,
Cotton,Superintendent of Public Instruction,Brian Kelly,REP,170003,2,1,4,7,
Cotton,Superintendent of Public Instruction,Janet Costello Barresi,REP,170003,0,0,12,12,
Cotton,Superintendent of Public Instruction,Joy Hofmeister,REP,170003,6,10,29,45,
Cotton,Insurance Commissioner,Bill Viner,REP,170003,1,2,9,12,
Cotton,Insurance Commissioner,John Doak,REP,170003,7,9,35,51,
Cotton,Corporation Commissioner,Todd Hiett,REP,170003,4,7,28,39,
Cotton,Corporation Commissioner,Cliff Branan,REP,170003,4,2,17,23,
Cotton,U.S. Senate,Evelyn Rogers,REP,170003,0,0,0,0,
Cotton,U.S. Senate,Rob Moye,REP,170003,0,0,1,1,
Cotton,U.S. Senate,D. Jean Mcbride-Samuels,REP,170003,0,0,1,1,
Cotton,U.S. Senate,Jim Inhofe,REP,170003,8,9,47,64,
Cotton,U.S. Senate,Erick Paul Wyatt,REP,170003,0,2,2,4,
Cotton,U.S. Senate,Andy Craig,REP,170003,0,0,0,0,
Cotton,U.S. Senate,T. Shannon,REP,170003,3,3,24,30,
Cotton,U.S. Senate,Randy Brogdon,REP,170003,0,1,1,2,
Cotton,U.S. Senate,Eric Mccray,REP,170003,0,0,0,0,
Cotton,U.S. Senate,Kevin Crow,REP,170003,0,0,0,0,
Cotton,U.S. Senate,James Lankford,REP,170003,5,7,24,36,
Cotton,U.S. Senate,Jason Weger,REP,170003,0,0,1,1,
Cotton,U.S. House,Anna Flatt,REP,170003,0,1,5,6,04
Cotton,U.S. House,Tom Cole,REP,170003,8,10,46,64,04
Cotton,State House,Renae Sexton,REP,170003,6,3,19,28,65
Cotton,State House,Scott Hayes,REP,170003,0,0,11,11,65
Cotton,State House,Scooter Park,REP,170003,2,5,18,25,65
Cotton,State House,Stephen Mills,REP,170003,0,3,2,5,65
Cotton,Superintendent of Public Instruction,John Cox,DEM,170004,2,5,27,34,
Cotton,Superintendent of Public Instruction,Jack Jr.,DEM,170004,1,0,14,15,
Cotton,Superintendent of Public Instruction,Ivan Holmes,DEM,170004,1,1,10,12,
Cotton,Superintendent of Public Instruction,Freda Deskin,DEM,170004,0,4,28,32,
Cotton,U.S. Senate,Patrick Michael Hayes,DEM,170004,1,2,16,19,
Cotton,U.S. Senate,Jim Rogers,DEM,170004,2,4,34,40,
Cotton,U.S. Senate,Connie Johnson,DEM,170004,1,5,32,38,
Cotton,U.S. House,Bert Smith,DEM,170004,4,9,69,82,04
Cotton,U.S. House,Tae Si,DEM,170004,0,1,7,8,04
Cotton,Governor,Dax Ewbank,REP,170004,0,3,16,19,
Cotton,Governor,Chad Moody,REP,170004,1,2,5,8,
Cotton,Governor,Mary Fallin,REP,170004,0,3,30,33,
Cotton,Superintendent of Public Instruction,Brian Kelly,REP,170004,0,2,11,13,
Cotton,Superintendent of Public Instruction,Janet Costello Barresi,REP,170004,0,1,7,8,
Cotton,Superintendent of Public Instruction,Joy Hofmeister,REP,170004,0,5,32,37,
Cotton,Insurance Commissioner,Bill Viner,REP,170004,0,0,9,9,
Cotton,Insurance Commissioner,John Doak,REP,170004,0,8,39,47,
Cotton,Corporation Commissioner,Todd Hiett,REP,170004,0,6,31,37,
Cotton,Corporation Commissioner,Cliff Branan,REP,170004,0,2,17,19,
Cotton,U.S. Senate,Evelyn Rogers,REP,170004,0,1,2,3,
Cotton,U.S. Senate,Rob Moye,REP,170004,0,0,0,0,
Cotton,U.S. Senate,D. Jean Mcbride-Samuels,REP,170004,0,0,2,2,
Cotton,U.S. Senate,Jim Inhofe,REP,170004,0,7,37,44,
Cotton,U.S. Senate,Erick Paul Wyatt,REP,170004,0,0,9,9,
Cotton,U.S. Senate,Andy Craig,REP,170004,0,0,0,0,
Cotton,U.S. Senate,T. Shannon,REP,170004,0,3,28,31,
Cotton,U.S. Senate,Randy Brogdon,REP,170004,0,0,1,1,
Cotton,U.S. Senate,Eric Mccray,REP,170004,0,0,0,0,
Cotton,U.S. Senate,Kevin Crow,REP,170004,0,0,3,3,
Cotton,U.S. Senate,James Lankford,REP,170004,0,5,21,26,
Cotton,U.S. Senate,Jason Weger,REP,170004,0,0,0,0,
Cotton,U.S. House,Anna Flatt,REP,170004,0,1,13,14,04
Cotton,U.S. House,Tom Cole,REP,170004,0,7,40,47,04
Cotton,State House,Renae Sexton,REP,170004,0,2,9,11,65
Cotton,State House,Scott Hayes,REP,170004,0,3,12,15,65
Cotton,State House,Scooter Park,REP,170004,0,3,24,27,65
Cotton,State House,Stephen Mills,REP,170004,0,0,7,7,65
Cotton,Superintendent of Public Instruction,John Cox,DEM,170005,5,2,29,36,
Cotton,Superintendent of Public Instruction,Jack Jr.,DEM,170005,0,2,15,17,
Cotton,Superintendent of Public Instruction,Ivan Holmes,DEM,170005,0,0,3,3,
Cotton,Superintendent of Public Instruction,Freda Deskin,DEM,170005,3,0,24,27,
Cotton,U.S. Senate,Patrick Michael Hayes,DEM,170005,2,2,21,25,
Cotton,U.S. Senate,Jim Rogers,DEM,170005,3,0,22,25,
Cotton,U.S. Senate,Connie Johnson,DEM,170005,3,1,25,29,
Cotton,U.S. House,Bert Smith,DEM,170005,5,4,58,67,04
Cotton,U.S. House,Tae Si,DEM,170005,3,0,9,12,04
Cotton,Governor,Dax Ewbank,REP,170005,0,0,5,5,
Cotton,Governor,Chad Moody,REP,170005,0,0,10,10,
Cotton,Governor,Mary Fallin,REP,170005,1,3,31,35,
Cotton,Superintendent of Public Instruction,Brian Kelly,REP,170005,0,0,8,8,
Cotton,Superintendent of Public Instruction,Janet Costello Barresi,REP,170005,1,1,13,15,
Cotton,Superintendent of Public Instruction,Joy Hofmeister,REP,170005,0,2,24,26,
Cotton,Insurance Commissioner,Bill Viner,REP,170005,0,1,11,12,
Cotton,Insurance Commissioner,John Doak,REP,170005,1,2,31,34,
Cotton,Corporation Commissioner,Todd Hiett,REP,170005,0,0,18,18,
Cotton,Corporation Commissioner,Cliff Branan,REP,170005,1,3,25,29,
Cotton,U.S. Senate,Evelyn Rogers,REP,170005,0,1,3,4,
Cotton,U.S. Senate,Rob Moye,REP,170005,0,0,2,2,
Cotton,U.S. Senate,D. Jean Mcbride-Samuels,REP,170005,0,0,0,0,
Cotton,U.S. Senate,Jim Inhofe,REP,170005,1,2,40,43,
Cotton,U.S. Senate,Erick Paul Wyatt,REP,170005,0,0,0,0,
Cotton,U.S. Senate,Andy Craig,REP,170005,1,0,0,1,
Cotton,U.S. Senate,T. Shannon,REP,170005,0,2,22,24,
Cotton,U.S. Senate,Randy Brogdon,REP,170005,0,0,0,0,
Cotton,U.S. Senate,Eric Mccray,REP,170005,0,0,1,1,
Cotton,U.S. Senate,Kevin Crow,REP,170005,0,1,3,4,
Cotton,U.S. Senate,James Lankford,REP,170005,0,0,18,18,
Cotton,U.S. Senate,Jason Weger,REP,170005,0,0,0,0,
Cotton,U.S. House,Anna Flatt,REP,170005,0,2,7,9,04
Cotton,U.S. House,Tom Cole,REP,170005,1,1,37,39,04
Cotton,State House,Renae Sexton,REP,170005,0,2,6,8,65
Cotton,State House,Scott Hayes,REP,170005,0,0,3,3,65
Cotton,State House,Scooter Park,REP,170005,1,1,33,35,65
Cotton,State House,Stephen Mills,REP,170005,0,0,4,4,65
Cotton,Superintendent of Public Instruction,John Cox,DEM,170007,0,5,17,22,
Cotton,Superintendent of Public Instruction,Jack Jr.,DEM,170007,0,3,22,25,
Cotton,Superintendent of Public Instruction,Ivan Holmes,DEM,170007,1,0,4,5,
Cotton,Superintendent of Public Instruction,Freda Deskin,DEM,170007,2,1,21,24,
Cotton,U.S. Senate,Patrick Michael Hayes,DEM,170007,2,3,15,20,
Cotton,U.S. Senate,Jim Rogers,DEM,170007,1,5,23,29,
Cotton,U.S. Senate,Connie Johnson,DEM,170007,0,1,26,27,
Cotton,U.S. House,Bert Smith,DEM,170007,2,8,54,64,04
Cotton,U.S. House,Tae Si,DEM,170007,1,0,10,11,04
Cotton,Governor,Dax Ewbank,REP,170007,0,6,9,15,
Cotton,Governor,Chad Moody,REP,170007,0,5,7,12,
Cotton,Governor,Mary Fallin,REP,170007,1,4,23,28,
Cotton,Superintendent of Public Instruction,Brian Kelly,REP,170007,0,2,11,13,
Cotton,Superintendent of Public Instruction,Janet Costello Barresi,REP,170007,0,1,5,6,
Cotton,Superintendent of Public Instruction,Joy Hofmeister,REP,170007,1,12,24,37,
Cotton,Insurance Commissioner,Bill Viner,REP,170007,0,4,4,8,
Cotton,Insurance Commissioner,John Doak,REP,170007,1,9,31,41,
Cotton,Corporation Commissioner,Todd Hiett,REP,170007,1,8,20,29,
Cotton,Corporation Commissioner,Cliff Branan,REP,170007,0,6,14,20,
Cotton,U.S. Senate,Evelyn Rogers,REP,170007,0,0,0,0,
Cotton,U.S. Senate,Rob Moye,REP,170007,0,2,0,2,
Cotton,U.S. Senate,D. Jean Mcbride-Samuels,REP,170007,0,0,1,1,
Cotton,U.S. Senate,Jim Inhofe,REP,170007,1,12,35,48,
Cotton,U.S. Senate,Erick Paul Wyatt,REP,170007,0,1,4,5,
Cotton,U.S. Senate,Andy Craig,REP,170007,0,1,0,1,
Cotton,U.S. Senate,T. Shannon,REP,170007,0,1,15,16,
Cotton,U.S. Senate,Randy Brogdon,REP,170007,0,1,4,5,
Cotton,U.S. Senate,Eric Mccray,REP,170007,0,0,0,0,
Cotton,U.S. Senate,Kevin Crow,REP,170007,0,1,0,1,
Cotton,U.S. Senate,James Lankford,REP,170007,0,10,21,31,
Cotton,U.S. Senate,Jason Weger,REP,170007,1,0,0,1,
Cotton,U.S. House,Anna Flatt,REP,170007,0,4,4,8,04
Cotton,U.S. House,Tom Cole,REP,170007,1,11,37,49,04
Cotton,State House,Renae Sexton,REP,170007,0,2,7,9,65
Cotton,State House,Scott Hayes,REP,170007,0,1,2,3,65
Cotton,State House,Scooter Park,REP,170007,1,11,25,37,65
Cotton,State House,Stephen Mills,REP,170007,0,0,7,7,65
Cotton,Superintendent of Public Instruction,John Cox,DEM,170008,0,0,7,7,
Cotton,Superintendent of Public Instruction,Jack Jr.,DEM,170008,0,0,2,2,
Cotton,Superintendent of Public Instruction,Ivan Holmes,DEM,170008,0,0,3,3,
Cotton,Superintendent of Public Instruction,Freda Deskin,DEM,170008,0,0,6,6,
Cotton,U.S. Senate,Patrick Michael Hayes,DEM,170008,0,0,5,5,
Cotton,U.S. Senate,Jim Rogers,DEM,170008,0,0,8,8,
Cotton,U.S. Senate,Connie Johnson,DEM,170008,0,0,5,5,
Cotton,U.S. House,Bert Smith,DEM,170008,0,0,17,17,04
Cotton,U.S. House,Tae Si,DEM,170008,0,0,1,1,04
Cotton,Governor,Dax Ewbank,REP,170008,0,0,1,1,
Cotton,Governor,Chad Moody,REP,170008,0,0,1,1,
Cotton,Governor,Mary Fallin,REP,170008,2,1,6,9,
Cotton,Superintendent of Public Instruction,Brian Kelly,REP,170008,1,0,0,1,
Cotton,Superintendent of Public Instruction,Janet Costello Barresi,REP,170008,0,0,4,4,
Cotton,Superintendent of Public Instruction,Joy Hofmeister,REP,170008,1,0,4,5,
Cotton,Insurance Commissioner,Bill Viner,REP,170008,0,0,2,2,
Cotton,Insurance Commissioner,John Doak,REP,170008,2,0,6,8,
Cotton,Corporation Commissioner,Todd Hiett,REP,170008,2,0,6,8,
Cotton,Corporation Commissioner,Cliff Branan,REP,170008,0,1,2,3,
Cotton,U.S. Senate,Evelyn Rogers,REP,170008,0,0,0,0,
Cotton,U.S. Senate,Rob Moye,REP,170008,0,0,0,0,
Cotton,U.S. Senate,D. Jean Mcbride-Samuels,REP,170008,0,0,0,0,
Cotton,U.S. Senate,Jim Inhofe,REP,170008,2,1,7,10,
Cotton,U.S. Senate,Erick Paul Wyatt,REP,170008,0,0,1,1,
Cotton,U.S. Senate,Andy Craig,REP,170008,0,0,0,0,
Cotton,U.S. Senate,T. Shannon,REP,170008,0,0,3,3,
Cotton,U.S. Senate,Randy Brogdon,REP,170008,0,0,0,0,
Cotton,U.S. Senate,Eric Mccray,REP,170008,0,0,0,0,
Cotton,U.S. Senate,Kevin Crow,REP,170008,0,0,0,0,
Cotton,U.S. Senate,James Lankford,REP,170008,2,1,6,9,
Cotton,U.S. Senate,Jason Weger,REP,170008,0,0,0,0,
Cotton,U.S. House,Anna Flatt,REP,170008,0,1,1,2,04
Cotton,U.S. House,Tom Cole,REP,170008,2,0,7,9,04
Cotton,State House,Renae Sexton,REP,170008,0,0,1,1,65
Cotton,State House,Scott Hayes,REP,170008,0,0,2,2,65
Cotton,State House,Scooter Park,REP,170008,2,1,6,9,65
Cotton,State House,Stephen Mills,REP,170008,0,0,0,0,65
Cotton,Superintendent of Public Instruction,John Cox,DEM,170009,0,1,20,21,
Cotton,Superintendent of Public Instruction,Jack Jr.,DEM,170009,1,4,16,21,
Cotton,Superintendent of Public Instruction,Ivan Holmes,DEM,170009,0,0,5,5,
Cotton,Superintendent of Public Instruction,Freda Deskin,DEM,170009,0,1,11,12,
Cotton,U.S. Senate,Patrick Michael Hayes,DEM,170009,1,2,15,18,
Cotton,U.S. Senate,Jim Rogers,DEM,170009,0,3,22,25,
Cotton,U.S. Senate,Connie Johnson,DEM,170009,0,1,11,12,
Cotton,U.S. House,Bert Smith,DEM,170009,1,6,43,50,04
Cotton,U.S. House,Tae Si,DEM,170009,0,0,5,5,04
Cotton,Governor,Dax Ewbank,REP,170009,0,3,10,13,
Cotton,Governor,Chad Moody,REP,170009,0,3,9,12,
Cotton,Governor,Mary Fallin,REP,170009,3,6,21,30,
Cotton,Superintendent of Public Instruction,Brian Kelly,REP,170009,1,1,10,12,
Cotton,Superintendent of Public Instruction,Janet Costello Barresi,REP,170009,2,1,5,8,
Cotton,Superintendent of Public Instruction,Joy Hofmeister,REP,170009,0,10,25,35,
Cotton,Insurance Commissioner,Bill Viner,REP,170009,1,1,13,15,
Cotton,Insurance Commissioner,John Doak,REP,170009,2,7,27,36,
Cotton,Corporation Commissioner,Todd Hiett,REP,170009,1,6,31,38,
Cotton,Corporation Commissioner,Cliff Branan,REP,170009,2,2,9,13,
Cotton,U.S. Senate,Evelyn Rogers,REP,170009,2,0,1,3,
Cotton,U.S. Senate,Rob Moye,REP,170009,0,0,0,0,
Cotton,U.S. Senate,D. Jean Mcbride-Samuels,REP,170009,0,0,0,0,
Cotton,U.S. Senate,Jim Inhofe,REP,170009,1,10,37,48,
Cotton,U.S. Senate,Erick Paul Wyatt,REP,170009,0,0,2,2,
Cotton,U.S. Senate,Andy Craig,REP,170009,0,0,0,0,
Cotton,U.S. Senate,T. Shannon,REP,170009,3,0,14,17,
Cotton,U.S. Senate,Randy Brogdon,REP,170009,0,1,5,6,
Cotton,U.S. Senate,Eric Mccray,REP,170009,0,0,1,1,
Cotton,U.S. Senate,Kevin Crow,REP,170009,0,0,0,0,
Cotton,U.S. Senate,James Lankford,REP,170009,0,10,20,30,
Cotton,U.S. Senate,Jason Weger,REP,170009,0,0,0,0,
Cotton,U.S. House,Anna Flatt,REP,170009,2,0,7,9,04
Cotton,U.S. House,Tom Cole,REP,170009,0,11,33,44,04
Cotton,State House,Renae Sexton,REP,170009,3,1,9,13,65
Cotton,State House,Scott Hayes,REP,170009,0,0,2,2,65
Cotton,State House,Scooter Park,REP,170009,0,7,24,31,65
Cotton,State House,Stephen Mills,REP,170009,0,2,5,7,65
Cotton,Superintendent of Public Instruction,John Cox,DEM,170010,0,0,4,4,
Cotton,Superintendent of Public Instruction,Jack Jr.,DEM,170010,0,0,2,2,
Cotton,Superintendent of Public Instruction,Ivan Holmes,DEM,170010,0,0,0,0,
Cotton,Superintendent of Public Instruction,Freda Deskin,DEM,170010,0,0,5,5,
Cotton,U.S. Senate,Patrick Michael Hayes,DEM,170010,0,0,5,5,
Cotton,U.S. Senate,Jim Rogers,DEM,170010,0,0,4,4,
Cotton,U.S. Senate,Connie Johnson,DEM,170010,0,0,2,2,
Cotton,U.S. House,Bert Smith,DEM,170010,0,0,10,10,04
Cotton,U.S. House,Tae Si,DEM,170010,0,0,0,0,04
Cotton,Governor,Dax Ewbank,REP,170010,0,0,4,4,
Cotton,Governor,Chad Moody,REP,170010,0,1,8,9,
Cotton,Governor,Mary Fallin,REP,170010,0,2,23,25,
Cotton,Superintendent of Public Instruction,Brian Kelly,REP,170010,0,1,9,10,
Cotton,Superintendent of Public Instruction,Janet Costello Barresi,REP,170010,0,0,6,6,
Cotton,Superintendent of Public Instruction,Joy Hofmeister,REP,170010,0,2,20,22,
Cotton,Insurance Commissioner,Bill Viner,REP,170010,0,1,13,14,
Cotton,Insurance Commissioner,John Doak,REP,170010,0,2,20,22,
Cotton,Corporation Commissioner,Todd Hiett,REP,170010,0,1,21,22,
Cotton,Corporation Commissioner,Cliff Branan,REP,170010,0,2,12,14,
Cotton,U.S. Senate,Evelyn Rogers,REP,170010,0,0,4,4,
Cotton,U.S. Senate,Rob Moye,REP,170010,0,0,1,1,
Cotton,U.S. Senate,D. Jean Mcbride-Samuels,REP,170010,0,1,3,4,
Cotton,U.S. Senate,Jim Inhofe,REP,170010,0,2,19,21,
Cotton,U.S. Senate,Erick Paul Wyatt,REP,170010,0,0,6,6,
Cotton,U.S. Senate,Andy Craig,REP,170010,0,0,4,4,
Cotton,U.S. Senate,T. Shannon,REP,170010,0,0,11,11,
Cotton,U.S. Senate,Randy Brogdon,REP,170010,0,2,1,3,
Cotton,U.S. Senate,Eric Mccray,REP,170010,0,0,1,1,
Cotton,U.S. Senate,Kevin Crow,REP,170010,0,0,0,0,
Cotton,U.S. Senate,James Lankford,REP,170010,0,1,15,16,
Cotton,U.S. Senate,Jason Weger,REP,170010,0,0,2,2,
Cotton,U.S. House,Anna Flatt,REP,170010,0,1,7,8,04
Cotton,U.S. House,Tom Cole,REP,170010,0,2,28,30,04
Cotton,State House,Renae Sexton,REP,170010,0,0,5,5,65
Cotton,State House,Scott Hayes,REP,170010,0,0,1,1,65
Cotton,State House,Scooter Park,REP,170010,0,3,29,32,65
Cotton,State House,Stephen Mills,REP,170010,0,0,1,1,65
Cotton,Superintendent of Public Instruction,John Cox,DEM,170011,0,1,9,10,
Cotton,Superintendent of Public Instruction,Jack Jr.,DEM,170011,0,0,4,4,
Cotton,Superintendent of Public Instruction,Ivan Holmes,DEM,170011,0,0,3,3,
Cotton,Superintendent of Public Instruction,Freda Deskin,DEM,170011,0,0,3,3,
Cotton,U.S. Senate,Patrick Michael Hayes,DEM,170011,0,0,4,4,
Cotton,U.S. Senate,Jim Rogers,DEM,170011,0,1,9,10,
Cotton,U.S. Senate,Connie Johnson,DEM,170011,0,0,6,6,
Cotton,U.S. House,Bert Smith,DEM,170011,0,1,16,17,04
Cotton,U.S. House,Tae Si,DEM,170011,0,0,3,3,04
Cotton,Governor,Dax Ewbank,REP,170011,0,0,15,15,
Cotton,Governor,Chad Moody,REP,170011,0,0,4,4,
Cotton,Governor,Mary Fallin,REP,170011,0,0,35,35,
Cotton,Superintendent of Public Instruction,Brian Kelly,REP,170011,0,0,12,12,
Cotton,Superintendent of Public Instruction,Janet Costello Barresi,REP,170011,0,0,3,3,
Cotton,Superintendent of Public Instruction,Joy Hofmeister,REP,170011,0,0,40,40,
Cotton,Insurance Commissioner,Bill Viner,REP,170011,0,0,18,18,
Cotton,Insurance Commissioner,John Doak,REP,170011,0,0,32,32,
Cotton,Corporation Commissioner,Todd Hiett,REP,170011,0,0,31,31,
Cotton,Corporation Commissioner,Cliff Branan,REP,170011,0,0,18,18,
Cotton,U.S. Senate,Evelyn Rogers,REP,170011,0,0,7,7,
Cotton,U.S. Senate,Rob Moye,REP,170011,0,0,7,7,
Cotton,U.S. Senate,D. Jean Mcbride-Samuels,REP,170011,0,0,0,0,
Cotton,U.S. Senate,Jim Inhofe,REP,170011,0,0,36,36,
Cotton,U.S. Senate,Erick Paul Wyatt,REP,170011,0,0,3,3,
Cotton,U.S. Senate,Andy Craig,REP,170011,0,0,2,2,
Cotton,U.S. Senate,T. Shannon,REP,170011,0,0,20,20,
Cotton,U.S. Senate,Randy Brogdon,REP,170011,0,0,10,10,
Cotton,U.S. Senate,Eric Mccray,REP,170011,0,0,1,1,
Cotton,U.S. Senate,Kevin Crow,REP,170011,0,0,0,0,
Cotton,U.S. Senate,James Lankford,REP,170011,0,0,22,22,
Cotton,U.S. Senate,Jason Weger,REP,170011,0,0,0,0,
Cotton,U.S. House,Anna Flatt,REP,170011,0,0,21,21,04
Cotton,U.S. House,Tom Cole,REP,170011,0,0,34,34,04
Cotton,State House,Renae Sexton,REP,170011,0,0,4,4,65
Cotton,State House,Scott Hayes,REP,170011,0,0,0,0,65
Cotton,State House,Scooter Park,REP,170011,0,0,45,45,65
Cotton,State House,Stephen Mills,REP,170011,0,0,11,11,65
Craig,Superintendent of Public Instruction,John Cox,DEM,180140,0,0,50,50,
Craig,Superintendent of Public Instruction,Jack Jr.,DEM,180140,1,0,14,15,
Craig,Superintendent of Public Instruction,Ivan Holmes,DEM,180140,0,0,12,12,
Craig,Superintendent of Public Instruction,Freda Deskin,DEM,180140,1,0,29,30,
Craig,U.S. Senate,Patrick Michael Hayes,DEM,180140,0,0,22,22,
Craig,U.S. Senate,Jim Rogers,DEM,180140,2,0,41,43,
Craig,U.S. Senate,Connie Johnson,DEM,180140,0,0,37,37,
Craig,U.S. House,Earl Everett,DEM,180140,2,0,70,72,02
Craig,U.S. House,Joshua Harris-Till,DEM,180140,0,0,24,24,02
Craig,Governor,Dax Ewbank,REP,180140,1,1,9,11,
Craig,Governor,Chad Moody,REP,180140,0,0,12,12,
Craig,Governor,Mary Fallin,REP,180140,3,0,42,45,
Craig,Superintendent of Public Instruction,Brian Kelly,REP,180140,2,0,13,15,
Craig,Superintendent of Public Instruction,Janet Costello Barresi,REP,180140,0,0,11,11,
Craig,Superintendent of Public Instruction,Joy Hofmeister,REP,180140,2,1,41,44,
Craig,Insurance Commissioner,Bill Viner,REP,180140,1,0,15,16,
Craig,Insurance Commissioner,John Doak,REP,180140,3,1,44,48,
Craig,Corporation Commissioner,Todd Hiett,REP,180140,3,1,34,38,
Craig,Corporation Commissioner,Cliff Branan,REP,180140,1,0,24,25,
Craig,U.S. Senate,Evelyn Rogers,REP,180140,0,0,2,2,
Craig,U.S. Senate,Rob Moye,REP,180140,0,0,2,2,
Craig,U.S. Senate,D. Jean Mcbride-Samuels,REP,180140,0,0,0,0,
Craig,U.S. Senate,Jim Inhofe,REP,180140,4,1,51,56,
Craig,U.S. Senate,Erick Paul Wyatt,REP,180140,0,0,7,7,
Craig,U.S. Senate,Andy Craig,REP,180140,0,0,2,2,
Craig,U.S. Senate,T. Shannon,REP,180140,2,0,35,37,
Craig,U.S. Senate,Randy Brogdon,REP,180140,0,1,1,2,
Craig,U.S. Senate,Eric Mccray,REP,180140,0,0,0,0,
Craig,U.S. Senate,Kevin Crow,REP,180140,0,0,0,0,
Craig,U.S. Senate,James Lankford,REP,180140,2,0,27,29,
Craig,U.S. Senate,Jason Weger,REP,180140,0,0,0,0,
Craig,U.S. House,Darrel Robertson,REP,180140,0,1,20,21,02
Craig,U.S. House,Markwayne Mullin,REP,180140,4,0,44,48,02
Craig,Superintendent of Public Instruction,John Cox,DEM,180320,0,2,28,30,
Craig,Superintendent of Public Instruction,Jack Jr.,DEM,180320,0,0,6,6,
Craig,Superintendent of Public Instruction,Ivan Holmes,DEM,180320,0,0,2,2,
Craig,Superintendent of Public Instruction,Freda Deskin,DEM,180320,1,0,11,12,
Craig,U.S. Senate,Patrick Michael Hayes,DEM,180320,1,2,7,10,
Craig,U.S. Senate,Jim Rogers,DEM,180320,0,0,22,22,
Craig,U.S. Senate,Connie Johnson,DEM,180320,0,0,17,17,
Craig,U.S. House,Earl Everett,DEM,180320,0,2,29,31,02
Craig,U.S. House,Joshua Harris-Till,DEM,180320,1,0,15,16,02
Craig,Governor,Dax Ewbank,REP,180320,1,0,0,1,
Craig,Governor,Chad Moody,REP,180320,0,0,1,1,
Craig,Governor,Mary Fallin,REP,180320,5,0,9,14,
Craig,Superintendent of Public Instruction,Brian Kelly,REP,180320,4,0,1,5,
Craig,Superintendent of Public Instruction,Janet Costello Barresi,REP,180320,0,0,2,2,
Craig,Superintendent of Public Instruction,Joy Hofmeister,REP,180320,2,0,5,7,
Craig,Insurance Commissioner,Bill Viner,REP,180320,1,0,2,3,
Craig,Insurance Commissioner,John Doak,REP,180320,5,0,6,11,
Craig,Corporation Commissioner,Todd Hiett,REP,180320,2,0,4,6,
Craig,Corporation Commissioner,Cliff Branan,REP,180320,4,0,4,8,
Craig,U.S. Senate,Evelyn Rogers,REP,180320,0,0,0,0,
Craig,U.S. Senate,Rob Moye,REP,180320,0,0,1,1,
Craig,U.S. Senate,D. Jean Mcbride-Samuels,REP,180320,0,0,0,0,
Craig,U.S. Senate,Jim Inhofe,REP,180320,6,0,9,15,
Craig,U.S. Senate,Erick Paul Wyatt,REP,180320,0,0,0,0,
Craig,U.S. Senate,Andy Craig,REP,180320,0,0,0,0,
Craig,U.S. Senate,T. Shannon,REP,180320,5,0,8,13,
Craig,U.S. Senate,Randy Brogdon,REP,180320,0,0,0,0,
Craig,U.S. Senate,Eric Mccray,REP,180320,0,0,0,0,
Craig,U.S. Senate,Kevin Crow,REP,180320,0,0,0,0,
Craig,U.S. Senate,James Lankford,REP,180320,1,0,1,2,
Craig,U.S. Senate,Jason Weger,REP,180320,0,0,0,0,
Craig,U.S. House,Darrel Robertson,REP,180320,1,0,0,1,02
Craig,U.S. House,Markwayne Mullin,REP,180320,5,0,10,15,02
Craig,Superintendent of Public Instruction,John Cox,DEM,180410,0,3,33,36,
Craig,Superintendent of Public Instruction,Jack Jr.,DEM,180410,0,0,6,6,
Craig,Superintendent of Public Instruction,Ivan Holmes,DEM,180410,0,0,5,5,
Craig,Superintendent of Public Instruction,Freda Deskin,DEM,180410,0,0,26,26,
Craig,U.S. Senate,Patrick Michael Hayes,DEM,180410,0,1,16,17,
Craig,U.S. Senate,Jim Rogers,DEM,180410,0,0,31,31,
Craig,U.S. Senate,Connie Johnson,DEM,180410,0,2,21,23,
Craig,U.S. House,Earl Everett,DEM,180410,0,1,44,45,02
Craig,U.S. House,Joshua Harris-Till,DEM,180410,0,2,25,27,02
Craig,Governor,Dax Ewbank,REP,180410,0,0,0,0,
Craig,Governor,Chad Moody,REP,180410,0,0,2,2,
Craig,Governor,Mary Fallin,REP,180410,1,1,33,35,
Craig,Superintendent of Public Instruction,Brian Kelly,REP,180410,0,0,9,9,
Craig,Superintendent of Public Instruction,Janet Costello Barresi,REP,180410,1,1,10,12,
Craig,Superintendent of Public Instruction,Joy Hofmeister,REP,180410,0,0,15,15,
Craig,Insurance Commissioner,Bill Viner,REP,180410,0,0,4,4,
Craig,Insurance Commissioner,John Doak,REP,180410,1,1,29,31,
Craig,Corporation Commissioner,Todd Hiett,REP,180410,0,1,19,20,
Craig,Corporation Commissioner,Cliff Branan,REP,180410,1,0,15,16,
Craig,U.S. Senate,Evelyn Rogers,REP,180410,0,0,3,3,
Craig,U.S. Senate,Rob Moye,REP,180410,0,0,1,1,
Craig,U.S. Senate,D. Jean Mcbride-Samuels,REP,180410,0,0,0,0,
Craig,U.S. Senate,Jim Inhofe,REP,180410,1,1,28,30,
Craig,U.S. Senate,Erick Paul Wyatt,REP,180410,0,0,2,2,
Craig,U.S. Senate,Andy Craig,REP,180410,0,0,2,2,
Craig,U.S. Senate,T. Shannon,REP,180410,0,0,17,17,
Craig,U.S. Senate,Randy Brogdon,REP,180410,0,0,0,0,
Craig,U.S. Senate,Eric Mccray,REP,180410,0,0,0,0,
Craig,U.S. Senate,Kevin Crow,REP,180410,0,0,1,1,
Craig,U.S. Senate,James Lankford,REP,180410,1,1,13,15,
Craig,U.S. Senate,Jason Weger,REP,180410,0,0,2,2,
Craig,U.S. House,Darrel Robertson,REP,180410,0,0,5,5,02
Craig,U.S. House,Markwayne Mullin,REP,180410,1,1,30,32,02
Craig,Superintendent of Public Instruction,John Cox,DEM,180520,0,3,68,71,
Craig,Superintendent of Public Instruction,Jack Jr.,DEM,180520,0,0,13,13,
Craig,Superintendent of Public Instruction,Ivan Holmes,DEM,180520,0,2,6,8,
Craig,Superintendent of Public Instruction,Freda Deskin,DEM,180520,0,4,37,41,
Craig,U.S. Senate,Patrick Michael Hayes,DEM,180520,0,0,33,33,
Craig,U.S. Senate,Jim Rogers,DEM,180520,0,6,44,50,
Craig,U.S. Senate,Connie Johnson,DEM,180520,0,2,41,43,
Craig,U.S. House,Earl Everett,DEM,180520,0,6,78,84,02
Craig,U.S. House,Joshua Harris-Till,DEM,180520,0,1,38,39,02
Craig,Governor,Dax Ewbank,REP,180520,0,0,4,4,
Craig,Governor,Chad Moody,REP,180520,0,0,3,3,
Craig,Governor,Mary Fallin,REP,180520,0,4,35,39,
Craig,Superintendent of Public Instruction,Brian Kelly,REP,180520,0,1,10,11,
Craig,Superintendent of Public Instruction,Janet Costello Barresi,REP,180520,0,0,7,7,
Craig,Superintendent of Public Instruction,Joy Hofmeister,REP,180520,0,3,22,25,
Craig,Insurance Commissioner,Bill Viner,REP,180520,0,0,4,4,
Craig,Insurance Commissioner,John Doak,REP,180520,0,4,31,35,
Craig,Corporation Commissioner,Todd Hiett,REP,180520,0,3,22,25,
Craig,Corporation Commissioner,Cliff Branan,REP,180520,0,1,18,19,
Craig,U.S. Senate,Evelyn Rogers,REP,180520,0,0,2,2,
Craig,U.S. Senate,Rob Moye,REP,180520,0,0,1,1,
Craig,U.S. Senate,D. Jean Mcbride-Samuels,REP,180520,0,0,0,0,
Craig,U.S. Senate,Jim Inhofe,REP,180520,0,4,33,37,
Craig,U.S. Senate,Erick Paul Wyatt,REP,180520,0,0,5,5,
Craig,U.S. Senate,Andy Craig,REP,180520,0,0,0,0,
Craig,U.S. Senate,T. Shannon,REP,180520,0,4,28,32,
Craig,U.S. Senate,Randy Brogdon,REP,180520,0,0,1,1,
Craig,U.S. Senate,Eric Mccray,REP,180520,0,0,0,0,
Craig,U.S. Senate,Kevin Crow,REP,180520,0,0,0,0,
Craig,U.S. Senate,James Lankford,REP,180520,0,0,12,12,
Craig,U.S. Senate,Jason Weger,REP,180520,0,0,1,1,
Craig,U.S. House,Darrel Robertson,REP,180520,0,0,4,4,02
Craig,U.S. House,Markwayne Mullin,REP,180520,0,4,38,42,02
Craig,Superintendent of Public Instruction,John Cox,DEM,180611,0,5,52,57,
Craig,Superintendent of Public Instruction,Jack Jr.,DEM,180611,0,1,11,12,
Craig,Superintendent of Public Instruction,Ivan Holmes,DEM,180611,0,0,6,6,
Craig,Superintendent of Public Instruction,Freda Deskin,DEM,180611,0,3,59,62,
Craig,U.S. Senate,Patrick Michael Hayes,DEM,180611,0,3,23,26,
Craig,U.S. Senate,Jim Rogers,DEM,180611,0,3,53,56,
Craig,U.S. Senate,Connie Johnson,DEM,180611,0,2,43,45,
Craig,U.S. House,Earl Everett,DEM,180611,0,4,78,82,02
Craig,U.S. House,Joshua Harris-Till,DEM,180611,0,4,42,46,02
Craig,Governor,Dax Ewbank,REP,180611,0,0,14,14,
Craig,Governor,Chad Moody,REP,180611,0,1,11,12,
Craig,Governor,Mary Fallin,REP,180611,0,2,34,36,
Craig,Superintendent of Public Instruction,Brian Kelly,REP,180611,0,0,8,8,
Craig,Superintendent of Public Instruction,Janet Costello Barresi,REP,180611,0,0,7,7,
Craig,Superintendent of Public Instruction,Joy Hofmeister,REP,180611,0,3,44,47,
Craig,Insurance Commissioner,Bill Viner,REP,180611,0,1,11,12,
Craig,Insurance Commissioner,John Doak,REP,180611,0,1,45,46,
Craig,Corporation Commissioner,Todd Hiett,REP,180611,0,1,34,35,
Craig,Corporation Commissioner,Cliff Branan,REP,180611,0,1,23,24,
Craig,U.S. Senate,Evelyn Rogers,REP,180611,0,0,4,4,
Craig,U.S. Senate,Rob Moye,REP,180611,0,0,2,2,
Craig,U.S. Senate,D. Jean Mcbride-Samuels,REP,180611,0,0,1,1,
Craig,U.S. Senate,Jim Inhofe,REP,180611,0,2,45,47,
Craig,U.S. Senate,Erick Paul Wyatt,REP,180611,0,0,7,7,
Craig,U.S. Senate,Andy Craig,REP,180611,0,0,0,0,
Craig,U.S. Senate,T. Shannon,REP,180611,0,1,24,25,
Craig,U.S. Senate,Randy Brogdon,REP,180611,0,0,1,1,
Craig,U.S. Senate,Eric Mccray,REP,180611,0,0,1,1,
Craig,U.S. Senate,Kevin Crow,REP,180611,0,0,0,0,
Craig,U.S. Senate,James Lankford,REP,180611,0,2,32,34,
Craig,U.S. Senate,Jason Weger,REP,180611,0,0,0,0,
Craig,U.S. House,Darrel Robertson,REP,180611,0,0,6,6,02
Craig,U.S. House,Markwayne Mullin,REP,180611,0,3,53,56,02
Craig,Superintendent of Public Instruction,John Cox,DEM,180612,0,0,34,34,
Craig,Superintendent of Public Instruction,Jack Jr.,DEM,180612,0,0,3,3,
Craig,Superintendent of Public Instruction,Ivan Holmes,DEM,180612,0,0,4,4,
Craig,Superintendent of Public Instruction,Freda Deskin,DEM,180612,0,3,31,34,
Craig,U.S. Senate,Patrick Michael Hayes,DEM,180612,0,1,20,21,
Craig,U.S. Senate,Jim Rogers,DEM,180612,0,0,28,28,
Craig,U.S. Senate,Connie Johnson,DEM,180612,0,2,22,24,
Craig,U.S. House,Earl Everett,DEM,180612,0,1,48,49,02
Craig,U.S. House,Joshua Harris-Till,DEM,180612,0,2,22,24,02
Craig,Governor,Dax Ewbank,REP,180612,0,0,2,2,
Craig,Governor,Chad Moody,REP,180612,0,0,6,6,
Craig,Governor,Mary Fallin,REP,180612,4,0,19,23,
Craig,Superintendent of Public Instruction,Brian Kelly,REP,180612,2,0,7,9,
Craig,Superintendent of Public Instruction,Janet Costello Barresi,REP,180612,0,0,1,1,
Craig,Superintendent of Public Instruction,Joy Hofmeister,REP,180612,1,0,19,20,
Craig,Insurance Commissioner,Bill Viner,REP,180612,0,0,4,4,
Craig,Insurance Commissioner,John Doak,REP,180612,3,0,22,25,
Craig,Corporation Commissioner,Todd Hiett,REP,180612,3,0,18,21,
Craig,Corporation Commissioner,Cliff Branan,REP,180612,0,0,8,8,
Craig,U.S. Senate,Evelyn Rogers,REP,180612,0,0,1,1,
Craig,U.S. Senate,Rob Moye,REP,180612,0,0,0,0,
Craig,U.S. Senate,D. Jean Mcbride-Samuels,REP,180612,0,0,1,1,
Craig,U.S. Senate,Jim Inhofe,REP,180612,4,0,21,25,
Craig,U.S. Senate,Erick Paul Wyatt,REP,180612,0,0,3,3,
Craig,U.S. Senate,Andy Craig,REP,180612,0,0,1,1,
Craig,U.S. Senate,T. Shannon,REP,180612,0,0,9,9,
Craig,U.S. Senate,Randy Brogdon,REP,180612,0,0,0,0,
Craig,U.S. Senate,Eric Mccray,REP,180612,0,0,0,0,
Craig,U.S. Senate,Kevin Crow,REP,180612,0,0,0,0,
Craig,U.S. Senate,James Lankford,REP,180612,4,0,16,20,
Craig,U.S. Senate,Jason Weger,REP,180612,0,0,0,0,
Craig,U.S. House,Darrel Robertson,REP,180612,1,0,6,7,02
Craig,U.S. House,Markwayne Mullin,REP,180612,2,0,21,23,02
Craig,Superintendent of Public Instruction,John Cox,DEM,180621,1,7,108,116,
Craig,Superintendent of Public Instruction,Jack Jr.,DEM,180621,0,2,24,26,
Craig,Superintendent of Public Instruction,Ivan Holmes,DEM,180621,0,0,24,24,
Craig,Superintendent of Public Instruction,Freda Deskin,DEM,180621,1,3,74,78,
Craig,U.S. Senate,Patrick Michael Hayes,DEM,180621,0,1,56,57,
Craig,U.S. Senate,Jim Rogers,DEM,180621,0,4,82,86,
Craig,U.S. Senate,Connie Johnson,DEM,180621,2,6,82,90,
Craig,U.S. House,Earl Everett,DEM,180621,1,6,134,141,02
Craig,U.S. House,Joshua Harris-Till,DEM,180621,1,5,79,85,02
Craig,Governor,Dax Ewbank,REP,180621,0,6,10,16,
Craig,Governor,Chad Moody,REP,180621,1,2,11,14,
Craig,Governor,Mary Fallin,REP,180621,0,7,61,68,
Craig,Superintendent of Public Instruction,Brian Kelly,REP,180621,0,1,16,17,
Craig,Superintendent of Public Instruction,Janet Costello Barresi,REP,180621,1,2,14,17,
Craig,Superintendent of Public Instruction,Joy Hofmeister,REP,180621,0,12,50,62,
Craig,Insurance Commissioner,Bill Viner,REP,180621,0,2,20,22,
Craig,Insurance Commissioner,John Doak,REP,180621,1,13,58,72,
Craig,Corporation Commissioner,Todd Hiett,REP,180621,0,12,38,50,
Craig,Corporation Commissioner,Cliff Branan,REP,180621,1,3,41,45,
Craig,U.S. Senate,Evelyn Rogers,REP,180621,0,0,5,5,
Craig,U.S. Senate,Rob Moye,REP,180621,0,0,2,2,
Craig,U.S. Senate,D. Jean Mcbride-Samuels,REP,180621,0,1,1,2,
Craig,U.S. Senate,Jim Inhofe,REP,180621,1,9,69,79,
Craig,U.S. Senate,Erick Paul Wyatt,REP,180621,0,5,3,8,
Craig,U.S. Senate,Andy Craig,REP,180621,0,1,1,2,
Craig,U.S. Senate,T. Shannon,REP,180621,0,9,39,48,
Craig,U.S. Senate,Randy Brogdon,REP,180621,0,0,2,2,
Craig,U.S. Senate,Eric Mccray,REP,180621,0,0,0,0,
Craig,U.S. Senate,Kevin Crow,REP,180621,0,0,3,3,
Craig,U.S. Senate,James Lankford,REP,180621,1,4,35,40,
Craig,U.S. Senate,Jason Weger,REP,180621,0,0,0,0,
Craig,U.S. House,Darrel Robertson,REP,180621,0,5,8,13,02
Craig,U.S. House,Markwayne Mullin,REP,180621,1,10,73,84,02
Craig,Superintendent of Public Instruction,John Cox,DEM,180622,2,0,62,64,
Craig,Superintendent of Public Instruction,Jack Jr.,DEM,180622,1,0,12,13,
Craig,Superintendent of Public Instruction,Ivan Holmes,DEM,180622,1,1,1,3,
Craig,Superintendent of Public Instruction,Freda Deskin,DEM,180622,0,3,45,48,
Craig,U.S. Senate,Patrick Michael Hayes,DEM,180622,0,2,30,32,
Craig,U.S. Senate,Jim Rogers,DEM,180622,2,0,47,49,
Craig,U.S. Senate,Connie Johnson,DEM,180622,2,3,40,45,
Craig,U.S. House,Earl Everett,DEM,180622,2,2,71,75,02
Craig,U.S. House,Joshua Harris-Till,DEM,180622,2,3,37,42,02
Craig,Governor,Dax Ewbank,REP,180622,0,0,0,0,
Craig,Governor,Chad Moody,REP,180622,0,2,8,10,
Craig,Governor,Mary Fallin,REP,180622,1,2,29,32,
Craig,Superintendent of Public Instruction,Brian Kelly,REP,180622,1,0,13,14,
Craig,Superintendent of Public Instruction,Janet Costello Barresi,REP,180622,0,0,1,1,
Craig,Superintendent of Public Instruction,Joy Hofmeister,REP,180622,0,4,23,27,
Craig,Insurance Commissioner,Bill Viner,REP,180622,0,2,11,13,
Craig,Insurance Commissioner,John Doak,REP,180622,1,2,25,28,
Craig,Corporation Commissioner,Todd Hiett,REP,180622,0,4,21,25,
Craig,Corporation Commissioner,Cliff Branan,REP,180622,1,0,16,17,
Craig,U.S. Senate,Evelyn Rogers,REP,180622,0,0,1,1,
Craig,U.S. Senate,Rob Moye,REP,180622,0,0,2,2,
Craig,U.S. Senate,D. Jean Mcbride-Samuels,REP,180622,0,0,0,0,
Craig,U.S. Senate,Jim Inhofe,REP,180622,1,4,30,35,
Craig,U.S. Senate,Erick Paul Wyatt,REP,180622,0,0,4,4,
Craig,U.S. Senate,Andy Craig,REP,180622,0,0,1,1,
Craig,U.S. Senate,T. Shannon,REP,180622,1,0,13,14,
Craig,U.S. Senate,Randy Brogdon,REP,180622,0,0,0,0,
Craig,U.S. Senate,Eric Mccray,REP,180622,0,0,0,0,
Craig,U.S. Senate,Kevin Crow,REP,180622,0,0,0,0,
Craig,U.S. Senate,James Lankford,REP,180622,0,4,23,27,
Craig,U.S. Senate,Jason Weger,REP,180622,0,0,0,0,
Craig,U.S. House,Darrel Robertson,REP,180622,0,0,3,3,02
Craig,U.S. House,Markwayne Mullin,REP,180622,1,4,34,39,02
Craig,Superintendent of Public Instruction,John Cox,DEM,180710,0,3,44,47,
Craig,Superintendent of Public Instruction,Jack Jr.,DEM,180710,0,0,11,11,
Craig,Superintendent of Public Instruction,Ivan Holmes,DEM,180710,0,0,5,5,
Craig,Superintendent of Public Instruction,Freda Deskin,DEM,180710,1,0,27,28,
Craig,U.S. Senate,Patrick Michael Hayes,DEM,180710,0,1,32,33,
Craig,U.S. Senate,Jim Rogers,DEM,180710,0,2,19,21,
Craig,U.S. Senate,Connie Johnson,DEM,180710,1,0,35,36,
Craig,U.S. House,Earl Everett,DEM,180710,0,2,41,43,02
Craig,U.S. House,Joshua Harris-Till,DEM,180710,1,1,42,44,02
Craig,Governor,Dax Ewbank,REP,180710,2,1,2,5,
Craig,Governor,Chad Moody,REP,180710,0,0,9,9,
Craig,Governor,Mary Fallin,REP,180710,3,2,39,44,
Craig,Superintendent of Public Instruction,Brian Kelly,REP,180710,1,0,12,13,
Craig,Superintendent of Public Instruction,Janet Costello Barresi,REP,180710,2,0,7,9,
Craig,Superintendent of Public Instruction,Joy Hofmeister,REP,180710,2,3,29,34,
Craig,Insurance Commissioner,Bill Viner,REP,180710,4,1,9,14,
Craig,Insurance Commissioner,John Doak,REP,180710,1,1,35,37,
Craig,Corporation Commissioner,Todd Hiett,REP,180710,4,2,23,29,
Craig,Corporation Commissioner,Cliff Branan,REP,180710,1,0,23,24,
Craig,U.S. Senate,Evelyn Rogers,REP,180710,0,0,1,1,
Craig,U.S. Senate,Rob Moye,REP,180710,0,0,0,0,
Craig,U.S. Senate,D. Jean Mcbride-Samuels,REP,180710,0,0,0,0,
Craig,U.S. Senate,Jim Inhofe,REP,180710,5,2,41,48,
Craig,U.S. Senate,Erick Paul Wyatt,REP,180710,0,1,6,7,
Craig,U.S. Senate,Andy Craig,REP,180710,0,0,0,0,
Craig,U.S. Senate,T. Shannon,REP,180710,5,1,25,31,
Craig,U.S. Senate,Randy Brogdon,REP,180710,0,0,3,3,
Craig,U.S. Senate,Eric Mccray,REP,180710,0,0,0,0,
Craig,U.S. Senate,Kevin Crow,REP,180710,0,0,1,1,
Craig,U.S. Senate,James Lankford,REP,180710,0,2,19,21,
Craig,U.S. Senate,Jason Weger,REP,180710,0,0,1,1,
Craig,U.S. House,Darrel Robertson,REP,180710,2,1,11,14,02
Craig,U.S. House,Markwayne Mullin,REP,180710,3,3,39,45,02
Craig,Superintendent of Public Instruction,John Cox,DEM,180810,2,3,74,79,
Craig,Superintendent of Public Instruction,Jack Jr.,DEM,180810,0,1,23,24,
Craig,Superintendent of Public Instruction,Ivan Holmes,DEM,180810,0,0,9,9,
Craig,Superintendent of Public Instruction,Freda Deskin,DEM,180810,0,2,42,44,
Craig,U.S. Senate,Patrick Michael Hayes,DEM,180810,0,0,36,36,
Craig,U.S. Senate,Jim Rogers,DEM,180810,0,4,57,61,
Craig,U.S. Senate,Connie Johnson,DEM,180810,0,2,52,54,
Craig,U.S. House,Earl Everett,DEM,180810,0,4,83,87,02
Craig,U.S. House,Joshua Harris-Till,DEM,180810,0,2,59,61,02
Craig,Governor,Dax Ewbank,REP,180810,0,0,2,2,
Craig,Governor,Chad Moody,REP,180810,0,0,14,14,
Craig,Governor,Mary Fallin,REP,180810,0,8,73,81,
Craig,Superintendent of Public Instruction,Brian Kelly,REP,180810,0,2,24,26,
Craig,Superintendent of Public Instruction,Janet Costello Barresi,REP,180810,0,2,15,17,
Craig,Superintendent of Public Instruction,Joy Hofmeister,REP,180810,0,4,50,54,
Craig,Insurance Commissioner,Bill Viner,REP,180810,0,0,21,21,
Craig,Insurance Commissioner,John Doak,REP,180810,0,8,65,73,
Craig,Corporation Commissioner,Todd Hiett,REP,180810,0,5,44,49,
Craig,Corporation Commissioner,Cliff Branan,REP,180810,0,2,43,45,
Craig,U.S. Senate,Evelyn Rogers,REP,180810,0,0,5,5,
Craig,U.S. Senate,Rob Moye,REP,180810,0,0,1,1,
Craig,U.S. Senate,D. Jean Mcbride-Samuels,REP,180810,0,0,1,1,
Craig,U.S. Senate,Jim Inhofe,REP,180810,0,7,73,80,
Craig,U.S. Senate,Erick Paul Wyatt,REP,180810,0,1,9,10,
Craig,U.S. Senate,Andy Craig,REP,180810,0,0,1,1,
Craig,U.S. Senate,T. Shannon,REP,180810,0,0,41,41,
Craig,U.S. Senate,Randy Brogdon,REP,180810,0,2,2,4,
Craig,U.S. Senate,Eric Mccray,REP,180810,0,0,0,0,
Craig,U.S. Senate,Kevin Crow,REP,180810,0,0,3,3,
Craig,U.S. Senate,James Lankford,REP,180810,0,6,40,46,
Craig,U.S. Senate,Jason Weger,REP,180810,0,0,1,1,
Craig,U.S. House,Darrel Robertson,REP,180810,0,0,15,15,02
Craig,U.S. House,Markwayne Mullin,REP,180810,0,8,74,82,02
Craig,Superintendent of Public Instruction,John Cox,DEM,180820,0,0,55,55,
Craig,Superintendent of Public Instruction,Jack Jr.,DEM,180820,0,1,9,10,
Craig,Superintendent of Public Instruction,Ivan Holmes,DEM,180820,0,0,4,4,
Craig,Superintendent of Public Instruction,Freda Deskin,DEM,180820,0,5,29,34,
Craig,U.S. Senate,Patrick Michael Hayes,DEM,180820,0,0,22,22,
Craig,U.S. Senate,Jim Rogers,DEM,180820,0,0,51,51,
Craig,U.S. Senate,Connie Johnson,DEM,180820,0,4,21,25,
Craig,U.S. House,Earl Everett,DEM,180820,0,2,58,60,02
Craig,U.S. House,Joshua Harris-Till,DEM,180820,0,2,30,32,02
Craig,Governor,Dax Ewbank,REP,180820,0,1,4,5,
Craig,Governor,Chad Moody,REP,180820,0,1,13,14,
Craig,Governor,Mary Fallin,REP,180820,4,7,76,87,
Craig,Superintendent of Public Instruction,Brian Kelly,REP,180820,1,0,25,26,
Craig,Superintendent of Public Instruction,Janet Costello Barresi,REP,180820,0,2,15,17,
Craig,Superintendent of Public Instruction,Joy Hofmeister,REP,180820,3,7,51,61,
Craig,Insurance Commissioner,Bill Viner,REP,180820,1,4,21,26,
Craig,Insurance Commissioner,John Doak,REP,180820,3,5,66,74,
Craig,Corporation Commissioner,Todd Hiett,REP,180820,1,4,42,47,
Craig,Corporation Commissioner,Cliff Branan,REP,180820,3,5,41,49,
Craig,U.S. Senate,Evelyn Rogers,REP,180820,0,0,2,2,
Craig,U.S. Senate,Rob Moye,REP,180820,0,0,1,1,
Craig,U.S. Senate,D. Jean Mcbride-Samuels,REP,180820,0,1,1,2,
Craig,U.S. Senate,Jim Inhofe,REP,180820,4,8,86,98,
Craig,U.S. Senate,Erick Paul Wyatt,REP,180820,0,0,3,3,
Craig,U.S. Senate,Andy Craig,REP,180820,0,0,0,0,
Craig,U.S. Senate,T. Shannon,REP,180820,2,6,31,39,
Craig,U.S. Senate,Randy Brogdon,REP,180820,0,0,1,1,
Craig,U.S. Senate,Eric Mccray,REP,180820,0,0,2,2,
Craig,U.S. Senate,Kevin Crow,REP,180820,0,0,2,2,
Craig,U.S. Senate,James Lankford,REP,180820,2,3,57,62,
Craig,U.S. Senate,Jason Weger,REP,180820,0,0,0,0,
Craig,U.S. House,Darrel Robertson,REP,180820,0,0,14,14,02
Craig,U.S. House,Markwayne Mullin,REP,180820,4,9,78,91,02
Craig,Superintendent of Public Instruction,John Cox,DEM,180910,0,0,37,37,
Craig,Superintendent of Public Instruction,Jack Jr.,DEM,180910,0,1,6,7,
Craig,Superintendent of Public Instruction,Ivan Holmes,DEM,180910,0,0,3,3,
Craig,Superintendent of Public Instruction,Freda Deskin,DEM,180910,0,2,22,24,
Craig,U.S. Senate,Patrick Michael Hayes,DEM,180910,0,0,11,11,
Craig,U.S. Senate,Jim Rogers,DEM,180910,0,0,21,21,
Craig,U.S. Senate,Connie Johnson,DEM,180910,0,3,29,32,
Craig,U.S. House,Earl Everett,DEM,180910,0,0,31,31,02
Craig,U.S. House,Joshua Harris-Till,DEM,180910,0,3,25,28,02
Craig,Governor,Dax Ewbank,REP,180910,0,0,4,4,
Craig,Governor,Chad Moody,REP,180910,0,0,6,6,
Craig,Governor,Mary Fallin,REP,180910,0,2,36,38,
Craig,Superintendent of Public Instruction,Brian Kelly,REP,180910,0,0,13,13,
Craig,Superintendent of Public Instruction,Janet Costello Barresi,REP,180910,0,1,5,6,
Craig,Superintendent of Public Instruction,Joy Hofmeister,REP,180910,0,1,29,30,
Craig,Insurance Commissioner,Bill Viner,REP,180910,0,0,4,4,
Craig,Insurance Commissioner,John Doak,REP,180910,0,2,42,44,
Craig,Corporation Commissioner,Todd Hiett,REP,180910,0,1,27,28,
Craig,Corporation Commissioner,Cliff Branan,REP,180910,0,1,18,19,
Craig,U.S. Senate,Evelyn Rogers,REP,180910,0,0,2,2,
Craig,U.S. Senate,Rob Moye,REP,180910,0,0,1,1,
Craig,U.S. Senate,D. Jean Mcbride-Samuels,REP,180910,0,0,0,0,
Craig,U.S. Senate,Jim Inhofe,REP,180910,0,2,40,42,
Craig,U.S. Senate,Erick Paul Wyatt,REP,180910,0,0,3,3,
Craig,U.S. Senate,Andy Craig,REP,180910,0,0,0,0,
Craig,U.S. Senate,T. Shannon,REP,180910,0,1,17,18,
Craig,U.S. Senate,Randy Brogdon,REP,180910,0,0,0,0,
Craig,U.S. Senate,Eric Mccray,REP,180910,0,0,0,0,
Craig,U.S. Senate,Kevin Crow,REP,180910,0,0,0,0,
Craig,U.S. Senate,James Lankford,REP,180910,0,2,29,31,
Craig,U.S. Senate,Jason Weger,REP,180910,0,0,1,1,
Craig,U.S. House,Darrel Robertson,REP,180910,0,1,7,8,02
Craig,U.S. House,Markwayne Mullin,REP,180910,0,2,41,43,02
Creek,Superintendent of Public Instruction,John Cox,DEM,190111,1,2,28,31,
Creek,Superintendent of Public Instruction,Jack Jr.,DEM,190111,0,2,6,8,
Creek,Superintendent of Public Instruction,Ivan Holmes,DEM,190111,2,1,7,10,
Creek,Superintendent of Public Instruction,Freda Deskin,DEM,190111,2,0,18,20,
Creek,U.S. Senate,Patrick Michael Hayes,DEM,190111,1,1,11,13,
Creek,U.S. Senate,Jim Rogers,DEM,190111,1,3,25,29,
Creek,U.S. Senate,Connie Johnson,DEM,190111,3,1,23,27,
Creek,Governor,Dax Ewbank,REP,190111,0,0,6,6,
Creek,Governor,Chad Moody,REP,190111,0,3,17,20,
Creek,Governor,Mary Fallin,REP,190111,1,12,79,92,
Creek,Superintendent of Public Instruction,Brian Kelly,REP,190111,0,2,24,26,
Creek,Superintendent of Public Instruction,Janet Costello Barresi,REP,190111,1,4,12,17,
Creek,Superintendent of Public Instruction,Joy Hofmeister,REP,190111,0,9,68,77,
Creek,Insurance Commissioner,Bill Viner,REP,190111,0,6,21,27,
Creek,Insurance Commissioner,John Doak,REP,190111,1,8,76,85,
Creek,Corporation Commissioner,Todd Hiett,REP,190111,1,6,73,80,
Creek,Corporation Commissioner,Cliff Branan,REP,190111,0,8,27,35,
Creek,U.S. Senate,Evelyn Rogers,REP,190111,0,0,2,2,
Creek,U.S. Senate,Rob Moye,REP,190111,0,2,2,4,
Creek,U.S. Senate,D. Jean Mcbride-Samuels,REP,190111,0,1,1,2,
Creek,U.S. Senate,Jim Inhofe,REP,190111,1,12,91,104,
Creek,U.S. Senate,Erick Paul Wyatt,REP,190111,0,0,4,4,
Creek,U.S. Senate,Andy Craig,REP,190111,0,0,0,0,
Creek,U.S. Senate,T. Shannon,REP,190111,0,6,56,62,
Creek,U.S. Senate,Randy Brogdon,REP,190111,0,0,8,8,
Creek,U.S. Senate,Eric Mccray,REP,190111,0,0,1,1,
Creek,U.S. Senate,Kevin Crow,REP,190111,0,0,0,0,
Creek,U.S. Senate,James Lankford,REP,190111,1,9,38,48,
Creek,U.S. Senate,Jason Weger,REP,190111,0,0,0,0,
Creek,U.S. House,Timothy Ray Murray,REP,190111,0,1,3,4,03
Creek,U.S. House,Robert Hubbard,REP,190111,0,1,15,16,03
Creek,U.S. House,Frank Lucas,REP,190111,1,13,82,96,03
Creek,State Senate,John Knecht,REP,190111,0,1,16,17,12
Creek,State Senate,Brian Bingman,REP,190111,1,14,84,99,12
Creek,Superintendent of Public Instruction,John Cox,DEM,190112,0,0,10,10,
Creek,Superintendent of Public Instruction,Jack Jr.,DEM,190112,0,0,6,6,
Creek,Superintendent of Public Instruction,Ivan Holmes,DEM,190112,1,0,3,4,
Creek,Superintendent of Public Instruction,Freda Deskin,DEM,190112,0,0,5,5,
Creek,U.S. Senate,Patrick Michael Hayes,DEM,190112,0,0,5,5,
Creek,U.S. Senate,Jim Rogers,DEM,190112,1,0,8,9,
Creek,U.S. Senate,Connie Johnson,DEM,190112,0,0,11,11,
Creek,Governor,Dax Ewbank,REP,190112,0,0,2,2,
Creek,Governor,Chad Moody,REP,190112,0,0,10,10,
Creek,Governor,Mary Fallin,REP,190112,1,3,35,39,
Creek,Superintendent of Public Instruction,Brian Kelly,REP,190112,1,1,17,19,
Creek,Superintendent of Public Instruction,Janet Costello Barresi,REP,190112,0,2,6,8,
Creek,Superintendent of Public Instruction,Joy Hofmeister,REP,190112,0,0,25,25,
Creek,Insurance Commissioner,Bill Viner,REP,190112,0,0,8,8,
Creek,Insurance Commissioner,John Doak,REP,190112,1,3,37,41,
Creek,Corporation Commissioner,Todd Hiett,REP,190112,0,2,29,31,
Creek,Corporation Commissioner,Cliff Branan,REP,190112,1,1,18,20,
Creek,U.S. Senate,Evelyn Rogers,REP,190112,0,0,2,2,
Creek,U.S. Senate,Rob Moye,REP,190112,0,0,0,0,
Creek,U.S. Senate,D. Jean Mcbride-Samuels,REP,190112,0,0,0,0,
Creek,U.S. Senate,Jim Inhofe,REP,190112,1,3,41,45,
Creek,U.S. Senate,Erick Paul Wyatt,REP,190112,0,0,4,4,
Creek,U.S. Senate,Andy Craig,REP,190112,0,0,0,0,
Creek,U.S. Senate,T. Shannon,REP,190112,0,2,23,25,
Creek,U.S. Senate,Randy Brogdon,REP,190112,1,1,3,5,
Creek,U.S. Senate,Eric Mccray,REP,190112,0,0,0,0,
Creek,U.S. Senate,Kevin Crow,REP,190112,0,0,0,0,
Creek,U.S. Senate,James Lankford,REP,190112,0,0,21,21,
Creek,U.S. Senate,Jason Weger,REP,190112,0,0,0,0,
Creek,U.S. House,Timothy Ray Murray,REP,190112,0,0,3,3,03
Creek,U.S. House,Robert Hubbard,REP,190112,0,1,11,12,03
Creek,U.S. House,Frank Lucas,REP,190112,1,2,34,37,03
Creek,State Senate,John Knecht,REP,190112,1,2,15,18,12
Creek,State Senate,Brian Bingman,REP,190112,0,1,34,35,12
Creek,Superintendent of Public Instruction,John Cox,DEM,190121,0,0,24,24,
Creek,Superintendent of Public Instruction,Jack Jr.,DEM,190121,0,0,4,4,
Creek,Superintendent of Public Instruction,Ivan Holmes,DEM,190121,2,0,5,7,
Creek,Superintendent of Public Instruction,Freda Deskin,DEM,190121,1,3,28,32,
Creek,U.S. Senate,Patrick Michael Hayes,DEM,190121,2,1,11,14,
Creek,U.S. Senate,Jim Rogers,DEM,190121,0,0,23,23,
Creek,U.S. Senate,Connie Johnson,DEM,190121,1,2,26,29,
Creek,Governor,Dax Ewbank,REP,190121,0,2,20,22,
Creek,Governor,Chad Moody,REP,190121,0,10,36,46,
Creek,Governor,Mary Fallin,REP,190121,3,10,181,194,
Creek,Superintendent of Public Instruction,Brian Kelly,REP,190121,0,3,45,48,
Creek,Superintendent of Public Instruction,Janet Costello Barresi,REP,190121,0,4,44,48,
Creek,Superintendent of Public Instruction,Joy Hofmeister,REP,190121,3,15,149,167,
Creek,Insurance Commissioner,Bill Viner,REP,190121,0,2,58,60,
Creek,Insurance Commissioner,John Doak,REP,190121,2,18,172,192,
Creek,Corporation Commissioner,Todd Hiett,REP,190121,3,13,145,161,
Creek,Corporation Commissioner,Cliff Branan,REP,190121,0,9,81,90,
Creek,U.S. Senate,Evelyn Rogers,REP,190121,0,2,9,11,
Creek,U.S. Senate,Rob Moye,REP,190121,0,0,6,6,
Creek,U.S. Senate,D. Jean Mcbride-Samuels,REP,190121,0,0,2,2,
Creek,U.S. Senate,Jim Inhofe,REP,190121,3,18,206,227,
Creek,U.S. Senate,Erick Paul Wyatt,REP,190121,0,1,13,14,
Creek,U.S. Senate,Andy Craig,REP,190121,0,1,0,1,
Creek,U.S. Senate,T. Shannon,REP,190121,3,6,106,115,
Creek,U.S. Senate,Randy Brogdon,REP,190121,0,0,23,23,
Creek,U.S. Senate,Eric Mccray,REP,190121,0,0,2,2,
Creek,U.S. Senate,Kevin Crow,REP,190121,0,0,2,2,
Creek,U.S. Senate,James Lankford,REP,190121,0,15,105,120,
Creek,U.S. Senate,Jason Weger,REP,190121,0,0,0,0,
Creek,U.S. House,Timothy Ray Murray,REP,190121,0,2,6,8,03
Creek,U.S. House,Robert Hubbard,REP,190121,1,0,26,27,03
Creek,U.S. House,Frank Lucas,REP,190121,2,19,200,221,03
Creek,State Senate,John Knecht,REP,190121,0,7,44,51,12
Creek,State Senate,Brian Bingman,REP,190121,3,15,192,210,12
Creek,State House,James Leewright,REP,190121,2,9,112,123,29
Creek,State House,Clayton Mckinzie,REP,190121,0,2,29,31,29
Creek,State House,Dani Thompson-Fields,REP,190121,0,6,65,71,29
Creek,State House,Geron Ledbetter,REP,190121,0,2,26,28,29
Creek,Superintendent of Public Instruction,John Cox,DEM,190122,0,0,8,8,
Creek,Superintendent of Public Instruction,Jack Jr.,DEM,190122,0,0,1,1,
Creek,Superintendent of Public Instruction,Ivan Holmes,DEM,190122,0,0,1,1,
Creek,Superintendent of Public Instruction,Freda Deskin,DEM,190122,0,0,16,16,
Creek,U.S. Senate,Patrick Michael Hayes,DEM,190122,0,0,2,2,
Creek,U.S. Senate,Jim Rogers,DEM,190122,0,0,5,5,
Creek,U.S. Senate,Connie Johnson,DEM,190122,0,0,17,17,
Creek,Governor,Dax Ewbank,REP,190122,0,0,2,2,
Creek,Governor,Chad Moody,REP,190122,0,0,3,3,
Creek,Governor,Mary Fallin,REP,190122,0,0,7,7,
Creek,Superintendent of Public Instruction,Brian Kelly,REP,190122,0,0,6,6,
Creek,Superintendent of Public Instruction,Janet Costello Barresi,REP,190122,0,0,0,0,
Creek,Superintendent of Public Instruction,Joy Hofmeister,REP,190122,0,0,5,5,
Creek,Insurance Commissioner,Bill Viner,REP,190122,0,0,3,3,
Creek,Insurance Commissioner,John Doak,REP,190122,0,0,8,8,
Creek,Corporation Commissioner,Todd Hiett,REP,190122,0,0,3,3,
Creek,Corporation Commissioner,Cliff Branan,REP,190122,0,0,8,8,
Creek,U.S. Senate,Evelyn Rogers,REP,190122,0,0,1,1,
Creek,U.S. Senate,Rob Moye,REP,190122,0,0,0,0,
Creek,U.S. Senate,D. Jean Mcbride-Samuels,REP,190122,0,0,1,1,
Creek,U.S. Senate,Jim Inhofe,REP,190122,0,0,8,8,
Creek,U.S. Senate,Erick Paul Wyatt,REP,190122,0,0,0,0,
Creek,U.S. Senate,Andy Craig,REP,190122,0,0,0,0,
Creek,U.S. Senate,T. Shannon,REP,190122,0,0,9,9,
Creek,U.S. Senate,Randy Brogdon,REP,190122,0,0,1,1,
Creek,U.S. Senate,Eric Mccray,REP,190122,0,0,0,0,
Creek,U.S. Senate,Kevin Crow,REP,190122,0,0,0,0,
Creek,U.S. Senate,James Lankford,REP,190122,0,0,2,2,
Creek,U.S. Senate,Jason Weger,REP,190122,0,0,0,0,
Creek,U.S. House,Timothy Ray Murray,REP,190122,0,0,2,2,03
Creek,U.S. House,Robert Hubbard,REP,190122,0,0,0,0,03
Creek,U.S. House,Frank Lucas,REP,190122,0,0,8,8,03
Creek,State Senate,John Knecht,REP,190122,0,0,1,1,12
Creek,State Senate,Brian Bingman,REP,190122,0,0,10,10,12
Creek,Superintendent of Public Instruction,John Cox,DEM,190131,0,1,16,17,
Creek,Superintendent of Public Instruction,Jack Jr.,DEM,190131,0,1,7,8,
Creek,Superintendent of Public Instruction,Ivan Holmes,DEM,190131,0,0,3,3,
Creek,Superintendent of Public Instruction,Freda Deskin,DEM,190131,0,2,19,21,
Creek,U.S. Senate,Patrick Michael Hayes,DEM,190131,0,0,11,11,
Creek,U.S. Senate,Jim Rogers,DEM,190131,0,1,12,13,
Creek,U.S. Senate,Connie Johnson,DEM,190131,0,3,23,26,
Creek,Governor,Dax Ewbank,REP,190131,1,0,10,11,
Creek,Governor,Chad Moody,REP,190131,1,1,11,13,
Creek,Governor,Mary Fallin,REP,190131,1,3,61,65,
Creek,Superintendent of Public Instruction,Brian Kelly,REP,190131,0,0,21,21,
Creek,Superintendent of Public Instruction,Janet Costello Barresi,REP,190131,0,0,13,13,
Creek,Superintendent of Public Instruction,Joy Hofmeister,REP,190131,3,4,47,54,
Creek,Insurance Commissioner,Bill Viner,REP,190131,1,2,25,28,
Creek,Insurance Commissioner,John Doak,REP,190131,2,2,52,56,
Creek,Corporation Commissioner,Todd Hiett,REP,190131,1,3,55,59,
Creek,Corporation Commissioner,Cliff Branan,REP,190131,1,1,24,26,
Creek,U.S. Senate,Evelyn Rogers,REP,190131,0,0,4,4,
Creek,U.S. Senate,Rob Moye,REP,190131,0,0,1,1,
Creek,U.S. Senate,D. Jean Mcbride-Samuels,REP,190131,1,0,2,3,
Creek,U.S. Senate,Jim Inhofe,REP,190131,0,4,68,72,
Creek,U.S. Senate,Erick Paul Wyatt,REP,190131,2,0,7,9,
Creek,U.S. Senate,Andy Craig,REP,190131,0,0,0,0,
Creek,U.S. Senate,T. Shannon,REP,190131,1,1,39,41,
Creek,U.S. Senate,Randy Brogdon,REP,190131,2,0,8,10,
Creek,U.S. Senate,Eric Mccray,REP,190131,0,0,0,0,
Creek,U.S. Senate,Kevin Crow,REP,190131,0,0,1,1,
Creek,U.S. Senate,James Lankford,REP,190131,0,3,35,38,
Creek,U.S. Senate,Jason Weger,REP,190131,0,0,0,0,
Creek,U.S. House,Timothy Ray Murray,REP,190131,1,0,7,8,03
Creek,U.S. House,Robert Hubbard,REP,190131,2,1,12,15,03
Creek,U.S. House,Frank Lucas,REP,190131,0,3,62,65,03
Creek,State Senate,John Knecht,REP,190131,2,1,20,23,12
Creek,State Senate,Brian Bingman,REP,190131,1,3,61,65,12
Creek,Superintendent of Public Instruction,John Cox,DEM,190132,0,4,22,26,
Creek,Superintendent of Public Instruction,Jack Jr.,DEM,190132,0,0,1,1,
Creek,Superintendent of Public Instruction,Ivan Holmes,DEM,190132,1,1,6,8,
Creek,Superintendent of Public Instruction,Freda Deskin,DEM,190132,0,3,32,35,
Creek,U.S. Senate,Patrick Michael Hayes,DEM,190132,0,0,14,14,
Creek,U.S. Senate,Jim Rogers,DEM,190132,1,7,18,26,
Creek,U.S. Senate,Connie Johnson,DEM,190132,0,1,27,28,
Creek,Governor,Dax Ewbank,REP,190132,0,1,12,13,
Creek,Governor,Chad Moody,REP,190132,0,2,32,34,
Creek,Governor,Mary Fallin,REP,190132,1,11,103,115,
Creek,Superintendent of Public Instruction,Brian Kelly,REP,190132,0,3,25,28,
Creek,Superintendent of Public Instruction,Janet Costello Barresi,REP,190132,0,3,19,22,
Creek,Superintendent of Public Instruction,Joy Hofmeister,REP,190132,1,8,104,113,
Creek,Insurance Commissioner,Bill Viner,REP,190132,0,2,32,34,
Creek,Insurance Commissioner,John Doak,REP,190132,1,12,108,121,
Creek,Corporation Commissioner,Todd Hiett,REP,190132,1,9,114,124,
Creek,Corporation Commissioner,Cliff Branan,REP,190132,0,4,31,35,
Creek,U.S. Senate,Evelyn Rogers,REP,190132,0,1,3,4,
Creek,U.S. Senate,Rob Moye,REP,190132,0,0,4,4,
Creek,U.S. Senate,D. Jean Mcbride-Samuels,REP,190132,0,3,5,8,
Creek,U.S. Senate,Jim Inhofe,REP,190132,1,10,126,137,
Creek,U.S. Senate,Erick Paul Wyatt,REP,190132,0,0,9,9,
Creek,U.S. Senate,Andy Craig,REP,190132,0,0,0,0,
Creek,U.S. Senate,T. Shannon,REP,190132,0,4,64,68,
Creek,U.S. Senate,Randy Brogdon,REP,190132,0,1,9,10,
Creek,U.S. Senate,Eric Mccray,REP,190132,0,0,1,1,
Creek,U.S. Senate,Kevin Crow,REP,190132,0,0,2,2,
Creek,U.S. Senate,James Lankford,REP,190132,1,9,69,79,
Creek,U.S. Senate,Jason Weger,REP,190132,0,0,3,3,
Creek,U.S. House,Timothy Ray Murray,REP,190132,0,0,9,9,03
Creek,U.S. House,Robert Hubbard,REP,190132,1,3,39,43,03
Creek,U.S. House,Frank Lucas,REP,190132,0,11,95,106,03
Creek,State Senate,John Knecht,REP,190132,1,4,26,31,12
Creek,State Senate,Brian Bingman,REP,190132,0,9,120,129,12
Creek,Superintendent of Public Instruction,John Cox,DEM,190142,3,10,63,76,
Creek,Superintendent of Public Instruction,Jack Jr.,DEM,190142,1,2,14,17,
Creek,Superintendent of Public Instruction,Ivan Holmes,DEM,190142,0,2,13,15,
Creek,Superintendent of Public Instruction,Freda Deskin,DEM,190142,1,10,71,82,
Creek,U.S. Senate,Patrick Michael Hayes,DEM,190142,0,1,31,32,
Creek,U.S. Senate,Jim Rogers,DEM,190142,1,12,58,71,
Creek,U.S. Senate,Connie Johnson,DEM,190142,4,11,70,85,
Creek,Governor,Dax Ewbank,REP,190142,0,2,28,30,
Creek,Governor,Chad Moody,REP,190142,0,10,70,80,
Creek,Governor,Mary Fallin,REP,190142,10,32,249,291,
Creek,Superintendent of Public Instruction,Brian Kelly,REP,190142,2,10,59,71,
Creek,Superintendent of Public Instruction,Janet Costello Barresi,REP,190142,2,5,57,64,
Creek,Superintendent of Public Instruction,Joy Hofmeister,REP,190142,6,30,231,267,
Creek,Insurance Commissioner,Bill Viner,REP,190142,1,14,76,91,
Creek,Insurance Commissioner,John Doak,REP,190142,6,29,251,286,
Creek,Corporation Commissioner,Todd Hiett,REP,190142,8,30,252,290,
Creek,Corporation Commissioner,Cliff Branan,REP,190142,2,14,90,106,
Creek,U.S. Senate,Evelyn Rogers,REP,190142,0,5,25,30,
Creek,U.S. Senate,Rob Moye,REP,190142,0,0,6,6,
Creek,U.S. Senate,D. Jean Mcbride-Samuels,REP,190142,0,0,4,4,
Creek,U.S. Senate,Jim Inhofe,REP,190142,10,37,294,341,
Creek,U.S. Senate,Erick Paul Wyatt,REP,190142,0,1,19,20,
Creek,U.S. Senate,Andy Craig,REP,190142,0,0,7,7,
Creek,U.S. Senate,T. Shannon,REP,190142,3,12,138,153,
Creek,U.S. Senate,Randy Brogdon,REP,190142,0,3,23,26,
Creek,U.S. Senate,Eric Mccray,REP,190142,0,0,0,0,
Creek,U.S. Senate,Kevin Crow,REP,190142,0,0,4,4,
Creek,U.S. Senate,James Lankford,REP,190142,6,30,176,212,
Creek,U.S. Senate,Jason Weger,REP,190142,0,0,1,1,
Creek,U.S. House,Timothy Ray Murray,REP,190142,0,1,16,17,03
Creek,U.S. House,Robert Hubbard,REP,190142,0,4,58,62,03
Creek,U.S. House,Frank Lucas,REP,190142,10,39,268,317,03
Creek,State Senate,John Knecht,REP,190142,0,9,61,70,12
Creek,State Senate,Brian Bingman,REP,190142,10,35,289,334,12
Creek,Superintendent of Public Instruction,John Cox,DEM,190143,3,2,19,24,
Creek,Superintendent of Public Instruction,Jack Jr.,DEM,190143,2,1,8,11,
Creek,Superintendent of Public Instruction,Ivan Holmes,DEM,190143,0,0,2,2,
Creek,Superintendent of Public Instruction,Freda Deskin,DEM,190143,2,2,40,44,
Creek,U.S. Senate,Patrick Michael Hayes,DEM,190143,2,1,8,11,
Creek,U.S. Senate,Jim Rogers,DEM,190143,2,1,28,31,
Creek,U.S. Senate,Connie Johnson,DEM,190143,3,2,34,39,
Creek,Governor,Dax Ewbank,REP,190143,2,0,15,17,
Creek,Governor,Chad Moody,REP,190143,2,4,21,27,
Creek,Governor,Mary Fallin,REP,190143,6,15,98,119,
Creek,Superintendent of Public Instruction,Brian Kelly,REP,190143,2,3,29,34,
Creek,Superintendent of Public Instruction,Janet Costello Barresi,REP,190143,1,3,22,26,
Creek,Superintendent of Public Instruction,Joy Hofmeister,REP,190143,6,15,80,101,
Creek,Insurance Commissioner,Bill Viner,REP,190143,5,2,36,43,
Creek,Insurance Commissioner,John Doak,REP,190143,5,17,91,113,
Creek,Corporation Commissioner,Todd Hiett,REP,190143,6,15,75,96,
Creek,Corporation Commissioner,Cliff Branan,REP,190143,4,5,55,64,
Creek,U.S. Senate,Evelyn Rogers,REP,190143,1,1,6,8,
Creek,U.S. Senate,Rob Moye,REP,190143,1,0,3,4,
Creek,U.S. Senate,D. Jean Mcbride-Samuels,REP,190143,2,1,5,8,
Creek,U.S. Senate,Jim Inhofe,REP,190143,6,17,108,131,
Creek,U.S. Senate,Erick Paul Wyatt,REP,190143,0,1,10,11,
Creek,U.S. Senate,Andy Craig,REP,190143,2,2,1,5,
Creek,U.S. Senate,T. Shannon,REP,190143,2,8,57,67,
Creek,U.S. Senate,Randy Brogdon,REP,190143,0,3,15,18,
Creek,U.S. Senate,Eric Mccray,REP,190143,1,0,3,4,
Creek,U.S. Senate,Kevin Crow,REP,190143,1,0,2,3,
Creek,U.S. Senate,James Lankford,REP,190143,4,7,57,68,
Creek,U.S. Senate,Jason Weger,REP,190143,0,0,0,0,
Creek,U.S. House,Timothy Ray Murray,REP,190143,1,0,10,11,03
Creek,U.S. House,Robert Hubbard,REP,190143,3,6,22,31,03
Creek,U.S. House,Frank Lucas,REP,190143,6,13,96,115,03
Creek,State Senate,John Knecht,REP,190143,4,6,31,41,12
Creek,State Senate,Brian Bingman,REP,190143,6,14,102,122,12
Creek,Superintendent of Public Instruction,John Cox,DEM,190211,2,0,36,38,
Creek,Superintendent of Public Instruction,Jack Jr.,DEM,190211,0,0,16,16,
Creek,Superintendent of Public Instruction,Ivan Holmes,DEM,190211,1,0,9,10,
Creek,Superintendent of Public Instruction,Freda Deskin,DEM,190211,0,0,31,31,
Creek,U.S. Senate,Patrick Michael Hayes,DEM,190211,2,0,27,29,
Creek,U.S. Senate,Jim Rogers,DEM,190211,0,0,37,37,
Creek,U.S. Senate,Connie Johnson,DEM,190211,1,0,26,27,
Creek,Governor,Dax Ewbank,REP,190211,2,0,11,13,
Creek,Governor,Chad Moody,REP,190211,1,0,11,12,
Creek,Governor,Mary Fallin,REP,190211,3,2,44,49,
Creek,Superintendent of Public Instruction,Brian Kelly,REP,190211,1,0,17,18,
Creek,Superintendent of Public Instruction,Janet Costello Barresi,REP,190211,0,2,6,8,
Creek,Superintendent of Public Instruction,Joy Hofmeister,REP,190211,5,0,45,50,
Creek,Insurance Commissioner,Bill Viner,REP,190211,0,1,13,14,
Creek,Insurance Commissioner,John Doak,REP,190211,5,1,52,58,
Creek,Corporation Commissioner,Todd Hiett,REP,190211,4,2,44,50,
Creek,Corporation Commissioner,Cliff Branan,REP,190211,2,0,22,24,
Creek,U.S. Senate,Evelyn Rogers,REP,190211,0,0,4,4,
Creek,U.S. Senate,Rob Moye,REP,190211,0,1,0,1,
Creek,U.S. Senate,D. Jean Mcbride-Samuels,REP,190211,0,0,5,5,
Creek,U.S. Senate,Jim Inhofe,REP,190211,7,1,53,61,
Creek,U.S. Senate,Erick Paul Wyatt,REP,190211,0,0,4,4,
Creek,U.S. Senate,Andy Craig,REP,190211,0,0,2,2,
Creek,U.S. Senate,T. Shannon,REP,190211,5,2,29,36,
Creek,U.S. Senate,Randy Brogdon,REP,190211,1,0,5,6,
Creek,U.S. Senate,Eric Mccray,REP,190211,0,0,0,0,
Creek,U.S. Senate,Kevin Crow,REP,190211,0,0,2,2,
Creek,U.S. Senate,James Lankford,REP,190211,0,0,26,26,
Creek,U.S. Senate,Jason Weger,REP,190211,0,0,1,1,
Creek,U.S. House,Timothy Ray Murray,REP,190211,2,0,7,9,03
Creek,U.S. House,Robert Hubbard,REP,190211,1,0,8,9,03
Creek,U.S. House,Frank Lucas,REP,190211,4,2,48,54,03
Creek,State Senate,John Knecht,REP,190211,2,0,23,25,12
Creek,State Senate,Brian Bingman,REP,190211,5,2,40,47,12
Creek,State House,James Leewright,REP,190211,2,2,23,27,29
Creek,State House,Clayton Mckinzie,REP,190211,1,0,13,14,29
Creek,State House,Dani Thompson-Fields,REP,190211,1,0,16,17,29
Creek,State House,Geron Ledbetter,REP,190211,2,0,15,17,29
Creek,Superintendent of Public Instruction,John Cox,DEM,190221,0,0,26,26,
Creek,Superintendent of Public Instruction,Jack Jr.,DEM,190221,0,0,7,7,
Creek,Superintendent of Public Instruction,Ivan Holmes,DEM,190221,0,0,5,5,
Creek,Superintendent of Public Instruction,Freda Deskin,DEM,190221,1,0,22,23,
Creek,U.S. Senate,Patrick Michael Hayes,DEM,190221,0,0,17,17,
Creek,U.S. Senate,Jim Rogers,DEM,190221,0,0,22,22,
Creek,U.S. Senate,Connie Johnson,DEM,190221,1,0,21,22,
Creek,Governor,Dax Ewbank,REP,190221,0,0,5,5,
Creek,Governor,Chad Moody,REP,190221,0,0,9,9,
Creek,Governor,Mary Fallin,REP,190221,0,0,24,24,
Creek,Superintendent of Public Instruction,Brian Kelly,REP,190221,0,0,10,10,
Creek,Superintendent of Public Instruction,Janet Costello Barresi,REP,190221,0,0,4,4,
Creek,Superintendent of Public Instruction,Joy Hofmeister,REP,190221,0,0,24,24,
Creek,Insurance Commissioner,Bill Viner,REP,190221,0,0,10,10,
Creek,Insurance Commissioner,John Doak,REP,190221,0,0,27,27,
Creek,Corporation Commissioner,Todd Hiett,REP,190221,0,0,31,31,
Creek,Corporation Commissioner,Cliff Branan,REP,190221,0,0,7,7,
Creek,U.S. Senate,Evelyn Rogers,REP,190221,0,0,2,2,
Creek,U.S. Senate,Rob Moye,REP,190221,0,0,0,0,
Creek,U.S. Senate,D. Jean Mcbride-Samuels,REP,190221,0,0,1,1,
Creek,U.S. Senate,Jim Inhofe,REP,190221,0,0,28,28,
Creek,U.S. Senate,Erick Paul Wyatt,REP,190221,0,0,7,7,
Creek,U.S. Senate,Andy Craig,REP,190221,0,0,2,2,
Creek,U.S. Senate,T. Shannon,REP,190221,0,0,10,10,
Creek,U.S. Senate,Randy Brogdon,REP,190221,0,0,5,5,
Creek,U.S. Senate,Eric Mccray,REP,190221,0,0,0,0,
Creek,U.S. Senate,Kevin Crow,REP,190221,0,0,1,1,
Creek,U.S. Senate,James Lankford,REP,190221,0,0,18,18,
Creek,U.S. Senate,Jason Weger,REP,190221,0,0,1,1,
Creek,U.S. House,Timothy Ray Murray,REP,190221,0,0,2,2,03
Creek,U.S. House,Robert Hubbard,REP,190221,0,0,5,5,03
Creek,U.S. House,Frank Lucas,REP,190221,0,0,30,30,03
Creek,State Senate,John Knecht,REP,190221,0,0,18,18,12
Creek,State Senate,Brian Bingman,REP,190221,0,0,19,19,12
Creek,State House,James Leewright,REP,190221,0,0,13,13,29
Creek,State House,Clayton Mckinzie,REP,190221,0,0,4,4,29
Creek,State House,Dani Thompson-Fields,REP,190221,0,0,16,16,29
Creek,State House,Geron Ledbetter,REP,190221,0,0,5,5,29
Creek,Superintendent of Public Instruction,John Cox,DEM,190231,0,0,29,29,
Creek,Superintendent of Public Instruction,Jack Jr.,DEM,190231,0,0,8,8,
Creek,Superintendent of Public Instruction,Ivan Holmes,DEM,190231,0,0,5,5,
Creek,Superintendent of Public Instruction,Freda Deskin,DEM,190231,0,0,33,33,
Creek,U.S. Senate,Patrick Michael Hayes,DEM,190231,0,0,22,22,
Creek,U.S. Senate,Jim Rogers,DEM,190231,0,0,25,25,
Creek,U.S. Senate,Connie Johnson,DEM,190231,0,0,28,28,
Creek,Governor,Dax Ewbank,REP,190231,1,0,9,10,
Creek,Governor,Chad Moody,REP,190231,1,0,14,15,
Creek,Governor,Mary Fallin,REP,190231,0,0,51,51,
Creek,Superintendent of Public Instruction,Brian Kelly,REP,190231,1,0,21,22,
Creek,Superintendent of Public Instruction,Janet Costello Barresi,REP,190231,0,0,8,8,
Creek,Superintendent of Public Instruction,Joy Hofmeister,REP,190231,1,0,46,47,
Creek,Insurance Commissioner,Bill Viner,REP,190231,0,0,8,8,
Creek,Insurance Commissioner,John Doak,REP,190231,2,0,61,63,
Creek,Corporation Commissioner,Todd Hiett,REP,190231,1,0,54,55,
Creek,Corporation Commissioner,Cliff Branan,REP,190231,1,0,19,20,
Creek,U.S. Senate,Evelyn Rogers,REP,190231,0,0,4,4,
Creek,U.S. Senate,Rob Moye,REP,190231,0,0,1,1,
Creek,U.S. Senate,D. Jean Mcbride-Samuels,REP,190231,0,0,0,0,
Creek,U.S. Senate,Jim Inhofe,REP,190231,2,0,63,65,
Creek,U.S. Senate,Erick Paul Wyatt,REP,190231,0,0,4,4,
Creek,U.S. Senate,Andy Craig,REP,190231,0,0,0,0,
Creek,U.S. Senate,T. Shannon,REP,190231,1,0,41,42,
Creek,U.S. Senate,Randy Brogdon,REP,190231,0,0,2,2,
Creek,U.S. Senate,Eric Mccray,REP,190231,0,0,0,0,
Creek,U.S. Senate,Kevin Crow,REP,190231,0,0,0,0,
Creek,U.S. Senate,James Lankford,REP,190231,1,0,29,30,
Creek,U.S. Senate,Jason Weger,REP,190231,0,0,1,1,
Creek,U.S. House,Timothy Ray Murray,REP,190231,0,0,8,8,03
Creek,U.S. House,Robert Hubbard,REP,190231,0,0,10,10,03
Creek,U.S. House,Frank Lucas,REP,190231,1,0,53,54,03
Creek,State Senate,John Knecht,REP,190231,0,0,25,25,12
Creek,State Senate,Brian Bingman,REP,190231,1,0,45,46,12
Creek,State House,James Leewright,REP,190231,0,0,18,18,29
Creek,State House,Clayton Mckinzie,REP,190231,0,0,10,10,29
Creek,State House,Dani Thompson-Fields,REP,190231,0,0,27,27,29
Creek,State House,Geron Ledbetter,REP,190231,2,0,19,21,29
Creek,Superintendent of Public Instruction,John Cox,DEM,190241,0,0,33,33,
Creek,Superintendent of Public Instruction,Jack Jr.,DEM,190241,0,0,9,9,
Creek,Superintendent of Public Instruction,Ivan Holmes,DEM,190241,0,0,8,8,
Creek,Superintendent of Public Instruction,Freda Deskin,DEM,190241,0,0,36,36,
Creek,U.S. Senate,Patrick Michael Hayes,DEM,190241,0,0,24,24,
Creek,U.S. Senate,Jim Rogers,DEM,190241,0,0,22,22,
Creek,U.S. Senate,Connie Johnson,DEM,190241,0,0,39,39,
Creek,Governor,Dax Ewbank,REP,190241,0,0,12,12,
Creek,Governor,Chad Moody,REP,190241,0,0,19,19,
Creek,Governor,Mary Fallin,REP,190241,3,3,82,88,
Creek,Superintendent of Public Instruction,Brian Kelly,REP,190241,0,1,24,25,
Creek,Superintendent of Public Instruction,Janet Costello Barresi,REP,190241,0,1,19,20,
Creek,Superintendent of Public Instruction,Joy Hofmeister,REP,190241,4,1,71,76,
Creek,Insurance Commissioner,Bill Viner,REP,190241,0,0,15,15,
Creek,Insurance Commissioner,John Doak,REP,190241,4,3,97,104,
Creek,Corporation Commissioner,Todd Hiett,REP,190241,4,2,80,86,
Creek,Corporation Commissioner,Cliff Branan,REP,190241,0,1,31,32,
Creek,U.S. Senate,Evelyn Rogers,REP,190241,1,0,5,6,
Creek,U.S. Senate,Rob Moye,REP,190241,0,0,2,2,
Creek,U.S. Senate,D. Jean Mcbride-Samuels,REP,190241,0,0,0,0,
Creek,U.S. Senate,Jim Inhofe,REP,190241,3,3,99,105,
Creek,U.S. Senate,Erick Paul Wyatt,REP,190241,0,0,7,7,
Creek,U.S. Senate,Andy Craig,REP,190241,0,0,1,1,
Creek,U.S. Senate,T. Shannon,REP,190241,2,1,39,42,
Creek,U.S. Senate,Randy Brogdon,REP,190241,1,1,10,12,
Creek,U.S. Senate,Eric Mccray,REP,190241,0,0,3,3,
Creek,U.S. Senate,Kevin Crow,REP,190241,0,0,0,0,
Creek,U.S. Senate,James Lankford,REP,190241,1,1,59,61,
Creek,U.S. Senate,Jason Weger,REP,190241,0,0,2,2,
Creek,U.S. House,Timothy Ray Murray,REP,190241,0,1,15,16,03
Creek,U.S. House,Robert Hubbard,REP,190241,0,2,11,13,03
Creek,U.S. House,Frank Lucas,REP,190241,4,0,86,90,03
Creek,State Senate,John Knecht,REP,190241,1,0,37,38,12
Creek,State Senate,Brian Bingman,REP,190241,3,3,75,81,12
Creek,State House,James Leewright,REP,190241,1,0,50,51,29
Creek,State House,Clayton Mckinzie,REP,190241,1,0,13,14,29
Creek,State House,Dani Thompson-Fields,REP,190241,0,0,29,29,29
Creek,State House,Geron Ledbetter,REP,190241,2,3,22,27,29
Creek,Superintendent of Public Instruction,John Cox,DEM,190311,0,0,35,35,
Creek,Superintendent of Public Instruction,Jack Jr.,DEM,190311,0,0,16,16,
Creek,Superintendent of Public Instruction,Ivan Holmes,DEM,190311,1,0,6,7,
Creek,Superintendent of Public Instruction,Freda Deskin,DEM,190311,3,0,32,35,
Creek,U.S. Senate,Patrick Michael Hayes,DEM,190311,0,0,18,18,
Creek,U.S. Senate,Jim Rogers,DEM,190311,2,0,30,32,
Creek,U.S. Senate,Connie Johnson,DEM,190311,2,0,41,43,
Creek,Governor,Dax Ewbank,REP,190311,0,0,13,13,
Creek,Governor,Chad Moody,REP,190311,3,0,39,42,
Creek,Governor,Mary Fallin,REP,190311,1,1,102,104,
Creek,Superintendent of Public Instruction,Brian Kelly,REP,190311,0,1,30,31,
Creek,Superintendent of Public Instruction,Janet Costello Barresi,REP,190311,0,0,16,16,
Creek,Superintendent of Public Instruction,Joy Hofmeister,REP,190311,4,0,109,113,
Creek,Insurance Commissioner,Bill Viner,REP,190311,2,0,43,45,
Creek,Insurance Commissioner,John Doak,REP,190311,1,0,103,104,
Creek,Corporation Commissioner,Todd Hiett,REP,190311,4,0,98,102,
Creek,Corporation Commissioner,Cliff Branan,REP,190311,0,1,55,56,
Creek,U.S. Senate,Evelyn Rogers,REP,190311,2,0,2,4,
Creek,U.S. Senate,Rob Moye,REP,190311,0,0,7,7,
Creek,U.S. Senate,D. Jean Mcbride-Samuels,REP,190311,0,0,2,2,
Creek,U.S. Senate,Jim Inhofe,REP,190311,2,1,135,138,
Creek,U.S. Senate,Erick Paul Wyatt,REP,190311,0,0,9,9,
Creek,U.S. Senate,Andy Craig,REP,190311,0,0,2,2,
Creek,U.S. Senate,T. Shannon,REP,190311,2,0,51,53,
Creek,U.S. Senate,Randy Brogdon,REP,190311,0,0,8,8,
Creek,U.S. Senate,Eric Mccray,REP,190311,0,0,1,1,
Creek,U.S. Senate,Kevin Crow,REP,190311,0,0,1,1,
Creek,U.S. Senate,James Lankford,REP,190311,2,1,92,95,
Creek,U.S. Senate,Jason Weger,REP,190311,0,0,1,1,
Creek,U.S. House,Timothy Ray Murray,REP,190311,0,0,12,12,03
Creek,U.S. House,Robert Hubbard,REP,190311,2,0,20,22,03
Creek,U.S. House,Frank Lucas,REP,190311,2,1,122,125,03
Creek,State Senate,John Knecht,REP,190311,3,0,41,44,12
Creek,State Senate,Brian Bingman,REP,190311,1,1,109,111,12
Creek,Superintendent of Public Instruction,John Cox,DEM,190401,4,1,16,21,
Creek,Superintendent of Public Instruction,Jack Jr.,DEM,190401,0,1,3,4,
Creek,Superintendent of Public Instruction,Ivan Holmes,DEM,190401,0,0,2,2,
Creek,Superintendent of Public Instruction,Freda Deskin,DEM,190401,0,1,22,23,
Creek,U.S. Senate,Patrick Michael Hayes,DEM,190401,0,1,11,12,
Creek,U.S. Senate,Jim Rogers,DEM,190401,3,2,14,19,
Creek,U.S. Senate,Connie Johnson,DEM,190401,1,0,18,19,
Creek,Governor,Dax Ewbank,REP,190401,0,0,7,7,
Creek,Governor,Chad Moody,REP,190401,3,4,23,30,
Creek,Governor,Mary Fallin,REP,190401,4,1,109,114,
Creek,Superintendent of Public Instruction,Brian Kelly,REP,190401,1,0,34,35,
Creek,Superintendent of Public Instruction,Janet Costello Barresi,REP,190401,1,0,19,20,
Creek,Superintendent of Public Instruction,Joy Hofmeister,REP,190401,5,5,83,93,
Creek,Insurance Commissioner,Bill Viner,REP,190401,1,0,29,30,
Creek,Insurance Commissioner,John Doak,REP,190401,5,4,103,112,
Creek,Corporation Commissioner,Todd Hiett,REP,190401,5,4,99,108,
Creek,Corporation Commissioner,Cliff Branan,REP,190401,1,1,36,38,
Creek,U.S. Senate,Evelyn Rogers,REP,190401,0,0,6,6,
Creek,U.S. Senate,Rob Moye,REP,190401,0,0,5,5,
Creek,U.S. Senate,D. Jean Mcbride-Samuels,REP,190401,0,0,0,0,
Creek,U.S. Senate,Jim Inhofe,REP,190401,4,3,123,130,
Creek,U.S. Senate,Erick Paul Wyatt,REP,190401,2,1,6,9,
Creek,U.S. Senate,Andy Craig,REP,190401,0,0,0,0,
Creek,U.S. Senate,T. Shannon,REP,190401,2,1,58,61,
Creek,U.S. Senate,Randy Brogdon,REP,190401,0,0,13,13,
Creek,U.S. Senate,Eric Mccray,REP,190401,0,0,0,0,
Creek,U.S. Senate,Kevin Crow,REP,190401,1,0,2,3,
Creek,U.S. Senate,James Lankford,REP,190401,3,2,66,71,
Creek,U.S. Senate,Jason Weger,REP,190401,0,1,1,2,
Creek,U.S. House,Timothy Ray Murray,REP,190401,0,0,9,9,03
Creek,U.S. House,Robert Hubbard,REP,190401,1,2,20,23,03
Creek,U.S. House,Frank Lucas,REP,190401,5,2,107,114,03
Creek,State Senate,John Knecht,REP,190401,0,1,35,36,12
Creek,State Senate,Brian Bingman,REP,190401,6,4,102,112,12
Creek,State House,James Leewright,REP,190401,2,1,53,56,29
Creek,State House,Clayton Mckinzie,REP,190401,0,0,16,16,29
Creek,State House,Dani Thompson-Fields,REP,190401,3,3,47,53,29
Creek,State House,Geron Ledbetter,REP,190401,1,0,19,20,29
Creek,Superintendent of Public Instruction,John Cox,DEM,190402,0,4,32,36,
Creek,Superintendent of Public Instruction,Jack Jr.,DEM,190402,0,1,8,9,
Creek,Superintendent of Public Instruction,Ivan Holmes,DEM,190402,0,1,5,6,
Creek,Superintendent of Public Instruction,Freda Deskin,DEM,190402,0,1,21,22,
Creek,U.S. Senate,Patrick Michael Hayes,DEM,190402,0,1,16,17,
Creek,U.S. Senate,Jim Rogers,DEM,190402,0,3,30,33,
Creek,U.S. Senate,Connie Johnson,DEM,190402,0,3,18,21,
Creek,Governor,Dax Ewbank,REP,190402,1,0,7,8,
Creek,Governor,Chad Moody,REP,190402,1,4,24,29,
Creek,Governor,Mary Fallin,REP,190402,1,13,120,134,
Creek,Superintendent of Public Instruction,Brian Kelly,REP,190402,2,2,27,31,
Creek,Superintendent of Public Instruction,Janet Costello Barresi,REP,190402,0,4,27,31,
Creek,Superintendent of Public Instruction,Joy Hofmeister,REP,190402,1,11,91,103,
Creek,Insurance Commissioner,Bill Viner,REP,190402,0,1,31,32,
Creek,Insurance Commissioner,John Doak,REP,190402,3,14,114,131,
Creek,Corporation Commissioner,Todd Hiett,REP,190402,3,14,124,141,
Creek,Corporation Commissioner,Cliff Branan,REP,190402,0,2,23,25,
Creek,U.S. Senate,Evelyn Rogers,REP,190402,0,0,7,7,
Creek,U.S. Senate,Rob Moye,REP,190402,0,0,1,1,
Creek,U.S. Senate,D. Jean Mcbride-Samuels,REP,190402,0,0,3,3,
Creek,U.S. Senate,Jim Inhofe,REP,190402,3,15,131,149,
Creek,U.S. Senate,Erick Paul Wyatt,REP,190402,0,1,6,7,
Creek,U.S. Senate,Andy Craig,REP,190402,0,0,0,0,
Creek,U.S. Senate,T. Shannon,REP,190402,3,2,57,62,
Creek,U.S. Senate,Randy Brogdon,REP,190402,0,1,10,11,
Creek,U.S. Senate,Eric Mccray,REP,190402,0,0,1,1,
Creek,U.S. Senate,Kevin Crow,REP,190402,0,1,4,5,
Creek,U.S. Senate,James Lankford,REP,190402,0,12,78,90,
Creek,U.S. Senate,Jason Weger,REP,190402,0,0,1,1,
Creek,U.S. House,Timothy Ray Murray,REP,190402,0,0,4,4,03
Creek,U.S. House,Robert Hubbard,REP,190402,0,1,26,27,03
Creek,U.S. House,Frank Lucas,REP,190402,3,15,117,135,03
Creek,State Senate,John Knecht,REP,190402,0,2,20,22,12
Creek,State Senate,Brian Bingman,REP,190402,3,15,129,147,12
Creek,State House,James Leewright,REP,190402,3,12,70,85,29
Creek,State House,Clayton Mckinzie,REP,190402,0,0,7,7,29
Creek,State House,Dani Thompson-Fields,REP,190402,0,3,54,57,29
Creek,State House,Geron Ledbetter,REP,190402,0,1,12,13,29
Creek,Superintendent of Public Instruction,John Cox,DEM,190403,0,3,28,31,
Creek,Superintendent of Public Instruction,Jack Jr.,DEM,190403,0,0,8,8,
Creek,Superintendent of Public Instruction,Ivan Holmes,DEM,190403,0,0,4,4,
Creek,Superintendent of Public Instruction,Freda Deskin,DEM,190403,0,1,27,28,
Creek,U.S. Senate,Patrick Michael Hayes,DEM,190403,0,2,9,11,
Creek,U.S. Senate,Jim Rogers,DEM,190403,0,1,22,23,
Creek,U.S. Senate,Connie Johnson,DEM,190403,0,1,34,35,
Creek,Governor,Dax Ewbank,REP,190403,0,0,20,20,
Creek,Governor,Chad Moody,REP,190403,0,0,21,21,
Creek,Governor,Mary Fallin,REP,190403,0,7,114,121,
Creek,Superintendent of Public Instruction,Brian Kelly,REP,190403,0,3,31,34,
Creek,Superintendent of Public Instruction,Janet Costello Barresi,REP,190403,0,1,18,19,
Creek,Superintendent of Public Instruction,Joy Hofmeister,REP,190403,0,3,107,110,
Creek,Insurance Commissioner,Bill Viner,REP,190403,0,1,35,36,
Creek,Insurance Commissioner,John Doak,REP,190403,0,6,113,119,
Creek,Corporation Commissioner,Todd Hiett,REP,190403,0,5,109,114,
Creek,Corporation Commissioner,Cliff Branan,REP,190403,0,2,42,44,
Creek,U.S. Senate,Evelyn Rogers,REP,190403,0,2,5,7,
Creek,U.S. Senate,Rob Moye,REP,190403,0,0,2,2,
Creek,U.S. Senate,D. Jean Mcbride-Samuels,REP,190403,0,0,5,5,
Creek,U.S. Senate,Jim Inhofe,REP,190403,0,5,138,143,
Creek,U.S. Senate,Erick Paul Wyatt,REP,190403,0,0,8,8,
Creek,U.S. Senate,Andy Craig,REP,190403,0,0,1,1,
Creek,U.S. Senate,T. Shannon,REP,190403,0,1,87,88,
Creek,U.S. Senate,Randy Brogdon,REP,190403,0,0,16,16,
Creek,U.S. Senate,Eric Mccray,REP,190403,0,0,3,3,
Creek,U.S. Senate,Kevin Crow,REP,190403,0,0,1,1,
Creek,U.S. Senate,James Lankford,REP,190403,0,6,50,56,
Creek,U.S. Senate,Jason Weger,REP,190403,0,0,1,1,
Creek,U.S. House,Timothy Ray Murray,REP,190403,0,1,7,8,03
Creek,U.S. House,Robert Hubbard,REP,190403,0,0,25,25,03
Creek,U.S. House,Frank Lucas,REP,190403,0,6,123,129,03
Creek,State Senate,John Knecht,REP,190403,0,1,39,40,12
Creek,State Senate,Brian Bingman,REP,190403,0,6,114,120,12
Creek,State House,James Leewright,REP,190403,0,3,45,48,29
Creek,State House,Clayton Mckinzie,REP,190403,0,0,22,22,29
Creek,State House,Dani Thompson-Fields,REP,190403,0,2,58,60,29
Creek,State House,Geron Ledbetter,REP,190403,0,2,25,27,29
Creek,Superintendent of Public Instruction,John Cox,DEM,190404,2,1,65,68,
Creek,Superintendent of Public Instruction,Jack Jr.,DEM,190404,0,0,10,10,
Creek,Superintendent of Public Instruction,Ivan Holmes,DEM,190404,0,0,4,4,
Creek,Superintendent of Public Instruction,Freda Deskin,DEM,190404,0,1,41,42,
Creek,U.S. Senate,Patrick Michael Hayes,DEM,190404,0,0,28,28,
Creek,U.S. Senate,Jim Rogers,DEM,190404,1,2,48,51,
Creek,U.S. Senate,Connie Johnson,DEM,190404,1,0,38,39,
Creek,Governor,Dax Ewbank,REP,190404,3,1,27,31,
Creek,Governor,Chad Moody,REP,190404,2,3,54,59,
Creek,Governor,Mary Fallin,REP,190404,5,12,224,241,
Creek,Superintendent of Public Instruction,Brian Kelly,REP,190404,0,4,59,63,
Creek,Superintendent of Public Instruction,Janet Costello Barresi,REP,190404,1,2,34,37,
Creek,Superintendent of Public Instruction,Joy Hofmeister,REP,190404,9,10,211,230,
Creek,Insurance Commissioner,Bill Viner,REP,190404,4,3,103,110,
Creek,Insurance Commissioner,John Doak,REP,190404,5,13,175,193,
Creek,Corporation Commissioner,Todd Hiett,REP,190404,6,13,191,210,
Creek,Corporation Commissioner,Cliff Branan,REP,190404,3,3,103,109,
Creek,U.S. Senate,Evelyn Rogers,REP,190404,1,0,17,18,
Creek,U.S. Senate,Rob Moye,REP,190404,0,0,6,6,
Creek,U.S. Senate,D. Jean Mcbride-Samuels,REP,190404,0,0,8,8,
Creek,U.S. Senate,Jim Inhofe,REP,190404,8,15,252,275,
Creek,U.S. Senate,Erick Paul Wyatt,REP,190404,1,1,17,19,
Creek,U.S. Senate,Andy Craig,REP,190404,0,0,2,2,
Creek,U.S. Senate,T. Shannon,REP,190404,4,3,123,130,
Creek,U.S. Senate,Randy Brogdon,REP,190404,2,0,22,24,
Creek,U.S. Senate,Eric Mccray,REP,190404,0,1,5,6,
Creek,U.S. Senate,Kevin Crow,REP,190404,0,0,3,3,
Creek,U.S. Senate,James Lankford,REP,190404,4,12,149,165,
Creek,U.S. Senate,Jason Weger,REP,190404,0,0,3,3,
Creek,U.S. House,Timothy Ray Murray,REP,190404,1,0,20,21,03
Creek,U.S. House,Robert Hubbard,REP,190404,2,1,50,53,03
Creek,U.S. House,Frank Lucas,REP,190404,6,15,231,252,03
Creek,State Senate,John Knecht,REP,190404,2,4,81,87,12
Creek,State Senate,Brian Bingman,REP,190404,6,12,210,228,12
Creek,State House,James Leewright,REP,190404,1,12,119,132,29
Creek,State House,Clayton Mckinzie,REP,190404,0,0,27,27,29
Creek,State House,Dani Thompson-Fields,REP,190404,6,2,96,104,29
Creek,State House,Geron Ledbetter,REP,190404,1,2,51,54,29
Creek,Superintendent of Public Instruction,John Cox,DEM,190405,0,0,38,38,
Creek,Superintendent of Public Instruction,Jack Jr.,DEM,190405,0,0,7,7,
Creek,Superintendent of Public Instruction,Ivan Holmes,DEM,190405,0,0,3,3,
Creek,Superintendent of Public Instruction,Freda Deskin,DEM,190405,0,0,17,17,
Creek,U.S. Senate,Patrick Michael Hayes,DEM,190405,0,0,15,15,
Creek,U.S. Senate,Jim Rogers,DEM,190405,0,0,31,31,
Creek,U.S. Senate,Connie Johnson,DEM,190405,0,0,18,18,
Creek,Governor,Dax Ewbank,REP,190405,0,0,23,23,
Creek,Governor,Chad Moody,REP,190405,0,0,24,24,
Creek,Governor,Mary Fallin,REP,190405,3,8,109,120,
Creek,Superintendent of Public Instruction,Brian Kelly,REP,190405,0,2,39,41,
Creek,Superintendent of Public Instruction,Janet Costello Barresi,REP,190405,1,2,23,26,
Creek,Superintendent of Public Instruction,Joy Hofmeister,REP,190405,2,4,94,100,
Creek,Insurance Commissioner,Bill Viner,REP,190405,1,1,39,41,
Creek,Insurance Commissioner,John Doak,REP,190405,2,7,109,118,
Creek,Corporation Commissioner,Todd Hiett,REP,190405,1,6,99,106,
Creek,Corporation Commissioner,Cliff Branan,REP,190405,2,2,50,54,
Creek,U.S. Senate,Evelyn Rogers,REP,190405,1,0,3,4,
Creek,U.S. Senate,Rob Moye,REP,190405,0,0,7,7,
Creek,U.S. Senate,D. Jean Mcbride-Samuels,REP,190405,0,0,2,2,
Creek,U.S. Senate,Jim Inhofe,REP,190405,2,8,131,141,
Creek,U.S. Senate,Erick Paul Wyatt,REP,190405,0,0,11,11,
Creek,U.S. Senate,Andy Craig,REP,190405,0,0,1,1,
Creek,U.S. Senate,T. Shannon,REP,190405,1,2,70,73,
Creek,U.S. Senate,Randy Brogdon,REP,190405,0,2,17,19,
Creek,U.S. Senate,Eric Mccray,REP,190405,0,0,0,0,
Creek,U.S. Senate,Kevin Crow,REP,190405,0,0,1,1,
Creek,U.S. Senate,James Lankford,REP,190405,2,4,63,69,
Creek,U.S. Senate,Jason Weger,REP,190405,0,0,3,3,
Creek,U.S. House,Timothy Ray Murray,REP,190405,0,0,5,5,03
Creek,U.S. House,Robert Hubbard,REP,190405,0,0,38,38,03
Creek,U.S. House,Frank Lucas,REP,190405,3,8,106,117,03
Creek,State Senate,John Knecht,REP,190405,0,1,47,48,12
Creek,State Senate,Brian Bingman,REP,190405,3,7,102,112,12
Creek,Superintendent of Public Instruction,John Cox,DEM,190406,0,0,30,30,
Creek,Superintendent of Public Instruction,Jack Jr.,DEM,190406,0,0,6,6,
Creek,Superintendent of Public Instruction,Ivan Holmes,DEM,190406,0,0,4,4,
Creek,Superintendent of Public Instruction,Freda Deskin,DEM,190406,1,0,22,23,
Creek,U.S. Senate,Patrick Michael Hayes,DEM,190406,0,0,19,19,
Creek,U.S. Senate,Jim Rogers,DEM,190406,0,0,29,29,
Creek,U.S. Senate,Connie Johnson,DEM,190406,0,0,13,13,
Creek,Governor,Dax Ewbank,REP,190406,0,0,9,9,
Creek,Governor,Chad Moody,REP,190406,0,0,10,10,
Creek,Governor,Mary Fallin,REP,190406,1,0,99,100,
Creek,Superintendent of Public Instruction,Brian Kelly,REP,190406,0,0,25,25,
Creek,Superintendent of Public Instruction,Janet Costello Barresi,REP,190406,0,0,19,19,
Creek,Superintendent of Public Instruction,Joy Hofmeister,REP,190406,1,0,73,74,
Creek,Insurance Commissioner,Bill Viner,REP,190406,0,0,16,16,
Creek,Insurance Commissioner,John Doak,REP,190406,1,0,95,96,
Creek,Corporation Commissioner,Todd Hiett,REP,190406,1,0,86,87,
Creek,Corporation Commissioner,Cliff Branan,REP,190406,0,0,28,28,
Creek,U.S. Senate,Evelyn Rogers,REP,190406,0,0,4,4,
Creek,U.S. Senate,Rob Moye,REP,190406,0,0,1,1,
Creek,U.S. Senate,D. Jean Mcbride-Samuels,REP,190406,0,0,3,3,
Creek,U.S. Senate,Jim Inhofe,REP,190406,1,0,110,111,
Creek,U.S. Senate,Erick Paul Wyatt,REP,190406,0,0,1,1,
Creek,U.S. Senate,Andy Craig,REP,190406,0,0,1,1,
Creek,U.S. Senate,T. Shannon,REP,190406,1,0,52,53,
Creek,U.S. Senate,Randy Brogdon,REP,190406,0,0,5,5,
Creek,U.S. Senate,Eric Mccray,REP,190406,0,0,1,1,
Creek,U.S. Senate,Kevin Crow,REP,190406,0,0,3,3,
Creek,U.S. Senate,James Lankford,REP,190406,0,0,57,57,
Creek,U.S. Senate,Jason Weger,REP,190406,0,0,0,0,
Creek,U.S. House,Timothy Ray Murray,REP,190406,0,0,7,7,03
Creek,U.S. House,Robert Hubbard,REP,190406,0,0,10,10,03
Creek,U.S. House,Frank Lucas,REP,190406,1,0,99,100,03
Creek,State Senate,John Knecht,REP,190406,0,0,28,28,12
Creek,State Senate,Brian Bingman,REP,190406,1,0,87,88,12
Creek,Superintendent of Public Instruction,John Cox,DEM,190407,0,0,17,17,
Creek,Superintendent of Public Instruction,Jack Jr.,DEM,190407,0,0,2,2,
Creek,Superintendent of Public Instruction,Ivan Holmes,DEM,190407,0,0,0,0,
Creek,Superintendent of Public Instruction,Freda Deskin,DEM,190407,0,0,12,12,
Creek,U.S. Senate,Patrick Michael Hayes,DEM,190407,0,0,8,8,
Creek,U.S. Senate,Jim Rogers,DEM,190407,0,0,9,9,
Creek,U.S. Senate,Connie Johnson,DEM,190407,0,0,12,12,
Creek,Governor,Dax Ewbank,REP,190407,0,1,6,7,
Creek,Governor,Chad Moody,REP,190407,0,0,13,13,
Creek,Governor,Mary Fallin,REP,190407,0,1,38,39,
Creek,Superintendent of Public Instruction,Brian Kelly,REP,190407,0,0,15,15,
Creek,Superintendent of Public Instruction,Janet Costello Barresi,REP,190407,0,0,4,4,
Creek,Superintendent of Public Instruction,Joy Hofmeister,REP,190407,0,2,38,40,
Creek,Insurance Commissioner,Bill Viner,REP,190407,0,2,16,18,
Creek,Insurance Commissioner,John Doak,REP,190407,0,0,38,38,
Creek,Corporation Commissioner,Todd Hiett,REP,190407,0,2,35,37,
Creek,Corporation Commissioner,Cliff Branan,REP,190407,0,0,21,21,
Creek,U.S. Senate,Evelyn Rogers,REP,190407,0,0,4,4,
Creek,U.S. Senate,Rob Moye,REP,190407,0,0,3,3,
Creek,U.S. Senate,D. Jean Mcbride-Samuels,REP,190407,0,0,0,0,
Creek,U.S. Senate,Jim Inhofe,REP,190407,0,2,46,48,
Creek,U.S. Senate,Erick Paul Wyatt,REP,190407,0,0,2,2,
Creek,U.S. Senate,Andy Craig,REP,190407,0,0,0,0,
Creek,U.S. Senate,T. Shannon,REP,190407,0,2,29,31,
Creek,U.S. Senate,Randy Brogdon,REP,190407,0,0,5,5,
Creek,U.S. Senate,Eric Mccray,REP,190407,0,0,0,0,
Creek,U.S. Senate,Kevin Crow,REP,190407,0,0,0,0,
Creek,U.S. Senate,James Lankford,REP,190407,0,0,22,22,
Creek,U.S. Senate,Jason Weger,REP,190407,0,0,0,0,
Creek,U.S. House,Timothy Ray Murray,REP,190407,0,0,3,3,03
Creek,U.S. House,Robert Hubbard,REP,190407,0,2,5,7,03
Creek,U.S. House,Frank Lucas,REP,190407,0,0,49,49,03
Creek,State Senate,John Knecht,REP,190407,0,2,10,12,12
Creek,State Senate,Brian Bingman,REP,190407,0,0,44,44,12
Creek,Superintendent of Public Instruction,John Cox,DEM,190408,0,0,18,18,
Creek,Superintendent of Public Instruction,Jack Jr.,DEM,190408,0,0,1,1,
Creek,Superintendent of Public Instruction,Ivan Holmes,DEM,190408,0,0,2,2,
Creek,Superintendent of Public Instruction,Freda Deskin,DEM,190408,0,0,15,15,
Creek,U.S. Senate,Patrick Michael Hayes,DEM,190408,0,0,8,8,
Creek,U.S. Senate,Jim Rogers,DEM,190408,0,0,10,10,
Creek,U.S. Senate,Connie Johnson,DEM,190408,0,0,17,17,
Creek,Governor,Dax Ewbank,REP,190408,0,0,15,15,
Creek,Governor,Chad Moody,REP,190408,2,0,9,11,
Creek,Governor,Mary Fallin,REP,190408,4,2,59,65,
Creek,Superintendent of Public Instruction,Brian Kelly,REP,190408,2,1,15,18,
Creek,Superintendent of Public Instruction,Janet Costello Barresi,REP,190408,1,1,9,11,
Creek,Superintendent of Public Instruction,Joy Hofmeister,REP,190408,3,0,58,61,
Creek,Insurance Commissioner,Bill Viner,REP,190408,2,0,18,20,
Creek,Insurance Commissioner,John Doak,REP,190408,4,2,59,65,
Creek,Corporation Commissioner,Todd Hiett,REP,190408,3,2,50,55,
Creek,Corporation Commissioner,Cliff Branan,REP,190408,3,0,32,35,
Creek,U.S. Senate,Evelyn Rogers,REP,190408,0,0,1,1,
Creek,U.S. Senate,Rob Moye,REP,190408,0,0,0,0,
Creek,U.S. Senate,D. Jean Mcbride-Samuels,REP,190408,0,0,2,2,
Creek,U.S. Senate,Jim Inhofe,REP,190408,4,2,74,80,
Creek,U.S. Senate,Erick Paul Wyatt,REP,190408,2,0,7,9,
Creek,U.S. Senate,Andy Craig,REP,190408,0,0,0,0,
Creek,U.S. Senate,T. Shannon,REP,190408,5,0,28,33,
Creek,U.S. Senate,Randy Brogdon,REP,190408,0,0,6,6,
Creek,U.S. Senate,Eric Mccray,REP,190408,0,0,0,0,
Creek,U.S. Senate,Kevin Crow,REP,190408,0,0,0,0,
Creek,U.S. Senate,James Lankford,REP,190408,1,2,48,51,
Creek,U.S. Senate,Jason Weger,REP,190408,0,0,1,1,
Creek,U.S. House,Timothy Ray Murray,REP,190408,1,0,4,5,03
Creek,U.S. House,Robert Hubbard,REP,190408,2,0,12,14,03
Creek,U.S. House,Frank Lucas,REP,190408,3,2,65,70,03
Creek,State Senate,John Knecht,REP,190408,1,1,34,36,12
Creek,State Senate,Brian Bingman,REP,190408,4,1,49,54,12
Creek,State House,James Leewright,REP,190408,1,0,22,23,29
Creek,State House,Clayton Mckinzie,REP,190408,0,0,24,24,29
Creek,State House,Dani Thompson-Fields,REP,190408,0,2,32,34,29
Creek,State House,Geron Ledbetter,REP,190408,5,0,5,10,29
Creek,Superintendent of Public Instruction,John Cox,DEM,190409,0,0,52,52,
Creek,Superintendent of Public Instruction,Jack Jr.,DEM,190409,1,0,10,11,
Creek,Superintendent of Public Instruction,Ivan Holmes,DEM,190409,0,0,3,3,
Creek,Superintendent of Public Instruction,Freda Deskin,DEM,190409,1,0,38,39,
Creek,U.S. Senate,Patrick Michael Hayes,DEM,190409,0,0,27,27,
Creek,U.S. Senate,Jim Rogers,DEM,190409,1,0,44,45,
Creek,U.S. Senate,Connie Johnson,DEM,190409,1,0,29,30,
Creek,Governor,Dax Ewbank,REP,190409,0,1,30,31,
Creek,Governor,Chad Moody,REP,190409,1,2,38,41,
Creek,Governor,Mary Fallin,REP,190409,0,5,144,149,
Creek,Superintendent of Public Instruction,Brian Kelly,REP,190409,0,2,47,49,
Creek,Superintendent of Public Instruction,Janet Costello Barresi,REP,190409,0,0,29,29,
Creek,Superintendent of Public Instruction,Joy Hofmeister,REP,190409,1,6,134,141,
Creek,Insurance Commissioner,Bill Viner,REP,190409,0,1,29,30,
Creek,Insurance Commissioner,John Doak,REP,190409,1,7,177,185,
Creek,Corporation Commissioner,Todd Hiett,REP,190409,0,6,159,165,
Creek,Corporation Commissioner,Cliff Branan,REP,190409,1,2,52,55,
Creek,U.S. Senate,Evelyn Rogers,REP,190409,0,1,6,7,
Creek,U.S. Senate,Rob Moye,REP,190409,1,1,0,2,
Creek,U.S. Senate,D. Jean Mcbride-Samuels,REP,190409,0,1,2,3,
Creek,U.S. Senate,Jim Inhofe,REP,190409,0,4,186,190,
Creek,U.S. Senate,Erick Paul Wyatt,REP,190409,0,1,15,16,
Creek,U.S. Senate,Andy Craig,REP,190409,0,0,1,1,
Creek,U.S. Senate,T. Shannon,REP,190409,0,1,108,109,
Creek,U.S. Senate,Randy Brogdon,REP,190409,1,0,20,21,
Creek,U.S. Senate,Eric Mccray,REP,190409,0,0,2,2,
Creek,U.S. Senate,Kevin Crow,REP,190409,0,0,1,1,
Creek,U.S. Senate,James Lankford,REP,190409,0,7,81,88,
Creek,U.S. Senate,Jason Weger,REP,190409,0,0,0,0,
Creek,U.S. House,Timothy Ray Murray,REP,190409,0,0,9,9,03
Creek,U.S. House,Robert Hubbard,REP,190409,0,1,34,35,03
Creek,U.S. House,Frank Lucas,REP,190409,1,7,166,174,03
Creek,State Senate,John Knecht,REP,190409,0,3,83,86,12
Creek,State Senate,Brian Bingman,REP,190409,1,5,128,134,12
Creek,State House,James Leewright,REP,190409,0,6,69,75,29
Creek,State House,Clayton Mckinzie,REP,190409,0,2,44,46,29
Creek,State House,Dani Thompson-Fields,REP,190409,1,0,72,73,29
Creek,State House,Geron Ledbetter,REP,190409,0,0,25,25,29
Creek,Superintendent of Public Instruction,John Cox,DEM,190410,0,0,18,18,
Creek,Superintendent of Public Instruction,Jack Jr.,DEM,190410,0,0,0,0,
Creek,Superintendent of Public Instruction,Ivan Holmes,DEM,190410,0,0,1,1,
Creek,Superintendent of Public Instruction,Freda Deskin,DEM,190410,0,0,11,11,
Creek,U.S. Senate,Patrick Michael Hayes,DEM,190410,0,0,10,10,
Creek,U.S. Senate,Jim Rogers,DEM,190410,0,0,15,15,
Creek,U.S. Senate,Connie Johnson,DEM,190410,0,0,5,5,
Creek,Governor,Dax Ewbank,REP,190410,0,2,8,10,
Creek,Governor,Chad Moody,REP,190410,0,0,5,5,
Creek,Governor,Mary Fallin,REP,190410,1,0,25,26,
Creek,Superintendent of Public Instruction,Brian Kelly,REP,190410,0,0,10,10,
Creek,Superintendent of Public Instruction,Janet Costello Barresi,REP,190410,0,0,3,3,
Creek,Superintendent of Public Instruction,Joy Hofmeister,REP,190410,1,2,25,28,
Creek,Insurance Commissioner,Bill Viner,REP,190410,1,0,5,6,
Creek,Insurance Commissioner,John Doak,REP,190410,0,2,30,32,
Creek,Corporation Commissioner,Todd Hiett,REP,190410,1,2,19,22,
Creek,Corporation Commissioner,Cliff Branan,REP,190410,0,0,15,15,
Creek,U.S. Senate,Evelyn Rogers,REP,190410,0,0,0,0,
Creek,U.S. Senate,Rob Moye,REP,190410,0,0,2,2,
Creek,U.S. Senate,D. Jean Mcbride-Samuels,REP,190410,0,0,0,0,
Creek,U.S. Senate,Jim Inhofe,REP,190410,1,2,33,36,
Creek,U.S. Senate,Erick Paul Wyatt,REP,190410,0,0,2,2,
Creek,U.S. Senate,Andy Craig,REP,190410,0,0,1,1,
Creek,U.S. Senate,T. Shannon,REP,190410,1,0,9,10,
Creek,U.S. Senate,Randy Brogdon,REP,190410,0,0,3,3,
Creek,U.S. Senate,Eric Mccray,REP,190410,0,0,2,2,
Creek,U.S. Senate,Kevin Crow,REP,190410,0,0,1,1,
Creek,U.S. Senate,James Lankford,REP,190410,0,2,22,24,
Creek,U.S. Senate,Jason Weger,REP,190410,0,0,0,0,
Creek,U.S. House,Timothy Ray Murray,REP,190410,0,0,2,2,03
Creek,U.S. House,Robert Hubbard,REP,190410,0,0,7,7,03
Creek,U.S. House,Frank Lucas,REP,190410,1,2,27,30,03
Creek,State Senate,John Knecht,REP,190410,0,2,15,17,12
Creek,State Senate,Brian Bingman,REP,190410,1,0,19,20,12
Creek,State House,James Leewright,REP,190410,0,0,7,7,29
Creek,State House,Clayton Mckinzie,REP,190410,1,2,15,18,29
Creek,State House,Dani Thompson-Fields,REP,190410,0,0,10,10,29
Creek,State House,Geron Ledbetter,REP,190410,0,0,5,5,29
Creek,Superintendent of Public Instruction,John Cox,DEM,190411,0,1,39,40,
Creek,Superintendent of Public Instruction,Jack Jr.,DEM,190411,0,0,9,9,
Creek,Superintendent of Public Instruction,Ivan Holmes,DEM,190411,0,0,9,9,
Creek,Superintendent of Public Instruction,Freda Deskin,DEM,190411,0,0,25,25,
Creek,U.S. Senate,Patrick Michael Hayes,DEM,190411,0,0,19,19,
Creek,U.S. Senate,Jim Rogers,DEM,190411,0,1,34,35,
Creek,U.S. Senate,Connie Johnson,DEM,190411,0,0,27,27,
Creek,Governor,Dax Ewbank,REP,190411,0,3,55,58,
Creek,Governor,Chad Moody,REP,190411,0,1,8,9,
Creek,Governor,Mary Fallin,REP,190411,0,2,89,91,
Creek,Superintendent of Public Instruction,Brian Kelly,REP,190411,0,2,36,38,
Creek,Superintendent of Public Instruction,Janet Costello Barresi,REP,190411,0,0,29,29,
Creek,Superintendent of Public Instruction,Joy Hofmeister,REP,190411,0,4,84,88,
Creek,Insurance Commissioner,Bill Viner,REP,190411,0,2,35,37,
Creek,Insurance Commissioner,John Doak,REP,190411,0,4,107,111,
Creek,Corporation Commissioner,Todd Hiett,REP,190411,0,4,107,111,
Creek,Corporation Commissioner,Cliff Branan,REP,190411,0,2,39,41,
Creek,U.S. Senate,Evelyn Rogers,REP,190411,0,1,5,6,
Creek,U.S. Senate,Rob Moye,REP,190411,0,1,0,1,
Creek,U.S. Senate,D. Jean Mcbride-Samuels,REP,190411,0,1,4,5,
Creek,U.S. Senate,Jim Inhofe,REP,190411,0,3,128,131,
Creek,U.S. Senate,Erick Paul Wyatt,REP,190411,0,0,13,13,
Creek,U.S. Senate,Andy Craig,REP,190411,0,0,4,4,
Creek,U.S. Senate,T. Shannon,REP,190411,0,1,58,59,
Creek,U.S. Senate,Randy Brogdon,REP,190411,0,1,9,10,
Creek,U.S. Senate,Eric Mccray,REP,190411,0,1,1,2,
Creek,U.S. Senate,Kevin Crow,REP,190411,0,0,4,4,
Creek,U.S. Senate,James Lankford,REP,190411,0,3,73,76,
Creek,U.S. Senate,Jason Weger,REP,190411,0,0,1,1,
Creek,U.S. House,Timothy Ray Murray,REP,190411,0,0,12,12,03
Creek,U.S. House,Robert Hubbard,REP,190411,0,2,40,42,03
Creek,U.S. House,Frank Lucas,REP,190411,0,4,100,104,03
Creek,State Senate,John Knecht,REP,190411,0,3,90,93,12
Creek,State Senate,Brian Bingman,REP,190411,0,3,58,61,12
Creek,State House,James Leewright,REP,190411,0,0,11,11,29
Creek,State House,Clayton Mckinzie,REP,190411,0,4,106,110,29
Creek,State House,Dani Thompson-Fields,REP,190411,0,2,37,39,29
Creek,State House,Geron Ledbetter,REP,190411,0,0,4,4,29
Creek,Superintendent of Public Instruction,John Cox,DEM,190412,0,0,21,21,
Creek,Superintendent of Public Instruction,Jack Jr.,DEM,190412,0,0,6,6,
Creek,Superintendent of Public Instruction,Ivan Holmes,DEM,190412,0,0,5,5,
Creek,Superintendent of Public Instruction,Freda Deskin,DEM,190412,0,0,44,44,
Creek,U.S. Senate,Patrick Michael Hayes,DEM,190412,0,0,21,21,
Creek,U.S. Senate,Jim Rogers,DEM,190412,0,0,29,29,
Creek,U.S. Senate,Connie Johnson,DEM,190412,0,0,26,26,
Creek,Governor,Dax Ewbank,REP,190412,0,0,10,10,
Creek,Governor,Chad Moody,REP,190412,0,3,15,18,
Creek,Governor,Mary Fallin,REP,190412,0,2,114,116,
Creek,Superintendent of Public Instruction,Brian Kelly,REP,190412,0,1,37,38,
Creek,Superintendent of Public Instruction,Janet Costello Barresi,REP,190412,0,0,18,18,
Creek,Superintendent of Public Instruction,Joy Hofmeister,REP,190412,0,4,82,86,
Creek,Insurance Commissioner,Bill Viner,REP,190412,0,1,21,22,
Creek,Insurance Commissioner,John Doak,REP,190412,0,4,113,117,
Creek,Corporation Commissioner,Todd Hiett,REP,190412,0,5,110,115,
Creek,Corporation Commissioner,Cliff Branan,REP,190412,0,0,29,29,
Creek,U.S. Senate,Evelyn Rogers,REP,190412,0,0,9,9,
Creek,U.S. Senate,Rob Moye,REP,190412,0,0,2,2,
Creek,U.S. Senate,D. Jean Mcbride-Samuels,REP,190412,0,0,5,5,
Creek,U.S. Senate,Jim Inhofe,REP,190412,0,4,116,120,
Creek,U.S. Senate,Erick Paul Wyatt,REP,190412,0,1,8,9,
Creek,U.S. Senate,Andy Craig,REP,190412,0,0,1,1,
Creek,U.S. Senate,T. Shannon,REP,190412,0,2,69,71,
Creek,U.S. Senate,Randy Brogdon,REP,190412,0,0,20,20,
Creek,U.S. Senate,Eric Mccray,REP,190412,0,0,2,2,
Creek,U.S. Senate,Kevin Crow,REP,190412,0,0,2,2,
Creek,U.S. Senate,James Lankford,REP,190412,0,3,43,46,
Creek,U.S. Senate,Jason Weger,REP,190412,0,0,0,0,
Creek,U.S. House,Timothy Ray Murray,REP,190412,0,1,8,9,03
Creek,U.S. House,Robert Hubbard,REP,190412,0,0,20,20,03
Creek,U.S. House,Frank Lucas,REP,190412,0,4,108,112,03
Creek,State Senate,John Knecht,REP,190412,0,1,53,54,12
Creek,State Senate,Brian Bingman,REP,190412,0,4,84,88,12
Creek,State House,James Leewright,REP,190412,0,5,37,42,29
Creek,State House,Clayton Mckinzie,REP,190412,0,0,38,38,29
Creek,State House,Dani Thompson-Fields,REP,190412,0,0,48,48,29
Creek,State House,Geron Ledbetter,REP,190412,0,0,18,18,29
Creek,Superintendent of Public Instruction,John Cox,DEM,190413,0,1,39,40,
Creek,Superintendent of Public Instruction,Jack Jr.,DEM,190413,0,1,12,13,
Creek,Superintendent of Public Instruction,Ivan Holmes,DEM,190413,0,0,14,14,
Creek,Superintendent of Public Instruction,Freda Deskin,DEM,190413,0,0,48,48,
Creek,U.S. Senate,Patrick Michael Hayes,DEM,190413,0,0,17,17,
Creek,U.S. Senate,Jim Rogers,DEM,190413,0,2,57,59,
Creek,U.S. Senate,Connie Johnson,DEM,190413,0,0,38,38,
Creek,Governor,Dax Ewbank,REP,190413,1,2,20,23,
Creek,Governor,Chad Moody,REP,190413,0,2,38,40,
Creek,Governor,Mary Fallin,REP,190413,0,6,160,166,
Creek,Superintendent of Public Instruction,Brian Kelly,REP,190413,0,3,55,58,
Creek,Superintendent of Public Instruction,Janet Costello Barresi,REP,190413,0,0,31,31,
Creek,Superintendent of Public Instruction,Joy Hofmeister,REP,190413,1,5,132,138,
Creek,Insurance Commissioner,Bill Viner,REP,190413,0,2,45,47,
Creek,Insurance Commissioner,John Doak,REP,190413,1,8,171,180,
Creek,Corporation Commissioner,Todd Hiett,REP,190413,1,11,177,189,
Creek,Corporation Commissioner,Cliff Branan,REP,190413,0,0,42,42,
Creek,U.S. Senate,Evelyn Rogers,REP,190413,0,0,10,10,
Creek,U.S. Senate,Rob Moye,REP,190413,0,0,3,3,
Creek,U.S. Senate,D. Jean Mcbride-Samuels,REP,190413,0,0,3,3,
Creek,U.S. Senate,Jim Inhofe,REP,190413,1,11,196,208,
Creek,U.S. Senate,Erick Paul Wyatt,REP,190413,0,0,8,8,
Creek,U.S. Senate,Andy Craig,REP,190413,0,0,3,3,
Creek,U.S. Senate,T. Shannon,REP,190413,0,8,107,115,
Creek,U.S. Senate,Randy Brogdon,REP,190413,0,0,15,15,
Creek,U.S. Senate,Eric Mccray,REP,190413,0,0,3,3,
Creek,U.S. Senate,Kevin Crow,REP,190413,0,0,3,3,
Creek,U.S. Senate,James Lankford,REP,190413,1,3,88,92,
Creek,U.S. Senate,Jason Weger,REP,190413,0,0,1,1,
Creek,U.S. House,Timothy Ray Murray,REP,190413,0,0,13,13,03
Creek,U.S. House,Robert Hubbard,REP,190413,0,1,34,35,03
Creek,U.S. House,Frank Lucas,REP,190413,1,7,167,175,03
Creek,State Senate,John Knecht,REP,190413,1,4,87,92,12
Creek,State Senate,Brian Bingman,REP,190413,0,6,129,135,12
Creek,State House,James Leewright,REP,190413,0,2,73,75,29
Creek,State House,Clayton Mckinzie,REP,190413,1,5,53,59,29
Creek,State House,Dani Thompson-Fields,REP,190413,0,0,73,73,29
Creek,State House,Geron Ledbetter,REP,190413,0,4,22,26,29
Creek,Superintendent of Public Instruction,John Cox,DEM,190414,2,6,68,76,
Creek,Superintendent of Public Instruction,Jack Jr.,DEM,190414,0,1,26,27,
Creek,Superintendent of Public Instruction,Ivan Holmes,DEM,190414,0,1,10,11,
Creek,Superintendent of Public Instruction,Freda Deskin,DEM,190414,1,3,68,72,
Creek,U.S. Senate,Patrick Michael Hayes,DEM,190414,0,2,48,50,
Creek,U.S. Senate,Jim Rogers,DEM,190414,1,8,72,81,
Creek,U.S. Senate,Connie Johnson,DEM,190414,2,1,50,53,
Creek,Governor,Dax Ewbank,REP,190414,0,1,38,39,
Creek,Governor,Chad Moody,REP,190414,0,7,59,66,
Creek,Governor,Mary Fallin,REP,190414,7,20,272,299,
Creek,Superintendent of Public Instruction,Brian Kelly,REP,190414,1,5,94,100,
Creek,Superintendent of Public Instruction,Janet Costello Barresi,REP,190414,4,1,46,51,
Creek,Superintendent of Public Instruction,Joy Hofmeister,REP,190414,2,22,223,247,
Creek,Insurance Commissioner,Bill Viner,REP,190414,1,4,96,101,
Creek,Insurance Commissioner,John Doak,REP,190414,6,23,257,286,
Creek,Corporation Commissioner,Todd Hiett,REP,190414,7,22,309,338,
Creek,Corporation Commissioner,Cliff Branan,REP,190414,0,6,60,66,
Creek,U.S. Senate,Evelyn Rogers,REP,190414,0,0,21,21,
Creek,U.S. Senate,Rob Moye,REP,190414,0,1,8,9,
Creek,U.S. Senate,D. Jean Mcbride-Samuels,REP,190414,0,0,5,5,
Creek,U.S. Senate,Jim Inhofe,REP,190414,7,27,325,359,
Creek,U.S. Senate,Erick Paul Wyatt,REP,190414,0,0,11,11,
Creek,U.S. Senate,Andy Craig,REP,190414,0,0,6,6,
Creek,U.S. Senate,T. Shannon,REP,190414,6,7,179,192,
Creek,U.S. Senate,Randy Brogdon,REP,190414,1,1,34,36,
Creek,U.S. Senate,Eric Mccray,REP,190414,0,0,8,8,
Creek,U.S. Senate,Kevin Crow,REP,190414,0,0,8,8,
Creek,U.S. Senate,James Lankford,REP,190414,0,21,130,151,
Creek,U.S. Senate,Jason Weger,REP,190414,0,0,1,1,
Creek,U.S. House,Timothy Ray Murray,REP,190414,0,1,28,29,03
Creek,U.S. House,Robert Hubbard,REP,190414,0,4,37,41,03
Creek,U.S. House,Frank Lucas,REP,190414,7,24,301,332,03
Creek,State Senate,John Knecht,REP,190414,1,5,96,102,12
Creek,State Senate,Brian Bingman,REP,190414,6,23,273,302,12
Creek,State House,James Leewright,REP,190414,7,16,175,198,29
Creek,State House,Clayton Mckinzie,REP,190414,0,3,40,43,29
Creek,State House,Dani Thompson-Fields,REP,190414,0,6,103,109,29
Creek,State House,Geron Ledbetter,REP,190414,0,2,43,45,29
Creek,Superintendent of Public Instruction,John Cox,DEM,190415,0,0,8,8,
Creek,Superintendent of Public Instruction,Jack Jr.,DEM,190415,0,0,3,3,
Creek,Superintendent of Public Instruction,Ivan Holmes,DEM,190415,0,0,2,2,
Creek,Superintendent of Public Instruction,Freda Deskin,DEM,190415,0,0,7,7,
Creek,U.S. Senate,Patrick Michael Hayes,DEM,190415,0,0,7,7,
Creek,U.S. Senate,Jim Rogers,DEM,190415,0,0,7,7,
Creek,U.S. Senate,Connie Johnson,DEM,190415,0,0,6,6,
Creek,Governor,Dax Ewbank,REP,190415,0,2,3,5,
Creek,Governor,Chad Moody,REP,190415,0,0,8,8,
Creek,Governor,Mary Fallin,REP,190415,0,5,53,58,
Creek,Superintendent of Public Instruction,Brian Kelly,REP,190415,0,0,19,19,
Creek,Superintendent of Public Instruction,Janet Costello Barresi,REP,190415,0,2,5,7,
Creek,Superintendent of Public Instruction,Joy Hofmeister,REP,190415,0,5,40,45,
Creek,Insurance Commissioner,Bill Viner,REP,190415,0,2,13,15,
Creek,Insurance Commissioner,John Doak,REP,190415,0,5,51,56,
Creek,Corporation Commissioner,Todd Hiett,REP,190415,0,5,41,46,
Creek,Corporation Commissioner,Cliff Branan,REP,190415,0,2,25,27,
Creek,U.S. Senate,Evelyn Rogers,REP,190415,0,0,3,3,
Creek,U.S. Senate,Rob Moye,REP,190415,0,0,1,1,
Creek,U.S. Senate,D. Jean Mcbride-Samuels,REP,190415,0,0,0,0,
Creek,U.S. Senate,Jim Inhofe,REP,190415,0,7,55,62,
Creek,U.S. Senate,Erick Paul Wyatt,REP,190415,0,0,5,5,
Creek,U.S. Senate,Andy Craig,REP,190415,0,0,1,1,
Creek,U.S. Senate,T. Shannon,REP,190415,0,3,33,36,
Creek,U.S. Senate,Randy Brogdon,REP,190415,0,2,4,6,
Creek,U.S. Senate,Eric Mccray,REP,190415,0,0,1,1,
Creek,U.S. Senate,Kevin Crow,REP,190415,0,0,0,0,
Creek,U.S. Senate,James Lankford,REP,190415,0,2,28,30,
Creek,U.S. Senate,Jason Weger,REP,190415,0,0,0,0,
Creek,State Senate,John Knecht,REP,190415,0,3,21,24,12
Creek,State Senate,Brian Bingman,REP,190415,0,4,44,48,12
Creek,State House,James Leewright,REP,190415,0,3,15,18,29
Creek,State House,Clayton Mckinzie,REP,190415,0,0,10,10,29
Creek,State House,Dani Thompson-Fields,REP,190415,0,2,16,18,29
Creek,State House,Geron Ledbetter,REP,190415,0,2,23,25,29
Creek,Superintendent of Public Instruction,John Cox,DEM,190416,0,1,10,11,
Creek,Superintendent of Public Instruction,Jack Jr.,DEM,190416,0,1,8,9,
Creek,Superintendent of Public Instruction,Ivan Holmes,DEM,190416,0,0,4,4,
Creek,Superintendent of Public Instruction,Freda Deskin,DEM,190416,0,0,30,30,
Creek,U.S. Senate,Patrick Michael Hayes,DEM,190416,0,0,14,14,
Creek,U.S. Senate,Jim Rogers,DEM,190416,0,0,19,19,
Creek,U.S. Senate,Connie Johnson,DEM,190416,0,2,19,21,
Creek,Governor,Dax Ewbank,REP,190416,0,1,10,11,
Creek,Governor,Chad Moody,REP,190416,1,2,25,28,
Creek,Governor,Mary Fallin,REP,190416,3,6,133,142,
Creek,Superintendent of Public Instruction,Brian Kelly,REP,190416,2,3,30,35,
Creek,Superintendent of Public Instruction,Janet Costello Barresi,REP,190416,0,0,25,25,
Creek,Superintendent of Public Instruction,Joy Hofmeister,REP,190416,2,6,110,118,
Creek,Insurance Commissioner,Bill Viner,REP,190416,0,3,27,30,
Creek,Insurance Commissioner,John Doak,REP,190416,3,6,129,138,
Creek,Corporation Commissioner,Todd Hiett,REP,190416,2,4,103,109,
Creek,Corporation Commissioner,Cliff Branan,REP,190416,1,5,54,60,
Creek,U.S. Senate,Evelyn Rogers,REP,190416,0,0,6,6,
Creek,U.S. Senate,Rob Moye,REP,190416,1,0,1,2,
Creek,U.S. Senate,D. Jean Mcbride-Samuels,REP,190416,0,0,2,2,
Creek,U.S. Senate,Jim Inhofe,REP,190416,3,9,153,165,
Creek,U.S. Senate,Erick Paul Wyatt,REP,190416,0,0,5,5,
Creek,U.S. Senate,Andy Craig,REP,190416,0,0,1,1,
Creek,U.S. Senate,T. Shannon,REP,190416,2,2,74,78,
Creek,U.S. Senate,Randy Brogdon,REP,190416,0,0,17,17,
Creek,U.S. Senate,Eric Mccray,REP,190416,0,0,0,0,
Creek,U.S. Senate,Kevin Crow,REP,190416,0,0,1,1,
Creek,U.S. Senate,James Lankford,REP,190416,2,7,77,86,
Creek,U.S. Senate,Jason Weger,REP,190416,0,0,0,0,
Creek,State Senate,John Knecht,REP,190416,0,0,36,36,12
Creek,State Senate,Brian Bingman,REP,190416,4,8,129,141,12
Creek,Superintendent of Public Instruction,John Cox,DEM,190417,0,3,44,47,
Creek,Superintendent of Public Instruction,Jack Jr.,DEM,190417,0,0,11,11,
Creek,Superintendent of Public Instruction,Ivan Holmes,DEM,190417,0,0,3,3,
Creek,Superintendent of Public Instruction,Freda Deskin,DEM,190417,0,3,39,42,
Creek,U.S. Senate,Patrick Michael Hayes,DEM,190417,0,0,22,22,
Creek,U.S. Senate,Jim Rogers,DEM,190417,0,3,34,37,
Creek,U.S. Senate,Connie Johnson,DEM,190417,0,3,39,42,
Creek,Governor,Dax Ewbank,REP,190417,0,0,15,15,
Creek,Governor,Chad Moody,REP,190417,1,3,50,54,
Creek,Governor,Mary Fallin,REP,190417,5,9,260,274,
Creek,Superintendent of Public Instruction,Brian Kelly,REP,190417,2,1,76,79,
Creek,Superintendent of Public Instruction,Janet Costello Barresi,REP,190417,0,3,54,57,
Creek,Superintendent of Public Instruction,Joy Hofmeister,REP,190417,3,8,194,205,
Creek,Insurance Commissioner,Bill Viner,REP,190417,1,2,80,83,
Creek,Insurance Commissioner,John Doak,REP,190417,4,9,225,238,
Creek,Corporation Commissioner,Todd Hiett,REP,190417,3,9,213,225,
Creek,Corporation Commissioner,Cliff Branan,REP,190417,3,3,95,101,
Creek,U.S. Senate,Evelyn Rogers,REP,190417,0,0,6,6,
Creek,U.S. Senate,Rob Moye,REP,190417,0,0,6,6,
Creek,U.S. Senate,D. Jean Mcbride-Samuels,REP,190417,0,0,3,3,
Creek,U.S. Senate,Jim Inhofe,REP,190417,6,12,304,322,
Creek,U.S. Senate,Erick Paul Wyatt,REP,190417,0,0,7,7,
Creek,U.S. Senate,Andy Craig,REP,190417,0,0,1,1,
Creek,U.S. Senate,T. Shannon,REP,190417,6,1,150,157,
Creek,U.S. Senate,Randy Brogdon,REP,190417,0,0,31,31,
Creek,U.S. Senate,Eric Mccray,REP,190417,0,0,0,0,
Creek,U.S. Senate,Kevin Crow,REP,190417,0,0,2,2,
Creek,U.S. Senate,James Lankford,REP,190417,0,11,138,149,
Creek,U.S. Senate,Jason Weger,REP,190417,0,0,0,0,
Creek,State Senate,John Knecht,REP,190417,2,2,72,76,12
Creek,State Senate,Brian Bingman,REP,190417,4,10,245,259,12
Creek,Superintendent of Public Instruction,John Cox,DEM,190418,0,1,34,35,
Creek,Superintendent of Public Instruction,Jack Jr.,DEM,190418,2,1,9,12,
Creek,Superintendent of Public Instruction,Ivan Holmes,DEM,190418,0,1,3,4,
Creek,Superintendent of Public Instruction,Freda Deskin,DEM,190418,0,3,41,44,
Creek,U.S. Senate,Patrick Michael Hayes,DEM,190418,0,1,20,21,
Creek,U.S. Senate,Jim Rogers,DEM,190418,0,2,29,31,
Creek,U.S. Senate,Connie Johnson,DEM,190418,2,3,36,41,
Creek,Governor,Dax Ewbank,REP,190418,0,3,15,18,
Creek,Governor,Chad Moody,REP,190418,1,1,38,40,
Creek,Governor,Mary Fallin,REP,190418,7,12,243,262,
Creek,Superintendent of Public Instruction,Brian Kelly,REP,190418,0,0,45,45,
Creek,Superintendent of Public Instruction,Janet Costello Barresi,REP,190418,3,1,43,47,
Creek,Superintendent of Public Instruction,Joy Hofmeister,REP,190418,5,15,205,225,
Creek,Insurance Commissioner,Bill Viner,REP,190418,0,5,55,60,
Creek,Insurance Commissioner,John Doak,REP,190418,8,9,226,243,
Creek,Corporation Commissioner,Todd Hiett,REP,190418,5,7,203,215,
Creek,Corporation Commissioner,Cliff Branan,REP,190418,1,7,84,92,
Creek,U.S. Senate,Evelyn Rogers,REP,190418,0,1,7,8,
Creek,U.S. Senate,Rob Moye,REP,190418,0,1,3,4,
Creek,U.S. Senate,D. Jean Mcbride-Samuels,REP,190418,0,0,1,1,
Creek,U.S. Senate,Jim Inhofe,REP,190418,8,14,274,296,
Creek,U.S. Senate,Erick Paul Wyatt,REP,190418,0,0,9,9,
Creek,U.S. Senate,Andy Craig,REP,190418,1,0,1,2,
Creek,U.S. Senate,T. Shannon,REP,190418,5,3,109,117,
Creek,U.S. Senate,Randy Brogdon,REP,190418,0,4,23,27,
Creek,U.S. Senate,Eric Mccray,REP,190418,0,0,3,3,
Creek,U.S. Senate,Kevin Crow,REP,190418,0,0,1,1,
Creek,U.S. Senate,James Lankford,REP,190418,2,9,160,171,
Creek,U.S. Senate,Jason Weger,REP,190418,0,0,2,2,
Creek,U.S. House,Timothy Ray Murray,REP,190418,0,0,20,20,03
Creek,U.S. House,Robert Hubbard,REP,190418,0,4,35,39,03
Creek,U.S. House,Frank Lucas,REP,190418,8,11,235,254,03
Creek,State Senate,John Knecht,REP,190418,1,7,67,75,12
Creek,State Senate,Brian Bingman,REP,190418,5,9,228,242,12
Creek,Superintendent of Public Instruction,John Cox,DEM,190419,0,1,25,26,
Creek,Superintendent of Public Instruction,Jack Jr.,DEM,190419,0,1,9,10,
Creek,Superintendent of Public Instruction,Ivan Holmes,DEM,190419,0,0,4,4,
Creek,Superintendent of Public Instruction,Freda Deskin,DEM,190419,0,0,28,28,
Creek,U.S. Senate,Patrick Michael Hayes,DEM,190419,0,0,18,18,
Creek,U.S. Senate,Jim Rogers,DEM,190419,0,1,15,16,
Creek,U.S. Senate,Connie Johnson,DEM,190419,0,1,34,35,
Creek,Governor,Dax Ewbank,REP,190419,0,1,16,17,
Creek,Governor,Chad Moody,REP,190419,0,0,30,30,
Creek,Governor,Mary Fallin,REP,190419,8,2,166,176,
Creek,Superintendent of Public Instruction,Brian Kelly,REP,190419,3,1,37,41,
Creek,Superintendent of Public Instruction,Janet Costello Barresi,REP,190419,5,1,36,42,
Creek,Superintendent of Public Instruction,Joy Hofmeister,REP,190419,0,1,137,138,
Creek,Insurance Commissioner,Bill Viner,REP,190419,3,1,46,50,
Creek,Insurance Commissioner,John Doak,REP,190419,5,1,151,157,
Creek,Corporation Commissioner,Todd Hiett,REP,190419,5,1,109,115,
Creek,Corporation Commissioner,Cliff Branan,REP,190419,1,1,89,91,
Creek,U.S. Senate,Evelyn Rogers,REP,190419,0,0,8,8,
Creek,U.S. Senate,Rob Moye,REP,190419,1,0,5,6,
Creek,U.S. Senate,D. Jean Mcbride-Samuels,REP,190419,0,0,5,5,
Creek,U.S. Senate,Jim Inhofe,REP,190419,7,2,189,198,
Creek,U.S. Senate,Erick Paul Wyatt,REP,190419,0,1,5,6,
Creek,U.S. Senate,Andy Craig,REP,190419,1,0,2,3,
Creek,U.S. Senate,T. Shannon,REP,190419,1,1,77,79,
Creek,U.S. Senate,Randy Brogdon,REP,190419,3,1,13,17,
Creek,U.S. Senate,Eric Mccray,REP,190419,0,0,0,0,
Creek,U.S. Senate,Kevin Crow,REP,190419,1,0,3,4,
Creek,U.S. Senate,James Lankford,REP,190419,2,1,118,121,
Creek,U.S. Senate,Jason Weger,REP,190419,0,0,0,0,
Creek,U.S. House,Timothy Ray Murray,REP,190419,0,0,12,12,03
Creek,U.S. House,Robert Hubbard,REP,190419,4,0,26,30,03
Creek,U.S. House,Frank Lucas,REP,190419,4,2,166,172,03
Creek,State Senate,John Knecht,REP,190419,4,3,41,48,12
Creek,State Senate,Brian Bingman,REP,190419,4,0,165,169,12
Creek,Superintendent of Public Instruction,John Cox,DEM,190420,0,0,4,4,
Creek,Superintendent of Public Instruction,Jack Jr.,DEM,190420,0,0,2,2,
Creek,Superintendent of Public Instruction,Ivan Holmes,DEM,190420,0,0,3,3,
Creek,Superintendent of Public Instruction,Freda Deskin,DEM,190420,0,1,16,17,
Creek,U.S. Senate,Patrick Michael Hayes,DEM,190420,0,0,3,3,
Creek,U.S. Senate,Jim Rogers,DEM,190420,0,1,5,6,
Creek,U.S. Senate,Connie Johnson,DEM,190420,0,0,17,17,
Creek,Governor,Dax Ewbank,REP,190420,0,0,8,8,
Creek,Governor,Chad Moody,REP,190420,0,3,23,26,
Creek,Governor,Mary Fallin,REP,190420,0,2,121,123,
Creek,Superintendent of Public Instruction,Brian Kelly,REP,190420,0,2,19,21,
Creek,Superintendent of Public Instruction,Janet Costello Barresi,REP,190420,0,0,15,15,
Creek,Superintendent of Public Instruction,Joy Hofmeister,REP,190420,2,3,119,124,
Creek,Insurance Commissioner,Bill Viner,REP,190420,0,1,26,27,
Creek,Insurance Commissioner,John Doak,REP,190420,2,3,114,119,
Creek,Corporation Commissioner,Todd Hiett,REP,190420,0,2,66,68,
Creek,Corporation Commissioner,Cliff Branan,REP,190420,0,2,77,79,
Creek,U.S. Senate,Evelyn Rogers,REP,190420,0,1,3,4,
Creek,U.S. Senate,Rob Moye,REP,190420,0,0,0,0,
Creek,U.S. Senate,D. Jean Mcbride-Samuels,REP,190420,0,0,0,0,
Creek,U.S. Senate,Jim Inhofe,REP,190420,0,4,145,149,
Creek,U.S. Senate,Erick Paul Wyatt,REP,190420,0,0,5,5,
Creek,U.S. Senate,Andy Craig,REP,190420,0,0,2,2,
Creek,U.S. Senate,T. Shannon,REP,190420,0,2,65,67,
Creek,U.S. Senate,Randy Brogdon,REP,190420,0,0,3,3,
Creek,U.S. Senate,Eric Mccray,REP,190420,0,0,1,1,
Creek,U.S. Senate,Kevin Crow,REP,190420,0,0,0,0,
Creek,U.S. Senate,James Lankford,REP,190420,0,3,82,85,
Creek,U.S. Senate,Jason Weger,REP,190420,2,0,1,3,
Creek,U.S. House,Timothy Ray Murray,REP,190420,2,0,8,10,03
Creek,U.S. House,Robert Hubbard,REP,190420,0,0,12,12,03
Creek,U.S. House,Frank Lucas,REP,190420,0,4,128,132,03
Creek,State Senate,John Knecht,REP,190420,0,0,23,23,12
Creek,State Senate,Brian Bingman,REP,190420,2,5,121,128,12
Creek,Superintendent of Public Instruction,John Cox,DEM,190421,0,1,24,25,
Creek,Superintendent of Public Instruction,Jack Jr.,DEM,190421,0,1,8,9,
Creek,Superintendent of Public Instruction,Ivan Holmes,DEM,190421,0,0,1,1,
Creek,Superintendent of Public Instruction,Freda Deskin,DEM,190421,2,0,24,26,
Creek,U.S. Senate,Patrick Michael Hayes,DEM,190421,0,0,11,11,
Creek,U.S. Senate,Jim Rogers,DEM,190421,0,2,22,24,
Creek,U.S. Senate,Connie Johnson,DEM,190421,2,0,22,24,
Creek,Governor,Dax Ewbank,REP,190421,1,0,11,12,
Creek,Governor,Chad Moody,REP,190421,1,0,17,18,
Creek,Governor,Mary Fallin,REP,190421,2,0,184,186,
Creek,Superintendent of Public Instruction,Brian Kelly,REP,190421,1,0,21,22,
Creek,Superintendent of Public Instruction,Janet Costello Barresi,REP,190421,0,0,42,42,
Creek,Superintendent of Public Instruction,Joy Hofmeister,REP,190421,3,0,146,149,
Creek,Insurance Commissioner,Bill Viner,REP,190421,1,0,31,32,
Creek,Insurance Commissioner,John Doak,REP,190421,2,0,142,144,
Creek,Corporation Commissioner,Todd Hiett,REP,190421,2,0,105,107,
Creek,Corporation Commissioner,Cliff Branan,REP,190421,0,0,80,80,
Creek,U.S. Senate,Evelyn Rogers,REP,190421,0,0,7,7,
Creek,U.S. Senate,Rob Moye,REP,190421,0,0,3,3,
Creek,U.S. Senate,D. Jean Mcbride-Samuels,REP,190421,0,0,2,2,
Creek,U.S. Senate,Jim Inhofe,REP,190421,4,0,194,198,
Creek,U.S. Senate,Erick Paul Wyatt,REP,190421,0,0,5,5,
Creek,U.S. Senate,Andy Craig,REP,190421,0,0,2,2,
Creek,U.S. Senate,T. Shannon,REP,190421,0,0,61,61,
Creek,U.S. Senate,Randy Brogdon,REP,190421,0,0,10,10,
Creek,U.S. Senate,Eric Mccray,REP,190421,0,0,1,1,
Creek,U.S. Senate,Kevin Crow,REP,190421,2,0,0,2,
Creek,U.S. Senate,James Lankford,REP,190421,2,0,139,141,
Creek,U.S. Senate,Jason Weger,REP,190421,0,0,1,1,
Creek,U.S. House,Timothy Ray Murray,REP,190421,0,0,7,7,03
Creek,U.S. House,Robert Hubbard,REP,190421,1,0,20,21,03
Creek,U.S. House,Frank Lucas,REP,190421,3,0,161,164,03
Creek,State Senate,John Knecht,REP,190421,1,0,29,30,12
Creek,State Senate,Brian Bingman,REP,190421,3,0,159,162,12
Creek,Superintendent of Public Instruction,John Cox,DEM,190422,0,0,20,20,
Creek,Superintendent of Public Instruction,Jack Jr.,DEM,190422,0,0,6,6,
Creek,Superintendent of Public Instruction,Ivan Holmes,DEM,190422,0,0,3,3,
Creek,Superintendent of Public Instruction,Freda Deskin,DEM,190422,0,0,16,16,
Creek,U.S. Senate,Patrick Michael Hayes,DEM,190422,0,0,14,14,
Creek,U.S. Senate,Jim Rogers,DEM,190422,0,0,20,20,
Creek,U.S. Senate,Connie Johnson,DEM,190422,0,0,9,9,
Creek,Governor,Dax Ewbank,REP,190422,0,0,8,8,
Creek,Governor,Chad Moody,REP,190422,2,2,17,21,
Creek,Governor,Mary Fallin,REP,190422,14,0,79,93,
Creek,Superintendent of Public Instruction,Brian Kelly,REP,190422,1,1,29,31,
Creek,Superintendent of Public Instruction,Janet Costello Barresi,REP,190422,2,0,15,17,
Creek,Superintendent of Public Instruction,Joy Hofmeister,REP,190422,13,1,60,74,
Creek,Insurance Commissioner,Bill Viner,REP,190422,1,1,31,33,
Creek,Insurance Commissioner,John Doak,REP,190422,13,1,66,80,
Creek,Corporation Commissioner,Todd Hiett,REP,190422,16,2,83,101,
Creek,Corporation Commissioner,Cliff Branan,REP,190422,0,0,20,20,
Creek,U.S. Senate,Evelyn Rogers,REP,190422,0,1,3,4,
Creek,U.S. Senate,Rob Moye,REP,190422,0,0,5,5,
Creek,U.S. Senate,D. Jean Mcbride-Samuels,REP,190422,0,0,4,4,
Creek,U.S. Senate,Jim Inhofe,REP,190422,16,1,84,101,
Creek,U.S. Senate,Erick Paul Wyatt,REP,190422,0,0,10,10,
Creek,U.S. Senate,Andy Craig,REP,190422,0,0,2,2,
Creek,U.S. Senate,T. Shannon,REP,190422,6,2,56,64,
Creek,U.S. Senate,Randy Brogdon,REP,190422,0,0,4,4,
Creek,U.S. Senate,Eric Mccray,REP,190422,0,0,2,2,
Creek,U.S. Senate,Kevin Crow,REP,190422,0,0,1,1,
Creek,U.S. Senate,James Lankford,REP,190422,10,0,42,52,
Creek,U.S. Senate,Jason Weger,REP,190422,0,0,0,0,
Creek,U.S. House,Timothy Ray Murray,REP,190422,1,0,9,10,03
Creek,U.S. House,Robert Hubbard,REP,190422,0,0,20,20,03
Creek,U.S. House,Frank Lucas,REP,190422,15,2,72,89,03
Creek,State Senate,John Knecht,REP,190422,3,0,35,38,12
Creek,State Senate,Brian Bingman,REP,190422,13,2,67,82,12
Creek,State House,James Leewright,REP,190422,8,1,36,45,29
Creek,State House,Clayton Mckinzie,REP,190422,1,0,13,14,29
Creek,State House,Dani Thompson-Fields,REP,190422,3,1,38,42,29
Creek,State House,Geron Ledbetter,REP,190422,2,0,12,14,29
Custer,Superintendent of Public Instruction,John Cox,DEM,200001,0,2,16,18,
Custer,Superintendent of Public Instruction,Jack Jr.,DEM,200001,0,4,9,13,
Custer,Superintendent of Public Instruction,Ivan Holmes,DEM,200001,0,0,5,5,
Custer,Superintendent of Public Instruction,Freda Deskin,DEM,200001,0,3,11,14,
Custer,U.S. Senate,Patrick Michael Hayes,DEM,200001,0,1,9,10,
Custer,U.S. Senate,Jim Rogers,DEM,200001,0,5,21,26,
Custer,U.S. Senate,Connie Johnson,DEM,200001,0,3,12,15,
Custer,Governor,Dax Ewbank,REP,200001,0,0,7,7,
Custer,Governor,Chad Moody,REP,200001,0,5,12,17,
Custer,Governor,Mary Fallin,REP,200001,1,3,66,70,
Custer,Superintendent of Public Instruction,Brian Kelly,REP,200001,0,1,18,19,
Custer,Superintendent of Public Instruction,Janet Costello Barresi,REP,200001,0,3,8,11,
Custer,Superintendent of Public Instruction,Joy Hofmeister,REP,200001,1,4,57,62,
Custer,Insurance Commissioner,Bill Viner,REP,200001,0,2,15,17,
Custer,Insurance Commissioner,John Doak,REP,200001,1,6,65,72,
Custer,Corporation Commissioner,Todd Hiett,REP,200001,0,2,41,43,
Custer,Corporation Commissioner,Cliff Branan,REP,200001,1,6,39,46,
Custer,U.S. Senate,Evelyn Rogers,REP,200001,0,1,4,5,
Custer,U.S. Senate,Rob Moye,REP,200001,0,0,1,1,
Custer,U.S. Senate,D. Jean Mcbride-Samuels,REP,200001,0,0,1,1,
Custer,U.S. Senate,Jim Inhofe,REP,200001,1,6,77,84,
Custer,U.S. Senate,Erick Paul Wyatt,REP,200001,0,1,2,3,
Custer,U.S. Senate,Andy Craig,REP,200001,0,0,0,0,
Custer,U.S. Senate,T. Shannon,REP,200001,0,2,33,35,
Custer,U.S. Senate,Randy Brogdon,REP,200001,0,0,2,2,
Custer,U.S. Senate,Eric Mccray,REP,200001,0,1,0,1,
Custer,U.S. Senate,Kevin Crow,REP,200001,0,0,0,0,
Custer,U.S. Senate,James Lankford,REP,200001,1,5,51,57,
Custer,U.S. Senate,Jason Weger,REP,200001,0,0,0,0,
Custer,U.S. House,Timothy Ray Murray,REP,200001,0,1,3,4,03
Custer,U.S. House,Robert Hubbard,REP,200001,0,1,6,7,03
Custer,U.S. House,Frank Lucas,REP,200001,1,6,76,83,03
Custer,Superintendent of Public Instruction,John Cox,DEM,200003,0,4,31,35,
Custer,Superintendent of Public Instruction,Jack Jr.,DEM,200003,1,2,14,17,
Custer,Superintendent of Public Instruction,Ivan Holmes,DEM,200003,1,1,5,7,
Custer,Superintendent of Public Instruction,Freda Deskin,DEM,200003,2,0,30,32,
Custer,U.S. Senate,Patrick Michael Hayes,DEM,200003,1,2,8,11,
Custer,U.S. Senate,Jim Rogers,DEM,200003,2,1,29,32,
Custer,U.S. Senate,Connie Johnson,DEM,200003,0,4,39,43,
Custer,Governor,Dax Ewbank,REP,200003,0,3,17,20,
Custer,Governor,Chad Moody,REP,200003,1,5,33,39,
Custer,Governor,Mary Fallin,REP,200003,8,7,132,147,
Custer,Superintendent of Public Instruction,Brian Kelly,REP,200003,0,3,28,31,
Custer,Superintendent of Public Instruction,Janet Costello Barresi,REP,200003,1,1,22,24,
Custer,Superintendent of Public Instruction,Joy Hofmeister,REP,200003,7,11,128,146,
Custer,Insurance Commissioner,Bill Viner,REP,200003,1,6,27,34,
Custer,Insurance Commissioner,John Doak,REP,200003,7,8,141,156,
Custer,Corporation Commissioner,Todd Hiett,REP,200003,4,7,98,109,
Custer,Corporation Commissioner,Cliff Branan,REP,200003,3,6,74,83,
Custer,U.S. Senate,Evelyn Rogers,REP,200003,0,0,4,4,
Custer,U.S. Senate,Rob Moye,REP,200003,0,2,1,3,
Custer,U.S. Senate,D. Jean Mcbride-Samuels,REP,200003,0,0,1,1,
Custer,U.S. Senate,Jim Inhofe,REP,200003,9,12,172,193,
Custer,U.S. Senate,Erick Paul Wyatt,REP,200003,0,0,5,5,
Custer,U.S. Senate,Andy Craig,REP,200003,0,0,1,1,
Custer,U.S. Senate,T. Shannon,REP,200003,4,4,55,63,
Custer,U.S. Senate,Randy Brogdon,REP,200003,0,2,5,7,
Custer,U.S. Senate,Eric Mccray,REP,200003,0,0,0,0,
Custer,U.S. Senate,Kevin Crow,REP,200003,0,0,5,5,
Custer,U.S. Senate,James Lankford,REP,200003,5,9,117,131,
Custer,U.S. Senate,Jason Weger,REP,200003,0,0,0,0,
Custer,U.S. House,Timothy Ray Murray,REP,200003,0,0,7,7,03
Custer,U.S. House,Robert Hubbard,REP,200003,3,2,9,14,03
Custer,U.S. House,Frank Lucas,REP,200003,6,12,164,182,03
Custer,Superintendent of Public Instruction,John Cox,DEM,200005,2,3,35,40,
Custer,Superintendent of Public Instruction,Jack Jr.,DEM,200005,1,1,17,19,
Custer,Superintendent of Public Instruction,Ivan Holmes,DEM,200005,0,1,18,19,
Custer,Superintendent of Public Instruction,Freda Deskin,DEM,200005,3,5,32,40,
Custer,U.S. Senate,Patrick Michael Hayes,DEM,200005,1,1,22,24,
Custer,U.S. Senate,Jim Rogers,DEM,200005,3,5,38,46,
Custer,U.S. Senate,Connie Johnson,DEM,200005,2,3,41,46,
Custer,Governor,Dax Ewbank,REP,200005,1,1,11,13,
Custer,Governor,Chad Moody,REP,200005,0,8,33,41,
Custer,Governor,Mary Fallin,REP,200005,7,13,119,139,
Custer,Superintendent of Public Instruction,Brian Kelly,REP,200005,5,5,22,32,
Custer,Superintendent of Public Instruction,Janet Costello Barresi,REP,200005,1,0,31,32,
Custer,Superintendent of Public Instruction,Joy Hofmeister,REP,200005,2,17,112,131,
Custer,Insurance Commissioner,Bill Viner,REP,200005,1,7,30,38,
Custer,Insurance Commissioner,John Doak,REP,200005,7,15,126,148,
Custer,Corporation Commissioner,Todd Hiett,REP,200005,7,11,88,106,
Custer,Corporation Commissioner,Cliff Branan,REP,200005,2,11,71,84,
Custer,U.S. Senate,Evelyn Rogers,REP,200005,0,2,4,6,
Custer,U.S. Senate,Rob Moye,REP,200005,0,0,3,3,
Custer,U.S. Senate,D. Jean Mcbride-Samuels,REP,200005,2,0,0,2,
Custer,U.S. Senate,Jim Inhofe,REP,200005,7,19,152,178,
Custer,U.S. Senate,Erick Paul Wyatt,REP,200005,0,1,5,6,
Custer,U.S. Senate,Andy Craig,REP,200005,1,1,1,3,
Custer,U.S. Senate,T. Shannon,REP,200005,1,5,47,53,
Custer,U.S. Senate,Randy Brogdon,REP,200005,0,1,6,7,
Custer,U.S. Senate,Eric Mccray,REP,200005,0,1,0,1,
Custer,U.S. Senate,Kevin Crow,REP,200005,1,0,1,2,
Custer,U.S. Senate,James Lankford,REP,200005,6,14,109,129,
Custer,U.S. Senate,Jason Weger,REP,200005,0,0,0,0,
Custer,U.S. House,Timothy Ray Murray,REP,200005,1,1,2,4,03
Custer,U.S. House,Robert Hubbard,REP,200005,0,4,10,14,03
Custer,U.S. House,Frank Lucas,REP,200005,7,17,152,176,03
Custer,Superintendent of Public Instruction,John Cox,DEM,200007,1,0,17,18,
Custer,Superintendent of Public Instruction,Jack Jr.,DEM,200007,1,0,2,3,
Custer,Superintendent of Public Instruction,Ivan Holmes,DEM,200007,1,0,6,7,
Custer,Superintendent of Public Instruction,Freda Deskin,DEM,200007,1,2,16,19,
Custer,U.S. Senate,Patrick Michael Hayes,DEM,200007,1,0,8,9,
Custer,U.S. Senate,Jim Rogers,DEM,200007,1,2,18,21,
Custer,U.S. Senate,Connie Johnson,DEM,200007,2,0,14,16,
Custer,Governor,Dax Ewbank,REP,200007,0,0,4,4,
Custer,Governor,Chad Moody,REP,200007,0,0,16,16,
Custer,Governor,Mary Fallin,REP,200007,4,8,67,79,
Custer,Superintendent of Public Instruction,Brian Kelly,REP,200007,2,3,21,26,
Custer,Superintendent of Public Instruction,Janet Costello Barresi,REP,200007,0,0,12,12,
Custer,Superintendent of Public Instruction,Joy Hofmeister,REP,200007,2,5,55,62,
Custer,Insurance Commissioner,Bill Viner,REP,200007,0,1,20,21,
Custer,Insurance Commissioner,John Doak,REP,200007,4,7,63,74,
Custer,Corporation Commissioner,Todd Hiett,REP,200007,4,4,47,55,
Custer,Corporation Commissioner,Cliff Branan,REP,200007,0,3,38,41,
Custer,U.S. Senate,Evelyn Rogers,REP,200007,0,0,2,2,
Custer,U.S. Senate,Rob Moye,REP,200007,0,0,1,1,
Custer,U.S. Senate,D. Jean Mcbride-Samuels,REP,200007,0,0,1,1,
Custer,U.S. Senate,Jim Inhofe,REP,200007,4,8,76,88,
Custer,U.S. Senate,Erick Paul Wyatt,REP,200007,0,0,8,8,
Custer,U.S. Senate,Andy Craig,REP,200007,0,0,1,1,
Custer,U.S. Senate,T. Shannon,REP,200007,1,2,23,26,
Custer,U.S. Senate,Randy Brogdon,REP,200007,0,0,0,0,
Custer,U.S. Senate,Eric Mccray,REP,200007,0,0,0,0,
Custer,U.S. Senate,Kevin Crow,REP,200007,0,0,0,0,
Custer,U.S. Senate,James Lankford,REP,200007,3,6,60,69,
Custer,U.S. Senate,Jason Weger,REP,200007,0,0,2,2,
Custer,U.S. House,Timothy Ray Murray,REP,200007,0,0,4,4,03
Custer,U.S. House,Robert Hubbard,REP,200007,1,0,6,7,03
Custer,U.S. House,Frank Lucas,REP,200007,3,8,78,89,03
Custer,Superintendent of Public Instruction,John Cox,DEM,200012,0,2,41,43,
Custer,Superintendent of Public Instruction,Jack Jr.,DEM,200012,0,1,10,11,
Custer,Superintendent of Public Instruction,Ivan Holmes,DEM,200012,0,1,10,11,
Custer,Superintendent of Public Instruction,Freda Deskin,DEM,200012,0,0,23,23,
Custer,U.S. Senate,Patrick Michael Hayes,DEM,200012,0,1,22,23,
Custer,U.S. Senate,Jim Rogers,DEM,200012,0,0,37,37,
Custer,U.S. Senate,Connie Johnson,DEM,200012,0,3,25,28,
Custer,Governor,Dax Ewbank,REP,200012,0,4,12,16,
Custer,Governor,Chad Moody,REP,200012,2,0,16,18,
Custer,Governor,Mary Fallin,REP,200012,3,18,107,128,
Custer,Superintendent of Public Instruction,Brian Kelly,REP,200012,0,5,31,36,
Custer,Superintendent of Public Instruction,Janet Costello Barresi,REP,200012,0,2,11,13,
Custer,Superintendent of Public Instruction,Joy Hofmeister,REP,200012,5,16,90,111,
Custer,Insurance Commissioner,Bill Viner,REP,200012,0,1,27,28,
Custer,Insurance Commissioner,John Doak,REP,200012,4,21,101,126,
Custer,Corporation Commissioner,Todd Hiett,REP,200012,3,8,60,71,
Custer,Corporation Commissioner,Cliff Branan,REP,200012,1,14,69,84,
Custer,U.S. Senate,Evelyn Rogers,REP,200012,0,0,2,2,
Custer,U.S. Senate,Rob Moye,REP,200012,0,0,2,2,
Custer,U.S. Senate,D. Jean Mcbride-Samuels,REP,200012,0,0,0,0,
Custer,U.S. Senate,Jim Inhofe,REP,200012,4,22,122,148,
Custer,U.S. Senate,Erick Paul Wyatt,REP,200012,0,1,7,8,
Custer,U.S. Senate,Andy Craig,REP,200012,0,0,1,1,
Custer,U.S. Senate,T. Shannon,REP,200012,3,7,46,56,
Custer,U.S. Senate,Randy Brogdon,REP,200012,1,0,9,10,
Custer,U.S. Senate,Eric Mccray,REP,200012,0,0,1,1,
Custer,U.S. Senate,Kevin Crow,REP,200012,0,2,2,4,
Custer,U.S. Senate,James Lankford,REP,200012,1,14,70,85,
Custer,U.S. Senate,Jason Weger,REP,200012,0,0,1,1,
Custer,U.S. House,Timothy Ray Murray,REP,200012,0,0,2,2,03
Custer,U.S. House,Robert Hubbard,REP,200012,1,2,11,14,03
Custer,U.S. House,Frank Lucas,REP,200012,3,21,121,145,03
Custer,State Senate,Darcy Jech,REP,200012,1,17,69,87,26
Custer,State Senate,Dan Gambill,REP,200012,3,5,62,70,26
Custer,Superintendent of Public Instruction,John Cox,DEM,200013,0,0,23,23,
Custer,Superintendent of Public Instruction,Jack Jr.,DEM,200013,0,0,3,3,
Custer,Superintendent of Public Instruction,Ivan Holmes,DEM,200013,0,0,7,7,
Custer,Superintendent of Public Instruction,Freda Deskin,DEM,200013,0,1,11,12,
Custer,U.S. Senate,Patrick Michael Hayes,DEM,200013,0,0,13,13,
Custer,U.S. Senate,Jim Rogers,DEM,200013,0,1,15,16,
Custer,U.S. Senate,Connie Johnson,DEM,200013,0,0,14,14,
Custer,Governor,Dax Ewbank,REP,200013,0,2,11,13,
Custer,Governor,Chad Moody,REP,200013,0,0,8,8,
Custer,Governor,Mary Fallin,REP,200013,0,3,49,52,
Custer,Superintendent of Public Instruction,Brian Kelly,REP,200013,0,1,17,18,
Custer,Superintendent of Public Instruction,Janet Costello Barresi,REP,200013,0,1,7,8,
Custer,Superintendent of Public Instruction,Joy Hofmeister,REP,200013,0,3,42,45,
Custer,Insurance Commissioner,Bill Viner,REP,200013,0,0,17,17,
Custer,Insurance Commissioner,John Doak,REP,200013,0,5,47,52,
Custer,Corporation Commissioner,Todd Hiett,REP,200013,0,3,39,42,
Custer,Corporation Commissioner,Cliff Branan,REP,200013,0,2,27,29,
Custer,U.S. Senate,Evelyn Rogers,REP,200013,0,0,5,5,
Custer,U.S. Senate,Rob Moye,REP,200013,0,0,1,1,
Custer,U.S. Senate,D. Jean Mcbride-Samuels,REP,200013,0,0,1,1,
Custer,U.S. Senate,Jim Inhofe,REP,200013,0,5,55,60,
Custer,U.S. Senate,Erick Paul Wyatt,REP,200013,0,0,5,5,
Custer,U.S. Senate,Andy Craig,REP,200013,0,1,2,3,
Custer,U.S. Senate,T. Shannon,REP,200013,0,2,20,22,
Custer,U.S. Senate,Randy Brogdon,REP,200013,0,0,4,4,
Custer,U.S. Senate,Eric Mccray,REP,200013,0,0,2,2,
Custer,U.S. Senate,Kevin Crow,REP,200013,0,0,1,1,
Custer,U.S. Senate,James Lankford,REP,200013,0,2,37,39,
Custer,U.S. Senate,Jason Weger,REP,200013,0,0,2,2,
Custer,U.S. House,Timothy Ray Murray,REP,200013,0,0,4,4,03
Custer,U.S. House,Robert Hubbard,REP,200013,0,2,3,5,03
Custer,U.S. House,Frank Lucas,REP,200013,0,3,60,63,03
Custer,State Senate,Darcy Jech,REP,200013,0,1,30,31,26
Custer,State Senate,Dan Gambill,REP,200013,0,4,36,40,26
Custer,Superintendent of Public Instruction,John Cox,DEM,200018,0,0,38,38,
Custer,Superintendent of Public Instruction,Jack Jr.,DEM,200018,0,0,13,13,
Custer,Superintendent of Public Instruction,Ivan Holmes,DEM,200018,0,1,11,12,
Custer,Superintendent of Public Instruction,Freda Deskin,DEM,200018,0,1,39,40,
Custer,U.S. Senate,Patrick Michael Hayes,DEM,200018,0,1,9,10,
Custer,U.S. Senate,Jim Rogers,DEM,200018,0,0,48,48,
Custer,U.S. Senate,Connie Johnson,DEM,200018,0,1,43,44,
Custer,Governor,Dax Ewbank,REP,200018,1,3,27,31,
Custer,Governor,Chad Moody,REP,200018,0,1,33,34,
Custer,Governor,Mary Fallin,REP,200018,10,8,184,202,
Custer,Superintendent of Public Instruction,Brian Kelly,REP,200018,0,2,39,41,
Custer,Superintendent of Public Instruction,Janet Costello Barresi,REP,200018,3,5,22,30,
Custer,Superintendent of Public Instruction,Joy Hofmeister,REP,200018,8,6,180,194,
Custer,Insurance Commissioner,Bill Viner,REP,200018,1,1,48,50,
Custer,Insurance Commissioner,John Doak,REP,200018,10,10,185,205,
Custer,Corporation Commissioner,Todd Hiett,REP,200018,9,6,132,147,
Custer,Corporation Commissioner,Cliff Branan,REP,200018,2,6,98,106,
Custer,U.S. Senate,Evelyn Rogers,REP,200018,0,0,8,8,
Custer,U.S. Senate,Rob Moye,REP,200018,0,0,1,1,
Custer,U.S. Senate,D. Jean Mcbride-Samuels,REP,200018,0,2,4,6,
Custer,U.S. Senate,Jim Inhofe,REP,200018,11,9,226,246,
Custer,U.S. Senate,Erick Paul Wyatt,REP,200018,0,1,6,7,
Custer,U.S. Senate,Andy Craig,REP,200018,0,1,0,1,
Custer,U.S. Senate,T. Shannon,REP,200018,3,3,69,75,
Custer,U.S. Senate,Randy Brogdon,REP,200018,5,3,18,26,
Custer,U.S. Senate,Eric Mccray,REP,200018,0,0,0,0,
Custer,U.S. Senate,Kevin Crow,REP,200018,0,0,1,1,
Custer,U.S. Senate,James Lankford,REP,200018,3,6,156,165,
Custer,U.S. Senate,Jason Weger,REP,200018,0,0,1,1,
Custer,U.S. House,Timothy Ray Murray,REP,200018,0,1,10,11,03
Custer,U.S. House,Robert Hubbard,REP,200018,2,3,20,25,03
Custer,U.S. House,Frank Lucas,REP,200018,9,8,209,226,03
Custer,Superintendent of Public Instruction,John Cox,DEM,200019,1,3,30,34,
Custer,Superintendent of Public Instruction,Jack Jr.,DEM,200019,3,0,10,13,
Custer,Superintendent of Public Instruction,Ivan Holmes,DEM,200019,0,0,11,11,
Custer,Superintendent of Public Instruction,Freda Deskin,DEM,200019,4,1,41,46,
Custer,U.S. Senate,Patrick Michael Hayes,DEM,200019,1,1,19,21,
Custer,U.S. Senate,Jim Rogers,DEM,200019,4,1,26,31,
Custer,U.S. Senate,Connie Johnson,DEM,200019,3,1,47,51,
Custer,Governor,Dax Ewbank,REP,200019,0,1,29,30,
Custer,Governor,Chad Moody,REP,200019,2,0,26,28,
Custer,Governor,Mary Fallin,REP,200019,17,9,185,211,
Custer,Superintendent of Public Instruction,Brian Kelly,REP,200019,1,0,50,51,
Custer,Superintendent of Public Instruction,Janet Costello Barresi,REP,200019,6,3,29,38,
Custer,Superintendent of Public Instruction,Joy Hofmeister,REP,200019,11,5,156,172,
Custer,Insurance Commissioner,Bill Viner,REP,200019,1,3,51,55,
Custer,Insurance Commissioner,John Doak,REP,200019,18,7,172,197,
Custer,Corporation Commissioner,Todd Hiett,REP,200019,10,6,117,133,
Custer,Corporation Commissioner,Cliff Branan,REP,200019,5,4,102,111,
Custer,U.S. Senate,Evelyn Rogers,REP,200019,0,0,10,10,
Custer,U.S. Senate,Rob Moye,REP,200019,1,0,4,5,
Custer,U.S. Senate,D. Jean Mcbride-Samuels,REP,200019,0,0,0,0,
Custer,U.S. Senate,Jim Inhofe,REP,200019,17,10,219,246,
Custer,U.S. Senate,Erick Paul Wyatt,REP,200019,1,0,5,6,
Custer,U.S. Senate,Andy Craig,REP,200019,2,0,0,2,
Custer,U.S. Senate,T. Shannon,REP,200019,8,2,58,68,
Custer,U.S. Senate,Randy Brogdon,REP,200019,0,1,12,13,
Custer,U.S. Senate,Eric Mccray,REP,200019,0,0,4,4,
Custer,U.S. Senate,Kevin Crow,REP,200019,1,0,1,2,
Custer,U.S. Senate,James Lankford,REP,200019,8,7,165,180,
Custer,U.S. Senate,Jason Weger,REP,200019,0,0,1,1,
Custer,U.S. House,Timothy Ray Murray,REP,200019,0,0,7,7,03
Custer,U.S. House,Robert Hubbard,REP,200019,1,0,19,20,03
Custer,U.S. House,Frank Lucas,REP,200019,17,10,211,238,03
Custer,Superintendent of Public Instruction,John Cox,DEM,200020,0,0,34,34,
Custer,Superintendent of Public Instruction,Jack Jr.,DEM,200020,0,0,20,20,
Custer,Superintendent of Public Instruction,Ivan Holmes,DEM,200020,0,0,10,10,
Custer,Superintendent of Public Instruction,Freda Deskin,DEM,200020,0,0,46,46,
Custer,U.S. Senate,Patrick Michael Hayes,DEM,200020,0,0,22,22,
Custer,U.S. Senate,Jim Rogers,DEM,200020,0,0,46,46,
Custer,U.S. Senate,Connie Johnson,DEM,200020,0,0,41,41,
Custer,Governor,Dax Ewbank,REP,200020,1,1,32,34,
Custer,Governor,Chad Moody,REP,200020,0,0,40,40,
Custer,Governor,Mary Fallin,REP,200020,3,17,176,196,
Custer,Superintendent of Public Instruction,Brian Kelly,REP,200020,1,2,51,54,
Custer,Superintendent of Public Instruction,Janet Costello Barresi,REP,200020,1,0,32,33,
Custer,Superintendent of Public Instruction,Joy Hofmeister,REP,200020,2,16,164,182,
Custer,Insurance Commissioner,Bill Viner,REP,200020,1,6,57,64,
Custer,Insurance Commissioner,John Doak,REP,200020,3,12,169,184,
Custer,Corporation Commissioner,Todd Hiett,REP,200020,3,13,127,143,
Custer,Corporation Commissioner,Cliff Branan,REP,200020,1,5,103,109,
Custer,U.S. Senate,Evelyn Rogers,REP,200020,0,1,11,12,
Custer,U.S. Senate,Rob Moye,REP,200020,0,0,4,4,
Custer,U.S. Senate,D. Jean Mcbride-Samuels,REP,200020,0,0,4,4,
Custer,U.S. Senate,Jim Inhofe,REP,200020,4,17,219,240,
Custer,U.S. Senate,Erick Paul Wyatt,REP,200020,0,0,8,8,
Custer,U.S. Senate,Andy Craig,REP,200020,0,0,0,0,
Custer,U.S. Senate,T. Shannon,REP,200020,1,7,81,89,
Custer,U.S. Senate,Randy Brogdon,REP,200020,1,0,20,21,
Custer,U.S. Senate,Eric Mccray,REP,200020,0,0,2,2,
Custer,U.S. Senate,Kevin Crow,REP,200020,0,0,2,2,
Custer,U.S. Senate,James Lankford,REP,200020,2,11,141,154,
Custer,U.S. Senate,Jason Weger,REP,200020,0,0,1,1,
Custer,U.S. House,Timothy Ray Murray,REP,200020,0,0,10,10,03
Custer,U.S. House,Robert Hubbard,REP,200020,1,0,17,18,03
Custer,U.S. House,Frank Lucas,REP,200020,3,18,218,239,03
Custer,Superintendent of Public Instruction,John Cox,DEM,200021,1,2,35,38,
Custer,Superintendent of Public Instruction,Jack Jr.,DEM,200021,2,0,11,13,
Custer,Superintendent of Public Instruction,Ivan Holmes,DEM,200021,1,0,8,9,
Custer,Superintendent of Public Instruction,Freda Deskin,DEM,200021,1,0,28,29,
Custer,U.S. Senate,Patrick Michael Hayes,DEM,200021,1,0,15,16,
Custer,U.S. Senate,Jim Rogers,DEM,200021,1,1,23,25,
Custer,U.S. Senate,Connie Johnson,DEM,200021,2,1,44,47,
Custer,Governor,Dax Ewbank,REP,200021,0,1,24,25,
Custer,Governor,Chad Moody,REP,200021,0,2,30,32,
Custer,Governor,Mary Fallin,REP,200021,1,0,116,117,
Custer,Superintendent of Public Instruction,Brian Kelly,REP,200021,1,0,28,29,
Custer,Superintendent of Public Instruction,Janet Costello Barresi,REP,200021,0,0,21,21,
Custer,Superintendent of Public Instruction,Joy Hofmeister,REP,200021,0,3,123,126,
Custer,Insurance Commissioner,Bill Viner,REP,200021,0,0,27,27,
Custer,Insurance Commissioner,John Doak,REP,200021,1,3,128,132,
Custer,Corporation Commissioner,Todd Hiett,REP,200021,0,1,95,96,
Custer,Corporation Commissioner,Cliff Branan,REP,200021,1,2,64,67,
Custer,U.S. Senate,Evelyn Rogers,REP,200021,0,1,4,5,
Custer,U.S. Senate,Rob Moye,REP,200021,0,0,2,2,
Custer,U.S. Senate,D. Jean Mcbride-Samuels,REP,200021,0,0,4,4,
Custer,U.S. Senate,Jim Inhofe,REP,200021,1,2,148,151,
Custer,U.S. Senate,Erick Paul Wyatt,REP,200021,0,0,8,8,
Custer,U.S. Senate,Andy Craig,REP,200021,0,0,1,1,
Custer,U.S. Senate,T. Shannon,REP,200021,1,1,59,61,
Custer,U.S. Senate,Randy Brogdon,REP,200021,0,0,9,9,
Custer,U.S. Senate,Eric Mccray,REP,200021,0,0,1,1,
Custer,U.S. Senate,Kevin Crow,REP,200021,0,0,0,0,
Custer,U.S. Senate,James Lankford,REP,200021,0,1,98,99,
Custer,U.S. Senate,Jason Weger,REP,200021,0,1,0,1,
Custer,U.S. House,Timothy Ray Murray,REP,200021,0,1,6,7,03
Custer,U.S. House,Robert Hubbard,REP,200021,0,1,17,18,03
Custer,U.S. House,Frank Lucas,REP,200021,1,1,148,150,03
Custer,Superintendent of Public Instruction,John Cox,DEM,200022,0,0,7,7,
Custer,Superintendent of Public Instruction,Jack Jr.,DEM,200022,0,0,2,2,
Custer,Superintendent of Public Instruction,Ivan Holmes,DEM,200022,0,0,0,0,
Custer,Superintendent of Public Instruction,Freda Deskin,DEM,200022,0,0,7,7,
Custer,U.S. Senate,Patrick Michael Hayes,DEM,200022,0,0,5,5,
Custer,U.S. Senate,Jim Rogers,DEM,200022,0,0,2,2,
Custer,U.S. Senate,Connie Johnson,DEM,200022,0,0,7,7,
Custer,Governor,Dax Ewbank,REP,200022,0,0,2,2,
Custer,Governor,Chad Moody,REP,200022,0,0,3,3,
Custer,Governor,Mary Fallin,REP,200022,1,4,39,44,
Custer,Superintendent of Public Instruction,Brian Kelly,REP,200022,0,0,8,8,
Custer,Superintendent of Public Instruction,Janet Costello Barresi,REP,200022,1,0,10,11,
Custer,Superintendent of Public Instruction,Joy Hofmeister,REP,200022,0,4,26,30,
Custer,Insurance Commissioner,Bill Viner,REP,200022,1,1,9,11,
Custer,Insurance Commissioner,John Doak,REP,200022,0,3,33,36,
Custer,Corporation Commissioner,Todd Hiett,REP,200022,1,3,23,27,
Custer,Corporation Commissioner,Cliff Branan,REP,200022,0,1,20,21,
Custer,U.S. Senate,Evelyn Rogers,REP,200022,0,0,0,0,
Custer,U.S. Senate,Rob Moye,REP,200022,0,0,3,3,
Custer,U.S. Senate,D. Jean Mcbride-Samuels,REP,200022,0,0,0,0,
Custer,U.S. Senate,Jim Inhofe,REP,200022,1,4,41,46,
Custer,U.S. Senate,Erick Paul Wyatt,REP,200022,0,0,1,1,
Custer,U.S. Senate,Andy Craig,REP,200022,0,0,0,0,
Custer,U.S. Senate,T. Shannon,REP,200022,0,4,17,21,
Custer,U.S. Senate,Randy Brogdon,REP,200022,0,0,0,0,
Custer,U.S. Senate,Eric Mccray,REP,200022,0,0,0,0,
Custer,U.S. Senate,Kevin Crow,REP,200022,0,0,0,0,
Custer,U.S. Senate,James Lankford,REP,200022,1,0,27,28,
Custer,U.S. Senate,Jason Weger,REP,200022,0,0,0,0,
Custer,U.S. House,Timothy Ray Murray,REP,200022,0,0,4,4,03
Custer,U.S. House,Robert Hubbard,REP,200022,0,0,3,3,03
Custer,U.S. House,Frank Lucas,REP,200022,1,4,38,43,03
Custer,State Senate,Darcy Jech,REP,200022,1,2,26,29,26
Custer,State Senate,Dan Gambill,REP,200022,0,2,14,16,26
Custer,Superintendent of Public Instruction,John Cox,DEM,200023,0,2,17,19,
Custer,Superintendent of Public Instruction,Jack Jr.,DEM,200023,0,0,7,7,
Custer,Superintendent of Public Instruction,Ivan Holmes,DEM,200023,0,0,5,5,
Custer,Superintendent of Public Instruction,Freda Deskin,DEM,200023,0,0,36,36,
Custer,U.S. Senate,Patrick Michael Hayes,DEM,200023,0,1,6,7,
Custer,U.S. Senate,Jim Rogers,DEM,200023,0,0,24,24,
Custer,U.S. Senate,Connie Johnson,DEM,200023,0,0,30,30,
Custer,Governor,Dax Ewbank,REP,200023,5,1,20,26,
Custer,Governor,Chad Moody,REP,200023,0,2,21,23,
Custer,Governor,Mary Fallin,REP,200023,6,7,118,131,
Custer,Superintendent of Public Instruction,Brian Kelly,REP,200023,4,2,40,46,
Custer,Superintendent of Public Instruction,Janet Costello Barresi,REP,200023,4,2,16,22,
Custer,Superintendent of Public Instruction,Joy Hofmeister,REP,200023,3,6,98,107,
Custer,Insurance Commissioner,Bill Viner,REP,200023,3,2,32,37,
Custer,Insurance Commissioner,John Doak,REP,200023,8,8,113,129,
Custer,Corporation Commissioner,Todd Hiett,REP,200023,7,3,81,91,
Custer,Corporation Commissioner,Cliff Branan,REP,200023,4,7,69,80,
Custer,U.S. Senate,Evelyn Rogers,REP,200023,0,1,3,4,
Custer,U.S. Senate,Rob Moye,REP,200023,0,0,4,4,
Custer,U.S. Senate,D. Jean Mcbride-Samuels,REP,200023,0,0,1,1,
Custer,U.S. Senate,Jim Inhofe,REP,200023,11,8,139,158,
Custer,U.S. Senate,Erick Paul Wyatt,REP,200023,0,1,12,13,
Custer,U.S. Senate,Andy Craig,REP,200023,0,0,3,3,
Custer,U.S. Senate,T. Shannon,REP,200023,1,0,64,65,
Custer,U.S. Senate,Randy Brogdon,REP,200023,0,1,4,5,
Custer,U.S. Senate,Eric Mccray,REP,200023,0,0,1,1,
Custer,U.S. Senate,Kevin Crow,REP,200023,1,0,2,3,
Custer,U.S. Senate,James Lankford,REP,200023,9,9,85,103,
Custer,U.S. Senate,Jason Weger,REP,200023,0,0,1,1,
Custer,U.S. House,Timothy Ray Murray,REP,200023,1,0,3,4,03
Custer,U.S. House,Robert Hubbard,REP,200023,1,2,17,20,03
Custer,U.S. House,Frank Lucas,REP,200023,9,8,139,156,03
Custer,State Senate,Darcy Jech,REP,200023,3,6,94,103,26
Custer,State Senate,Dan Gambill,REP,200023,8,4,61,73,26
Custer,Superintendent of Public Instruction,John Cox,DEM,200026,2,0,35,37,
Custer,Superintendent of Public Instruction,Jack Jr.,DEM,200026,0,0,8,8,
Custer,Superintendent of Public Instruction,Ivan Holmes,DEM,200026,0,0,9,9,
Custer,Superintendent of Public Instruction,Freda Deskin,DEM,200026,0,2,12,14,
Custer,U.S. Senate,Patrick Michael Hayes,DEM,200026,1,0,10,11,
Custer,U.S. Senate,Jim Rogers,DEM,200026,0,1,36,37,
Custer,U.S. Senate,Connie Johnson,DEM,200026,0,1,15,16,
Custer,Governor,Dax Ewbank,REP,200026,0,0,8,8,
Custer,Governor,Chad Moody,REP,200026,0,0,14,14,
Custer,Governor,Mary Fallin,REP,200026,3,3,69,75,
Custer,Superintendent of Public Instruction,Brian Kelly,REP,200026,1,0,20,21,
Custer,Superintendent of Public Instruction,Janet Costello Barresi,REP,200026,0,0,12,12,
Custer,Superintendent of Public Instruction,Joy Hofmeister,REP,200026,2,3,60,65,
Custer,Insurance Commissioner,Bill Viner,REP,200026,1,0,19,20,
Custer,Insurance Commissioner,John Doak,REP,200026,2,3,70,75,
Custer,Corporation Commissioner,Todd Hiett,REP,200026,1,2,54,57,
Custer,Corporation Commissioner,Cliff Branan,REP,200026,2,1,35,38,
Custer,U.S. Senate,Evelyn Rogers,REP,200026,0,0,5,5,
Custer,U.S. Senate,Rob Moye,REP,200026,0,0,1,1,
Custer,U.S. Senate,D. Jean Mcbride-Samuels,REP,200026,0,0,2,2,
Custer,U.S. Senate,Jim Inhofe,REP,200026,3,3,83,89,
Custer,U.S. Senate,Erick Paul Wyatt,REP,200026,0,0,1,1,
Custer,U.S. Senate,Andy Craig,REP,200026,0,0,0,0,
Custer,U.S. Senate,T. Shannon,REP,200026,0,1,32,33,
Custer,U.S. Senate,Randy Brogdon,REP,200026,0,0,6,6,
Custer,U.S. Senate,Eric Mccray,REP,200026,0,0,1,1,
Custer,U.S. Senate,Kevin Crow,REP,200026,0,0,1,1,
Custer,U.S. Senate,James Lankford,REP,200026,3,2,51,56,
Custer,U.S. Senate,Jason Weger,REP,200026,0,0,0,0,
Custer,U.S. House,Timothy Ray Murray,REP,200026,0,0,2,2,03
Custer,U.S. House,Robert Hubbard,REP,200026,1,0,11,12,03
Custer,U.S. House,Frank Lucas,REP,200026,2,3,79,84,03
Custer,State Senate,Darcy Jech,REP,200026,2,2,35,39,26
Custer,State Senate,Dan Gambill,REP,200026,1,1,57,59,26
Delaware,Superintendent of Public Instruction,John Cox,DEM,210001,1,0,27,28,
Delaware,Superintendent of Public Instruction,Jack Jr.,DEM,210001,1,0,11,12,
Delaware,Superintendent of Public Instruction,Ivan Holmes,DEM,210001,1,0,3,4,
Delaware,Superintendent of Public Instruction,Freda Deskin,DEM,210001,0,0,31,31,
Delaware,U.S. Senate,Patrick Michael Hayes,DEM,210001,0,0,14,14,
Delaware,U.S. Senate,Jim Rogers,DEM,210001,3,0,32,35,
Delaware,U.S. Senate,Connie Johnson,DEM,210001,0,0,25,25,
Delaware,U.S. House,Earl Everett,DEM,210001,1,0,39,40,02
Delaware,U.S. House,Joshua Harris-Till,DEM,210001,1,0,27,28,02
Delaware,Governor,Dax Ewbank,REP,210001,0,0,15,15,
Delaware,Governor,Chad Moody,REP,210001,0,0,23,23,
Delaware,Governor,Mary Fallin,REP,210001,3,1,153,157,
Delaware,Superintendent of Public Instruction,Brian Kelly,REP,210001,0,0,37,37,
Delaware,Superintendent of Public Instruction,Janet Costello Barresi,REP,210001,1,0,32,33,
Delaware,Superintendent of Public Instruction,Joy Hofmeister,REP,210001,2,1,116,119,
Delaware,Insurance Commissioner,Bill Viner,REP,210001,1,0,31,32,
Delaware,Insurance Commissioner,John Doak,REP,210001,2,1,145,148,
Delaware,Corporation Commissioner,Todd Hiett,REP,210001,2,0,83,85,
Delaware,Corporation Commissioner,Cliff Branan,REP,210001,0,1,94,95,
Delaware,U.S. Senate,Evelyn Rogers,REP,210001,0,0,11,11,
Delaware,U.S. Senate,Rob Moye,REP,210001,0,0,3,3,
Delaware,U.S. Senate,D. Jean Mcbride-Samuels,REP,210001,0,0,6,6,
Delaware,U.S. Senate,Jim Inhofe,REP,210001,3,1,160,164,
Delaware,U.S. Senate,Erick Paul Wyatt,REP,210001,0,0,8,8,
Delaware,U.S. Senate,Andy Craig,REP,210001,0,0,0,0,
Delaware,U.S. Senate,T. Shannon,REP,210001,1,0,86,87,
Delaware,U.S. Senate,Randy Brogdon,REP,210001,0,0,8,8,
Delaware,U.S. Senate,Eric Mccray,REP,210001,0,0,1,1,
Delaware,U.S. Senate,Kevin Crow,REP,210001,0,0,2,2,
Delaware,U.S. Senate,James Lankford,REP,210001,2,1,93,96,
Delaware,U.S. Senate,Jason Weger,REP,210001,0,0,1,1,
Delaware,U.S. House,Darrel Robertson,REP,210001,0,0,33,33,02
Delaware,U.S. House,Markwayne Mullin,REP,210001,3,1,152,156,02
Delaware,Superintendent of Public Instruction,John Cox,DEM,210002,1,0,34,35,
Delaware,Superintendent of Public Instruction,Jack Jr.,DEM,210002,0,0,7,7,
Delaware,Superintendent of Public Instruction,Ivan Holmes,DEM,210002,0,0,5,5,
Delaware,Superintendent of Public Instruction,Freda Deskin,DEM,210002,0,0,28,28,
Delaware,U.S. Senate,Patrick Michael Hayes,DEM,210002,0,0,16,16,
Delaware,U.S. Senate,Jim Rogers,DEM,210002,0,0,23,23,
Delaware,U.S. Senate,Connie Johnson,DEM,210002,1,0,34,35,
Delaware,U.S. House,Earl Everett,DEM,210002,0,0,48,48,02
Delaware,U.S. House,Joshua Harris-Till,DEM,210002,1,0,17,18,02
Delaware,Governor,Dax Ewbank,REP,210002,0,0,9,9,
Delaware,Governor,Chad Moody,REP,210002,0,0,9,9,
Delaware,Governor,Mary Fallin,REP,210002,0,0,60,60,
Delaware,Superintendent of Public Instruction,Brian Kelly,REP,210002,0,0,15,15,
Delaware,Superintendent of Public Instruction,Janet Costello Barresi,REP,210002,0,0,22,22,
Delaware,Superintendent of Public Instruction,Joy Hofmeister,REP,210002,0,0,39,39,
Delaware,Insurance Commissioner,Bill Viner,REP,210002,0,0,26,26,
Delaware,Insurance Commissioner,John Doak,REP,210002,0,0,48,48,
Delaware,Corporation Commissioner,Todd Hiett,REP,210002,0,0,43,43,
Delaware,Corporation Commissioner,Cliff Branan,REP,210002,0,0,30,30,
Delaware,U.S. Senate,Evelyn Rogers,REP,210002,0,0,8,8,
Delaware,U.S. Senate,Rob Moye,REP,210002,0,0,2,2,
Delaware,U.S. Senate,D. Jean Mcbride-Samuels,REP,210002,0,0,4,4,
Delaware,U.S. Senate,Jim Inhofe,REP,210002,0,0,56,56,
Delaware,U.S. Senate,Erick Paul Wyatt,REP,210002,0,0,7,7,
Delaware,U.S. Senate,Andy Craig,REP,210002,0,0,2,2,
Delaware,U.S. Senate,T. Shannon,REP,210002,0,0,35,35,
Delaware,U.S. Senate,Randy Brogdon,REP,210002,0,0,8,8,
Delaware,U.S. Senate,Eric Mccray,REP,210002,0,0,0,0,
Delaware,U.S. Senate,Kevin Crow,REP,210002,0,0,1,1,
Delaware,U.S. Senate,James Lankford,REP,210002,0,0,31,31,
Delaware,U.S. Senate,Jason Weger,REP,210002,0,0,0,0,
Delaware,U.S. House,Darrel Robertson,REP,210002,0,0,14,14,02
Delaware,U.S. House,Markwayne Mullin,REP,210002,0,0,62,62,02
Delaware,Superintendent of Public Instruction,John Cox,DEM,210003,1,0,37,38,
Delaware,Superintendent of Public Instruction,Jack Jr.,DEM,210003,0,0,6,6,
Delaware,Superintendent of Public Instruction,Ivan Holmes,DEM,210003,0,0,2,2,
Delaware,Superintendent of Public Instruction,Freda Deskin,DEM,210003,0,0,24,24,
Delaware,U.S. Senate,Patrick Michael Hayes,DEM,210003,1,0,12,13,
Delaware,U.S. Senate,Jim Rogers,DEM,210003,0,0,20,20,
Delaware,U.S. Senate,Connie Johnson,DEM,210003,0,0,30,30,
Delaware,U.S. House,Earl Everett,DEM,210003,1,0,38,39,02
Delaware,U.S. House,Joshua Harris-Till,DEM,210003,0,0,23,23,02
Delaware,Governor,Dax Ewbank,REP,210003,1,0,11,12,
Delaware,Governor,Chad Moody,REP,210003,0,0,10,10,
Delaware,Governor,Mary Fallin,REP,210003,7,0,111,118,
Delaware,Superintendent of Public Instruction,Brian Kelly,REP,210003,3,0,29,32,
Delaware,Superintendent of Public Instruction,Janet Costello Barresi,REP,210003,1,0,36,37,
Delaware,Superintendent of Public Instruction,Joy Hofmeister,REP,210003,3,0,68,71,
Delaware,Insurance Commissioner,Bill Viner,REP,210003,1,0,25,26,
Delaware,Insurance Commissioner,John Doak,REP,210003,5,0,99,104,
Delaware,Corporation Commissioner,Todd Hiett,REP,210003,5,0,66,71,
Delaware,Corporation Commissioner,Cliff Branan,REP,210003,1,0,53,54,
Delaware,U.S. Senate,Evelyn Rogers,REP,210003,0,0,4,4,
Delaware,U.S. Senate,Rob Moye,REP,210003,0,0,4,4,
Delaware,U.S. Senate,D. Jean Mcbride-Samuels,REP,210003,0,0,3,3,
Delaware,U.S. Senate,Jim Inhofe,REP,210003,6,0,115,121,
Delaware,U.S. Senate,Erick Paul Wyatt,REP,210003,2,0,7,9,
Delaware,U.S. Senate,Andy Craig,REP,210003,0,0,0,0,
Delaware,U.S. Senate,T. Shannon,REP,210003,3,0,47,50,
Delaware,U.S. Senate,Randy Brogdon,REP,210003,2,0,4,6,
Delaware,U.S. Senate,Eric Mccray,REP,210003,0,0,1,1,
Delaware,U.S. Senate,Kevin Crow,REP,210003,0,0,2,2,
Delaware,U.S. Senate,James Lankford,REP,210003,3,0,78,81,
Delaware,U.S. Senate,Jason Weger,REP,210003,0,0,1,1,
Delaware,U.S. House,Darrel Robertson,REP,210003,2,0,37,39,02
Delaware,U.S. House,Markwayne Mullin,REP,210003,6,0,95,101,02
Delaware,Superintendent of Public Instruction,John Cox,DEM,210004,0,0,29,29,
Delaware,Superintendent of Public Instruction,Jack Jr.,DEM,210004,0,0,6,6,
Delaware,Superintendent of Public Instruction,Ivan Holmes,DEM,210004,0,0,7,7,
Delaware,Superintendent of Public Instruction,Freda Deskin,DEM,210004,0,0,22,22,
Delaware,U.S. Senate,Patrick Michael Hayes,DEM,210004,0,0,14,14,
Delaware,U.S. Senate,Jim Rogers,DEM,210004,0,0,21,21,
Delaware,U.S. Senate,Connie Johnson,DEM,210004,0,0,25,25,
Delaware,U.S. House,Earl Everett,DEM,210004,0,0,28,28,02
Delaware,U.S. House,Joshua Harris-Till,DEM,210004,0,0,26,26,02
Delaware,State House,Donnie Howe,DEM,210004,0,0,13,13,7
Delaware,State House,Ben Loring,DEM,210004,0,0,50,50,7
Delaware,Governor,Dax Ewbank,REP,210004,0,0,3,3,
Delaware,Governor,Chad Moody,REP,210004,1,0,8,9,
Delaware,Governor,Mary Fallin,REP,210004,1,3,63,67,
Delaware,Superintendent of Public Instruction,Brian Kelly,REP,210004,0,0,16,16,
Delaware,Superintendent of Public Instruction,Janet Costello Barresi,REP,210004,0,0,22,22,
Delaware,Superintendent of Public Instruction,Joy Hofmeister,REP,210004,2,3,36,41,
Delaware,Insurance Commissioner,Bill Viner,REP,210004,1,0,19,20,
Delaware,Insurance Commissioner,John Doak,REP,210004,1,3,52,56,
Delaware,Corporation Commissioner,Todd Hiett,REP,210004,1,3,32,36,
Delaware,Corporation Commissioner,Cliff Branan,REP,210004,1,0,39,40,
Delaware,U.S. Senate,Evelyn Rogers,REP,210004,0,0,8,8,
Delaware,U.S. Senate,Rob Moye,REP,210004,0,0,2,2,
Delaware,U.S. Senate,D. Jean Mcbride-Samuels,REP,210004,0,0,2,2,
Delaware,U.S. Senate,Jim Inhofe,REP,210004,1,1,54,56,
Delaware,U.S. Senate,Erick Paul Wyatt,REP,210004,1,2,8,11,
Delaware,U.S. Senate,Andy Craig,REP,210004,0,0,1,1,
Delaware,U.S. Senate,T. Shannon,REP,210004,2,0,42,44,
Delaware,U.S. Senate,Randy Brogdon,REP,210004,0,2,2,4,
Delaware,U.S. Senate,Eric Mccray,REP,210004,0,0,2,2,
Delaware,U.S. Senate,Kevin Crow,REP,210004,0,0,1,1,
Delaware,U.S. Senate,James Lankford,REP,210004,0,1,24,25,
Delaware,U.S. Senate,Jason Weger,REP,210004,0,0,2,2,
Delaware,U.S. House,Darrel Robertson,REP,210004,1,2,16,19,02
Delaware,U.S. House,Markwayne Mullin,REP,210004,1,1,59,61,02
Delaware,Superintendent of Public Instruction,John Cox,DEM,210005,1,0,38,39,
Delaware,Superintendent of Public Instruction,Jack Jr.,DEM,210005,0,0,1,1,
Delaware,Superintendent of Public Instruction,Ivan Holmes,DEM,210005,0,0,5,5,
Delaware,Superintendent of Public Instruction,Freda Deskin,DEM,210005,0,0,26,26,
Delaware,U.S. Senate,Patrick Michael Hayes,DEM,210005,0,0,14,14,
Delaware,U.S. Senate,Jim Rogers,DEM,210005,0,0,20,20,
Delaware,U.S. Senate,Connie Johnson,DEM,210005,1,0,32,33,
Delaware,U.S. House,Earl Everett,DEM,210005,0,0,34,34,02
Delaware,U.S. House,Joshua Harris-Till,DEM,210005,0,0,28,28,02
Delaware,Governor,Dax Ewbank,REP,210005,3,1,14,18,
Delaware,Governor,Chad Moody,REP,210005,0,1,26,27,
Delaware,Governor,Mary Fallin,REP,210005,1,9,162,172,
Delaware,Superintendent of Public Instruction,Brian Kelly,REP,210005,1,2,35,38,
Delaware,Superintendent of Public Instruction,Janet Costello Barresi,REP,210005,3,2,34,39,
Delaware,Superintendent of Public Instruction,Joy Hofmeister,REP,210005,0,7,129,136,
Delaware,Insurance Commissioner,Bill Viner,REP,210005,1,3,42,46,
Delaware,Insurance Commissioner,John Doak,REP,210005,3,8,139,150,
Delaware,Corporation Commissioner,Todd Hiett,REP,210005,1,5,85,91,
Delaware,Corporation Commissioner,Cliff Branan,REP,210005,3,5,99,107,
Delaware,U.S. Senate,Evelyn Rogers,REP,210005,0,1,19,20,
Delaware,U.S. Senate,Rob Moye,REP,210005,1,0,7,8,
Delaware,U.S. Senate,D. Jean Mcbride-Samuels,REP,210005,0,0,2,2,
Delaware,U.S. Senate,Jim Inhofe,REP,210005,3,9,159,171,
Delaware,U.S. Senate,Erick Paul Wyatt,REP,210005,0,1,14,15,
Delaware,U.S. Senate,Andy Craig,REP,210005,0,2,5,7,
Delaware,U.S. Senate,T. Shannon,REP,210005,1,4,75,80,
Delaware,U.S. Senate,Randy Brogdon,REP,210005,0,0,11,11,
Delaware,U.S. Senate,Eric Mccray,REP,210005,0,0,0,0,
Delaware,U.S. Senate,Kevin Crow,REP,210005,0,0,3,3,
Delaware,U.S. Senate,James Lankford,REP,210005,3,5,107,115,
Delaware,U.S. Senate,Jason Weger,REP,210005,0,0,1,1,
Delaware,U.S. House,Darrel Robertson,REP,210005,0,1,69,70,02
Delaware,U.S. House,Markwayne Mullin,REP,210005,4,10,131,145,02
Delaware,Superintendent of Public Instruction,John Cox,DEM,210006,2,1,24,27,
Delaware,Superintendent of Public Instruction,Jack Jr.,DEM,210006,0,0,3,3,
Delaware,Superintendent of Public Instruction,Ivan Holmes,DEM,210006,0,0,5,5,
Delaware,Superintendent of Public Instruction,Freda Deskin,DEM,210006,0,0,19,19,
Delaware,U.S. Senate,Patrick Michael Hayes,DEM,210006,0,0,13,13,
Delaware,U.S. Senate,Jim Rogers,DEM,210006,0,0,23,23,
Delaware,U.S. Senate,Connie Johnson,DEM,210006,2,1,12,15,
Delaware,U.S. House,Earl Everett,DEM,210006,2,0,26,28,02
Delaware,U.S. House,Joshua Harris-Till,DEM,210006,0,0,21,21,02
Delaware,State House,Donnie Howe,DEM,210006,0,0,9,9,7
Delaware,State House,Ben Loring,DEM,210006,2,1,40,43,7
Delaware,Governor,Dax Ewbank,REP,210006,0,0,0,0,
Delaware,Governor,Chad Moody,REP,210006,0,1,15,16,
Delaware,Governor,Mary Fallin,REP,210006,3,2,100,105,
Delaware,Superintendent of Public Instruction,Brian Kelly,REP,210006,1,0,22,23,
Delaware,Superintendent of Public Instruction,Janet Costello Barresi,REP,210006,1,0,24,25,
Delaware,Superintendent of Public Instruction,Joy Hofmeister,REP,210006,1,3,72,76,
Delaware,Insurance Commissioner,Bill Viner,REP,210006,1,1,25,27,
Delaware,Insurance Commissioner,John Doak,REP,210006,0,1,84,85,
Delaware,Corporation Commissioner,Todd Hiett,REP,210006,1,0,59,60,
Delaware,Corporation Commissioner,Cliff Branan,REP,210006,0,1,49,50,
Delaware,U.S. Senate,Evelyn Rogers,REP,210006,0,0,4,4,
Delaware,U.S. Senate,Rob Moye,REP,210006,0,1,3,4,
Delaware,U.S. Senate,D. Jean Mcbride-Samuels,REP,210006,0,0,1,1,
Delaware,U.S. Senate,Jim Inhofe,REP,210006,2,1,104,107,
Delaware,U.S. Senate,Erick Paul Wyatt,REP,210006,0,0,6,6,
Delaware,U.S. Senate,Andy Craig,REP,210006,0,0,3,3,
Delaware,U.S. Senate,T. Shannon,REP,210006,2,1,49,52,
Delaware,U.S. Senate,Randy Brogdon,REP,210006,0,0,3,3,
Delaware,U.S. Senate,Eric Mccray,REP,210006,0,0,0,0,
Delaware,U.S. Senate,Kevin Crow,REP,210006,0,0,2,2,
Delaware,U.S. Senate,James Lankford,REP,210006,1,2,58,61,
Delaware,U.S. Senate,Jason Weger,REP,210006,0,0,3,3,
Delaware,U.S. House,Darrel Robertson,REP,210006,1,3,55,59,02
Delaware,U.S. House,Markwayne Mullin,REP,210006,2,0,62,64,02
Delaware,Superintendent of Public Instruction,John Cox,DEM,210007,4,3,59,66,
Delaware,Superintendent of Public Instruction,Jack Jr.,DEM,210007,1,0,12,13,
Delaware,Superintendent of Public Instruction,Ivan Holmes,DEM,210007,0,0,4,4,
Delaware,Superintendent of Public Instruction,Freda Deskin,DEM,210007,1,1,54,56,
Delaware,U.S. Senate,Patrick Michael Hayes,DEM,210007,1,0,34,35,
Delaware,U.S. Senate,Jim Rogers,DEM,210007,1,1,40,42,
Delaware,U.S. Senate,Connie Johnson,DEM,210007,4,3,47,54,
Delaware,U.S. House,Earl Everett,DEM,210007,3,1,68,72,02
Delaware,U.S. House,Joshua Harris-Till,DEM,210007,3,1,44,48,02
Delaware,Governor,Dax Ewbank,REP,210007,4,4,31,39,
Delaware,Governor,Chad Moody,REP,210007,1,0,26,27,
Delaware,Governor,Mary Fallin,REP,210007,17,13,290,320,
Delaware,Superintendent of Public Instruction,Brian Kelly,REP,210007,3,0,61,64,
Delaware,Superintendent of Public Instruction,Janet Costello Barresi,REP,210007,4,4,58,66,
Delaware,Superintendent of Public Instruction,Joy Hofmeister,REP,210007,15,13,224,252,
Delaware,Insurance Commissioner,Bill Viner,REP,210007,1,7,87,95,
Delaware,Insurance Commissioner,John Doak,REP,210007,20,9,221,250,
Delaware,Corporation Commissioner,Todd Hiett,REP,210007,14,11,157,182,
Delaware,Corporation Commissioner,Cliff Branan,REP,210007,6,5,145,156,
Delaware,U.S. Senate,Evelyn Rogers,REP,210007,0,0,22,22,
Delaware,U.S. Senate,Rob Moye,REP,210007,0,0,6,6,
Delaware,U.S. Senate,D. Jean Mcbride-Samuels,REP,210007,0,0,3,3,
Delaware,U.S. Senate,Jim Inhofe,REP,210007,18,16,291,325,
Delaware,U.S. Senate,Erick Paul Wyatt,REP,210007,4,1,20,25,
Delaware,U.S. Senate,Andy Craig,REP,210007,1,0,0,1,
Delaware,U.S. Senate,T. Shannon,REP,210007,7,2,134,143,
Delaware,U.S. Senate,Randy Brogdon,REP,210007,6,5,30,41,
Delaware,U.S. Senate,Eric Mccray,REP,210007,0,0,1,1,
Delaware,U.S. Senate,Kevin Crow,REP,210007,0,0,4,4,
Delaware,U.S. Senate,James Lankford,REP,210007,7,10,181,198,
Delaware,U.S. Senate,Jason Weger,REP,210007,0,0,2,2,
Delaware,U.S. House,Darrel Robertson,REP,210007,11,10,136,157,02
Delaware,U.S. House,Markwayne Mullin,REP,210007,10,7,212,229,02
Delaware,Superintendent of Public Instruction,John Cox,DEM,210008,1,1,24,26,
Delaware,Superintendent of Public Instruction,Jack Jr.,DEM,210008,0,1,3,4,
Delaware,Superintendent of Public Instruction,Ivan Holmes,DEM,210008,0,0,5,5,
Delaware,Superintendent of Public Instruction,Freda Deskin,DEM,210008,0,1,10,11,
Delaware,U.S. Senate,Patrick Michael Hayes,DEM,210008,0,1,11,12,
Delaware,U.S. Senate,Jim Rogers,DEM,210008,1,0,16,17,
Delaware,U.S. Senate,Connie Johnson,DEM,210008,0,3,14,17,
Delaware,U.S. House,Earl Everett,DEM,210008,0,3,19,22,02
Delaware,U.S. House,Joshua Harris-Till,DEM,210008,1,0,20,21,02
Delaware,Governor,Dax Ewbank,REP,210008,2,2,10,14,
Delaware,Governor,Chad Moody,REP,210008,0,0,12,12,
Delaware,Governor,Mary Fallin,REP,210008,0,3,61,64,
Delaware,Superintendent of Public Instruction,Brian Kelly,REP,210008,0,1,23,24,
Delaware,Superintendent of Public Instruction,Janet Costello Barresi,REP,210008,0,1,10,11,
Delaware,Superintendent of Public Instruction,Joy Hofmeister,REP,210008,2,3,48,53,
Delaware,Insurance Commissioner,Bill Viner,REP,210008,0,3,21,24,
Delaware,Insurance Commissioner,John Doak,REP,210008,2,2,53,57,
Delaware,Corporation Commissioner,Todd Hiett,REP,210008,0,2,39,41,
Delaware,Corporation Commissioner,Cliff Branan,REP,210008,2,3,34,39,
Delaware,U.S. Senate,Evelyn Rogers,REP,210008,0,0,3,3,
Delaware,U.S. Senate,Rob Moye,REP,210008,0,0,4,4,
Delaware,U.S. Senate,D. Jean Mcbride-Samuels,REP,210008,0,0,3,3,
Delaware,U.S. Senate,Jim Inhofe,REP,210008,2,3,64,69,
Delaware,U.S. Senate,Erick Paul Wyatt,REP,210008,0,2,8,10,
Delaware,U.S. Senate,Andy Craig,REP,210008,0,1,1,2,
Delaware,U.S. Senate,T. Shannon,REP,210008,0,2,39,41,
Delaware,U.S. Senate,Randy Brogdon,REP,210008,2,2,7,11,
Delaware,U.S. Senate,Eric Mccray,REP,210008,0,0,4,4,
Delaware,U.S. Senate,Kevin Crow,REP,210008,0,0,1,1,
Delaware,U.S. Senate,James Lankford,REP,210008,0,0,29,29,
Delaware,U.S. Senate,Jason Weger,REP,210008,0,0,1,1,
Delaware,U.S. House,Darrel Robertson,REP,210008,2,5,58,65,02
Delaware,U.S. House,Markwayne Mullin,REP,210008,0,0,25,25,02
Delaware,Superintendent of Public Instruction,John Cox,DEM,210009,4,3,98,105,
Delaware,Superintendent of Public Instruction,Jack Jr.,DEM,210009,1,0,6,7,
Delaware,Superintendent of Public Instruction,Ivan Holmes,DEM,210009,0,0,11,11,
Delaware,Superintendent of Public Instruction,Freda Deskin,DEM,210009,3,0,42,45,
Delaware,U.S. Senate,Patrick Michael Hayes,DEM,210009,0,0,33,33,
Delaware,U.S. Senate,Jim Rogers,DEM,210009,2,2,50,54,
Delaware,U.S. Senate,Connie Johnson,DEM,210009,5,1,67,73,
Delaware,U.S. House,Earl Everett,DEM,210009,1,2,87,90,02
Delaware,U.S. House,Joshua Harris-Till,DEM,210009,6,0,56,62,02
Delaware,Governor,Dax Ewbank,REP,210009,1,3,29,33,
Delaware,Governor,Chad Moody,REP,210009,1,2,41,44,
Delaware,Governor,Mary Fallin,REP,210009,11,7,274,292,
Delaware,Superintendent of Public Instruction,Brian Kelly,REP,210009,3,2,64,69,
Delaware,Superintendent of Public Instruction,Janet Costello Barresi,REP,210009,7,4,62,73,
Delaware,Superintendent of Public Instruction,Joy Hofmeister,REP,210009,3,2,213,218,
Delaware,Insurance Commissioner,Bill Viner,REP,210009,2,0,88,90,
Delaware,Insurance Commissioner,John Doak,REP,210009,11,7,225,243,
Delaware,Corporation Commissioner,Todd Hiett,REP,210009,8,6,164,178,
Delaware,Corporation Commissioner,Cliff Branan,REP,210009,3,3,140,146,
Delaware,U.S. Senate,Evelyn Rogers,REP,210009,0,0,14,14,
Delaware,U.S. Senate,Rob Moye,REP,210009,0,0,10,10,
Delaware,U.S. Senate,D. Jean Mcbride-Samuels,REP,210009,0,0,4,4,
Delaware,U.S. Senate,Jim Inhofe,REP,210009,9,7,284,300,
Delaware,U.S. Senate,Erick Paul Wyatt,REP,210009,2,3,30,35,
Delaware,U.S. Senate,Andy Craig,REP,210009,1,0,3,4,
Delaware,U.S. Senate,T. Shannon,REP,210009,5,3,111,119,
Delaware,U.S. Senate,Randy Brogdon,REP,210009,0,5,36,41,
Delaware,U.S. Senate,Eric Mccray,REP,210009,0,0,2,2,
Delaware,U.S. Senate,Kevin Crow,REP,210009,0,1,5,6,
Delaware,U.S. Senate,James Lankford,REP,210009,7,3,194,204,
Delaware,U.S. Senate,Jason Weger,REP,210009,0,0,1,1,
Delaware,U.S. House,Darrel Robertson,REP,210009,3,7,143,153,02
Delaware,U.S. House,Markwayne Mullin,REP,210009,10,5,207,222,02
Delaware,Superintendent of Public Instruction,John Cox,DEM,210010,2,2,5,9,
Delaware,Superintendent of Public Instruction,Jack Jr.,DEM,210010,0,0,0,0,
Delaware,Superintendent of Public Instruction,Ivan Holmes,DEM,210010,0,0,0,0,
Delaware,Superintendent of Public Instruction,Freda Deskin,DEM,210010,0,0,0,0,
Delaware,U.S. Senate,Patrick Michael Hayes,DEM,210010,2,0,0,2,
Delaware,U.S. Senate,Jim Rogers,DEM,210010,0,1,4,5,
Delaware,U.S. Senate,Connie Johnson,DEM,210010,0,0,1,1,
Delaware,U.S. House,Earl Everett,DEM,210010,2,0,4,6,02
Delaware,U.S. House,Joshua Harris-Till,DEM,210010,0,1,1,2,02
Delaware,Governor,Dax Ewbank,REP,210010,0,0,0,0,
Delaware,Governor,Chad Moody,REP,210010,0,0,0,0,
Delaware,Governor,Mary Fallin,REP,210010,2,2,5,9,
Delaware,Superintendent of Public Instruction,Brian Kelly,REP,210010,1,0,1,2,
Delaware,Superintendent of Public Instruction,Janet Costello Barresi,REP,210010,0,0,4,4,
Delaware,Superintendent of Public Instruction,Joy Hofmeister,REP,210010,1,2,0,3,
Delaware,Insurance Commissioner,Bill Viner,REP,210010,0,2,0,2,
Delaware,Insurance Commissioner,John Doak,REP,210010,2,0,5,7,
Delaware,Corporation Commissioner,Todd Hiett,REP,210010,1,2,3,6,
Delaware,Corporation Commissioner,Cliff Branan,REP,210010,1,0,2,3,
Delaware,U.S. Senate,Evelyn Rogers,REP,210010,0,0,0,0,
Delaware,U.S. Senate,Rob Moye,REP,210010,0,0,0,0,
Delaware,U.S. Senate,D. Jean Mcbride-Samuels,REP,210010,0,0,0,0,
Delaware,U.S. Senate,Jim Inhofe,REP,210010,1,2,5,8,
Delaware,U.S. Senate,Erick Paul Wyatt,REP,210010,1,0,0,1,
Delaware,U.S. Senate,Andy Craig,REP,210010,0,0,0,0,
Delaware,U.S. Senate,T. Shannon,REP,210010,0,0,3,3,
Delaware,U.S. Senate,Randy Brogdon,REP,210010,0,0,0,0,
Delaware,U.S. Senate,Eric Mccray,REP,210010,0,0,0,0,
Delaware,U.S. Senate,Kevin Crow,REP,210010,0,0,0,0,
Delaware,U.S. Senate,James Lankford,REP,210010,2,0,2,4,
Delaware,U.S. Senate,Jason Weger,REP,210010,0,0,0,0,
Delaware,U.S. House,Darrel Robertson,REP,210010,0,0,0,0,02
Delaware,U.S. House,Markwayne Mullin,REP,210010,2,2,5,9,02
Delaware,Superintendent of Public Instruction,John Cox,DEM,210011,0,2,21,23,
Delaware,Superintendent of Public Instruction,Jack Jr.,DEM,210011,0,0,6,6,
Delaware,Superintendent of Public Instruction,Ivan Holmes,DEM,210011,0,0,5,5,
Delaware,Superintendent of Public Instruction,Freda Deskin,DEM,210011,0,1,19,20,
Delaware,U.S. Senate,Patrick Michael Hayes,DEM,210011,0,1,13,14,
Delaware,U.S. Senate,Jim Rogers,DEM,210011,0,2,17,19,
Delaware,U.S. Senate,Connie Johnson,DEM,210011,0,0,19,19,
Delaware,U.S. House,Earl Everett,DEM,210011,0,1,26,27,02
Delaware,U.S. House,Joshua Harris-Till,DEM,210011,0,2,22,24,02
Delaware,State House,Donnie Howe,DEM,210011,0,2,16,18,7
Delaware,State House,Ben Loring,DEM,210011,0,1,35,36,7
Delaware,Governor,Dax Ewbank,REP,210011,0,0,3,3,
Delaware,Governor,Chad Moody,REP,210011,0,3,16,19,
Delaware,Governor,Mary Fallin,REP,210011,3,1,118,122,
Delaware,Superintendent of Public Instruction,Brian Kelly,REP,210011,0,4,26,30,
Delaware,Superintendent of Public Instruction,Janet Costello Barresi,REP,210011,0,0,34,34,
Delaware,Superintendent of Public Instruction,Joy Hofmeister,REP,210011,3,0,71,74,
Delaware,Insurance Commissioner,Bill Viner,REP,210011,0,3,41,44,
Delaware,Insurance Commissioner,John Doak,REP,210011,3,1,88,92,
Delaware,Corporation Commissioner,Todd Hiett,REP,210011,2,3,57,62,
Delaware,Corporation Commissioner,Cliff Branan,REP,210011,1,1,64,66,
Delaware,U.S. Senate,Evelyn Rogers,REP,210011,0,0,4,4,
Delaware,U.S. Senate,Rob Moye,REP,210011,0,0,6,6,
Delaware,U.S. Senate,D. Jean Mcbride-Samuels,REP,210011,0,0,1,1,
Delaware,U.S. Senate,Jim Inhofe,REP,210011,3,3,118,124,
Delaware,U.S. Senate,Erick Paul Wyatt,REP,210011,0,1,5,6,
Delaware,U.S. Senate,Andy Craig,REP,210011,0,0,1,1,
Delaware,U.S. Senate,T. Shannon,REP,210011,3,0,57,60,
Delaware,U.S. Senate,Randy Brogdon,REP,210011,0,1,3,4,
Delaware,U.S. Senate,Eric Mccray,REP,210011,0,0,3,3,
Delaware,U.S. Senate,Kevin Crow,REP,210011,0,1,4,5,
Delaware,U.S. Senate,James Lankford,REP,210011,0,2,65,67,
Delaware,U.S. Senate,Jason Weger,REP,210011,0,0,0,0,
Delaware,U.S. House,Darrel Robertson,REP,210011,3,1,46,50,02
Delaware,U.S. House,Markwayne Mullin,REP,210011,0,3,87,90,02
Delaware,Superintendent of Public Instruction,John Cox,DEM,210012,0,4,62,66,
Delaware,Superintendent of Public Instruction,Jack Jr.,DEM,210012,1,0,2,3,
Delaware,Superintendent of Public Instruction,Ivan Holmes,DEM,210012,1,0,3,4,
Delaware,Superintendent of Public Instruction,Freda Deskin,DEM,210012,1,2,21,24,
Delaware,U.S. Senate,Patrick Michael Hayes,DEM,210012,0,2,25,27,
Delaware,U.S. Senate,Jim Rogers,DEM,210012,2,2,32,36,
Delaware,U.S. Senate,Connie Johnson,DEM,210012,1,2,29,32,
Delaware,U.S. House,Earl Everett,DEM,210012,2,4,45,51,02
Delaware,U.S. House,Joshua Harris-Till,DEM,210012,1,2,35,38,02
Delaware,Governor,Dax Ewbank,REP,210012,0,1,7,8,
Delaware,Governor,Chad Moody,REP,210012,0,0,11,11,
Delaware,Governor,Mary Fallin,REP,210012,2,0,97,99,
Delaware,Superintendent of Public Instruction,Brian Kelly,REP,210012,0,0,24,24,
Delaware,Superintendent of Public Instruction,Janet Costello Barresi,REP,210012,0,0,25,25,
Delaware,Superintendent of Public Instruction,Joy Hofmeister,REP,210012,1,1,63,65,
Delaware,Insurance Commissioner,Bill Viner,REP,210012,0,0,30,30,
Delaware,Insurance Commissioner,John Doak,REP,210012,2,1,71,74,
Delaware,Corporation Commissioner,Todd Hiett,REP,210012,0,1,51,52,
Delaware,Corporation Commissioner,Cliff Branan,REP,210012,1,0,54,55,
Delaware,U.S. Senate,Evelyn Rogers,REP,210012,0,0,4,4,
Delaware,U.S. Senate,Rob Moye,REP,210012,0,0,2,2,
Delaware,U.S. Senate,D. Jean Mcbride-Samuels,REP,210012,0,0,0,0,
Delaware,U.S. Senate,Jim Inhofe,REP,210012,2,1,101,104,
Delaware,U.S. Senate,Erick Paul Wyatt,REP,210012,0,0,8,8,
Delaware,U.S. Senate,Andy Craig,REP,210012,0,0,1,1,
Delaware,U.S. Senate,T. Shannon,REP,210012,2,0,50,52,
Delaware,U.S. Senate,Randy Brogdon,REP,210012,0,0,11,11,
Delaware,U.S. Senate,Eric Mccray,REP,210012,0,0,1,1,
Delaware,U.S. Senate,Kevin Crow,REP,210012,0,0,0,0,
Delaware,U.S. Senate,James Lankford,REP,210012,0,1,51,52,
Delaware,U.S. Senate,Jason Weger,REP,210012,0,0,0,0,
Delaware,U.S. House,Darrel Robertson,REP,210012,1,0,46,47,02
Delaware,U.S. House,Markwayne Mullin,REP,210012,1,0,68,69,02
Delaware,Superintendent of Public Instruction,John Cox,DEM,210014,1,14,103,118,
Delaware,Superintendent of Public Instruction,Jack Jr.,DEM,210014,0,0,4,4,
Delaware,Superintendent of Public Instruction,Ivan Holmes,DEM,210014,0,0,1,1,
Delaware,Superintendent of Public Instruction,Freda Deskin,DEM,210014,2,1,16,19,
Delaware,U.S. Senate,Patrick Michael Hayes,DEM,210014,1,7,25,33,
Delaware,U.S. Senate,Jim Rogers,DEM,210014,1,4,62,67,
Delaware,U.S. Senate,Connie Johnson,DEM,210014,1,3,30,34,
Delaware,U.S. House,Earl Everett,DEM,210014,1,9,77,87,02
Delaware,U.S. House,Joshua Harris-Till,DEM,210014,2,4,35,41,02
Delaware,Governor,Dax Ewbank,REP,210014,0,1,2,3,
Delaware,Governor,Chad Moody,REP,210014,0,0,12,12,
Delaware,Governor,Mary Fallin,REP,210014,2,7,36,45,
Delaware,Superintendent of Public Instruction,Brian Kelly,REP,210014,0,4,12,16,
Delaware,Superintendent of Public Instruction,Janet Costello Barresi,REP,210014,2,4,6,12,
Delaware,Superintendent of Public Instruction,Joy Hofmeister,REP,210014,0,1,34,35,
Delaware,Insurance Commissioner,Bill Viner,REP,210014,0,4,12,16,
Delaware,Insurance Commissioner,John Doak,REP,210014,2,5,36,43,
Delaware,Corporation Commissioner,Todd Hiett,REP,210014,2,7,22,31,
Delaware,Corporation Commissioner,Cliff Branan,REP,210014,0,2,24,26,
Delaware,U.S. Senate,Evelyn Rogers,REP,210014,0,0,1,1,
Delaware,U.S. Senate,Rob Moye,REP,210014,0,0,1,1,
Delaware,U.S. Senate,D. Jean Mcbride-Samuels,REP,210014,0,0,0,0,
Delaware,U.S. Senate,Jim Inhofe,REP,210014,2,7,42,51,
Delaware,U.S. Senate,Erick Paul Wyatt,REP,210014,0,2,5,7,
Delaware,U.S. Senate,Andy Craig,REP,210014,0,1,1,2,
Delaware,U.S. Senate,T. Shannon,REP,210014,0,1,36,37,
Delaware,U.S. Senate,Randy Brogdon,REP,210014,0,2,2,4,
Delaware,U.S. Senate,Eric Mccray,REP,210014,0,0,0,0,
Delaware,U.S. Senate,Kevin Crow,REP,210014,0,0,0,0,
Delaware,U.S. Senate,James Lankford,REP,210014,2,6,13,21,
Delaware,U.S. Senate,Jason Weger,REP,210014,0,0,0,0,
Delaware,U.S. House,Darrel Robertson,REP,210014,0,4,12,16,02
Delaware,U.S. House,Markwayne Mullin,REP,210014,2,6,39,47,02
Delaware,Superintendent of Public Instruction,John Cox,DEM,210015,1,11,59,71,
Delaware,Superintendent of Public Instruction,Jack Jr.,DEM,210015,0,0,8,8,
Delaware,Superintendent of Public Instruction,Ivan Holmes,DEM,210015,0,0,4,4,
Delaware,Superintendent of Public Instruction,Freda Deskin,DEM,210015,1,1,28,30,
Delaware,U.S. Senate,Patrick Michael Hayes,DEM,210015,0,2,18,20,
Delaware,U.S. Senate,Jim Rogers,DEM,210015,0,2,42,44,
Delaware,U.S. Senate,Connie Johnson,DEM,210015,2,7,33,42,
Delaware,U.S. House,Earl Everett,DEM,210015,1,4,53,58,02
Delaware,U.S. House,Joshua Harris-Till,DEM,210015,1,6,38,45,02
Delaware,Governor,Dax Ewbank,REP,210015,0,1,3,4,
Delaware,Governor,Chad Moody,REP,210015,1,1,8,10,
Delaware,Governor,Mary Fallin,REP,210015,7,4,81,92,
Delaware,Superintendent of Public Instruction,Brian Kelly,REP,210015,3,1,20,24,
Delaware,Superintendent of Public Instruction,Janet Costello Barresi,REP,210015,2,2,27,31,
Delaware,Superintendent of Public Instruction,Joy Hofmeister,REP,210015,3,3,44,50,
Delaware,Insurance Commissioner,Bill Viner,REP,210015,3,1,22,26,
Delaware,Insurance Commissioner,John Doak,REP,210015,5,4,62,71,
Delaware,Corporation Commissioner,Todd Hiett,REP,210015,4,4,45,53,
Delaware,Corporation Commissioner,Cliff Branan,REP,210015,4,2,40,46,
Delaware,U.S. Senate,Evelyn Rogers,REP,210015,0,0,6,6,
Delaware,U.S. Senate,Rob Moye,REP,210015,0,0,0,0,
Delaware,U.S. Senate,D. Jean Mcbride-Samuels,REP,210015,0,0,3,3,
Delaware,U.S. Senate,Jim Inhofe,REP,210015,8,6,83,97,
Delaware,U.S. Senate,Erick Paul Wyatt,REP,210015,0,0,1,1,
Delaware,U.S. Senate,Andy Craig,REP,210015,1,0,1,2,
Delaware,U.S. Senate,T. Shannon,REP,210015,3,3,54,60,
Delaware,U.S. Senate,Randy Brogdon,REP,210015,0,1,2,3,
Delaware,U.S. Senate,Eric Mccray,REP,210015,0,0,1,1,
Delaware,U.S. Senate,Kevin Crow,REP,210015,0,0,1,1,
Delaware,U.S. Senate,James Lankford,REP,210015,4,2,32,38,
Delaware,U.S. Senate,Jason Weger,REP,210015,0,0,2,2,
Delaware,U.S. House,Darrel Robertson,REP,210015,2,1,20,23,02
Delaware,U.S. House,Markwayne Mullin,REP,210015,6,5,73,84,02
Delaware,Superintendent of Public Instruction,John Cox,DEM,210016,1,18,67,86,
Delaware,Superintendent of Public Instruction,Jack Jr.,DEM,210016,1,0,9,10,
Delaware,Superintendent of Public Instruction,Ivan Holmes,DEM,210016,1,2,2,5,
Delaware,Superintendent of Public Instruction,Freda Deskin,DEM,210016,0,0,16,16,
Delaware,U.S. Senate,Patrick Michael Hayes,DEM,210016,0,5,27,32,
Delaware,U.S. Senate,Jim Rogers,DEM,210016,1,10,33,44,
Delaware,U.S. Senate,Connie Johnson,DEM,210016,1,3,25,29,
Delaware,U.S. House,Earl Everett,DEM,210016,0,13,52,65,02
Delaware,U.S. House,Joshua Harris-Till,DEM,210016,1,5,26,32,02
Delaware,Governor,Dax Ewbank,REP,210016,1,0,5,6,
Delaware,Governor,Chad Moody,REP,210016,0,1,10,11,
Delaware,Governor,Mary Fallin,REP,210016,1,5,40,46,
Delaware,Superintendent of Public Instruction,Brian Kelly,REP,210016,1,3,8,12,
Delaware,Superintendent of Public Instruction,Janet Costello Barresi,REP,210016,0,1,8,9,
Delaware,Superintendent of Public Instruction,Joy Hofmeister,REP,210016,1,2,37,40,
Delaware,Insurance Commissioner,Bill Viner,REP,210016,1,2,16,19,
Delaware,Insurance Commissioner,John Doak,REP,210016,1,4,35,40,
Delaware,Corporation Commissioner,Todd Hiett,REP,210016,2,3,23,28,
Delaware,Corporation Commissioner,Cliff Branan,REP,210016,0,2,26,28,
Delaware,U.S. Senate,Evelyn Rogers,REP,210016,0,0,4,4,
Delaware,U.S. Senate,Rob Moye,REP,210016,0,0,1,1,
Delaware,U.S. Senate,D. Jean Mcbride-Samuels,REP,210016,0,0,0,0,
Delaware,U.S. Senate,Jim Inhofe,REP,210016,2,6,45,53,
Delaware,U.S. Senate,Erick Paul Wyatt,REP,210016,0,0,5,5,
Delaware,U.S. Senate,Andy Craig,REP,210016,0,1,0,1,
Delaware,U.S. Senate,T. Shannon,REP,210016,1,1,36,38,
Delaware,U.S. Senate,Randy Brogdon,REP,210016,1,0,3,4,
Delaware,U.S. Senate,Eric Mccray,REP,210016,0,0,0,0,
Delaware,U.S. Senate,Kevin Crow,REP,210016,0,0,2,2,
Delaware,U.S. Senate,James Lankford,REP,210016,0,4,13,17,
Delaware,U.S. Senate,Jason Weger,REP,210016,0,0,1,1,
Delaware,U.S. House,Darrel Robertson,REP,210016,1,2,15,18,02
Delaware,U.S. House,Markwayne Mullin,REP,210016,1,4,38,43,02
Delaware,Superintendent of Public Instruction,John Cox,DEM,210017,1,9,67,77,
Delaware,Superintendent of Public Instruction,Jack Jr.,DEM,210017,1,0,2,3,
Delaware,Superintendent of Public Instruction,Ivan Holmes,DEM,210017,0,0,1,1,
Delaware,Superintendent of Public Instruction,Freda Deskin,DEM,210017,0,3,5,8,
Delaware,U.S. Senate,Patrick Michael Hayes,DEM,210017,1,4,14,19,
Delaware,U.S. Senate,Jim Rogers,DEM,210017,0,1,25,26,
Delaware,U.S. Senate,Connie Johnson,DEM,210017,1,6,23,30,
Delaware,U.S. House,Earl Everett,DEM,210017,1,8,40,49,02
Delaware,U.S. House,Joshua Harris-Till,DEM,210017,1,3,19,23,02
Delaware,Governor,Dax Ewbank,REP,210017,0,1,4,5,
Delaware,Governor,Chad Moody,REP,210017,1,1,7,9,
Delaware,Governor,Mary Fallin,REP,210017,0,3,18,21,
Delaware,Superintendent of Public Instruction,Brian Kelly,REP,210017,0,2,5,7,
Delaware,Superintendent of Public Instruction,Janet Costello Barresi,REP,210017,0,1,5,6,
Delaware,Superintendent of Public Instruction,Joy Hofmeister,REP,210017,1,1,19,21,
Delaware,Insurance Commissioner,Bill Viner,REP,210017,0,1,9,10,
Delaware,Insurance Commissioner,John Doak,REP,210017,1,1,12,14,
Delaware,Corporation Commissioner,Todd Hiett,REP,210017,0,2,12,14,
Delaware,Corporation Commissioner,Cliff Branan,REP,210017,1,0,15,16,
Delaware,U.S. Senate,Evelyn Rogers,REP,210017,0,0,2,2,
Delaware,U.S. Senate,Rob Moye,REP,210017,0,0,2,2,
Delaware,U.S. Senate,D. Jean Mcbride-Samuels,REP,210017,0,0,0,0,
Delaware,U.S. Senate,Jim Inhofe,REP,210017,1,3,20,24,
Delaware,U.S. Senate,Erick Paul Wyatt,REP,210017,0,0,4,4,
Delaware,U.S. Senate,Andy Craig,REP,210017,0,0,1,1,
Delaware,U.S. Senate,T. Shannon,REP,210017,0,3,19,22,
Delaware,U.S. Senate,Randy Brogdon,REP,210017,0,0,0,0,
Delaware,U.S. Senate,Eric Mccray,REP,210017,1,0,0,1,
Delaware,U.S. Senate,Kevin Crow,REP,210017,0,0,0,0,
Delaware,U.S. Senate,James Lankford,REP,210017,0,2,7,9,
Delaware,U.S. Senate,Jason Weger,REP,210017,0,0,1,1,
Delaware,U.S. House,Darrel Robertson,REP,210017,0,1,8,9,02
Delaware,U.S. House,Markwayne Mullin,REP,210017,1,3,21,25,02
Delaware,Superintendent of Public Instruction,John Cox,DEM,210018,0,6,41,47,
Delaware,Superintendent of Public Instruction,Jack Jr.,DEM,210018,0,0,3,3,
Delaware,Superintendent of Public Instruction,Ivan Holmes,DEM,210018,0,1,2,3,
Delaware,Superintendent of Public Instruction,Freda Deskin,DEM,210018,0,1,9,10,
Delaware,U.S. Senate,Patrick Michael Hayes,DEM,210018,0,1,16,17,
Delaware,U.S. Senate,Jim Rogers,DEM,210018,0,3,31,34,
Delaware,U.S. Senate,Connie Johnson,DEM,210018,0,3,6,9,
Delaware,U.S. House,Earl Everett,DEM,210018,0,1,29,30,02
Delaware,U.S. House,Joshua Harris-Till,DEM,210018,0,5,23,28,02
Delaware,Governor,Dax Ewbank,REP,210018,0,1,2,3,
Delaware,Governor,Chad Moody,REP,210018,0,0,4,4,
Delaware,Governor,Mary Fallin,REP,210018,0,1,31,32,
Delaware,Superintendent of Public Instruction,Brian Kelly,REP,210018,0,2,7,9,
Delaware,Superintendent of Public Instruction,Janet Costello Barresi,REP,210018,0,0,2,2,
Delaware,Superintendent of Public Instruction,Joy Hofmeister,REP,210018,0,0,28,28,
Delaware,Insurance Commissioner,Bill Viner,REP,210018,0,1,14,15,
Delaware,Insurance Commissioner,John Doak,REP,210018,0,1,20,21,
Delaware,Corporation Commissioner,Todd Hiett,REP,210018,0,0,21,21,
Delaware,Corporation Commissioner,Cliff Branan,REP,210018,0,2,13,15,
Delaware,U.S. Senate,Evelyn Rogers,REP,210018,0,0,1,1,
Delaware,U.S. Senate,Rob Moye,REP,210018,0,0,0,0,
Delaware,U.S. Senate,D. Jean Mcbride-Samuels,REP,210018,0,0,0,0,
Delaware,U.S. Senate,Jim Inhofe,REP,210018,0,2,34,36,
Delaware,U.S. Senate,Erick Paul Wyatt,REP,210018,0,0,2,2,
Delaware,U.S. Senate,Andy Craig,REP,210018,0,0,1,1,
Delaware,U.S. Senate,T. Shannon,REP,210018,0,0,19,19,
Delaware,U.S. Senate,Randy Brogdon,REP,210018,0,0,6,6,
Delaware,U.S. Senate,Eric Mccray,REP,210018,0,0,0,0,
Delaware,U.S. Senate,Kevin Crow,REP,210018,0,0,0,0,
Delaware,U.S. Senate,James Lankford,REP,210018,0,2,11,13,
Delaware,U.S. Senate,Jason Weger,REP,210018,0,0,0,0,
Delaware,U.S. House,Darrel Robertson,REP,210018,0,0,14,14,02
Delaware,U.S. House,Markwayne Mullin,REP,210018,0,2,22,24,02
Delaware,Superintendent of Public Instruction,John Cox,DEM,210019,9,3,231,243,
Delaware,Superintendent of Public Instruction,Jack Jr.,DEM,210019,0,0,19,19,
Delaware,Superintendent of Public Instruction,Ivan Holmes,DEM,210019,2,2,18,22,
Delaware,Superintendent of Public Instruction,Freda Deskin,DEM,210019,0,0,36,36,
Delaware,U.S. Senate,Patrick Michael Hayes,DEM,210019,2,0,104,106,
Delaware,U.S. Senate,Jim Rogers,DEM,210019,5,3,113,121,
Delaware,U.S. Senate,Connie Johnson,DEM,210019,3,2,57,62,
Delaware,U.S. House,Earl Everett,DEM,210019,7,4,171,182,02
Delaware,U.S. House,Joshua Harris-Till,DEM,210019,2,1,105,108,02
Delaware,Governor,Dax Ewbank,REP,210019,0,0,1,1,
Delaware,Governor,Chad Moody,REP,210019,0,0,11,11,
Delaware,Governor,Mary Fallin,REP,210019,3,0,56,59,
Delaware,Superintendent of Public Instruction,Brian Kelly,REP,210019,1,0,20,21,
Delaware,Superintendent of Public Instruction,Janet Costello Barresi,REP,210019,0,0,12,12,
Delaware,Superintendent of Public Instruction,Joy Hofmeister,REP,210019,2,0,30,32,
Delaware,Insurance Commissioner,Bill Viner,REP,210019,0,0,15,15,
Delaware,Insurance Commissioner,John Doak,REP,210019,3,0,44,47,
Delaware,Corporation Commissioner,Todd Hiett,REP,210019,2,0,31,33,
Delaware,Corporation Commissioner,Cliff Branan,REP,210019,1,0,32,33,
Delaware,U.S. Senate,Evelyn Rogers,REP,210019,0,0,3,3,
Delaware,U.S. Senate,Rob Moye,REP,210019,0,0,1,1,
Delaware,U.S. Senate,D. Jean Mcbride-Samuels,REP,210019,0,0,0,0,
Delaware,U.S. Senate,Jim Inhofe,REP,210019,3,0,52,55,
Delaware,U.S. Senate,Erick Paul Wyatt,REP,210019,0,0,9,9,
Delaware,U.S. Senate,Andy Craig,REP,210019,0,0,2,2,
Delaware,U.S. Senate,T. Shannon,REP,210019,3,0,30,33,
Delaware,U.S. Senate,Randy Brogdon,REP,210019,0,0,4,4,
Delaware,U.S. Senate,Eric Mccray,REP,210019,0,0,1,1,
Delaware,U.S. Senate,Kevin Crow,REP,210019,0,0,3,3,
Delaware,U.S. Senate,James Lankford,REP,210019,0,0,26,26,
Delaware,U.S. Senate,Jason Weger,REP,210019,0,0,0,0,
Delaware,U.S. House,Darrel Robertson,REP,210019,2,0,9,11,02
Delaware,U.S. House,Markwayne Mullin,REP,210019,1,0,58,59,02
Delaware,Superintendent of Public Instruction,John Cox,DEM,210020,0,0,50,50,
Delaware,Superintendent of Public Instruction,Jack Jr.,DEM,210020,0,0,2,2,
Delaware,Superintendent of Public Instruction,Ivan Holmes,DEM,210020,0,0,4,4,
Delaware,Superintendent of Public Instruction,Freda Deskin,DEM,210020,0,0,6,6,
Delaware,U.S. Senate,Patrick Michael Hayes,DEM,210020,0,0,20,20,
Delaware,U.S. Senate,Jim Rogers,DEM,210020,0,0,29,29,
Delaware,U.S. Senate,Connie Johnson,DEM,210020,0,0,12,12,
Delaware,U.S. House,Earl Everett,DEM,210020,0,0,27,27,02
Delaware,U.S. House,Joshua Harris-Till,DEM,210020,0,0,32,32,02
Delaware,Governor,Dax Ewbank,REP,210020,0,0,2,2,
Delaware,Governor,Chad Moody,REP,210020,0,0,6,6,
Delaware,Governor,Mary Fallin,REP,210020,0,0,10,10,
Delaware,Superintendent of Public Instruction,Brian Kelly,REP,210020,0,0,5,5,
Delaware,Superintendent of Public Instruction,Janet Costello Barresi,REP,210020,0,0,1,1,
Delaware,Superintendent of Public Instruction,Joy Hofmeister,REP,210020,0,0,12,12,
Delaware,Insurance Commissioner,Bill Viner,REP,210020,0,0,4,4,
Delaware,Insurance Commissioner,John Doak,REP,210020,0,0,13,13,
Delaware,Corporation Commissioner,Todd Hiett,REP,210020,0,0,11,11,
Delaware,Corporation Commissioner,Cliff Branan,REP,210020,0,0,6,6,
Delaware,U.S. Senate,Evelyn Rogers,REP,210020,0,0,3,3,
Delaware,U.S. Senate,Rob Moye,REP,210020,0,0,0,0,
Delaware,U.S. Senate,D. Jean Mcbride-Samuels,REP,210020,0,0,0,0,
Delaware,U.S. Senate,Jim Inhofe,REP,210020,0,0,12,12,
Delaware,U.S. Senate,Erick Paul Wyatt,REP,210020,0,0,3,3,
Delaware,U.S. Senate,Andy Craig,REP,210020,0,0,0,0,
Delaware,U.S. Senate,T. Shannon,REP,210020,0,0,13,13,
Delaware,U.S. Senate,Randy Brogdon,REP,210020,0,0,1,1,
Delaware,U.S. Senate,Eric Mccray,REP,210020,0,0,1,1,
Delaware,U.S. Senate,Kevin Crow,REP,210020,0,0,0,0,
Delaware,U.S. Senate,James Lankford,REP,210020,0,0,3,3,
Delaware,U.S. Senate,Jason Weger,REP,210020,0,0,0,0,
Delaware,U.S. House,Darrel Robertson,REP,210020,0,0,4,4,02
Delaware,U.S. House,Markwayne Mullin,REP,210020,0,0,14,14,02
Delaware,Superintendent of Public Instruction,John Cox,DEM,210021,0,0,40,40,
Delaware,Superintendent of Public Instruction,Jack Jr.,DEM,210021,0,0,2,2,
Delaware,Superintendent of Public Instruction,Ivan Holmes,DEM,210021,1,0,3,4,
Delaware,Superintendent of Public Instruction,Freda Deskin,DEM,210021,0,0,13,13,
Delaware,U.S. Senate,Patrick Michael Hayes,DEM,210021,0,0,14,14,
Delaware,U.S. Senate,Jim Rogers,DEM,210021,0,0,20,20,
Delaware,U.S. Senate,Connie Johnson,DEM,210021,1,0,19,20,
Delaware,U.S. House,Earl Everett,DEM,210021,1,0,28,29,02
Delaware,U.S. House,Joshua Harris-Till,DEM,210021,0,0,21,21,02
Delaware,Governor,Dax Ewbank,REP,210021,0,0,3,3,
Delaware,Governor,Chad Moody,REP,210021,0,0,1,1,
Delaware,Governor,Mary Fallin,REP,210021,0,1,11,12,
Delaware,Superintendent of Public Instruction,Brian Kelly,REP,210021,0,0,4,4,
Delaware,Superintendent of Public Instruction,Janet Costello Barresi,REP,210021,0,1,4,5,
Delaware,Superintendent of Public Instruction,Joy Hofmeister,REP,210021,0,0,7,7,
Delaware,Insurance Commissioner,Bill Viner,REP,210021,0,0,5,5,
Delaware,Insurance Commissioner,John Doak,REP,210021,0,1,10,11,
Delaware,Corporation Commissioner,Todd Hiett,REP,210021,0,1,8,9,
Delaware,Corporation Commissioner,Cliff Branan,REP,210021,0,0,6,6,
Delaware,U.S. Senate,Evelyn Rogers,REP,210021,0,0,1,1,
Delaware,U.S. Senate,Rob Moye,REP,210021,0,0,0,0,
Delaware,U.S. Senate,D. Jean Mcbride-Samuels,REP,210021,0,0,0,0,
Delaware,U.S. Senate,Jim Inhofe,REP,210021,0,1,12,13,
Delaware,U.S. Senate,Erick Paul Wyatt,REP,210021,0,0,2,2,
Delaware,U.S. Senate,Andy Craig,REP,210021,0,0,0,0,
Delaware,U.S. Senate,T. Shannon,REP,210021,0,0,13,13,
Delaware,U.S. Senate,Randy Brogdon,REP,210021,0,0,2,2,
Delaware,U.S. Senate,Eric Mccray,REP,210021,0,0,0,0,
Delaware,U.S. Senate,Kevin Crow,REP,210021,0,0,0,0,
Delaware,U.S. Senate,James Lankford,REP,210021,0,1,0,1,
Delaware,U.S. Senate,Jason Weger,REP,210021,0,0,0,0,
Delaware,U.S. House,Darrel Robertson,REP,210021,0,1,5,6,02
Delaware,U.S. House,Markwayne Mullin,REP,210021,0,0,9,9,02
Delaware,Superintendent of Public Instruction,John Cox,DEM,210022,7,4,221,232,
Delaware,Superintendent of Public Instruction,Jack Jr.,DEM,210022,0,0,18,18,
Delaware,Superintendent of Public Instruction,Ivan Holmes,DEM,210022,1,0,12,13,
Delaware,Superintendent of Public Instruction,Freda Deskin,DEM,210022,1,0,52,53,
Delaware,U.S. Senate,Patrick Michael Hayes,DEM,210022,0,2,84,86,
Delaware,U.S. Senate,Jim Rogers,DEM,210022,3,2,131,136,
Delaware,U.S. Senate,Connie Johnson,DEM,210022,4,0,68,72,
Delaware,U.S. House,Earl Everett,DEM,210022,5,3,192,200,02
Delaware,U.S. House,Joshua Harris-Till,DEM,210022,2,1,84,87,02
Delaware,Governor,Dax Ewbank,REP,210022,2,0,4,6,
Delaware,Governor,Chad Moody,REP,210022,1,2,20,23,
Delaware,Governor,Mary Fallin,REP,210022,9,4,99,112,
Delaware,Superintendent of Public Instruction,Brian Kelly,REP,210022,4,1,25,30,
Delaware,Superintendent of Public Instruction,Janet Costello Barresi,REP,210022,2,0,22,24,
Delaware,Superintendent of Public Instruction,Joy Hofmeister,REP,210022,6,5,72,83,
Delaware,Insurance Commissioner,Bill Viner,REP,210022,5,1,29,35,
Delaware,Insurance Commissioner,John Doak,REP,210022,7,5,79,91,
Delaware,Corporation Commissioner,Todd Hiett,REP,210022,5,1,58,64,
Delaware,Corporation Commissioner,Cliff Branan,REP,210022,7,5,50,62,
Delaware,U.S. Senate,Evelyn Rogers,REP,210022,2,0,5,7,
Delaware,U.S. Senate,Rob Moye,REP,210022,0,0,1,1,
Delaware,U.S. Senate,D. Jean Mcbride-Samuels,REP,210022,0,0,2,2,
Delaware,U.S. Senate,Jim Inhofe,REP,210022,8,6,107,121,
Delaware,U.S. Senate,Erick Paul Wyatt,REP,210022,2,0,9,11,
Delaware,U.S. Senate,Andy Craig,REP,210022,0,0,1,1,
Delaware,U.S. Senate,T. Shannon,REP,210022,8,2,69,79,
Delaware,U.S. Senate,Randy Brogdon,REP,210022,0,0,4,4,
Delaware,U.S. Senate,Eric Mccray,REP,210022,2,0,2,4,
Delaware,U.S. Senate,Kevin Crow,REP,210022,0,0,1,1,
Delaware,U.S. Senate,James Lankford,REP,210022,2,4,46,52,
Delaware,U.S. Senate,Jason Weger,REP,210022,0,0,1,1,
Delaware,U.S. House,Darrel Robertson,REP,210022,0,0,16,16,02
Delaware,U.S. House,Markwayne Mullin,REP,210022,12,6,105,123,02
Delaware,Superintendent of Public Instruction,John Cox,DEM,210023,6,1,95,102,
Delaware,Superintendent of Public Instruction,Jack Jr.,DEM,210023,2,0,11,13,
Delaware,Superintendent of Public Instruction,Ivan Holmes,DEM,210023,0,0,11,11,
Delaware,Superintendent of Public Instruction,Freda Deskin,DEM,210023,1,0,26,27,
Delaware,U.S. Senate,Patrick Michael Hayes,DEM,210023,0,0,28,28,
Delaware,U.S. Senate,Jim Rogers,DEM,210023,2,1,70,73,
Delaware,U.S. Senate,Connie Johnson,DEM,210023,6,0,30,36,
Delaware,U.S. House,Earl Everett,DEM,210023,4,1,86,91,02
Delaware,U.S. House,Joshua Harris-Till,DEM,210023,4,0,34,38,02
Delaware,Governor,Dax Ewbank,REP,210023,0,0,2,2,
Delaware,Governor,Chad Moody,REP,210023,1,0,11,12,
Delaware,Governor,Mary Fallin,REP,210023,8,0,68,76,
Delaware,Superintendent of Public Instruction,Brian Kelly,REP,210023,5,0,32,37,
Delaware,Superintendent of Public Instruction,Janet Costello Barresi,REP,210023,4,0,15,19,
Delaware,Superintendent of Public Instruction,Joy Hofmeister,REP,210023,0,0,34,34,
Delaware,Insurance Commissioner,Bill Viner,REP,210023,5,0,22,27,
Delaware,Insurance Commissioner,John Doak,REP,210023,4,0,48,52,
Delaware,Corporation Commissioner,Todd Hiett,REP,210023,5,0,44,49,
Delaware,Corporation Commissioner,Cliff Branan,REP,210023,4,0,32,36,
Delaware,U.S. Senate,Evelyn Rogers,REP,210023,0,0,3,3,
Delaware,U.S. Senate,Rob Moye,REP,210023,0,0,0,0,
Delaware,U.S. Senate,D. Jean Mcbride-Samuels,REP,210023,0,0,1,1,
Delaware,U.S. Senate,Jim Inhofe,REP,210023,7,0,70,77,
Delaware,U.S. Senate,Erick Paul Wyatt,REP,210023,2,0,8,10,
Delaware,U.S. Senate,Andy Craig,REP,210023,1,0,3,4,
Delaware,U.S. Senate,T. Shannon,REP,210023,0,0,41,41,
Delaware,U.S. Senate,Randy Brogdon,REP,210023,1,0,3,4,
Delaware,U.S. Senate,Eric Mccray,REP,210023,1,0,0,1,
Delaware,U.S. Senate,Kevin Crow,REP,210023,1,0,2,3,
Delaware,U.S. Senate,James Lankford,REP,210023,4,0,31,35,
Delaware,U.S. Senate,Jason Weger,REP,210023,1,0,0,1,
Delaware,U.S. House,Darrel Robertson,REP,210023,4,0,6,10,02
Delaware,U.S. House,Markwayne Mullin,REP,210023,5,0,76,81,02
Dewey,Superintendent of Public Instruction,John Cox,DEM,220001,0,3,34,37,
Dewey,Superintendent of Public Instruction,Jack Jr.,DEM,220001,0,0,5,5,
Dewey,Superintendent of Public Instruction,Ivan Holmes,DEM,220001,0,0,16,16,
Dewey,Superintendent of Public Instruction,Freda Deskin,DEM,220001,1,3,21,25,
Dewey,U.S. Senate,Patrick Michael Hayes,DEM,220001,0,1,16,17,
Dewey,U.S. Senate,Jim Rogers,DEM,220001,0,2,36,38,
Dewey,U.S. Senate,Connie Johnson,DEM,220001,1,3,22,26,
Dewey,Governor,Dax Ewbank,REP,220001,0,0,19,19,
Dewey,Governor,Chad Moody,REP,220001,0,0,4,4,
Dewey,Governor,Mary Fallin,REP,220001,0,3,25,28,
Dewey,Superintendent of Public Instruction,Brian Kelly,REP,220001,0,3,13,16,
Dewey,Superintendent of Public Instruction,Janet Costello Barresi,REP,220001,0,0,8,8,
Dewey,Superintendent of Public Instruction,Joy Hofmeister,REP,220001,0,0,27,27,
Dewey,Insurance Commissioner,Bill Viner,REP,220001,0,1,12,13,
Dewey,Insurance Commissioner,John Doak,REP,220001,0,2,33,35,
Dewey,Corporation Commissioner,Todd Hiett,REP,220001,0,1,27,28,
Dewey,Corporation Commissioner,Cliff Branan,REP,220001,0,1,21,22,
Dewey,U.S. Senate,Evelyn Rogers,REP,220001,0,1,1,2,
Dewey,U.S. Senate,Rob Moye,REP,220001,0,0,0,0,
Dewey,U.S. Senate,D. Jean Mcbride-Samuels,REP,220001,0,0,0,0,
Dewey,U.S. Senate,Jim Inhofe,REP,220001,0,1,43,44,
Dewey,U.S. Senate,Erick Paul Wyatt,REP,220001,0,1,4,5,
Dewey,U.S. Senate,Andy Craig,REP,220001,0,1,0,1,
Dewey,U.S. Senate,T. Shannon,REP,220001,0,0,21,21,
Dewey,U.S. Senate,Randy Brogdon,REP,220001,0,0,1,1,
Dewey,U.S. Senate,Eric Mccray,REP,220001,0,0,1,1,
Dewey,U.S. Senate,Kevin Crow,REP,220001,0,0,1,1,
Dewey,U.S. Senate,James Lankford,REP,220001,0,2,23,25,
Dewey,U.S. Senate,Jason Weger,REP,220001,0,0,1,1,
Dewey,U.S. House,Timothy Ray Murray,REP,220001,0,0,2,2,03
Dewey,U.S. House,Robert Hubbard,REP,220001,0,1,11,12,03
Dewey,U.S. House,Frank Lucas,REP,220001,0,2,36,38,03
Dewey,Superintendent of Public Instruction,John Cox,DEM,220002,2,0,7,9,
Dewey,Superintendent of Public Instruction,Jack Jr.,DEM,220002,0,0,4,4,
Dewey,Superintendent of Public Instruction,Ivan Holmes,DEM,220002,0,0,1,1,
Dewey,Superintendent of Public Instruction,Freda Deskin,DEM,220002,0,0,4,4,
Dewey,U.S. Senate,Patrick Michael Hayes,DEM,220002,0,0,1,1,
Dewey,U.S. Senate,Jim Rogers,DEM,220002,0,0,8,8,
Dewey,U.S. Senate,Connie Johnson,DEM,220002,2,0,7,9,
Dewey,Governor,Dax Ewbank,REP,220002,0,0,1,1,
Dewey,Governor,Chad Moody,REP,220002,0,0,1,1,
Dewey,Governor,Mary Fallin,REP,220002,2,0,22,24,
Dewey,Superintendent of Public Instruction,Brian Kelly,REP,220002,1,0,5,6,
Dewey,Superintendent of Public Instruction,Janet Costello Barresi,REP,220002,0,0,5,5,
Dewey,Superintendent of Public Instruction,Joy Hofmeister,REP,220002,1,1,14,16,
Dewey,Insurance Commissioner,Bill Viner,REP,220002,0,0,4,4,
Dewey,Insurance Commissioner,John Doak,REP,220002,2,0,20,22,
Dewey,Corporation Commissioner,Todd Hiett,REP,220002,2,0,13,15,
Dewey,Corporation Commissioner,Cliff Branan,REP,220002,0,1,11,12,
Dewey,U.S. Senate,Evelyn Rogers,REP,220002,1,0,2,3,
Dewey,U.S. Senate,Rob Moye,REP,220002,0,0,0,0,
Dewey,U.S. Senate,D. Jean Mcbride-Samuels,REP,220002,0,0,0,0,
Dewey,U.S. Senate,Jim Inhofe,REP,220002,1,1,20,22,
Dewey,U.S. Senate,Erick Paul Wyatt,REP,220002,0,0,2,2,
Dewey,U.S. Senate,Andy Craig,REP,220002,0,0,0,0,
Dewey,U.S. Senate,T. Shannon,REP,220002,1,0,7,8,
Dewey,U.S. Senate,Randy Brogdon,REP,220002,0,0,0,0,
Dewey,U.S. Senate,Eric Mccray,REP,220002,0,0,0,0,
Dewey,U.S. Senate,Kevin Crow,REP,220002,0,0,0,0,
Dewey,U.S. Senate,James Lankford,REP,220002,1,1,17,19,
Dewey,U.S. Senate,Jason Weger,REP,220002,0,0,0,0,
Dewey,U.S. House,Timothy Ray Murray,REP,220002,1,0,1,2,03
Dewey,U.S. House,Robert Hubbard,REP,220002,0,0,3,3,03
Dewey,U.S. House,Frank Lucas,REP,220002,1,1,20,22,03
Dewey,Superintendent of Public Instruction,John Cox,DEM,220003,0,0,51,51,
Dewey,Superintendent of Public Instruction,Jack Jr.,DEM,220003,0,0,8,8,
Dewey,Superintendent of Public Instruction,Ivan Holmes,DEM,220003,0,0,8,8,
Dewey,Superintendent of Public Instruction,Freda Deskin,DEM,220003,1,0,25,26,
Dewey,U.S. Senate,Patrick Michael Hayes,DEM,220003,0,0,22,22,
Dewey,U.S. Senate,Jim Rogers,DEM,220003,0,0,43,43,
Dewey,U.S. Senate,Connie Johnson,DEM,220003,1,0,24,25,
Dewey,Governor,Dax Ewbank,REP,220003,2,0,9,11,
Dewey,Governor,Chad Moody,REP,220003,2,0,4,6,
Dewey,Governor,Mary Fallin,REP,220003,0,0,47,47,
Dewey,Superintendent of Public Instruction,Brian Kelly,REP,220003,4,0,12,16,
Dewey,Superintendent of Public Instruction,Janet Costello Barresi,REP,220003,0,0,2,2,
Dewey,Superintendent of Public Instruction,Joy Hofmeister,REP,220003,0,0,48,48,
Dewey,Insurance Commissioner,Bill Viner,REP,220003,0,0,12,12,
Dewey,Insurance Commissioner,John Doak,REP,220003,4,0,42,46,
Dewey,Corporation Commissioner,Todd Hiett,REP,220003,3,0,36,39,
Dewey,Corporation Commissioner,Cliff Branan,REP,220003,1,0,20,21,
Dewey,U.S. Senate,Evelyn Rogers,REP,220003,0,0,2,2,
Dewey,U.S. Senate,Rob Moye,REP,220003,1,0,0,1,
Dewey,U.S. Senate,D. Jean Mcbride-Samuels,REP,220003,0,0,0,0,
Dewey,U.S. Senate,Jim Inhofe,REP,220003,2,0,55,57,
Dewey,U.S. Senate,Erick Paul Wyatt,REP,220003,1,0,3,4,
Dewey,U.S. Senate,Andy Craig,REP,220003,0,0,0,0,
Dewey,U.S. Senate,T. Shannon,REP,220003,0,0,30,30,
Dewey,U.S. Senate,Randy Brogdon,REP,220003,0,0,0,0,
Dewey,U.S. Senate,Eric Mccray,REP,220003,0,0,1,1,
Dewey,U.S. Senate,Kevin Crow,REP,220003,0,0,0,0,
Dewey,U.S. Senate,James Lankford,REP,220003,4,0,32,36,
Dewey,U.S. Senate,Jason Weger,REP,220003,0,0,0,0,
Dewey,U.S. House,Timothy Ray Murray,REP,220003,2,0,4,6,03
Dewey,U.S. House,Robert Hubbard,REP,220003,2,0,13,15,03
Dewey,U.S. House,Frank Lucas,REP,220003,0,0,46,46,03
Dewey,Superintendent of Public Instruction,John Cox,DEM,220004,0,0,13,13,
Dewey,Superintendent of Public Instruction,Jack Jr.,DEM,220004,0,0,2,2,
Dewey,Superintendent of Public Instruction,Ivan Holmes,DEM,220004,0,0,0,0,
Dewey,Superintendent of Public Instruction,Freda Deskin,DEM,220004,0,0,12,12,
Dewey,U.S. Senate,Patrick Michael Hayes,DEM,220004,0,0,8,8,
Dewey,U.S. Senate,Jim Rogers,DEM,220004,0,0,8,8,
Dewey,U.S. Senate,Connie Johnson,DEM,220004,0,0,9,9,
Dewey,Governor,Dax Ewbank,REP,220004,0,0,9,9,
Dewey,Governor,Chad Moody,REP,220004,0,0,5,5,
Dewey,Governor,Mary Fallin,REP,220004,2,0,16,18,
Dewey,Superintendent of Public Instruction,Brian Kelly,REP,220004,0,0,8,8,
Dewey,Superintendent of Public Instruction,Janet Costello Barresi,REP,220004,2,0,5,7,
Dewey,Superintendent of Public Instruction,Joy Hofmeister,REP,220004,0,0,17,17,
Dewey,Insurance Commissioner,Bill Viner,REP,220004,0,0,5,5,
Dewey,Insurance Commissioner,John Doak,REP,220004,2,0,24,26,
Dewey,Corporation Commissioner,Todd Hiett,REP,220004,1,0,18,19,
Dewey,Corporation Commissioner,Cliff Branan,REP,220004,1,0,10,11,
Dewey,U.S. Senate,Evelyn Rogers,REP,220004,0,0,1,1,
Dewey,U.S. Senate,Rob Moye,REP,220004,0,0,0,0,
Dewey,U.S. Senate,D. Jean Mcbride-Samuels,REP,220004,0,0,0,0,
Dewey,U.S. Senate,Jim Inhofe,REP,220004,2,0,28,30,
Dewey,U.S. Senate,Erick Paul Wyatt,REP,220004,0,0,1,1,
Dewey,U.S. Senate,Andy Craig,REP,220004,0,0,0,0,
Dewey,U.S. Senate,T. Shannon,REP,220004,1,0,9,10,
Dewey,U.S. Senate,Randy Brogdon,REP,220004,0,0,0,0,
Dewey,U.S. Senate,Eric Mccray,REP,220004,0,0,0,0,
Dewey,U.S. Senate,Kevin Crow,REP,220004,0,0,0,0,
Dewey,U.S. Senate,James Lankford,REP,220004,1,0,22,23,
Dewey,U.S. Senate,Jason Weger,REP,220004,0,0,0,0,
Dewey,U.S. House,Timothy Ray Murray,REP,220004,0,0,1,1,03
Dewey,U.S. House,Robert Hubbard,REP,220004,1,0,7,8,03
Dewey,U.S. House,Frank Lucas,REP,220004,1,0,23,24,03
Dewey,Superintendent of Public Instruction,John Cox,DEM,220005,2,1,37,40,
Dewey,Superintendent of Public Instruction,Jack Jr.,DEM,220005,0,2,4,6,
Dewey,Superintendent of Public Instruction,Ivan Holmes,DEM,220005,0,0,3,3,
Dewey,Superintendent of Public Instruction,Freda Deskin,DEM,220005,0,0,25,25,
Dewey,U.S. Senate,Patrick Michael Hayes,DEM,220005,1,1,15,17,
Dewey,U.S. Senate,Jim Rogers,DEM,220005,0,0,29,29,
Dewey,U.S. Senate,Connie Johnson,DEM,220005,1,0,19,20,
Dewey,Governor,Dax Ewbank,REP,220005,1,6,24,31,
Dewey,Governor,Chad Moody,REP,220005,1,2,16,19,
Dewey,Governor,Mary Fallin,REP,220005,6,6,89,101,
Dewey,Superintendent of Public Instruction,Brian Kelly,REP,220005,2,5,45,52,
Dewey,Superintendent of Public Instruction,Janet Costello Barresi,REP,220005,2,2,14,18,
Dewey,Superintendent of Public Instruction,Joy Hofmeister,REP,220005,4,7,69,80,
Dewey,Insurance Commissioner,Bill Viner,REP,220005,2,3,25,30,
Dewey,Insurance Commissioner,John Doak,REP,220005,6,10,97,113,
Dewey,Corporation Commissioner,Todd Hiett,REP,220005,3,6,60,69,
Dewey,Corporation Commissioner,Cliff Branan,REP,220005,5,7,63,75,
Dewey,U.S. Senate,Evelyn Rogers,REP,220005,1,0,1,2,
Dewey,U.S. Senate,Rob Moye,REP,220005,0,0,5,5,
Dewey,U.S. Senate,D. Jean Mcbride-Samuels,REP,220005,0,0,1,1,
Dewey,U.S. Senate,Jim Inhofe,REP,220005,7,14,114,135,
Dewey,U.S. Senate,Erick Paul Wyatt,REP,220005,0,0,8,8,
Dewey,U.S. Senate,Andy Craig,REP,220005,0,0,0,0,
Dewey,U.S. Senate,T. Shannon,REP,220005,3,12,57,72,
Dewey,U.S. Senate,Randy Brogdon,REP,220005,1,0,1,2,
Dewey,U.S. Senate,Eric Mccray,REP,220005,0,0,0,0,
Dewey,U.S. Senate,Kevin Crow,REP,220005,0,0,7,7,
Dewey,U.S. Senate,James Lankford,REP,220005,4,2,63,69,
Dewey,U.S. Senate,Jason Weger,REP,220005,0,0,0,0,
Dewey,U.S. House,Timothy Ray Murray,REP,220005,0,2,5,7,03
Dewey,U.S. House,Robert Hubbard,REP,220005,0,0,12,12,03
Dewey,U.S. House,Frank Lucas,REP,220005,8,12,114,134,03
Dewey,Superintendent of Public Instruction,John Cox,DEM,220007,0,0,3,3,
Dewey,Superintendent of Public Instruction,Jack Jr.,DEM,220007,0,0,2,2,
Dewey,Superintendent of Public Instruction,Ivan Holmes,DEM,220007,0,0,2,2,
Dewey,Superintendent of Public Instruction,Freda Deskin,DEM,220007,0,0,8,8,
Dewey,U.S. Senate,Patrick Michael Hayes,DEM,220007,0,0,4,4,
Dewey,U.S. Senate,Jim Rogers,DEM,220007,0,0,7,7,
Dewey,U.S. Senate,Connie Johnson,DEM,220007,0,0,3,3,
Dewey,Governor,Dax Ewbank,REP,220007,0,1,12,13,
Dewey,Governor,Chad Moody,REP,220007,0,0,2,2,
Dewey,Governor,Mary Fallin,REP,220007,0,0,15,15,
Dewey,Superintendent of Public Instruction,Brian Kelly,REP,220007,0,0,8,8,
Dewey,Superintendent of Public Instruction,Janet Costello Barresi,REP,220007,0,0,3,3,
Dewey,Superintendent of Public Instruction,Joy Hofmeister,REP,220007,0,1,17,18,
Dewey,Insurance Commissioner,Bill Viner,REP,220007,0,0,4,4,
Dewey,Insurance Commissioner,John Doak,REP,220007,0,1,23,24,
Dewey,Corporation Commissioner,Todd Hiett,REP,220007,0,1,15,16,
Dewey,Corporation Commissioner,Cliff Branan,REP,220007,0,0,13,13,
Dewey,U.S. Senate,Evelyn Rogers,REP,220007,0,0,1,1,
Dewey,U.S. Senate,Rob Moye,REP,220007,0,0,0,0,
Dewey,U.S. Senate,D. Jean Mcbride-Samuels,REP,220007,0,0,0,0,
Dewey,U.S. Senate,Jim Inhofe,REP,220007,0,1,27,28,
Dewey,U.S. Senate,Erick Paul Wyatt,REP,220007,0,0,1,1,
Dewey,U.S. Senate,Andy Craig,REP,220007,0,0,0,0,
Dewey,U.S. Senate,T. Shannon,REP,220007,0,1,11,12,
Dewey,U.S. Senate,Randy Brogdon,REP,220007,0,0,0,0,
Dewey,U.S. Senate,Eric Mccray,REP,220007,0,0,0,0,
Dewey,U.S. Senate,Kevin Crow,REP,220007,0,0,0,0,
Dewey,U.S. Senate,James Lankford,REP,220007,0,0,17,17,
Dewey,U.S. Senate,Jason Weger,REP,220007,0,0,0,0,
Dewey,U.S. House,Timothy Ray Murray,REP,220007,0,0,0,0,03
Dewey,U.S. House,Robert Hubbard,REP,220007,0,0,2,2,03
Dewey,U.S. House,Frank Lucas,REP,220007,0,1,27,28,03
Dewey,Superintendent of Public Instruction,John Cox,DEM,220008,2,1,20,23,
Dewey,Superintendent of Public Instruction,Jack Jr.,DEM,220008,1,0,10,11,
Dewey,Superintendent of Public Instruction,Ivan Holmes,DEM,220008,0,0,10,10,
Dewey,Superintendent of Public Instruction,Freda Deskin,DEM,220008,3,0,18,21,
Dewey,U.S. Senate,Patrick Michael Hayes,DEM,220008,4,1,15,20,
Dewey,U.S. Senate,Jim Rogers,DEM,220008,1,0,20,21,
Dewey,U.S. Senate,Connie Johnson,DEM,220008,1,0,20,21,
Dewey,Governor,Dax Ewbank,REP,220008,0,5,63,68,
Dewey,Governor,Chad Moody,REP,220008,1,0,17,18,
Dewey,Governor,Mary Fallin,REP,220008,6,1,63,70,
Dewey,Superintendent of Public Instruction,Brian Kelly,REP,220008,3,0,41,44,
Dewey,Superintendent of Public Instruction,Janet Costello Barresi,REP,220008,0,0,10,10,
Dewey,Superintendent of Public Instruction,Joy Hofmeister,REP,220008,3,6,92,101,
Dewey,Insurance Commissioner,Bill Viner,REP,220008,0,1,24,25,
Dewey,Insurance Commissioner,John Doak,REP,220008,5,5,116,126,
Dewey,Corporation Commissioner,Todd Hiett,REP,220008,2,3,85,90,
Dewey,Corporation Commissioner,Cliff Branan,REP,220008,0,3,55,58,
Dewey,U.S. Senate,Evelyn Rogers,REP,220008,0,0,3,3,
Dewey,U.S. Senate,Rob Moye,REP,220008,0,0,1,1,
Dewey,U.S. Senate,D. Jean Mcbride-Samuels,REP,220008,0,0,2,2,
Dewey,U.S. Senate,Jim Inhofe,REP,220008,7,5,134,146,
Dewey,U.S. Senate,Erick Paul Wyatt,REP,220008,0,1,3,4,
Dewey,U.S. Senate,Andy Craig,REP,220008,0,0,0,0,
Dewey,U.S. Senate,T. Shannon,REP,220008,0,5,60,65,
Dewey,U.S. Senate,Randy Brogdon,REP,220008,0,0,2,2,
Dewey,U.S. Senate,Eric Mccray,REP,220008,0,0,3,3,
Dewey,U.S. Senate,Kevin Crow,REP,220008,0,0,5,5,
Dewey,U.S. Senate,James Lankford,REP,220008,4,1,73,78,
Dewey,U.S. Senate,Jason Weger,REP,220008,0,0,0,0,
Dewey,U.S. House,Timothy Ray Murray,REP,220008,0,0,1,1,03
Dewey,U.S. House,Robert Hubbard,REP,220008,0,0,15,15,03
Dewey,U.S. House,Frank Lucas,REP,220008,7,6,125,138,03
Dewey,Superintendent of Public Instruction,John Cox,DEM,220009,1,1,11,13,
Dewey,Superintendent of Public Instruction,Jack Jr.,DEM,220009,1,0,6,7,
Dewey,Superintendent of Public Instruction,Ivan Holmes,DEM,220009,0,0,0,0,
Dewey,Superintendent of Public Instruction,Freda Deskin,DEM,220009,1,0,8,9,
Dewey,U.S. Senate,Patrick Michael Hayes,DEM,220009,0,0,7,7,
Dewey,U.S. Senate,Jim Rogers,DEM,220009,1,0,12,13,
Dewey,U.S. Senate,Connie Johnson,DEM,220009,2,1,4,7,
Dewey,Governor,Dax Ewbank,REP,220009,0,0,8,8,
Dewey,Governor,Chad Moody,REP,220009,0,0,2,2,
Dewey,Governor,Mary Fallin,REP,220009,0,2,36,38,
Dewey,Superintendent of Public Instruction,Brian Kelly,REP,220009,0,0,10,10,
Dewey,Superintendent of Public Instruction,Janet Costello Barresi,REP,220009,0,0,7,7,
Dewey,Superintendent of Public Instruction,Joy Hofmeister,REP,220009,0,2,27,29,
Dewey,Insurance Commissioner,Bill Viner,REP,220009,0,0,7,7,
Dewey,Insurance Commissioner,John Doak,REP,220009,0,2,38,40,
Dewey,Corporation Commissioner,Todd Hiett,REP,220009,0,1,26,27,
Dewey,Corporation Commissioner,Cliff Branan,REP,220009,0,1,18,19,
Dewey,U.S. Senate,Evelyn Rogers,REP,220009,0,0,1,1,
Dewey,U.S. Senate,Rob Moye,REP,220009,0,1,1,2,
Dewey,U.S. Senate,D. Jean Mcbride-Samuels,REP,220009,0,0,0,0,
Dewey,U.S. Senate,Jim Inhofe,REP,220009,0,1,42,43,
Dewey,U.S. Senate,Erick Paul Wyatt,REP,220009,0,0,1,1,
Dewey,U.S. Senate,Andy Craig,REP,220009,0,0,0,0,
Dewey,U.S. Senate,T. Shannon,REP,220009,0,0,15,15,
Dewey,U.S. Senate,Randy Brogdon,REP,220009,0,0,2,2,
Dewey,U.S. Senate,Eric Mccray,REP,220009,0,0,1,1,
Dewey,U.S. Senate,Kevin Crow,REP,220009,0,0,0,0,
Dewey,U.S. Senate,James Lankford,REP,220009,0,2,28,30,
Dewey,U.S. Senate,Jason Weger,REP,220009,0,0,0,0,
Dewey,U.S. House,Timothy Ray Murray,REP,220009,0,0,1,1,03
Dewey,U.S. House,Robert Hubbard,REP,220009,0,1,2,3,03
Dewey,U.S. House,Frank Lucas,REP,220009,0,1,43,44,03
Dewey,Superintendent of Public Instruction,John Cox,DEM,220010,0,0,6,6,
Dewey,Superintendent of Public Instruction,Jack Jr.,DEM,220010,0,0,0,0,
Dewey,Superintendent of Public Instruction,Ivan Holmes,DEM,220010,1,0,3,4,
Dewey,Superintendent of Public Instruction,Freda Deskin,DEM,220010,0,0,5,5,
Dewey,U.S. Senate,Patrick Michael Hayes,DEM,220010,0,0,1,1,
Dewey,U.S. Senate,Jim Rogers,DEM,220010,0,0,5,5,
Dewey,U.S. Senate,Connie Johnson,DEM,220010,0,0,6,6,
Dewey,Governor,Dax Ewbank,REP,220010,0,0,0,0,
Dewey,Governor,Chad Moody,REP,220010,0,0,1,1,
Dewey,Governor,Mary Fallin,REP,220010,2,0,7,9,
Dewey,Superintendent of Public Instruction,Brian Kelly,REP,220010,1,0,1,2,
Dewey,Superintendent of Public Instruction,Janet Costello Barresi,REP,220010,0,0,0,0,
Dewey,Superintendent of Public Instruction,Joy Hofmeister,REP,220010,1,0,7,8,
Dewey,Insurance Commissioner,Bill Viner,REP,220010,0,0,2,2,
Dewey,Insurance Commissioner,John Doak,REP,220010,2,0,6,8,
Dewey,Corporation Commissioner,Todd Hiett,REP,220010,1,0,4,5,
Dewey,Corporation Commissioner,Cliff Branan,REP,220010,1,0,4,5,
Dewey,U.S. Senate,Evelyn Rogers,REP,220010,0,0,0,0,
Dewey,U.S. Senate,Rob Moye,REP,220010,0,0,0,0,
Dewey,U.S. Senate,D. Jean Mcbride-Samuels,REP,220010,0,0,0,0,
Dewey,U.S. Senate,Jim Inhofe,REP,220010,1,0,8,9,
Dewey,U.S. Senate,Erick Paul Wyatt,REP,220010,1,0,0,1,
Dewey,U.S. Senate,Andy Craig,REP,220010,0,0,0,0,
Dewey,U.S. Senate,T. Shannon,REP,220010,1,0,4,5,
Dewey,U.S. Senate,Randy Brogdon,REP,220010,0,0,1,1,
Dewey,U.S. Senate,Eric Mccray,REP,220010,0,0,0,0,
Dewey,U.S. Senate,Kevin Crow,REP,220010,0,0,0,0,
Dewey,U.S. Senate,James Lankford,REP,220010,1,0,3,4,
Dewey,U.S. Senate,Jason Weger,REP,220010,0,0,0,0,
Dewey,U.S. House,Timothy Ray Murray,REP,220010,0,0,0,0,03
Dewey,U.S. House,Robert Hubbard,REP,220010,0,0,4,4,03
Dewey,U.S. House,Frank Lucas,REP,220010,2,0,4,6,03
Ellis,Superintendent of Public Instruction,John Cox,DEM,230001,0,3,24,27,
Ellis,Superintendent of Public Instruction,Jack Jr.,DEM,230001,0,1,7,8,
Ellis,Superintendent of Public Instruction,Ivan Holmes,DEM,230001,0,0,5,5,
Ellis,Superintendent of Public Instruction,Freda Deskin,DEM,230001,0,2,25,27,
Ellis,U.S. Senate,Patrick Michael Hayes,DEM,230001,0,1,12,13,
Ellis,U.S. Senate,Jim Rogers,DEM,230001,0,1,30,31,
Ellis,U.S. Senate,Connie Johnson,DEM,230001,0,2,19,21,
Ellis,Governor,Dax Ewbank,REP,230001,0,2,10,12,
Ellis,Governor,Chad Moody,REP,230001,2,5,17,24,
Ellis,Governor,Mary Fallin,REP,230001,6,8,77,91,
Ellis,Superintendent of Public Instruction,Brian Kelly,REP,230001,3,5,22,30,
Ellis,Superintendent of Public Instruction,Janet Costello Barresi,REP,230001,2,2,10,14,
Ellis,Superintendent of Public Instruction,Joy Hofmeister,REP,230001,3,8,71,82,
Ellis,Insurance Commissioner,Bill Viner,REP,230001,2,3,19,24,
Ellis,Insurance Commissioner,John Doak,REP,230001,6,12,78,96,
Ellis,Corporation Commissioner,Todd Hiett,REP,230001,7,7,47,61,
Ellis,Corporation Commissioner,Cliff Branan,REP,230001,1,7,51,59,
Ellis,U.S. Senate,Evelyn Rogers,REP,230001,0,1,5,6,
Ellis,U.S. Senate,Rob Moye,REP,230001,0,1,1,2,
Ellis,U.S. Senate,D. Jean Mcbride-Samuels,REP,230001,0,0,2,2,
Ellis,U.S. Senate,Jim Inhofe,REP,230001,8,10,92,110,
Ellis,U.S. Senate,Erick Paul Wyatt,REP,230001,0,3,4,7,
Ellis,U.S. Senate,Andy Craig,REP,230001,0,0,0,0,
Ellis,U.S. Senate,T. Shannon,REP,230001,3,5,28,36,
Ellis,U.S. Senate,Randy Brogdon,REP,230001,0,1,1,2,
Ellis,U.S. Senate,Eric Mccray,REP,230001,1,0,4,5,
Ellis,U.S. Senate,Kevin Crow,REP,230001,1,0,2,3,
Ellis,U.S. Senate,James Lankford,REP,230001,3,7,68,78,
Ellis,U.S. Senate,Jason Weger,REP,230001,0,2,1,3,
Ellis,U.S. House,Timothy Ray Murray,REP,230001,1,2,5,8,03
Ellis,U.S. House,Robert Hubbard,REP,230001,0,4,13,17,03
Ellis,U.S. House,Frank Lucas,REP,230001,7,9,84,100,03
Ellis,State House,Casey Murdock,REP,230001,4,10,41,55,61
Ellis,State House,David Elder,REP,230001,1,0,16,17,61
Ellis,State House,Steve Moore,REP,230001,0,1,8,9,61
Ellis,State House,Kenny Bob Tapp,REP,230001,3,3,33,39,61
Ellis,State House,Larry Swager,REP,230001,0,1,2,3,61
Ellis,Superintendent of Public Instruction,John Cox,DEM,230003,1,0,18,19,
Ellis,Superintendent of Public Instruction,Jack Jr.,DEM,230003,0,0,5,5,
Ellis,Superintendent of Public Instruction,Ivan Holmes,DEM,230003,1,0,1,2,
Ellis,Superintendent of Public Instruction,Freda Deskin,DEM,230003,0,0,13,13,
Ellis,U.S. Senate,Patrick Michael Hayes,DEM,230003,0,0,14,14,
Ellis,U.S. Senate,Jim Rogers,DEM,230003,2,0,12,14,
Ellis,U.S. Senate,Connie Johnson,DEM,230003,0,0,11,11,
Ellis,Governor,Dax Ewbank,REP,230003,2,1,17,20,
Ellis,Governor,Chad Moody,REP,230003,0,3,45,48,
Ellis,Governor,Mary Fallin,REP,230003,7,3,133,143,
Ellis,Superintendent of Public Instruction,Brian Kelly,REP,230003,1,2,44,47,
Ellis,Superintendent of Public Instruction,Janet Costello Barresi,REP,230003,2,0,14,16,
Ellis,Superintendent of Public Instruction,Joy Hofmeister,REP,230003,6,5,137,148,
Ellis,Insurance Commissioner,Bill Viner,REP,230003,2,1,43,46,
Ellis,Insurance Commissioner,John Doak,REP,230003,7,5,144,156,
Ellis,Corporation Commissioner,Todd Hiett,REP,230003,9,4,108,121,
Ellis,Corporation Commissioner,Cliff Branan,REP,230003,0,3,80,83,
Ellis,U.S. Senate,Evelyn Rogers,REP,230003,1,1,10,12,
Ellis,U.S. Senate,Rob Moye,REP,230003,0,0,3,3,
Ellis,U.S. Senate,D. Jean Mcbride-Samuels,REP,230003,0,0,3,3,
Ellis,U.S. Senate,Jim Inhofe,REP,230003,8,6,167,181,
Ellis,U.S. Senate,Erick Paul Wyatt,REP,230003,0,0,11,11,
Ellis,U.S. Senate,Andy Craig,REP,230003,0,0,0,0,
Ellis,U.S. Senate,T. Shannon,REP,230003,1,2,88,91,
Ellis,U.S. Senate,Randy Brogdon,REP,230003,1,0,4,5,
Ellis,U.S. Senate,Eric Mccray,REP,230003,0,0,1,1,
Ellis,U.S. Senate,Kevin Crow,REP,230003,0,0,1,1,
Ellis,U.S. Senate,James Lankford,REP,230003,7,5,100,112,
Ellis,U.S. Senate,Jason Weger,REP,230003,0,0,1,1,
Ellis,U.S. House,Timothy Ray Murray,REP,230003,0,2,25,27,03
Ellis,U.S. House,Robert Hubbard,REP,230003,0,1,33,34,03
Ellis,U.S. House,Frank Lucas,REP,230003,9,4,138,151,03
Ellis,State House,Casey Murdock,REP,230003,6,4,101,111,61
Ellis,State House,David Elder,REP,230003,1,1,8,10,61
Ellis,State House,Steve Moore,REP,230003,1,2,22,25,61
Ellis,State House,Kenny Bob Tapp,REP,230003,1,0,56,57,61
Ellis,State House,Larry Swager,REP,230003,0,0,9,9,61
Ellis,Superintendent of Public Instruction,John Cox,DEM,230004,0,0,6,6,
Ellis,Superintendent of Public Instruction,Jack Jr.,DEM,230004,0,0,0,0,
Ellis,Superintendent of Public Instruction,Ivan Holmes,DEM,230004,0,0,1,1,
Ellis,Superintendent of Public Instruction,Freda Deskin,DEM,230004,0,0,1,1,
Ellis,U.S. Senate,Patrick Michael Hayes,DEM,230004,0,0,0,0,
Ellis,U.S. Senate,Jim Rogers,DEM,230004,0,0,5,5,
Ellis,U.S. Senate,Connie Johnson,DEM,230004,0,0,3,3,
Ellis,Governor,Dax Ewbank,REP,230004,0,0,4,4,
Ellis,Governor,Chad Moody,REP,230004,0,0,5,5,
Ellis,Governor,Mary Fallin,REP,230004,2,0,28,30,
Ellis,Superintendent of Public Instruction,Brian Kelly,REP,230004,0,0,10,10,
Ellis,Superintendent of Public Instruction,Janet Costello Barresi,REP,230004,0,0,4,4,
Ellis,Superintendent of Public Instruction,Joy Hofmeister,REP,230004,2,0,22,24,
Ellis,Insurance Commissioner,Bill Viner,REP,230004,0,0,12,12,
Ellis,Insurance Commissioner,John Doak,REP,230004,2,0,23,25,
Ellis,Corporation Commissioner,Todd Hiett,REP,230004,0,0,16,16,
Ellis,Corporation Commissioner,Cliff Branan,REP,230004,2,0,21,23,
Ellis,U.S. Senate,Evelyn Rogers,REP,230004,0,0,1,1,
Ellis,U.S. Senate,Rob Moye,REP,230004,0,0,0,0,
Ellis,U.S. Senate,D. Jean Mcbride-Samuels,REP,230004,0,0,1,1,
Ellis,U.S. Senate,Jim Inhofe,REP,230004,2,0,33,35,
Ellis,U.S. Senate,Erick Paul Wyatt,REP,230004,0,0,2,2,
Ellis,U.S. Senate,Andy Craig,REP,230004,0,0,0,0,
Ellis,U.S. Senate,T. Shannon,REP,230004,0,0,19,19,
Ellis,U.S. Senate,Randy Brogdon,REP,230004,0,0,2,2,
Ellis,U.S. Senate,Eric Mccray,REP,230004,0,0,0,0,
Ellis,U.S. Senate,Kevin Crow,REP,230004,0,0,1,1,
Ellis,U.S. Senate,James Lankford,REP,230004,2,0,15,17,
Ellis,U.S. Senate,Jason Weger,REP,230004,0,0,0,0,
Ellis,U.S. House,Timothy Ray Murray,REP,230004,0,0,4,4,03
Ellis,U.S. House,Robert Hubbard,REP,230004,0,0,4,4,03
Ellis,U.S. House,Frank Lucas,REP,230004,2,0,29,31,03
Ellis,State House,Casey Murdock,REP,230004,0,0,16,16,61
Ellis,State House,David Elder,REP,230004,0,0,3,3,61
Ellis,State House,Steve Moore,REP,230004,2,0,4,6,61
Ellis,State House,Kenny Bob Tapp,REP,230004,0,0,12,12,61
Ellis,State House,Larry Swager,REP,230004,0,0,1,1,61
Ellis,Superintendent of Public Instruction,John Cox,DEM,230006,0,0,0,0,
Ellis,Superintendent of Public Instruction,Jack Jr.,DEM,230006,0,0,1,1,
Ellis,Superintendent of Public Instruction,Ivan Holmes,DEM,230006,0,0,1,1,
Ellis,Superintendent of Public Instruction,Freda Deskin,DEM,230006,1,0,1,2,
Ellis,U.S. Senate,Patrick Michael Hayes,DEM,230006,0,0,1,1,
Ellis,U.S. Senate,Jim Rogers,DEM,230006,1,0,1,2,
Ellis,U.S. Senate,Connie Johnson,DEM,230006,0,0,1,1,
Ellis,Governor,Dax Ewbank,REP,230006,0,0,1,1,
Ellis,Governor,Chad Moody,REP,230006,1,0,1,2,
Ellis,Governor,Mary Fallin,REP,230006,0,0,12,12,
Ellis,Superintendent of Public Instruction,Brian Kelly,REP,230006,0,0,3,3,
Ellis,Superintendent of Public Instruction,Janet Costello Barresi,REP,230006,1,0,0,1,
Ellis,Superintendent of Public Instruction,Joy Hofmeister,REP,230006,0,0,11,11,
Ellis,Insurance Commissioner,Bill Viner,REP,230006,0,0,5,5,
Ellis,Insurance Commissioner,John Doak,REP,230006,1,0,8,9,
Ellis,Corporation Commissioner,Todd Hiett,REP,230006,1,0,7,8,
Ellis,Corporation Commissioner,Cliff Branan,REP,230006,0,0,7,7,
Ellis,U.S. Senate,Evelyn Rogers,REP,230006,0,0,0,0,
Ellis,U.S. Senate,Rob Moye,REP,230006,0,0,0,0,
Ellis,U.S. Senate,D. Jean Mcbride-Samuels,REP,230006,0,0,0,0,
Ellis,U.S. Senate,Jim Inhofe,REP,230006,1,0,13,14,
Ellis,U.S. Senate,Erick Paul Wyatt,REP,230006,0,0,1,1,
Ellis,U.S. Senate,Andy Craig,REP,230006,0,0,0,0,
Ellis,U.S. Senate,T. Shannon,REP,230006,0,0,4,4,
Ellis,U.S. Senate,Randy Brogdon,REP,230006,0,0,0,0,
Ellis,U.S. Senate,Eric Mccray,REP,230006,0,0,0,0,
Ellis,U.S. Senate,Kevin Crow,REP,230006,0,0,0,0,
Ellis,U.S. Senate,James Lankford,REP,230006,1,0,10,11,
Ellis,U.S. Senate,Jason Weger,REP,230006,0,0,0,0,
Ellis,U.S. House,Timothy Ray Murray,REP,230006,0,0,1,1,03
Ellis,U.S. House,Robert Hubbard,REP,230006,0,0,0,0,03
Ellis,U.S. House,Frank Lucas,REP,230006,1,0,13,14,03
Ellis,State House,Casey Murdock,REP,230006,1,0,8,9,61
Ellis,State House,David Elder,REP,230006,0,0,5,5,61
Ellis,State House,Steve Moore,REP,230006,0,0,1,1,61
Ellis,State House,Kenny Bob Tapp,REP,230006,0,0,0,0,61
Ellis,State House,Larry Swager,REP,230006,0,0,0,0,61
Ellis,Superintendent of Public Instruction,John Cox,DEM,230007,1,0,10,11,
Ellis,Superintendent of Public Instruction,Jack Jr.,DEM,230007,1,0,2,3,
Ellis,Superintendent of Public Instruction,Ivan Holmes,DEM,230007,0,0,0,0,
Ellis,Superintendent of Public Instruction,Freda Deskin,DEM,230007,0,0,18,18,
Ellis,U.S. Senate,Patrick Michael Hayes,DEM,230007,1,0,6,7,
Ellis,U.S. Senate,Jim Rogers,DEM,230007,1,0,16,17,
Ellis,U.S. Senate,Connie Johnson,DEM,230007,0,0,8,8,
Ellis,Governor,Dax Ewbank,REP,230007,0,0,6,6,
Ellis,Governor,Chad Moody,REP,230007,0,0,18,18,
Ellis,Governor,Mary Fallin,REP,230007,0,4,85,89,
Ellis,Superintendent of Public Instruction,Brian Kelly,REP,230007,0,0,28,28,
Ellis,Superintendent of Public Instruction,Janet Costello Barresi,REP,230007,0,0,11,11,
Ellis,Superintendent of Public Instruction,Joy Hofmeister,REP,230007,0,4,68,72,
Ellis,Insurance Commissioner,Bill Viner,REP,230007,0,0,22,22,
Ellis,Insurance Commissioner,John Doak,REP,230007,0,3,78,81,
Ellis,Corporation Commissioner,Todd Hiett,REP,230007,0,2,49,51,
Ellis,Corporation Commissioner,Cliff Branan,REP,230007,0,1,56,57,
Ellis,U.S. Senate,Evelyn Rogers,REP,230007,0,0,3,3,
Ellis,U.S. Senate,Rob Moye,REP,230007,0,0,1,1,
Ellis,U.S. Senate,D. Jean Mcbride-Samuels,REP,230007,0,0,1,1,
Ellis,U.S. Senate,Jim Inhofe,REP,230007,0,4,93,97,
Ellis,U.S. Senate,Erick Paul Wyatt,REP,230007,0,0,10,10,
Ellis,U.S. Senate,Andy Craig,REP,230007,0,0,1,1,
Ellis,U.S. Senate,T. Shannon,REP,230007,0,0,37,37,
Ellis,U.S. Senate,Randy Brogdon,REP,230007,0,0,1,1,
Ellis,U.S. Senate,Eric Mccray,REP,230007,0,0,2,2,
Ellis,U.S. Senate,Kevin Crow,REP,230007,0,0,0,0,
Ellis,U.S. Senate,James Lankford,REP,230007,0,4,68,72,
Ellis,U.S. Senate,Jason Weger,REP,230007,0,0,0,0,
Ellis,U.S. House,Timothy Ray Murray,REP,230007,0,0,6,6,03
Ellis,U.S. House,Robert Hubbard,REP,230007,0,1,9,10,03
Ellis,U.S. House,Frank Lucas,REP,230007,0,3,93,96,03
Ellis,State House,Casey Murdock,REP,230007,0,1,35,36,61
Ellis,State House,David Elder,REP,230007,0,3,23,26,61
Ellis,State House,Steve Moore,REP,230007,0,0,15,15,61
Ellis,State House,Kenny Bob Tapp,REP,230007,0,0,28,28,61
Ellis,State House,Larry Swager,REP,230007,0,0,5,5,61
Ellis,Superintendent of Public Instruction,John Cox,DEM,230008,0,0,11,11,
Ellis,Superintendent of Public Instruction,Jack Jr.,DEM,230008,0,0,1,1,
Ellis,Superintendent of Public Instruction,Ivan Holmes,DEM,230008,0,0,0,0,
Ellis,Superintendent of Public Instruction,Freda Deskin,DEM,230008,0,0,5,5,
Ellis,U.S. Senate,Patrick Michael Hayes,DEM,230008,0,0,4,4,
Ellis,U.S. Senate,Jim Rogers,DEM,230008,0,0,5,5,
Ellis,U.S. Senate,Connie Johnson,DEM,230008,0,0,7,7,
Ellis,Governor,Dax Ewbank,REP,230008,1,1,9,11,
Ellis,Governor,Chad Moody,REP,230008,1,1,8,10,
Ellis,Governor,Mary Fallin,REP,230008,0,1,59,60,
Ellis,Superintendent of Public Instruction,Brian Kelly,REP,230008,0,0,19,19,
Ellis,Superintendent of Public Instruction,Janet Costello Barresi,REP,230008,0,0,14,14,
Ellis,Superintendent of Public Instruction,Joy Hofmeister,REP,230008,2,3,44,49,
Ellis,Insurance Commissioner,Bill Viner,REP,230008,0,2,11,13,
Ellis,Insurance Commissioner,John Doak,REP,230008,2,1,62,65,
Ellis,Corporation Commissioner,Todd Hiett,REP,230008,2,2,35,39,
Ellis,Corporation Commissioner,Cliff Branan,REP,230008,0,1,40,41,
Ellis,U.S. Senate,Evelyn Rogers,REP,230008,0,1,0,1,
Ellis,U.S. Senate,Rob Moye,REP,230008,0,0,1,1,
Ellis,U.S. Senate,D. Jean Mcbride-Samuels,REP,230008,0,0,1,1,
Ellis,U.S. Senate,Jim Inhofe,REP,230008,2,2,68,72,
Ellis,U.S. Senate,Erick Paul Wyatt,REP,230008,0,0,7,7,
Ellis,U.S. Senate,Andy Craig,REP,230008,0,0,0,0,
Ellis,U.S. Senate,T. Shannon,REP,230008,1,2,25,28,
Ellis,U.S. Senate,Randy Brogdon,REP,230008,1,0,4,5,
Ellis,U.S. Senate,Eric Mccray,REP,230008,0,0,0,0,
Ellis,U.S. Senate,Kevin Crow,REP,230008,0,0,0,0,
Ellis,U.S. Senate,James Lankford,REP,230008,0,1,48,49,
Ellis,U.S. Senate,Jason Weger,REP,230008,0,0,0,0,
Ellis,U.S. House,Timothy Ray Murray,REP,230008,0,0,1,1,03
Ellis,U.S. House,Robert Hubbard,REP,230008,1,0,12,13,03
Ellis,U.S. House,Frank Lucas,REP,230008,1,3,64,68,03
Ellis,State House,Casey Murdock,REP,230008,1,2,17,20,61
Ellis,State House,David Elder,REP,230008,0,0,13,13,61
Ellis,State House,Steve Moore,REP,230008,1,0,22,23,61
Ellis,State House,Kenny Bob Tapp,REP,230008,0,1,19,20,61
Ellis,State House,Larry Swager,REP,230008,0,0,5,5,61
Ellis,Superintendent of Public Instruction,John Cox,DEM,230009,0,0,7,7,
Ellis,Superintendent of Public Instruction,Jack Jr.,DEM,230009,0,0,0,0,
Ellis,Superintendent of Public Instruction,Ivan Holmes,DEM,230009,0,0,2,2,
Ellis,Superintendent of Public Instruction,Freda Deskin,DEM,230009,0,0,7,7,
Ellis,U.S. Senate,Patrick Michael Hayes,DEM,230009,0,0,5,5,
Ellis,U.S. Senate,Jim Rogers,DEM,230009,0,0,6,6,
Ellis,U.S. Senate,Connie Johnson,DEM,230009,0,0,4,4,
Ellis,Governor,Dax Ewbank,REP,230009,1,0,3,4,
Ellis,Governor,Chad Moody,REP,230009,0,0,1,1,
Ellis,Governor,Mary Fallin,REP,230009,1,2,21,24,
Ellis,Superintendent of Public Instruction,Brian Kelly,REP,230009,0,0,8,8,
Ellis,Superintendent of Public Instruction,Janet Costello Barresi,REP,230009,0,0,1,1,
Ellis,Superintendent of Public Instruction,Joy Hofmeister,REP,230009,3,2,15,20,
Ellis,Insurance Commissioner,Bill Viner,REP,230009,0,0,6,6,
Ellis,Insurance Commissioner,John Doak,REP,230009,3,2,16,21,
Ellis,Corporation Commissioner,Todd Hiett,REP,230009,3,0,8,11,
Ellis,Corporation Commissioner,Cliff Branan,REP,230009,0,2,14,16,
Ellis,U.S. Senate,Evelyn Rogers,REP,230009,0,0,1,1,
Ellis,U.S. Senate,Rob Moye,REP,230009,0,0,1,1,
Ellis,U.S. Senate,D. Jean Mcbride-Samuels,REP,230009,0,0,1,1,
Ellis,U.S. Senate,Jim Inhofe,REP,230009,3,2,21,26,
Ellis,U.S. Senate,Erick Paul Wyatt,REP,230009,0,0,0,0,
Ellis,U.S. Senate,Andy Craig,REP,230009,0,0,1,1,
Ellis,U.S. Senate,T. Shannon,REP,230009,2,0,10,12,
Ellis,U.S. Senate,Randy Brogdon,REP,230009,0,0,0,0,
Ellis,U.S. Senate,Eric Mccray,REP,230009,0,0,0,0,
Ellis,U.S. Senate,Kevin Crow,REP,230009,0,0,0,0,
Ellis,U.S. Senate,James Lankford,REP,230009,1,2,14,17,
Ellis,U.S. Senate,Jason Weger,REP,230009,0,0,0,0,
Ellis,U.S. House,Timothy Ray Murray,REP,230009,0,0,0,0,03
Ellis,U.S. House,Robert Hubbard,REP,230009,0,0,4,4,03
Ellis,U.S. House,Frank Lucas,REP,230009,3,2,20,25,03
Ellis,State House,Casey Murdock,REP,230009,2,0,8,10,61
Ellis,State House,David Elder,REP,230009,0,0,5,5,61
Ellis,State House,Steve Moore,REP,230009,0,1,5,6,61
Ellis,State House,Kenny Bob Tapp,REP,230009,1,1,6,8,61
Ellis,State House,Larry Swager,REP,230009,0,0,0,0,61
Garfield,Superintendent of Public Instruction,John Cox,DEM,240101,0,0,4,4,
Garfield,Superintendent of Public Instruction,Jack Jr.,DEM,240101,0,0,3,3,
Garfield,Superintendent of Public Instruction,Ivan Holmes,DEM,240101,0,0,4,4,
Garfield,Superintendent of Public Instruction,Freda Deskin,DEM,240101,0,0,12,12,
Garfield,U.S. Senate,Patrick Michael Hayes,DEM,240101,0,0,4,4,
Garfield,U.S. Senate,Jim Rogers,DEM,240101,0,0,5,5,
Garfield,U.S. Senate,Connie Johnson,DEM,240101,0,0,14,14,
Garfield,Governor,Dax Ewbank,REP,240101,0,0,10,10,
Garfield,Governor,Chad Moody,REP,240101,0,1,20,21,
Garfield,Governor,Mary Fallin,REP,240101,2,1,34,37,
Garfield,Superintendent of Public Instruction,Brian Kelly,REP,240101,0,1,28,29,
Garfield,Superintendent of Public Instruction,Janet Costello Barresi,REP,240101,1,0,12,13,
Garfield,Superintendent of Public Instruction,Joy Hofmeister,REP,240101,1,1,24,26,
Garfield,Insurance Commissioner,Bill Viner,REP,240101,0,0,18,18,
Garfield,Insurance Commissioner,John Doak,REP,240101,2,2,45,49,
Garfield,Corporation Commissioner,Todd Hiett,REP,240101,0,0,31,31,
Garfield,Corporation Commissioner,Cliff Branan,REP,240101,2,2,31,35,
Garfield,U.S. Senate,Evelyn Rogers,REP,240101,0,0,6,6,
Garfield,U.S. Senate,Rob Moye,REP,240101,0,0,0,0,
Garfield,U.S. Senate,D. Jean Mcbride-Samuels,REP,240101,0,0,1,1,
Garfield,U.S. Senate,Jim Inhofe,REP,240101,2,2,51,55,
Garfield,U.S. Senate,Erick Paul Wyatt,REP,240101,0,0,6,6,
Garfield,U.S. Senate,Andy Craig,REP,240101,0,0,1,1,
Garfield,U.S. Senate,T. Shannon,REP,240101,1,0,23,24,
Garfield,U.S. Senate,Randy Brogdon,REP,240101,0,0,0,0,
Garfield,U.S. Senate,Eric Mccray,REP,240101,0,0,1,1,
Garfield,U.S. Senate,Kevin Crow,REP,240101,0,0,0,0,
Garfield,U.S. Senate,James Lankford,REP,240101,1,2,37,40,
Garfield,U.S. Senate,Jason Weger,REP,240101,0,0,2,2,
Garfield,U.S. House,Timothy Ray Murray,REP,240101,0,0,7,7,03
Garfield,U.S. House,Robert Hubbard,REP,240101,0,0,8,8,03
Garfield,U.S. House,Frank Lucas,REP,240101,2,2,49,53,03
Garfield,State House,Mike Stuber,REP,240101,0,2,31,33,40
Garfield,State House,Chad Caldwell,REP,240101,1,0,33,34,40
Garfield,Superintendent of Public Instruction,John Cox,DEM,240102,0,0,15,15,
Garfield,Superintendent of Public Instruction,Jack Jr.,DEM,240102,0,0,9,9,
Garfield,Superintendent of Public Instruction,Ivan Holmes,DEM,240102,0,0,9,9,
Garfield,Superintendent of Public Instruction,Freda Deskin,DEM,240102,0,0,16,16,
Garfield,U.S. Senate,Patrick Michael Hayes,DEM,240102,0,0,16,16,
Garfield,U.S. Senate,Jim Rogers,DEM,240102,0,0,10,10,
Garfield,U.S. Senate,Connie Johnson,DEM,240102,0,0,23,23,
Garfield,Governor,Dax Ewbank,REP,240102,0,1,20,21,
Garfield,Governor,Chad Moody,REP,240102,0,0,20,20,
Garfield,Governor,Mary Fallin,REP,240102,0,2,42,44,
Garfield,Superintendent of Public Instruction,Brian Kelly,REP,240102,0,3,27,30,
Garfield,Superintendent of Public Instruction,Janet Costello Barresi,REP,240102,0,0,13,13,
Garfield,Superintendent of Public Instruction,Joy Hofmeister,REP,240102,0,0,41,41,
Garfield,Insurance Commissioner,Bill Viner,REP,240102,0,2,24,26,
Garfield,Insurance Commissioner,John Doak,REP,240102,0,1,57,58,
Garfield,Corporation Commissioner,Todd Hiett,REP,240102,0,1,36,37,
Garfield,Corporation Commissioner,Cliff Branan,REP,240102,0,2,43,45,
Garfield,U.S. Senate,Evelyn Rogers,REP,240102,0,0,4,4,
Garfield,U.S. Senate,Rob Moye,REP,240102,0,0,2,2,
Garfield,U.S. Senate,D. Jean Mcbride-Samuels,REP,240102,0,0,0,0,
Garfield,U.S. Senate,Jim Inhofe,REP,240102,0,3,70,73,
Garfield,U.S. Senate,Erick Paul Wyatt,REP,240102,0,0,5,5,
Garfield,U.S. Senate,Andy Craig,REP,240102,0,0,1,1,
Garfield,U.S. Senate,T. Shannon,REP,240102,0,1,35,36,
Garfield,U.S. Senate,Randy Brogdon,REP,240102,0,0,2,2,
Garfield,U.S. Senate,Eric Mccray,REP,240102,0,0,1,1,
Garfield,U.S. Senate,Kevin Crow,REP,240102,0,0,4,4,
Garfield,U.S. Senate,James Lankford,REP,240102,0,2,38,40,
Garfield,U.S. Senate,Jason Weger,REP,240102,0,0,0,0,
Garfield,U.S. House,Timothy Ray Murray,REP,240102,0,0,4,4,03
Garfield,U.S. House,Robert Hubbard,REP,240102,0,0,6,6,03
Garfield,U.S. House,Frank Lucas,REP,240102,0,3,72,75,03
Garfield,State House,Mike Stuber,REP,240102,0,2,40,42,40
Garfield,State House,Chad Caldwell,REP,240102,0,1,41,42,40
Garfield,Superintendent of Public Instruction,John Cox,DEM,240103,0,0,25,25,
Garfield,Superintendent of Public Instruction,Jack Jr.,DEM,240103,1,0,4,5,
Garfield,Superintendent of Public Instruction,Ivan Holmes,DEM,240103,1,0,5,6,
Garfield,Superintendent of Public Instruction,Freda Deskin,DEM,240103,0,2,20,22,
Garfield,U.S. Senate,Patrick Michael Hayes,DEM,240103,0,0,13,13,
Garfield,U.S. Senate,Jim Rogers,DEM,240103,2,1,19,22,
Garfield,U.S. Senate,Connie Johnson,DEM,240103,0,1,22,23,
Garfield,Governor,Dax Ewbank,REP,240103,0,2,12,14,
Garfield,Governor,Chad Moody,REP,240103,0,0,36,36,
Garfield,Governor,Mary Fallin,REP,240103,3,7,72,82,
Garfield,Superintendent of Public Instruction,Brian Kelly,REP,240103,0,1,47,48,
Garfield,Superintendent of Public Instruction,Janet Costello Barresi,REP,240103,2,2,18,22,
Garfield,Superintendent of Public Instruction,Joy Hofmeister,REP,240103,1,6,55,62,
Garfield,Insurance Commissioner,Bill Viner,REP,240103,1,2,35,38,
Garfield,Insurance Commissioner,John Doak,REP,240103,2,7,82,91,
Garfield,Corporation Commissioner,Todd Hiett,REP,240103,2,6,48,56,
Garfield,Corporation Commissioner,Cliff Branan,REP,240103,1,3,68,72,
Garfield,U.S. Senate,Evelyn Rogers,REP,240103,0,0,9,9,
Garfield,U.S. Senate,Rob Moye,REP,240103,0,0,5,5,
Garfield,U.S. Senate,D. Jean Mcbride-Samuels,REP,240103,0,1,1,2,
Garfield,U.S. Senate,Jim Inhofe,REP,240103,4,8,101,113,
Garfield,U.S. Senate,Erick Paul Wyatt,REP,240103,0,0,5,5,
Garfield,U.S. Senate,Andy Craig,REP,240103,0,0,0,0,
Garfield,U.S. Senate,T. Shannon,REP,240103,1,1,50,52,
Garfield,U.S. Senate,Randy Brogdon,REP,240103,0,0,2,2,
Garfield,U.S. Senate,Eric Mccray,REP,240103,0,0,1,1,
Garfield,U.S. Senate,Kevin Crow,REP,240103,1,0,3,4,
Garfield,U.S. Senate,James Lankford,REP,240103,1,8,61,70,
Garfield,U.S. Senate,Jason Weger,REP,240103,0,0,3,3,
Garfield,U.S. House,Timothy Ray Murray,REP,240103,0,0,6,6,03
Garfield,U.S. House,Robert Hubbard,REP,240103,0,1,13,14,03
Garfield,U.S. House,Frank Lucas,REP,240103,4,8,102,114,03
Garfield,State House,Mike Stuber,REP,240103,1,3,50,54,40
Garfield,State House,Chad Caldwell,REP,240103,2,6,68,76,40
Garfield,Superintendent of Public Instruction,John Cox,DEM,240104,2,0,19,21,
Garfield,Superintendent of Public Instruction,Jack Jr.,DEM,240104,0,0,4,4,
Garfield,Superintendent of Public Instruction,Ivan Holmes,DEM,240104,1,1,7,9,
Garfield,Superintendent of Public Instruction,Freda Deskin,DEM,240104,0,0,14,14,
Garfield,U.S. Senate,Patrick Michael Hayes,DEM,240104,2,0,9,11,
Garfield,U.S. Senate,Jim Rogers,DEM,240104,0,0,20,20,
Garfield,U.S. Senate,Connie Johnson,DEM,240104,1,1,14,16,
Garfield,Governor,Dax Ewbank,REP,240104,1,2,17,20,
Garfield,Governor,Chad Moody,REP,240104,0,0,26,26,
Garfield,Governor,Mary Fallin,REP,240104,1,5,77,83,
Garfield,Superintendent of Public Instruction,Brian Kelly,REP,240104,0,2,34,36,
Garfield,Superintendent of Public Instruction,Janet Costello Barresi,REP,240104,1,2,11,14,
Garfield,Superintendent of Public Instruction,Joy Hofmeister,REP,240104,0,3,77,80,
Garfield,Insurance Commissioner,Bill Viner,REP,240104,0,2,30,32,
Garfield,Insurance Commissioner,John Doak,REP,240104,2,5,88,95,
Garfield,Corporation Commissioner,Todd Hiett,REP,240104,1,1,56,58,
Garfield,Corporation Commissioner,Cliff Branan,REP,240104,0,6,62,68,
Garfield,U.S. Senate,Evelyn Rogers,REP,240104,1,0,6,7,
Garfield,U.S. Senate,Rob Moye,REP,240104,0,0,4,4,
Garfield,U.S. Senate,D. Jean Mcbride-Samuels,REP,240104,0,0,1,1,
Garfield,U.S. Senate,Jim Inhofe,REP,240104,0,7,102,109,
Garfield,U.S. Senate,Erick Paul Wyatt,REP,240104,0,0,9,9,
Garfield,U.S. Senate,Andy Craig,REP,240104,0,0,0,0,
Garfield,U.S. Senate,T. Shannon,REP,240104,0,2,48,50,
Garfield,U.S. Senate,Randy Brogdon,REP,240104,0,0,3,3,
Garfield,U.S. Senate,Eric Mccray,REP,240104,0,0,1,1,
Garfield,U.S. Senate,Kevin Crow,REP,240104,0,0,3,3,
Garfield,U.S. Senate,James Lankford,REP,240104,0,5,67,72,
Garfield,U.S. Senate,Jason Weger,REP,240104,1,0,0,1,
Garfield,U.S. House,Timothy Ray Murray,REP,240104,1,0,8,9,03
Garfield,U.S. House,Robert Hubbard,REP,240104,0,1,18,19,03
Garfield,U.S. House,Frank Lucas,REP,240104,0,6,95,101,03
Garfield,State House,Mike Stuber,REP,240104,0,5,49,54,40
Garfield,State House,Chad Caldwell,REP,240104,2,2,72,76,40
Garfield,Superintendent of Public Instruction,John Cox,DEM,240105,0,0,8,8,
Garfield,Superintendent of Public Instruction,Jack Jr.,DEM,240105,0,0,7,7,
Garfield,Superintendent of Public Instruction,Ivan Holmes,DEM,240105,0,1,6,7,
Garfield,Superintendent of Public Instruction,Freda Deskin,DEM,240105,0,4,12,16,
Garfield,U.S. Senate,Patrick Michael Hayes,DEM,240105,0,0,8,8,
Garfield,U.S. Senate,Jim Rogers,DEM,240105,0,1,11,12,
Garfield,U.S. Senate,Connie Johnson,DEM,240105,0,4,10,14,
Garfield,Governor,Dax Ewbank,REP,240105,1,2,19,22,
Garfield,Governor,Chad Moody,REP,240105,1,0,41,42,
Garfield,Governor,Mary Fallin,REP,240105,0,5,83,88,
Garfield,Superintendent of Public Instruction,Brian Kelly,REP,240105,0,3,35,38,
Garfield,Superintendent of Public Instruction,Janet Costello Barresi,REP,240105,0,0,21,21,
Garfield,Superintendent of Public Instruction,Joy Hofmeister,REP,240105,2,4,86,92,
Garfield,Insurance Commissioner,Bill Viner,REP,240105,2,1,35,38,
Garfield,Insurance Commissioner,John Doak,REP,240105,0,6,106,112,
Garfield,Corporation Commissioner,Todd Hiett,REP,240105,0,3,75,78,
Garfield,Corporation Commissioner,Cliff Branan,REP,240105,2,4,66,72,
Garfield,U.S. Senate,Evelyn Rogers,REP,240105,0,0,11,11,
Garfield,U.S. Senate,Rob Moye,REP,240105,0,0,5,5,
Garfield,U.S. Senate,D. Jean Mcbride-Samuels,REP,240105,0,0,4,4,
Garfield,U.S. Senate,Jim Inhofe,REP,240105,2,7,116,125,
Garfield,U.S. Senate,Erick Paul Wyatt,REP,240105,0,1,8,9,
Garfield,U.S. Senate,Andy Craig,REP,240105,0,0,3,3,
Garfield,U.S. Senate,T. Shannon,REP,240105,1,2,73,76,
Garfield,U.S. Senate,Randy Brogdon,REP,240105,0,0,6,6,
Garfield,U.S. Senate,Eric Mccray,REP,240105,0,0,1,1,
Garfield,U.S. Senate,Kevin Crow,REP,240105,0,0,2,2,
Garfield,U.S. Senate,James Lankford,REP,240105,1,6,57,64,
Garfield,U.S. Senate,Jason Weger,REP,240105,0,0,1,1,
Garfield,U.S. House,Timothy Ray Murray,REP,240105,0,0,11,11,03
Garfield,U.S. House,Robert Hubbard,REP,240105,0,0,16,16,03
Garfield,U.S. House,Frank Lucas,REP,240105,2,7,116,125,03
Garfield,State House,Ross Vanhooser,REP,240105,0,3,40,43,41
Garfield,State House,John Enns,REP,240105,2,5,103,110,41
Garfield,Superintendent of Public Instruction,John Cox,DEM,240106,0,0,15,15,
Garfield,Superintendent of Public Instruction,Jack Jr.,DEM,240106,0,0,3,3,
Garfield,Superintendent of Public Instruction,Ivan Holmes,DEM,240106,0,0,3,3,
Garfield,Superintendent of Public Instruction,Freda Deskin,DEM,240106,0,0,7,7,
Garfield,U.S. Senate,Patrick Michael Hayes,DEM,240106,0,0,7,7,
Garfield,U.S. Senate,Jim Rogers,DEM,240106,0,0,12,12,
Garfield,U.S. Senate,Connie Johnson,DEM,240106,0,0,10,10,
Garfield,Governor,Dax Ewbank,REP,240106,0,1,13,14,
Garfield,Governor,Chad Moody,REP,240106,0,2,28,30,
Garfield,Governor,Mary Fallin,REP,240106,0,1,86,87,
Garfield,Superintendent of Public Instruction,Brian Kelly,REP,240106,0,0,23,23,
Garfield,Superintendent of Public Instruction,Janet Costello Barresi,REP,240106,0,0,4,4,
Garfield,Superintendent of Public Instruction,Joy Hofmeister,REP,240106,0,4,101,105,
Garfield,Insurance Commissioner,Bill Viner,REP,240106,0,1,18,19,
Garfield,Insurance Commissioner,John Doak,REP,240106,0,3,108,111,
Garfield,Corporation Commissioner,Todd Hiett,REP,240106,0,2,64,66,
Garfield,Corporation Commissioner,Cliff Branan,REP,240106,0,2,63,65,
Garfield,U.S. Senate,Evelyn Rogers,REP,240106,0,1,5,6,
Garfield,U.S. Senate,Rob Moye,REP,240106,0,0,1,1,
Garfield,U.S. Senate,D. Jean Mcbride-Samuels,REP,240106,0,0,1,1,
Garfield,U.S. Senate,Jim Inhofe,REP,240106,0,3,117,120,
Garfield,U.S. Senate,Erick Paul Wyatt,REP,240106,0,0,4,4,
Garfield,U.S. Senate,Andy Craig,REP,240106,0,0,2,2,
Garfield,U.S. Senate,T. Shannon,REP,240106,0,0,42,42,
Garfield,U.S. Senate,Randy Brogdon,REP,240106,0,0,1,1,
Garfield,U.S. Senate,Eric Mccray,REP,240106,0,0,0,0,
Garfield,U.S. Senate,Kevin Crow,REP,240106,0,0,1,1,
Garfield,U.S. Senate,James Lankford,REP,240106,0,4,82,86,
Garfield,U.S. Senate,Jason Weger,REP,240106,0,0,0,0,
Garfield,U.S. House,Timothy Ray Murray,REP,240106,0,0,5,5,03
Garfield,U.S. House,Robert Hubbard,REP,240106,0,0,8,8,03
Garfield,U.S. House,Frank Lucas,REP,240106,0,4,115,119,03
Garfield,State House,Roy Chaney,REP,240106,0,1,17,18,38
Garfield,State House,Niki Schrader,REP,240106,0,0,14,14,38
Garfield,State House,Jason Warren,REP,240106,0,0,8,8,38
Garfield,State House,Ralph Meade,REP,240106,0,0,6,6,38
Garfield,State House,John Pfeiffer,REP,240106,0,2,69,71,38
Garfield,State House,Harold Levalley,REP,240106,0,1,13,14,38
Garfield,Superintendent of Public Instruction,John Cox,DEM,240107,0,0,0,0,
Garfield,Superintendent of Public Instruction,Jack Jr.,DEM,240107,0,0,1,1,
Garfield,Superintendent of Public Instruction,Ivan Holmes,DEM,240107,0,0,0,0,
Garfield,Superintendent of Public Instruction,Freda Deskin,DEM,240107,0,0,1,1,
Garfield,U.S. Senate,Patrick Michael Hayes,DEM,240107,0,0,0,0,
Garfield,U.S. Senate,Jim Rogers,DEM,240107,0,0,0,0,
Garfield,U.S. Senate,Connie Johnson,DEM,240107,0,0,1,1,
Garfield,Governor,Dax Ewbank,REP,240107,0,0,5,5,
Garfield,Governor,Chad Moody,REP,240107,0,0,8,8,
Garfield,Governor,Mary Fallin,REP,240107,1,3,27,31,
Garfield,Superintendent of Public Instruction,Brian Kelly,REP,240107,0,1,3,4,
Garfield,Superintendent of Public Instruction,Janet Costello Barresi,REP,240107,1,0,3,4,
Garfield,Superintendent of Public Instruction,Joy Hofmeister,REP,240107,0,2,32,34,
Garfield,Insurance Commissioner,Bill Viner,REP,240107,1,2,8,11,
Garfield,Insurance Commissioner,John Doak,REP,240107,0,1,30,31,
Garfield,Corporation Commissioner,Todd Hiett,REP,240107,1,2,24,27,
Garfield,Corporation Commissioner,Cliff Branan,REP,240107,0,1,12,13,
Garfield,U.S. Senate,Evelyn Rogers,REP,240107,0,1,1,2,
Garfield,U.S. Senate,Rob Moye,REP,240107,0,0,0,0,
Garfield,U.S. Senate,D. Jean Mcbride-Samuels,REP,240107,0,0,0,0,
Garfield,U.S. Senate,Jim Inhofe,REP,240107,1,2,36,39,
Garfield,U.S. Senate,Erick Paul Wyatt,REP,240107,0,0,3,3,
Garfield,U.S. Senate,Andy Craig,REP,240107,0,0,0,0,
Garfield,U.S. Senate,T. Shannon,REP,240107,0,1,16,17,
Garfield,U.S. Senate,Randy Brogdon,REP,240107,0,0,2,2,
Garfield,U.S. Senate,Eric Mccray,REP,240107,0,0,2,2,
Garfield,U.S. Senate,Kevin Crow,REP,240107,0,0,0,0,
Garfield,U.S. Senate,James Lankford,REP,240107,1,2,20,23,
Garfield,U.S. Senate,Jason Weger,REP,240107,0,0,0,0,
Garfield,U.S. House,Timothy Ray Murray,REP,240107,0,1,1,2,03
Garfield,U.S. House,Robert Hubbard,REP,240107,0,0,3,3,03
Garfield,U.S. House,Frank Lucas,REP,240107,1,2,36,39,03
Garfield,State House,Ross Vanhooser,REP,240107,0,0,14,14,41
Garfield,State House,John Enns,REP,240107,1,3,25,29,41
Garfield,Superintendent of Public Instruction,John Cox,DEM,240108,0,0,0,0,
Garfield,Superintendent of Public Instruction,Jack Jr.,DEM,240108,0,0,0,0,
Garfield,Superintendent of Public Instruction,Ivan Holmes,DEM,240108,0,0,0,0,
Garfield,Superintendent of Public Instruction,Freda Deskin,DEM,240108,0,1,1,2,
Garfield,U.S. Senate,Patrick Michael Hayes,DEM,240108,0,0,1,1,
Garfield,U.S. Senate,Jim Rogers,DEM,240108,0,0,0,0,
Garfield,U.S. Senate,Connie Johnson,DEM,240108,0,1,0,1,
Garfield,Governor,Dax Ewbank,REP,240108,0,0,4,4,
Garfield,Governor,Chad Moody,REP,240108,0,1,5,6,
Garfield,Governor,Mary Fallin,REP,240108,0,0,24,24,
Garfield,Superintendent of Public Instruction,Brian Kelly,REP,240108,0,0,8,8,
Garfield,Superintendent of Public Instruction,Janet Costello Barresi,REP,240108,0,0,8,8,
Garfield,Superintendent of Public Instruction,Joy Hofmeister,REP,240108,0,1,17,18,
Garfield,Insurance Commissioner,Bill Viner,REP,240108,0,0,5,5,
Garfield,Insurance Commissioner,John Doak,REP,240108,0,1,27,28,
Garfield,Corporation Commissioner,Todd Hiett,REP,240108,0,1,12,13,
Garfield,Corporation Commissioner,Cliff Branan,REP,240108,0,0,22,22,
Garfield,U.S. Senate,Evelyn Rogers,REP,240108,0,0,0,0,
Garfield,U.S. Senate,Rob Moye,REP,240108,0,0,2,2,
Garfield,U.S. Senate,D. Jean Mcbride-Samuels,REP,240108,0,0,0,0,
Garfield,U.S. Senate,Jim Inhofe,REP,240108,0,1,31,32,
Garfield,U.S. Senate,Erick Paul Wyatt,REP,240108,0,0,1,1,
Garfield,U.S. Senate,Andy Craig,REP,240108,0,0,0,0,
Garfield,U.S. Senate,T. Shannon,REP,240108,0,0,10,10,
Garfield,U.S. Senate,Randy Brogdon,REP,240108,0,0,0,0,
Garfield,U.S. Senate,Eric Mccray,REP,240108,0,0,0,0,
Garfield,U.S. Senate,Kevin Crow,REP,240108,0,0,2,2,
Garfield,U.S. Senate,James Lankford,REP,240108,0,1,22,23,
Garfield,U.S. Senate,Jason Weger,REP,240108,0,0,0,0,
Garfield,U.S. House,Timothy Ray Murray,REP,240108,0,0,0,0,03
Garfield,U.S. House,Robert Hubbard,REP,240108,0,0,6,6,03
Garfield,U.S. House,Frank Lucas,REP,240108,0,1,28,29,03
Garfield,State House,Roy Chaney,REP,240108,0,0,6,6,38
Garfield,State House,Niki Schrader,REP,240108,0,0,7,7,38
Garfield,State House,Jason Warren,REP,240108,0,0,0,0,38
Garfield,State House,Ralph Meade,REP,240108,0,0,1,1,38
Garfield,State House,John Pfeiffer,REP,240108,0,1,17,18,38
Garfield,State House,Harold Levalley,REP,240108,0,0,0,0,38
Garfield,Superintendent of Public Instruction,John Cox,DEM,240109,0,0,10,10,
Garfield,Superintendent of Public Instruction,Jack Jr.,DEM,240109,0,0,3,3,
Garfield,Superintendent of Public Instruction,Ivan Holmes,DEM,240109,0,0,1,1,
Garfield,Superintendent of Public Instruction,Freda Deskin,DEM,240109,2,0,10,12,
Garfield,U.S. Senate,Patrick Michael Hayes,DEM,240109,0,0,10,10,
Garfield,U.S. Senate,Jim Rogers,DEM,240109,2,0,5,7,
Garfield,U.S. Senate,Connie Johnson,DEM,240109,0,0,8,8,
Garfield,Governor,Dax Ewbank,REP,240109,0,1,13,14,
Garfield,Governor,Chad Moody,REP,240109,1,1,9,11,
Garfield,Governor,Mary Fallin,REP,240109,1,1,55,57,
Garfield,Superintendent of Public Instruction,Brian Kelly,REP,240109,0,0,22,22,
Garfield,Superintendent of Public Instruction,Janet Costello Barresi,REP,240109,0,0,8,8,
Garfield,Superintendent of Public Instruction,Joy Hofmeister,REP,240109,2,3,48,53,
Garfield,Insurance Commissioner,Bill Viner,REP,240109,1,0,12,13,
Garfield,Insurance Commissioner,John Doak,REP,240109,1,3,62,66,
Garfield,Corporation Commissioner,Todd Hiett,REP,240109,2,1,38,41,
Garfield,Corporation Commissioner,Cliff Branan,REP,240109,0,2,34,36,
Garfield,U.S. Senate,Evelyn Rogers,REP,240109,0,0,4,4,
Garfield,U.S. Senate,Rob Moye,REP,240109,0,0,0,0,
Garfield,U.S. Senate,D. Jean Mcbride-Samuels,REP,240109,0,0,0,0,
Garfield,U.S. Senate,Jim Inhofe,REP,240109,1,3,68,72,
Garfield,U.S. Senate,Erick Paul Wyatt,REP,240109,1,0,5,6,
Garfield,U.S. Senate,Andy Craig,REP,240109,0,0,0,0,
Garfield,U.S. Senate,T. Shannon,REP,240109,0,2,24,26,
Garfield,U.S. Senate,Randy Brogdon,REP,240109,0,0,1,1,
Garfield,U.S. Senate,Eric Mccray,REP,240109,0,0,1,1,
Garfield,U.S. Senate,Kevin Crow,REP,240109,0,0,1,1,
Garfield,U.S. Senate,James Lankford,REP,240109,2,1,51,54,
Garfield,U.S. Senate,Jason Weger,REP,240109,0,0,0,0,
Garfield,U.S. House,Timothy Ray Murray,REP,240109,0,0,9,9,03
Garfield,U.S. House,Robert Hubbard,REP,240109,0,0,6,6,03
Garfield,U.S. House,Frank Lucas,REP,240109,2,3,63,68,03
Garfield,State House,Roy Chaney,REP,240109,0,2,16,18,38
Garfield,State House,Niki Schrader,REP,240109,0,0,22,22,38
Garfield,State House,Jason Warren,REP,240109,0,0,6,6,38
Garfield,State House,Ralph Meade,REP,240109,0,0,11,11,38
Garfield,State House,John Pfeiffer,REP,240109,2,1,22,25,38
Garfield,State House,Harold Levalley,REP,240109,0,0,1,1,38
Garfield,Superintendent of Public Instruction,John Cox,DEM,240110,0,0,10,10,
Garfield,Superintendent of Public Instruction,Jack Jr.,DEM,240110,0,0,3,3,
Garfield,Superintendent of Public Instruction,Ivan Holmes,DEM,240110,0,3,3,6,
Garfield,Superintendent of Public Instruction,Freda Deskin,DEM,240110,0,0,9,9,
Garfield,U.S. Senate,Patrick Michael Hayes,DEM,240110,0,0,10,10,
Garfield,U.S. Senate,Jim Rogers,DEM,240110,0,1,4,5,
Garfield,U.S. Senate,Connie Johnson,DEM,240110,0,2,11,13,
Garfield,Governor,Dax Ewbank,REP,240110,4,4,18,26,
Garfield,Governor,Chad Moody,REP,240110,0,5,46,51,
Garfield,Governor,Mary Fallin,REP,240110,1,7,78,86,
Garfield,Superintendent of Public Instruction,Brian Kelly,REP,240110,2,5,47,54,
Garfield,Superintendent of Public Instruction,Janet Costello Barresi,REP,240110,0,2,15,17,
Garfield,Superintendent of Public Instruction,Joy Hofmeister,REP,240110,3,9,76,88,
Garfield,Insurance Commissioner,Bill Viner,REP,240110,4,3,30,37,
Garfield,Insurance Commissioner,John Doak,REP,240110,0,12,101,113,
Garfield,Corporation Commissioner,Todd Hiett,REP,240110,1,7,61,69,
Garfield,Corporation Commissioner,Cliff Branan,REP,240110,3,9,76,88,
Garfield,U.S. Senate,Evelyn Rogers,REP,240110,1,2,6,9,
Garfield,U.S. Senate,Rob Moye,REP,240110,0,0,4,4,
Garfield,U.S. Senate,D. Jean Mcbride-Samuels,REP,240110,0,0,1,1,
Garfield,U.S. Senate,Jim Inhofe,REP,240110,3,14,124,141,
Garfield,U.S. Senate,Erick Paul Wyatt,REP,240110,1,0,7,8,
Garfield,U.S. Senate,Andy Craig,REP,240110,0,0,2,2,
Garfield,U.S. Senate,T. Shannon,REP,240110,3,7,52,62,
Garfield,U.S. Senate,Randy Brogdon,REP,240110,1,0,2,3,
Garfield,U.S. Senate,Eric Mccray,REP,240110,0,0,1,1,
Garfield,U.S. Senate,Kevin Crow,REP,240110,0,0,2,2,
Garfield,U.S. Senate,James Lankford,REP,240110,1,9,82,92,
Garfield,U.S. Senate,Jason Weger,REP,240110,0,0,0,0,
Garfield,U.S. House,Timothy Ray Murray,REP,240110,1,2,3,6,03
Garfield,U.S. House,Robert Hubbard,REP,240110,0,2,14,16,03
Garfield,U.S. House,Frank Lucas,REP,240110,4,12,124,140,03
Garfield,State House,Ross Vanhooser,REP,240110,3,8,47,58,41
Garfield,State House,John Enns,REP,240110,2,8,95,105,41
Garfield,Superintendent of Public Instruction,John Cox,DEM,240201,3,0,18,21,
Garfield,Superintendent of Public Instruction,Jack Jr.,DEM,240201,0,0,14,14,
Garfield,Superintendent of Public Instruction,Ivan Holmes,DEM,240201,0,1,7,8,
Garfield,Superintendent of Public Instruction,Freda Deskin,DEM,240201,1,3,28,32,
Garfield,U.S. Senate,Patrick Michael Hayes,DEM,240201,0,0,13,13,
Garfield,U.S. Senate,Jim Rogers,DEM,240201,0,0,15,15,
Garfield,U.S. Senate,Connie Johnson,DEM,240201,4,4,36,44,
Garfield,Governor,Dax Ewbank,REP,240201,0,6,62,68,
Garfield,Governor,Chad Moody,REP,240201,2,5,67,74,
Garfield,Governor,Mary Fallin,REP,240201,6,18,210,234,
Garfield,Superintendent of Public Instruction,Brian Kelly,REP,240201,2,4,79,85,
Garfield,Superintendent of Public Instruction,Janet Costello Barresi,REP,240201,3,5,69,77,
Garfield,Superintendent of Public Instruction,Joy Hofmeister,REP,240201,3,21,194,218,
Garfield,Insurance Commissioner,Bill Viner,REP,240201,4,4,74,82,
Garfield,Insurance Commissioner,John Doak,REP,240201,4,25,255,284,
Garfield,Corporation Commissioner,Todd Hiett,REP,240201,3,18,175,196,
Garfield,Corporation Commissioner,Cliff Branan,REP,240201,4,11,146,161,
Garfield,U.S. Senate,Evelyn Rogers,REP,240201,0,1,13,14,
Garfield,U.S. Senate,Rob Moye,REP,240201,0,0,13,13,
Garfield,U.S. Senate,D. Jean Mcbride-Samuels,REP,240201,0,0,5,5,
Garfield,U.S. Senate,Jim Inhofe,REP,240201,8,28,300,336,
Garfield,U.S. Senate,Erick Paul Wyatt,REP,240201,0,0,12,12,
Garfield,U.S. Senate,Andy Craig,REP,240201,0,0,3,3,
Garfield,U.S. Senate,T. Shannon,REP,240201,5,8,124,137,
Garfield,U.S. Senate,Randy Brogdon,REP,240201,0,0,7,7,
Garfield,U.S. Senate,Eric Mccray,REP,240201,1,0,1,2,
Garfield,U.S. Senate,Kevin Crow,REP,240201,0,1,5,6,
Garfield,U.S. Senate,James Lankford,REP,240201,1,20,206,227,
Garfield,U.S. Senate,Jason Weger,REP,240201,0,0,0,0,
Garfield,U.S. House,Timothy Ray Murray,REP,240201,1,1,21,23,03
Garfield,U.S. House,Robert Hubbard,REP,240201,0,0,39,39,03
Garfield,U.S. House,Frank Lucas,REP,240201,7,29,283,319,03
Garfield,State House,Mike Stuber,REP,240201,3,13,134,150,40
Garfield,State House,Chad Caldwell,REP,240201,5,17,210,232,40
Garfield,Superintendent of Public Instruction,John Cox,DEM,240202,4,2,29,35,
Garfield,Superintendent of Public Instruction,Jack Jr.,DEM,240202,1,0,14,15,
Garfield,Superintendent of Public Instruction,Ivan Holmes,DEM,240202,1,0,2,3,
Garfield,Superintendent of Public Instruction,Freda Deskin,DEM,240202,5,2,42,49,
Garfield,U.S. Senate,Patrick Michael Hayes,DEM,240202,4,0,19,23,
Garfield,U.S. Senate,Jim Rogers,DEM,240202,5,2,29,36,
Garfield,U.S. Senate,Connie Johnson,DEM,240202,2,2,40,44,
Garfield,Governor,Dax Ewbank,REP,240202,1,1,58,60,
Garfield,Governor,Chad Moody,REP,240202,2,3,66,71,
Garfield,Governor,Mary Fallin,REP,240202,14,15,230,259,
Garfield,Superintendent of Public Instruction,Brian Kelly,REP,240202,6,3,88,97,
Garfield,Superintendent of Public Instruction,Janet Costello Barresi,REP,240202,2,1,41,44,
Garfield,Superintendent of Public Instruction,Joy Hofmeister,REP,240202,8,15,219,242,
Garfield,Insurance Commissioner,Bill Viner,REP,240202,5,2,79,86,
Garfield,Insurance Commissioner,John Doak,REP,240202,11,17,249,277,
Garfield,Corporation Commissioner,Todd Hiett,REP,240202,5,10,124,139,
Garfield,Corporation Commissioner,Cliff Branan,REP,240202,11,9,209,229,
Garfield,U.S. Senate,Evelyn Rogers,REP,240202,0,1,14,15,
Garfield,U.S. Senate,Rob Moye,REP,240202,0,0,8,8,
Garfield,U.S. Senate,D. Jean Mcbride-Samuels,REP,240202,1,0,4,5,
Garfield,U.S. Senate,Jim Inhofe,REP,240202,13,18,316,347,
Garfield,U.S. Senate,Erick Paul Wyatt,REP,240202,3,0,8,11,
Garfield,U.S. Senate,Andy Craig,REP,240202,0,1,2,3,
Garfield,U.S. Senate,T. Shannon,REP,240202,4,5,111,120,
Garfield,U.S. Senate,Randy Brogdon,REP,240202,0,0,6,6,
Garfield,U.S. Senate,Eric Mccray,REP,240202,0,0,2,2,
Garfield,U.S. Senate,Kevin Crow,REP,240202,1,0,6,7,
Garfield,U.S. Senate,James Lankford,REP,240202,11,13,228,252,
Garfield,U.S. Senate,Jason Weger,REP,240202,0,0,1,1,
Garfield,U.S. House,Timothy Ray Murray,REP,240202,2,0,13,15,03
Garfield,U.S. House,Robert Hubbard,REP,240202,3,3,34,40,03
Garfield,U.S. House,Frank Lucas,REP,240202,12,16,305,333,03
Garfield,State House,Mike Stuber,REP,240202,8,8,101,117,40
Garfield,State House,Chad Caldwell,REP,240202,8,11,249,268,40
Garfield,Superintendent of Public Instruction,John Cox,DEM,240203,3,0,10,13,
Garfield,Superintendent of Public Instruction,Jack Jr.,DEM,240203,1,0,6,7,
Garfield,Superintendent of Public Instruction,Ivan Holmes,DEM,240203,0,0,2,2,
Garfield,Superintendent of Public Instruction,Freda Deskin,DEM,240203,0,1,11,12,
Garfield,U.S. Senate,Patrick Michael Hayes,DEM,240203,2,0,9,11,
Garfield,U.S. Senate,Jim Rogers,DEM,240203,2,0,8,10,
Garfield,U.S. Senate,Connie Johnson,DEM,240203,0,1,13,14,
Garfield,Governor,Dax Ewbank,REP,240203,0,1,20,21,
Garfield,Governor,Chad Moody,REP,240203,2,0,32,34,
Garfield,Governor,Mary Fallin,REP,240203,5,3,70,78,
Garfield,Superintendent of Public Instruction,Brian Kelly,REP,240203,2,1,33,36,
Garfield,Superintendent of Public Instruction,Janet Costello Barresi,REP,240203,2,0,17,19,
Garfield,Superintendent of Public Instruction,Joy Hofmeister,REP,240203,3,2,72,77,
Garfield,Insurance Commissioner,Bill Viner,REP,240203,3,1,33,37,
Garfield,Insurance Commissioner,John Doak,REP,240203,4,2,83,89,
Garfield,Corporation Commissioner,Todd Hiett,REP,240203,3,3,57,63,
Garfield,Corporation Commissioner,Cliff Branan,REP,240203,3,1,61,65,
Garfield,U.S. Senate,Evelyn Rogers,REP,240203,1,1,13,15,
Garfield,U.S. Senate,Rob Moye,REP,240203,1,0,5,6,
Garfield,U.S. Senate,D. Jean Mcbride-Samuels,REP,240203,1,0,1,2,
Garfield,U.S. Senate,Jim Inhofe,REP,240203,4,3,90,97,
Garfield,U.S. Senate,Erick Paul Wyatt,REP,240203,0,0,12,12,
Garfield,U.S. Senate,Andy Craig,REP,240203,0,0,2,2,
Garfield,U.S. Senate,T. Shannon,REP,240203,2,1,43,46,
Garfield,U.S. Senate,Randy Brogdon,REP,240203,1,2,5,8,
Garfield,U.S. Senate,Eric Mccray,REP,240203,0,0,2,2,
Garfield,U.S. Senate,Kevin Crow,REP,240203,0,0,2,2,
Garfield,U.S. Senate,James Lankford,REP,240203,4,1,67,72,
Garfield,U.S. Senate,Jason Weger,REP,240203,0,0,1,1,
Garfield,U.S. House,Timothy Ray Murray,REP,240203,1,1,11,13,03
Garfield,U.S. House,Robert Hubbard,REP,240203,3,1,11,15,03
Garfield,U.S. House,Frank Lucas,REP,240203,3,2,99,104,03
Garfield,State House,Mike Stuber,REP,240203,4,0,53,57,40
Garfield,State House,Chad Caldwell,REP,240203,2,4,66,72,40
Garfield,Superintendent of Public Instruction,John Cox,DEM,240204,0,2,20,22,
Garfield,Superintendent of Public Instruction,Jack Jr.,DEM,240204,1,0,14,15,
Garfield,Superintendent of Public Instruction,Ivan Holmes,DEM,240204,0,0,5,5,
Garfield,Superintendent of Public Instruction,Freda Deskin,DEM,240204,0,3,28,31,
Garfield,U.S. Senate,Patrick Michael Hayes,DEM,240204,0,1,9,10,
Garfield,U.S. Senate,Jim Rogers,DEM,240204,0,0,32,32,
Garfield,U.S. Senate,Connie Johnson,DEM,240204,1,3,26,30,
Garfield,Governor,Dax Ewbank,REP,240204,2,2,64,68,
Garfield,Governor,Chad Moody,REP,240204,2,2,75,79,
Garfield,Governor,Mary Fallin,REP,240204,7,14,293,314,
Garfield,Superintendent of Public Instruction,Brian Kelly,REP,240204,2,1,77,80,
Garfield,Superintendent of Public Instruction,Janet Costello Barresi,REP,240204,2,4,67,73,
Garfield,Superintendent of Public Instruction,Joy Hofmeister,REP,240204,7,13,286,306,
Garfield,Insurance Commissioner,Bill Viner,REP,240204,5,1,85,91,
Garfield,Insurance Commissioner,John Doak,REP,240204,6,16,327,349,
Garfield,Corporation Commissioner,Todd Hiett,REP,240204,5,8,192,205,
Garfield,Corporation Commissioner,Cliff Branan,REP,240204,6,7,219,232,
Garfield,U.S. Senate,Evelyn Rogers,REP,240204,2,1,15,18,
Garfield,U.S. Senate,Rob Moye,REP,240204,0,1,12,13,
Garfield,U.S. Senate,D. Jean Mcbride-Samuels,REP,240204,0,0,4,4,
Garfield,U.S. Senate,Jim Inhofe,REP,240204,9,16,387,412,
Garfield,U.S. Senate,Erick Paul Wyatt,REP,240204,0,0,13,13,
Garfield,U.S. Senate,Andy Craig,REP,240204,2,0,2,4,
Garfield,U.S. Senate,T. Shannon,REP,240204,3,5,151,159,
Garfield,U.S. Senate,Randy Brogdon,REP,240204,0,2,9,11,
Garfield,U.S. Senate,Eric Mccray,REP,240204,2,0,3,5,
Garfield,U.S. Senate,Kevin Crow,REP,240204,0,0,5,5,
Garfield,U.S. Senate,James Lankford,REP,240204,4,11,258,273,
Garfield,U.S. Senate,Jason Weger,REP,240204,0,0,2,2,
Garfield,U.S. House,Timothy Ray Murray,REP,240204,0,2,14,16,03
Garfield,U.S. House,Robert Hubbard,REP,240204,1,2,49,52,03
Garfield,U.S. House,Frank Lucas,REP,240204,10,14,369,393,03
Garfield,State House,Mike Stuber,REP,240204,3,5,193,201,40
Garfield,State House,Chad Caldwell,REP,240204,8,12,232,252,40
Garfield,Superintendent of Public Instruction,John Cox,DEM,240206,0,0,12,12,
Garfield,Superintendent of Public Instruction,Jack Jr.,DEM,240206,0,0,8,8,
Garfield,Superintendent of Public Instruction,Ivan Holmes,DEM,240206,1,0,5,6,
Garfield,Superintendent of Public Instruction,Freda Deskin,DEM,240206,1,0,19,20,
Garfield,U.S. Senate,Patrick Michael Hayes,DEM,240206,1,0,9,10,
Garfield,U.S. Senate,Jim Rogers,DEM,240206,0,0,16,16,
Garfield,U.S. Senate,Connie Johnson,DEM,240206,1,0,18,19,
Garfield,Governor,Dax Ewbank,REP,240206,0,0,19,19,
Garfield,Governor,Chad Moody,REP,240206,0,1,33,34,
Garfield,Governor,Mary Fallin,REP,240206,0,2,100,102,
Garfield,Superintendent of Public Instruction,Brian Kelly,REP,240206,0,3,34,37,
Garfield,Superintendent of Public Instruction,Janet Costello Barresi,REP,240206,0,0,29,29,
Garfield,Superintendent of Public Instruction,Joy Hofmeister,REP,240206,0,0,88,88,
Garfield,Insurance Commissioner,Bill Viner,REP,240206,0,2,32,34,
Garfield,Insurance Commissioner,John Doak,REP,240206,0,1,114,115,
Garfield,Corporation Commissioner,Todd Hiett,REP,240206,0,1,65,66,
Garfield,Corporation Commissioner,Cliff Branan,REP,240206,0,2,81,83,
Garfield,U.S. Senate,Evelyn Rogers,REP,240206,0,0,6,6,
Garfield,U.S. Senate,Rob Moye,REP,240206,0,0,0,0,
Garfield,U.S. Senate,D. Jean Mcbride-Samuels,REP,240206,0,0,0,0,
Garfield,U.S. Senate,Jim Inhofe,REP,240206,0,3,136,139,
Garfield,U.S. Senate,Erick Paul Wyatt,REP,240206,0,0,9,9,
Garfield,U.S. Senate,Andy Craig,REP,240206,0,1,1,2,
Garfield,U.S. Senate,T. Shannon,REP,240206,0,0,62,62,
Garfield,U.S. Senate,Randy Brogdon,REP,240206,0,1,5,6,
Garfield,U.S. Senate,Eric Mccray,REP,240206,0,0,0,0,
Garfield,U.S. Senate,Kevin Crow,REP,240206,0,0,0,0,
Garfield,U.S. Senate,James Lankford,REP,240206,0,1,81,82,
Garfield,U.S. Senate,Jason Weger,REP,240206,0,0,1,1,
Garfield,U.S. House,Timothy Ray Murray,REP,240206,0,1,3,4,03
Garfield,U.S. House,Robert Hubbard,REP,240206,0,0,11,11,03
Garfield,U.S. House,Frank Lucas,REP,240206,0,2,137,139,03
Garfield,State House,Mike Stuber,REP,240206,0,1,66,67,40
Garfield,State House,Chad Caldwell,REP,240206,0,2,84,86,40
Garfield,Superintendent of Public Instruction,John Cox,DEM,240207,0,0,14,14,
Garfield,Superintendent of Public Instruction,Jack Jr.,DEM,240207,0,0,3,3,
Garfield,Superintendent of Public Instruction,Ivan Holmes,DEM,240207,0,1,2,3,
Garfield,Superintendent of Public Instruction,Freda Deskin,DEM,240207,0,0,19,19,
Garfield,U.S. Senate,Patrick Michael Hayes,DEM,240207,0,0,8,8,
Garfield,U.S. Senate,Jim Rogers,DEM,240207,0,1,11,12,
Garfield,U.S. Senate,Connie Johnson,DEM,240207,0,0,19,19,
Garfield,Governor,Dax Ewbank,REP,240207,1,0,28,29,
Garfield,Governor,Chad Moody,REP,240207,0,1,42,43,
Garfield,Governor,Mary Fallin,REP,240207,1,5,98,104,
Garfield,Superintendent of Public Instruction,Brian Kelly,REP,240207,1,0,38,39,
Garfield,Superintendent of Public Instruction,Janet Costello Barresi,REP,240207,0,0,20,20,
Garfield,Superintendent of Public Instruction,Joy Hofmeister,REP,240207,1,6,109,116,
Garfield,Insurance Commissioner,Bill Viner,REP,240207,0,0,46,46,
Garfield,Insurance Commissioner,John Doak,REP,240207,2,5,112,119,
Garfield,Corporation Commissioner,Todd Hiett,REP,240207,1,3,83,87,
Garfield,Corporation Commissioner,Cliff Branan,REP,240207,1,3,77,81,
Garfield,U.S. Senate,Evelyn Rogers,REP,240207,0,0,10,10,
Garfield,U.S. Senate,Rob Moye,REP,240207,0,0,3,3,
Garfield,U.S. Senate,D. Jean Mcbride-Samuels,REP,240207,0,0,2,2,
Garfield,U.S. Senate,Jim Inhofe,REP,240207,1,6,140,147,
Garfield,U.S. Senate,Erick Paul Wyatt,REP,240207,1,0,12,13,
Garfield,U.S. Senate,Andy Craig,REP,240207,0,0,1,1,
Garfield,U.S. Senate,T. Shannon,REP,240207,0,1,63,64,
Garfield,U.S. Senate,Randy Brogdon,REP,240207,1,0,6,7,
Garfield,U.S. Senate,Eric Mccray,REP,240207,0,0,3,3,
Garfield,U.S. Senate,Kevin Crow,REP,240207,0,0,5,5,
Garfield,U.S. Senate,James Lankford,REP,240207,1,5,89,95,
Garfield,U.S. Senate,Jason Weger,REP,240207,0,0,1,1,
Garfield,U.S. House,Timothy Ray Murray,REP,240207,0,0,7,7,03
Garfield,U.S. House,Robert Hubbard,REP,240207,0,0,23,23,03
Garfield,U.S. House,Frank Lucas,REP,240207,2,6,137,145,03
Garfield,State House,Mike Stuber,REP,240207,2,2,76,80,40
Garfield,State House,Chad Caldwell,REP,240207,0,2,88,90,40
Garfield,Superintendent of Public Instruction,John Cox,DEM,240208,0,0,3,3,
Garfield,Superintendent of Public Instruction,Jack Jr.,DEM,240208,0,0,1,1,
Garfield,Superintendent of Public Instruction,Ivan Holmes,DEM,240208,0,0,0,0,
Garfield,Superintendent of Public Instruction,Freda Deskin,DEM,240208,0,0,0,0,
Garfield,U.S. Senate,Patrick Michael Hayes,DEM,240208,0,0,1,1,
Garfield,U.S. Senate,Jim Rogers,DEM,240208,0,0,3,3,
Garfield,U.S. Senate,Connie Johnson,DEM,240208,0,0,0,0,
Garfield,Governor,Dax Ewbank,REP,240208,0,0,3,3,
Garfield,Governor,Chad Moody,REP,240208,0,0,12,12,
Garfield,Governor,Mary Fallin,REP,240208,0,0,40,40,
Garfield,Superintendent of Public Instruction,Brian Kelly,REP,240208,0,0,8,8,
Garfield,Superintendent of Public Instruction,Janet Costello Barresi,REP,240208,0,0,7,7,
Garfield,Superintendent of Public Instruction,Joy Hofmeister,REP,240208,0,0,42,42,
Garfield,Insurance Commissioner,Bill Viner,REP,240208,0,0,12,12,
Garfield,Insurance Commissioner,John Doak,REP,240208,0,0,41,41,
Garfield,Corporation Commissioner,Todd Hiett,REP,240208,0,0,31,31,
Garfield,Corporation Commissioner,Cliff Branan,REP,240208,0,0,22,22,
Garfield,U.S. Senate,Evelyn Rogers,REP,240208,0,0,0,0,
Garfield,U.S. Senate,Rob Moye,REP,240208,0,0,2,2,
Garfield,U.S. Senate,D. Jean Mcbride-Samuels,REP,240208,0,0,0,0,
Garfield,U.S. Senate,Jim Inhofe,REP,240208,0,0,52,52,
Garfield,U.S. Senate,Erick Paul Wyatt,REP,240208,0,0,2,2,
Garfield,U.S. Senate,Andy Craig,REP,240208,0,0,0,0,
Garfield,U.S. Senate,T. Shannon,REP,240208,0,0,24,24,
Garfield,U.S. Senate,Randy Brogdon,REP,240208,0,0,0,0,
Garfield,U.S. Senate,Eric Mccray,REP,240208,0,0,0,0,
Garfield,U.S. Senate,Kevin Crow,REP,240208,0,0,2,2,
Garfield,U.S. Senate,James Lankford,REP,240208,0,0,30,30,
Garfield,U.S. Senate,Jason Weger,REP,240208,0,0,1,1,
Garfield,U.S. House,Timothy Ray Murray,REP,240208,0,0,4,4,03
Garfield,U.S. House,Robert Hubbard,REP,240208,0,0,2,2,03
Garfield,U.S. House,Frank Lucas,REP,240208,0,0,50,50,03
Garfield,State House,Ross Vanhooser,REP,240208,0,0,13,13,41
Garfield,State House,John Enns,REP,240208,0,0,44,44,41
Garfield,Superintendent of Public Instruction,John Cox,DEM,240210,0,0,14,14,
Garfield,Superintendent of Public Instruction,Jack Jr.,DEM,240210,0,0,2,2,
Garfield,Superintendent of Public Instruction,Ivan Holmes,DEM,240210,0,0,3,3,
Garfield,Superintendent of Public Instruction,Freda Deskin,DEM,240210,0,0,6,6,
Garfield,U.S. Senate,Patrick Michael Hayes,DEM,240210,0,0,6,6,
Garfield,U.S. Senate,Jim Rogers,DEM,240210,0,0,8,8,
Garfield,U.S. Senate,Connie Johnson,DEM,240210,0,0,10,10,
Garfield,Governor,Dax Ewbank,REP,240210,0,0,15,15,
Garfield,Governor,Chad Moody,REP,240210,0,0,29,29,
Garfield,Governor,Mary Fallin,REP,240210,0,0,59,59,
Garfield,Superintendent of Public Instruction,Brian Kelly,REP,240210,0,0,22,22,
Garfield,Superintendent of Public Instruction,Janet Costello Barresi,REP,240210,0,0,11,11,
Garfield,Superintendent of Public Instruction,Joy Hofmeister,REP,240210,0,0,69,69,
Garfield,Insurance Commissioner,Bill Viner,REP,240210,0,0,25,25,
Garfield,Insurance Commissioner,John Doak,REP,240210,0,0,73,73,
Garfield,Corporation Commissioner,Todd Hiett,REP,240210,0,0,42,42,
Garfield,Corporation Commissioner,Cliff Branan,REP,240210,0,0,56,56,
Garfield,U.S. Senate,Evelyn Rogers,REP,240210,0,0,3,3,
Garfield,U.S. Senate,Rob Moye,REP,240210,0,0,3,3,
Garfield,U.S. Senate,D. Jean Mcbride-Samuels,REP,240210,0,0,1,1,
Garfield,U.S. Senate,Jim Inhofe,REP,240210,0,0,87,87,
Garfield,U.S. Senate,Erick Paul Wyatt,REP,240210,0,0,7,7,
Garfield,U.S. Senate,Andy Craig,REP,240210,0,0,3,3,
Garfield,U.S. Senate,T. Shannon,REP,240210,0,0,36,36,
Garfield,U.S. Senate,Randy Brogdon,REP,240210,0,0,3,3,
Garfield,U.S. Senate,Eric Mccray,REP,240210,0,0,1,1,
Garfield,U.S. Senate,Kevin Crow,REP,240210,0,0,3,3,
Garfield,U.S. Senate,James Lankford,REP,240210,0,0,55,55,
Garfield,U.S. Senate,Jason Weger,REP,240210,0,0,3,3,
Garfield,U.S. House,Timothy Ray Murray,REP,240210,0,0,12,12,03
Garfield,U.S. House,Robert Hubbard,REP,240210,0,0,9,9,03
Garfield,U.S. House,Frank Lucas,REP,240210,0,0,81,81,03
Garfield,State House,Roy Chaney,REP,240210,0,0,8,8,38
Garfield,State House,Niki Schrader,REP,240210,0,0,43,43,38
Garfield,State House,Jason Warren,REP,240210,0,0,4,4,38
Garfield,State House,Ralph Meade,REP,240210,0,0,5,5,38
Garfield,State House,John Pfeiffer,REP,240210,0,0,36,36,38
Garfield,State House,Harold Levalley,REP,240210,0,0,6,6,38
Garfield,Superintendent of Public Instruction,John Cox,DEM,240211,1,0,13,14,
Garfield,Superintendent of Public Instruction,Jack Jr.,DEM,240211,0,0,5,5,
Garfield,Superintendent of Public Instruction,Ivan Holmes,DEM,240211,0,0,1,1,
Garfield,Superintendent of Public Instruction,Freda Deskin,DEM,240211,1,0,18,19,
Garfield,U.S. Senate,Patrick Michael Hayes,DEM,240211,0,0,11,11,
Garfield,U.S. Senate,Jim Rogers,DEM,240211,1,0,13,14,
Garfield,U.S. Senate,Connie Johnson,DEM,240211,0,0,13,13,
Garfield,Governor,Dax Ewbank,REP,240211,1,1,22,24,
Garfield,Governor,Chad Moody,REP,240211,2,2,45,49,
Garfield,Governor,Mary Fallin,REP,240211,2,3,126,131,
Garfield,Superintendent of Public Instruction,Brian Kelly,REP,240211,0,1,37,38,
Garfield,Superintendent of Public Instruction,Janet Costello Barresi,REP,240211,1,0,16,17,
Garfield,Superintendent of Public Instruction,Joy Hofmeister,REP,240211,4,5,142,151,
Garfield,Insurance Commissioner,Bill Viner,REP,240211,0,1,39,40,
Garfield,Insurance Commissioner,John Doak,REP,240211,5,5,143,153,
Garfield,Corporation Commissioner,Todd Hiett,REP,240211,5,1,91,97,
Garfield,Corporation Commissioner,Cliff Branan,REP,240211,0,4,86,90,
Garfield,U.S. Senate,Evelyn Rogers,REP,240211,0,0,10,10,
Garfield,U.S. Senate,Rob Moye,REP,240211,0,0,0,0,
Garfield,U.S. Senate,D. Jean Mcbride-Samuels,REP,240211,0,0,1,1,
Garfield,U.S. Senate,Jim Inhofe,REP,240211,5,6,171,182,
Garfield,U.S. Senate,Erick Paul Wyatt,REP,240211,0,0,12,12,
Garfield,U.S. Senate,Andy Craig,REP,240211,0,0,4,4,
Garfield,U.S. Senate,T. Shannon,REP,240211,4,3,60,67,
Garfield,U.S. Senate,Randy Brogdon,REP,240211,0,0,4,4,
Garfield,U.S. Senate,Eric Mccray,REP,240211,0,0,1,1,
Garfield,U.S. Senate,Kevin Crow,REP,240211,0,0,8,8,
Garfield,U.S. Senate,James Lankford,REP,240211,1,3,114,118,
Garfield,U.S. Senate,Jason Weger,REP,240211,0,0,1,1,
Garfield,U.S. House,Timothy Ray Murray,REP,240211,0,0,5,5,03
Garfield,U.S. House,Robert Hubbard,REP,240211,1,0,15,16,03
Garfield,U.S. House,Frank Lucas,REP,240211,4,6,172,182,03
Garfield,State House,Roy Chaney,REP,240211,1,2,16,19,38
Garfield,State House,Niki Schrader,REP,240211,3,2,117,122,38
Garfield,State House,Jason Warren,REP,240211,0,0,6,6,38
Garfield,State House,Ralph Meade,REP,240211,0,1,12,13,38
Garfield,State House,John Pfeiffer,REP,240211,1,1,41,43,38
Garfield,State House,Harold Levalley,REP,240211,0,0,2,2,38
Garfield,Superintendent of Public Instruction,John Cox,DEM,240212,1,0,5,6,
Garfield,Superintendent of Public Instruction,Jack Jr.,DEM,240212,0,0,3,3,
Garfield,Superintendent of Public Instruction,Ivan Holmes,DEM,240212,0,0,2,2,
Garfield,Superintendent of Public Instruction,Freda Deskin,DEM,240212,0,0,6,6,
Garfield,U.S. Senate,Patrick Michael Hayes,DEM,240212,0,0,3,3,
Garfield,U.S. Senate,Jim Rogers,DEM,240212,1,0,6,7,
Garfield,U.S. Senate,Connie Johnson,DEM,240212,0,0,8,8,
Garfield,Governor,Dax Ewbank,REP,240212,1,0,19,20,
Garfield,Governor,Chad Moody,REP,240212,1,1,16,18,
Garfield,Governor,Mary Fallin,REP,240212,0,4,72,76,
Garfield,Superintendent of Public Instruction,Brian Kelly,REP,240212,1,3,18,22,
Garfield,Superintendent of Public Instruction,Janet Costello Barresi,REP,240212,0,1,16,17,
Garfield,Superintendent of Public Instruction,Joy Hofmeister,REP,240212,1,0,73,74,
Garfield,Insurance Commissioner,Bill Viner,REP,240212,1,0,19,20,
Garfield,Insurance Commissioner,John Doak,REP,240212,1,5,86,92,
Garfield,Corporation Commissioner,Todd Hiett,REP,240212,2,1,52,55,
Garfield,Corporation Commissioner,Cliff Branan,REP,240212,0,4,52,56,
Garfield,U.S. Senate,Evelyn Rogers,REP,240212,0,0,4,4,
Garfield,U.S. Senate,Rob Moye,REP,240212,0,0,1,1,
Garfield,U.S. Senate,D. Jean Mcbride-Samuels,REP,240212,0,0,1,1,
Garfield,U.S. Senate,Jim Inhofe,REP,240212,1,5,100,106,
Garfield,U.S. Senate,Erick Paul Wyatt,REP,240212,1,0,2,3,
Garfield,U.S. Senate,Andy Craig,REP,240212,0,0,1,1,
Garfield,U.S. Senate,T. Shannon,REP,240212,0,3,43,46,
Garfield,U.S. Senate,Randy Brogdon,REP,240212,0,0,1,1,
Garfield,U.S. Senate,Eric Mccray,REP,240212,1,0,1,2,
Garfield,U.S. Senate,Kevin Crow,REP,240212,0,0,0,0,
Garfield,U.S. Senate,James Lankford,REP,240212,1,2,60,63,
Garfield,U.S. Senate,Jason Weger,REP,240212,0,0,1,1,
Garfield,U.S. House,Timothy Ray Murray,REP,240212,0,0,2,2,03
Garfield,U.S. House,Robert Hubbard,REP,240212,0,0,7,7,03
Garfield,U.S. House,Frank Lucas,REP,240212,2,5,97,104,03
Garfield,State House,Roy Chaney,REP,240212,0,0,16,16,38
Garfield,State House,Niki Schrader,REP,240212,0,2,14,16,38
Garfield,State House,Jason Warren,REP,240212,1,0,1,2,38
Garfield,State House,Ralph Meade,REP,240212,1,0,19,20,38
Garfield,State House,John Pfeiffer,REP,240212,0,1,40,41,38
Garfield,State House,Harold Levalley,REP,240212,0,2,15,17,38
Garfield,Superintendent of Public Instruction,John Cox,DEM,240301,0,0,17,17,
Garfield,Superintendent of Public Instruction,Jack Jr.,DEM,240301,0,0,5,5,
Garfield,Superintendent of Public Instruction,Ivan Holmes,DEM,240301,0,0,3,3,
Garfield,Superintendent of Public Instruction,Freda Deskin,DEM,240301,0,2,13,15,
Garfield,U.S. Senate,Patrick Michael Hayes,DEM,240301,0,0,14,14,
Garfield,U.S. Senate,Jim Rogers,DEM,240301,0,0,7,7,
Garfield,U.S. Senate,Connie Johnson,DEM,240301,0,2,17,19,
Garfield,Governor,Dax Ewbank,REP,240301,1,3,25,29,
Garfield,Governor,Chad Moody,REP,240301,1,1,39,41,
Garfield,Governor,Mary Fallin,REP,240301,1,12,126,139,
Garfield,Superintendent of Public Instruction,Brian Kelly,REP,240301,2,1,49,52,
Garfield,Superintendent of Public Instruction,Janet Costello Barresi,REP,240301,1,3,26,30,
Garfield,Superintendent of Public Instruction,Joy Hofmeister,REP,240301,0,14,118,132,
Garfield,Insurance Commissioner,Bill Viner,REP,240301,0,3,34,37,
Garfield,Insurance Commissioner,John Doak,REP,240301,2,12,147,161,
Garfield,Corporation Commissioner,Todd Hiett,REP,240301,1,8,89,98,
Garfield,Corporation Commissioner,Cliff Branan,REP,240301,1,7,92,100,
Garfield,U.S. Senate,Evelyn Rogers,REP,240301,0,0,5,5,
Garfield,U.S. Senate,Rob Moye,REP,240301,0,0,0,0,
Garfield,U.S. Senate,D. Jean Mcbride-Samuels,REP,240301,0,0,1,1,
Garfield,U.S. Senate,Jim Inhofe,REP,240301,3,18,180,201,
Garfield,U.S. Senate,Erick Paul Wyatt,REP,240301,0,0,4,4,
Garfield,U.S. Senate,Andy Craig,REP,240301,0,0,0,0,
Garfield,U.S. Senate,T. Shannon,REP,240301,1,7,62,70,
Garfield,U.S. Senate,Randy Brogdon,REP,240301,0,0,0,0,
Garfield,U.S. Senate,Eric Mccray,REP,240301,0,0,0,0,
Garfield,U.S. Senate,Kevin Crow,REP,240301,0,0,4,4,
Garfield,U.S. Senate,James Lankford,REP,240301,2,11,124,137,
Garfield,U.S. Senate,Jason Weger,REP,240301,0,0,2,2,
Garfield,U.S. House,Timothy Ray Murray,REP,240301,0,0,5,5,03
Garfield,U.S. House,Robert Hubbard,REP,240301,0,4,14,18,03
Garfield,U.S. House,Frank Lucas,REP,240301,3,14,170,187,03
Garfield,State House,Mike Stuber,REP,240301,1,11,76,88,40
Garfield,State House,Chad Caldwell,REP,240301,2,7,113,122,40
Garfield,Superintendent of Public Instruction,John Cox,DEM,240302,0,3,26,29,
Garfield,Superintendent of Public Instruction,Jack Jr.,DEM,240302,1,1,13,15,
Garfield,Superintendent of Public Instruction,Ivan Holmes,DEM,240302,1,1,5,7,
Garfield,Superintendent of Public Instruction,Freda Deskin,DEM,240302,2,2,37,41,
Garfield,U.S. Senate,Patrick Michael Hayes,DEM,240302,1,2,30,33,
Garfield,U.S. Senate,Jim Rogers,DEM,240302,0,2,28,30,
Garfield,U.S. Senate,Connie Johnson,DEM,240302,3,3,23,29,
Garfield,Governor,Dax Ewbank,REP,240302,0,3,71,74,
Garfield,Governor,Chad Moody,REP,240302,0,7,99,106,
Garfield,Governor,Mary Fallin,REP,240302,14,25,302,341,
Garfield,Superintendent of Public Instruction,Brian Kelly,REP,240302,1,5,117,123,
Garfield,Superintendent of Public Instruction,Janet Costello Barresi,REP,240302,7,7,66,80,
Garfield,Superintendent of Public Instruction,Joy Hofmeister,REP,240302,5,24,292,321,
Garfield,Insurance Commissioner,Bill Viner,REP,240302,7,7,110,124,
Garfield,Insurance Commissioner,John Doak,REP,240302,6,26,340,372,
Garfield,Corporation Commissioner,Todd Hiett,REP,240302,10,19,227,256,
Garfield,Corporation Commissioner,Cliff Branan,REP,240302,3,15,227,245,
Garfield,U.S. Senate,Evelyn Rogers,REP,240302,0,0,29,29,
Garfield,U.S. Senate,Rob Moye,REP,240302,0,1,9,10,
Garfield,U.S. Senate,D. Jean Mcbride-Samuels,REP,240302,0,0,2,2,
Garfield,U.S. Senate,Jim Inhofe,REP,240302,14,35,401,450,
Garfield,U.S. Senate,Erick Paul Wyatt,REP,240302,0,0,31,31,
Garfield,U.S. Senate,Andy Craig,REP,240302,0,0,7,7,
Garfield,U.S. Senate,T. Shannon,REP,240302,7,18,167,192,
Garfield,U.S. Senate,Randy Brogdon,REP,240302,0,0,13,13,
Garfield,U.S. Senate,Eric Mccray,REP,240302,0,0,4,4,
Garfield,U.S. Senate,Kevin Crow,REP,240302,0,0,11,11,
Garfield,U.S. Senate,James Lankford,REP,240302,5,19,271,295,
Garfield,U.S. Senate,Jason Weger,REP,240302,0,0,3,3,
Garfield,U.S. House,Timothy Ray Murray,REP,240302,0,1,23,24,03
Garfield,U.S. House,Robert Hubbard,REP,240302,2,3,51,56,03
Garfield,U.S. House,Frank Lucas,REP,240302,12,32,402,446,03
Garfield,State House,Ross Vanhooser,REP,240302,6,13,144,163,41
Garfield,State House,John Enns,REP,240302,8,24,332,364,41
Garfield,Superintendent of Public Instruction,John Cox,DEM,240304,0,4,21,25,
Garfield,Superintendent of Public Instruction,Jack Jr.,DEM,240304,0,2,9,11,
Garfield,Superintendent of Public Instruction,Ivan Holmes,DEM,240304,0,1,6,7,
Garfield,Superintendent of Public Instruction,Freda Deskin,DEM,240304,0,0,29,29,
Garfield,U.S. Senate,Patrick Michael Hayes,DEM,240304,0,2,26,28,
Garfield,U.S. Senate,Jim Rogers,DEM,240304,0,2,15,17,
Garfield,U.S. Senate,Connie Johnson,DEM,240304,0,3,19,22,
Garfield,Governor,Dax Ewbank,REP,240304,3,3,75,81,
Garfield,Governor,Chad Moody,REP,240304,3,5,89,97,
Garfield,Governor,Mary Fallin,REP,240304,5,39,328,372,
Garfield,Superintendent of Public Instruction,Brian Kelly,REP,240304,3,10,101,114,
Garfield,Superintendent of Public Instruction,Janet Costello Barresi,REP,240304,2,7,58,67,
Garfield,Superintendent of Public Instruction,Joy Hofmeister,REP,240304,5,30,332,367,
Garfield,Insurance Commissioner,Bill Viner,REP,240304,0,4,104,108,
Garfield,Insurance Commissioner,John Doak,REP,240304,9,35,368,412,
Garfield,Corporation Commissioner,Todd Hiett,REP,240304,7,20,232,259,
Garfield,Corporation Commissioner,Cliff Branan,REP,240304,3,22,237,262,
Garfield,U.S. Senate,Evelyn Rogers,REP,240304,0,0,33,33,
Garfield,U.S. Senate,Rob Moye,REP,240304,1,2,12,15,
Garfield,U.S. Senate,D. Jean Mcbride-Samuels,REP,240304,0,0,5,5,
Garfield,U.S. Senate,Jim Inhofe,REP,240304,10,42,422,474,
Garfield,U.S. Senate,Erick Paul Wyatt,REP,240304,0,2,20,22,
Garfield,U.S. Senate,Andy Craig,REP,240304,0,0,7,7,
Garfield,U.S. Senate,T. Shannon,REP,240304,6,19,168,193,
Garfield,U.S. Senate,Randy Brogdon,REP,240304,0,0,9,9,
Garfield,U.S. Senate,Eric Mccray,REP,240304,0,0,5,5,
Garfield,U.S. Senate,Kevin Crow,REP,240304,0,0,7,7,
Garfield,U.S. Senate,James Lankford,REP,240304,4,28,300,332,
Garfield,U.S. Senate,Jason Weger,REP,240304,1,0,1,2,
Garfield,U.S. House,Timothy Ray Murray,REP,240304,0,2,28,30,03
Garfield,U.S. House,Robert Hubbard,REP,240304,2,2,54,58,03
Garfield,U.S. House,Frank Lucas,REP,240304,8,44,413,465,03
Garfield,State House,Ross Vanhooser,REP,240304,4,22,194,220,41
Garfield,State House,John Enns,REP,240304,7,25,306,338,41
Garfield,Superintendent of Public Instruction,John Cox,DEM,240305,0,3,30,33,
Garfield,Superintendent of Public Instruction,Jack Jr.,DEM,240305,2,1,7,10,
Garfield,Superintendent of Public Instruction,Ivan Holmes,DEM,240305,0,2,4,6,
Garfield,Superintendent of Public Instruction,Freda Deskin,DEM,240305,0,7,18,25,
Garfield,U.S. Senate,Patrick Michael Hayes,DEM,240305,0,2,8,10,
Garfield,U.S. Senate,Jim Rogers,DEM,240305,0,7,18,25,
Garfield,U.S. Senate,Connie Johnson,DEM,240305,0,3,32,35,
Garfield,Governor,Dax Ewbank,REP,240305,1,6,48,55,
Garfield,Governor,Chad Moody,REP,240305,0,7,65,72,
Garfield,Governor,Mary Fallin,REP,240305,19,33,332,384,
Garfield,Superintendent of Public Instruction,Brian Kelly,REP,240305,2,3,69,74,
Garfield,Superintendent of Public Instruction,Janet Costello Barresi,REP,240305,4,15,100,119,
Garfield,Superintendent of Public Instruction,Joy Hofmeister,REP,240305,15,30,277,322,
Garfield,Insurance Commissioner,Bill Viner,REP,240305,5,10,91,106,
Garfield,Insurance Commissioner,John Doak,REP,240305,15,34,331,380,
Garfield,Corporation Commissioner,Todd Hiett,REP,240305,12,22,193,227,
Garfield,Corporation Commissioner,Cliff Branan,REP,240305,8,21,237,266,
Garfield,U.S. Senate,Evelyn Rogers,REP,240305,0,5,14,19,
Garfield,U.S. Senate,Rob Moye,REP,240305,0,0,6,6,
Garfield,U.S. Senate,D. Jean Mcbride-Samuels,REP,240305,0,0,4,4,
Garfield,U.S. Senate,Jim Inhofe,REP,240305,20,38,406,464,
Garfield,U.S. Senate,Erick Paul Wyatt,REP,240305,0,4,17,21,
Garfield,U.S. Senate,Andy Craig,REP,240305,0,0,3,3,
Garfield,U.S. Senate,T. Shannon,REP,240305,7,13,137,157,
Garfield,U.S. Senate,Randy Brogdon,REP,240305,0,0,7,7,
Garfield,U.S. Senate,Eric Mccray,REP,240305,0,0,1,1,
Garfield,U.S. Senate,Kevin Crow,REP,240305,0,0,2,2,
Garfield,U.S. Senate,James Lankford,REP,240305,14,34,300,348,
Garfield,U.S. Senate,Jason Weger,REP,240305,0,2,2,4,
Garfield,U.S. House,Timothy Ray Murray,REP,240305,1,4,16,21,03
Garfield,U.S. House,Robert Hubbard,REP,240305,0,3,40,43,03
Garfield,U.S. House,Frank Lucas,REP,240305,20,40,393,453,03
Garfield,State House,Mike Stuber,REP,240305,11,22,152,185,40
Garfield,State House,Chad Caldwell,REP,240305,10,26,296,332,40
Garfield,Superintendent of Public Instruction,John Cox,DEM,240306,1,0,13,14,
Garfield,Superintendent of Public Instruction,Jack Jr.,DEM,240306,0,0,10,10,
Garfield,Superintendent of Public Instruction,Ivan Holmes,DEM,240306,0,0,2,2,
Garfield,Superintendent of Public Instruction,Freda Deskin,DEM,240306,3,1,15,19,
Garfield,U.S. Senate,Patrick Michael Hayes,DEM,240306,0,0,11,11,
Garfield,U.S. Senate,Jim Rogers,DEM,240306,2,0,17,19,
Garfield,U.S. Senate,Connie Johnson,DEM,240306,2,1,11,14,
Garfield,Governor,Dax Ewbank,REP,240306,0,2,24,26,
Garfield,Governor,Chad Moody,REP,240306,0,1,43,44,
Garfield,Governor,Mary Fallin,REP,240306,4,8,143,155,
Garfield,Superintendent of Public Instruction,Brian Kelly,REP,240306,0,3,30,33,
Garfield,Superintendent of Public Instruction,Janet Costello Barresi,REP,240306,2,2,37,41,
Garfield,Superintendent of Public Instruction,Joy Hofmeister,REP,240306,2,6,145,153,
Garfield,Insurance Commissioner,Bill Viner,REP,240306,1,2,50,53,
Garfield,Insurance Commissioner,John Doak,REP,240306,3,7,153,163,
Garfield,Corporation Commissioner,Todd Hiett,REP,240306,2,6,95,103,
Garfield,Corporation Commissioner,Cliff Branan,REP,240306,2,4,106,112,
Garfield,U.S. Senate,Evelyn Rogers,REP,240306,0,0,6,6,
Garfield,U.S. Senate,Rob Moye,REP,240306,0,1,2,3,
Garfield,U.S. Senate,D. Jean Mcbride-Samuels,REP,240306,0,0,5,5,
Garfield,U.S. Senate,Jim Inhofe,REP,240306,4,9,187,200,
Garfield,U.S. Senate,Erick Paul Wyatt,REP,240306,0,1,9,10,
Garfield,U.S. Senate,Andy Craig,REP,240306,0,0,2,2,
Garfield,U.S. Senate,T. Shannon,REP,240306,1,3,74,78,
Garfield,U.S. Senate,Randy Brogdon,REP,240306,1,0,8,9,
Garfield,U.S. Senate,Eric Mccray,REP,240306,0,0,3,3,
Garfield,U.S. Senate,Kevin Crow,REP,240306,0,0,1,1,
Garfield,U.S. Senate,James Lankford,REP,240306,2,8,123,133,
Garfield,U.S. Senate,Jason Weger,REP,240306,0,0,0,0,
Garfield,U.S. House,Timothy Ray Murray,REP,240306,0,1,11,12,03
Garfield,U.S. House,Robert Hubbard,REP,240306,0,1,18,19,03
Garfield,U.S. House,Frank Lucas,REP,240306,4,9,183,196,03
Garfield,State House,Mike Stuber,REP,240306,1,3,87,91,40
Garfield,State House,Chad Caldwell,REP,240306,3,8,121,132,40
Garfield,Superintendent of Public Instruction,John Cox,DEM,240307,1,0,5,6,
Garfield,Superintendent of Public Instruction,Jack Jr.,DEM,240307,0,0,1,1,
Garfield,Superintendent of Public Instruction,Ivan Holmes,DEM,240307,0,0,1,1,
Garfield,Superintendent of Public Instruction,Freda Deskin,DEM,240307,1,0,5,6,
Garfield,U.S. Senate,Patrick Michael Hayes,DEM,240307,0,0,3,3,
Garfield,U.S. Senate,Jim Rogers,DEM,240307,1,0,4,5,
Garfield,U.S. Senate,Connie Johnson,DEM,240307,1,0,5,6,
Garfield,Governor,Dax Ewbank,REP,240307,1,0,9,10,
Garfield,Governor,Chad Moody,REP,240307,1,1,15,17,
Garfield,Governor,Mary Fallin,REP,240307,4,2,62,68,
Garfield,Superintendent of Public Instruction,Brian Kelly,REP,240307,1,0,23,24,
Garfield,Superintendent of Public Instruction,Janet Costello Barresi,REP,240307,1,0,9,10,
Garfield,Superintendent of Public Instruction,Joy Hofmeister,REP,240307,4,3,53,60,
Garfield,Insurance Commissioner,Bill Viner,REP,240307,3,2,24,29,
Garfield,Insurance Commissioner,John Doak,REP,240307,3,1,58,62,
Garfield,Corporation Commissioner,Todd Hiett,REP,240307,5,2,28,35,
Garfield,Corporation Commissioner,Cliff Branan,REP,240307,1,1,52,54,
Garfield,U.S. Senate,Evelyn Rogers,REP,240307,1,0,2,3,
Garfield,U.S. Senate,Rob Moye,REP,240307,1,0,3,4,
Garfield,U.S. Senate,D. Jean Mcbride-Samuels,REP,240307,1,0,0,1,
Garfield,U.S. Senate,Jim Inhofe,REP,240307,3,3,74,80,
Garfield,U.S. Senate,Erick Paul Wyatt,REP,240307,0,0,6,6,
Garfield,U.S. Senate,Andy Craig,REP,240307,1,0,0,1,
Garfield,U.S. Senate,T. Shannon,REP,240307,1,0,38,39,
Garfield,U.S. Senate,Randy Brogdon,REP,240307,0,0,2,2,
Garfield,U.S. Senate,Eric Mccray,REP,240307,0,0,0,0,
Garfield,U.S. Senate,Kevin Crow,REP,240307,0,0,3,3,
Garfield,U.S. Senate,James Lankford,REP,240307,3,2,42,47,
Garfield,U.S. Senate,Jason Weger,REP,240307,0,1,1,2,
Garfield,U.S. House,Timothy Ray Murray,REP,240307,1,0,7,8,03
Garfield,U.S. House,Robert Hubbard,REP,240307,1,1,5,7,03
Garfield,U.S. House,Frank Lucas,REP,240307,3,2,73,78,03
Garfield,State House,Mike Stuber,REP,240307,4,2,49,55,40
Garfield,State House,Chad Caldwell,REP,240307,2,1,35,38,40
Garfield,Superintendent of Public Instruction,John Cox,DEM,240308,0,2,7,9,
Garfield,Superintendent of Public Instruction,Jack Jr.,DEM,240308,1,0,1,2,
Garfield,Superintendent of Public Instruction,Ivan Holmes,DEM,240308,0,0,2,2,
Garfield,Superintendent of Public Instruction,Freda Deskin,DEM,240308,0,1,9,10,
Garfield,U.S. Senate,Patrick Michael Hayes,DEM,240308,0,0,5,5,
Garfield,U.S. Senate,Jim Rogers,DEM,240308,0,2,7,9,
Garfield,U.S. Senate,Connie Johnson,DEM,240308,1,1,8,10,
Garfield,Governor,Dax Ewbank,REP,240308,0,3,25,28,
Garfield,Governor,Chad Moody,REP,240308,1,3,40,44,
Garfield,Governor,Mary Fallin,REP,240308,7,14,99,120,
Garfield,Superintendent of Public Instruction,Brian Kelly,REP,240308,2,8,26,36,
Garfield,Superintendent of Public Instruction,Janet Costello Barresi,REP,240308,4,3,29,36,
Garfield,Superintendent of Public Instruction,Joy Hofmeister,REP,240308,2,9,110,121,
Garfield,Insurance Commissioner,Bill Viner,REP,240308,2,4,28,34,
Garfield,Insurance Commissioner,John Doak,REP,240308,6,13,131,150,
Garfield,Corporation Commissioner,Todd Hiett,REP,240308,5,13,92,110,
Garfield,Corporation Commissioner,Cliff Branan,REP,240308,2,5,65,72,
Garfield,U.S. Senate,Evelyn Rogers,REP,240308,0,2,4,6,
Garfield,U.S. Senate,Rob Moye,REP,240308,0,0,0,0,
Garfield,U.S. Senate,D. Jean Mcbride-Samuels,REP,240308,0,0,3,3,
Garfield,U.S. Senate,Jim Inhofe,REP,240308,7,16,146,169,
Garfield,U.S. Senate,Erick Paul Wyatt,REP,240308,1,1,10,12,
Garfield,U.S. Senate,Andy Craig,REP,240308,0,0,0,0,
Garfield,U.S. Senate,T. Shannon,REP,240308,1,10,64,75,
Garfield,U.S. Senate,Randy Brogdon,REP,240308,1,0,8,9,
Garfield,U.S. Senate,Eric Mccray,REP,240308,0,0,2,2,
Garfield,U.S. Senate,Kevin Crow,REP,240308,0,0,1,1,
Garfield,U.S. Senate,James Lankford,REP,240308,6,10,88,104,
Garfield,U.S. Senate,Jason Weger,REP,240308,0,0,2,2,
Garfield,U.S. House,Timothy Ray Murray,REP,240308,0,0,5,5,03
Garfield,U.S. House,Robert Hubbard,REP,240308,1,2,12,15,03
Garfield,U.S. House,Frank Lucas,REP,240308,7,17,146,170,03
Garfield,State House,Ross Vanhooser,REP,240308,6,11,67,84,41
Garfield,State House,John Enns,REP,240308,2,9,98,109,41
Garfield,Superintendent of Public Instruction,John Cox,DEM,240309,0,0,8,8,
Garfield,Superintendent of Public Instruction,Jack Jr.,DEM,240309,0,0,5,5,
Garfield,Superintendent of Public Instruction,Ivan Holmes,DEM,240309,0,0,0,0,
Garfield,Superintendent of Public Instruction,Freda Deskin,DEM,240309,0,1,13,14,
Garfield,U.S. Senate,Patrick Michael Hayes,DEM,240309,0,0,12,12,
Garfield,U.S. Senate,Jim Rogers,DEM,240309,0,1,4,5,
Garfield,U.S. Senate,Connie Johnson,DEM,240309,0,0,10,10,
Garfield,Governor,Dax Ewbank,REP,240309,0,1,33,34,
Garfield,Governor,Chad Moody,REP,240309,0,1,39,40,
Garfield,Governor,Mary Fallin,REP,240309,5,5,90,100,
Garfield,Superintendent of Public Instruction,Brian Kelly,REP,240309,0,0,35,35,
Garfield,Superintendent of Public Instruction,Janet Costello Barresi,REP,240309,3,0,15,18,
Garfield,Superintendent of Public Instruction,Joy Hofmeister,REP,240309,1,7,112,120,
Garfield,Insurance Commissioner,Bill Viner,REP,240309,1,1,33,35,
Garfield,Insurance Commissioner,John Doak,REP,240309,3,5,123,131,
Garfield,Corporation Commissioner,Todd Hiett,REP,240309,4,3,84,91,
Garfield,Corporation Commissioner,Cliff Branan,REP,240309,0,4,71,75,
Garfield,U.S. Senate,Evelyn Rogers,REP,240309,0,0,7,7,
Garfield,U.S. Senate,Rob Moye,REP,240309,1,0,3,4,
Garfield,U.S. Senate,D. Jean Mcbride-Samuels,REP,240309,0,0,0,0,
Garfield,U.S. Senate,Jim Inhofe,REP,240309,4,6,137,147,
Garfield,U.S. Senate,Erick Paul Wyatt,REP,240309,0,1,14,15,
Garfield,U.S. Senate,Andy Craig,REP,240309,0,0,0,0,
Garfield,U.S. Senate,T. Shannon,REP,240309,3,3,58,64,
Garfield,U.S. Senate,Randy Brogdon,REP,240309,0,0,2,2,
Garfield,U.S. Senate,Eric Mccray,REP,240309,0,0,1,1,
Garfield,U.S. Senate,Kevin Crow,REP,240309,0,0,6,6,
Garfield,U.S. Senate,James Lankford,REP,240309,0,4,93,97,
Garfield,U.S. Senate,Jason Weger,REP,240309,0,0,2,2,
Garfield,U.S. House,Timothy Ray Murray,REP,240309,0,0,5,5,03
Garfield,U.S. House,Robert Hubbard,REP,240309,0,1,18,19,03
Garfield,U.S. House,Frank Lucas,REP,240309,5,6,141,152,03
Garfield,State House,Ross Vanhooser,REP,240309,1,2,43,46,41
Garfield,State House,John Enns,REP,240309,4,5,119,128,41
Garfield,Superintendent of Public Instruction,John Cox,DEM,240310,0,0,18,18,
Garfield,Superintendent of Public Instruction,Jack Jr.,DEM,240310,0,1,5,6,
Garfield,Superintendent of Public Instruction,Ivan Holmes,DEM,240310,0,0,2,2,
Garfield,Superintendent of Public Instruction,Freda Deskin,DEM,240310,0,0,9,9,
Garfield,U.S. Senate,Patrick Michael Hayes,DEM,240310,0,1,9,10,
Garfield,U.S. Senate,Jim Rogers,DEM,240310,0,0,11,11,
Garfield,U.S. Senate,Connie Johnson,DEM,240310,0,0,13,13,
Garfield,Governor,Dax Ewbank,REP,240310,0,1,29,30,
Garfield,Governor,Chad Moody,REP,240310,2,0,38,40,
Garfield,Governor,Mary Fallin,REP,240310,6,11,124,141,
Garfield,Superintendent of Public Instruction,Brian Kelly,REP,240310,2,2,33,37,
Garfield,Superintendent of Public Instruction,Janet Costello Barresi,REP,240310,0,4,28,32,
Garfield,Superintendent of Public Instruction,Joy Hofmeister,REP,240310,4,6,130,140,
Garfield,Insurance Commissioner,Bill Viner,REP,240310,0,3,38,41,
Garfield,Insurance Commissioner,John Doak,REP,240310,6,9,146,161,
Garfield,Corporation Commissioner,Todd Hiett,REP,240310,6,7,91,104,
Garfield,Corporation Commissioner,Cliff Branan,REP,240310,0,5,97,102,
Garfield,U.S. Senate,Evelyn Rogers,REP,240310,0,0,10,10,
Garfield,U.S. Senate,Rob Moye,REP,240310,0,0,5,5,
Garfield,U.S. Senate,D. Jean Mcbride-Samuels,REP,240310,0,0,2,2,
Garfield,U.S. Senate,Jim Inhofe,REP,240310,8,12,157,177,
Garfield,U.S. Senate,Erick Paul Wyatt,REP,240310,0,0,17,17,
Garfield,U.S. Senate,Andy Craig,REP,240310,0,0,1,1,
Garfield,U.S. Senate,T. Shannon,REP,240310,4,8,71,83,
Garfield,U.S. Senate,Randy Brogdon,REP,240310,0,0,7,7,
Garfield,U.S. Senate,Eric Mccray,REP,240310,0,0,0,0,
Garfield,U.S. Senate,Kevin Crow,REP,240310,0,0,7,7,
Garfield,U.S. Senate,James Lankford,REP,240310,3,4,105,112,
Garfield,U.S. Senate,Jason Weger,REP,240310,0,0,1,1,
Garfield,U.S. House,Timothy Ray Murray,REP,240310,0,0,8,8,03
Garfield,U.S. House,Robert Hubbard,REP,240310,0,2,31,33,03
Garfield,U.S. House,Frank Lucas,REP,240310,8,10,152,170,03
Garfield,State House,Ross Vanhooser,REP,240310,4,4,37,45,41
Garfield,State House,John Enns,REP,240310,4,8,154,166,41
Garfield,Superintendent of Public Instruction,John Cox,DEM,240311,0,0,16,16,
Garfield,Superintendent of Public Instruction,Jack Jr.,DEM,240311,0,2,8,10,
Garfield,Superintendent of Public Instruction,Ivan Holmes,DEM,240311,0,2,7,9,
Garfield,Superintendent of Public Instruction,Freda Deskin,DEM,240311,1,3,16,20,
Garfield,U.S. Senate,Patrick Michael Hayes,DEM,240311,0,1,12,13,
Garfield,U.S. Senate,Jim Rogers,DEM,240311,0,5,13,18,
Garfield,U.S. Senate,Connie Johnson,DEM,240311,1,1,21,23,
Garfield,Governor,Dax Ewbank,REP,240311,0,6,47,53,
Garfield,Governor,Chad Moody,REP,240311,2,6,62,70,
Garfield,Governor,Mary Fallin,REP,240311,4,12,143,159,
Garfield,Superintendent of Public Instruction,Brian Kelly,REP,240311,2,6,64,72,
Garfield,Superintendent of Public Instruction,Janet Costello Barresi,REP,240311,2,1,25,28,
Garfield,Superintendent of Public Instruction,Joy Hofmeister,REP,240311,2,17,166,185,
Garfield,Insurance Commissioner,Bill Viner,REP,240311,2,8,58,68,
Garfield,Insurance Commissioner,John Doak,REP,240311,4,16,185,205,
Garfield,Corporation Commissioner,Todd Hiett,REP,240311,4,8,120,132,
Garfield,Corporation Commissioner,Cliff Branan,REP,240311,0,14,119,133,
Garfield,U.S. Senate,Evelyn Rogers,REP,240311,0,2,17,19,
Garfield,U.S. Senate,Rob Moye,REP,240311,0,0,9,9,
Garfield,U.S. Senate,D. Jean Mcbride-Samuels,REP,240311,0,0,4,4,
Garfield,U.S. Senate,Jim Inhofe,REP,240311,4,18,214,236,
Garfield,U.S. Senate,Erick Paul Wyatt,REP,240311,0,4,9,13,
Garfield,U.S. Senate,Andy Craig,REP,240311,0,1,1,2,
Garfield,U.S. Senate,T. Shannon,REP,240311,3,3,94,100,
Garfield,U.S. Senate,Randy Brogdon,REP,240311,0,1,3,4,
Garfield,U.S. Senate,Eric Mccray,REP,240311,0,0,0,0,
Garfield,U.S. Senate,Kevin Crow,REP,240311,0,0,3,3,
Garfield,U.S. Senate,James Lankford,REP,240311,3,19,152,174,
Garfield,U.S. Senate,Jason Weger,REP,240311,0,0,1,1,
Garfield,U.S. House,Timothy Ray Murray,REP,240311,1,1,15,17,03
Garfield,U.S. House,Robert Hubbard,REP,240311,1,5,28,34,03
Garfield,U.S. House,Frank Lucas,REP,240311,4,17,211,232,03
Garfield,State House,Ross Vanhooser,REP,240311,1,10,71,82,41
Garfield,State House,John Enns,REP,240311,5,14,184,203,41
Garvin,Superintendent of Public Instruction,John Cox,DEM,250001,0,0,14,14,
Garvin,Superintendent of Public Instruction,Jack Jr.,DEM,250001,0,0,8,8,
Garvin,Superintendent of Public Instruction,Ivan Holmes,DEM,250001,0,0,1,1,
Garvin,Superintendent of Public Instruction,Freda Deskin,DEM,250001,2,0,33,35,
Garvin,U.S. Senate,Patrick Michael Hayes,DEM,250001,1,0,9,10,
Garvin,U.S. Senate,Jim Rogers,DEM,250001,0,0,26,26,
Garvin,U.S. Senate,Connie Johnson,DEM,250001,1,0,18,19,
Garvin,U.S. House,Bert Smith,DEM,250001,2,0,43,45,04
Garvin,U.S. House,Tae Si,DEM,250001,0,0,6,6,04
Garvin,Governor,Dax Ewbank,REP,250001,0,0,12,12,
Garvin,Governor,Chad Moody,REP,250001,1,0,5,6,
Garvin,Governor,Mary Fallin,REP,250001,2,0,51,53,
Garvin,Superintendent of Public Instruction,Brian Kelly,REP,250001,0,0,22,22,
Garvin,Superintendent of Public Instruction,Janet Costello Barresi,REP,250001,0,0,7,7,
Garvin,Superintendent of Public Instruction,Joy Hofmeister,REP,250001,3,0,38,41,
Garvin,Insurance Commissioner,Bill Viner,REP,250001,1,0,14,15,
Garvin,Insurance Commissioner,John Doak,REP,250001,2,0,49,51,
Garvin,Corporation Commissioner,Todd Hiett,REP,250001,3,0,34,37,
Garvin,Corporation Commissioner,Cliff Branan,REP,250001,0,0,29,29,
Garvin,U.S. Senate,Evelyn Rogers,REP,250001,1,0,3,4,
Garvin,U.S. Senate,Rob Moye,REP,250001,0,0,1,1,
Garvin,U.S. Senate,D. Jean Mcbride-Samuels,REP,250001,0,0,0,0,
Garvin,U.S. Senate,Jim Inhofe,REP,250001,2,0,62,64,
Garvin,U.S. Senate,Erick Paul Wyatt,REP,250001,0,0,2,2,
Garvin,U.S. Senate,Andy Craig,REP,250001,0,0,0,0,
Garvin,U.S. Senate,T. Shannon,REP,250001,0,0,21,21,
Garvin,U.S. Senate,Randy Brogdon,REP,250001,0,0,3,3,
Garvin,U.S. Senate,Eric Mccray,REP,250001,0,0,0,0,
Garvin,U.S. Senate,Kevin Crow,REP,250001,0,0,0,0,
Garvin,U.S. Senate,James Lankford,REP,250001,3,0,44,47,
Garvin,U.S. Senate,Jason Weger,REP,250001,0,0,1,1,
Garvin,U.S. House,Anna Flatt,REP,250001,1,0,14,15,04
Garvin,U.S. House,Tom Cole,REP,250001,2,0,55,57,04
Garvin,Superintendent of Public Instruction,John Cox,DEM,250002,1,0,27,28,
Garvin,Superintendent of Public Instruction,Jack Jr.,DEM,250002,0,1,10,11,
Garvin,Superintendent of Public Instruction,Ivan Holmes,DEM,250002,0,0,4,4,
Garvin,Superintendent of Public Instruction,Freda Deskin,DEM,250002,0,0,45,45,
Garvin,U.S. Senate,Patrick Michael Hayes,DEM,250002,1,1,17,19,
Garvin,U.S. Senate,Jim Rogers,DEM,250002,0,0,48,48,
Garvin,U.S. Senate,Connie Johnson,DEM,250002,0,0,18,18,
Garvin,U.S. House,Bert Smith,DEM,250002,0,1,73,74,04
Garvin,U.S. House,Tae Si,DEM,250002,1,0,6,7,04
Garvin,Governor,Dax Ewbank,REP,250002,0,0,11,11,
Garvin,Governor,Chad Moody,REP,250002,0,0,22,22,
Garvin,Governor,Mary Fallin,REP,250002,3,0,62,65,
Garvin,Superintendent of Public Instruction,Brian Kelly,REP,250002,1,0,18,19,
Garvin,Superintendent of Public Instruction,Janet Costello Barresi,REP,250002,0,0,12,12,
Garvin,Superintendent of Public Instruction,Joy Hofmeister,REP,250002,2,0,63,65,
Garvin,Insurance Commissioner,Bill Viner,REP,250002,0,0,13,13,
Garvin,Insurance Commissioner,John Doak,REP,250002,3,0,81,84,
Garvin,Corporation Commissioner,Todd Hiett,REP,250002,2,0,44,46,
Garvin,Corporation Commissioner,Cliff Branan,REP,250002,1,0,44,45,
Garvin,U.S. Senate,Evelyn Rogers,REP,250002,0,0,2,2,
Garvin,U.S. Senate,Rob Moye,REP,250002,0,0,3,3,
Garvin,U.S. Senate,D. Jean Mcbride-Samuels,REP,250002,0,0,0,0,
Garvin,U.S. Senate,Jim Inhofe,REP,250002,3,0,87,90,
Garvin,U.S. Senate,Erick Paul Wyatt,REP,250002,0,0,3,3,
Garvin,U.S. Senate,Andy Craig,REP,250002,0,0,0,0,
Garvin,U.S. Senate,T. Shannon,REP,250002,1,0,37,38,
Garvin,U.S. Senate,Randy Brogdon,REP,250002,0,0,1,1,
Garvin,U.S. Senate,Eric Mccray,REP,250002,0,0,0,0,
Garvin,U.S. Senate,Kevin Crow,REP,250002,0,0,1,1,
Garvin,U.S. Senate,James Lankford,REP,250002,2,0,55,57,
Garvin,U.S. Senate,Jason Weger,REP,250002,0,0,1,1,
Garvin,U.S. House,Anna Flatt,REP,250002,0,0,16,16,04
Garvin,U.S. House,Tom Cole,REP,250002,3,0,75,78,04
Garvin,Superintendent of Public Instruction,John Cox,DEM,250003,0,0,31,31,
Garvin,Superintendent of Public Instruction,Jack Jr.,DEM,250003,0,1,13,14,
Garvin,Superintendent of Public Instruction,Ivan Holmes,DEM,250003,0,0,3,3,
Garvin,Superintendent of Public Instruction,Freda Deskin,DEM,250003,0,1,28,29,
Garvin,U.S. Senate,Patrick Michael Hayes,DEM,250003,0,1,18,19,
Garvin,U.S. Senate,Jim Rogers,DEM,250003,0,0,32,32,
Garvin,U.S. Senate,Connie Johnson,DEM,250003,0,1,22,23,
Garvin,U.S. House,Bert Smith,DEM,250003,0,1,57,58,04
Garvin,U.S. House,Tae Si,DEM,250003,0,1,13,14,04
Garvin,Governor,Dax Ewbank,REP,250003,0,0,9,9,
Garvin,Governor,Chad Moody,REP,250003,0,0,7,7,
Garvin,Governor,Mary Fallin,REP,250003,1,0,61,62,
Garvin,Superintendent of Public Instruction,Brian Kelly,REP,250003,0,0,27,27,
Garvin,Superintendent of Public Instruction,Janet Costello Barresi,REP,250003,1,0,9,10,
Garvin,Superintendent of Public Instruction,Joy Hofmeister,REP,250003,0,0,40,40,
Garvin,Insurance Commissioner,Bill Viner,REP,250003,0,0,11,11,
Garvin,Insurance Commissioner,John Doak,REP,250003,1,0,61,62,
Garvin,Corporation Commissioner,Todd Hiett,REP,250003,1,0,38,39,
Garvin,Corporation Commissioner,Cliff Branan,REP,250003,0,0,34,34,
Garvin,U.S. Senate,Evelyn Rogers,REP,250003,0,0,2,2,
Garvin,U.S. Senate,Rob Moye,REP,250003,0,0,0,0,
Garvin,U.S. Senate,D. Jean Mcbride-Samuels,REP,250003,0,0,1,1,
Garvin,U.S. Senate,Jim Inhofe,REP,250003,1,0,73,74,
Garvin,U.S. Senate,Erick Paul Wyatt,REP,250003,0,0,1,1,
Garvin,U.S. Senate,Andy Craig,REP,250003,0,0,0,0,
Garvin,U.S. Senate,T. Shannon,REP,250003,0,0,32,32,
Garvin,U.S. Senate,Randy Brogdon,REP,250003,0,0,2,2,
Garvin,U.S. Senate,Eric Mccray,REP,250003,0,0,0,0,
Garvin,U.S. Senate,Kevin Crow,REP,250003,0,0,0,0,
Garvin,U.S. Senate,James Lankford,REP,250003,1,0,42,43,
Garvin,U.S. Senate,Jason Weger,REP,250003,0,0,1,1,
Garvin,U.S. House,Anna Flatt,REP,250003,0,0,9,9,04
Garvin,U.S. House,Tom Cole,REP,250003,1,0,67,68,04
Garvin,Superintendent of Public Instruction,John Cox,DEM,250005,0,1,49,50,
Garvin,Superintendent of Public Instruction,Jack Jr.,DEM,250005,0,2,17,19,
Garvin,Superintendent of Public Instruction,Ivan Holmes,DEM,250005,0,0,8,8,
Garvin,Superintendent of Public Instruction,Freda Deskin,DEM,250005,2,3,59,64,
Garvin,U.S. Senate,Patrick Michael Hayes,DEM,250005,0,3,33,36,
Garvin,U.S. Senate,Jim Rogers,DEM,250005,1,3,68,72,
Garvin,U.S. Senate,Connie Johnson,DEM,250005,1,0,29,30,
Garvin,U.S. House,Bert Smith,DEM,250005,2,6,115,123,04
Garvin,U.S. House,Tae Si,DEM,250005,0,0,8,8,04
Garvin,Governor,Dax Ewbank,REP,250005,0,0,10,10,
Garvin,Governor,Chad Moody,REP,250005,0,1,22,23,
Garvin,Governor,Mary Fallin,REP,250005,0,3,76,79,
Garvin,Superintendent of Public Instruction,Brian Kelly,REP,250005,0,1,34,35,
Garvin,Superintendent of Public Instruction,Janet Costello Barresi,REP,250005,0,0,14,14,
Garvin,Superintendent of Public Instruction,Joy Hofmeister,REP,250005,0,3,60,63,
Garvin,Insurance Commissioner,Bill Viner,REP,250005,0,1,27,28,
Garvin,Insurance Commissioner,John Doak,REP,250005,0,3,81,84,
Garvin,Corporation Commissioner,Todd Hiett,REP,250005,0,2,40,42,
Garvin,Corporation Commissioner,Cliff Branan,REP,250005,0,2,64,66,
Garvin,U.S. Senate,Evelyn Rogers,REP,250005,0,0,7,7,
Garvin,U.S. Senate,Rob Moye,REP,250005,0,0,4,4,
Garvin,U.S. Senate,D. Jean Mcbride-Samuels,REP,250005,0,0,1,1,
Garvin,U.S. Senate,Jim Inhofe,REP,250005,0,4,92,96,
Garvin,U.S. Senate,Erick Paul Wyatt,REP,250005,0,0,4,4,
Garvin,U.S. Senate,Andy Craig,REP,250005,0,0,2,2,
Garvin,U.S. Senate,T. Shannon,REP,250005,0,3,44,47,
Garvin,U.S. Senate,Randy Brogdon,REP,250005,0,0,0,0,
Garvin,U.S. Senate,Eric Mccray,REP,250005,0,0,0,0,
Garvin,U.S. Senate,Kevin Crow,REP,250005,0,0,4,4,
Garvin,U.S. Senate,James Lankford,REP,250005,0,1,57,58,
Garvin,U.S. Senate,Jason Weger,REP,250005,0,0,2,2,
Garvin,U.S. House,Anna Flatt,REP,250005,0,0,9,9,04
Garvin,U.S. House,Tom Cole,REP,250005,0,4,100,104,04
Garvin,Superintendent of Public Instruction,John Cox,DEM,250006,0,1,21,22,
Garvin,Superintendent of Public Instruction,Jack Jr.,DEM,250006,0,0,2,2,
Garvin,Superintendent of Public Instruction,Ivan Holmes,DEM,250006,1,0,1,2,
Garvin,Superintendent of Public Instruction,Freda Deskin,DEM,250006,0,1,45,46,
Garvin,U.S. Senate,Patrick Michael Hayes,DEM,250006,0,1,25,26,
Garvin,U.S. Senate,Jim Rogers,DEM,250006,0,0,22,22,
Garvin,U.S. Senate,Connie Johnson,DEM,250006,1,1,20,22,
Garvin,U.S. House,Bert Smith,DEM,250006,0,2,55,57,04
Garvin,U.S. House,Tae Si,DEM,250006,1,0,11,12,04
Garvin,Governor,Dax Ewbank,REP,250006,0,0,1,1,
Garvin,Governor,Chad Moody,REP,250006,0,0,8,8,
Garvin,Governor,Mary Fallin,REP,250006,0,4,21,25,
Garvin,Superintendent of Public Instruction,Brian Kelly,REP,250006,0,1,8,9,
Garvin,Superintendent of Public Instruction,Janet Costello Barresi,REP,250006,0,1,2,3,
Garvin,Superintendent of Public Instruction,Joy Hofmeister,REP,250006,0,1,20,21,
Garvin,Insurance Commissioner,Bill Viner,REP,250006,0,0,3,3,
Garvin,Insurance Commissioner,John Doak,REP,250006,0,3,24,27,
Garvin,Corporation Commissioner,Todd Hiett,REP,250006,0,1,12,13,
Garvin,Corporation Commissioner,Cliff Branan,REP,250006,0,2,15,17,
Garvin,U.S. Senate,Evelyn Rogers,REP,250006,0,1,3,4,
Garvin,U.S. Senate,Rob Moye,REP,250006,0,0,1,1,
Garvin,U.S. Senate,D. Jean Mcbride-Samuels,REP,250006,0,0,0,0,
Garvin,U.S. Senate,Jim Inhofe,REP,250006,0,3,25,28,
Garvin,U.S. Senate,Erick Paul Wyatt,REP,250006,0,0,1,1,
Garvin,U.S. Senate,Andy Craig,REP,250006,0,0,1,1,
Garvin,U.S. Senate,T. Shannon,REP,250006,0,1,11,12,
Garvin,U.S. Senate,Randy Brogdon,REP,250006,0,0,1,1,
Garvin,U.S. Senate,Eric Mccray,REP,250006,0,0,0,0,
Garvin,U.S. Senate,Kevin Crow,REP,250006,0,0,0,0,
Garvin,U.S. Senate,James Lankford,REP,250006,0,3,17,20,
Garvin,U.S. Senate,Jason Weger,REP,250006,0,0,0,0,
Garvin,U.S. House,Anna Flatt,REP,250006,0,0,5,5,04
Garvin,U.S. House,Tom Cole,REP,250006,0,4,24,28,04
Garvin,Superintendent of Public Instruction,John Cox,DEM,250007,0,3,12,15,
Garvin,Superintendent of Public Instruction,Jack Jr.,DEM,250007,0,1,2,3,
Garvin,Superintendent of Public Instruction,Ivan Holmes,DEM,250007,0,1,3,4,
Garvin,Superintendent of Public Instruction,Freda Deskin,DEM,250007,0,5,75,80,
Garvin,U.S. Senate,Patrick Michael Hayes,DEM,250007,0,4,25,29,
Garvin,U.S. Senate,Jim Rogers,DEM,250007,0,4,31,35,
Garvin,U.S. Senate,Connie Johnson,DEM,250007,0,2,32,34,
Garvin,U.S. House,Bert Smith,DEM,250007,0,7,73,80,04
Garvin,U.S. House,Tae Si,DEM,250007,0,1,13,14,04
Garvin,Governor,Dax Ewbank,REP,250007,0,2,8,10,
Garvin,Governor,Chad Moody,REP,250007,0,0,8,8,
Garvin,Governor,Mary Fallin,REP,250007,0,8,37,45,
Garvin,Superintendent of Public Instruction,Brian Kelly,REP,250007,0,1,15,16,
Garvin,Superintendent of Public Instruction,Janet Costello Barresi,REP,250007,0,9,7,16,
Garvin,Superintendent of Public Instruction,Joy Hofmeister,REP,250007,0,0,32,32,
Garvin,Insurance Commissioner,Bill Viner,REP,250007,0,2,10,12,
Garvin,Insurance Commissioner,John Doak,REP,250007,0,8,43,51,
Garvin,Corporation Commissioner,Todd Hiett,REP,250007,0,7,16,23,
Garvin,Corporation Commissioner,Cliff Branan,REP,250007,0,3,34,37,
Garvin,U.S. Senate,Evelyn Rogers,REP,250007,0,1,5,6,
Garvin,U.S. Senate,Rob Moye,REP,250007,0,0,1,1,
Garvin,U.S. Senate,D. Jean Mcbride-Samuels,REP,250007,0,0,1,1,
Garvin,U.S. Senate,Jim Inhofe,REP,250007,0,9,45,54,
Garvin,U.S. Senate,Erick Paul Wyatt,REP,250007,0,0,3,3,
Garvin,U.S. Senate,Andy Craig,REP,250007,0,0,2,2,
Garvin,U.S. Senate,T. Shannon,REP,250007,0,1,21,22,
Garvin,U.S. Senate,Randy Brogdon,REP,250007,0,0,0,0,
Garvin,U.S. Senate,Eric Mccray,REP,250007,0,0,0,0,
Garvin,U.S. Senate,Kevin Crow,REP,250007,0,0,0,0,
Garvin,U.S. Senate,James Lankford,REP,250007,0,9,31,40,
Garvin,U.S. Senate,Jason Weger,REP,250007,0,0,0,0,
Garvin,U.S. House,Anna Flatt,REP,250007,0,3,8,11,04
Garvin,U.S. House,Tom Cole,REP,250007,0,7,46,53,04
Garvin,Superintendent of Public Instruction,John Cox,DEM,250008,0,0,15,15,
Garvin,Superintendent of Public Instruction,Jack Jr.,DEM,250008,0,0,1,1,
Garvin,Superintendent of Public Instruction,Ivan Holmes,DEM,250008,0,0,0,0,
Garvin,Superintendent of Public Instruction,Freda Deskin,DEM,250008,0,4,52,56,
Garvin,U.S. Senate,Patrick Michael Hayes,DEM,250008,0,0,18,18,
Garvin,U.S. Senate,Jim Rogers,DEM,250008,0,2,20,22,
Garvin,U.S. Senate,Connie Johnson,DEM,250008,0,2,25,27,
Garvin,U.S. House,Bert Smith,DEM,250008,0,3,45,48,04
Garvin,U.S. House,Tae Si,DEM,250008,0,1,14,15,04
Garvin,Governor,Dax Ewbank,REP,250008,0,0,3,3,
Garvin,Governor,Chad Moody,REP,250008,1,3,5,9,
Garvin,Governor,Mary Fallin,REP,250008,1,12,52,65,
Garvin,Superintendent of Public Instruction,Brian Kelly,REP,250008,0,5,11,16,
Garvin,Superintendent of Public Instruction,Janet Costello Barresi,REP,250008,1,5,16,22,
Garvin,Superintendent of Public Instruction,Joy Hofmeister,REP,250008,1,5,34,40,
Garvin,Insurance Commissioner,Bill Viner,REP,250008,0,3,14,17,
Garvin,Insurance Commissioner,John Doak,REP,250008,2,12,43,57,
Garvin,Corporation Commissioner,Todd Hiett,REP,250008,2,5,30,37,
Garvin,Corporation Commissioner,Cliff Branan,REP,250008,0,10,29,39,
Garvin,U.S. Senate,Evelyn Rogers,REP,250008,0,0,1,1,
Garvin,U.S. Senate,Rob Moye,REP,250008,0,0,0,0,
Garvin,U.S. Senate,D. Jean Mcbride-Samuels,REP,250008,1,0,2,3,
Garvin,U.S. Senate,Jim Inhofe,REP,250008,1,15,54,70,
Garvin,U.S. Senate,Erick Paul Wyatt,REP,250008,0,0,4,4,
Garvin,U.S. Senate,Andy Craig,REP,250008,0,0,0,0,
Garvin,U.S. Senate,T. Shannon,REP,250008,1,6,24,31,
Garvin,U.S. Senate,Randy Brogdon,REP,250008,0,0,1,1,
Garvin,U.S. Senate,Eric Mccray,REP,250008,0,0,0,0,
Garvin,U.S. Senate,Kevin Crow,REP,250008,0,0,0,0,
Garvin,U.S. Senate,James Lankford,REP,250008,1,9,35,45,
Garvin,U.S. Senate,Jason Weger,REP,250008,0,0,1,1,
Garvin,U.S. House,Anna Flatt,REP,250008,1,1,14,16,04
Garvin,U.S. House,Tom Cole,REP,250008,1,14,46,61,04
Garvin,Superintendent of Public Instruction,John Cox,DEM,250009,0,2,73,75,
Garvin,Superintendent of Public Instruction,Jack Jr.,DEM,250009,2,0,17,19,
Garvin,Superintendent of Public Instruction,Ivan Holmes,DEM,250009,1,0,7,8,
Garvin,Superintendent of Public Instruction,Freda Deskin,DEM,250009,1,2,52,55,
Garvin,U.S. Senate,Patrick Michael Hayes,DEM,250009,0,2,27,29,
Garvin,U.S. Senate,Jim Rogers,DEM,250009,3,2,68,73,
Garvin,U.S. Senate,Connie Johnson,DEM,250009,1,0,46,47,
Garvin,U.S. House,Bert Smith,DEM,250009,4,4,124,132,04
Garvin,U.S. House,Tae Si,DEM,250009,0,0,13,13,04
Garvin,Governor,Dax Ewbank,REP,250009,0,0,7,7,
Garvin,Governor,Chad Moody,REP,250009,0,3,12,15,
Garvin,Governor,Mary Fallin,REP,250009,2,4,79,85,
Garvin,Superintendent of Public Instruction,Brian Kelly,REP,250009,0,3,25,28,
Garvin,Superintendent of Public Instruction,Janet Costello Barresi,REP,250009,1,1,12,14,
Garvin,Superintendent of Public Instruction,Joy Hofmeister,REP,250009,1,3,62,66,
Garvin,Insurance Commissioner,Bill Viner,REP,250009,0,1,19,20,
Garvin,Insurance Commissioner,John Doak,REP,250009,2,6,71,79,
Garvin,Corporation Commissioner,Todd Hiett,REP,250009,1,2,35,38,
Garvin,Corporation Commissioner,Cliff Branan,REP,250009,1,5,57,63,
Garvin,U.S. Senate,Evelyn Rogers,REP,250009,0,0,3,3,
Garvin,U.S. Senate,Rob Moye,REP,250009,0,0,1,1,
Garvin,U.S. Senate,D. Jean Mcbride-Samuels,REP,250009,0,0,1,1,
Garvin,U.S. Senate,Jim Inhofe,REP,250009,2,7,90,99,
Garvin,U.S. Senate,Erick Paul Wyatt,REP,250009,0,0,4,4,
Garvin,U.S. Senate,Andy Craig,REP,250009,0,0,0,0,
Garvin,U.S. Senate,T. Shannon,REP,250009,0,2,31,33,
Garvin,U.S. Senate,Randy Brogdon,REP,250009,0,0,2,2,
Garvin,U.S. Senate,Eric Mccray,REP,250009,0,0,0,0,
Garvin,U.S. Senate,Kevin Crow,REP,250009,0,0,0,0,
Garvin,U.S. Senate,James Lankford,REP,250009,2,5,66,73,
Garvin,U.S. Senate,Jason Weger,REP,250009,0,0,1,1,
Garvin,U.S. House,Anna Flatt,REP,250009,0,2,15,17,04
Garvin,U.S. House,Tom Cole,REP,250009,2,5,84,91,04
Garvin,Superintendent of Public Instruction,John Cox,DEM,250013,0,0,17,17,
Garvin,Superintendent of Public Instruction,Jack Jr.,DEM,250013,0,0,8,8,
Garvin,Superintendent of Public Instruction,Ivan Holmes,DEM,250013,0,0,0,0,
Garvin,Superintendent of Public Instruction,Freda Deskin,DEM,250013,0,1,30,31,
Garvin,U.S. Senate,Patrick Michael Hayes,DEM,250013,0,0,8,8,
Garvin,U.S. Senate,Jim Rogers,DEM,250013,0,1,32,33,
Garvin,U.S. Senate,Connie Johnson,DEM,250013,0,0,14,14,
Garvin,U.S. House,Bert Smith,DEM,250013,0,1,46,47,04
Garvin,U.S. House,Tae Si,DEM,250013,0,0,4,4,04
Garvin,Governor,Dax Ewbank,REP,250013,0,0,5,5,
Garvin,Governor,Chad Moody,REP,250013,0,1,5,6,
Garvin,Governor,Mary Fallin,REP,250013,2,0,18,20,
Garvin,Superintendent of Public Instruction,Brian Kelly,REP,250013,0,1,6,7,
Garvin,Superintendent of Public Instruction,Janet Costello Barresi,REP,250013,2,0,2,4,
Garvin,Superintendent of Public Instruction,Joy Hofmeister,REP,250013,0,0,19,19,
Garvin,Insurance Commissioner,Bill Viner,REP,250013,0,1,8,9,
Garvin,Insurance Commissioner,John Doak,REP,250013,2,0,18,20,
Garvin,Corporation Commissioner,Todd Hiett,REP,250013,0,1,17,18,
Garvin,Corporation Commissioner,Cliff Branan,REP,250013,2,0,9,11,
Garvin,U.S. Senate,Evelyn Rogers,REP,250013,0,0,0,0,
Garvin,U.S. Senate,Rob Moye,REP,250013,0,0,0,0,
Garvin,U.S. Senate,D. Jean Mcbride-Samuels,REP,250013,0,0,0,0,
Garvin,U.S. Senate,Jim Inhofe,REP,250013,2,1,27,30,
Garvin,U.S. Senate,Erick Paul Wyatt,REP,250013,0,0,0,0,
Garvin,U.S. Senate,Andy Craig,REP,250013,0,0,1,1,
Garvin,U.S. Senate,T. Shannon,REP,250013,0,0,4,4,
Garvin,U.S. Senate,Randy Brogdon,REP,250013,0,0,0,0,
Garvin,U.S. Senate,Eric Mccray,REP,250013,0,0,1,1,
Garvin,U.S. Senate,Kevin Crow,REP,250013,0,0,0,0,
Garvin,U.S. Senate,James Lankford,REP,250013,2,1,21,24,
Garvin,U.S. Senate,Jason Weger,REP,250013,0,0,1,1,
Garvin,U.S. House,Anna Flatt,REP,250013,0,0,3,3,04
Garvin,U.S. House,Tom Cole,REP,250013,2,1,25,28,04
Garvin,Superintendent of Public Instruction,John Cox,DEM,250015,0,2,24,26,
Garvin,Superintendent of Public Instruction,Jack Jr.,DEM,250015,1,0,5,6,
Garvin,Superintendent of Public Instruction,Ivan Holmes,DEM,250015,0,0,4,4,
Garvin,Superintendent of Public Instruction,Freda Deskin,DEM,250015,1,9,77,87,
Garvin,U.S. Senate,Patrick Michael Hayes,DEM,250015,0,0,21,21,
Garvin,U.S. Senate,Jim Rogers,DEM,250015,1,3,52,56,
Garvin,U.S. Senate,Connie Johnson,DEM,250015,1,7,29,37,
Garvin,U.S. House,Bert Smith,DEM,250015,2,8,87,97,04
Garvin,U.S. House,Tae Si,DEM,250015,0,1,7,8,04
Garvin,Governor,Dax Ewbank,REP,250015,1,0,2,3,
Garvin,Governor,Chad Moody,REP,250015,0,0,8,8,
Garvin,Governor,Mary Fallin,REP,250015,2,6,64,72,
Garvin,Superintendent of Public Instruction,Brian Kelly,REP,250015,0,1,15,16,
Garvin,Superintendent of Public Instruction,Janet Costello Barresi,REP,250015,0,4,20,24,
Garvin,Superintendent of Public Instruction,Joy Hofmeister,REP,250015,1,1,37,39,
Garvin,Insurance Commissioner,Bill Viner,REP,250015,0,0,16,16,
Garvin,Insurance Commissioner,John Doak,REP,250015,3,6,51,60,
Garvin,Corporation Commissioner,Todd Hiett,REP,250015,2,3,32,37,
Garvin,Corporation Commissioner,Cliff Branan,REP,250015,1,3,36,40,
Garvin,U.S. Senate,Evelyn Rogers,REP,250015,0,0,1,1,
Garvin,U.S. Senate,Rob Moye,REP,250015,0,0,0,0,
Garvin,U.S. Senate,D. Jean Mcbride-Samuels,REP,250015,0,0,0,0,
Garvin,U.S. Senate,Jim Inhofe,REP,250015,3,6,71,80,
Garvin,U.S. Senate,Erick Paul Wyatt,REP,250015,0,0,1,1,
Garvin,U.S. Senate,Andy Craig,REP,250015,0,0,1,1,
Garvin,U.S. Senate,T. Shannon,REP,250015,2,0,21,23,
Garvin,U.S. Senate,Randy Brogdon,REP,250015,0,0,0,0,
Garvin,U.S. Senate,Eric Mccray,REP,250015,0,0,1,1,
Garvin,U.S. Senate,Kevin Crow,REP,250015,0,0,1,1,
Garvin,U.S. Senate,James Lankford,REP,250015,1,6,47,54,
Garvin,U.S. Senate,Jason Weger,REP,250015,0,0,1,1,
Garvin,U.S. House,Anna Flatt,REP,250015,0,2,6,8,04
Garvin,U.S. House,Tom Cole,REP,250015,3,4,66,73,04
Garvin,Superintendent of Public Instruction,John Cox,DEM,250016,0,5,24,29,
Garvin,Superintendent of Public Instruction,Jack Jr.,DEM,250016,1,0,6,7,
Garvin,Superintendent of Public Instruction,Ivan Holmes,DEM,250016,0,0,2,2,
Garvin,Superintendent of Public Instruction,Freda Deskin,DEM,250016,0,7,46,53,
Garvin,U.S. Senate,Patrick Michael Hayes,DEM,250016,0,2,12,14,
Garvin,U.S. Senate,Jim Rogers,DEM,250016,1,1,38,40,
Garvin,U.S. Senate,Connie Johnson,DEM,250016,0,8,25,33,
Garvin,U.S. House,Bert Smith,DEM,250016,1,8,59,68,04
Garvin,U.S. House,Tae Si,DEM,250016,0,1,12,13,04
Garvin,Governor,Dax Ewbank,REP,250016,0,2,3,5,
Garvin,Governor,Chad Moody,REP,250016,1,2,8,11,
Garvin,Governor,Mary Fallin,REP,250016,2,7,46,55,
Garvin,Superintendent of Public Instruction,Brian Kelly,REP,250016,1,1,15,17,
Garvin,Superintendent of Public Instruction,Janet Costello Barresi,REP,250016,2,4,8,14,
Garvin,Superintendent of Public Instruction,Joy Hofmeister,REP,250016,0,6,31,37,
Garvin,Insurance Commissioner,Bill Viner,REP,250016,0,4,13,17,
Garvin,Insurance Commissioner,John Doak,REP,250016,3,7,41,51,
Garvin,Corporation Commissioner,Todd Hiett,REP,250016,3,5,26,34,
Garvin,Corporation Commissioner,Cliff Branan,REP,250016,0,6,26,32,
Garvin,U.S. Senate,Evelyn Rogers,REP,250016,0,0,1,1,
Garvin,U.S. Senate,Rob Moye,REP,250016,0,0,0,0,
Garvin,U.S. Senate,D. Jean Mcbride-Samuels,REP,250016,0,0,0,0,
Garvin,U.S. Senate,Jim Inhofe,REP,250016,3,11,48,62,
Garvin,U.S. Senate,Erick Paul Wyatt,REP,250016,0,0,7,7,
Garvin,U.S. Senate,Andy Craig,REP,250016,0,0,0,0,
Garvin,U.S. Senate,T. Shannon,REP,250016,1,3,24,28,
Garvin,U.S. Senate,Randy Brogdon,REP,250016,0,0,0,0,
Garvin,U.S. Senate,Eric Mccray,REP,250016,0,0,0,0,
Garvin,U.S. Senate,Kevin Crow,REP,250016,0,0,0,0,
Garvin,U.S. Senate,James Lankford,REP,250016,2,8,33,43,
Garvin,U.S. Senate,Jason Weger,REP,250016,0,0,0,0,
Garvin,U.S. House,Anna Flatt,REP,250016,0,4,7,11,04
Garvin,U.S. House,Tom Cole,REP,250016,3,7,47,57,04
Garvin,Superintendent of Public Instruction,John Cox,DEM,250017,3,1,11,15,
Garvin,Superintendent of Public Instruction,Jack Jr.,DEM,250017,1,0,9,10,
Garvin,Superintendent of Public Instruction,Ivan Holmes,DEM,250017,1,0,0,1,
Garvin,Superintendent of Public Instruction,Freda Deskin,DEM,250017,2,9,62,73,
Garvin,U.S. Senate,Patrick Michael Hayes,DEM,250017,2,2,24,28,
Garvin,U.S. Senate,Jim Rogers,DEM,250017,3,3,28,34,
Garvin,U.S. Senate,Connie Johnson,DEM,250017,1,4,24,29,
Garvin,U.S. House,Bert Smith,DEM,250017,5,7,61,73,04
Garvin,U.S. House,Tae Si,DEM,250017,1,2,11,14,04
Garvin,Governor,Dax Ewbank,REP,250017,0,0,8,8,
Garvin,Governor,Chad Moody,REP,250017,0,1,9,10,
Garvin,Governor,Mary Fallin,REP,250017,1,7,33,41,
Garvin,Superintendent of Public Instruction,Brian Kelly,REP,250017,0,5,15,20,
Garvin,Superintendent of Public Instruction,Janet Costello Barresi,REP,250017,0,1,10,11,
Garvin,Superintendent of Public Instruction,Joy Hofmeister,REP,250017,1,2,26,29,
Garvin,Insurance Commissioner,Bill Viner,REP,250017,0,2,13,15,
Garvin,Insurance Commissioner,John Doak,REP,250017,0,6,36,42,
Garvin,Corporation Commissioner,Todd Hiett,REP,250017,1,3,18,22,
Garvin,Corporation Commissioner,Cliff Branan,REP,250017,0,5,30,35,
Garvin,U.S. Senate,Evelyn Rogers,REP,250017,0,0,3,3,
Garvin,U.S. Senate,Rob Moye,REP,250017,0,0,1,1,
Garvin,U.S. Senate,D. Jean Mcbride-Samuels,REP,250017,0,0,1,1,
Garvin,U.S. Senate,Jim Inhofe,REP,250017,1,8,41,50,
Garvin,U.S. Senate,Erick Paul Wyatt,REP,250017,0,0,3,3,
Garvin,U.S. Senate,Andy Craig,REP,250017,0,0,0,0,
Garvin,U.S. Senate,T. Shannon,REP,250017,0,1,19,20,
Garvin,U.S. Senate,Randy Brogdon,REP,250017,0,1,1,2,
Garvin,U.S. Senate,Eric Mccray,REP,250017,0,0,0,0,
Garvin,U.S. Senate,Kevin Crow,REP,250017,0,0,0,0,
Garvin,U.S. Senate,James Lankford,REP,250017,1,6,31,38,
Garvin,U.S. Senate,Jason Weger,REP,250017,0,0,0,0,
Garvin,U.S. House,Anna Flatt,REP,250017,0,0,12,12,04
Garvin,U.S. House,Tom Cole,REP,250017,1,8,39,48,04
Garvin,Superintendent of Public Instruction,John Cox,DEM,250018,3,10,47,60,
Garvin,Superintendent of Public Instruction,Jack Jr.,DEM,250018,0,4,20,24,
Garvin,Superintendent of Public Instruction,Ivan Holmes,DEM,250018,2,1,6,9,
Garvin,Superintendent of Public Instruction,Freda Deskin,DEM,250018,3,32,143,178,
Garvin,U.S. Senate,Patrick Michael Hayes,DEM,250018,2,9,49,60,
Garvin,U.S. Senate,Jim Rogers,DEM,250018,3,19,81,103,
Garvin,U.S. Senate,Connie Johnson,DEM,250018,3,15,72,90,
Garvin,U.S. House,Bert Smith,DEM,250018,7,36,172,215,04
Garvin,U.S. House,Tae Si,DEM,250018,1,8,25,34,04
Garvin,Governor,Dax Ewbank,REP,250018,1,2,11,14,
Garvin,Governor,Chad Moody,REP,250018,2,5,22,29,
Garvin,Governor,Mary Fallin,REP,250018,6,13,103,122,
Garvin,Superintendent of Public Instruction,Brian Kelly,REP,250018,3,5,31,39,
Garvin,Superintendent of Public Instruction,Janet Costello Barresi,REP,250018,1,5,21,27,
Garvin,Superintendent of Public Instruction,Joy Hofmeister,REP,250018,3,10,81,94,
Garvin,Insurance Commissioner,Bill Viner,REP,250018,3,7,28,38,
Garvin,Insurance Commissioner,John Doak,REP,250018,6,11,98,115,
Garvin,Corporation Commissioner,Todd Hiett,REP,250018,5,9,56,70,
Garvin,Corporation Commissioner,Cliff Branan,REP,250018,2,9,68,79,
Garvin,U.S. Senate,Evelyn Rogers,REP,250018,1,0,4,5,
Garvin,U.S. Senate,Rob Moye,REP,250018,0,1,2,3,
Garvin,U.S. Senate,D. Jean Mcbride-Samuels,REP,250018,0,1,2,3,
Garvin,U.S. Senate,Jim Inhofe,REP,250018,6,16,122,144,
Garvin,U.S. Senate,Erick Paul Wyatt,REP,250018,0,2,4,6,
Garvin,U.S. Senate,Andy Craig,REP,250018,0,0,3,3,
Garvin,U.S. Senate,T. Shannon,REP,250018,2,7,45,54,
Garvin,U.S. Senate,Randy Brogdon,REP,250018,1,0,0,1,
Garvin,U.S. Senate,Eric Mccray,REP,250018,0,0,3,3,
Garvin,U.S. Senate,Kevin Crow,REP,250018,0,0,4,4,
Garvin,U.S. Senate,James Lankford,REP,250018,4,13,80,97,
Garvin,U.S. Senate,Jason Weger,REP,250018,0,0,1,1,
Garvin,U.S. House,Anna Flatt,REP,250018,2,4,14,20,04
Garvin,U.S. House,Tom Cole,REP,250018,5,16,120,141,04
Garvin,Superintendent of Public Instruction,John Cox,DEM,250020,2,5,89,96,
Garvin,Superintendent of Public Instruction,Jack Jr.,DEM,250020,3,1,24,28,
Garvin,Superintendent of Public Instruction,Ivan Holmes,DEM,250020,2,1,12,15,
Garvin,Superintendent of Public Instruction,Freda Deskin,DEM,250020,1,4,121,126,
Garvin,U.S. Senate,Patrick Michael Hayes,DEM,250020,3,5,80,88,
Garvin,U.S. Senate,Jim Rogers,DEM,250020,3,4,101,108,
Garvin,U.S. Senate,Connie Johnson,DEM,250020,2,1,58,61,
Garvin,U.S. House,Bert Smith,DEM,250020,7,7,212,226,04
Garvin,U.S. House,Tae Si,DEM,250020,1,1,22,24,04
Garvin,Governor,Dax Ewbank,REP,250020,1,0,6,7,
Garvin,Governor,Chad Moody,REP,250020,1,1,23,25,
Garvin,Governor,Mary Fallin,REP,250020,1,4,76,81,
Garvin,Superintendent of Public Instruction,Brian Kelly,REP,250020,1,0,14,15,
Garvin,Superintendent of Public Instruction,Janet Costello Barresi,REP,250020,2,1,11,14,
Garvin,Superintendent of Public Instruction,Joy Hofmeister,REP,250020,0,4,81,85,
Garvin,Insurance Commissioner,Bill Viner,REP,250020,0,1,26,27,
Garvin,Insurance Commissioner,John Doak,REP,250020,3,4,74,81,
Garvin,Corporation Commissioner,Todd Hiett,REP,250020,1,2,57,60,
Garvin,Corporation Commissioner,Cliff Branan,REP,250020,2,3,43,48,
Garvin,U.S. Senate,Evelyn Rogers,REP,250020,1,0,4,5,
Garvin,U.S. Senate,Rob Moye,REP,250020,0,0,3,3,
Garvin,U.S. Senate,D. Jean Mcbride-Samuels,REP,250020,0,0,0,0,
Garvin,U.S. Senate,Jim Inhofe,REP,250020,2,5,93,100,
Garvin,U.S. Senate,Erick Paul Wyatt,REP,250020,0,0,4,4,
Garvin,U.S. Senate,Andy Craig,REP,250020,0,0,1,1,
Garvin,U.S. Senate,T. Shannon,REP,250020,1,2,41,44,
Garvin,U.S. Senate,Randy Brogdon,REP,250020,1,0,1,2,
Garvin,U.S. Senate,Eric Mccray,REP,250020,0,0,1,1,
Garvin,U.S. Senate,Kevin Crow,REP,250020,0,0,2,2,
Garvin,U.S. Senate,James Lankford,REP,250020,1,3,60,64,
Garvin,U.S. Senate,Jason Weger,REP,250020,0,0,0,0,
Garvin,U.S. House,Anna Flatt,REP,250020,0,0,11,11,04
Garvin,U.S. House,Tom Cole,REP,250020,3,5,92,100,04
Garvin,Superintendent of Public Instruction,John Cox,DEM,250021,0,0,1,1,
Garvin,Superintendent of Public Instruction,Jack Jr.,DEM,250021,0,0,0,0,
Garvin,Superintendent of Public Instruction,Ivan Holmes,DEM,250021,0,0,0,0,
Garvin,Superintendent of Public Instruction,Freda Deskin,DEM,250021,0,0,0,0,
Garvin,U.S. Senate,Patrick Michael Hayes,DEM,250021,0,0,0,0,
Garvin,U.S. Senate,Jim Rogers,DEM,250021,0,0,0,0,
Garvin,U.S. Senate,Connie Johnson,DEM,250021,0,0,1,1,
Garvin,U.S. House,Bert Smith,DEM,250021,0,0,1,1,04
Garvin,U.S. House,Tae Si,DEM,250021,0,0,0,0,04
Garvin,Governor,Dax Ewbank,REP,250021,0,0,0,0,
Garvin,Governor,Chad Moody,REP,250021,0,0,0,0,
Garvin,Governor,Mary Fallin,REP,250021,0,0,0,0,
Garvin,Superintendent of Public Instruction,Brian Kelly,REP,250021,0,0,0,0,
Garvin,Superintendent of Public Instruction,Janet Costello Barresi,REP,250021,0,0,0,0,
Garvin,Superintendent of Public Instruction,Joy Hofmeister,REP,250021,0,0,0,0,
Garvin,Insurance Commissioner,Bill Viner,REP,250021,0,0,0,0,
Garvin,Insurance Commissioner,John Doak,REP,250021,0,0,0,0,
Garvin,Corporation Commissioner,Todd Hiett,REP,250021,0,0,0,0,
Garvin,Corporation Commissioner,Cliff Branan,REP,250021,0,0,0,0,
Garvin,U.S. Senate,Evelyn Rogers,REP,250021,0,0,0,0,
Garvin,U.S. Senate,Rob Moye,REP,250021,0,0,0,0,
Garvin,U.S. Senate,D. Jean Mcbride-Samuels,REP,250021,0,0,0,0,
Garvin,U.S. Senate,Jim Inhofe,REP,250021,0,0,0,0,
Garvin,U.S. Senate,Erick Paul Wyatt,REP,250021,0,0,0,0,
Garvin,U.S. Senate,Andy Craig,REP,250021,0,0,0,0,
Garvin,U.S. Senate,T. Shannon,REP,250021,0,0,0,0,
Garvin,U.S. Senate,Randy Brogdon,REP,250021,0,0,0,0,
Garvin,U.S. Senate,Eric Mccray,REP,250021,0,0,0,0,
Garvin,U.S. Senate,Kevin Crow,REP,250021,0,0,0,0,
Garvin,U.S. Senate,James Lankford,REP,250021,0,0,0,0,
Garvin,U.S. Senate,Jason Weger,REP,250021,0,0,0,0,
Garvin,U.S. House,Anna Flatt,REP,250021,0,0,0,0,04
Garvin,U.S. House,Tom Cole,REP,250021,0,0,0,0,04
Garvin,Superintendent of Public Instruction,John Cox,DEM,250024,0,5,61,66,
Garvin,Superintendent of Public Instruction,Jack Jr.,DEM,250024,0,1,32,33,
Garvin,Superintendent of Public Instruction,Ivan Holmes,DEM,250024,0,0,15,15,
Garvin,Superintendent of Public Instruction,Freda Deskin,DEM,250024,1,5,72,78,
Garvin,U.S. Senate,Patrick Michael Hayes,DEM,250024,0,2,45,47,
Garvin,U.S. Senate,Jim Rogers,DEM,250024,0,6,74,80,
Garvin,U.S. Senate,Connie Johnson,DEM,250024,0,2,51,53,
Garvin,U.S. House,Bert Smith,DEM,250024,0,7,140,147,04
Garvin,U.S. House,Tae Si,DEM,250024,0,2,19,21,04
Garvin,Governor,Dax Ewbank,REP,250024,0,0,7,7,
Garvin,Governor,Chad Moody,REP,250024,1,2,16,19,
Garvin,Governor,Mary Fallin,REP,250024,0,0,91,91,
Garvin,Superintendent of Public Instruction,Brian Kelly,REP,250024,0,1,26,27,
Garvin,Superintendent of Public Instruction,Janet Costello Barresi,REP,250024,0,0,29,29,
Garvin,Superintendent of Public Instruction,Joy Hofmeister,REP,250024,1,1,57,59,
Garvin,Insurance Commissioner,Bill Viner,REP,250024,0,0,16,16,
Garvin,Insurance Commissioner,John Doak,REP,250024,1,2,89,92,
Garvin,Corporation Commissioner,Todd Hiett,REP,250024,1,1,63,65,
Garvin,Corporation Commissioner,Cliff Branan,REP,250024,0,1,45,46,
Garvin,U.S. Senate,Evelyn Rogers,REP,250024,0,0,4,4,
Garvin,U.S. Senate,Rob Moye,REP,250024,0,0,3,3,
Garvin,U.S. Senate,D. Jean Mcbride-Samuels,REP,250024,0,0,1,1,
Garvin,U.S. Senate,Jim Inhofe,REP,250024,1,1,101,103,
Garvin,U.S. Senate,Erick Paul Wyatt,REP,250024,0,1,6,7,
Garvin,U.S. Senate,Andy Craig,REP,250024,0,0,3,3,
Garvin,U.S. Senate,T. Shannon,REP,250024,0,0,48,48,
Garvin,U.S. Senate,Randy Brogdon,REP,250024,0,1,4,5,
Garvin,U.S. Senate,Eric Mccray,REP,250024,0,0,0,0,
Garvin,U.S. Senate,Kevin Crow,REP,250024,0,0,1,1,
Garvin,U.S. Senate,James Lankford,REP,250024,1,1,53,55,
Garvin,U.S. Senate,Jason Weger,REP,250024,0,0,5,5,
Garvin,U.S. House,Anna Flatt,REP,250024,0,1,18,19,04
Garvin,U.S. House,Tom Cole,REP,250024,1,1,95,97,04
Garvin,Superintendent of Public Instruction,John Cox,DEM,250025,0,4,22,26,
Garvin,Superintendent of Public Instruction,Jack Jr.,DEM,250025,1,2,17,20,
Garvin,Superintendent of Public Instruction,Ivan Holmes,DEM,250025,2,2,6,10,
Garvin,Superintendent of Public Instruction,Freda Deskin,DEM,250025,4,4,49,57,
Garvin,U.S. Senate,Patrick Michael Hayes,DEM,250025,0,3,17,20,
Garvin,U.S. Senate,Jim Rogers,DEM,250025,3,6,47,56,
Garvin,U.S. Senate,Connie Johnson,DEM,250025,4,3,24,31,
Garvin,U.S. House,Bert Smith,DEM,250025,6,11,85,102,04
Garvin,U.S. House,Tae Si,DEM,250025,1,1,3,5,04
Garvin,Governor,Dax Ewbank,REP,250025,3,1,4,8,
Garvin,Governor,Chad Moody,REP,250025,0,0,12,12,
Garvin,Governor,Mary Fallin,REP,250025,4,2,54,60,
Garvin,Superintendent of Public Instruction,Brian Kelly,REP,250025,3,1,15,19,
Garvin,Superintendent of Public Instruction,Janet Costello Barresi,REP,250025,1,0,8,9,
Garvin,Superintendent of Public Instruction,Joy Hofmeister,REP,250025,1,1,44,46,
Garvin,Insurance Commissioner,Bill Viner,REP,250025,1,1,20,22,
Garvin,Insurance Commissioner,John Doak,REP,250025,6,1,43,50,
Garvin,Corporation Commissioner,Todd Hiett,REP,250025,5,1,31,37,
Garvin,Corporation Commissioner,Cliff Branan,REP,250025,1,1,31,33,
Garvin,U.S. Senate,Evelyn Rogers,REP,250025,0,0,3,3,
Garvin,U.S. Senate,Rob Moye,REP,250025,0,0,0,0,
Garvin,U.S. Senate,D. Jean Mcbride-Samuels,REP,250025,0,0,0,0,
Garvin,U.S. Senate,Jim Inhofe,REP,250025,3,1,58,62,
Garvin,U.S. Senate,Erick Paul Wyatt,REP,250025,1,0,8,9,
Garvin,U.S. Senate,Andy Craig,REP,250025,0,0,0,0,
Garvin,U.S. Senate,T. Shannon,REP,250025,0,0,26,26,
Garvin,U.S. Senate,Randy Brogdon,REP,250025,3,1,1,5,
Garvin,U.S. Senate,Eric Mccray,REP,250025,0,0,1,1,
Garvin,U.S. Senate,Kevin Crow,REP,250025,0,0,1,1,
Garvin,U.S. Senate,James Lankford,REP,250025,4,1,39,44,
Garvin,U.S. Senate,Jason Weger,REP,250025,0,0,1,1,
Garvin,U.S. House,Anna Flatt,REP,250025,5,2,14,21,04
Garvin,U.S. House,Tom Cole,REP,250025,2,0,54,56,04
Grady,Superintendent of Public Instruction,John Cox,DEM,260001,0,1,25,26,
Grady,Superintendent of Public Instruction,Jack Jr.,DEM,260001,0,0,6,6,
Grady,Superintendent of Public Instruction,Ivan Holmes,DEM,260001,0,0,8,8,
Grady,Superintendent of Public Instruction,Freda Deskin,DEM,260001,0,0,31,31,
Grady,U.S. Senate,Patrick Michael Hayes,DEM,260001,0,1,11,12,
Grady,U.S. Senate,Jim Rogers,DEM,260001,0,0,29,29,
Grady,U.S. Senate,Connie Johnson,DEM,260001,0,0,29,29,
Grady,U.S. House,Bert Smith,DEM,260001,0,1,57,58,04
Grady,U.S. House,Tae Si,DEM,260001,0,0,10,10,04
Grady,Governor,Dax Ewbank,REP,260001,0,1,5,6,
Grady,Governor,Chad Moody,REP,260001,0,1,19,20,
Grady,Governor,Mary Fallin,REP,260001,2,5,91,98,
Grady,Superintendent of Public Instruction,Brian Kelly,REP,260001,1,1,22,24,
Grady,Superintendent of Public Instruction,Janet Costello Barresi,REP,260001,0,0,21,21,
Grady,Superintendent of Public Instruction,Joy Hofmeister,REP,260001,1,4,72,77,
Grady,Insurance Commissioner,Bill Viner,REP,260001,1,0,16,17,
Grady,Insurance Commissioner,John Doak,REP,260001,1,5,91,97,
Grady,Corporation Commissioner,Todd Hiett,REP,260001,1,3,48,52,
Grady,Corporation Commissioner,Cliff Branan,REP,260001,1,2,61,64,
Grady,U.S. Senate,Evelyn Rogers,REP,260001,0,0,2,2,
Grady,U.S. Senate,Rob Moye,REP,260001,0,0,1,1,
Grady,U.S. Senate,D. Jean Mcbride-Samuels,REP,260001,0,0,0,0,
Grady,U.S. Senate,Jim Inhofe,REP,260001,2,7,107,116,
Grady,U.S. Senate,Erick Paul Wyatt,REP,260001,0,0,3,3,
Grady,U.S. Senate,Andy Craig,REP,260001,0,0,1,1,
Grady,U.S. Senate,T. Shannon,REP,260001,1,0,30,31,
Grady,U.S. Senate,Randy Brogdon,REP,260001,0,0,1,1,
Grady,U.S. Senate,Eric Mccray,REP,260001,0,0,1,1,
Grady,U.S. Senate,Kevin Crow,REP,260001,0,2,6,8,
Grady,U.S. Senate,James Lankford,REP,260001,1,5,74,80,
Grady,U.S. Senate,Jason Weger,REP,260001,0,0,0,0,
Grady,U.S. House,Anna Flatt,REP,260001,0,2,15,17,04
Grady,U.S. House,Tom Cole,REP,260001,2,5,99,106,04
Grady,Superintendent of Public Instruction,John Cox,DEM,260002,0,2,30,32,
Grady,Superintendent of Public Instruction,Jack Jr.,DEM,260002,0,0,7,7,
Grady,Superintendent of Public Instruction,Ivan Holmes,DEM,260002,0,1,8,9,
Grady,Superintendent of Public Instruction,Freda Deskin,DEM,260002,1,4,46,51,
Grady,U.S. Senate,Patrick Michael Hayes,DEM,260002,0,0,16,16,
Grady,U.S. Senate,Jim Rogers,DEM,260002,0,4,41,45,
Grady,U.S. Senate,Connie Johnson,DEM,260002,1,2,31,34,
Grady,U.S. House,Bert Smith,DEM,260002,1,5,80,86,04
Grady,U.S. House,Tae Si,DEM,260002,0,1,7,8,04
Grady,Governor,Dax Ewbank,REP,260002,2,0,12,14,
Grady,Governor,Chad Moody,REP,260002,1,1,48,50,
Grady,Governor,Mary Fallin,REP,260002,2,13,149,164,
Grady,Superintendent of Public Instruction,Brian Kelly,REP,260002,3,6,44,53,
Grady,Superintendent of Public Instruction,Janet Costello Barresi,REP,260002,1,2,50,53,
Grady,Superintendent of Public Instruction,Joy Hofmeister,REP,260002,1,6,116,123,
Grady,Insurance Commissioner,Bill Viner,REP,260002,0,3,38,41,
Grady,Insurance Commissioner,John Doak,REP,260002,5,9,155,169,
Grady,Corporation Commissioner,Todd Hiett,REP,260002,4,3,95,102,
Grady,Corporation Commissioner,Cliff Branan,REP,260002,1,9,105,115,
Grady,U.S. Senate,Evelyn Rogers,REP,260002,0,0,8,8,
Grady,U.S. Senate,Rob Moye,REP,260002,0,0,4,4,
Grady,U.S. Senate,D. Jean Mcbride-Samuels,REP,260002,0,0,1,1,
Grady,U.S. Senate,Jim Inhofe,REP,260002,5,14,188,207,
Grady,U.S. Senate,Erick Paul Wyatt,REP,260002,0,0,9,9,
Grady,U.S. Senate,Andy Craig,REP,260002,0,0,0,0,
Grady,U.S. Senate,T. Shannon,REP,260002,1,4,55,60,
Grady,U.S. Senate,Randy Brogdon,REP,260002,0,0,2,2,
Grady,U.S. Senate,Eric Mccray,REP,260002,0,0,1,1,
Grady,U.S. Senate,Kevin Crow,REP,260002,2,1,15,18,
Grady,U.S. Senate,James Lankford,REP,260002,2,9,141,152,
Grady,U.S. Senate,Jason Weger,REP,260002,0,0,0,0,
Grady,U.S. House,Anna Flatt,REP,260002,1,1,26,28,04
Grady,U.S. House,Tom Cole,REP,260002,4,13,186,203,04
Grady,Superintendent of Public Instruction,John Cox,DEM,260003,0,2,21,23,
Grady,Superintendent of Public Instruction,Jack Jr.,DEM,260003,0,1,16,17,
Grady,Superintendent of Public Instruction,Ivan Holmes,DEM,260003,0,0,3,3,
Grady,Superintendent of Public Instruction,Freda Deskin,DEM,260003,0,1,29,30,
Grady,U.S. Senate,Patrick Michael Hayes,DEM,260003,0,0,10,10,
Grady,U.S. Senate,Jim Rogers,DEM,260003,0,4,26,30,
Grady,U.S. Senate,Connie Johnson,DEM,260003,0,0,31,31,
Grady,U.S. House,Bert Smith,DEM,260003,0,4,48,52,04
Grady,U.S. House,Tae Si,DEM,260003,0,0,18,18,04
Grady,Governor,Dax Ewbank,REP,260003,0,1,3,4,
Grady,Governor,Chad Moody,REP,260003,0,2,24,26,
Grady,Governor,Mary Fallin,REP,260003,0,6,88,94,
Grady,Superintendent of Public Instruction,Brian Kelly,REP,260003,0,0,19,19,
Grady,Superintendent of Public Instruction,Janet Costello Barresi,REP,260003,0,4,12,16,
Grady,Superintendent of Public Instruction,Joy Hofmeister,REP,260003,0,6,84,90,
Grady,Insurance Commissioner,Bill Viner,REP,260003,0,0,10,10,
Grady,Insurance Commissioner,John Doak,REP,260003,0,8,100,108,
Grady,Corporation Commissioner,Todd Hiett,REP,260003,0,6,54,60,
Grady,Corporation Commissioner,Cliff Branan,REP,260003,0,4,55,59,
Grady,U.S. Senate,Evelyn Rogers,REP,260003,0,1,5,6,
Grady,U.S. Senate,Rob Moye,REP,260003,0,0,1,1,
Grady,U.S. Senate,D. Jean Mcbride-Samuels,REP,260003,0,0,0,0,
Grady,U.S. Senate,Jim Inhofe,REP,260003,0,9,107,116,
Grady,U.S. Senate,Erick Paul Wyatt,REP,260003,0,0,2,2,
Grady,U.S. Senate,Andy Craig,REP,260003,0,0,0,0,
Grady,U.S. Senate,T. Shannon,REP,260003,0,4,38,42,
Grady,U.S. Senate,Randy Brogdon,REP,260003,0,0,2,2,
Grady,U.S. Senate,Eric Mccray,REP,260003,0,0,0,0,
Grady,U.S. Senate,Kevin Crow,REP,260003,0,0,9,9,
Grady,U.S. Senate,James Lankford,REP,260003,0,6,67,73,
Grady,U.S. Senate,Jason Weger,REP,260003,0,0,0,0,
Grady,U.S. House,Anna Flatt,REP,260003,0,1,8,9,04
Grady,U.S. House,Tom Cole,REP,260003,0,9,107,116,04
Grady,Superintendent of Public Instruction,John Cox,DEM,260005,0,0,19,19,
Grady,Superintendent of Public Instruction,Jack Jr.,DEM,260005,0,0,3,3,
Grady,Superintendent of Public Instruction,Ivan Holmes,DEM,260005,1,0,0,1,
Grady,Superintendent of Public Instruction,Freda Deskin,DEM,260005,2,2,28,32,
Grady,U.S. Senate,Patrick Michael Hayes,DEM,260005,0,0,7,7,
Grady,U.S. Senate,Jim Rogers,DEM,260005,0,0,10,10,
Grady,U.S. Senate,Connie Johnson,DEM,260005,3,1,31,35,
Grady,U.S. House,Bert Smith,DEM,260005,1,0,34,35,04
Grady,U.S. House,Tae Si,DEM,260005,2,1,13,16,04
Grady,Governor,Dax Ewbank,REP,260005,0,0,3,3,
Grady,Governor,Chad Moody,REP,260005,0,0,7,7,
Grady,Governor,Mary Fallin,REP,260005,1,4,28,33,
Grady,Superintendent of Public Instruction,Brian Kelly,REP,260005,0,0,10,10,
Grady,Superintendent of Public Instruction,Janet Costello Barresi,REP,260005,1,0,7,8,
Grady,Superintendent of Public Instruction,Joy Hofmeister,REP,260005,0,4,20,24,
Grady,Insurance Commissioner,Bill Viner,REP,260005,0,0,4,4,
Grady,Insurance Commissioner,John Doak,REP,260005,0,3,28,31,
Grady,Corporation Commissioner,Todd Hiett,REP,260005,0,0,18,18,
Grady,Corporation Commissioner,Cliff Branan,REP,260005,0,4,17,21,
Grady,U.S. Senate,Evelyn Rogers,REP,260005,0,0,2,2,
Grady,U.S. Senate,Rob Moye,REP,260005,0,0,0,0,
Grady,U.S. Senate,D. Jean Mcbride-Samuels,REP,260005,0,0,0,0,
Grady,U.S. Senate,Jim Inhofe,REP,260005,1,4,31,36,
Grady,U.S. Senate,Erick Paul Wyatt,REP,260005,0,0,5,5,
Grady,U.S. Senate,Andy Craig,REP,260005,0,0,0,0,
Grady,U.S. Senate,T. Shannon,REP,260005,1,2,12,15,
Grady,U.S. Senate,Randy Brogdon,REP,260005,0,0,2,2,
Grady,U.S. Senate,Eric Mccray,REP,260005,0,0,1,1,
Grady,U.S. Senate,Kevin Crow,REP,260005,0,0,5,5,
Grady,U.S. Senate,James Lankford,REP,260005,0,2,19,21,
Grady,U.S. Senate,Jason Weger,REP,260005,0,0,0,0,
Grady,U.S. House,Anna Flatt,REP,260005,0,0,8,8,04
Grady,U.S. House,Tom Cole,REP,260005,1,4,30,35,04
Grady,Superintendent of Public Instruction,John Cox,DEM,260006,0,0,13,13,
Grady,Superintendent of Public Instruction,Jack Jr.,DEM,260006,1,0,8,9,
Grady,Superintendent of Public Instruction,Ivan Holmes,DEM,260006,0,0,2,2,
Grady,Superintendent of Public Instruction,Freda Deskin,DEM,260006,2,0,34,36,
Grady,U.S. Senate,Patrick Michael Hayes,DEM,260006,1,0,11,12,
Grady,U.S. Senate,Jim Rogers,DEM,260006,0,0,21,21,
Grady,U.S. Senate,Connie Johnson,DEM,260006,2,0,24,26,
Grady,U.S. House,Bert Smith,DEM,260006,2,0,43,45,04
Grady,U.S. House,Tae Si,DEM,260006,1,0,12,13,04
Grady,Governor,Dax Ewbank,REP,260006,0,0,7,7,
Grady,Governor,Chad Moody,REP,260006,1,1,11,13,
Grady,Governor,Mary Fallin,REP,260006,4,5,54,63,
Grady,Superintendent of Public Instruction,Brian Kelly,REP,260006,1,1,17,19,
Grady,Superintendent of Public Instruction,Janet Costello Barresi,REP,260006,1,2,24,27,
Grady,Superintendent of Public Instruction,Joy Hofmeister,REP,260006,3,3,31,37,
Grady,Insurance Commissioner,Bill Viner,REP,260006,0,1,11,12,
Grady,Insurance Commissioner,John Doak,REP,260006,5,5,57,67,
Grady,Corporation Commissioner,Todd Hiett,REP,260006,4,5,35,44,
Grady,Corporation Commissioner,Cliff Branan,REP,260006,1,1,33,35,
Grady,U.S. Senate,Evelyn Rogers,REP,260006,0,1,5,6,
Grady,U.S. Senate,Rob Moye,REP,260006,0,0,1,1,
Grady,U.S. Senate,D. Jean Mcbride-Samuels,REP,260006,0,0,1,1,
Grady,U.S. Senate,Jim Inhofe,REP,260006,5,5,63,73,
Grady,U.S. Senate,Erick Paul Wyatt,REP,260006,0,0,2,2,
Grady,U.S. Senate,Andy Craig,REP,260006,0,0,0,0,
Grady,U.S. Senate,T. Shannon,REP,260006,2,1,21,24,
Grady,U.S. Senate,Randy Brogdon,REP,260006,0,0,1,1,
Grady,U.S. Senate,Eric Mccray,REP,260006,0,0,0,0,
Grady,U.S. Senate,Kevin Crow,REP,260006,0,0,9,9,
Grady,U.S. Senate,James Lankford,REP,260006,3,5,40,48,
Grady,U.S. Senate,Jason Weger,REP,260006,0,0,0,0,
Grady,U.S. House,Anna Flatt,REP,260006,1,0,11,12,04
Grady,U.S. House,Tom Cole,REP,260006,4,6,60,70,04
Grady,Superintendent of Public Instruction,John Cox,DEM,260008,1,1,17,19,
Grady,Superintendent of Public Instruction,Jack Jr.,DEM,260008,1,0,5,6,
Grady,Superintendent of Public Instruction,Ivan Holmes,DEM,260008,1,0,1,2,
Grady,Superintendent of Public Instruction,Freda Deskin,DEM,260008,1,2,30,33,
Grady,U.S. Senate,Patrick Michael Hayes,DEM,260008,2,0,11,13,
Grady,U.S. Senate,Jim Rogers,DEM,260008,0,2,24,26,
Grady,U.S. Senate,Connie Johnson,DEM,260008,2,1,17,20,
Grady,U.S. House,Bert Smith,DEM,260008,3,3,38,44,04
Grady,U.S. House,Tae Si,DEM,260008,1,0,14,15,04
Grady,Governor,Dax Ewbank,REP,260008,1,1,10,12,
Grady,Governor,Chad Moody,REP,260008,0,0,21,21,
Grady,Governor,Mary Fallin,REP,260008,2,3,59,64,
Grady,Superintendent of Public Instruction,Brian Kelly,REP,260008,1,0,23,24,
Grady,Superintendent of Public Instruction,Janet Costello Barresi,REP,260008,0,1,12,13,
Grady,Superintendent of Public Instruction,Joy Hofmeister,REP,260008,2,3,58,63,
Grady,Insurance Commissioner,Bill Viner,REP,260008,0,1,19,20,
Grady,Insurance Commissioner,John Doak,REP,260008,2,2,67,71,
Grady,Corporation Commissioner,Todd Hiett,REP,260008,2,2,35,39,
Grady,Corporation Commissioner,Cliff Branan,REP,260008,0,1,51,52,
Grady,U.S. Senate,Evelyn Rogers,REP,260008,1,0,8,9,
Grady,U.S. Senate,Rob Moye,REP,260008,0,0,3,3,
Grady,U.S. Senate,D. Jean Mcbride-Samuels,REP,260008,0,0,1,1,
Grady,U.S. Senate,Jim Inhofe,REP,260008,2,4,69,75,
Grady,U.S. Senate,Erick Paul Wyatt,REP,260008,0,0,9,9,
Grady,U.S. Senate,Andy Craig,REP,260008,0,0,1,1,
Grady,U.S. Senate,T. Shannon,REP,260008,2,2,24,28,
Grady,U.S. Senate,Randy Brogdon,REP,260008,0,0,4,4,
Grady,U.S. Senate,Eric Mccray,REP,260008,0,0,0,0,
Grady,U.S. Senate,Kevin Crow,REP,260008,0,0,16,16,
Grady,U.S. Senate,James Lankford,REP,260008,0,2,46,48,
Grady,U.S. Senate,Jason Weger,REP,260008,0,0,1,1,
Grady,U.S. House,Anna Flatt,REP,260008,1,0,17,18,04
Grady,U.S. House,Tom Cole,REP,260008,2,4,75,81,04
Grady,Superintendent of Public Instruction,John Cox,DEM,260009,0,3,25,28,
Grady,Superintendent of Public Instruction,Jack Jr.,DEM,260009,0,1,13,14,
Grady,Superintendent of Public Instruction,Ivan Holmes,DEM,260009,1,2,2,5,
Grady,Superintendent of Public Instruction,Freda Deskin,DEM,260009,1,5,40,46,
Grady,U.S. Senate,Patrick Michael Hayes,DEM,260009,0,2,11,13,
Grady,U.S. Senate,Jim Rogers,DEM,260009,1,3,31,35,
Grady,U.S. Senate,Connie Johnson,DEM,260009,1,6,33,40,
Grady,U.S. House,Bert Smith,DEM,260009,2,8,62,72,04
Grady,U.S. House,Tae Si,DEM,260009,0,2,13,15,04
Grady,Governor,Dax Ewbank,REP,260009,1,2,4,7,
Grady,Governor,Chad Moody,REP,260009,0,1,24,25,
Grady,Governor,Mary Fallin,REP,260009,7,19,98,124,
Grady,Superintendent of Public Instruction,Brian Kelly,REP,260009,1,1,21,23,
Grady,Superintendent of Public Instruction,Janet Costello Barresi,REP,260009,2,4,23,29,
Grady,Superintendent of Public Instruction,Joy Hofmeister,REP,260009,5,16,82,103,
Grady,Insurance Commissioner,Bill Viner,REP,260009,3,1,18,22,
Grady,Insurance Commissioner,John Doak,REP,260009,5,20,96,121,
Grady,Corporation Commissioner,Todd Hiett,REP,260009,2,10,61,73,
Grady,Corporation Commissioner,Cliff Branan,REP,260009,4,11,55,70,
Grady,U.S. Senate,Evelyn Rogers,REP,260009,0,0,5,5,
Grady,U.S. Senate,Rob Moye,REP,260009,0,0,0,0,
Grady,U.S. Senate,D. Jean Mcbride-Samuels,REP,260009,0,1,1,2,
Grady,U.S. Senate,Jim Inhofe,REP,260009,8,21,113,142,
Grady,U.S. Senate,Erick Paul Wyatt,REP,260009,0,0,9,9,
Grady,U.S. Senate,Andy Craig,REP,260009,0,0,0,0,
Grady,U.S. Senate,T. Shannon,REP,260009,7,8,26,41,
Grady,U.S. Senate,Randy Brogdon,REP,260009,0,0,5,5,
Grady,U.S. Senate,Eric Mccray,REP,260009,0,0,0,0,
Grady,U.S. Senate,Kevin Crow,REP,260009,0,2,19,21,
Grady,U.S. Senate,James Lankford,REP,260009,1,12,78,91,
Grady,U.S. Senate,Jason Weger,REP,260009,0,0,0,0,
Grady,U.S. House,Anna Flatt,REP,260009,0,3,15,18,04
Grady,U.S. House,Tom Cole,REP,260009,8,18,113,139,04
Grady,Superintendent of Public Instruction,John Cox,DEM,260011,1,3,19,23,
Grady,Superintendent of Public Instruction,Jack Jr.,DEM,260011,1,1,2,4,
Grady,Superintendent of Public Instruction,Ivan Holmes,DEM,260011,0,0,1,1,
Grady,Superintendent of Public Instruction,Freda Deskin,DEM,260011,0,6,15,21,
Grady,U.S. Senate,Patrick Michael Hayes,DEM,260011,1,5,18,24,
Grady,U.S. Senate,Jim Rogers,DEM,260011,1,4,4,9,
Grady,U.S. Senate,Connie Johnson,DEM,260011,0,0,13,13,
Grady,U.S. House,Bert Smith,DEM,260011,2,6,29,37,04
Grady,U.S. House,Tae Si,DEM,260011,0,3,6,9,04
Grady,Governor,Dax Ewbank,REP,260011,2,0,6,8,
Grady,Governor,Chad Moody,REP,260011,0,2,8,10,
Grady,Governor,Mary Fallin,REP,260011,0,6,52,58,
Grady,Superintendent of Public Instruction,Brian Kelly,REP,260011,0,1,12,13,
Grady,Superintendent of Public Instruction,Janet Costello Barresi,REP,260011,0,2,15,17,
Grady,Superintendent of Public Instruction,Joy Hofmeister,REP,260011,2,5,37,44,
Grady,Insurance Commissioner,Bill Viner,REP,260011,2,2,6,10,
Grady,Insurance Commissioner,John Doak,REP,260011,0,6,56,62,
Grady,Corporation Commissioner,Todd Hiett,REP,260011,0,5,36,41,
Grady,Corporation Commissioner,Cliff Branan,REP,260011,2,2,28,32,
Grady,U.S. Senate,Evelyn Rogers,REP,260011,0,1,2,3,
Grady,U.S. Senate,Rob Moye,REP,260011,0,0,1,1,
Grady,U.S. Senate,D. Jean Mcbride-Samuels,REP,260011,0,0,1,1,
Grady,U.S. Senate,Jim Inhofe,REP,260011,1,7,59,67,
Grady,U.S. Senate,Erick Paul Wyatt,REP,260011,0,0,2,2,
Grady,U.S. Senate,Andy Craig,REP,260011,0,0,1,1,
Grady,U.S. Senate,T. Shannon,REP,260011,1,1,25,27,
Grady,U.S. Senate,Randy Brogdon,REP,260011,0,0,3,3,
Grady,U.S. Senate,Eric Mccray,REP,260011,0,0,0,0,
Grady,U.S. Senate,Kevin Crow,REP,260011,0,1,0,1,
Grady,U.S. Senate,James Lankford,REP,260011,0,6,38,44,
Grady,U.S. Senate,Jason Weger,REP,260011,0,0,0,0,
Grady,U.S. House,Anna Flatt,REP,260011,0,1,8,9,04
Grady,U.S. House,Tom Cole,REP,260011,1,7,58,66,04
Grady,Superintendent of Public Instruction,John Cox,DEM,260016,0,0,10,10,
Grady,Superintendent of Public Instruction,Jack Jr.,DEM,260016,0,0,1,1,
Grady,Superintendent of Public Instruction,Ivan Holmes,DEM,260016,0,2,0,2,
Grady,Superintendent of Public Instruction,Freda Deskin,DEM,260016,3,0,15,18,
Grady,U.S. Senate,Patrick Michael Hayes,DEM,260016,0,0,9,9,
Grady,U.S. Senate,Jim Rogers,DEM,260016,0,2,9,11,
Grady,U.S. Senate,Connie Johnson,DEM,260016,3,0,8,11,
Grady,U.S. House,Bert Smith,DEM,260016,1,2,25,28,04
Grady,U.S. House,Tae Si,DEM,260016,2,0,2,4,04
Grady,Governor,Dax Ewbank,REP,260016,1,0,2,3,
Grady,Governor,Chad Moody,REP,260016,0,0,3,3,
Grady,Governor,Mary Fallin,REP,260016,0,0,18,18,
Grady,Superintendent of Public Instruction,Brian Kelly,REP,260016,0,0,5,5,
Grady,Superintendent of Public Instruction,Janet Costello Barresi,REP,260016,0,0,5,5,
Grady,Superintendent of Public Instruction,Joy Hofmeister,REP,260016,1,0,14,15,
Grady,Insurance Commissioner,Bill Viner,REP,260016,0,0,4,4,
Grady,Insurance Commissioner,John Doak,REP,260016,1,0,15,16,
Grady,Corporation Commissioner,Todd Hiett,REP,260016,0,0,9,9,
Grady,Corporation Commissioner,Cliff Branan,REP,260016,1,0,12,13,
Grady,U.S. Senate,Evelyn Rogers,REP,260016,0,0,2,2,
Grady,U.S. Senate,Rob Moye,REP,260016,0,0,1,1,
Grady,U.S. Senate,D. Jean Mcbride-Samuels,REP,260016,0,0,0,0,
Grady,U.S. Senate,Jim Inhofe,REP,260016,1,0,19,20,
Grady,U.S. Senate,Erick Paul Wyatt,REP,260016,0,0,1,1,
Grady,U.S. Senate,Andy Craig,REP,260016,0,0,0,0,
Grady,U.S. Senate,T. Shannon,REP,260016,0,0,2,2,
Grady,U.S. Senate,Randy Brogdon,REP,260016,0,0,1,1,
Grady,U.S. Senate,Eric Mccray,REP,260016,0,0,0,0,
Grady,U.S. Senate,Kevin Crow,REP,260016,0,0,1,1,
Grady,U.S. Senate,James Lankford,REP,260016,1,0,19,20,
Grady,U.S. Senate,Jason Weger,REP,260016,0,0,0,0,
Grady,U.S. House,Anna Flatt,REP,260016,1,0,4,5,04
Grady,U.S. House,Tom Cole,REP,260016,0,0,19,19,04
Grady,Superintendent of Public Instruction,John Cox,DEM,260017,0,0,19,19,
Grady,Superintendent of Public Instruction,Jack Jr.,DEM,260017,0,0,2,2,
Grady,Superintendent of Public Instruction,Ivan Holmes,DEM,260017,0,0,2,2,
Grady,Superintendent of Public Instruction,Freda Deskin,DEM,260017,0,1,25,26,
Grady,U.S. Senate,Patrick Michael Hayes,DEM,260017,0,0,12,12,
Grady,U.S. Senate,Jim Rogers,DEM,260017,0,0,21,21,
Grady,U.S. Senate,Connie Johnson,DEM,260017,0,1,14,15,
Grady,U.S. House,Bert Smith,DEM,260017,0,1,43,44,04
Grady,U.S. House,Tae Si,DEM,260017,0,0,4,4,04
Grady,Governor,Dax Ewbank,REP,260017,0,0,3,3,
Grady,Governor,Chad Moody,REP,260017,0,0,8,8,
Grady,Governor,Mary Fallin,REP,260017,0,0,25,25,
Grady,Superintendent of Public Instruction,Brian Kelly,REP,260017,0,0,10,10,
Grady,Superintendent of Public Instruction,Janet Costello Barresi,REP,260017,0,0,3,3,
Grady,Superintendent of Public Instruction,Joy Hofmeister,REP,260017,0,0,23,23,
Grady,Insurance Commissioner,Bill Viner,REP,260017,0,0,6,6,
Grady,Insurance Commissioner,John Doak,REP,260017,0,0,27,27,
Grady,Corporation Commissioner,Todd Hiett,REP,260017,0,0,19,19,
Grady,Corporation Commissioner,Cliff Branan,REP,260017,0,0,14,14,
Grady,U.S. Senate,Evelyn Rogers,REP,260017,0,0,3,3,
Grady,U.S. Senate,Rob Moye,REP,260017,0,0,0,0,
Grady,U.S. Senate,D. Jean Mcbride-Samuels,REP,260017,0,0,0,0,
Grady,U.S. Senate,Jim Inhofe,REP,260017,0,0,27,27,
Grady,U.S. Senate,Erick Paul Wyatt,REP,260017,0,0,5,5,
Grady,U.S. Senate,Andy Craig,REP,260017,0,0,0,0,
Grady,U.S. Senate,T. Shannon,REP,260017,0,0,15,15,
Grady,U.S. Senate,Randy Brogdon,REP,260017,0,0,0,0,
Grady,U.S. Senate,Eric Mccray,REP,260017,0,0,0,0,
Grady,U.S. Senate,Kevin Crow,REP,260017,0,0,2,2,
Grady,U.S. Senate,James Lankford,REP,260017,0,0,19,19,
Grady,U.S. Senate,Jason Weger,REP,260017,0,0,0,0,
Grady,U.S. House,Anna Flatt,REP,260017,0,0,7,7,04
Grady,U.S. House,Tom Cole,REP,260017,0,0,28,28,04
Grady,Superintendent of Public Instruction,John Cox,DEM,260020,1,2,21,24,
Grady,Superintendent of Public Instruction,Jack Jr.,DEM,260020,0,0,5,5,
Grady,Superintendent of Public Instruction,Ivan Holmes,DEM,260020,2,0,5,7,
Grady,Superintendent of Public Instruction,Freda Deskin,DEM,260020,0,0,17,17,
Grady,U.S. Senate,Patrick Michael Hayes,DEM,260020,1,0,12,13,
Grady,U.S. Senate,Jim Rogers,DEM,260020,2,1,25,28,
Grady,U.S. Senate,Connie Johnson,DEM,260020,0,1,7,8,
Grady,U.S. House,Bert Smith,DEM,260020,2,1,42,45,04
Grady,U.S. House,Tae Si,DEM,260020,1,1,1,3,04
Grady,Governor,Dax Ewbank,REP,260020,0,0,4,4,
Grady,Governor,Chad Moody,REP,260020,0,1,13,14,
Grady,Governor,Mary Fallin,REP,260020,1,5,24,30,
Grady,Superintendent of Public Instruction,Brian Kelly,REP,260020,0,2,10,12,
Grady,Superintendent of Public Instruction,Janet Costello Barresi,REP,260020,1,0,8,9,
Grady,Superintendent of Public Instruction,Joy Hofmeister,REP,260020,0,4,23,27,
Grady,Insurance Commissioner,Bill Viner,REP,260020,1,1,4,6,
Grady,Insurance Commissioner,John Doak,REP,260020,0,5,35,40,
Grady,Corporation Commissioner,Todd Hiett,REP,260020,0,4,25,29,
Grady,Corporation Commissioner,Cliff Branan,REP,260020,1,2,14,17,
Grady,U.S. Senate,Evelyn Rogers,REP,260020,0,0,2,2,
Grady,U.S. Senate,Rob Moye,REP,260020,0,0,2,2,
Grady,U.S. Senate,D. Jean Mcbride-Samuels,REP,260020,0,0,1,1,
Grady,U.S. Senate,Jim Inhofe,REP,260020,1,6,32,39,
Grady,U.S. Senate,Erick Paul Wyatt,REP,260020,0,0,4,4,
Grady,U.S. Senate,Andy Craig,REP,260020,0,0,0,0,
Grady,U.S. Senate,T. Shannon,REP,260020,1,2,15,18,
Grady,U.S. Senate,Randy Brogdon,REP,260020,0,0,0,0,
Grady,U.S. Senate,Eric Mccray,REP,260020,0,0,1,1,
Grady,U.S. Senate,Kevin Crow,REP,260020,0,0,3,3,
Grady,U.S. Senate,James Lankford,REP,260020,0,3,22,25,
Grady,U.S. Senate,Jason Weger,REP,260020,0,1,1,2,
Grady,U.S. House,Anna Flatt,REP,260020,0,0,8,8,04
Grady,U.S. House,Tom Cole,REP,260020,1,6,33,40,04
Grady,Superintendent of Public Instruction,John Cox,DEM,260021,0,0,7,7,
Grady,Superintendent of Public Instruction,Jack Jr.,DEM,260021,0,0,5,5,
Grady,Superintendent of Public Instruction,Ivan Holmes,DEM,260021,0,0,4,4,
Grady,Superintendent of Public Instruction,Freda Deskin,DEM,260021,0,0,18,18,
Grady,U.S. Senate,Patrick Michael Hayes,DEM,260021,0,0,7,7,
Grady,U.S. Senate,Jim Rogers,DEM,260021,0,0,12,12,
Grady,U.S. Senate,Connie Johnson,DEM,260021,0,0,15,15,
Grady,U.S. House,Bert Smith,DEM,260021,0,0,29,29,04
Grady,U.S. House,Tae Si,DEM,260021,0,0,5,5,04
Grady,Governor,Dax Ewbank,REP,260021,0,0,8,8,
Grady,Governor,Chad Moody,REP,260021,3,1,6,10,
Grady,Governor,Mary Fallin,REP,260021,0,2,38,40,
Grady,Superintendent of Public Instruction,Brian Kelly,REP,260021,2,0,7,9,
Grady,Superintendent of Public Instruction,Janet Costello Barresi,REP,260021,0,1,4,5,
Grady,Superintendent of Public Instruction,Joy Hofmeister,REP,260021,1,2,41,44,
Grady,Insurance Commissioner,Bill Viner,REP,260021,2,1,5,8,
Grady,Insurance Commissioner,John Doak,REP,260021,1,2,44,47,
Grady,Corporation Commissioner,Todd Hiett,REP,260021,1,1,19,21,
Grady,Corporation Commissioner,Cliff Branan,REP,260021,2,2,30,34,
Grady,U.S. Senate,Evelyn Rogers,REP,260021,0,0,4,4,
Grady,U.S. Senate,Rob Moye,REP,260021,2,0,0,2,
Grady,U.S. Senate,D. Jean Mcbride-Samuels,REP,260021,0,0,0,0,
Grady,U.S. Senate,Jim Inhofe,REP,260021,1,3,43,47,
Grady,U.S. Senate,Erick Paul Wyatt,REP,260021,0,0,5,5,
Grady,U.S. Senate,Andy Craig,REP,260021,0,0,0,0,
Grady,U.S. Senate,T. Shannon,REP,260021,0,0,14,14,
Grady,U.S. Senate,Randy Brogdon,REP,260021,0,0,3,3,
Grady,U.S. Senate,Eric Mccray,REP,260021,0,0,0,0,
Grady,U.S. Senate,Kevin Crow,REP,260021,0,0,1,1,
Grady,U.S. Senate,James Lankford,REP,260021,3,3,34,40,
Grady,U.S. Senate,Jason Weger,REP,260021,0,0,0,0,
Grady,U.S. House,Anna Flatt,REP,260021,0,0,6,6,04
Grady,U.S. House,Tom Cole,REP,260021,3,3,46,52,04
Grady,Superintendent of Public Instruction,John Cox,DEM,260023,0,2,3,5,
Grady,Superintendent of Public Instruction,Jack Jr.,DEM,260023,0,0,2,2,
Grady,Superintendent of Public Instruction,Ivan Holmes,DEM,260023,0,0,0,0,
Grady,Superintendent of Public Instruction,Freda Deskin,DEM,260023,0,1,6,7,
Grady,U.S. Senate,Patrick Michael Hayes,DEM,260023,0,1,2,3,
Grady,U.S. Senate,Jim Rogers,DEM,260023,0,1,6,7,
Grady,U.S. Senate,Connie Johnson,DEM,260023,0,1,4,5,
Grady,U.S. House,Bert Smith,DEM,260023,0,1,12,13,04
Grady,U.S. House,Tae Si,DEM,260023,0,2,0,2,04
Grady,Governor,Dax Ewbank,REP,260023,0,0,1,1,
Grady,Governor,Chad Moody,REP,260023,0,0,4,4,
Grady,Governor,Mary Fallin,REP,260023,0,1,15,16,
Grady,Superintendent of Public Instruction,Brian Kelly,REP,260023,0,1,4,5,
Grady,Superintendent of Public Instruction,Janet Costello Barresi,REP,260023,0,0,3,3,
Grady,Superintendent of Public Instruction,Joy Hofmeister,REP,260023,0,0,13,13,
Grady,Insurance Commissioner,Bill Viner,REP,260023,0,1,5,6,
Grady,Insurance Commissioner,John Doak,REP,260023,0,0,15,15,
Grady,Corporation Commissioner,Todd Hiett,REP,260023,0,1,6,7,
Grady,Corporation Commissioner,Cliff Branan,REP,260023,0,0,13,13,
Grady,U.S. Senate,Evelyn Rogers,REP,260023,0,0,3,3,
Grady,U.S. Senate,Rob Moye,REP,260023,0,0,0,0,
Grady,U.S. Senate,D. Jean Mcbride-Samuels,REP,260023,0,0,0,0,
Grady,U.S. Senate,Jim Inhofe,REP,260023,0,1,16,17,
Grady,U.S. Senate,Erick Paul Wyatt,REP,260023,0,0,0,0,
Grady,U.S. Senate,Andy Craig,REP,260023,0,0,0,0,
Grady,U.S. Senate,T. Shannon,REP,260023,0,1,3,4,
Grady,U.S. Senate,Randy Brogdon,REP,260023,0,0,1,1,
Grady,U.S. Senate,Eric Mccray,REP,260023,0,0,0,0,
Grady,U.S. Senate,Kevin Crow,REP,260023,0,0,1,1,
Grady,U.S. Senate,James Lankford,REP,260023,0,0,15,15,
Grady,U.S. Senate,Jason Weger,REP,260023,0,0,0,0,
Grady,U.S. House,Anna Flatt,REP,260023,0,0,2,2,04
Grady,U.S. House,Tom Cole,REP,260023,0,1,18,19,04
Grady,Superintendent of Public Instruction,John Cox,DEM,260025,0,0,18,18,
Grady,Superintendent of Public Instruction,Jack Jr.,DEM,260025,0,3,6,9,
Grady,Superintendent of Public Instruction,Ivan Holmes,DEM,260025,0,1,0,1,
Grady,Superintendent of Public Instruction,Freda Deskin,DEM,260025,0,1,24,25,
Grady,U.S. Senate,Patrick Michael Hayes,DEM,260025,0,1,10,11,
Grady,U.S. Senate,Jim Rogers,DEM,260025,0,3,14,17,
Grady,U.S. Senate,Connie Johnson,DEM,260025,0,1,22,23,
Grady,U.S. House,Bert Smith,DEM,260025,0,4,41,45,04
Grady,U.S. House,Tae Si,DEM,260025,0,1,5,6,04
Grady,Governor,Dax Ewbank,REP,260025,0,0,7,7,
Grady,Governor,Chad Moody,REP,260025,0,0,9,9,
Grady,Governor,Mary Fallin,REP,260025,0,7,66,73,
Grady,Superintendent of Public Instruction,Brian Kelly,REP,260025,0,1,14,15,
Grady,Superintendent of Public Instruction,Janet Costello Barresi,REP,260025,0,1,9,10,
Grady,Superintendent of Public Instruction,Joy Hofmeister,REP,260025,0,5,59,64,
Grady,Insurance Commissioner,Bill Viner,REP,260025,0,1,8,9,
Grady,Insurance Commissioner,John Doak,REP,260025,0,6,68,74,
Grady,Corporation Commissioner,Todd Hiett,REP,260025,0,3,42,45,
Grady,Corporation Commissioner,Cliff Branan,REP,260025,0,4,35,39,
Grady,U.S. Senate,Evelyn Rogers,REP,260025,0,0,4,4,
Grady,U.S. Senate,Rob Moye,REP,260025,0,0,2,2,
Grady,U.S. Senate,D. Jean Mcbride-Samuels,REP,260025,0,0,0,0,
Grady,U.S. Senate,Jim Inhofe,REP,260025,0,7,76,83,
Grady,U.S. Senate,Erick Paul Wyatt,REP,260025,0,0,0,0,
Grady,U.S. Senate,Andy Craig,REP,260025,0,0,1,1,
Grady,U.S. Senate,T. Shannon,REP,260025,0,2,17,19,
Grady,U.S. Senate,Randy Brogdon,REP,260025,0,0,0,0,
Grady,U.S. Senate,Eric Mccray,REP,260025,0,0,0,0,
Grady,U.S. Senate,Kevin Crow,REP,260025,0,1,1,2,
Grady,U.S. Senate,James Lankford,REP,260025,0,4,65,69,
Grady,U.S. Senate,Jason Weger,REP,260025,0,0,0,0,
Grady,U.S. House,Anna Flatt,REP,260025,0,1,6,7,04
Grady,U.S. House,Tom Cole,REP,260025,0,6,77,83,04
Grady,Superintendent of Public Instruction,John Cox,DEM,260026,0,2,11,13,
Grady,Superintendent of Public Instruction,Jack Jr.,DEM,260026,0,0,5,5,
Grady,Superintendent of Public Instruction,Ivan Holmes,DEM,260026,0,0,3,3,
Grady,Superintendent of Public Instruction,Freda Deskin,DEM,260026,0,0,7,7,
Grady,U.S. Senate,Patrick Michael Hayes,DEM,260026,0,2,9,11,
Grady,U.S. Senate,Jim Rogers,DEM,260026,0,0,12,12,
Grady,U.S. Senate,Connie Johnson,DEM,260026,0,0,5,5,
Grady,U.S. House,Bert Smith,DEM,260026,0,2,22,24,04
Grady,U.S. House,Tae Si,DEM,260026,0,0,4,4,04
Grady,Governor,Dax Ewbank,REP,260026,0,0,2,2,
Grady,Governor,Chad Moody,REP,260026,1,0,3,4,
Grady,Governor,Mary Fallin,REP,260026,3,0,14,17,
Grady,Superintendent of Public Instruction,Brian Kelly,REP,260026,3,0,6,9,
Grady,Superintendent of Public Instruction,Janet Costello Barresi,REP,260026,0,0,2,2,
Grady,Superintendent of Public Instruction,Joy Hofmeister,REP,260026,1,0,10,11,
Grady,Insurance Commissioner,Bill Viner,REP,260026,2,0,4,6,
Grady,Insurance Commissioner,John Doak,REP,260026,2,0,13,15,
Grady,Corporation Commissioner,Todd Hiett,REP,260026,3,0,6,9,
Grady,Corporation Commissioner,Cliff Branan,REP,260026,1,0,12,13,
Grady,U.S. Senate,Evelyn Rogers,REP,260026,0,0,2,2,
Grady,U.S. Senate,Rob Moye,REP,260026,0,0,1,1,
Grady,U.S. Senate,D. Jean Mcbride-Samuels,REP,260026,0,0,0,0,
Grady,U.S. Senate,Jim Inhofe,REP,260026,4,0,11,15,
Grady,U.S. Senate,Erick Paul Wyatt,REP,260026,0,0,3,3,
Grady,U.S. Senate,Andy Craig,REP,260026,0,0,1,1,
Grady,U.S. Senate,T. Shannon,REP,260026,1,0,9,10,
Grady,U.S. Senate,Randy Brogdon,REP,260026,1,0,1,2,
Grady,U.S. Senate,Eric Mccray,REP,260026,0,0,0,0,
Grady,U.S. Senate,Kevin Crow,REP,260026,0,0,0,0,
Grady,U.S. Senate,James Lankford,REP,260026,2,0,7,9,
Grady,U.S. Senate,Jason Weger,REP,260026,0,0,0,0,
Grady,U.S. House,Anna Flatt,REP,260026,0,0,2,2,04
Grady,U.S. House,Tom Cole,REP,260026,4,0,17,21,04
Grady,Superintendent of Public Instruction,John Cox,DEM,260027,0,1,14,15,
Grady,Superintendent of Public Instruction,Jack Jr.,DEM,260027,0,0,2,2,
Grady,Superintendent of Public Instruction,Ivan Holmes,DEM,260027,0,0,0,0,
Grady,Superintendent of Public Instruction,Freda Deskin,DEM,260027,0,2,20,22,
Grady,U.S. Senate,Patrick Michael Hayes,DEM,260027,0,0,8,8,
Grady,U.S. Senate,Jim Rogers,DEM,260027,0,0,12,12,
Grady,U.S. Senate,Connie Johnson,DEM,260027,0,3,16,19,
Grady,U.S. House,Bert Smith,DEM,260027,0,2,31,33,04
Grady,U.S. House,Tae Si,DEM,260027,0,1,5,6,04
Grady,Governor,Dax Ewbank,REP,260027,0,3,2,5,
Grady,Governor,Chad Moody,REP,260027,0,1,20,21,
Grady,Governor,Mary Fallin,REP,260027,3,6,46,55,
Grady,Superintendent of Public Instruction,Brian Kelly,REP,260027,1,1,16,18,
Grady,Superintendent of Public Instruction,Janet Costello Barresi,REP,260027,0,5,3,8,
Grady,Superintendent of Public Instruction,Joy Hofmeister,REP,260027,2,4,48,54,
Grady,Insurance Commissioner,Bill Viner,REP,260027,0,3,13,16,
Grady,Insurance Commissioner,John Doak,REP,260027,3,6,50,59,
Grady,Corporation Commissioner,Todd Hiett,REP,260027,3,8,35,46,
Grady,Corporation Commissioner,Cliff Branan,REP,260027,0,2,28,30,
Grady,U.S. Senate,Evelyn Rogers,REP,260027,0,1,5,6,
Grady,U.S. Senate,Rob Moye,REP,260027,0,0,0,0,
Grady,U.S. Senate,D. Jean Mcbride-Samuels,REP,260027,0,0,0,0,
Grady,U.S. Senate,Jim Inhofe,REP,260027,3,7,58,68,
Grady,U.S. Senate,Erick Paul Wyatt,REP,260027,0,2,4,6,
Grady,U.S. Senate,Andy Craig,REP,260027,0,0,0,0,
Grady,U.S. Senate,T. Shannon,REP,260027,0,2,18,20,
Grady,U.S. Senate,Randy Brogdon,REP,260027,2,0,2,4,
Grady,U.S. Senate,Eric Mccray,REP,260027,0,0,0,0,
Grady,U.S. Senate,Kevin Crow,REP,260027,0,2,3,5,
Grady,U.S. Senate,James Lankford,REP,260027,1,6,43,50,
Grady,U.S. Senate,Jason Weger,REP,260027,0,0,0,0,
Grady,U.S. House,Anna Flatt,REP,260027,2,3,10,15,04
Grady,U.S. House,Tom Cole,REP,260027,1,7,57,65,04
Grady,Superintendent of Public Instruction,John Cox,DEM,260028,5,0,35,40,
Grady,Superintendent of Public Instruction,Jack Jr.,DEM,260028,0,0,4,4,
Grady,Superintendent of Public Instruction,Ivan Holmes,DEM,260028,3,0,2,5,
Grady,Superintendent of Public Instruction,Freda Deskin,DEM,260028,0,1,27,28,
Grady,U.S. Senate,Patrick Michael Hayes,DEM,260028,1,0,18,19,
Grady,U.S. Senate,Jim Rogers,DEM,260028,4,1,21,26,
Grady,U.S. Senate,Connie Johnson,DEM,260028,3,0,24,27,
Grady,U.S. House,Bert Smith,DEM,260028,7,1,53,61,04
Grady,U.S. House,Tae Si,DEM,260028,0,0,11,11,04
Grady,Governor,Dax Ewbank,REP,260028,0,0,17,17,
Grady,Governor,Chad Moody,REP,260028,0,0,21,21,
Grady,Governor,Mary Fallin,REP,260028,3,5,95,103,
Grady,Superintendent of Public Instruction,Brian Kelly,REP,260028,2,0,28,30,
Grady,Superintendent of Public Instruction,Janet Costello Barresi,REP,260028,0,1,23,24,
Grady,Superintendent of Public Instruction,Joy Hofmeister,REP,260028,1,4,79,84,
Grady,Insurance Commissioner,Bill Viner,REP,260028,0,1,28,29,
Grady,Insurance Commissioner,John Doak,REP,260028,3,3,96,102,
Grady,Corporation Commissioner,Todd Hiett,REP,260028,2,2,61,65,
Grady,Corporation Commissioner,Cliff Branan,REP,260028,1,2,64,67,
Grady,U.S. Senate,Evelyn Rogers,REP,260028,0,0,6,6,
Grady,U.S. Senate,Rob Moye,REP,260028,0,0,4,4,
Grady,U.S. Senate,D. Jean Mcbride-Samuels,REP,260028,0,0,2,2,
Grady,U.S. Senate,Jim Inhofe,REP,260028,3,5,114,122,
Grady,U.S. Senate,Erick Paul Wyatt,REP,260028,0,0,5,5,
Grady,U.S. Senate,Andy Craig,REP,260028,0,0,0,0,
Grady,U.S. Senate,T. Shannon,REP,260028,1,0,39,40,
Grady,U.S. Senate,Randy Brogdon,REP,260028,0,0,11,11,
Grady,U.S. Senate,Eric Mccray,REP,260028,0,0,0,0,
Grady,U.S. Senate,Kevin Crow,REP,260028,0,0,2,2,
Grady,U.S. Senate,James Lankford,REP,260028,2,5,80,87,
Grady,U.S. Senate,Jason Weger,REP,260028,0,0,1,1,
Grady,U.S. House,Anna Flatt,REP,260028,0,0,17,17,04
Grady,U.S. House,Tom Cole,REP,260028,3,5,116,124,04
Grady,Superintendent of Public Instruction,John Cox,DEM,260029,0,1,54,55,
Grady,Superintendent of Public Instruction,Jack Jr.,DEM,260029,0,0,34,34,
Grady,Superintendent of Public Instruction,Ivan Holmes,DEM,260029,0,0,2,2,
Grady,Superintendent of Public Instruction,Freda Deskin,DEM,260029,1,1,64,66,
Grady,U.S. Senate,Patrick Michael Hayes,DEM,260029,0,1,25,26,
Grady,U.S. Senate,Jim Rogers,DEM,260029,1,0,65,66,
Grady,U.S. Senate,Connie Johnson,DEM,260029,0,1,61,62,
Grady,U.S. House,Bert Smith,DEM,260029,1,1,135,137,04
Grady,U.S. House,Tae Si,DEM,260029,0,1,13,14,04
Grady,Governor,Dax Ewbank,REP,260029,1,0,14,15,
Grady,Governor,Chad Moody,REP,260029,0,2,35,37,
Grady,Governor,Mary Fallin,REP,260029,7,5,193,205,
Grady,Superintendent of Public Instruction,Brian Kelly,REP,260029,1,0,49,50,
Grady,Superintendent of Public Instruction,Janet Costello Barresi,REP,260029,4,2,35,41,
Grady,Superintendent of Public Instruction,Joy Hofmeister,REP,260029,3,5,157,165,
Grady,Insurance Commissioner,Bill Viner,REP,260029,1,0,47,48,
Grady,Insurance Commissioner,John Doak,REP,260029,7,6,179,192,
Grady,Corporation Commissioner,Todd Hiett,REP,260029,7,4,135,146,
Grady,Corporation Commissioner,Cliff Branan,REP,260029,1,2,96,99,
Grady,U.S. Senate,Evelyn Rogers,REP,260029,0,0,5,5,
Grady,U.S. Senate,Rob Moye,REP,260029,0,0,7,7,
Grady,U.S. Senate,D. Jean Mcbride-Samuels,REP,260029,0,0,2,2,
Grady,U.S. Senate,Jim Inhofe,REP,260029,7,7,217,231,
Grady,U.S. Senate,Erick Paul Wyatt,REP,260029,1,0,9,10,
Grady,U.S. Senate,Andy Craig,REP,260029,0,0,1,1,
Grady,U.S. Senate,T. Shannon,REP,260029,2,2,63,67,
Grady,U.S. Senate,Randy Brogdon,REP,260029,0,0,3,3,
Grady,U.S. Senate,Eric Mccray,REP,260029,0,0,2,2,
Grady,U.S. Senate,Kevin Crow,REP,260029,0,0,7,7,
Grady,U.S. Senate,James Lankford,REP,260029,6,5,167,178,
Grady,U.S. Senate,Jason Weger,REP,260029,0,0,0,0,
Grady,U.S. House,Anna Flatt,REP,260029,1,0,25,26,04
Grady,U.S. House,Tom Cole,REP,260029,7,7,217,231,04
Grady,Superintendent of Public Instruction,John Cox,DEM,260031,0,0,15,15,
Grady,Superintendent of Public Instruction,Jack Jr.,DEM,260031,1,0,1,2,
Grady,Superintendent of Public Instruction,Ivan Holmes,DEM,260031,0,1,1,2,
Grady,Superintendent of Public Instruction,Freda Deskin,DEM,260031,0,0,21,21,
Grady,U.S. Senate,Patrick Michael Hayes,DEM,260031,0,0,7,7,
Grady,U.S. Senate,Jim Rogers,DEM,260031,1,1,8,10,
Grady,U.S. Senate,Connie Johnson,DEM,260031,0,0,19,19,
Grady,U.S. House,Bert Smith,DEM,260031,1,1,35,37,04
Grady,U.S. House,Tae Si,DEM,260031,0,0,3,3,04
Grady,Governor,Dax Ewbank,REP,260031,0,0,1,1,
Grady,Governor,Chad Moody,REP,260031,0,0,6,6,
Grady,Governor,Mary Fallin,REP,260031,1,3,47,51,
Grady,Superintendent of Public Instruction,Brian Kelly,REP,260031,0,1,11,12,
Grady,Superintendent of Public Instruction,Janet Costello Barresi,REP,260031,0,0,14,14,
Grady,Superintendent of Public Instruction,Joy Hofmeister,REP,260031,1,2,30,33,
Grady,Insurance Commissioner,Bill Viner,REP,260031,0,2,11,13,
Grady,Insurance Commissioner,John Doak,REP,260031,1,1,40,42,
Grady,Corporation Commissioner,Todd Hiett,REP,260031,1,0,27,28,
Grady,Corporation Commissioner,Cliff Branan,REP,260031,0,3,27,30,
Grady,U.S. Senate,Evelyn Rogers,REP,260031,0,0,0,0,
Grady,U.S. Senate,Rob Moye,REP,260031,0,0,0,0,
Grady,U.S. Senate,D. Jean Mcbride-Samuels,REP,260031,0,0,0,0,
Grady,U.S. Senate,Jim Inhofe,REP,260031,1,3,52,56,
Grady,U.S. Senate,Erick Paul Wyatt,REP,260031,0,0,3,3,
Grady,U.S. Senate,Andy Craig,REP,260031,0,0,0,0,
Grady,U.S. Senate,T. Shannon,REP,260031,0,1,17,18,
Grady,U.S. Senate,Randy Brogdon,REP,260031,0,0,1,1,
Grady,U.S. Senate,Eric Mccray,REP,260031,0,0,0,0,
Grady,U.S. Senate,Kevin Crow,REP,260031,0,0,0,0,
Grady,U.S. Senate,James Lankford,REP,260031,1,2,36,39,
Grady,U.S. Senate,Jason Weger,REP,260031,0,0,1,1,
Grady,U.S. House,Anna Flatt,REP,260031,0,0,10,10,04
Grady,U.S. House,Tom Cole,REP,260031,1,3,44,48,04
Grady,Superintendent of Public Instruction,John Cox,DEM,260032,0,0,40,40,
Grady,Superintendent of Public Instruction,Jack Jr.,DEM,260032,0,1,7,8,
Grady,Superintendent of Public Instruction,Ivan Holmes,DEM,260032,0,0,5,5,
Grady,Superintendent of Public Instruction,Freda Deskin,DEM,260032,0,3,56,59,
Grady,U.S. Senate,Patrick Michael Hayes,DEM,260032,0,1,23,24,
Grady,U.S. Senate,Jim Rogers,DEM,260032,0,2,47,49,
Grady,U.S. Senate,Connie Johnson,DEM,260032,0,1,32,33,
Grady,U.S. House,Bert Smith,DEM,260032,0,4,88,92,04
Grady,U.S. House,Tae Si,DEM,260032,0,0,12,12,04
Grady,Governor,Dax Ewbank,REP,260032,0,2,5,7,
Grady,Governor,Chad Moody,REP,260032,0,3,27,30,
Grady,Governor,Mary Fallin,REP,260032,6,14,99,119,
Grady,Superintendent of Public Instruction,Brian Kelly,REP,260032,1,9,37,47,
Grady,Superintendent of Public Instruction,Janet Costello Barresi,REP,260032,1,2,20,23,
Grady,Superintendent of Public Instruction,Joy Hofmeister,REP,260032,4,9,74,87,
Grady,Insurance Commissioner,Bill Viner,REP,260032,2,5,20,27,
Grady,Insurance Commissioner,John Doak,REP,260032,4,15,104,123,
Grady,Corporation Commissioner,Todd Hiett,REP,260032,4,6,53,63,
Grady,Corporation Commissioner,Cliff Branan,REP,260032,0,13,73,86,
Grady,U.S. Senate,Evelyn Rogers,REP,260032,0,1,6,7,
Grady,U.S. Senate,Rob Moye,REP,260032,0,2,3,5,
Grady,U.S. Senate,D. Jean Mcbride-Samuels,REP,260032,0,0,2,2,
Grady,U.S. Senate,Jim Inhofe,REP,260032,6,16,108,130,
Grady,U.S. Senate,Erick Paul Wyatt,REP,260032,0,0,9,9,
Grady,U.S. Senate,Andy Craig,REP,260032,0,0,1,1,
Grady,U.S. Senate,T. Shannon,REP,260032,1,7,47,55,
Grady,U.S. Senate,Randy Brogdon,REP,260032,0,1,3,4,
Grady,U.S. Senate,Eric Mccray,REP,260032,0,0,2,2,
Grady,U.S. Senate,Kevin Crow,REP,260032,1,0,4,5,
Grady,U.S. Senate,James Lankford,REP,260032,4,11,74,89,
Grady,U.S. Senate,Jason Weger,REP,260032,0,0,0,0,
Grady,U.S. House,Anna Flatt,REP,260032,0,2,13,15,04
Grady,U.S. House,Tom Cole,REP,260032,6,17,118,141,04
Grady,Superintendent of Public Instruction,John Cox,DEM,260033,0,0,12,12,
Grady,Superintendent of Public Instruction,Jack Jr.,DEM,260033,0,0,5,5,
Grady,Superintendent of Public Instruction,Ivan Holmes,DEM,260033,0,0,3,3,
Grady,Superintendent of Public Instruction,Freda Deskin,DEM,260033,0,0,9,9,
Grady,U.S. Senate,Patrick Michael Hayes,DEM,260033,0,0,11,11,
Grady,U.S. Senate,Jim Rogers,DEM,260033,0,0,8,8,
Grady,U.S. Senate,Connie Johnson,DEM,260033,0,0,8,8,
Grady,U.S. House,Bert Smith,DEM,260033,0,0,24,24,04
Grady,U.S. House,Tae Si,DEM,260033,0,0,3,3,04
Grady,Governor,Dax Ewbank,REP,260033,0,0,1,1,
Grady,Governor,Chad Moody,REP,260033,0,2,5,7,
Grady,Governor,Mary Fallin,REP,260033,0,0,22,22,
Grady,Superintendent of Public Instruction,Brian Kelly,REP,260033,0,0,10,10,
Grady,Superintendent of Public Instruction,Janet Costello Barresi,REP,260033,0,0,3,3,
Grady,Superintendent of Public Instruction,Joy Hofmeister,REP,260033,0,2,16,18,
Grady,Insurance Commissioner,Bill Viner,REP,260033,0,0,6,6,
Grady,Insurance Commissioner,John Doak,REP,260033,0,2,21,23,
Grady,Corporation Commissioner,Todd Hiett,REP,260033,0,0,12,12,
Grady,Corporation Commissioner,Cliff Branan,REP,260033,0,2,16,18,
Grady,U.S. Senate,Evelyn Rogers,REP,260033,0,0,4,4,
Grady,U.S. Senate,Rob Moye,REP,260033,0,1,0,1,
Grady,U.S. Senate,D. Jean Mcbride-Samuels,REP,260033,0,0,0,0,
Grady,U.S. Senate,Jim Inhofe,REP,260033,0,1,22,23,
Grady,U.S. Senate,Erick Paul Wyatt,REP,260033,0,0,2,2,
Grady,U.S. Senate,Andy Craig,REP,260033,0,0,0,0,
Grady,U.S. Senate,T. Shannon,REP,260033,0,2,8,10,
Grady,U.S. Senate,Randy Brogdon,REP,260033,0,0,1,1,
Grady,U.S. Senate,Eric Mccray,REP,260033,0,0,0,0,
Grady,U.S. Senate,Kevin Crow,REP,260033,0,0,2,2,
Grady,U.S. Senate,James Lankford,REP,260033,0,0,19,19,
Grady,U.S. Senate,Jason Weger,REP,260033,0,0,0,0,
Grady,U.S. House,Anna Flatt,REP,260033,0,1,4,5,04
Grady,U.S. House,Tom Cole,REP,260033,0,1,25,26,04
Grady,Superintendent of Public Instruction,John Cox,DEM,260035,0,0,4,4,
Grady,Superintendent of Public Instruction,Jack Jr.,DEM,260035,0,0,3,3,
Grady,Superintendent of Public Instruction,Ivan Holmes,DEM,260035,0,0,1,1,
Grady,Superintendent of Public Instruction,Freda Deskin,DEM,260035,0,0,9,9,
Grady,U.S. Senate,Patrick Michael Hayes,DEM,260035,0,0,3,3,
Grady,U.S. Senate,Jim Rogers,DEM,260035,0,0,6,6,
Grady,U.S. Senate,Connie Johnson,DEM,260035,0,0,8,8,
Grady,U.S. House,Bert Smith,DEM,260035,0,0,16,16,04
Grady,U.S. House,Tae Si,DEM,260035,0,0,0,0,04
Grady,Governor,Dax Ewbank,REP,260035,0,1,4,5,
Grady,Governor,Chad Moody,REP,260035,0,1,5,6,
Grady,Governor,Mary Fallin,REP,260035,0,0,18,18,
Grady,Superintendent of Public Instruction,Brian Kelly,REP,260035,0,0,7,7,
Grady,Superintendent of Public Instruction,Janet Costello Barresi,REP,260035,0,0,6,6,
Grady,Superintendent of Public Instruction,Joy Hofmeister,REP,260035,0,2,14,16,
Grady,Insurance Commissioner,Bill Viner,REP,260035,0,0,4,4,
Grady,Insurance Commissioner,John Doak,REP,260035,0,2,22,24,
Grady,Corporation Commissioner,Todd Hiett,REP,260035,0,2,15,17,
Grady,Corporation Commissioner,Cliff Branan,REP,260035,0,0,12,12,
Grady,U.S. Senate,Evelyn Rogers,REP,260035,0,0,1,1,
Grady,U.S. Senate,Rob Moye,REP,260035,0,0,1,1,
Grady,U.S. Senate,D. Jean Mcbride-Samuels,REP,260035,0,0,1,1,
Grady,U.S. Senate,Jim Inhofe,REP,260035,0,2,23,25,
Grady,U.S. Senate,Erick Paul Wyatt,REP,260035,0,0,1,1,
Grady,U.S. Senate,Andy Craig,REP,260035,0,0,0,0,
Grady,U.S. Senate,T. Shannon,REP,260035,0,1,5,6,
Grady,U.S. Senate,Randy Brogdon,REP,260035,0,0,3,3,
Grady,U.S. Senate,Eric Mccray,REP,260035,0,0,0,0,
Grady,U.S. Senate,Kevin Crow,REP,260035,0,0,2,2,
Grady,U.S. Senate,James Lankford,REP,260035,0,1,17,18,
Grady,U.S. Senate,Jason Weger,REP,260035,0,0,0,0,
Grady,U.S. House,Anna Flatt,REP,260035,0,0,3,3,04
Grady,U.S. House,Tom Cole,REP,260035,0,2,24,26,04
Grady,Superintendent of Public Instruction,John Cox,DEM,260036,0,2,62,64,
Grady,Superintendent of Public Instruction,Jack Jr.,DEM,260036,0,2,43,45,
Grady,Superintendent of Public Instruction,Ivan Holmes,DEM,260036,1,0,15,16,
Grady,Superintendent of Public Instruction,Freda Deskin,DEM,260036,2,0,63,65,
Grady,U.S. Senate,Patrick Michael Hayes,DEM,260036,3,1,73,77,
Grady,U.S. Senate,Jim Rogers,DEM,260036,0,3,57,60,
Grady,U.S. Senate,Connie Johnson,DEM,260036,0,0,53,53,
Grady,U.S. House,Bert Smith,DEM,260036,3,4,158,165,04
Grady,U.S. House,Tae Si,DEM,260036,0,0,19,19,04
Grady,Governor,Dax Ewbank,REP,260036,0,0,16,16,
Grady,Governor,Chad Moody,REP,260036,1,4,28,33,
Grady,Governor,Mary Fallin,REP,260036,4,3,98,105,
Grady,Superintendent of Public Instruction,Brian Kelly,REP,260036,3,2,44,49,
Grady,Superintendent of Public Instruction,Janet Costello Barresi,REP,260036,0,1,25,26,
Grady,Superintendent of Public Instruction,Joy Hofmeister,REP,260036,2,4,73,79,
Grady,Insurance Commissioner,Bill Viner,REP,260036,3,0,42,45,
Grady,Insurance Commissioner,John Doak,REP,260036,2,7,91,100,
Grady,Corporation Commissioner,Todd Hiett,REP,260036,1,3,60,64,
Grady,Corporation Commissioner,Cliff Branan,REP,260036,4,4,78,86,
Grady,U.S. Senate,Evelyn Rogers,REP,260036,0,0,8,8,
Grady,U.S. Senate,Rob Moye,REP,260036,0,0,4,4,
Grady,U.S. Senate,D. Jean Mcbride-Samuels,REP,260036,0,0,2,2,
Grady,U.S. Senate,Jim Inhofe,REP,260036,5,7,121,133,
Grady,U.S. Senate,Erick Paul Wyatt,REP,260036,0,0,7,7,
Grady,U.S. Senate,Andy Craig,REP,260036,0,0,1,1,
Grady,U.S. Senate,T. Shannon,REP,260036,1,2,42,45,
Grady,U.S. Senate,Randy Brogdon,REP,260036,0,1,2,3,
Grady,U.S. Senate,Eric Mccray,REP,260036,0,0,3,3,
Grady,U.S. Senate,Kevin Crow,REP,260036,0,0,7,7,
Grady,U.S. Senate,James Lankford,REP,260036,4,4,88,96,
Grady,U.S. Senate,Jason Weger,REP,260036,0,0,1,1,
Grady,U.S. House,Anna Flatt,REP,260036,0,1,23,24,04
Grady,U.S. House,Tom Cole,REP,260036,5,6,121,132,04
Grady,State House,Renae Sexton,REP,260036,3,2,30,35,65
Grady,State House,Scott Hayes,REP,260036,1,0,27,28,65
Grady,State House,Scooter Park,REP,260036,0,0,21,21,65
Grady,State House,Stephen Mills,REP,260036,1,5,62,68,65
Grady,Superintendent of Public Instruction,John Cox,DEM,260037,5,0,27,32,
Grady,Superintendent of Public Instruction,Jack Jr.,DEM,260037,3,0,13,16,
Grady,Superintendent of Public Instruction,Ivan Holmes,DEM,260037,3,0,5,8,
Grady,Superintendent of Public Instruction,Freda Deskin,DEM,260037,2,2,29,33,
Grady,U.S. Senate,Patrick Michael Hayes,DEM,260037,1,1,13,15,
Grady,U.S. Senate,Jim Rogers,DEM,260037,2,0,30,32,
Grady,U.S. Senate,Connie Johnson,DEM,260037,10,1,32,43,
Grady,U.S. House,Bert Smith,DEM,260037,10,2,58,70,04
Grady,U.S. House,Tae Si,DEM,260037,3,0,17,20,04
Grady,Governor,Dax Ewbank,REP,260037,2,0,39,41,
Grady,Governor,Chad Moody,REP,260037,1,0,53,54,
Grady,Governor,Mary Fallin,REP,260037,34,11,331,376,
Grady,Superintendent of Public Instruction,Brian Kelly,REP,260037,8,1,99,108,
Grady,Superintendent of Public Instruction,Janet Costello Barresi,REP,260037,18,4,83,105,
Grady,Superintendent of Public Instruction,Joy Hofmeister,REP,260037,10,5,236,251,
Grady,Insurance Commissioner,Bill Viner,REP,260037,10,2,109,121,
Grady,Insurance Commissioner,John Doak,REP,260037,25,8,282,315,
Grady,Corporation Commissioner,Todd Hiett,REP,260037,18,5,185,208,
Grady,Corporation Commissioner,Cliff Branan,REP,260037,16,4,208,228,
Grady,U.S. Senate,Evelyn Rogers,REP,260037,0,0,20,20,
Grady,U.S. Senate,Rob Moye,REP,260037,0,0,4,4,
Grady,U.S. Senate,D. Jean Mcbride-Samuels,REP,260037,3,0,5,8,
Grady,U.S. Senate,Jim Inhofe,REP,260037,32,11,373,416,
Grady,U.S. Senate,Erick Paul Wyatt,REP,260037,2,0,19,21,
Grady,U.S. Senate,Andy Craig,REP,260037,4,0,2,6,
Grady,U.S. Senate,T. Shannon,REP,260037,8,6,127,141,
Grady,U.S. Senate,Randy Brogdon,REP,260037,0,0,11,11,
Grady,U.S. Senate,Eric Mccray,REP,260037,0,0,0,0,
Grady,U.S. Senate,Kevin Crow,REP,260037,0,1,1,2,
Grady,U.S. Senate,James Lankford,REP,260037,26,4,285,315,
Grady,U.S. Senate,Jason Weger,REP,260037,0,0,2,2,
Grady,U.S. House,Anna Flatt,REP,260037,3,1,67,71,04
Grady,U.S. House,Tom Cole,REP,260037,35,10,357,402,04
Grady,Superintendent of Public Instruction,John Cox,DEM,260038,2,0,23,25,
Grady,Superintendent of Public Instruction,Jack Jr.,DEM,260038,2,1,12,15,
Grady,Superintendent of Public Instruction,Ivan Holmes,DEM,260038,1,0,6,7,
Grady,Superintendent of Public Instruction,Freda Deskin,DEM,260038,2,0,20,22,
Grady,U.S. Senate,Patrick Michael Hayes,DEM,260038,0,0,8,8,
Grady,U.S. Senate,Jim Rogers,DEM,260038,3,1,30,34,
Grady,U.S. Senate,Connie Johnson,DEM,260038,3,0,23,26,
Grady,U.S. House,Bert Smith,DEM,260038,6,1,56,63,04
Grady,U.S. House,Tae Si,DEM,260038,1,0,6,7,04
Grady,Governor,Dax Ewbank,REP,260038,1,1,27,29,
Grady,Governor,Chad Moody,REP,260038,2,0,53,55,
Grady,Governor,Mary Fallin,REP,260038,9,1,213,223,
Grady,Superintendent of Public Instruction,Brian Kelly,REP,260038,1,2,77,80,
Grady,Superintendent of Public Instruction,Janet Costello Barresi,REP,260038,5,0,45,50,
Grady,Superintendent of Public Instruction,Joy Hofmeister,REP,260038,5,0,171,176,
Grady,Insurance Commissioner,Bill Viner,REP,260038,1,0,76,77,
Grady,Insurance Commissioner,John Doak,REP,260038,11,3,207,221,
Grady,Corporation Commissioner,Todd Hiett,REP,260038,5,3,149,157,
Grady,Corporation Commissioner,Cliff Branan,REP,260038,5,0,137,142,
Grady,U.S. Senate,Evelyn Rogers,REP,260038,0,0,14,14,
Grady,U.S. Senate,Rob Moye,REP,260038,0,0,9,9,
Grady,U.S. Senate,D. Jean Mcbride-Samuels,REP,260038,1,0,1,2,
Grady,U.S. Senate,Jim Inhofe,REP,260038,10,2,259,271,
Grady,U.S. Senate,Erick Paul Wyatt,REP,260038,0,1,16,17,
Grady,U.S. Senate,Andy Craig,REP,260038,0,0,2,2,
Grady,U.S. Senate,T. Shannon,REP,260038,2,0,95,97,
Grady,U.S. Senate,Randy Brogdon,REP,260038,0,1,12,13,
Grady,U.S. Senate,Eric Mccray,REP,260038,0,0,2,2,
Grady,U.S. Senate,Kevin Crow,REP,260038,0,0,2,2,
Grady,U.S. Senate,James Lankford,REP,260038,9,2,183,194,
Grady,U.S. Senate,Jason Weger,REP,260038,1,0,0,1,
Grady,U.S. House,Anna Flatt,REP,260038,2,1,64,67,04
Grady,U.S. House,Tom Cole,REP,260038,10,2,230,242,04
Grady,Superintendent of Public Instruction,John Cox,DEM,260039,2,0,35,37,
Grady,Superintendent of Public Instruction,Jack Jr.,DEM,260039,0,0,7,7,
Grady,Superintendent of Public Instruction,Ivan Holmes,DEM,260039,0,0,0,0,
Grady,Superintendent of Public Instruction,Freda Deskin,DEM,260039,0,0,32,32,
Grady,U.S. Senate,Patrick Michael Hayes,DEM,260039,0,0,10,10,
Grady,U.S. Senate,Jim Rogers,DEM,260039,2,0,34,36,
Grady,U.S. Senate,Connie Johnson,DEM,260039,0,0,27,27,
Grady,U.S. House,Bert Smith,DEM,260039,2,0,61,63,04
Grady,U.S. House,Tae Si,DEM,260039,0,0,12,12,04
Grady,Governor,Dax Ewbank,REP,260039,0,1,15,16,
Grady,Governor,Chad Moody,REP,260039,0,0,37,37,
Grady,Governor,Mary Fallin,REP,260039,2,10,149,161,
Grady,Superintendent of Public Instruction,Brian Kelly,REP,260039,0,2,47,49,
Grady,Superintendent of Public Instruction,Janet Costello Barresi,REP,260039,2,2,25,29,
Grady,Superintendent of Public Instruction,Joy Hofmeister,REP,260039,0,7,124,131,
Grady,Insurance Commissioner,Bill Viner,REP,260039,0,1,43,44,
Grady,Insurance Commissioner,John Doak,REP,260039,2,10,142,154,
Grady,Corporation Commissioner,Todd Hiett,REP,260039,2,7,98,107,
Grady,Corporation Commissioner,Cliff Branan,REP,260039,0,2,90,92,
Grady,U.S. Senate,Evelyn Rogers,REP,260039,0,1,8,9,
Grady,U.S. Senate,Rob Moye,REP,260039,0,0,3,3,
Grady,U.S. Senate,D. Jean Mcbride-Samuels,REP,260039,0,0,5,5,
Grady,U.S. Senate,Jim Inhofe,REP,260039,2,8,176,186,
Grady,U.S. Senate,Erick Paul Wyatt,REP,260039,0,2,9,11,
Grady,U.S. Senate,Andy Craig,REP,260039,0,0,0,0,
Grady,U.S. Senate,T. Shannon,REP,260039,1,3,62,66,
Grady,U.S. Senate,Randy Brogdon,REP,260039,0,2,5,7,
Grady,U.S. Senate,Eric Mccray,REP,260039,0,0,1,1,
Grady,U.S. Senate,Kevin Crow,REP,260039,1,0,1,2,
Grady,U.S. Senate,James Lankford,REP,260039,0,6,132,138,
Grady,U.S. Senate,Jason Weger,REP,260039,0,0,1,1,
Grady,U.S. House,Anna Flatt,REP,260039,1,5,34,40,04
Grady,U.S. House,Tom Cole,REP,260039,1,6,168,175,04
Grady,Superintendent of Public Instruction,John Cox,DEM,260040,1,2,38,41,
Grady,Superintendent of Public Instruction,Jack Jr.,DEM,260040,1,0,14,15,
Grady,Superintendent of Public Instruction,Ivan Holmes,DEM,260040,2,1,4,7,
Grady,Superintendent of Public Instruction,Freda Deskin,DEM,260040,1,1,34,36,
Grady,U.S. Senate,Patrick Michael Hayes,DEM,260040,0,1,13,14,
Grady,U.S. Senate,Jim Rogers,DEM,260040,1,0,40,41,
Grady,U.S. Senate,Connie Johnson,DEM,260040,3,2,34,39,
Grady,U.S. House,Bert Smith,DEM,260040,2,3,72,77,04
Grady,U.S. House,Tae Si,DEM,260040,2,0,16,18,04
Grady,Governor,Dax Ewbank,REP,260040,1,0,19,20,
Grady,Governor,Chad Moody,REP,260040,1,1,51,53,
Grady,Governor,Mary Fallin,REP,260040,11,8,231,250,
Grady,Superintendent of Public Instruction,Brian Kelly,REP,260040,2,1,54,57,
Grady,Superintendent of Public Instruction,Janet Costello Barresi,REP,260040,3,0,47,50,
Grady,Superintendent of Public Instruction,Joy Hofmeister,REP,260040,8,8,197,213,
Grady,Insurance Commissioner,Bill Viner,REP,260040,5,2,63,70,
Grady,Insurance Commissioner,John Doak,REP,260040,6,7,212,225,
Grady,Corporation Commissioner,Todd Hiett,REP,260040,5,5,136,146,
Grady,Corporation Commissioner,Cliff Branan,REP,260040,6,4,148,158,
Grady,U.S. Senate,Evelyn Rogers,REP,260040,1,0,7,8,
Grady,U.S. Senate,Rob Moye,REP,260040,1,0,2,3,
Grady,U.S. Senate,D. Jean Mcbride-Samuels,REP,260040,0,0,1,1,
Grady,U.S. Senate,Jim Inhofe,REP,260040,10,9,272,291,
Grady,U.S. Senate,Erick Paul Wyatt,REP,260040,0,0,15,15,
Grady,U.S. Senate,Andy Craig,REP,260040,0,0,2,2,
Grady,U.S. Senate,T. Shannon,REP,260040,2,2,100,104,
Grady,U.S. Senate,Randy Brogdon,REP,260040,1,0,6,7,
Grady,U.S. Senate,Eric Mccray,REP,260040,0,0,2,2,
Grady,U.S. Senate,Kevin Crow,REP,260040,1,0,0,1,
Grady,U.S. Senate,James Lankford,REP,260040,9,7,191,207,
Grady,U.S. Senate,Jason Weger,REP,260040,0,0,2,2,
Grady,U.S. House,Anna Flatt,REP,260040,2,1,32,35,04
Grady,U.S. House,Tom Cole,REP,260040,11,8,269,288,04
Grady,Superintendent of Public Instruction,John Cox,DEM,260041,0,0,28,28,
Grady,Superintendent of Public Instruction,Jack Jr.,DEM,260041,1,0,13,14,
Grady,Superintendent of Public Instruction,Ivan Holmes,DEM,260041,0,0,5,5,
Grady,Superintendent of Public Instruction,Freda Deskin,DEM,260041,0,0,44,44,
Grady,U.S. Senate,Patrick Michael Hayes,DEM,260041,1,0,11,12,
Grady,U.S. Senate,Jim Rogers,DEM,260041,0,0,29,29,
Grady,U.S. Senate,Connie Johnson,DEM,260041,0,0,47,47,
Grady,U.S. House,Bert Smith,DEM,260041,1,0,70,71,04
Grady,U.S. House,Tae Si,DEM,260041,0,0,18,18,04
Grady,Governor,Dax Ewbank,REP,260041,1,3,27,31,
Grady,Governor,Chad Moody,REP,260041,5,4,47,56,
Grady,Governor,Mary Fallin,REP,260041,5,2,243,250,
Grady,Superintendent of Public Instruction,Brian Kelly,REP,260041,2,1,62,65,
Grady,Superintendent of Public Instruction,Janet Costello Barresi,REP,260041,1,0,57,58,
Grady,Superintendent of Public Instruction,Joy Hofmeister,REP,260041,8,8,200,216,
Grady,Insurance Commissioner,Bill Viner,REP,260041,1,3,64,68,
Grady,Insurance Commissioner,John Doak,REP,260041,9,6,222,237,
Grady,Corporation Commissioner,Todd Hiett,REP,260041,8,4,133,145,
Grady,Corporation Commissioner,Cliff Branan,REP,260041,2,5,158,165,
Grady,U.S. Senate,Evelyn Rogers,REP,260041,3,0,10,13,
Grady,U.S. Senate,Rob Moye,REP,260041,0,0,4,4,
Grady,U.S. Senate,D. Jean Mcbride-Samuels,REP,260041,0,0,7,7,
Grady,U.S. Senate,Jim Inhofe,REP,260041,7,9,272,288,
Grady,U.S. Senate,Erick Paul Wyatt,REP,260041,1,0,18,19,
Grady,U.S. Senate,Andy Craig,REP,260041,0,0,3,3,
Grady,U.S. Senate,T. Shannon,REP,260041,3,3,121,127,
Grady,U.S. Senate,Randy Brogdon,REP,260041,0,1,1,2,
Grady,U.S. Senate,Eric Mccray,REP,260041,0,0,0,0,
Grady,U.S. Senate,Kevin Crow,REP,260041,1,0,6,7,
Grady,U.S. Senate,James Lankford,REP,260041,7,5,191,203,
Grady,U.S. Senate,Jason Weger,REP,260041,0,0,1,1,
Grady,U.S. House,Anna Flatt,REP,260041,5,4,38,47,04
Grady,U.S. House,Tom Cole,REP,260041,6,5,281,292,04
Grant,Superintendent of Public Instruction,John Cox,DEM,270011,0,0,10,10,
Grant,Superintendent of Public Instruction,Jack Jr.,DEM,270011,0,0,0,0,
Grant,Superintendent of Public Instruction,Ivan Holmes,DEM,270011,0,0,0,0,
Grant,Superintendent of Public Instruction,Freda Deskin,DEM,270011,0,0,5,5,
Grant,U.S. Senate,Patrick Michael Hayes,DEM,270011,0,0,4,4,
Grant,U.S. Senate,Jim Rogers,DEM,270011,0,0,5,5,
Grant,U.S. Senate,Connie Johnson,DEM,270011,0,0,7,7,
Grant,Governor,Dax Ewbank,REP,270011,0,0,6,6,
Grant,Governor,Chad Moody,REP,270011,0,0,8,8,
Grant,Governor,Mary Fallin,REP,270011,0,0,33,33,
Grant,Superintendent of Public Instruction,Brian Kelly,REP,270011,0,0,11,11,
Grant,Superintendent of Public Instruction,Janet Costello Barresi,REP,270011,0,0,5,5,
Grant,Superintendent of Public Instruction,Joy Hofmeister,REP,270011,0,1,32,33,
Grant,Insurance Commissioner,Bill Viner,REP,270011,0,1,10,11,
Grant,Insurance Commissioner,John Doak,REP,270011,0,0,35,35,
Grant,Corporation Commissioner,Todd Hiett,REP,270011,0,1,25,26,
Grant,Corporation Commissioner,Cliff Branan,REP,270011,0,0,23,23,
Grant,U.S. Senate,Evelyn Rogers,REP,270011,0,0,1,1,
Grant,U.S. Senate,Rob Moye,REP,270011,0,0,1,1,
Grant,U.S. Senate,D. Jean Mcbride-Samuels,REP,270011,0,0,2,2,
Grant,U.S. Senate,Jim Inhofe,REP,270011,0,2,35,37,
Grant,U.S. Senate,Erick Paul Wyatt,REP,270011,0,0,7,7,
Grant,U.S. Senate,Andy Craig,REP,270011,0,0,1,1,
Grant,U.S. Senate,T. Shannon,REP,270011,0,0,13,13,
Grant,U.S. Senate,Randy Brogdon,REP,270011,0,0,6,6,
Grant,U.S. Senate,Eric Mccray,REP,270011,0,0,0,0,
Grant,U.S. Senate,Kevin Crow,REP,270011,0,0,1,1,
Grant,U.S. Senate,James Lankford,REP,270011,0,1,26,27,
Grant,U.S. Senate,Jason Weger,REP,270011,0,0,1,1,
Grant,U.S. House,Timothy Ray Murray,REP,270011,0,1,1,2,03
Grant,U.S. House,Robert Hubbard,REP,270011,0,0,7,7,03
Grant,U.S. House,Frank Lucas,REP,270011,0,0,40,40,03
Grant,State House,Roy Chaney,REP,270011,0,1,4,5,38
Grant,State House,Niki Schrader,REP,270011,0,0,0,0,38
Grant,State House,Jason Warren,REP,270011,0,0,9,9,38
Grant,State House,Ralph Meade,REP,270011,0,1,9,10,38
Grant,State House,John Pfeiffer,REP,270011,0,0,18,18,38
Grant,State House,Harold Levalley,REP,270011,0,0,9,9,38
Grant,Superintendent of Public Instruction,John Cox,DEM,270017,0,0,7,7,
Grant,Superintendent of Public Instruction,Jack Jr.,DEM,270017,0,0,1,1,
Grant,Superintendent of Public Instruction,Ivan Holmes,DEM,270017,0,0,1,1,
Grant,Superintendent of Public Instruction,Freda Deskin,DEM,270017,0,0,10,10,
Grant,U.S. Senate,Patrick Michael Hayes,DEM,270017,0,0,4,4,
Grant,U.S. Senate,Jim Rogers,DEM,270017,0,0,7,7,
Grant,U.S. Senate,Connie Johnson,DEM,270017,2,0,8,10,
Grant,Governor,Dax Ewbank,REP,270017,0,0,17,17,
Grant,Governor,Chad Moody,REP,270017,2,0,14,16,
Grant,Governor,Mary Fallin,REP,270017,5,4,67,76,
Grant,Superintendent of Public Instruction,Brian Kelly,REP,270017,4,1,25,30,
Grant,Superintendent of Public Instruction,Janet Costello Barresi,REP,270017,3,0,11,14,
Grant,Superintendent of Public Instruction,Joy Hofmeister,REP,270017,0,3,64,67,
Grant,Insurance Commissioner,Bill Viner,REP,270017,2,1,19,22,
Grant,Insurance Commissioner,John Doak,REP,270017,5,3,70,78,
Grant,Corporation Commissioner,Todd Hiett,REP,270017,3,1,49,53,
Grant,Corporation Commissioner,Cliff Branan,REP,270017,2,3,47,52,
Grant,U.S. Senate,Evelyn Rogers,REP,270017,1,0,7,8,
Grant,U.S. Senate,Rob Moye,REP,270017,0,0,0,0,
Grant,U.S. Senate,D. Jean Mcbride-Samuels,REP,270017,0,0,2,2,
Grant,U.S. Senate,Jim Inhofe,REP,270017,6,4,91,101,
Grant,U.S. Senate,Erick Paul Wyatt,REP,270017,0,0,0,0,
Grant,U.S. Senate,Andy Craig,REP,270017,0,0,0,0,
Grant,U.S. Senate,T. Shannon,REP,270017,4,3,35,42,
Grant,U.S. Senate,Randy Brogdon,REP,270017,0,0,0,0,
Grant,U.S. Senate,Eric Mccray,REP,270017,1,0,0,1,
Grant,U.S. Senate,Kevin Crow,REP,270017,0,0,1,1,
Grant,U.S. Senate,James Lankford,REP,270017,2,1,63,66,
Grant,U.S. Senate,Jason Weger,REP,270017,0,0,0,0,
Grant,U.S. House,Timothy Ray Murray,REP,270017,1,0,3,4,03
Grant,U.S. House,Robert Hubbard,REP,270017,1,0,8,9,03
Grant,U.S. House,Frank Lucas,REP,270017,5,4,89,98,03
Grant,State House,Roy Chaney,REP,270017,3,1,8,12,38
Grant,State House,Niki Schrader,REP,270017,3,3,28,34,38
Grant,State House,Jason Warren,REP,270017,0,0,8,8,38
Grant,State House,Ralph Meade,REP,270017,0,0,12,12,38
Grant,State House,John Pfeiffer,REP,270017,1,0,24,25,38
Grant,State House,Harold Levalley,REP,270017,0,0,16,16,38
Grant,Superintendent of Public Instruction,John Cox,DEM,270023,0,0,32,32,
Grant,Superintendent of Public Instruction,Jack Jr.,DEM,270023,3,0,7,10,
Grant,Superintendent of Public Instruction,Ivan Holmes,DEM,270023,0,1,3,4,
Grant,Superintendent of Public Instruction,Freda Deskin,DEM,270023,0,0,18,18,
Grant,U.S. Senate,Patrick Michael Hayes,DEM,270023,2,0,13,15,
Grant,U.S. Senate,Jim Rogers,DEM,270023,0,0,25,25,
Grant,U.S. Senate,Connie Johnson,DEM,270023,1,1,21,23,
Grant,Governor,Dax Ewbank,REP,270023,0,2,13,15,
Grant,Governor,Chad Moody,REP,270023,2,0,40,42,
Grant,Governor,Mary Fallin,REP,270023,0,5,105,110,
Grant,Superintendent of Public Instruction,Brian Kelly,REP,270023,0,1,45,46,
Grant,Superintendent of Public Instruction,Janet Costello Barresi,REP,270023,0,0,11,11,
Grant,Superintendent of Public Instruction,Joy Hofmeister,REP,270023,2,6,103,111,
Grant,Insurance Commissioner,Bill Viner,REP,270023,1,1,44,46,
Grant,Insurance Commissioner,John Doak,REP,270023,1,6,108,115,
Grant,Corporation Commissioner,Todd Hiett,REP,270023,2,4,80,86,
Grant,Corporation Commissioner,Cliff Branan,REP,270023,0,3,73,76,
Grant,U.S. Senate,Evelyn Rogers,REP,270023,0,0,7,7,
Grant,U.S. Senate,Rob Moye,REP,270023,0,0,1,1,
Grant,U.S. Senate,D. Jean Mcbride-Samuels,REP,270023,0,0,5,5,
Grant,U.S. Senate,Jim Inhofe,REP,270023,1,7,137,145,
Grant,U.S. Senate,Erick Paul Wyatt,REP,270023,1,0,9,10,
Grant,U.S. Senate,Andy Craig,REP,270023,0,0,3,3,
Grant,U.S. Senate,T. Shannon,REP,270023,1,5,74,80,
Grant,U.S. Senate,Randy Brogdon,REP,270023,0,0,0,0,
Grant,U.S. Senate,Eric Mccray,REP,270023,0,0,2,2,
Grant,U.S. Senate,Kevin Crow,REP,270023,0,0,3,3,
Grant,U.S. Senate,James Lankford,REP,270023,1,2,76,79,
Grant,U.S. Senate,Jason Weger,REP,270023,0,0,1,1,
Grant,U.S. House,Timothy Ray Murray,REP,270023,0,0,7,7,03
Grant,U.S. House,Robert Hubbard,REP,270023,1,0,14,15,03
Grant,U.S. House,Frank Lucas,REP,270023,1,7,139,147,03
Grant,State House,Roy Chaney,REP,270023,1,0,22,23,38
Grant,State House,Niki Schrader,REP,270023,1,2,73,76,38
Grant,State House,Jason Warren,REP,270023,0,0,2,2,38
Grant,State House,Ralph Meade,REP,270023,0,1,11,12,38
Grant,State House,John Pfeiffer,REP,270023,0,0,27,27,38
Grant,State House,Harold Levalley,REP,270023,0,4,25,29,38
Grant,Superintendent of Public Instruction,John Cox,DEM,270025,1,0,11,12,
Grant,Superintendent of Public Instruction,Jack Jr.,DEM,270025,1,0,5,6,
Grant,Superintendent of Public Instruction,Ivan Holmes,DEM,270025,2,0,2,4,
Grant,Superintendent of Public Instruction,Freda Deskin,DEM,270025,2,0,9,11,
Grant,U.S. Senate,Patrick Michael Hayes,DEM,270025,2,0,7,9,
Grant,U.S. Senate,Jim Rogers,DEM,270025,2,0,12,14,
Grant,U.S. Senate,Connie Johnson,DEM,270025,2,0,9,11,
Grant,Governor,Dax Ewbank,REP,270025,1,0,3,4,
Grant,Governor,Chad Moody,REP,270025,0,0,10,10,
Grant,Governor,Mary Fallin,REP,270025,2,1,78,81,
Grant,Superintendent of Public Instruction,Brian Kelly,REP,270025,0,0,31,31,
Grant,Superintendent of Public Instruction,Janet Costello Barresi,REP,270025,1,0,11,12,
Grant,Superintendent of Public Instruction,Joy Hofmeister,REP,270025,2,1,48,51,
Grant,Insurance Commissioner,Bill Viner,REP,270025,0,0,18,18,
Grant,Insurance Commissioner,John Doak,REP,270025,2,1,73,76,
Grant,Corporation Commissioner,Todd Hiett,REP,270025,1,1,37,39,
Grant,Corporation Commissioner,Cliff Branan,REP,270025,1,0,52,53,
Grant,U.S. Senate,Evelyn Rogers,REP,270025,0,0,3,3,
Grant,U.S. Senate,Rob Moye,REP,270025,0,0,0,0,
Grant,U.S. Senate,D. Jean Mcbride-Samuels,REP,270025,1,0,2,3,
Grant,U.S. Senate,Jim Inhofe,REP,270025,2,1,83,86,
Grant,U.S. Senate,Erick Paul Wyatt,REP,270025,0,0,4,4,
Grant,U.S. Senate,Andy Craig,REP,270025,0,0,1,1,
Grant,U.S. Senate,T. Shannon,REP,270025,0,1,35,36,
Grant,U.S. Senate,Randy Brogdon,REP,270025,1,0,0,1,
Grant,U.S. Senate,Eric Mccray,REP,270025,0,0,0,0,
Grant,U.S. Senate,Kevin Crow,REP,270025,0,0,0,0,
Grant,U.S. Senate,James Lankford,REP,270025,1,0,56,57,
Grant,U.S. Senate,Jason Weger,REP,270025,0,0,0,0,
Grant,U.S. House,Timothy Ray Murray,REP,270025,1,0,3,4,03
Grant,U.S. House,Robert Hubbard,REP,270025,1,0,4,5,03
Grant,U.S. House,Frank Lucas,REP,270025,1,1,85,87,03
Grant,State House,Roy Chaney,REP,270025,0,0,9,9,38
Grant,State House,Niki Schrader,REP,270025,0,0,8,8,38
Grant,State House,Jason Warren,REP,270025,0,0,2,2,38
Grant,State House,Ralph Meade,REP,270025,0,1,15,16,38
Grant,State House,John Pfeiffer,REP,270025,1,0,29,30,38
Grant,State House,Harold Levalley,REP,270025,1,0,27,28,38
Grant,Superintendent of Public Instruction,John Cox,DEM,270026,0,0,5,5,
Grant,Superintendent of Public Instruction,Jack Jr.,DEM,270026,0,0,6,6,
Grant,Superintendent of Public Instruction,Ivan Holmes,DEM,270026,0,0,4,4,
Grant,Superintendent of Public Instruction,Freda Deskin,DEM,270026,0,0,11,11,
Grant,U.S. Senate,Patrick Michael Hayes,DEM,270026,0,0,10,10,
Grant,U.S. Senate,Jim Rogers,DEM,270026,0,0,8,8,
Grant,U.S. Senate,Connie Johnson,DEM,270026,0,0,8,8,
Grant,Governor,Dax Ewbank,REP,270026,0,0,15,15,
Grant,Governor,Chad Moody,REP,270026,0,0,12,12,
Grant,Governor,Mary Fallin,REP,270026,1,1,52,54,
Grant,Superintendent of Public Instruction,Brian Kelly,REP,270026,1,0,17,18,
Grant,Superintendent of Public Instruction,Janet Costello Barresi,REP,270026,0,1,12,13,
Grant,Superintendent of Public Instruction,Joy Hofmeister,REP,270026,0,0,50,50,
Grant,Insurance Commissioner,Bill Viner,REP,270026,0,0,25,25,
Grant,Insurance Commissioner,John Doak,REP,270026,1,1,53,55,
Grant,Corporation Commissioner,Todd Hiett,REP,270026,1,1,41,43,
Grant,Corporation Commissioner,Cliff Branan,REP,270026,0,0,31,31,
Grant,U.S. Senate,Evelyn Rogers,REP,270026,0,0,2,2,
Grant,U.S. Senate,Rob Moye,REP,270026,0,0,2,2,
Grant,U.S. Senate,D. Jean Mcbride-Samuels,REP,270026,0,0,0,0,
Grant,U.S. Senate,Jim Inhofe,REP,270026,1,1,62,64,
Grant,U.S. Senate,Erick Paul Wyatt,REP,270026,0,0,11,11,
Grant,U.S. Senate,Andy Craig,REP,270026,0,0,1,1,
Grant,U.S. Senate,T. Shannon,REP,270026,0,0,26,26,
Grant,U.S. Senate,Randy Brogdon,REP,270026,0,0,4,4,
Grant,U.S. Senate,Eric Mccray,REP,270026,0,0,3,3,
Grant,U.S. Senate,Kevin Crow,REP,270026,0,0,3,3,
Grant,U.S. Senate,James Lankford,REP,270026,1,1,36,38,
Grant,U.S. Senate,Jason Weger,REP,270026,0,0,3,3,
Grant,U.S. House,Timothy Ray Murray,REP,270026,0,0,4,4,03
Grant,U.S. House,Robert Hubbard,REP,270026,0,0,13,13,03
Grant,U.S. House,Frank Lucas,REP,270026,1,1,60,62,03
Grant,State House,Roy Chaney,REP,270026,0,0,19,19,38
Grant,State House,Niki Schrader,REP,270026,0,0,9,9,38
Grant,State House,Jason Warren,REP,270026,1,0,13,14,38
Grant,State House,Ralph Meade,REP,270026,0,0,14,14,38
Grant,State House,John Pfeiffer,REP,270026,0,0,13,13,38
Grant,State House,Harold Levalley,REP,270026,0,1,8,9,38
Grant,Superintendent of Public Instruction,John Cox,DEM,270029,0,1,13,14,
Grant,Superintendent of Public Instruction,Jack Jr.,DEM,270029,0,0,4,4,
Grant,Superintendent of Public Instruction,Ivan Holmes,DEM,270029,0,0,2,2,
Grant,Superintendent of Public Instruction,Freda Deskin,DEM,270029,0,3,4,7,
Grant,U.S. Senate,Patrick Michael Hayes,DEM,270029,0,2,3,5,
Grant,U.S. Senate,Jim Rogers,DEM,270029,0,2,14,16,
Grant,U.S. Senate,Connie Johnson,DEM,270029,0,0,5,5,
Grant,Governor,Dax Ewbank,REP,270029,0,0,6,6,
Grant,Governor,Chad Moody,REP,270029,1,2,7,10,
Grant,Governor,Mary Fallin,REP,270029,1,5,48,54,
Grant,Superintendent of Public Instruction,Brian Kelly,REP,270029,1,2,17,20,
Grant,Superintendent of Public Instruction,Janet Costello Barresi,REP,270029,1,1,6,8,
Grant,Superintendent of Public Instruction,Joy Hofmeister,REP,270029,0,4,37,41,
Grant,Insurance Commissioner,Bill Viner,REP,270029,0,4,13,17,
Grant,Insurance Commissioner,John Doak,REP,270029,2,3,44,49,
Grant,Corporation Commissioner,Todd Hiett,REP,270029,1,4,32,37,
Grant,Corporation Commissioner,Cliff Branan,REP,270029,1,3,27,31,
Grant,U.S. Senate,Evelyn Rogers,REP,270029,0,1,3,4,
Grant,U.S. Senate,Rob Moye,REP,270029,0,0,1,1,
Grant,U.S. Senate,D. Jean Mcbride-Samuels,REP,270029,0,0,0,0,
Grant,U.S. Senate,Jim Inhofe,REP,270029,2,5,51,58,
Grant,U.S. Senate,Erick Paul Wyatt,REP,270029,0,1,4,5,
Grant,U.S. Senate,Andy Craig,REP,270029,0,0,0,0,
Grant,U.S. Senate,T. Shannon,REP,270029,0,2,32,34,
Grant,U.S. Senate,Randy Brogdon,REP,270029,0,0,1,1,
Grant,U.S. Senate,Eric Mccray,REP,270029,0,0,2,2,
Grant,U.S. Senate,Kevin Crow,REP,270029,1,1,1,3,
Grant,U.S. Senate,James Lankford,REP,270029,1,4,25,30,
Grant,U.S. Senate,Jason Weger,REP,270029,0,0,0,0,
Grant,U.S. House,Timothy Ray Murray,REP,270029,0,0,4,4,03
Grant,U.S. House,Robert Hubbard,REP,270029,1,0,7,8,03
Grant,U.S. House,Frank Lucas,REP,270029,1,8,49,58,03
Grant,State House,Roy Chaney,REP,270029,0,1,10,11,38
Grant,State House,Niki Schrader,REP,270029,0,4,5,9,38
Grant,State House,Jason Warren,REP,270029,0,0,6,6,38
Grant,State House,Ralph Meade,REP,270029,0,1,11,12,38
Grant,State House,John Pfeiffer,REP,270029,1,3,13,17,38
Grant,State House,Harold Levalley,REP,270029,1,0,16,17,38
Grant,Superintendent of Public Instruction,John Cox,DEM,270030,2,2,16,20,
Grant,Superintendent of Public Instruction,Jack Jr.,DEM,270030,0,0,4,4,
Grant,Superintendent of Public Instruction,Ivan Holmes,DEM,270030,0,1,6,7,
Grant,Superintendent of Public Instruction,Freda Deskin,DEM,270030,1,5,15,21,
Grant,U.S. Senate,Patrick Michael Hayes,DEM,270030,0,1,8,9,
Grant,U.S. Senate,Jim Rogers,DEM,270030,1,4,19,24,
Grant,U.S. Senate,Connie Johnson,DEM,270030,2,2,15,19,
Grant,Governor,Dax Ewbank,REP,270030,0,5,14,19,
Grant,Governor,Chad Moody,REP,270030,1,6,21,28,
Grant,Governor,Mary Fallin,REP,270030,4,9,83,96,
Grant,Superintendent of Public Instruction,Brian Kelly,REP,270030,2,6,34,42,
Grant,Superintendent of Public Instruction,Janet Costello Barresi,REP,270030,0,1,12,13,
Grant,Superintendent of Public Instruction,Joy Hofmeister,REP,270030,2,12,72,86,
Grant,Insurance Commissioner,Bill Viner,REP,270030,0,8,26,34,
Grant,Insurance Commissioner,John Doak,REP,270030,4,11,88,103,
Grant,Corporation Commissioner,Todd Hiett,REP,270030,3,9,69,81,
Grant,Corporation Commissioner,Cliff Branan,REP,270030,1,10,45,56,
Grant,U.S. Senate,Evelyn Rogers,REP,270030,0,1,5,6,
Grant,U.S. Senate,Rob Moye,REP,270030,0,1,6,7,
Grant,U.S. Senate,D. Jean Mcbride-Samuels,REP,270030,0,2,2,4,
Grant,U.S. Senate,Jim Inhofe,REP,270030,4,12,101,117,
Grant,U.S. Senate,Erick Paul Wyatt,REP,270030,0,3,6,9,
Grant,U.S. Senate,Andy Craig,REP,270030,0,0,3,3,
Grant,U.S. Senate,T. Shannon,REP,270030,2,4,41,47,
Grant,U.S. Senate,Randy Brogdon,REP,270030,0,3,4,7,
Grant,U.S. Senate,Eric Mccray,REP,270030,0,1,3,4,
Grant,U.S. Senate,Kevin Crow,REP,270030,1,0,3,4,
Grant,U.S. Senate,James Lankford,REP,270030,1,12,64,77,
Grant,U.S. Senate,Jason Weger,REP,270030,0,0,2,2,
Grant,U.S. House,Timothy Ray Murray,REP,270030,0,3,5,8,03
Grant,U.S. House,Robert Hubbard,REP,270030,0,2,7,9,03
Grant,U.S. House,Frank Lucas,REP,270030,5,15,109,129,03
Grant,State House,Roy Chaney,REP,270030,0,2,11,13,38
Grant,State House,Niki Schrader,REP,270030,0,9,26,35,38
Grant,State House,Jason Warren,REP,270030,1,1,3,5,38
Grant,State House,Ralph Meade,REP,270030,0,6,41,47,38
Grant,State House,John Pfeiffer,REP,270030,0,3,23,26,38
Grant,State House,Harold Levalley,REP,270030,3,0,17,20,38
Greer,Superintendent of Public Instruction,John Cox,DEM,280101,1,2,33,36,
Greer,Superintendent of Public Instruction,Jack Jr.,DEM,280101,8,11,64,83,
Greer,Superintendent of Public Instruction,Ivan Holmes,DEM,280101,1,2,12,15,
Greer,Superintendent of Public Instruction,Freda Deskin,DEM,280101,0,3,32,35,
Greer,U.S. Senate,Patrick Michael Hayes,DEM,280101,3,2,27,32,
Greer,U.S. Senate,Jim Rogers,DEM,280101,3,8,65,76,
Greer,U.S. Senate,Connie Johnson,DEM,280101,3,3,33,39,
Greer,Governor,Dax Ewbank,REP,280101,0,0,3,3,
Greer,Governor,Chad Moody,REP,280101,0,1,3,4,
Greer,Governor,Mary Fallin,REP,280101,5,6,26,37,
Greer,Superintendent of Public Instruction,Brian Kelly,REP,280101,0,2,5,7,
Greer,Superintendent of Public Instruction,Janet Costello Barresi,REP,280101,1,3,8,12,
Greer,Superintendent of Public Instruction,Joy Hofmeister,REP,280101,4,2,18,24,
Greer,Insurance Commissioner,Bill Viner,REP,280101,0,2,7,9,
Greer,Insurance Commissioner,John Doak,REP,280101,4,5,21,30,
Greer,Corporation Commissioner,Todd Hiett,REP,280101,4,2,17,23,
Greer,Corporation Commissioner,Cliff Branan,REP,280101,1,4,15,20,
Greer,U.S. Senate,Evelyn Rogers,REP,280101,0,1,1,2,
Greer,U.S. Senate,Rob Moye,REP,280101,0,0,0,0,
Greer,U.S. Senate,D. Jean Mcbride-Samuels,REP,280101,0,0,0,0,
Greer,U.S. Senate,Jim Inhofe,REP,280101,5,5,30,40,
Greer,U.S. Senate,Erick Paul Wyatt,REP,280101,0,0,1,1,
Greer,U.S. Senate,Andy Craig,REP,280101,0,0,0,0,
Greer,U.S. Senate,T. Shannon,REP,280101,2,7,15,24,
Greer,U.S. Senate,Randy Brogdon,REP,280101,0,0,0,0,
Greer,U.S. Senate,Eric Mccray,REP,280101,0,0,0,0,
Greer,U.S. Senate,Kevin Crow,REP,280101,0,0,0,0,
Greer,U.S. Senate,James Lankford,REP,280101,3,0,17,20,
Greer,U.S. Senate,Jason Weger,REP,280101,0,0,0,0,
Greer,U.S. House,Timothy Ray Murray,REP,280101,0,0,5,5,03
Greer,U.S. House,Robert Hubbard,REP,280101,0,2,3,5,03
Greer,U.S. House,Frank Lucas,REP,280101,5,5,24,34,03
Greer,Superintendent of Public Instruction,John Cox,DEM,280102,0,2,32,34,
Greer,Superintendent of Public Instruction,Jack Jr.,DEM,280102,0,6,96,102,
Greer,Superintendent of Public Instruction,Ivan Holmes,DEM,280102,0,0,9,9,
Greer,Superintendent of Public Instruction,Freda Deskin,DEM,280102,0,1,33,34,
Greer,U.S. Senate,Patrick Michael Hayes,DEM,280102,0,0,24,24,
Greer,U.S. Senate,Jim Rogers,DEM,280102,0,6,82,88,
Greer,U.S. Senate,Connie Johnson,DEM,280102,0,1,47,48,
Greer,Governor,Dax Ewbank,REP,280102,0,1,5,6,
Greer,Governor,Chad Moody,REP,280102,0,0,2,2,
Greer,Governor,Mary Fallin,REP,280102,0,3,36,39,
Greer,Superintendent of Public Instruction,Brian Kelly,REP,280102,0,3,12,15,
Greer,Superintendent of Public Instruction,Janet Costello Barresi,REP,280102,0,0,10,10,
Greer,Superintendent of Public Instruction,Joy Hofmeister,REP,280102,0,1,21,22,
Greer,Insurance Commissioner,Bill Viner,REP,280102,0,2,5,7,
Greer,Insurance Commissioner,John Doak,REP,280102,0,2,35,37,
Greer,Corporation Commissioner,Todd Hiett,REP,280102,0,2,25,27,
Greer,Corporation Commissioner,Cliff Branan,REP,280102,0,2,16,18,
Greer,U.S. Senate,Evelyn Rogers,REP,280102,0,0,2,2,
Greer,U.S. Senate,Rob Moye,REP,280102,0,1,0,1,
Greer,U.S. Senate,D. Jean Mcbride-Samuels,REP,280102,0,0,0,0,
Greer,U.S. Senate,Jim Inhofe,REP,280102,0,2,40,42,
Greer,U.S. Senate,Erick Paul Wyatt,REP,280102,0,1,1,2,
Greer,U.S. Senate,Andy Craig,REP,280102,0,1,0,1,
Greer,U.S. Senate,T. Shannon,REP,280102,0,0,27,27,
Greer,U.S. Senate,Randy Brogdon,REP,280102,0,1,0,1,
Greer,U.S. Senate,Eric Mccray,REP,280102,0,1,0,1,
Greer,U.S. Senate,Kevin Crow,REP,280102,0,0,0,0,
Greer,U.S. Senate,James Lankford,REP,280102,0,0,15,15,
Greer,U.S. Senate,Jason Weger,REP,280102,0,1,1,2,
Greer,U.S. House,Timothy Ray Murray,REP,280102,0,0,3,3,03
Greer,U.S. House,Robert Hubbard,REP,280102,0,1,4,5,03
Greer,U.S. House,Frank Lucas,REP,280102,0,3,36,39,03
Greer,Superintendent of Public Instruction,John Cox,DEM,280103,0,0,2,2,
Greer,Superintendent of Public Instruction,Jack Jr.,DEM,280103,0,1,2,3,
Greer,Superintendent of Public Instruction,Ivan Holmes,DEM,280103,0,0,0,0,
Greer,Superintendent of Public Instruction,Freda Deskin,DEM,280103,0,0,3,3,
Greer,U.S. Senate,Patrick Michael Hayes,DEM,280103,0,0,1,1,
Greer,U.S. Senate,Jim Rogers,DEM,280103,0,1,4,5,
Greer,U.S. Senate,Connie Johnson,DEM,280103,0,0,2,2,
Greer,Governor,Dax Ewbank,REP,280103,0,0,0,0,
Greer,Governor,Chad Moody,REP,280103,0,1,1,2,
Greer,Governor,Mary Fallin,REP,280103,0,1,1,2,
Greer,Superintendent of Public Instruction,Brian Kelly,REP,280103,0,0,1,1,
Greer,Superintendent of Public Instruction,Janet Costello Barresi,REP,280103,0,1,0,1,
Greer,Superintendent of Public Instruction,Joy Hofmeister,REP,280103,0,1,1,2,
Greer,Insurance Commissioner,Bill Viner,REP,280103,0,0,0,0,
Greer,Insurance Commissioner,John Doak,REP,280103,0,2,2,4,
Greer,Corporation Commissioner,Todd Hiett,REP,280103,0,0,2,2,
Greer,Corporation Commissioner,Cliff Branan,REP,280103,0,1,0,1,
Greer,U.S. Senate,Evelyn Rogers,REP,280103,0,0,1,1,
Greer,U.S. Senate,Rob Moye,REP,280103,0,0,0,0,
Greer,U.S. Senate,D. Jean Mcbride-Samuels,REP,280103,0,1,0,1,
Greer,U.S. Senate,Jim Inhofe,REP,280103,0,1,1,2,
Greer,U.S. Senate,Erick Paul Wyatt,REP,280103,0,0,0,0,
Greer,U.S. Senate,Andy Craig,REP,280103,0,0,0,0,
Greer,U.S. Senate,T. Shannon,REP,280103,0,0,1,1,
Greer,U.S. Senate,Randy Brogdon,REP,280103,0,0,0,0,
Greer,U.S. Senate,Eric Mccray,REP,280103,0,0,0,0,
Greer,U.S. Senate,Kevin Crow,REP,280103,0,1,1,2,
Greer,U.S. Senate,James Lankford,REP,280103,0,1,0,1,
Greer,U.S. Senate,Jason Weger,REP,280103,0,0,0,0,
Greer,U.S. House,Timothy Ray Murray,REP,280103,0,1,1,2,03
Greer,U.S. House,Robert Hubbard,REP,280103,0,0,0,0,03
Greer,U.S. House,Frank Lucas,REP,280103,0,1,1,2,03
Greer,Superintendent of Public Instruction,John Cox,DEM,280105,0,0,12,12,
Greer,Superintendent of Public Instruction,Jack Jr.,DEM,280105,1,0,18,19,
Greer,Superintendent of Public Instruction,Ivan Holmes,DEM,280105,0,0,3,3,
Greer,Superintendent of Public Instruction,Freda Deskin,DEM,280105,0,2,15,17,
Greer,U.S. Senate,Patrick Michael Hayes,DEM,280105,0,0,14,14,
Greer,U.S. Senate,Jim Rogers,DEM,280105,1,0,21,22,
Greer,U.S. Senate,Connie Johnson,DEM,280105,0,3,8,11,
Greer,Governor,Dax Ewbank,REP,280105,0,0,0,0,
Greer,Governor,Chad Moody,REP,280105,0,0,0,0,
Greer,Governor,Mary Fallin,REP,280105,0,1,6,7,
Greer,Superintendent of Public Instruction,Brian Kelly,REP,280105,0,0,2,2,
Greer,Superintendent of Public Instruction,Janet Costello Barresi,REP,280105,0,0,1,1,
Greer,Superintendent of Public Instruction,Joy Hofmeister,REP,280105,0,1,3,4,
Greer,Insurance Commissioner,Bill Viner,REP,280105,0,0,2,2,
Greer,Insurance Commissioner,John Doak,REP,280105,0,1,2,3,
Greer,Corporation Commissioner,Todd Hiett,REP,280105,0,1,2,3,
Greer,Corporation Commissioner,Cliff Branan,REP,280105,0,0,2,2,
Greer,U.S. Senate,Evelyn Rogers,REP,280105,0,0,0,0,
Greer,U.S. Senate,Rob Moye,REP,280105,0,0,0,0,
Greer,U.S. Senate,D. Jean Mcbride-Samuels,REP,280105,0,0,0,0,
Greer,U.S. Senate,Jim Inhofe,REP,280105,0,1,5,6,
Greer,U.S. Senate,Erick Paul Wyatt,REP,280105,0,0,0,0,
Greer,U.S. Senate,Andy Craig,REP,280105,0,0,0,0,
Greer,U.S. Senate,T. Shannon,REP,280105,0,0,3,3,
Greer,U.S. Senate,Randy Brogdon,REP,280105,0,0,0,0,
Greer,U.S. Senate,Eric Mccray,REP,280105,0,0,0,0,
Greer,U.S. Senate,Kevin Crow,REP,280105,0,0,0,0,
Greer,U.S. Senate,James Lankford,REP,280105,0,1,3,4,
Greer,U.S. Senate,Jason Weger,REP,280105,0,0,0,0,
Greer,U.S. House,Timothy Ray Murray,REP,280105,0,0,0,0,03
Greer,U.S. House,Robert Hubbard,REP,280105,0,0,0,0,03
Greer,U.S. House,Frank Lucas,REP,280105,0,1,5,6,03
Greer,Superintendent of Public Instruction,John Cox,DEM,280106,0,1,12,13,
Greer,Superintendent of Public Instruction,Jack Jr.,DEM,280106,0,0,13,13,
Greer,Superintendent of Public Instruction,Ivan Holmes,DEM,280106,0,0,0,0,
Greer,Superintendent of Public Instruction,Freda Deskin,DEM,280106,0,0,6,6,
Greer,U.S. Senate,Patrick Michael Hayes,DEM,280106,0,0,9,9,
Greer,U.S. Senate,Jim Rogers,DEM,280106,0,0,9,9,
Greer,U.S. Senate,Connie Johnson,DEM,280106,0,1,7,8,
Greer,Governor,Dax Ewbank,REP,280106,0,0,0,0,
Greer,Governor,Chad Moody,REP,280106,0,0,2,2,
Greer,Governor,Mary Fallin,REP,280106,2,1,5,8,
Greer,Superintendent of Public Instruction,Brian Kelly,REP,280106,2,0,3,5,
Greer,Superintendent of Public Instruction,Janet Costello Barresi,REP,280106,0,0,3,3,
Greer,Superintendent of Public Instruction,Joy Hofmeister,REP,280106,0,1,2,3,
Greer,Insurance Commissioner,Bill Viner,REP,280106,0,1,2,3,
Greer,Insurance Commissioner,John Doak,REP,280106,2,0,5,7,
Greer,Corporation Commissioner,Todd Hiett,REP,280106,0,1,3,4,
Greer,Corporation Commissioner,Cliff Branan,REP,280106,2,0,5,7,
Greer,U.S. Senate,Evelyn Rogers,REP,280106,0,0,0,0,
Greer,U.S. Senate,Rob Moye,REP,280106,0,0,0,0,
Greer,U.S. Senate,D. Jean Mcbride-Samuels,REP,280106,0,0,0,0,
Greer,U.S. Senate,Jim Inhofe,REP,280106,2,1,7,10,
Greer,U.S. Senate,Erick Paul Wyatt,REP,280106,0,0,1,1,
Greer,U.S. Senate,Andy Craig,REP,280106,0,0,0,0,
Greer,U.S. Senate,T. Shannon,REP,280106,0,1,5,6,
Greer,U.S. Senate,Randy Brogdon,REP,280106,0,0,0,0,
Greer,U.S. Senate,Eric Mccray,REP,280106,0,0,0,0,
Greer,U.S. Senate,Kevin Crow,REP,280106,0,0,0,0,
Greer,U.S. Senate,James Lankford,REP,280106,2,0,3,5,
Greer,U.S. Senate,Jason Weger,REP,280106,0,0,0,0,
Greer,U.S. House,Timothy Ray Murray,REP,280106,0,0,0,0,03
Greer,U.S. House,Robert Hubbard,REP,280106,0,0,2,2,03
Greer,U.S. House,Frank Lucas,REP,280106,2,1,6,9,03
Greer,Superintendent of Public Instruction,John Cox,DEM,280202,0,0,42,42,
Greer,Superintendent of Public Instruction,Jack Jr.,DEM,280202,0,2,22,24,
Greer,Superintendent of Public Instruction,Ivan Holmes,DEM,280202,0,0,12,12,
Greer,Superintendent of Public Instruction,Freda Deskin,DEM,280202,0,0,32,32,
Greer,U.S. Senate,Patrick Michael Hayes,DEM,280202,0,0,17,17,
Greer,U.S. Senate,Jim Rogers,DEM,280202,0,0,41,41,
Greer,U.S. Senate,Connie Johnson,DEM,280202,0,2,40,42,
Greer,Governor,Dax Ewbank,REP,280202,0,0,4,4,
Greer,Governor,Chad Moody,REP,280202,0,0,12,12,
Greer,Governor,Mary Fallin,REP,280202,0,0,37,37,
Greer,Superintendent of Public Instruction,Brian Kelly,REP,280202,0,0,18,18,
Greer,Superintendent of Public Instruction,Janet Costello Barresi,REP,280202,0,0,8,8,
Greer,Superintendent of Public Instruction,Joy Hofmeister,REP,280202,0,0,26,26,
Greer,Insurance Commissioner,Bill Viner,REP,280202,0,0,12,12,
Greer,Insurance Commissioner,John Doak,REP,280202,0,0,33,33,
Greer,Corporation Commissioner,Todd Hiett,REP,280202,0,0,21,21,
Greer,Corporation Commissioner,Cliff Branan,REP,280202,0,0,26,26,
Greer,U.S. Senate,Evelyn Rogers,REP,280202,0,0,0,0,
Greer,U.S. Senate,Rob Moye,REP,280202,0,0,1,1,
Greer,U.S. Senate,D. Jean Mcbride-Samuels,REP,280202,0,0,2,2,
Greer,U.S. Senate,Jim Inhofe,REP,280202,0,0,47,47,
Greer,U.S. Senate,Erick Paul Wyatt,REP,280202,0,0,2,2,
Greer,U.S. Senate,Andy Craig,REP,280202,0,0,0,0,
Greer,U.S. Senate,T. Shannon,REP,280202,0,0,13,13,
Greer,U.S. Senate,Randy Brogdon,REP,280202,0,0,0,0,
Greer,U.S. Senate,Eric Mccray,REP,280202,0,0,0,0,
Greer,U.S. Senate,Kevin Crow,REP,280202,0,0,0,0,
Greer,U.S. Senate,James Lankford,REP,280202,0,0,37,37,
Greer,U.S. Senate,Jason Weger,REP,280202,0,0,2,2,
Greer,U.S. House,Timothy Ray Murray,REP,280202,0,0,3,3,03
Greer,U.S. House,Robert Hubbard,REP,280202,0,0,3,3,03
Greer,U.S. House,Frank Lucas,REP,280202,0,0,47,47,03
Greer,Superintendent of Public Instruction,John Cox,DEM,280203,2,1,17,20,
Greer,Superintendent of Public Instruction,Jack Jr.,DEM,280203,0,3,12,15,
Greer,Superintendent of Public Instruction,Ivan Holmes,DEM,280203,3,0,3,6,
Greer,Superintendent of Public Instruction,Freda Deskin,DEM,280203,0,0,12,12,
Greer,U.S. Senate,Patrick Michael Hayes,DEM,280203,1,0,10,11,
Greer,U.S. Senate,Jim Rogers,DEM,280203,2,4,14,20,
Greer,U.S. Senate,Connie Johnson,DEM,280203,2,0,15,17,
Greer,Governor,Dax Ewbank,REP,280203,0,0,1,1,
Greer,Governor,Chad Moody,REP,280203,0,0,2,2,
Greer,Governor,Mary Fallin,REP,280203,1,1,15,17,
Greer,Superintendent of Public Instruction,Brian Kelly,REP,280203,0,0,4,4,
Greer,Superintendent of Public Instruction,Janet Costello Barresi,REP,280203,0,0,4,4,
Greer,Superintendent of Public Instruction,Joy Hofmeister,REP,280203,1,1,9,11,
Greer,Insurance Commissioner,Bill Viner,REP,280203,0,0,3,3,
Greer,Insurance Commissioner,John Doak,REP,280203,1,1,14,16,
Greer,Corporation Commissioner,Todd Hiett,REP,280203,0,1,8,9,
Greer,Corporation Commissioner,Cliff Branan,REP,280203,1,0,8,9,
Greer,U.S. Senate,Evelyn Rogers,REP,280203,0,0,1,1,
Greer,U.S. Senate,Rob Moye,REP,280203,0,0,2,2,
Greer,U.S. Senate,D. Jean Mcbride-Samuels,REP,280203,0,0,1,1,
Greer,U.S. Senate,Jim Inhofe,REP,280203,1,1,14,16,
Greer,U.S. Senate,Erick Paul Wyatt,REP,280203,0,0,0,0,
Greer,U.S. Senate,Andy Craig,REP,280203,0,0,0,0,
Greer,U.S. Senate,T. Shannon,REP,280203,0,0,6,6,
Greer,U.S. Senate,Randy Brogdon,REP,280203,0,0,0,0,
Greer,U.S. Senate,Eric Mccray,REP,280203,0,0,0,0,
Greer,U.S. Senate,Kevin Crow,REP,280203,0,0,0,0,
Greer,U.S. Senate,James Lankford,REP,280203,1,1,12,14,
Greer,U.S. Senate,Jason Weger,REP,280203,0,0,0,0,
Greer,U.S. House,Timothy Ray Murray,REP,280203,0,0,3,3,03
Greer,U.S. House,Robert Hubbard,REP,280203,0,0,2,2,03
Greer,U.S. House,Frank Lucas,REP,280203,1,1,13,15,03
Greer,Superintendent of Public Instruction,John Cox,DEM,280302,0,1,5,6,
Greer,Superintendent of Public Instruction,Jack Jr.,DEM,280302,0,2,11,13,
Greer,Superintendent of Public Instruction,Ivan Holmes,DEM,280302,0,0,2,2,
Greer,Superintendent of Public Instruction,Freda Deskin,DEM,280302,0,0,3,3,
Greer,U.S. Senate,Patrick Michael Hayes,DEM,280302,0,0,8,8,
Greer,U.S. Senate,Jim Rogers,DEM,280302,0,2,6,8,
Greer,U.S. Senate,Connie Johnson,DEM,280302,0,1,5,6,
Greer,Governor,Dax Ewbank,REP,280302,0,0,0,0,
Greer,Governor,Chad Moody,REP,280302,0,0,0,0,
Greer,Governor,Mary Fallin,REP,280302,0,0,2,2,
Greer,Superintendent of Public Instruction,Brian Kelly,REP,280302,0,0,0,0,
Greer,Superintendent of Public Instruction,Janet Costello Barresi,REP,280302,0,0,0,0,
Greer,Superintendent of Public Instruction,Joy Hofmeister,REP,280302,0,0,2,2,
Greer,Insurance Commissioner,Bill Viner,REP,280302,0,0,1,1,
Greer,Insurance Commissioner,John Doak,REP,280302,0,0,1,1,
Greer,Corporation Commissioner,Todd Hiett,REP,280302,0,0,1,1,
Greer,Corporation Commissioner,Cliff Branan,REP,280302,0,0,1,1,
Greer,U.S. Senate,Evelyn Rogers,REP,280302,0,0,0,0,
Greer,U.S. Senate,Rob Moye,REP,280302,0,0,0,0,
Greer,U.S. Senate,D. Jean Mcbride-Samuels,REP,280302,0,0,0,0,
Greer,U.S. Senate,Jim Inhofe,REP,280302,0,0,1,1,
Greer,U.S. Senate,Erick Paul Wyatt,REP,280302,0,0,1,1,
Greer,U.S. Senate,Andy Craig,REP,280302,0,0,0,0,
Greer,U.S. Senate,T. Shannon,REP,280302,0,0,1,1,
Greer,U.S. Senate,Randy Brogdon,REP,280302,0,0,0,0,
Greer,U.S. Senate,Eric Mccray,REP,280302,0,0,0,0,
Greer,U.S. Senate,Kevin Crow,REP,280302,0,0,0,0,
Greer,U.S. Senate,James Lankford,REP,280302,0,0,1,1,
Greer,U.S. Senate,Jason Weger,REP,280302,0,0,0,0,
Greer,U.S. House,Timothy Ray Murray,REP,280302,0,0,0,0,03
Greer,U.S. House,Robert Hubbard,REP,280302,0,0,0,0,03
Greer,U.S. House,Frank Lucas,REP,280302,0,0,2,2,03
Harmon,Superintendent of Public Instruction,John Cox,DEM,290101,0,0,7,7,
Harmon,Superintendent of Public Instruction,Jack Jr.,DEM,290101,0,0,7,7,
Harmon,Superintendent of Public Instruction,Ivan Holmes,DEM,290101,0,0,0,0,
Harmon,Superintendent of Public Instruction,Freda Deskin,DEM,290101,0,0,3,3,
Harmon,U.S. Senate,Patrick Michael Hayes,DEM,290101,0,0,6,6,
Harmon,U.S. Senate,Jim Rogers,DEM,290101,0,0,7,7,
Harmon,U.S. Senate,Connie Johnson,DEM,290101,0,0,4,4,
Harmon,Governor,Dax Ewbank,REP,290101,0,0,0,0,
Harmon,Governor,Chad Moody,REP,290101,0,0,0,0,
Harmon,Governor,Mary Fallin,REP,290101,0,0,0,0,
Harmon,Superintendent of Public Instruction,Brian Kelly,REP,290101,0,0,0,0,
Harmon,Superintendent of Public Instruction,Janet Costello Barresi,REP,290101,0,0,0,0,
Harmon,Superintendent of Public Instruction,Joy Hofmeister,REP,290101,0,0,0,0,
Harmon,Insurance Commissioner,Bill Viner,REP,290101,0,0,0,0,
Harmon,Insurance Commissioner,John Doak,REP,290101,0,0,0,0,
Harmon,Corporation Commissioner,Todd Hiett,REP,290101,0,0,0,0,
Harmon,Corporation Commissioner,Cliff Branan,REP,290101,0,0,0,0,
Harmon,U.S. Senate,Evelyn Rogers,REP,290101,0,0,0,0,
Harmon,U.S. Senate,Rob Moye,REP,290101,0,0,0,0,
Harmon,U.S. Senate,D. Jean Mcbride-Samuels,REP,290101,0,0,0,0,
Harmon,U.S. Senate,Jim Inhofe,REP,290101,0,0,0,0,
Harmon,U.S. Senate,Erick Paul Wyatt,REP,290101,0,0,0,0,
Harmon,U.S. Senate,Andy Craig,REP,290101,0,0,0,0,
Harmon,U.S. Senate,T. Shannon,REP,290101,0,0,0,0,
Harmon,U.S. Senate,Randy Brogdon,REP,290101,0,0,0,0,
Harmon,U.S. Senate,Eric Mccray,REP,290101,0,0,0,0,
Harmon,U.S. Senate,Kevin Crow,REP,290101,0,0,0,0,
Harmon,U.S. Senate,James Lankford,REP,290101,0,0,0,0,
Harmon,U.S. Senate,Jason Weger,REP,290101,0,0,0,0,
Harmon,U.S. House,Timothy Ray Murray,REP,290101,0,0,0,0,03
Harmon,U.S. House,Robert Hubbard,REP,290101,0,0,0,0,03
Harmon,U.S. House,Frank Lucas,REP,290101,0,0,0,0,03
Harmon,Superintendent of Public Instruction,John Cox,DEM,290102,0,3,72,75,
Harmon,Superintendent of Public Instruction,Jack Jr.,DEM,290102,2,0,10,12,
Harmon,Superintendent of Public Instruction,Ivan Holmes,DEM,290102,0,0,5,5,
Harmon,Superintendent of Public Instruction,Freda Deskin,DEM,290102,0,2,21,23,
Harmon,U.S. Senate,Patrick Michael Hayes,DEM,290102,0,3,14,17,
Harmon,U.S. Senate,Jim Rogers,DEM,290102,2,2,56,60,
Harmon,U.S. Senate,Connie Johnson,DEM,290102,0,0,27,27,
Harmon,Governor,Dax Ewbank,REP,290102,0,0,2,2,
Harmon,Governor,Chad Moody,REP,290102,0,0,3,3,
Harmon,Governor,Mary Fallin,REP,290102,0,1,27,28,
Harmon,Superintendent of Public Instruction,Brian Kelly,REP,290102,0,0,3,3,
Harmon,Superintendent of Public Instruction,Janet Costello Barresi,REP,290102,0,0,2,2,
Harmon,Superintendent of Public Instruction,Joy Hofmeister,REP,290102,0,1,28,29,
Harmon,Insurance Commissioner,Bill Viner,REP,290102,0,0,4,4,
Harmon,Insurance Commissioner,John Doak,REP,290102,0,1,26,27,
Harmon,Corporation Commissioner,Todd Hiett,REP,290102,0,1,12,13,
Harmon,Corporation Commissioner,Cliff Branan,REP,290102,0,0,19,19,
Harmon,U.S. Senate,Evelyn Rogers,REP,290102,0,0,0,0,
Harmon,U.S. Senate,Rob Moye,REP,290102,0,0,0,0,
Harmon,U.S. Senate,D. Jean Mcbride-Samuels,REP,290102,0,0,0,0,
Harmon,U.S. Senate,Jim Inhofe,REP,290102,0,1,31,32,
Harmon,U.S. Senate,Erick Paul Wyatt,REP,290102,0,0,2,2,
Harmon,U.S. Senate,Andy Craig,REP,290102,0,0,0,0,
Harmon,U.S. Senate,T. Shannon,REP,290102,0,1,10,11,
Harmon,U.S. Senate,Randy Brogdon,REP,290102,0,0,0,0,
Harmon,U.S. Senate,Eric Mccray,REP,290102,0,0,0,0,
Harmon,U.S. Senate,Kevin Crow,REP,290102,0,0,0,0,
Harmon,U.S. Senate,James Lankford,REP,290102,0,0,23,23,
Harmon,U.S. Senate,Jason Weger,REP,290102,0,0,0,0,
Harmon,U.S. House,Timothy Ray Murray,REP,290102,0,0,1,1,03
Harmon,U.S. House,Robert Hubbard,REP,290102,0,0,0,0,03
Harmon,U.S. House,Frank Lucas,REP,290102,0,1,31,32,03
Harmon,Superintendent of Public Instruction,John Cox,DEM,290201,0,0,26,26,
Harmon,Superintendent of Public Instruction,Jack Jr.,DEM,290201,1,0,5,6,
Harmon,Superintendent of Public Instruction,Ivan Holmes,DEM,290201,0,0,4,4,
Harmon,Superintendent of Public Instruction,Freda Deskin,DEM,290201,0,3,11,14,
Harmon,U.S. Senate,Patrick Michael Hayes,DEM,290201,0,0,8,8,
Harmon,U.S. Senate,Jim Rogers,DEM,290201,1,3,20,24,
Harmon,U.S. Senate,Connie Johnson,DEM,290201,0,0,17,17,
Harmon,Governor,Dax Ewbank,REP,290201,0,0,0,0,
Harmon,Governor,Chad Moody,REP,290201,0,1,0,1,
Harmon,Governor,Mary Fallin,REP,290201,0,4,18,22,
Harmon,Superintendent of Public Instruction,Brian Kelly,REP,290201,0,1,1,2,
Harmon,Superintendent of Public Instruction,Janet Costello Barresi,REP,290201,0,0,0,0,
Harmon,Superintendent of Public Instruction,Joy Hofmeister,REP,290201,0,5,16,21,
Harmon,Insurance Commissioner,Bill Viner,REP,290201,0,1,4,5,
Harmon,Insurance Commissioner,John Doak,REP,290201,0,4,9,13,
Harmon,Corporation Commissioner,Todd Hiett,REP,290201,0,3,8,11,
Harmon,Corporation Commissioner,Cliff Branan,REP,290201,0,0,7,7,
Harmon,U.S. Senate,Evelyn Rogers,REP,290201,0,0,0,0,
Harmon,U.S. Senate,Rob Moye,REP,290201,0,0,0,0,
Harmon,U.S. Senate,D. Jean Mcbride-Samuels,REP,290201,0,0,0,0,
Harmon,U.S. Senate,Jim Inhofe,REP,290201,0,5,16,21,
Harmon,U.S. Senate,Erick Paul Wyatt,REP,290201,0,1,0,1,
Harmon,U.S. Senate,Andy Craig,REP,290201,0,0,0,0,
Harmon,U.S. Senate,T. Shannon,REP,290201,0,4,5,9,
Harmon,U.S. Senate,Randy Brogdon,REP,290201,0,0,0,0,
Harmon,U.S. Senate,Eric Mccray,REP,290201,0,0,0,0,
Harmon,U.S. Senate,Kevin Crow,REP,290201,0,0,0,0,
Harmon,U.S. Senate,James Lankford,REP,290201,0,2,12,14,
Harmon,U.S. Senate,Jason Weger,REP,290201,0,0,0,0,
Harmon,U.S. House,Timothy Ray Murray,REP,290201,0,0,0,0,03
Harmon,U.S. House,Robert Hubbard,REP,290201,0,0,1,1,03
Harmon,U.S. House,Frank Lucas,REP,290201,0,5,15,20,03
Harmon,Superintendent of Public Instruction,John Cox,DEM,290203,0,2,2,4,
Harmon,Superintendent of Public Instruction,Jack Jr.,DEM,290203,0,0,0,0,
Harmon,Superintendent of Public Instruction,Ivan Holmes,DEM,290203,0,0,0,0,
Harmon,Superintendent of Public Instruction,Freda Deskin,DEM,290203,0,1,0,1,
Harmon,U.S. Senate,Patrick Michael Hayes,DEM,290203,0,1,0,1,
Harmon,U.S. Senate,Jim Rogers,DEM,290203,0,1,2,3,
Harmon,U.S. Senate,Connie Johnson,DEM,290203,0,1,0,1,
Harmon,Governor,Dax Ewbank,REP,290203,0,0,0,0,
Harmon,Governor,Chad Moody,REP,290203,0,0,1,1,
Harmon,Governor,Mary Fallin,REP,290203,0,0,7,7,
Harmon,Superintendent of Public Instruction,Brian Kelly,REP,290203,0,0,2,2,
Harmon,Superintendent of Public Instruction,Janet Costello Barresi,REP,290203,0,0,0,0,
Harmon,Superintendent of Public Instruction,Joy Hofmeister,REP,290203,0,0,5,5,
Harmon,Insurance Commissioner,Bill Viner,REP,290203,0,0,2,2,
Harmon,Insurance Commissioner,John Doak,REP,290203,0,0,5,5,
Harmon,Corporation Commissioner,Todd Hiett,REP,290203,0,0,1,1,
Harmon,Corporation Commissioner,Cliff Branan,REP,290203,0,0,7,7,
Harmon,U.S. Senate,Evelyn Rogers,REP,290203,0,0,0,0,
Harmon,U.S. Senate,Rob Moye,REP,290203,0,0,0,0,
Harmon,U.S. Senate,D. Jean Mcbride-Samuels,REP,290203,0,0,0,0,
Harmon,U.S. Senate,Jim Inhofe,REP,290203,0,0,7,7,
Harmon,U.S. Senate,Erick Paul Wyatt,REP,290203,0,0,0,0,
Harmon,U.S. Senate,Andy Craig,REP,290203,0,0,0,0,
Harmon,U.S. Senate,T. Shannon,REP,290203,0,0,2,2,
Harmon,U.S. Senate,Randy Brogdon,REP,290203,0,0,0,0,
Harmon,U.S. Senate,Eric Mccray,REP,290203,0,0,0,0,
Harmon,U.S. Senate,Kevin Crow,REP,290203,0,0,0,0,
Harmon,U.S. Senate,James Lankford,REP,290203,0,0,6,6,
Harmon,U.S. Senate,Jason Weger,REP,290203,0,0,0,0,
Harmon,U.S. House,Timothy Ray Murray,REP,290203,0,0,1,1,03
Harmon,U.S. House,Robert Hubbard,REP,290203,0,0,1,1,03
Harmon,U.S. House,Frank Lucas,REP,290203,0,0,6,6,03
Harmon,Superintendent of Public Instruction,John Cox,DEM,290204,0,1,3,4,
Harmon,Superintendent of Public Instruction,Jack Jr.,DEM,290204,0,0,0,0,
Harmon,Superintendent of Public Instruction,Ivan Holmes,DEM,290204,0,0,0,0,
Harmon,Superintendent of Public Instruction,Freda Deskin,DEM,290204,0,0,6,6,
Harmon,U.S. Senate,Patrick Michael Hayes,DEM,290204,0,0,0,0,
Harmon,U.S. Senate,Jim Rogers,DEM,290204,0,1,4,5,
Harmon,U.S. Senate,Connie Johnson,DEM,290204,0,0,3,3,
Harmon,Governor,Dax Ewbank,REP,290204,0,0,0,0,
Harmon,Governor,Chad Moody,REP,290204,0,0,0,0,
Harmon,Governor,Mary Fallin,REP,290204,0,0,4,4,
Harmon,Superintendent of Public Instruction,Brian Kelly,REP,290204,0,0,0,0,
Harmon,Superintendent of Public Instruction,Janet Costello Barresi,REP,290204,0,0,0,0,
Harmon,Superintendent of Public Instruction,Joy Hofmeister,REP,290204,0,0,4,4,
Harmon,Insurance Commissioner,Bill Viner,REP,290204,0,0,0,0,
Harmon,Insurance Commissioner,John Doak,REP,290204,0,0,4,4,
Harmon,Corporation Commissioner,Todd Hiett,REP,290204,0,0,2,2,
Harmon,Corporation Commissioner,Cliff Branan,REP,290204,0,0,2,2,
Harmon,U.S. Senate,Evelyn Rogers,REP,290204,0,0,0,0,
Harmon,U.S. Senate,Rob Moye,REP,290204,0,0,0,0,
Harmon,U.S. Senate,D. Jean Mcbride-Samuels,REP,290204,0,0,0,0,
Harmon,U.S. Senate,Jim Inhofe,REP,290204,0,0,4,4,
Harmon,U.S. Senate,Erick Paul Wyatt,REP,290204,0,0,0,0,
Harmon,U.S. Senate,Andy Craig,REP,290204,0,0,0,0,
Harmon,U.S. Senate,T. Shannon,REP,290204,0,0,2,2,
Harmon,U.S. Senate,Randy Brogdon,REP,290204,0,0,0,0,
Harmon,U.S. Senate,Eric Mccray,REP,290204,0,0,0,0,
Harmon,U.S. Senate,Kevin Crow,REP,290204,0,0,0,0,
Harmon,U.S. Senate,James Lankford,REP,290204,0,0,2,2,
Harmon,U.S. Senate,Jason Weger,REP,290204,0,0,0,0,
Harmon,U.S. House,Timothy Ray Murray,REP,290204,0,0,0,0,03
Harmon,U.S. House,Robert Hubbard,REP,290204,0,0,0,0,03
Harmon,U.S. House,Frank Lucas,REP,290204,0,0,4,4,03
Harmon,Superintendent of Public Instruction,John Cox,DEM,290301,0,0,28,28,
Harmon,Superintendent of Public Instruction,Jack Jr.,DEM,290301,1,0,7,8,
Harmon,Superintendent of Public Instruction,Ivan Holmes,DEM,290301,0,0,0,0,
Harmon,Superintendent of Public Instruction,Freda Deskin,DEM,290301,0,1,15,16,
Harmon,U.S. Senate,Patrick Michael Hayes,DEM,290301,0,0,14,14,
Harmon,U.S. Senate,Jim Rogers,DEM,290301,0,0,11,11,
Harmon,U.S. Senate,Connie Johnson,DEM,290301,1,1,22,24,
Harmon,Governor,Dax Ewbank,REP,290301,0,0,0,0,
Harmon,Governor,Chad Moody,REP,290301,0,0,3,3,
Harmon,Governor,Mary Fallin,REP,290301,2,3,9,14,
Harmon,Superintendent of Public Instruction,Brian Kelly,REP,290301,0,1,0,1,
Harmon,Superintendent of Public Instruction,Janet Costello Barresi,REP,290301,0,0,2,2,
Harmon,Superintendent of Public Instruction,Joy Hofmeister,REP,290301,2,1,10,13,
Harmon,Insurance Commissioner,Bill Viner,REP,290301,0,1,1,2,
Harmon,Insurance Commissioner,John Doak,REP,290301,2,1,8,11,
Harmon,Corporation Commissioner,Todd Hiett,REP,290301,0,0,7,7,
Harmon,Corporation Commissioner,Cliff Branan,REP,290301,2,2,4,8,
Harmon,U.S. Senate,Evelyn Rogers,REP,290301,0,0,0,0,
Harmon,U.S. Senate,Rob Moye,REP,290301,0,0,1,1,
Harmon,U.S. Senate,D. Jean Mcbride-Samuels,REP,290301,0,0,0,0,
Harmon,U.S. Senate,Jim Inhofe,REP,290301,2,1,9,12,
Harmon,U.S. Senate,Erick Paul Wyatt,REP,290301,0,2,1,3,
Harmon,U.S. Senate,Andy Craig,REP,290301,0,0,0,0,
Harmon,U.S. Senate,T. Shannon,REP,290301,2,2,2,6,
Harmon,U.S. Senate,Randy Brogdon,REP,290301,0,0,1,1,
Harmon,U.S. Senate,Eric Mccray,REP,290301,0,0,0,0,
Harmon,U.S. Senate,Kevin Crow,REP,290301,0,0,0,0,
Harmon,U.S. Senate,James Lankford,REP,290301,0,1,8,9,
Harmon,U.S. Senate,Jason Weger,REP,290301,0,0,0,0,
Harmon,U.S. House,Timothy Ray Murray,REP,290301,0,0,0,0,03
Harmon,U.S. House,Robert Hubbard,REP,290301,0,0,0,0,03
Harmon,U.S. House,Frank Lucas,REP,290301,2,3,11,16,03
Harmon,Superintendent of Public Instruction,John Cox,DEM,290302,0,0,20,20,
Harmon,Superintendent of Public Instruction,Jack Jr.,DEM,290302,0,0,6,6,
Harmon,Superintendent of Public Instruction,Ivan Holmes,DEM,290302,0,0,0,0,
Harmon,Superintendent of Public Instruction,Freda Deskin,DEM,290302,0,0,14,14,
Harmon,U.S. Senate,Patrick Michael Hayes,DEM,290302,0,0,6,6,
Harmon,U.S. Senate,Jim Rogers,DEM,290302,0,0,18,18,
Harmon,U.S. Senate,Connie Johnson,DEM,290302,0,0,12,12,
Harmon,Governor,Dax Ewbank,REP,290302,0,0,1,1,
Harmon,Governor,Chad Moody,REP,290302,0,0,5,5,
Harmon,Governor,Mary Fallin,REP,290302,0,0,13,13,
Harmon,Superintendent of Public Instruction,Brian Kelly,REP,290302,0,0,1,1,
Harmon,Superintendent of Public Instruction,Janet Costello Barresi,REP,290302,0,0,1,1,
Harmon,Superintendent of Public Instruction,Joy Hofmeister,REP,290302,0,0,17,17,
Harmon,Insurance Commissioner,Bill Viner,REP,290302,0,0,4,4,
Harmon,Insurance Commissioner,John Doak,REP,290302,0,0,15,15,
Harmon,Corporation Commissioner,Todd Hiett,REP,290302,0,0,15,15,
Harmon,Corporation Commissioner,Cliff Branan,REP,290302,0,0,4,4,
Harmon,U.S. Senate,Evelyn Rogers,REP,290302,0,0,0,0,
Harmon,U.S. Senate,Rob Moye,REP,290302,0,0,0,0,
Harmon,U.S. Senate,D. Jean Mcbride-Samuels,REP,290302,0,0,0,0,
Harmon,U.S. Senate,Jim Inhofe,REP,290302,0,0,19,19,
Harmon,U.S. Senate,Erick Paul Wyatt,REP,290302,0,0,0,0,
Harmon,U.S. Senate,Andy Craig,REP,290302,0,0,0,0,
Harmon,U.S. Senate,T. Shannon,REP,290302,0,0,9,9,
Harmon,U.S. Senate,Randy Brogdon,REP,290302,0,0,0,0,
Harmon,U.S. Senate,Eric Mccray,REP,290302,0,0,0,0,
Harmon,U.S. Senate,Kevin Crow,REP,290302,0,0,0,0,
Harmon,U.S. Senate,James Lankford,REP,290302,0,0,9,9,
Harmon,U.S. Senate,Jason Weger,REP,290302,0,0,0,0,
Harmon,U.S. House,Timothy Ray Murray,REP,290302,0,0,0,0,03
Harmon,U.S. House,Robert Hubbard,REP,290302,0,0,2,2,03
Harmon,U.S. House,Frank Lucas,REP,290302,0,0,17,17,03
Harper,Superintendent of Public Instruction,John Cox,DEM,300201,2,0,31,33,
Harper,Superintendent of Public Instruction,Jack Jr.,DEM,300201,1,1,7,9,
Harper,Superintendent of Public Instruction,Ivan Holmes,DEM,300201,0,0,6,6,
Harper,Superintendent of Public Instruction,Freda Deskin,DEM,300201,0,0,18,18,
Harper,U.S. Senate,Patrick Michael Hayes,DEM,300201,3,0,20,23,
Harper,U.S. Senate,Jim Rogers,DEM,300201,0,1,19,20,
Harper,U.S. Senate,Connie Johnson,DEM,300201,0,0,18,18,
Harper,Governor,Dax Ewbank,REP,300201,2,1,17,20,
Harper,Governor,Chad Moody,REP,300201,0,1,33,34,
Harper,Governor,Mary Fallin,REP,300201,3,5,117,125,
Harper,Superintendent of Public Instruction,Brian Kelly,REP,300201,4,1,36,41,
Harper,Superintendent of Public Instruction,Janet Costello Barresi,REP,300201,0,1,17,18,
Harper,Superintendent of Public Instruction,Joy Hofmeister,REP,300201,1,5,114,120,
Harper,Insurance Commissioner,Bill Viner,REP,300201,1,1,30,32,
Harper,Insurance Commissioner,John Doak,REP,300201,3,5,127,135,
Harper,Corporation Commissioner,Todd Hiett,REP,300201,3,5,100,108,
Harper,Corporation Commissioner,Cliff Branan,REP,300201,2,2,61,65,
Harper,U.S. Senate,Evelyn Rogers,REP,300201,1,0,3,4,
Harper,U.S. Senate,Rob Moye,REP,300201,0,0,1,1,
Harper,U.S. Senate,D. Jean Mcbride-Samuels,REP,300201,0,0,2,2,
Harper,U.S. Senate,Jim Inhofe,REP,300201,4,7,155,166,
Harper,U.S. Senate,Erick Paul Wyatt,REP,300201,0,0,5,5,
Harper,U.S. Senate,Andy Craig,REP,300201,1,0,2,3,
Harper,U.S. Senate,T. Shannon,REP,300201,1,2,59,62,
Harper,U.S. Senate,Randy Brogdon,REP,300201,0,0,5,5,
Harper,U.S. Senate,Eric Mccray,REP,300201,0,0,2,2,
Harper,U.S. Senate,Kevin Crow,REP,300201,0,0,1,1,
Harper,U.S. Senate,James Lankford,REP,300201,3,4,99,106,
Harper,U.S. Senate,Jason Weger,REP,300201,0,0,0,0,
Harper,U.S. House,Timothy Ray Murray,REP,300201,0,0,4,4,03
Harper,U.S. House,Robert Hubbard,REP,300201,0,0,22,22,03
Harper,U.S. House,Frank Lucas,REP,300201,5,7,142,154,03
Harper,State House,Casey Murdock,REP,300201,2,4,62,68,61
Harper,State House,David Elder,REP,300201,3,1,58,62,61
Harper,State House,Steve Moore,REP,300201,0,1,12,13,61
Harper,State House,Kenny Bob Tapp,REP,300201,0,1,31,32,61
Harper,State House,Larry Swager,REP,300201,0,0,2,2,61
Harper,Superintendent of Public Instruction,John Cox,DEM,300203,0,0,5,5,
Harper,Superintendent of Public Instruction,Jack Jr.,DEM,300203,0,1,1,2,
Harper,Superintendent of Public Instruction,Ivan Holmes,DEM,300203,0,0,1,1,
Harper,Superintendent of Public Instruction,Freda Deskin,DEM,300203,0,0,7,7,
Harper,U.S. Senate,Patrick Michael Hayes,DEM,300203,0,0,6,6,
Harper,U.S. Senate,Jim Rogers,DEM,300203,0,1,3,4,
Harper,U.S. Senate,Connie Johnson,DEM,300203,0,0,4,4,
Harper,Governor,Dax Ewbank,REP,300203,0,1,2,3,
Harper,Governor,Chad Moody,REP,300203,0,0,4,4,
Harper,Governor,Mary Fallin,REP,300203,0,0,25,25,
Harper,Superintendent of Public Instruction,Brian Kelly,REP,300203,0,1,7,8,
Harper,Superintendent of Public Instruction,Janet Costello Barresi,REP,300203,0,0,8,8,
Harper,Superintendent of Public Instruction,Joy Hofmeister,REP,300203,0,0,14,14,
Harper,Insurance Commissioner,Bill Viner,REP,300203,0,1,6,7,
Harper,Insurance Commissioner,John Doak,REP,300203,0,0,21,21,
Harper,Corporation Commissioner,Todd Hiett,REP,300203,0,1,13,14,
Harper,Corporation Commissioner,Cliff Branan,REP,300203,0,0,16,16,
Harper,U.S. Senate,Evelyn Rogers,REP,300203,0,0,2,2,
Harper,U.S. Senate,Rob Moye,REP,300203,0,0,0,0,
Harper,U.S. Senate,D. Jean Mcbride-Samuels,REP,300203,0,0,0,0,
Harper,U.S. Senate,Jim Inhofe,REP,300203,0,0,26,26,
Harper,U.S. Senate,Erick Paul Wyatt,REP,300203,0,1,2,3,
Harper,U.S. Senate,Andy Craig,REP,300203,0,0,1,1,
Harper,U.S. Senate,T. Shannon,REP,300203,0,1,15,16,
Harper,U.S. Senate,Randy Brogdon,REP,300203,0,0,0,0,
Harper,U.S. Senate,Eric Mccray,REP,300203,0,0,1,1,
Harper,U.S. Senate,Kevin Crow,REP,300203,0,0,0,0,
Harper,U.S. Senate,James Lankford,REP,300203,0,0,15,15,
Harper,U.S. Senate,Jason Weger,REP,300203,0,0,0,0,
Harper,U.S. House,Timothy Ray Murray,REP,300203,0,1,1,2,03
Harper,U.S. House,Robert Hubbard,REP,300203,0,0,4,4,03
Harper,U.S. House,Frank Lucas,REP,300203,0,0,26,26,03
Harper,State House,Casey Murdock,REP,300203,0,1,10,11,61
Harper,State House,David Elder,REP,300203,0,0,15,15,61
Harper,State House,Steve Moore,REP,300203,0,0,1,1,61
Harper,State House,Kenny Bob Tapp,REP,300203,0,0,5,5,61
Harper,State House,Larry Swager,REP,300203,0,0,1,1,61
Harper,Superintendent of Public Instruction,John Cox,DEM,300301,0,0,23,23,
Harper,Superintendent of Public Instruction,Jack Jr.,DEM,300301,0,0,5,5,
Harper,Superintendent of Public Instruction,Ivan Holmes,DEM,300301,0,0,4,4,
Harper,Superintendent of Public Instruction,Freda Deskin,DEM,300301,0,0,15,15,
Harper,U.S. Senate,Patrick Michael Hayes,DEM,300301,0,0,14,14,
Harper,U.S. Senate,Jim Rogers,DEM,300301,0,0,12,12,
Harper,U.S. Senate,Connie Johnson,DEM,300301,0,0,19,19,
Harper,Governor,Dax Ewbank,REP,300301,0,5,12,17,
Harper,Governor,Chad Moody,REP,300301,0,1,11,12,
Harper,Governor,Mary Fallin,REP,300301,2,3,63,68,
Harper,Superintendent of Public Instruction,Brian Kelly,REP,300301,2,0,19,21,
Harper,Superintendent of Public Instruction,Janet Costello Barresi,REP,300301,0,0,9,9,
Harper,Superintendent of Public Instruction,Joy Hofmeister,REP,300301,1,9,54,64,
Harper,Insurance Commissioner,Bill Viner,REP,300301,1,1,14,16,
Harper,Insurance Commissioner,John Doak,REP,300301,2,8,64,74,
Harper,Corporation Commissioner,Todd Hiett,REP,300301,1,6,47,54,
Harper,Corporation Commissioner,Cliff Branan,REP,300301,1,3,30,34,
Harper,U.S. Senate,Evelyn Rogers,REP,300301,0,0,1,1,
Harper,U.S. Senate,Rob Moye,REP,300301,0,0,0,0,
Harper,U.S. Senate,D. Jean Mcbride-Samuels,REP,300301,0,0,1,1,
Harper,U.S. Senate,Jim Inhofe,REP,300301,3,7,77,87,
Harper,U.S. Senate,Erick Paul Wyatt,REP,300301,0,2,6,8,
Harper,U.S. Senate,Andy Craig,REP,300301,0,1,0,1,
Harper,U.S. Senate,T. Shannon,REP,300301,1,3,31,35,
Harper,U.S. Senate,Randy Brogdon,REP,300301,0,1,5,6,
Harper,U.S. Senate,Eric Mccray,REP,300301,0,0,2,2,
Harper,U.S. Senate,Kevin Crow,REP,300301,0,0,1,1,
Harper,U.S. Senate,James Lankford,REP,300301,2,4,46,52,
Harper,U.S. Senate,Jason Weger,REP,300301,0,0,1,1,
Harper,U.S. House,Timothy Ray Murray,REP,300301,0,1,7,8,03
Harper,U.S. House,Robert Hubbard,REP,300301,0,0,15,15,03
Harper,U.S. House,Frank Lucas,REP,300301,3,8,64,75,03
Harper,State House,Casey Murdock,REP,300301,0,4,22,26,61
Harper,State House,David Elder,REP,300301,2,0,4,6,61
Harper,State House,Steve Moore,REP,300301,1,0,34,35,61
Harper,State House,Kenny Bob Tapp,REP,300301,0,3,24,27,61
Harper,State House,Larry Swager,REP,300301,0,2,3,5,61
Harper,Superintendent of Public Instruction,John Cox,DEM,300302,0,0,2,2,
Harper,Superintendent of Public Instruction,Jack Jr.,DEM,300302,0,0,1,1,
Harper,Superintendent of Public Instruction,Ivan Holmes,DEM,300302,0,0,0,0,
Harper,Superintendent of Public Instruction,Freda Deskin,DEM,300302,0,0,3,3,
Harper,U.S. Senate,Patrick Michael Hayes,DEM,300302,0,0,1,1,
Harper,U.S. Senate,Jim Rogers,DEM,300302,0,0,2,2,
Harper,U.S. Senate,Connie Johnson,DEM,300302,0,0,3,3,
Harper,Governor,Dax Ewbank,REP,300302,0,2,3,5,
Harper,Governor,Chad Moody,REP,300302,0,0,1,1,
Harper,Governor,Mary Fallin,REP,300302,0,0,23,23,
Harper,Superintendent of Public Instruction,Brian Kelly,REP,300302,0,0,3,3,
Harper,Superintendent of Public Instruction,Janet Costello Barresi,REP,300302,0,0,8,8,
Harper,Superintendent of Public Instruction,Joy Hofmeister,REP,300302,0,2,16,18,
Harper,Insurance Commissioner,Bill Viner,REP,300302,0,0,5,5,
Harper,Insurance Commissioner,John Doak,REP,300302,0,2,21,23,
Harper,Corporation Commissioner,Todd Hiett,REP,300302,0,1,20,21,
Harper,Corporation Commissioner,Cliff Branan,REP,300302,0,1,7,8,
Harper,U.S. Senate,Evelyn Rogers,REP,300302,0,0,1,1,
Harper,U.S. Senate,Rob Moye,REP,300302,0,0,0,0,
Harper,U.S. Senate,D. Jean Mcbride-Samuels,REP,300302,0,0,0,0,
Harper,U.S. Senate,Jim Inhofe,REP,300302,0,2,27,29,
Harper,U.S. Senate,Erick Paul Wyatt,REP,300302,0,0,0,0,
Harper,U.S. Senate,Andy Craig,REP,300302,0,0,0,0,
Harper,U.S. Senate,T. Shannon,REP,300302,0,0,9,9,
Harper,U.S. Senate,Randy Brogdon,REP,300302,0,0,1,1,
Harper,U.S. Senate,Eric Mccray,REP,300302,0,0,0,0,
Harper,U.S. Senate,Kevin Crow,REP,300302,0,0,0,0,
Harper,U.S. Senate,James Lankford,REP,300302,0,2,18,20,
Harper,U.S. Senate,Jason Weger,REP,300302,0,0,0,0,
Harper,U.S. House,Timothy Ray Murray,REP,300302,0,0,0,0,03
Harper,U.S. House,Robert Hubbard,REP,300302,0,0,0,0,03
Harper,U.S. House,Frank Lucas,REP,300302,0,2,27,29,03
Harper,State House,Casey Murdock,REP,300302,0,0,15,15,61
Harper,State House,David Elder,REP,300302,0,0,6,6,61
Harper,State House,Steve Moore,REP,300302,0,2,1,3,61
Harper,State House,Kenny Bob Tapp,REP,300302,0,0,6,6,61
Harper,State House,Larry Swager,REP,300302,0,0,0,0,61
Harper,Superintendent of Public Instruction,John Cox,DEM,300303,0,0,9,9,
Harper,Superintendent of Public Instruction,Jack Jr.,DEM,300303,0,0,2,2,
Harper,Superintendent of Public Instruction,Ivan Holmes,DEM,300303,0,0,1,1,
Harper,Superintendent of Public Instruction,Freda Deskin,DEM,300303,0,0,3,3,
Harper,U.S. Senate,Patrick Michael Hayes,DEM,300303,0,0,2,2,
Harper,U.S. Senate,Jim Rogers,DEM,300303,0,0,6,6,
Harper,U.S. Senate,Connie Johnson,DEM,300303,0,0,7,7,
Harper,Governor,Dax Ewbank,REP,300303,1,0,3,4,
Harper,Governor,Chad Moody,REP,300303,1,1,8,10,
Harper,Governor,Mary Fallin,REP,300303,0,1,25,26,
Harper,Superintendent of Public Instruction,Brian Kelly,REP,300303,1,0,10,11,
Harper,Superintendent of Public Instruction,Janet Costello Barresi,REP,300303,0,1,4,5,
Harper,Superintendent of Public Instruction,Joy Hofmeister,REP,300303,1,1,20,22,
Harper,Insurance Commissioner,Bill Viner,REP,300303,1,0,10,11,
Harper,Insurance Commissioner,John Doak,REP,300303,1,2,24,27,
Harper,Corporation Commissioner,Todd Hiett,REP,300303,0,0,16,16,
Harper,Corporation Commissioner,Cliff Branan,REP,300303,2,1,18,21,
Harper,U.S. Senate,Evelyn Rogers,REP,300303,0,0,1,1,
Harper,U.S. Senate,Rob Moye,REP,300303,2,0,0,2,
Harper,U.S. Senate,D. Jean Mcbride-Samuels,REP,300303,0,0,0,0,
Harper,U.S. Senate,Jim Inhofe,REP,300303,0,1,33,34,
Harper,U.S. Senate,Erick Paul Wyatt,REP,300303,0,1,2,3,
Harper,U.S. Senate,Andy Craig,REP,300303,0,0,1,1,
Harper,U.S. Senate,T. Shannon,REP,300303,0,0,10,10,
Harper,U.S. Senate,Randy Brogdon,REP,300303,0,0,0,0,
Harper,U.S. Senate,Eric Mccray,REP,300303,0,0,0,0,
Harper,U.S. Senate,Kevin Crow,REP,300303,0,1,0,1,
Harper,U.S. Senate,James Lankford,REP,300303,2,1,25,28,
Harper,U.S. Senate,Jason Weger,REP,300303,0,0,0,0,
Harper,U.S. House,Timothy Ray Murray,REP,300303,1,0,0,1,03
Harper,U.S. House,Robert Hubbard,REP,300303,0,0,5,5,03
Harper,U.S. House,Frank Lucas,REP,300303,1,2,31,34,03
Harper,State House,Casey Murdock,REP,300303,0,1,8,9,61
Harper,State House,David Elder,REP,300303,0,0,3,3,61
Harper,State House,Steve Moore,REP,300303,2,0,13,15,61
Harper,State House,Kenny Bob Tapp,REP,300303,0,1,10,11,61
Harper,State House,Larry Swager,REP,300303,0,0,1,1,61
Harper,Superintendent of Public Instruction,John Cox,DEM,300402,0,0,17,17,
Harper,Superintendent of Public Instruction,Jack Jr.,DEM,300402,0,1,1,2,
Harper,Superintendent of Public Instruction,Ivan Holmes,DEM,300402,0,0,4,4,
Harper,Superintendent of Public Instruction,Freda Deskin,DEM,300402,1,0,9,10,
Harper,U.S. Senate,Patrick Michael Hayes,DEM,300402,0,0,15,15,
Harper,U.S. Senate,Jim Rogers,DEM,300402,0,1,7,8,
Harper,U.S. Senate,Connie Johnson,DEM,300402,1,0,8,9,
Harper,Governor,Dax Ewbank,REP,300402,3,0,13,16,
Harper,Governor,Chad Moody,REP,300402,1,1,18,20,
Harper,Governor,Mary Fallin,REP,300402,3,8,65,76,
Harper,Superintendent of Public Instruction,Brian Kelly,REP,300402,1,2,29,32,
Harper,Superintendent of Public Instruction,Janet Costello Barresi,REP,300402,1,1,4,6,
Harper,Superintendent of Public Instruction,Joy Hofmeister,REP,300402,5,6,60,71,
Harper,Insurance Commissioner,Bill Viner,REP,300402,2,3,19,24,
Harper,Insurance Commissioner,John Doak,REP,300402,4,6,73,83,
Harper,Corporation Commissioner,Todd Hiett,REP,300402,3,6,42,51,
Harper,Corporation Commissioner,Cliff Branan,REP,300402,2,3,47,52,
Harper,U.S. Senate,Evelyn Rogers,REP,300402,0,0,5,5,
Harper,U.S. Senate,Rob Moye,REP,300402,0,1,1,2,
Harper,U.S. Senate,D. Jean Mcbride-Samuels,REP,300402,0,0,1,1,
Harper,U.S. Senate,Jim Inhofe,REP,300402,5,8,85,98,
Harper,U.S. Senate,Erick Paul Wyatt,REP,300402,2,0,3,5,
Harper,U.S. Senate,Andy Craig,REP,300402,0,0,1,1,
Harper,U.S. Senate,T. Shannon,REP,300402,2,3,35,40,
Harper,U.S. Senate,Randy Brogdon,REP,300402,0,0,0,0,
Harper,U.S. Senate,Eric Mccray,REP,300402,0,0,3,3,
Harper,U.S. Senate,Kevin Crow,REP,300402,0,0,1,1,
Harper,U.S. Senate,James Lankford,REP,300402,5,6,56,67,
Harper,U.S. Senate,Jason Weger,REP,300402,0,0,0,0,
Harper,U.S. House,Timothy Ray Murray,REP,300402,1,0,3,4,03
Harper,U.S. House,Robert Hubbard,REP,300402,3,1,18,22,03
Harper,U.S. House,Frank Lucas,REP,300402,3,8,76,87,03
Harper,State House,Casey Murdock,REP,300402,2,2,25,29,61
Harper,State House,David Elder,REP,300402,0,0,5,5,61
Harper,State House,Steve Moore,REP,300402,3,6,36,45,61
Harper,State House,Kenny Bob Tapp,REP,300402,2,0,29,31,61
Harper,State House,Larry Swager,REP,300402,0,1,4,5,61
Haskell,Superintendent of Public Instruction,John Cox,DEM,310007,0,3,57,60,
Haskell,Superintendent of Public Instruction,Jack Jr.,DEM,310007,0,0,10,10,
Haskell,Superintendent of Public Instruction,Ivan Holmes,DEM,310007,0,0,6,6,
Haskell,Superintendent of Public Instruction,Freda Deskin,DEM,310007,0,0,10,10,
Haskell,U.S. Senate,Patrick Michael Hayes,DEM,310007,0,0,20,20,
Haskell,U.S. Senate,Jim Rogers,DEM,310007,0,1,46,47,
Haskell,U.S. Senate,Connie Johnson,DEM,310007,0,1,11,12,
Haskell,U.S. House,Earl Everett,DEM,310007,0,1,46,47,02
Haskell,U.S. House,Joshua Harris-Till,DEM,310007,0,1,25,26,02
Haskell,Governor,Dax Ewbank,REP,310007,0,0,2,2,
Haskell,Governor,Chad Moody,REP,310007,0,0,5,5,
Haskell,Governor,Mary Fallin,REP,310007,0,1,8,9,
Haskell,Superintendent of Public Instruction,Brian Kelly,REP,310007,0,0,7,7,
Haskell,Superintendent of Public Instruction,Janet Costello Barresi,REP,310007,0,0,0,0,
Haskell,Superintendent of Public Instruction,Joy Hofmeister,REP,310007,0,1,9,10,
Haskell,Insurance Commissioner,Bill Viner,REP,310007,0,1,5,6,
Haskell,Insurance Commissioner,John Doak,REP,310007,0,0,8,8,
Haskell,Corporation Commissioner,Todd Hiett,REP,310007,0,0,8,8,
Haskell,Corporation Commissioner,Cliff Branan,REP,310007,0,1,4,5,
Haskell,U.S. Senate,Evelyn Rogers,REP,310007,0,0,1,1,
Haskell,U.S. Senate,Rob Moye,REP,310007,0,0,1,1,
Haskell,U.S. Senate,D. Jean Mcbride-Samuels,REP,310007,0,0,0,0,
Haskell,U.S. Senate,Jim Inhofe,REP,310007,0,1,13,14,
Haskell,U.S. Senate,Erick Paul Wyatt,REP,310007,0,0,2,2,
Haskell,U.S. Senate,Andy Craig,REP,310007,0,0,0,0,
Haskell,U.S. Senate,T. Shannon,REP,310007,0,1,9,10,
Haskell,U.S. Senate,Randy Brogdon,REP,310007,0,0,4,4,
Haskell,U.S. Senate,Eric Mccray,REP,310007,0,0,0,0,
Haskell,U.S. Senate,Kevin Crow,REP,310007,0,0,1,1,
Haskell,U.S. Senate,James Lankford,REP,310007,0,0,3,3,
Haskell,U.S. Senate,Jason Weger,REP,310007,0,0,0,0,
Haskell,U.S. House,Darrel Robertson,REP,310007,0,0,5,5,02
Haskell,U.S. House,Markwayne Mullin,REP,310007,0,1,9,10,02
Haskell,Superintendent of Public Instruction,John Cox,DEM,310009,0,1,21,22,
Haskell,Superintendent of Public Instruction,Jack Jr.,DEM,310009,0,0,2,2,
Haskell,Superintendent of Public Instruction,Ivan Holmes,DEM,310009,0,0,2,2,
Haskell,Superintendent of Public Instruction,Freda Deskin,DEM,310009,0,1,4,5,
Haskell,U.S. Senate,Patrick Michael Hayes,DEM,310009,0,2,3,5,
Haskell,U.S. Senate,Jim Rogers,DEM,310009,0,0,16,16,
Haskell,U.S. Senate,Connie Johnson,DEM,310009,0,0,8,8,
Haskell,U.S. House,Earl Everett,DEM,310009,0,1,16,17,02
Haskell,U.S. House,Joshua Harris-Till,DEM,310009,0,1,10,11,02
Haskell,Governor,Dax Ewbank,REP,310009,0,0,0,0,
Haskell,Governor,Chad Moody,REP,310009,0,0,2,2,
Haskell,Governor,Mary Fallin,REP,310009,0,0,4,4,
Haskell,Superintendent of Public Instruction,Brian Kelly,REP,310009,0,0,6,6,
Haskell,Superintendent of Public Instruction,Janet Costello Barresi,REP,310009,0,0,0,0,
Haskell,Superintendent of Public Instruction,Joy Hofmeister,REP,310009,0,0,0,0,
Haskell,Insurance Commissioner,Bill Viner,REP,310009,0,0,2,2,
Haskell,Insurance Commissioner,John Doak,REP,310009,0,0,4,4,
Haskell,Corporation Commissioner,Todd Hiett,REP,310009,0,0,3,3,
Haskell,Corporation Commissioner,Cliff Branan,REP,310009,0,0,3,3,
Haskell,U.S. Senate,Evelyn Rogers,REP,310009,0,0,0,0,
Haskell,U.S. Senate,Rob Moye,REP,310009,0,0,0,0,
Haskell,U.S. Senate,D. Jean Mcbride-Samuels,REP,310009,0,0,0,0,
Haskell,U.S. Senate,Jim Inhofe,REP,310009,0,0,5,5,
Haskell,U.S. Senate,Erick Paul Wyatt,REP,310009,0,0,1,1,
Haskell,U.S. Senate,Andy Craig,REP,310009,0,0,0,0,
Haskell,U.S. Senate,T. Shannon,REP,310009,0,0,3,3,
Haskell,U.S. Senate,Randy Brogdon,REP,310009,0,0,0,0,
Haskell,U.S. Senate,Eric Mccray,REP,310009,0,0,0,0,
Haskell,U.S. Senate,Kevin Crow,REP,310009,0,0,0,0,
Haskell,U.S. Senate,James Lankford,REP,310009,0,0,3,3,
Haskell,U.S. Senate,Jason Weger,REP,310009,0,0,0,0,
Haskell,U.S. House,Darrel Robertson,REP,310009,0,0,0,0,02
Haskell,U.S. House,Markwayne Mullin,REP,310009,0,0,6,6,02
Haskell,Superintendent of Public Instruction,John Cox,DEM,310011,0,0,15,15,
Haskell,Superintendent of Public Instruction,Jack Jr.,DEM,310011,0,1,3,4,
Haskell,Superintendent of Public Instruction,Ivan Holmes,DEM,310011,0,0,4,4,
Haskell,Superintendent of Public Instruction,Freda Deskin,DEM,310011,0,0,15,15,
Haskell,U.S. Senate,Patrick Michael Hayes,DEM,310011,0,1,14,15,
Haskell,U.S. Senate,Jim Rogers,DEM,310011,0,0,11,11,
Haskell,U.S. Senate,Connie Johnson,DEM,310011,0,0,11,11,
Haskell,U.S. House,Earl Everett,DEM,310011,0,1,23,24,02
Haskell,U.S. House,Joshua Harris-Till,DEM,310011,0,0,12,12,02
Haskell,Governor,Dax Ewbank,REP,310011,0,2,2,4,
Haskell,Governor,Chad Moody,REP,310011,0,0,1,1,
Haskell,Governor,Mary Fallin,REP,310011,0,2,18,20,
Haskell,Superintendent of Public Instruction,Brian Kelly,REP,310011,0,2,13,15,
Haskell,Superintendent of Public Instruction,Janet Costello Barresi,REP,310011,0,0,0,0,
Haskell,Superintendent of Public Instruction,Joy Hofmeister,REP,310011,0,2,8,10,
Haskell,Insurance Commissioner,Bill Viner,REP,310011,0,2,4,6,
Haskell,Insurance Commissioner,John Doak,REP,310011,0,2,13,15,
Haskell,Corporation Commissioner,Todd Hiett,REP,310011,0,1,12,13,
Haskell,Corporation Commissioner,Cliff Branan,REP,310011,0,2,9,11,
Haskell,U.S. Senate,Evelyn Rogers,REP,310011,0,0,0,0,
Haskell,U.S. Senate,Rob Moye,REP,310011,0,0,0,0,
Haskell,U.S. Senate,D. Jean Mcbride-Samuels,REP,310011,0,0,2,2,
Haskell,U.S. Senate,Jim Inhofe,REP,310011,0,4,15,19,
Haskell,U.S. Senate,Erick Paul Wyatt,REP,310011,0,0,4,4,
Haskell,U.S. Senate,Andy Craig,REP,310011,0,0,0,0,
Haskell,U.S. Senate,T. Shannon,REP,310011,0,2,12,14,
Haskell,U.S. Senate,Randy Brogdon,REP,310011,0,0,0,0,
Haskell,U.S. Senate,Eric Mccray,REP,310011,0,0,0,0,
Haskell,U.S. Senate,Kevin Crow,REP,310011,0,0,0,0,
Haskell,U.S. Senate,James Lankford,REP,310011,0,2,9,11,
Haskell,U.S. Senate,Jason Weger,REP,310011,0,0,1,1,
Haskell,U.S. House,Darrel Robertson,REP,310011,0,0,3,3,02
Haskell,U.S. House,Markwayne Mullin,REP,310011,0,4,19,23,02
Haskell,Superintendent of Public Instruction,John Cox,DEM,310015,0,9,45,54,
Haskell,Superintendent of Public Instruction,Jack Jr.,DEM,310015,1,1,13,15,
Haskell,Superintendent of Public Instruction,Ivan Holmes,DEM,310015,0,1,3,4,
Haskell,Superintendent of Public Instruction,Freda Deskin,DEM,310015,1,4,20,25,
Haskell,U.S. Senate,Patrick Michael Hayes,DEM,310015,0,5,17,22,
Haskell,U.S. Senate,Jim Rogers,DEM,310015,1,7,39,47,
Haskell,U.S. Senate,Connie Johnson,DEM,310015,1,4,20,25,
Haskell,U.S. House,Earl Everett,DEM,310015,1,9,47,57,02
Haskell,U.S. House,Joshua Harris-Till,DEM,310015,1,5,25,31,02
Haskell,Governor,Dax Ewbank,REP,310015,1,0,2,3,
Haskell,Governor,Chad Moody,REP,310015,1,0,0,1,
Haskell,Governor,Mary Fallin,REP,310015,0,2,6,8,
Haskell,Superintendent of Public Instruction,Brian Kelly,REP,310015,1,0,2,3,
Haskell,Superintendent of Public Instruction,Janet Costello Barresi,REP,310015,0,0,0,0,
Haskell,Superintendent of Public Instruction,Joy Hofmeister,REP,310015,1,2,5,8,
Haskell,Insurance Commissioner,Bill Viner,REP,310015,1,0,1,2,
Haskell,Insurance Commissioner,John Doak,REP,310015,1,1,5,7,
Haskell,Corporation Commissioner,Todd Hiett,REP,310015,2,1,4,7,
Haskell,Corporation Commissioner,Cliff Branan,REP,310015,0,1,5,6,
Haskell,U.S. Senate,Evelyn Rogers,REP,310015,0,0,0,0,
Haskell,U.S. Senate,Rob Moye,REP,310015,0,0,1,1,
Haskell,U.S. Senate,D. Jean Mcbride-Samuels,REP,310015,0,0,1,1,
Haskell,U.S. Senate,Jim Inhofe,REP,310015,2,1,7,10,
Haskell,U.S. Senate,Erick Paul Wyatt,REP,310015,0,0,0,0,
Haskell,U.S. Senate,Andy Craig,REP,310015,0,0,0,0,
Haskell,U.S. Senate,T. Shannon,REP,310015,0,0,4,4,
Haskell,U.S. Senate,Randy Brogdon,REP,310015,0,0,1,1,
Haskell,U.S. Senate,Eric Mccray,REP,310015,0,0,0,0,
Haskell,U.S. Senate,Kevin Crow,REP,310015,0,0,0,0,
Haskell,U.S. Senate,James Lankford,REP,310015,2,2,4,8,
Haskell,U.S. Senate,Jason Weger,REP,310015,0,0,0,0,
Haskell,U.S. House,Darrel Robertson,REP,310015,0,0,2,2,02
Haskell,U.S. House,Markwayne Mullin,REP,310015,2,2,7,11,02
Haskell,Superintendent of Public Instruction,John Cox,DEM,310016,0,9,43,52,
Haskell,Superintendent of Public Instruction,Jack Jr.,DEM,310016,2,3,7,12,
Haskell,Superintendent of Public Instruction,Ivan Holmes,DEM,310016,1,2,6,9,
Haskell,Superintendent of Public Instruction,Freda Deskin,DEM,310016,0,7,22,29,
Haskell,U.S. Senate,Patrick Michael Hayes,DEM,310016,0,2,11,13,
Haskell,U.S. Senate,Jim Rogers,DEM,310016,3,10,42,55,
Haskell,U.S. Senate,Connie Johnson,DEM,310016,0,7,23,30,
Haskell,U.S. House,Earl Everett,DEM,310016,3,13,42,58,02
Haskell,U.S. House,Joshua Harris-Till,DEM,310016,0,5,32,37,02
Haskell,Governor,Dax Ewbank,REP,310016,0,0,2,2,
Haskell,Governor,Chad Moody,REP,310016,0,0,4,4,
Haskell,Governor,Mary Fallin,REP,310016,0,2,9,11,
Haskell,Superintendent of Public Instruction,Brian Kelly,REP,310016,0,1,2,3,
Haskell,Superintendent of Public Instruction,Janet Costello Barresi,REP,310016,0,1,0,1,
Haskell,Superintendent of Public Instruction,Joy Hofmeister,REP,310016,0,0,13,13,
Haskell,Insurance Commissioner,Bill Viner,REP,310016,0,1,6,7,
Haskell,Insurance Commissioner,John Doak,REP,310016,0,1,9,10,
Haskell,Corporation Commissioner,Todd Hiett,REP,310016,0,1,11,12,
Haskell,Corporation Commissioner,Cliff Branan,REP,310016,0,1,4,5,
Haskell,U.S. Senate,Evelyn Rogers,REP,310016,0,0,0,0,
Haskell,U.S. Senate,Rob Moye,REP,310016,0,0,2,2,
Haskell,U.S. Senate,D. Jean Mcbride-Samuels,REP,310016,0,0,1,1,
Haskell,U.S. Senate,Jim Inhofe,REP,310016,0,2,12,14,
Haskell,U.S. Senate,Erick Paul Wyatt,REP,310016,0,0,0,0,
Haskell,U.S. Senate,Andy Craig,REP,310016,0,0,0,0,
Haskell,U.S. Senate,T. Shannon,REP,310016,0,1,9,10,
Haskell,U.S. Senate,Randy Brogdon,REP,310016,0,0,0,0,
Haskell,U.S. Senate,Eric Mccray,REP,310016,0,0,0,0,
Haskell,U.S. Senate,Kevin Crow,REP,310016,0,0,0,0,
Haskell,U.S. Senate,James Lankford,REP,310016,0,1,5,6,
Haskell,U.S. Senate,Jason Weger,REP,310016,0,0,1,1,
Haskell,U.S. House,Darrel Robertson,REP,310016,0,0,0,0,02
Haskell,U.S. House,Markwayne Mullin,REP,310016,0,2,15,17,02
Haskell,Superintendent of Public Instruction,John Cox,DEM,310019,2,3,88,93,
Haskell,Superintendent of Public Instruction,Jack Jr.,DEM,310019,0,1,15,16,
Haskell,Superintendent of Public Instruction,Ivan Holmes,DEM,310019,0,1,11,12,
Haskell,Superintendent of Public Instruction,Freda Deskin,DEM,310019,2,1,41,44,
Haskell,U.S. Senate,Patrick Michael Hayes,DEM,310019,1,2,26,29,
Haskell,U.S. Senate,Jim Rogers,DEM,310019,1,4,84,89,
Haskell,U.S. Senate,Connie Johnson,DEM,310019,2,0,37,39,
Haskell,U.S. House,Earl Everett,DEM,310019,1,3,87,91,02
Haskell,U.S. House,Joshua Harris-Till,DEM,310019,3,2,57,62,02
Haskell,Governor,Dax Ewbank,REP,310019,0,0,3,3,
Haskell,Governor,Chad Moody,REP,310019,0,0,6,6,
Haskell,Governor,Mary Fallin,REP,310019,0,2,25,27,
Haskell,Superintendent of Public Instruction,Brian Kelly,REP,310019,0,1,7,8,
Haskell,Superintendent of Public Instruction,Janet Costello Barresi,REP,310019,0,0,4,4,
Haskell,Superintendent of Public Instruction,Joy Hofmeister,REP,310019,0,1,24,25,
Haskell,Insurance Commissioner,Bill Viner,REP,310019,0,0,6,6,
Haskell,Insurance Commissioner,John Doak,REP,310019,0,1,27,28,
Haskell,Corporation Commissioner,Todd Hiett,REP,310019,0,1,23,24,
Haskell,Corporation Commissioner,Cliff Branan,REP,310019,0,1,12,13,
Haskell,U.S. Senate,Evelyn Rogers,REP,310019,0,0,2,2,
Haskell,U.S. Senate,Rob Moye,REP,310019,0,0,2,2,
Haskell,U.S. Senate,D. Jean Mcbride-Samuels,REP,310019,0,0,0,0,
Haskell,U.S. Senate,Jim Inhofe,REP,310019,0,2,29,31,
Haskell,U.S. Senate,Erick Paul Wyatt,REP,310019,0,0,1,1,
Haskell,U.S. Senate,Andy Craig,REP,310019,0,0,1,1,
Haskell,U.S. Senate,T. Shannon,REP,310019,0,1,18,19,
Haskell,U.S. Senate,Randy Brogdon,REP,310019,0,1,1,2,
Haskell,U.S. Senate,Eric Mccray,REP,310019,0,0,0,0,
Haskell,U.S. Senate,Kevin Crow,REP,310019,0,0,1,1,
Haskell,U.S. Senate,James Lankford,REP,310019,0,0,14,14,
Haskell,U.S. Senate,Jason Weger,REP,310019,0,0,0,0,
Haskell,U.S. House,Darrel Robertson,REP,310019,0,0,3,3,02
Haskell,U.S. House,Markwayne Mullin,REP,310019,0,2,32,34,02
Haskell,Superintendent of Public Instruction,John Cox,DEM,310023,1,3,84,88,
Haskell,Superintendent of Public Instruction,Jack Jr.,DEM,310023,1,0,8,9,
Haskell,Superintendent of Public Instruction,Ivan Holmes,DEM,310023,1,0,4,5,
Haskell,Superintendent of Public Instruction,Freda Deskin,DEM,310023,0,1,38,39,
Haskell,U.S. Senate,Patrick Michael Hayes,DEM,310023,2,1,34,37,
Haskell,U.S. Senate,Jim Rogers,DEM,310023,1,1,69,71,
Haskell,U.S. Senate,Connie Johnson,DEM,310023,0,2,28,30,
Haskell,U.S. House,Earl Everett,DEM,310023,1,1,70,72,02
Haskell,U.S. House,Joshua Harris-Till,DEM,310023,1,2,58,61,02
Haskell,Governor,Dax Ewbank,REP,310023,0,0,4,4,
Haskell,Governor,Chad Moody,REP,310023,1,1,5,7,
Haskell,Governor,Mary Fallin,REP,310023,0,3,38,41,
Haskell,Superintendent of Public Instruction,Brian Kelly,REP,310023,0,1,14,15,
Haskell,Superintendent of Public Instruction,Janet Costello Barresi,REP,310023,0,3,8,11,
Haskell,Superintendent of Public Instruction,Joy Hofmeister,REP,310023,1,0,25,26,
Haskell,Insurance Commissioner,Bill Viner,REP,310023,0,0,15,15,
Haskell,Insurance Commissioner,John Doak,REP,310023,1,4,29,34,
Haskell,Corporation Commissioner,Todd Hiett,REP,310023,1,4,28,33,
Haskell,Corporation Commissioner,Cliff Branan,REP,310023,0,0,18,18,
Haskell,U.S. Senate,Evelyn Rogers,REP,310023,1,0,2,3,
Haskell,U.S. Senate,Rob Moye,REP,310023,0,0,2,2,
Haskell,U.S. Senate,D. Jean Mcbride-Samuels,REP,310023,0,0,0,0,
Haskell,U.S. Senate,Jim Inhofe,REP,310023,0,4,41,45,
Haskell,U.S. Senate,Erick Paul Wyatt,REP,310023,0,0,2,2,
Haskell,U.S. Senate,Andy Craig,REP,310023,0,0,1,1,
Haskell,U.S. Senate,T. Shannon,REP,310023,0,4,24,28,
Haskell,U.S. Senate,Randy Brogdon,REP,310023,0,0,1,1,
Haskell,U.S. Senate,Eric Mccray,REP,310023,0,0,0,0,
Haskell,U.S. Senate,Kevin Crow,REP,310023,0,0,0,0,
Haskell,U.S. Senate,James Lankford,REP,310023,1,0,21,22,
Haskell,U.S. Senate,Jason Weger,REP,310023,0,0,0,0,
Haskell,U.S. House,Darrel Robertson,REP,310023,0,0,8,8,02
Haskell,U.S. House,Markwayne Mullin,REP,310023,1,4,39,44,02
Haskell,Superintendent of Public Instruction,John Cox,DEM,310027,2,15,97,114,
Haskell,Superintendent of Public Instruction,Jack Jr.,DEM,310027,0,1,20,21,
Haskell,Superintendent of Public Instruction,Ivan Holmes,DEM,310027,1,5,5,11,
Haskell,Superintendent of Public Instruction,Freda Deskin,DEM,310027,2,6,38,46,
Haskell,U.S. Senate,Patrick Michael Hayes,DEM,310027,1,8,43,52,
Haskell,U.S. Senate,Jim Rogers,DEM,310027,4,11,64,79,
Haskell,U.S. Senate,Connie Johnson,DEM,310027,0,7,44,51,
Haskell,U.S. House,Earl Everett,DEM,310027,4,19,82,105,02
Haskell,U.S. House,Joshua Harris-Till,DEM,310027,2,7,59,68,02
Haskell,Governor,Dax Ewbank,REP,310027,0,0,2,2,
Haskell,Governor,Chad Moody,REP,310027,0,0,4,4,
Haskell,Governor,Mary Fallin,REP,310027,4,5,28,37,
Haskell,Superintendent of Public Instruction,Brian Kelly,REP,310027,2,2,7,11,
Haskell,Superintendent of Public Instruction,Janet Costello Barresi,REP,310027,0,3,3,6,
Haskell,Superintendent of Public Instruction,Joy Hofmeister,REP,310027,2,0,24,26,
Haskell,Insurance Commissioner,Bill Viner,REP,310027,0,0,6,6,
Haskell,Insurance Commissioner,John Doak,REP,310027,4,5,25,34,
Haskell,Corporation Commissioner,Todd Hiett,REP,310027,2,4,20,26,
Haskell,Corporation Commissioner,Cliff Branan,REP,310027,2,1,12,15,
Haskell,U.S. Senate,Evelyn Rogers,REP,310027,0,0,2,2,
Haskell,U.S. Senate,Rob Moye,REP,310027,0,0,1,1,
Haskell,U.S. Senate,D. Jean Mcbride-Samuels,REP,310027,0,0,0,0,
Haskell,U.S. Senate,Jim Inhofe,REP,310027,4,5,29,38,
Haskell,U.S. Senate,Erick Paul Wyatt,REP,310027,0,0,1,1,
Haskell,U.S. Senate,Andy Craig,REP,310027,0,0,0,0,
Haskell,U.S. Senate,T. Shannon,REP,310027,4,2,10,16,
Haskell,U.S. Senate,Randy Brogdon,REP,310027,0,0,1,1,
Haskell,U.S. Senate,Eric Mccray,REP,310027,0,0,0,0,
Haskell,U.S. Senate,Kevin Crow,REP,310027,0,0,0,0,
Haskell,U.S. Senate,James Lankford,REP,310027,0,3,22,25,
Haskell,U.S. Senate,Jason Weger,REP,310027,0,0,0,0,
Haskell,U.S. House,Darrel Robertson,REP,310027,0,0,3,3,02
Haskell,U.S. House,Markwayne Mullin,REP,310027,4,5,30,39,02
Haskell,Superintendent of Public Instruction,John Cox,DEM,310030,2,11,59,72,
Haskell,Superintendent of Public Instruction,Jack Jr.,DEM,310030,0,2,18,20,
Haskell,Superintendent of Public Instruction,Ivan Holmes,DEM,310030,0,1,6,7,
Haskell,Superintendent of Public Instruction,Freda Deskin,DEM,310030,0,4,22,26,
Haskell,U.S. Senate,Patrick Michael Hayes,DEM,310030,2,3,31,36,
Haskell,U.S. Senate,Jim Rogers,DEM,310030,0,11,45,56,
Haskell,U.S. Senate,Connie Johnson,DEM,310030,0,3,29,32,
Haskell,U.S. House,Earl Everett,DEM,310030,2,6,67,75,02
Haskell,U.S. House,Joshua Harris-Till,DEM,310030,0,10,32,42,02
Haskell,Governor,Dax Ewbank,REP,310030,0,0,1,1,
Haskell,Governor,Chad Moody,REP,310030,0,2,3,5,
Haskell,Governor,Mary Fallin,REP,310030,0,5,21,26,
Haskell,Superintendent of Public Instruction,Brian Kelly,REP,310030,0,2,3,5,
Haskell,Superintendent of Public Instruction,Janet Costello Barresi,REP,310030,0,1,5,6,
Haskell,Superintendent of Public Instruction,Joy Hofmeister,REP,310030,0,4,16,20,
Haskell,Insurance Commissioner,Bill Viner,REP,310030,0,1,4,5,
Haskell,Insurance Commissioner,John Doak,REP,310030,0,6,17,23,
Haskell,Corporation Commissioner,Todd Hiett,REP,310030,0,5,6,11,
Haskell,Corporation Commissioner,Cliff Branan,REP,310030,0,2,16,18,
Haskell,U.S. Senate,Evelyn Rogers,REP,310030,0,1,2,3,
Haskell,U.S. Senate,Rob Moye,REP,310030,0,0,0,0,
Haskell,U.S. Senate,D. Jean Mcbride-Samuels,REP,310030,0,0,0,0,
Haskell,U.S. Senate,Jim Inhofe,REP,310030,0,6,23,29,
Haskell,U.S. Senate,Erick Paul Wyatt,REP,310030,0,0,1,1,
Haskell,U.S. Senate,Andy Craig,REP,310030,0,0,0,0,
Haskell,U.S. Senate,T. Shannon,REP,310030,0,3,11,14,
Haskell,U.S. Senate,Randy Brogdon,REP,310030,0,0,0,0,
Haskell,U.S. Senate,Eric Mccray,REP,310030,0,0,0,0,
Haskell,U.S. Senate,Kevin Crow,REP,310030,0,0,0,0,
Haskell,U.S. Senate,James Lankford,REP,310030,0,2,15,17,
Haskell,U.S. Senate,Jason Weger,REP,310030,0,0,0,0,
Haskell,U.S. House,Darrel Robertson,REP,310030,0,1,7,8,02
Haskell,U.S. House,Markwayne Mullin,REP,310030,0,6,18,24,02
Haskell,Superintendent of Public Instruction,John Cox,DEM,310031,3,9,124,136,
Haskell,Superintendent of Public Instruction,Jack Jr.,DEM,310031,0,3,27,30,
Haskell,Superintendent of Public Instruction,Ivan Holmes,DEM,310031,6,0,17,23,
Haskell,Superintendent of Public Instruction,Freda Deskin,DEM,310031,0,3,43,46,
Haskell,U.S. Senate,Patrick Michael Hayes,DEM,310031,1,4,57,62,
Haskell,U.S. Senate,Jim Rogers,DEM,310031,1,7,94,102,
Haskell,U.S. Senate,Connie Johnson,DEM,310031,5,2,52,59,
Haskell,U.S. House,Earl Everett,DEM,310031,3,4,125,132,02
Haskell,U.S. House,Joshua Harris-Till,DEM,310031,6,9,70,85,02
Haskell,Governor,Dax Ewbank,REP,310031,0,0,5,5,
Haskell,Governor,Chad Moody,REP,310031,0,0,4,4,
Haskell,Governor,Mary Fallin,REP,310031,0,2,37,39,
Haskell,Superintendent of Public Instruction,Brian Kelly,REP,310031,0,0,20,20,
Haskell,Superintendent of Public Instruction,Janet Costello Barresi,REP,310031,0,0,9,9,
Haskell,Superintendent of Public Instruction,Joy Hofmeister,REP,310031,0,1,18,19,
Haskell,Insurance Commissioner,Bill Viner,REP,310031,0,0,12,12,
Haskell,Insurance Commissioner,John Doak,REP,310031,0,2,34,36,
Haskell,Corporation Commissioner,Todd Hiett,REP,310031,0,0,23,23,
Haskell,Corporation Commissioner,Cliff Branan,REP,310031,0,1,21,22,
Haskell,U.S. Senate,Evelyn Rogers,REP,310031,0,0,1,1,
Haskell,U.S. Senate,Rob Moye,REP,310031,0,0,0,0,
Haskell,U.S. Senate,D. Jean Mcbride-Samuels,REP,310031,0,0,0,0,
Haskell,U.S. Senate,Jim Inhofe,REP,310031,0,2,44,46,
Haskell,U.S. Senate,Erick Paul Wyatt,REP,310031,0,0,2,2,
Haskell,U.S. Senate,Andy Craig,REP,310031,0,0,1,1,
Haskell,U.S. Senate,T. Shannon,REP,310031,0,1,21,22,
Haskell,U.S. Senate,Randy Brogdon,REP,310031,0,1,6,7,
Haskell,U.S. Senate,Eric Mccray,REP,310031,0,0,1,1,
Haskell,U.S. Senate,Kevin Crow,REP,310031,0,0,1,1,
Haskell,U.S. Senate,James Lankford,REP,310031,0,1,18,19,
Haskell,U.S. Senate,Jason Weger,REP,310031,0,0,0,0,
Haskell,U.S. House,Darrel Robertson,REP,310031,0,0,6,6,02
Haskell,U.S. House,Markwayne Mullin,REP,310031,0,3,42,45,02
Haskell,Superintendent of Public Instruction,John Cox,DEM,310032,1,5,76,82,
Haskell,Superintendent of Public Instruction,Jack Jr.,DEM,310032,0,0,2,2,
Haskell,Superintendent of Public Instruction,Ivan Holmes,DEM,310032,1,1,10,12,
Haskell,Superintendent of Public Instruction,Freda Deskin,DEM,310032,0,2,33,35,
Haskell,U.S. Senate,Patrick Michael Hayes,DEM,310032,1,2,22,25,
Haskell,U.S. Senate,Jim Rogers,DEM,310032,1,4,63,68,
Haskell,U.S. Senate,Connie Johnson,DEM,310032,0,2,30,32,
Haskell,U.S. House,Earl Everett,DEM,310032,2,2,67,71,02
Haskell,U.S. House,Joshua Harris-Till,DEM,310032,0,6,41,47,02
Haskell,Governor,Dax Ewbank,REP,310032,0,0,1,1,
Haskell,Governor,Chad Moody,REP,310032,0,0,5,5,
Haskell,Governor,Mary Fallin,REP,310032,0,1,18,19,
Haskell,Superintendent of Public Instruction,Brian Kelly,REP,310032,0,0,4,4,
Haskell,Superintendent of Public Instruction,Janet Costello Barresi,REP,310032,0,0,5,5,
Haskell,Superintendent of Public Instruction,Joy Hofmeister,REP,310032,0,1,16,17,
Haskell,Insurance Commissioner,Bill Viner,REP,310032,0,0,5,5,
Haskell,Insurance Commissioner,John Doak,REP,310032,0,1,18,19,
Haskell,Corporation Commissioner,Todd Hiett,REP,310032,0,1,14,15,
Haskell,Corporation Commissioner,Cliff Branan,REP,310032,0,0,10,10,
Haskell,U.S. Senate,Evelyn Rogers,REP,310032,0,0,2,2,
Haskell,U.S. Senate,Rob Moye,REP,310032,0,0,0,0,
Haskell,U.S. Senate,D. Jean Mcbride-Samuels,REP,310032,0,0,0,0,
Haskell,U.S. Senate,Jim Inhofe,REP,310032,0,1,21,22,
Haskell,U.S. Senate,Erick Paul Wyatt,REP,310032,0,0,2,2,
Haskell,U.S. Senate,Andy Craig,REP,310032,0,0,0,0,
Haskell,U.S. Senate,T. Shannon,REP,310032,0,0,8,8,
Haskell,U.S. Senate,Randy Brogdon,REP,310032,0,0,1,1,
Haskell,U.S. Senate,Eric Mccray,REP,310032,0,0,1,1,
Haskell,U.S. Senate,Kevin Crow,REP,310032,0,0,1,1,
Haskell,U.S. Senate,James Lankford,REP,310032,0,1,11,12,
Haskell,U.S. Senate,Jason Weger,REP,310032,0,0,3,3,
Haskell,U.S. House,Darrel Robertson,REP,310032,0,0,5,5,02
Haskell,U.S. House,Markwayne Mullin,REP,310032,0,1,20,21,02
Hughes,Superintendent of Public Instruction,John Cox,DEM,320010,0,0,0,0,
Hughes,Superintendent of Public Instruction,Jack Jr.,DEM,320010,0,0,0,0,
Hughes,Superintendent of Public Instruction,Ivan Holmes,DEM,320010,0,0,0,0,
Hughes,Superintendent of Public Instruction,Freda Deskin,DEM,320010,0,0,0,0,
Hughes,U.S. Senate,Patrick Michael Hayes,DEM,320010,0,0,0,0,
Hughes,U.S. Senate,Jim Rogers,DEM,320010,0,0,0,0,
Hughes,U.S. Senate,Connie Johnson,DEM,320010,0,0,0,0,
Hughes,U.S. House,Earl Everett,DEM,320010,0,0,0,0,02
Hughes,U.S. House,Joshua Harris-Till,DEM,320010,0,0,0,0,02
Hughes,Governor,Dax Ewbank,REP,320010,0,0,0,0,
Hughes,Governor,Chad Moody,REP,320010,0,0,0,0,
Hughes,Governor,Mary Fallin,REP,320010,0,0,0,0,
Hughes,Superintendent of Public Instruction,Brian Kelly,REP,320010,0,0,0,0,
Hughes,Superintendent of Public Instruction,Janet Costello Barresi,REP,320010,0,0,0,0,
Hughes,Superintendent of Public Instruction,Joy Hofmeister,REP,320010,0,0,0,0,
Hughes,Insurance Commissioner,Bill Viner,REP,320010,0,0,0,0,
Hughes,Insurance Commissioner,John Doak,REP,320010,0,0,0,0,
Hughes,Corporation Commissioner,Todd Hiett,REP,320010,0,0,0,0,
Hughes,Corporation Commissioner,Cliff Branan,REP,320010,0,0,0,0,
Hughes,U.S. Senate,Evelyn Rogers,REP,320010,0,0,0,0,
Hughes,U.S. Senate,Rob Moye,REP,320010,0,0,0,0,
Hughes,U.S. Senate,D. Jean Mcbride-Samuels,REP,320010,0,0,0,0,
Hughes,U.S. Senate,Jim Inhofe,REP,320010,0,0,0,0,
Hughes,U.S. Senate,Erick Paul Wyatt,REP,320010,0,0,0,0,
Hughes,U.S. Senate,Andy Craig,REP,320010,0,0,0,0,
Hughes,U.S. Senate,T. Shannon,REP,320010,0,0,0,0,
Hughes,U.S. Senate,Randy Brogdon,REP,320010,0,0,0,0,
Hughes,U.S. Senate,Eric Mccray,REP,320010,0,0,0,0,
Hughes,U.S. Senate,Kevin Crow,REP,320010,0,0,0,0,
Hughes,U.S. Senate,James Lankford,REP,320010,0,0,0,0,
Hughes,U.S. Senate,Jason Weger,REP,320010,0,0,0,0,
Hughes,U.S. House,Darrel Robertson,REP,320010,0,0,0,0,02
Hughes,U.S. House,Markwayne Mullin,REP,320010,0,0,0,0,02
Hughes,Superintendent of Public Instruction,John Cox,DEM,320011,2,11,68,81,
Hughes,Superintendent of Public Instruction,Jack Jr.,DEM,320011,1,3,30,34,
Hughes,Superintendent of Public Instruction,Ivan Holmes,DEM,320011,3,2,14,19,
Hughes,Superintendent of Public Instruction,Freda Deskin,DEM,320011,2,6,74,82,
Hughes,U.S. Senate,Patrick Michael Hayes,DEM,320011,1,5,28,34,
Hughes,U.S. Senate,Jim Rogers,DEM,320011,2,10,76,88,
Hughes,U.S. Senate,Connie Johnson,DEM,320011,5,7,69,81,
Hughes,U.S. House,Earl Everett,DEM,320011,3,13,116,132,02
Hughes,U.S. House,Joshua Harris-Till,DEM,320011,4,2,48,54,02
Hughes,Governor,Dax Ewbank,REP,320011,0,4,14,18,
Hughes,Governor,Chad Moody,REP,320011,2,1,10,13,
Hughes,Governor,Mary Fallin,REP,320011,0,4,41,45,
Hughes,Superintendent of Public Instruction,Brian Kelly,REP,320011,0,5,17,22,
Hughes,Superintendent of Public Instruction,Janet Costello Barresi,REP,320011,0,2,14,16,
Hughes,Superintendent of Public Instruction,Joy Hofmeister,REP,320011,2,0,34,36,
Hughes,Insurance Commissioner,Bill Viner,REP,320011,0,3,17,20,
Hughes,Insurance Commissioner,John Doak,REP,320011,2,6,42,50,
Hughes,Corporation Commissioner,Todd Hiett,REP,320011,0,6,34,40,
Hughes,Corporation Commissioner,Cliff Branan,REP,320011,2,3,26,31,
Hughes,U.S. Senate,Evelyn Rogers,REP,320011,0,0,5,5,
Hughes,U.S. Senate,Rob Moye,REP,320011,0,0,5,5,
Hughes,U.S. Senate,D. Jean Mcbride-Samuels,REP,320011,0,0,2,2,
Hughes,U.S. Senate,Jim Inhofe,REP,320011,2,8,46,56,
Hughes,U.S. Senate,Erick Paul Wyatt,REP,320011,0,1,5,6,
Hughes,U.S. Senate,Andy Craig,REP,320011,0,0,0,0,
Hughes,U.S. Senate,T. Shannon,REP,320011,2,0,21,23,
Hughes,U.S. Senate,Randy Brogdon,REP,320011,0,5,10,15,
Hughes,U.S. Senate,Eric Mccray,REP,320011,0,0,0,0,
Hughes,U.S. Senate,Kevin Crow,REP,320011,0,0,0,0,
Hughes,U.S. Senate,James Lankford,REP,320011,0,4,31,35,
Hughes,U.S. Senate,Jason Weger,REP,320011,0,0,3,3,
Hughes,U.S. House,Darrel Robertson,REP,320011,2,5,21,28,02
Hughes,U.S. House,Markwayne Mullin,REP,320011,0,4,43,47,02
Hughes,Superintendent of Public Instruction,John Cox,DEM,320012,4,9,46,59,
Hughes,Superintendent of Public Instruction,Jack Jr.,DEM,320012,2,1,13,16,
Hughes,Superintendent of Public Instruction,Ivan Holmes,DEM,320012,1,0,15,16,
Hughes,Superintendent of Public Instruction,Freda Deskin,DEM,320012,3,6,39,48,
Hughes,U.S. Senate,Patrick Michael Hayes,DEM,320012,2,2,25,29,
Hughes,U.S. Senate,Jim Rogers,DEM,320012,4,5,49,58,
Hughes,U.S. Senate,Connie Johnson,DEM,320012,4,8,37,49,
Hughes,U.S. House,Earl Everett,DEM,320012,9,8,62,79,02
Hughes,U.S. House,Joshua Harris-Till,DEM,320012,1,4,41,46,02
Hughes,Governor,Dax Ewbank,REP,320012,0,1,2,3,
Hughes,Governor,Chad Moody,REP,320012,2,1,5,8,
Hughes,Governor,Mary Fallin,REP,320012,1,2,13,16,
Hughes,Superintendent of Public Instruction,Brian Kelly,REP,320012,3,1,2,6,
Hughes,Superintendent of Public Instruction,Janet Costello Barresi,REP,320012,0,1,6,7,
Hughes,Superintendent of Public Instruction,Joy Hofmeister,REP,320012,0,2,12,14,
Hughes,Insurance Commissioner,Bill Viner,REP,320012,1,0,5,6,
Hughes,Insurance Commissioner,John Doak,REP,320012,2,3,12,17,
Hughes,Corporation Commissioner,Todd Hiett,REP,320012,1,1,3,5,
Hughes,Corporation Commissioner,Cliff Branan,REP,320012,2,2,13,17,
Hughes,U.S. Senate,Evelyn Rogers,REP,320012,1,0,0,1,
Hughes,U.S. Senate,Rob Moye,REP,320012,1,0,0,1,
Hughes,U.S. Senate,D. Jean Mcbride-Samuels,REP,320012,0,0,0,0,
Hughes,U.S. Senate,Jim Inhofe,REP,320012,1,4,18,23,
Hughes,U.S. Senate,Erick Paul Wyatt,REP,320012,0,0,3,3,
Hughes,U.S. Senate,Andy Craig,REP,320012,0,0,0,0,
Hughes,U.S. Senate,T. Shannon,REP,320012,1,0,13,14,
Hughes,U.S. Senate,Randy Brogdon,REP,320012,0,1,0,1,
Hughes,U.S. Senate,Eric Mccray,REP,320012,0,0,0,0,
Hughes,U.S. Senate,Kevin Crow,REP,320012,0,0,0,0,
Hughes,U.S. Senate,James Lankford,REP,320012,1,3,6,10,
Hughes,U.S. Senate,Jason Weger,REP,320012,1,0,1,2,
Hughes,U.S. House,Darrel Robertson,REP,320012,2,1,3,6,02
Hughes,U.S. House,Markwayne Mullin,REP,320012,1,3,14,18,02
Hughes,Superintendent of Public Instruction,John Cox,DEM,320016,0,4,28,32,
Hughes,Superintendent of Public Instruction,Jack Jr.,DEM,320016,0,0,8,8,
Hughes,Superintendent of Public Instruction,Ivan Holmes,DEM,320016,0,0,4,4,
Hughes,Superintendent of Public Instruction,Freda Deskin,DEM,320016,0,3,15,18,
Hughes,U.S. Senate,Patrick Michael Hayes,DEM,320016,0,3,12,15,
Hughes,U.S. Senate,Jim Rogers,DEM,320016,0,3,28,31,
Hughes,U.S. Senate,Connie Johnson,DEM,320016,0,1,14,15,
Hughes,U.S. House,Earl Everett,DEM,320016,0,5,36,41,02
Hughes,U.S. House,Joshua Harris-Till,DEM,320016,0,2,17,19,02
Hughes,Governor,Dax Ewbank,REP,320016,0,1,4,5,
Hughes,Governor,Chad Moody,REP,320016,0,0,3,3,
Hughes,Governor,Mary Fallin,REP,320016,0,0,14,14,
Hughes,Superintendent of Public Instruction,Brian Kelly,REP,320016,0,0,5,5,
Hughes,Superintendent of Public Instruction,Janet Costello Barresi,REP,320016,0,0,2,2,
Hughes,Superintendent of Public Instruction,Joy Hofmeister,REP,320016,0,1,14,15,
Hughes,Insurance Commissioner,Bill Viner,REP,320016,0,0,6,6,
Hughes,Insurance Commissioner,John Doak,REP,320016,0,1,14,15,
Hughes,Corporation Commissioner,Todd Hiett,REP,320016,0,1,11,12,
Hughes,Corporation Commissioner,Cliff Branan,REP,320016,0,0,10,10,
Hughes,U.S. Senate,Evelyn Rogers,REP,320016,0,0,2,2,
Hughes,U.S. Senate,Rob Moye,REP,320016,0,0,0,0,
Hughes,U.S. Senate,D. Jean Mcbride-Samuels,REP,320016,0,0,0,0,
Hughes,U.S. Senate,Jim Inhofe,REP,320016,0,1,18,19,
Hughes,U.S. Senate,Erick Paul Wyatt,REP,320016,0,0,0,0,
Hughes,U.S. Senate,Andy Craig,REP,320016,0,0,0,0,
Hughes,U.S. Senate,T. Shannon,REP,320016,0,0,2,2,
Hughes,U.S. Senate,Randy Brogdon,REP,320016,0,1,3,4,
Hughes,U.S. Senate,Eric Mccray,REP,320016,0,0,0,0,
Hughes,U.S. Senate,Kevin Crow,REP,320016,0,0,0,0,
Hughes,U.S. Senate,James Lankford,REP,320016,0,0,15,15,
Hughes,U.S. Senate,Jason Weger,REP,320016,0,0,1,1,
Hughes,U.S. House,Darrel Robertson,REP,320016,0,0,2,2,02
Hughes,U.S. House,Markwayne Mullin,REP,320016,0,1,19,20,02
Hughes,Superintendent of Public Instruction,John Cox,DEM,320018,0,9,57,66,
Hughes,Superintendent of Public Instruction,Jack Jr.,DEM,320018,0,1,7,8,
Hughes,Superintendent of Public Instruction,Ivan Holmes,DEM,320018,0,1,2,3,
Hughes,Superintendent of Public Instruction,Freda Deskin,DEM,320018,1,0,27,28,
Hughes,U.S. Senate,Patrick Michael Hayes,DEM,320018,1,2,27,30,
Hughes,U.S. Senate,Jim Rogers,DEM,320018,0,6,33,39,
Hughes,U.S. Senate,Connie Johnson,DEM,320018,0,3,26,29,
Hughes,U.S. House,Earl Everett,DEM,320018,0,8,49,57,02
Hughes,U.S. House,Joshua Harris-Till,DEM,320018,1,2,35,38,02
Hughes,Governor,Dax Ewbank,REP,320018,0,0,7,7,
Hughes,Governor,Chad Moody,REP,320018,0,0,3,3,
Hughes,Governor,Mary Fallin,REP,320018,0,2,10,12,
Hughes,Superintendent of Public Instruction,Brian Kelly,REP,320018,0,0,5,5,
Hughes,Superintendent of Public Instruction,Janet Costello Barresi,REP,320018,0,0,1,1,
Hughes,Superintendent of Public Instruction,Joy Hofmeister,REP,320018,0,2,13,15,
Hughes,Insurance Commissioner,Bill Viner,REP,320018,0,0,6,6,
Hughes,Insurance Commissioner,John Doak,REP,320018,0,2,13,15,
Hughes,Corporation Commissioner,Todd Hiett,REP,320018,0,0,16,16,
Hughes,Corporation Commissioner,Cliff Branan,REP,320018,0,2,4,6,
Hughes,U.S. Senate,Evelyn Rogers,REP,320018,0,0,0,0,
Hughes,U.S. Senate,Rob Moye,REP,320018,0,0,3,3,
Hughes,U.S. Senate,D. Jean Mcbride-Samuels,REP,320018,0,0,0,0,
Hughes,U.S. Senate,Jim Inhofe,REP,320018,0,2,14,16,
Hughes,U.S. Senate,Erick Paul Wyatt,REP,320018,0,0,3,3,
Hughes,U.S. Senate,Andy Craig,REP,320018,0,0,0,0,
Hughes,U.S. Senate,T. Shannon,REP,320018,0,2,9,11,
Hughes,U.S. Senate,Randy Brogdon,REP,320018,0,0,4,4,
Hughes,U.S. Senate,Eric Mccray,REP,320018,0,0,0,0,
Hughes,U.S. Senate,Kevin Crow,REP,320018,0,0,1,1,
Hughes,U.S. Senate,James Lankford,REP,320018,0,0,6,6,
Hughes,U.S. Senate,Jason Weger,REP,320018,0,0,0,0,
Hughes,U.S. House,Darrel Robertson,REP,320018,0,0,9,9,02
Hughes,U.S. House,Markwayne Mullin,REP,320018,0,2,10,12,02
Hughes,Superintendent of Public Instruction,John Cox,DEM,320019,1,0,13,14,
Hughes,Superintendent of Public Instruction,Jack Jr.,DEM,320019,0,1,9,10,
Hughes,Superintendent of Public Instruction,Ivan Holmes,DEM,320019,0,0,3,3,
Hughes,Superintendent of Public Instruction,Freda Deskin,DEM,320019,0,0,15,15,
Hughes,U.S. Senate,Patrick Michael Hayes,DEM,320019,0,0,6,6,
Hughes,U.S. Senate,Jim Rogers,DEM,320019,0,0,15,15,
Hughes,U.S. Senate,Connie Johnson,DEM,320019,2,1,17,20,
Hughes,U.S. House,Earl Everett,DEM,320019,1,0,23,24,02
Hughes,U.S. House,Joshua Harris-Till,DEM,320019,0,1,14,15,02
Hughes,Governor,Dax Ewbank,REP,320019,0,0,0,0,
Hughes,Governor,Chad Moody,REP,320019,0,0,1,1,
Hughes,Governor,Mary Fallin,REP,320019,0,0,7,7,
Hughes,Superintendent of Public Instruction,Brian Kelly,REP,320019,0,0,4,4,
Hughes,Superintendent of Public Instruction,Janet Costello Barresi,REP,320019,0,0,1,1,
Hughes,Superintendent of Public Instruction,Joy Hofmeister,REP,320019,0,0,3,3,
Hughes,Insurance Commissioner,Bill Viner,REP,320019,0,0,2,2,
Hughes,Insurance Commissioner,John Doak,REP,320019,0,0,5,5,
Hughes,Corporation Commissioner,Todd Hiett,REP,320019,0,0,2,2,
Hughes,Corporation Commissioner,Cliff Branan,REP,320019,0,0,4,4,
Hughes,U.S. Senate,Evelyn Rogers,REP,320019,0,0,0,0,
Hughes,U.S. Senate,Rob Moye,REP,320019,0,0,0,0,
Hughes,U.S. Senate,D. Jean Mcbride-Samuels,REP,320019,0,0,0,0,
Hughes,U.S. Senate,Jim Inhofe,REP,320019,0,0,6,6,
Hughes,U.S. Senate,Erick Paul Wyatt,REP,320019,0,0,1,1,
Hughes,U.S. Senate,Andy Craig,REP,320019,0,0,0,0,
Hughes,U.S. Senate,T. Shannon,REP,320019,0,0,4,4,
Hughes,U.S. Senate,Randy Brogdon,REP,320019,0,0,1,1,
Hughes,U.S. Senate,Eric Mccray,REP,320019,0,0,1,1,
Hughes,U.S. Senate,Kevin Crow,REP,320019,0,0,0,0,
Hughes,U.S. Senate,James Lankford,REP,320019,0,0,2,2,
Hughes,U.S. Senate,Jason Weger,REP,320019,0,0,0,0,
Hughes,U.S. House,Darrel Robertson,REP,320019,0,0,5,5,02
Hughes,U.S. House,Markwayne Mullin,REP,320019,0,0,3,3,02
Hughes,Superintendent of Public Instruction,John Cox,DEM,320020,0,2,77,79,
Hughes,Superintendent of Public Instruction,Jack Jr.,DEM,320020,0,0,24,24,
Hughes,Superintendent of Public Instruction,Ivan Holmes,DEM,320020,0,0,8,8,
Hughes,Superintendent of Public Instruction,Freda Deskin,DEM,320020,0,2,47,49,
Hughes,U.S. Senate,Patrick Michael Hayes,DEM,320020,0,0,30,30,
Hughes,U.S. Senate,Jim Rogers,DEM,320020,0,3,71,74,
Hughes,U.S. Senate,Connie Johnson,DEM,320020,0,1,46,47,
Hughes,U.S. House,Earl Everett,DEM,320020,0,4,98,102,02
Hughes,U.S. House,Joshua Harris-Till,DEM,320020,0,0,45,45,02
Hughes,Governor,Dax Ewbank,REP,320020,0,0,4,4,
Hughes,Governor,Chad Moody,REP,320020,0,0,7,7,
Hughes,Governor,Mary Fallin,REP,320020,3,1,49,53,
Hughes,Superintendent of Public Instruction,Brian Kelly,REP,320020,0,0,11,11,
Hughes,Superintendent of Public Instruction,Janet Costello Barresi,REP,320020,3,0,8,11,
Hughes,Superintendent of Public Instruction,Joy Hofmeister,REP,320020,0,1,42,43,
Hughes,Insurance Commissioner,Bill Viner,REP,320020,0,0,11,11,
Hughes,Insurance Commissioner,John Doak,REP,320020,3,1,46,50,
Hughes,Corporation Commissioner,Todd Hiett,REP,320020,2,0,28,30,
Hughes,Corporation Commissioner,Cliff Branan,REP,320020,1,1,32,34,
Hughes,U.S. Senate,Evelyn Rogers,REP,320020,0,0,2,2,
Hughes,U.S. Senate,Rob Moye,REP,320020,0,0,1,1,
Hughes,U.S. Senate,D. Jean Mcbride-Samuels,REP,320020,0,0,1,1,
Hughes,U.S. Senate,Jim Inhofe,REP,320020,3,1,54,58,
Hughes,U.S. Senate,Erick Paul Wyatt,REP,320020,0,0,1,1,
Hughes,U.S. Senate,Andy Craig,REP,320020,0,0,0,0,
Hughes,U.S. Senate,T. Shannon,REP,320020,2,1,20,23,
Hughes,U.S. Senate,Randy Brogdon,REP,320020,0,0,2,2,
Hughes,U.S. Senate,Eric Mccray,REP,320020,0,0,0,0,
Hughes,U.S. Senate,Kevin Crow,REP,320020,0,0,1,1,
Hughes,U.S. Senate,James Lankford,REP,320020,1,0,37,38,
Hughes,U.S. Senate,Jason Weger,REP,320020,0,0,0,0,
Hughes,U.S. House,Darrel Robertson,REP,320020,1,0,19,20,02
Hughes,U.S. House,Markwayne Mullin,REP,320020,2,1,41,44,02
Hughes,Superintendent of Public Instruction,John Cox,DEM,320021,0,7,31,38,
Hughes,Superintendent of Public Instruction,Jack Jr.,DEM,320021,2,2,11,15,
Hughes,Superintendent of Public Instruction,Ivan Holmes,DEM,320021,0,1,9,10,
Hughes,Superintendent of Public Instruction,Freda Deskin,DEM,320021,3,1,36,40,
Hughes,U.S. Senate,Patrick Michael Hayes,DEM,320021,0,3,19,22,
Hughes,U.S. Senate,Jim Rogers,DEM,320021,1,2,31,34,
Hughes,U.S. Senate,Connie Johnson,DEM,320021,4,6,33,43,
Hughes,U.S. House,Earl Everett,DEM,320021,1,8,40,49,02
Hughes,U.S. House,Joshua Harris-Till,DEM,320021,4,3,37,44,02
Hughes,Governor,Dax Ewbank,REP,320021,0,0,2,2,
Hughes,Governor,Chad Moody,REP,320021,0,0,4,4,
Hughes,Governor,Mary Fallin,REP,320021,2,2,13,17,
Hughes,Superintendent of Public Instruction,Brian Kelly,REP,320021,0,0,4,4,
Hughes,Superintendent of Public Instruction,Janet Costello Barresi,REP,320021,0,2,1,3,
Hughes,Superintendent of Public Instruction,Joy Hofmeister,REP,320021,1,0,14,15,
Hughes,Insurance Commissioner,Bill Viner,REP,320021,1,0,3,4,
Hughes,Insurance Commissioner,John Doak,REP,320021,1,2,13,16,
Hughes,Corporation Commissioner,Todd Hiett,REP,320021,0,2,8,10,
Hughes,Corporation Commissioner,Cliff Branan,REP,320021,1,0,8,9,
Hughes,U.S. Senate,Evelyn Rogers,REP,320021,0,0,0,0,
Hughes,U.S. Senate,Rob Moye,REP,320021,0,0,0,0,
Hughes,U.S. Senate,D. Jean Mcbride-Samuels,REP,320021,0,0,0,0,
Hughes,U.S. Senate,Jim Inhofe,REP,320021,2,2,15,19,
Hughes,U.S. Senate,Erick Paul Wyatt,REP,320021,0,0,3,3,
Hughes,U.S. Senate,Andy Craig,REP,320021,0,0,0,0,
Hughes,U.S. Senate,T. Shannon,REP,320021,0,0,7,7,
Hughes,U.S. Senate,Randy Brogdon,REP,320021,0,2,1,3,
Hughes,U.S. Senate,Eric Mccray,REP,320021,0,0,0,0,
Hughes,U.S. Senate,Kevin Crow,REP,320021,0,0,0,0,
Hughes,U.S. Senate,James Lankford,REP,320021,1,0,11,12,
Hughes,U.S. Senate,Jason Weger,REP,320021,1,0,0,1,
Hughes,U.S. House,Darrel Robertson,REP,320021,1,0,6,7,02
Hughes,U.S. House,Markwayne Mullin,REP,320021,1,2,10,13,02
Hughes,Superintendent of Public Instruction,John Cox,DEM,320022,1,0,19,20,
Hughes,Superintendent of Public Instruction,Jack Jr.,DEM,320022,0,0,16,16,
Hughes,Superintendent of Public Instruction,Ivan Holmes,DEM,320022,0,0,2,2,
Hughes,Superintendent of Public Instruction,Freda Deskin,DEM,320022,0,1,20,21,
Hughes,U.S. Senate,Patrick Michael Hayes,DEM,320022,0,0,13,13,
Hughes,U.S. Senate,Jim Rogers,DEM,320022,0,0,21,21,
Hughes,U.S. Senate,Connie Johnson,DEM,320022,1,1,19,21,
Hughes,U.S. House,Earl Everett,DEM,320022,0,1,29,30,02
Hughes,U.S. House,Joshua Harris-Till,DEM,320022,1,0,23,24,02
Hughes,Governor,Dax Ewbank,REP,320022,0,0,0,0,
Hughes,Governor,Chad Moody,REP,320022,0,0,3,3,
Hughes,Governor,Mary Fallin,REP,320022,0,1,19,20,
Hughes,Superintendent of Public Instruction,Brian Kelly,REP,320022,0,0,5,5,
Hughes,Superintendent of Public Instruction,Janet Costello Barresi,REP,320022,0,1,1,2,
Hughes,Superintendent of Public Instruction,Joy Hofmeister,REP,320022,0,0,15,15,
Hughes,Insurance Commissioner,Bill Viner,REP,320022,0,0,4,4,
Hughes,Insurance Commissioner,John Doak,REP,320022,0,1,17,18,
Hughes,Corporation Commissioner,Todd Hiett,REP,320022,0,0,13,13,
Hughes,Corporation Commissioner,Cliff Branan,REP,320022,0,1,7,8,
Hughes,U.S. Senate,Evelyn Rogers,REP,320022,0,0,1,1,
Hughes,U.S. Senate,Rob Moye,REP,320022,0,0,1,1,
Hughes,U.S. Senate,D. Jean Mcbride-Samuels,REP,320022,0,0,0,0,
Hughes,U.S. Senate,Jim Inhofe,REP,320022,0,1,18,19,
Hughes,U.S. Senate,Erick Paul Wyatt,REP,320022,0,0,2,2,
Hughes,U.S. Senate,Andy Craig,REP,320022,0,0,0,0,
Hughes,U.S. Senate,T. Shannon,REP,320022,0,1,10,11,
Hughes,U.S. Senate,Randy Brogdon,REP,320022,0,0,1,1,
Hughes,U.S. Senate,Eric Mccray,REP,320022,0,0,0,0,
Hughes,U.S. Senate,Kevin Crow,REP,320022,0,0,1,1,
Hughes,U.S. Senate,James Lankford,REP,320022,0,0,9,9,
Hughes,U.S. Senate,Jason Weger,REP,320022,0,0,0,0,
Hughes,U.S. House,Darrel Robertson,REP,320022,0,0,4,4,02
Hughes,U.S. House,Markwayne Mullin,REP,320022,0,1,17,18,02
Hughes,Superintendent of Public Instruction,John Cox,DEM,320023,0,0,26,26,
Hughes,Superintendent of Public Instruction,Jack Jr.,DEM,320023,0,0,4,4,
Hughes,Superintendent of Public Instruction,Ivan Holmes,DEM,320023,0,0,1,1,
Hughes,Superintendent of Public Instruction,Freda Deskin,DEM,320023,0,0,15,15,
Hughes,U.S. Senate,Patrick Michael Hayes,DEM,320023,0,0,13,13,
Hughes,U.S. Senate,Jim Rogers,DEM,320023,0,0,20,20,
Hughes,U.S. Senate,Connie Johnson,DEM,320023,0,0,12,12,
Hughes,U.S. House,Earl Everett,DEM,320023,0,0,30,30,02
Hughes,U.S. House,Joshua Harris-Till,DEM,320023,0,0,10,10,02
Hughes,Governor,Dax Ewbank,REP,320023,0,0,1,1,
Hughes,Governor,Chad Moody,REP,320023,0,1,0,1,
Hughes,Governor,Mary Fallin,REP,320023,0,3,12,15,
Hughes,Superintendent of Public Instruction,Brian Kelly,REP,320023,0,0,4,4,
Hughes,Superintendent of Public Instruction,Janet Costello Barresi,REP,320023,0,2,0,2,
Hughes,Superintendent of Public Instruction,Joy Hofmeister,REP,320023,0,2,9,11,
Hughes,Insurance Commissioner,Bill Viner,REP,320023,0,0,4,4,
Hughes,Insurance Commissioner,John Doak,REP,320023,0,4,9,13,
Hughes,Corporation Commissioner,Todd Hiett,REP,320023,0,4,8,12,
Hughes,Corporation Commissioner,Cliff Branan,REP,320023,0,0,5,5,
Hughes,U.S. Senate,Evelyn Rogers,REP,320023,0,0,1,1,
Hughes,U.S. Senate,Rob Moye,REP,320023,0,1,0,1,
Hughes,U.S. Senate,D. Jean Mcbride-Samuels,REP,320023,0,0,0,0,
Hughes,U.S. Senate,Jim Inhofe,REP,320023,0,3,12,15,
Hughes,U.S. Senate,Erick Paul Wyatt,REP,320023,0,0,0,0,
Hughes,U.S. Senate,Andy Craig,REP,320023,0,0,0,0,
Hughes,U.S. Senate,T. Shannon,REP,320023,0,0,3,3,
Hughes,U.S. Senate,Randy Brogdon,REP,320023,0,2,2,4,
Hughes,U.S. Senate,Eric Mccray,REP,320023,0,0,0,0,
Hughes,U.S. Senate,Kevin Crow,REP,320023,0,0,0,0,
Hughes,U.S. Senate,James Lankford,REP,320023,0,2,8,10,
Hughes,U.S. Senate,Jason Weger,REP,320023,0,0,0,0,
Hughes,U.S. House,Darrel Robertson,REP,320023,0,0,7,7,02
Hughes,U.S. House,Markwayne Mullin,REP,320023,0,4,6,10,02
Hughes,Superintendent of Public Instruction,John Cox,DEM,320030,0,0,27,27,
Hughes,Superintendent of Public Instruction,Jack Jr.,DEM,320030,0,0,6,6,
Hughes,Superintendent of Public Instruction,Ivan Holmes,DEM,320030,0,0,6,6,
Hughes,Superintendent of Public Instruction,Freda Deskin,DEM,320030,0,0,33,33,
Hughes,U.S. Senate,Patrick Michael Hayes,DEM,320030,0,0,16,16,
Hughes,U.S. Senate,Jim Rogers,DEM,320030,0,0,23,23,
Hughes,U.S. Senate,Connie Johnson,DEM,320030,0,0,33,33,
Hughes,U.S. House,Earl Everett,DEM,320030,0,0,42,42,02
Hughes,U.S. House,Joshua Harris-Till,DEM,320030,0,0,26,26,02
Hughes,Governor,Dax Ewbank,REP,320030,0,0,1,1,
Hughes,Governor,Chad Moody,REP,320030,0,0,2,2,
Hughes,Governor,Mary Fallin,REP,320030,0,0,8,8,
Hughes,Superintendent of Public Instruction,Brian Kelly,REP,320030,0,0,2,2,
Hughes,Superintendent of Public Instruction,Janet Costello Barresi,REP,320030,0,0,3,3,
Hughes,Superintendent of Public Instruction,Joy Hofmeister,REP,320030,0,0,5,5,
Hughes,Insurance Commissioner,Bill Viner,REP,320030,0,0,3,3,
Hughes,Insurance Commissioner,John Doak,REP,320030,0,0,8,8,
Hughes,Corporation Commissioner,Todd Hiett,REP,320030,0,0,6,6,
Hughes,Corporation Commissioner,Cliff Branan,REP,320030,0,0,5,5,
Hughes,U.S. Senate,Evelyn Rogers,REP,320030,0,0,1,1,
Hughes,U.S. Senate,Rob Moye,REP,320030,0,0,0,0,
Hughes,U.S. Senate,D. Jean Mcbride-Samuels,REP,320030,0,0,0,0,
Hughes,U.S. Senate,Jim Inhofe,REP,320030,0,0,9,9,
Hughes,U.S. Senate,Erick Paul Wyatt,REP,320030,0,0,1,1,
Hughes,U.S. Senate,Andy Craig,REP,320030,0,0,0,0,
Hughes,U.S. Senate,T. Shannon,REP,320030,0,0,4,4,
Hughes,U.S. Senate,Randy Brogdon,REP,320030,0,0,0,0,
Hughes,U.S. Senate,Eric Mccray,REP,320030,0,0,0,0,
Hughes,U.S. Senate,Kevin Crow,REP,320030,0,0,0,0,
Hughes,U.S. Senate,James Lankford,REP,320030,0,0,7,7,
Hughes,U.S. Senate,Jason Weger,REP,320030,0,0,0,0,
Hughes,U.S. House,Darrel Robertson,REP,320030,0,0,2,2,02
Hughes,U.S. House,Markwayne Mullin,REP,320030,0,0,8,8,02
Hughes,Superintendent of Public Instruction,John Cox,DEM,320031,0,0,31,31,
Hughes,Superintendent of Public Instruction,Jack Jr.,DEM,320031,0,0,7,7,
Hughes,Superintendent of Public Instruction,Ivan Holmes,DEM,320031,0,0,5,5,
Hughes,Superintendent of Public Instruction,Freda Deskin,DEM,320031,0,0,42,42,
Hughes,U.S. Senate,Patrick Michael Hayes,DEM,320031,0,0,15,15,
Hughes,U.S. Senate,Jim Rogers,DEM,320031,0,0,42,42,
Hughes,U.S. Senate,Connie Johnson,DEM,320031,0,0,25,25,
Hughes,U.S. House,Earl Everett,DEM,320031,0,0,49,49,02
Hughes,U.S. House,Joshua Harris-Till,DEM,320031,0,0,23,23,02
Hughes,Governor,Dax Ewbank,REP,320031,0,0,4,4,
Hughes,Governor,Chad Moody,REP,320031,0,0,0,0,
Hughes,Governor,Mary Fallin,REP,320031,0,1,20,21,
Hughes,Superintendent of Public Instruction,Brian Kelly,REP,320031,0,0,5,5,
Hughes,Superintendent of Public Instruction,Janet Costello Barresi,REP,320031,0,0,9,9,
Hughes,Superintendent of Public Instruction,Joy Hofmeister,REP,320031,0,2,10,12,
Hughes,Insurance Commissioner,Bill Viner,REP,320031,0,0,6,6,
Hughes,Insurance Commissioner,John Doak,REP,320031,0,1,15,16,
Hughes,Corporation Commissioner,Todd Hiett,REP,320031,0,1,15,16,
Hughes,Corporation Commissioner,Cliff Branan,REP,320031,0,0,8,8,
Hughes,U.S. Senate,Evelyn Rogers,REP,320031,0,0,2,2,
Hughes,U.S. Senate,Rob Moye,REP,320031,0,0,0,0,
Hughes,U.S. Senate,D. Jean Mcbride-Samuels,REP,320031,0,0,0,0,
Hughes,U.S. Senate,Jim Inhofe,REP,320031,0,1,20,21,
Hughes,U.S. Senate,Erick Paul Wyatt,REP,320031,0,0,2,2,
Hughes,U.S. Senate,Andy Craig,REP,320031,0,0,0,0,
Hughes,U.S. Senate,T. Shannon,REP,320031,0,1,8,9,
Hughes,U.S. Senate,Randy Brogdon,REP,320031,0,0,4,4,
Hughes,U.S. Senate,Eric Mccray,REP,320031,0,0,0,0,
Hughes,U.S. Senate,Kevin Crow,REP,320031,0,0,0,0,
Hughes,U.S. Senate,James Lankford,REP,320031,0,1,12,13,
Hughes,U.S. Senate,Jason Weger,REP,320031,0,0,0,0,
Hughes,U.S. House,Darrel Robertson,REP,320031,0,1,7,8,02
Hughes,U.S. House,Markwayne Mullin,REP,320031,0,0,15,15,02
Hughes,Superintendent of Public Instruction,John Cox,DEM,320032,1,0,50,51,
Hughes,Superintendent of Public Instruction,Jack Jr.,DEM,320032,0,0,4,4,
Hughes,Superintendent of Public Instruction,Ivan Holmes,DEM,320032,0,0,0,0,
Hughes,Superintendent of Public Instruction,Freda Deskin,DEM,320032,0,0,22,22,
Hughes,U.S. Senate,Patrick Michael Hayes,DEM,320032,0,0,13,13,
Hughes,U.S. Senate,Jim Rogers,DEM,320032,1,0,37,38,
Hughes,U.S. Senate,Connie Johnson,DEM,320032,0,0,22,22,
Hughes,U.S. House,Earl Everett,DEM,320032,1,0,51,52,02
Hughes,U.S. House,Joshua Harris-Till,DEM,320032,0,0,21,21,02
Hughes,Governor,Dax Ewbank,REP,320032,0,0,3,3,
Hughes,Governor,Chad Moody,REP,320032,0,0,2,2,
Hughes,Governor,Mary Fallin,REP,320032,0,0,12,12,
Hughes,Superintendent of Public Instruction,Brian Kelly,REP,320032,0,0,5,5,
Hughes,Superintendent of Public Instruction,Janet Costello Barresi,REP,320032,0,0,4,4,
Hughes,Superintendent of Public Instruction,Joy Hofmeister,REP,320032,0,0,7,7,
Hughes,Insurance Commissioner,Bill Viner,REP,320032,0,0,3,3,
Hughes,Insurance Commissioner,John Doak,REP,320032,0,0,11,11,
Hughes,Corporation Commissioner,Todd Hiett,REP,320032,0,0,5,5,
Hughes,Corporation Commissioner,Cliff Branan,REP,320032,0,0,9,9,
Hughes,U.S. Senate,Evelyn Rogers,REP,320032,0,0,1,1,
Hughes,U.S. Senate,Rob Moye,REP,320032,0,0,0,0,
Hughes,U.S. Senate,D. Jean Mcbride-Samuels,REP,320032,0,0,0,0,
Hughes,U.S. Senate,Jim Inhofe,REP,320032,0,0,14,14,
Hughes,U.S. Senate,Erick Paul Wyatt,REP,320032,0,0,2,2,
Hughes,U.S. Senate,Andy Craig,REP,320032,0,0,0,0,
Hughes,U.S. Senate,T. Shannon,REP,320032,0,0,9,9,
Hughes,U.S. Senate,Randy Brogdon,REP,320032,0,0,0,0,
Hughes,U.S. Senate,Eric Mccray,REP,320032,0,0,0,0,
Hughes,U.S. Senate,Kevin Crow,REP,320032,0,0,0,0,
Hughes,U.S. Senate,James Lankford,REP,320032,0,0,7,7,
Hughes,U.S. Senate,Jason Weger,REP,320032,0,0,1,1,
Hughes,U.S. House,Darrel Robertson,REP,320032,0,0,5,5,02
Hughes,U.S. House,Markwayne Mullin,REP,320032,0,0,10,10,02
Hughes,Superintendent of Public Instruction,John Cox,DEM,320033,0,3,28,31,
Hughes,Superintendent of Public Instruction,Jack Jr.,DEM,320033,0,0,6,6,
Hughes,Superintendent of Public Instruction,Ivan Holmes,DEM,320033,0,0,2,2,
Hughes,Superintendent of Public Instruction,Freda Deskin,DEM,320033,2,0,18,20,
Hughes,U.S. Senate,Patrick Michael Hayes,DEM,320033,0,1,4,5,
Hughes,U.S. Senate,Jim Rogers,DEM,320033,0,1,24,25,
Hughes,U.S. Senate,Connie Johnson,DEM,320033,2,0,20,22,
Hughes,U.S. House,Earl Everett,DEM,320033,2,2,34,38,02
Hughes,U.S. House,Joshua Harris-Till,DEM,320033,0,0,16,16,02
Hughes,Governor,Dax Ewbank,REP,320033,0,0,2,2,
Hughes,Governor,Chad Moody,REP,320033,0,0,2,2,
Hughes,Governor,Mary Fallin,REP,320033,0,0,16,16,
Hughes,Superintendent of Public Instruction,Brian Kelly,REP,320033,0,0,8,8,
Hughes,Superintendent of Public Instruction,Janet Costello Barresi,REP,320033,0,0,4,4,
Hughes,Superintendent of Public Instruction,Joy Hofmeister,REP,320033,0,0,8,8,
Hughes,Insurance Commissioner,Bill Viner,REP,320033,0,0,5,5,
Hughes,Insurance Commissioner,John Doak,REP,320033,0,0,14,14,
Hughes,Corporation Commissioner,Todd Hiett,REP,320033,0,0,5,5,
Hughes,Corporation Commissioner,Cliff Branan,REP,320033,0,0,13,13,
Hughes,U.S. Senate,Evelyn Rogers,REP,320033,0,0,0,0,
Hughes,U.S. Senate,Rob Moye,REP,320033,0,0,0,0,
Hughes,U.S. Senate,D. Jean Mcbride-Samuels,REP,320033,0,0,0,0,
Hughes,U.S. Senate,Jim Inhofe,REP,320033,0,0,19,19,
Hughes,U.S. Senate,Erick Paul Wyatt,REP,320033,0,0,1,1,
Hughes,U.S. Senate,Andy Craig,REP,320033,0,0,0,0,
Hughes,U.S. Senate,T. Shannon,REP,320033,0,0,11,11,
Hughes,U.S. Senate,Randy Brogdon,REP,320033,0,0,0,0,
Hughes,U.S. Senate,Eric Mccray,REP,320033,0,0,1,1,
Hughes,U.S. Senate,Kevin Crow,REP,320033,0,0,0,0,
Hughes,U.S. Senate,James Lankford,REP,320033,0,0,8,8,
Hughes,U.S. Senate,Jason Weger,REP,320033,0,0,0,0,
Hughes,U.S. House,Darrel Robertson,REP,320033,0,0,8,8,02
Hughes,U.S. House,Markwayne Mullin,REP,320033,0,0,12,12,02
Hughes,Superintendent of Public Instruction,John Cox,DEM,320034,0,1,25,26,
Hughes,Superintendent of Public Instruction,Jack Jr.,DEM,320034,0,0,3,3,
Hughes,Superintendent of Public Instruction,Ivan Holmes,DEM,320034,0,0,0,0,
Hughes,Superintendent of Public Instruction,Freda Deskin,DEM,320034,0,1,12,13,
Hughes,U.S. Senate,Patrick Michael Hayes,DEM,320034,0,2,10,12,
Hughes,U.S. Senate,Jim Rogers,DEM,320034,0,0,15,15,
Hughes,U.S. Senate,Connie Johnson,DEM,320034,0,0,13,13,
Hughes,U.S. House,Earl Everett,DEM,320034,0,2,14,16,02
Hughes,U.S. House,Joshua Harris-Till,DEM,320034,0,0,23,23,02
Hughes,Governor,Dax Ewbank,REP,320034,0,0,3,3,
Hughes,Governor,Chad Moody,REP,320034,0,0,4,4,
Hughes,Governor,Mary Fallin,REP,320034,0,0,14,14,
Hughes,Superintendent of Public Instruction,Brian Kelly,REP,320034,0,0,2,2,
Hughes,Superintendent of Public Instruction,Janet Costello Barresi,REP,320034,0,0,1,1,
Hughes,Superintendent of Public Instruction,Joy Hofmeister,REP,320034,0,0,17,17,
Hughes,Insurance Commissioner,Bill Viner,REP,320034,0,0,4,4,
Hughes,Insurance Commissioner,John Doak,REP,320034,0,0,13,13,
Hughes,Corporation Commissioner,Todd Hiett,REP,320034,0,0,12,12,
Hughes,Corporation Commissioner,Cliff Branan,REP,320034,0,0,6,6,
Hughes,U.S. Senate,Evelyn Rogers,REP,320034,0,0,2,2,
Hughes,U.S. Senate,Rob Moye,REP,320034,0,0,1,1,
Hughes,U.S. Senate,D. Jean Mcbride-Samuels,REP,320034,0,0,0,0,
Hughes,U.S. Senate,Jim Inhofe,REP,320034,0,0,16,16,
Hughes,U.S. Senate,Erick Paul Wyatt,REP,320034,0,0,1,1,
Hughes,U.S. Senate,Andy Craig,REP,320034,0,0,0,0,
Hughes,U.S. Senate,T. Shannon,REP,320034,0,0,6,6,
Hughes,U.S. Senate,Randy Brogdon,REP,320034,0,0,0,0,
Hughes,U.S. Senate,Eric Mccray,REP,320034,0,0,0,0,
Hughes,U.S. Senate,Kevin Crow,REP,320034,0,0,0,0,
Hughes,U.S. Senate,James Lankford,REP,320034,0,0,14,14,
Hughes,U.S. Senate,Jason Weger,REP,320034,0,0,0,0,
Hughes,U.S. House,Darrel Robertson,REP,320034,0,0,11,11,02
Hughes,U.S. House,Markwayne Mullin,REP,320034,0,0,10,10,02
Hughes,Superintendent of Public Instruction,John Cox,DEM,320035,3,10,88,101,
Hughes,Superintendent of Public Instruction,Jack Jr.,DEM,320035,0,3,30,33,
Hughes,Superintendent of Public Instruction,Ivan Holmes,DEM,320035,0,2,19,21,
Hughes,Superintendent of Public Instruction,Freda Deskin,DEM,320035,2,5,82,89,
Hughes,U.S. Senate,Patrick Michael Hayes,DEM,320035,2,1,42,45,
Hughes,U.S. Senate,Jim Rogers,DEM,320035,1,8,79,88,
Hughes,U.S. Senate,Connie Johnson,DEM,320035,2,11,96,109,
Hughes,U.S. House,Earl Everett,DEM,320035,4,14,139,157,02
Hughes,U.S. House,Joshua Harris-Till,DEM,320035,1,5,64,70,02
Hughes,Governor,Dax Ewbank,REP,320035,2,0,6,8,
Hughes,Governor,Chad Moody,REP,320035,0,1,9,10,
Hughes,Governor,Mary Fallin,REP,320035,0,3,45,48,
Hughes,Superintendent of Public Instruction,Brian Kelly,REP,320035,1,3,16,20,
Hughes,Superintendent of Public Instruction,Janet Costello Barresi,REP,320035,0,1,5,6,
Hughes,Superintendent of Public Instruction,Joy Hofmeister,REP,320035,1,1,38,40,
Hughes,Insurance Commissioner,Bill Viner,REP,320035,1,1,11,13,
Hughes,Insurance Commissioner,John Doak,REP,320035,1,4,43,48,
Hughes,Corporation Commissioner,Todd Hiett,REP,320035,1,3,28,32,
Hughes,Corporation Commissioner,Cliff Branan,REP,320035,1,2,30,33,
Hughes,U.S. Senate,Evelyn Rogers,REP,320035,0,0,1,1,
Hughes,U.S. Senate,Rob Moye,REP,320035,0,0,3,3,
Hughes,U.S. Senate,D. Jean Mcbride-Samuels,REP,320035,0,0,1,1,
Hughes,U.S. Senate,Jim Inhofe,REP,320035,2,5,50,57,
Hughes,U.S. Senate,Erick Paul Wyatt,REP,320035,0,0,5,5,
Hughes,U.S. Senate,Andy Craig,REP,320035,0,0,1,1,
Hughes,U.S. Senate,T. Shannon,REP,320035,0,2,24,26,
Hughes,U.S. Senate,Randy Brogdon,REP,320035,1,2,5,8,
Hughes,U.S. Senate,Eric Mccray,REP,320035,0,0,0,0,
Hughes,U.S. Senate,Kevin Crow,REP,320035,0,0,0,0,
Hughes,U.S. Senate,James Lankford,REP,320035,1,1,28,30,
Hughes,U.S. Senate,Jason Weger,REP,320035,0,0,1,1,
Hughes,U.S. House,Darrel Robertson,REP,320035,2,1,17,20,02
Hughes,U.S. House,Markwayne Mullin,REP,320035,0,4,42,46,02
Jackson,Superintendent of Public Instruction,John Cox,DEM,330001,0,1,22,23,
Jackson,Superintendent of Public Instruction,Jack Jr.,DEM,330001,0,1,35,36,
Jackson,Superintendent of Public Instruction,Ivan Holmes,DEM,330001,0,0,9,9,
Jackson,Superintendent of Public Instruction,Freda Deskin,DEM,330001,0,5,23,28,
Jackson,U.S. Senate,Patrick Michael Hayes,DEM,330001,0,0,24,24,
Jackson,U.S. Senate,Jim Rogers,DEM,330001,0,3,38,41,
Jackson,U.S. Senate,Connie Johnson,DEM,330001,0,4,27,31,
Jackson,Governor,Dax Ewbank,REP,330001,1,0,15,16,
Jackson,Governor,Chad Moody,REP,330001,0,9,37,46,
Jackson,Governor,Mary Fallin,REP,330001,6,31,228,265,
Jackson,Superintendent of Public Instruction,Brian Kelly,REP,330001,1,6,46,53,
Jackson,Superintendent of Public Instruction,Janet Costello Barresi,REP,330001,5,10,56,71,
Jackson,Superintendent of Public Instruction,Joy Hofmeister,REP,330001,1,25,167,193,
Jackson,Insurance Commissioner,Bill Viner,REP,330001,2,14,67,83,
Jackson,Insurance Commissioner,John Doak,REP,330001,4,26,190,220,
Jackson,Corporation Commissioner,Todd Hiett,REP,330001,4,21,130,155,
Jackson,Corporation Commissioner,Cliff Branan,REP,330001,2,18,128,148,
Jackson,U.S. Senate,Evelyn Rogers,REP,330001,1,0,9,10,
Jackson,U.S. Senate,Rob Moye,REP,330001,0,0,3,3,
Jackson,U.S. Senate,D. Jean Mcbride-Samuels,REP,330001,0,0,2,2,
Jackson,U.S. Senate,Jim Inhofe,REP,330001,7,39,260,306,
Jackson,U.S. Senate,Erick Paul Wyatt,REP,330001,0,2,5,7,
Jackson,U.S. Senate,Andy Craig,REP,330001,0,1,0,1,
Jackson,U.S. Senate,T. Shannon,REP,330001,3,14,117,134,
Jackson,U.S. Senate,Randy Brogdon,REP,330001,2,0,5,7,
Jackson,U.S. Senate,Eric Mccray,REP,330001,0,0,1,1,
Jackson,U.S. Senate,Kevin Crow,REP,330001,0,0,0,0,
Jackson,U.S. Senate,James Lankford,REP,330001,3,25,157,185,
Jackson,U.S. Senate,Jason Weger,REP,330001,0,1,0,1,
Jackson,U.S. House,Timothy Ray Murray,REP,330001,1,1,9,11,03
Jackson,U.S. House,Robert Hubbard,REP,330001,1,3,20,24,03
Jackson,U.S. House,Frank Lucas,REP,330001,6,37,252,295,03
Jackson,Superintendent of Public Instruction,John Cox,DEM,330002,0,0,7,7,
Jackson,Superintendent of Public Instruction,Jack Jr.,DEM,330002,0,0,12,12,
Jackson,Superintendent of Public Instruction,Ivan Holmes,DEM,330002,0,0,4,4,
Jackson,Superintendent of Public Instruction,Freda Deskin,DEM,330002,0,1,14,15,
Jackson,U.S. Senate,Patrick Michael Hayes,DEM,330002,0,0,6,6,
Jackson,U.S. Senate,Jim Rogers,DEM,330002,0,0,14,14,
Jackson,U.S. Senate,Connie Johnson,DEM,330002,0,1,16,17,
Jackson,Governor,Dax Ewbank,REP,330002,0,1,5,6,
Jackson,Governor,Chad Moody,REP,330002,0,3,4,7,
Jackson,Governor,Mary Fallin,REP,330002,2,19,106,127,
Jackson,Superintendent of Public Instruction,Brian Kelly,REP,330002,1,0,16,17,
Jackson,Superintendent of Public Instruction,Janet Costello Barresi,REP,330002,0,6,21,27,
Jackson,Superintendent of Public Instruction,Joy Hofmeister,REP,330002,1,17,75,93,
Jackson,Insurance Commissioner,Bill Viner,REP,330002,0,5,15,20,
Jackson,Insurance Commissioner,John Doak,REP,330002,2,17,91,110,
Jackson,Corporation Commissioner,Todd Hiett,REP,330002,1,15,48,64,
Jackson,Corporation Commissioner,Cliff Branan,REP,330002,1,8,55,64,
Jackson,U.S. Senate,Evelyn Rogers,REP,330002,0,1,1,2,
Jackson,U.S. Senate,Rob Moye,REP,330002,0,0,1,1,
Jackson,U.S. Senate,D. Jean Mcbride-Samuels,REP,330002,0,0,1,1,
Jackson,U.S. Senate,Jim Inhofe,REP,330002,2,22,112,136,
Jackson,U.S. Senate,Erick Paul Wyatt,REP,330002,0,0,1,1,
Jackson,U.S. Senate,Andy Craig,REP,330002,0,0,0,0,
Jackson,U.S. Senate,T. Shannon,REP,330002,0,6,34,40,
Jackson,U.S. Senate,Randy Brogdon,REP,330002,0,0,0,0,
Jackson,U.S. Senate,Eric Mccray,REP,330002,0,0,0,0,
Jackson,U.S. Senate,Kevin Crow,REP,330002,0,0,0,0,
Jackson,U.S. Senate,James Lankford,REP,330002,2,17,81,100,
Jackson,U.S. Senate,Jason Weger,REP,330002,0,0,1,1,
Jackson,U.S. House,Timothy Ray Murray,REP,330002,0,0,4,4,03
Jackson,U.S. House,Robert Hubbard,REP,330002,0,2,5,7,03
Jackson,U.S. House,Frank Lucas,REP,330002,2,21,103,126,03
Jackson,Superintendent of Public Instruction,John Cox,DEM,330003,0,2,3,5,
Jackson,Superintendent of Public Instruction,Jack Jr.,DEM,330003,0,1,11,12,
Jackson,Superintendent of Public Instruction,Ivan Holmes,DEM,330003,0,0,5,5,
Jackson,Superintendent of Public Instruction,Freda Deskin,DEM,330003,0,1,9,10,
Jackson,U.S. Senate,Patrick Michael Hayes,DEM,330003,0,2,4,6,
Jackson,U.S. Senate,Jim Rogers,DEM,330003,0,1,8,9,
Jackson,U.S. Senate,Connie Johnson,DEM,330003,0,1,16,17,
Jackson,Governor,Dax Ewbank,REP,330003,0,0,1,1,
Jackson,Governor,Chad Moody,REP,330003,0,0,4,4,
Jackson,Governor,Mary Fallin,REP,330003,4,4,46,54,
Jackson,Superintendent of Public Instruction,Brian Kelly,REP,330003,0,1,7,8,
Jackson,Superintendent of Public Instruction,Janet Costello Barresi,REP,330003,0,1,13,14,
Jackson,Superintendent of Public Instruction,Joy Hofmeister,REP,330003,2,2,27,31,
Jackson,Insurance Commissioner,Bill Viner,REP,330003,2,1,14,17,
Jackson,Insurance Commissioner,John Doak,REP,330003,2,2,30,34,
Jackson,Corporation Commissioner,Todd Hiett,REP,330003,2,3,26,31,
Jackson,Corporation Commissioner,Cliff Branan,REP,330003,0,0,18,18,
Jackson,U.S. Senate,Evelyn Rogers,REP,330003,0,2,3,5,
Jackson,U.S. Senate,Rob Moye,REP,330003,0,0,0,0,
Jackson,U.S. Senate,D. Jean Mcbride-Samuels,REP,330003,0,0,1,1,
Jackson,U.S. Senate,Jim Inhofe,REP,330003,4,2,45,51,
Jackson,U.S. Senate,Erick Paul Wyatt,REP,330003,0,0,1,1,
Jackson,U.S. Senate,Andy Craig,REP,330003,0,0,0,0,
Jackson,U.S. Senate,T. Shannon,REP,330003,2,2,25,29,
Jackson,U.S. Senate,Randy Brogdon,REP,330003,0,0,0,0,
Jackson,U.S. Senate,Eric Mccray,REP,330003,0,0,1,1,
Jackson,U.S. Senate,Kevin Crow,REP,330003,0,0,0,0,
Jackson,U.S. Senate,James Lankford,REP,330003,2,2,24,28,
Jackson,U.S. Senate,Jason Weger,REP,330003,0,0,0,0,
Jackson,U.S. House,Timothy Ray Murray,REP,330003,0,0,2,2,03
Jackson,U.S. House,Robert Hubbard,REP,330003,0,1,3,4,03
Jackson,U.S. House,Frank Lucas,REP,330003,4,3,43,50,03
Jackson,Superintendent of Public Instruction,John Cox,DEM,330006,0,5,26,31,
Jackson,Superintendent of Public Instruction,Jack Jr.,DEM,330006,0,1,35,36,
Jackson,Superintendent of Public Instruction,Ivan Holmes,DEM,330006,1,1,9,11,
Jackson,Superintendent of Public Instruction,Freda Deskin,DEM,330006,4,5,26,35,
Jackson,U.S. Senate,Patrick Michael Hayes,DEM,330006,0,3,30,33,
Jackson,U.S. Senate,Jim Rogers,DEM,330006,1,6,42,49,
Jackson,U.S. Senate,Connie Johnson,DEM,330006,4,3,22,29,
Jackson,Governor,Dax Ewbank,REP,330006,0,0,5,5,
Jackson,Governor,Chad Moody,REP,330006,1,3,29,33,
Jackson,Governor,Mary Fallin,REP,330006,1,22,138,161,
Jackson,Superintendent of Public Instruction,Brian Kelly,REP,330006,1,2,29,32,
Jackson,Superintendent of Public Instruction,Janet Costello Barresi,REP,330006,0,5,35,40,
Jackson,Superintendent of Public Instruction,Joy Hofmeister,REP,330006,1,19,103,123,
Jackson,Insurance Commissioner,Bill Viner,REP,330006,0,3,57,60,
Jackson,Insurance Commissioner,John Doak,REP,330006,2,19,91,112,
Jackson,Corporation Commissioner,Todd Hiett,REP,330006,1,8,83,92,
Jackson,Corporation Commissioner,Cliff Branan,REP,330006,1,15,70,86,
Jackson,U.S. Senate,Evelyn Rogers,REP,330006,0,0,3,3,
Jackson,U.S. Senate,Rob Moye,REP,330006,0,0,0,0,
Jackson,U.S. Senate,D. Jean Mcbride-Samuels,REP,330006,0,0,0,0,
Jackson,U.S. Senate,Jim Inhofe,REP,330006,2,24,156,182,
Jackson,U.S. Senate,Erick Paul Wyatt,REP,330006,0,0,6,6,
Jackson,U.S. Senate,Andy Craig,REP,330006,0,0,2,2,
Jackson,U.S. Senate,T. Shannon,REP,330006,1,5,64,70,
Jackson,U.S. Senate,Randy Brogdon,REP,330006,0,0,1,1,
Jackson,U.S. Senate,Eric Mccray,REP,330006,0,0,0,0,
Jackson,U.S. Senate,Kevin Crow,REP,330006,0,0,0,0,
Jackson,U.S. Senate,James Lankford,REP,330006,1,21,102,124,
Jackson,U.S. Senate,Jason Weger,REP,330006,0,0,1,1,
Jackson,U.S. House,Timothy Ray Murray,REP,330006,0,0,6,6,03
Jackson,U.S. House,Robert Hubbard,REP,330006,0,1,14,15,03
Jackson,U.S. House,Frank Lucas,REP,330006,2,25,147,174,03
Jackson,Superintendent of Public Instruction,John Cox,DEM,330007,1,1,10,12,
Jackson,Superintendent of Public Instruction,Jack Jr.,DEM,330007,0,1,15,16,
Jackson,Superintendent of Public Instruction,Ivan Holmes,DEM,330007,0,0,6,6,
Jackson,Superintendent of Public Instruction,Freda Deskin,DEM,330007,0,3,14,17,
Jackson,U.S. Senate,Patrick Michael Hayes,DEM,330007,0,0,9,9,
Jackson,U.S. Senate,Jim Rogers,DEM,330007,1,3,17,21,
Jackson,U.S. Senate,Connie Johnson,DEM,330007,0,2,18,20,
Jackson,Governor,Dax Ewbank,REP,330007,0,0,3,3,
Jackson,Governor,Chad Moody,REP,330007,0,1,9,10,
Jackson,Governor,Mary Fallin,REP,330007,1,2,58,61,
Jackson,Superintendent of Public Instruction,Brian Kelly,REP,330007,0,1,15,16,
Jackson,Superintendent of Public Instruction,Janet Costello Barresi,REP,330007,0,0,16,16,
Jackson,Superintendent of Public Instruction,Joy Hofmeister,REP,330007,1,2,36,39,
Jackson,Insurance Commissioner,Bill Viner,REP,330007,1,0,17,18,
Jackson,Insurance Commissioner,John Doak,REP,330007,0,3,49,52,
Jackson,Corporation Commissioner,Todd Hiett,REP,330007,0,2,43,45,
Jackson,Corporation Commissioner,Cliff Branan,REP,330007,1,1,22,24,
Jackson,U.S. Senate,Evelyn Rogers,REP,330007,0,0,3,3,
Jackson,U.S. Senate,Rob Moye,REP,330007,0,0,1,1,
Jackson,U.S. Senate,D. Jean Mcbride-Samuels,REP,330007,0,0,1,1,
Jackson,U.S. Senate,Jim Inhofe,REP,330007,1,3,60,64,
Jackson,U.S. Senate,Erick Paul Wyatt,REP,330007,0,0,6,6,
Jackson,U.S. Senate,Andy Craig,REP,330007,0,0,0,0,
Jackson,U.S. Senate,T. Shannon,REP,330007,1,1,41,43,
Jackson,U.S. Senate,Randy Brogdon,REP,330007,0,0,0,0,
Jackson,U.S. Senate,Eric Mccray,REP,330007,0,0,0,0,
Jackson,U.S. Senate,Kevin Crow,REP,330007,0,0,6,6,
Jackson,U.S. Senate,James Lankford,REP,330007,0,2,23,25,
Jackson,U.S. Senate,Jason Weger,REP,330007,0,0,1,1,
Jackson,U.S. House,Timothy Ray Murray,REP,330007,0,0,9,9,03
Jackson,U.S. House,Robert Hubbard,REP,330007,0,0,5,5,03
Jackson,U.S. House,Frank Lucas,REP,330007,1,3,55,59,03
Jackson,Superintendent of Public Instruction,John Cox,DEM,330010,1,3,11,15,
Jackson,Superintendent of Public Instruction,Jack Jr.,DEM,330010,1,0,11,12,
Jackson,Superintendent of Public Instruction,Ivan Holmes,DEM,330010,0,0,4,4,
Jackson,Superintendent of Public Instruction,Freda Deskin,DEM,330010,0,3,6,9,
Jackson,U.S. Senate,Patrick Michael Hayes,DEM,330010,1,1,7,9,
Jackson,U.S. Senate,Jim Rogers,DEM,330010,0,2,11,13,
Jackson,U.S. Senate,Connie Johnson,DEM,330010,1,1,13,15,
Jackson,Governor,Dax Ewbank,REP,330010,0,0,1,1,
Jackson,Governor,Chad Moody,REP,330010,0,0,3,3,
Jackson,Governor,Mary Fallin,REP,330010,0,8,33,41,
Jackson,Superintendent of Public Instruction,Brian Kelly,REP,330010,0,3,9,12,
Jackson,Superintendent of Public Instruction,Janet Costello Barresi,REP,330010,0,0,11,11,
Jackson,Superintendent of Public Instruction,Joy Hofmeister,REP,330010,0,5,14,19,
Jackson,Insurance Commissioner,Bill Viner,REP,330010,0,2,8,10,
Jackson,Insurance Commissioner,John Doak,REP,330010,0,5,24,29,
Jackson,Corporation Commissioner,Todd Hiett,REP,330010,0,3,14,17,
Jackson,Corporation Commissioner,Cliff Branan,REP,330010,0,3,18,21,
Jackson,U.S. Senate,Evelyn Rogers,REP,330010,0,0,3,3,
Jackson,U.S. Senate,Rob Moye,REP,330010,0,0,0,0,
Jackson,U.S. Senate,D. Jean Mcbride-Samuels,REP,330010,0,0,3,3,
Jackson,U.S. Senate,Jim Inhofe,REP,330010,0,7,27,34,
Jackson,U.S. Senate,Erick Paul Wyatt,REP,330010,0,1,2,3,
Jackson,U.S. Senate,Andy Craig,REP,330010,0,0,0,0,
Jackson,U.S. Senate,T. Shannon,REP,330010,0,2,25,27,
Jackson,U.S. Senate,Randy Brogdon,REP,330010,0,0,1,1,
Jackson,U.S. Senate,Eric Mccray,REP,330010,0,0,1,1,
Jackson,U.S. Senate,Kevin Crow,REP,330010,0,1,0,1,
Jackson,U.S. Senate,James Lankford,REP,330010,0,5,9,14,
Jackson,U.S. Senate,Jason Weger,REP,330010,0,0,0,0,
Jackson,U.S. House,Timothy Ray Murray,REP,330010,0,2,3,5,03
Jackson,U.S. House,Robert Hubbard,REP,330010,0,0,5,5,03
Jackson,U.S. House,Frank Lucas,REP,330010,0,6,29,35,03
Jackson,Superintendent of Public Instruction,John Cox,DEM,330014,0,1,14,15,
Jackson,Superintendent of Public Instruction,Jack Jr.,DEM,330014,0,5,28,33,
Jackson,Superintendent of Public Instruction,Ivan Holmes,DEM,330014,0,0,8,8,
Jackson,Superintendent of Public Instruction,Freda Deskin,DEM,330014,1,2,19,22,
Jackson,U.S. Senate,Patrick Michael Hayes,DEM,330014,0,2,9,11,
Jackson,U.S. Senate,Jim Rogers,DEM,330014,0,2,36,38,
Jackson,U.S. Senate,Connie Johnson,DEM,330014,1,4,22,27,
Jackson,Governor,Dax Ewbank,REP,330014,0,0,3,3,
Jackson,Governor,Chad Moody,REP,330014,0,2,27,29,
Jackson,Governor,Mary Fallin,REP,330014,2,17,123,142,
Jackson,Superintendent of Public Instruction,Brian Kelly,REP,330014,0,0,36,36,
Jackson,Superintendent of Public Instruction,Janet Costello Barresi,REP,330014,0,6,37,43,
Jackson,Superintendent of Public Instruction,Joy Hofmeister,REP,330014,2,13,76,91,
Jackson,Insurance Commissioner,Bill Viner,REP,330014,2,1,37,40,
Jackson,Insurance Commissioner,John Doak,REP,330014,0,15,104,119,
Jackson,Corporation Commissioner,Todd Hiett,REP,330014,2,11,74,87,
Jackson,Corporation Commissioner,Cliff Branan,REP,330014,0,6,68,74,
Jackson,U.S. Senate,Evelyn Rogers,REP,330014,0,0,6,6,
Jackson,U.S. Senate,Rob Moye,REP,330014,0,0,2,2,
Jackson,U.S. Senate,D. Jean Mcbride-Samuels,REP,330014,0,1,5,6,
Jackson,U.S. Senate,Jim Inhofe,REP,330014,2,16,133,151,
Jackson,U.S. Senate,Erick Paul Wyatt,REP,330014,0,2,7,9,
Jackson,U.S. Senate,Andy Craig,REP,330014,0,0,0,0,
Jackson,U.S. Senate,T. Shannon,REP,330014,0,6,81,87,
Jackson,U.S. Senate,Randy Brogdon,REP,330014,0,0,3,3,
Jackson,U.S. Senate,Eric Mccray,REP,330014,0,0,1,1,
Jackson,U.S. Senate,Kevin Crow,REP,330014,0,0,0,0,
Jackson,U.S. Senate,James Lankford,REP,330014,2,13,67,82,
Jackson,U.S. Senate,Jason Weger,REP,330014,0,0,0,0,
Jackson,U.S. House,Timothy Ray Murray,REP,330014,0,2,5,7,03
Jackson,U.S. House,Robert Hubbard,REP,330014,0,2,15,17,03
Jackson,U.S. House,Frank Lucas,REP,330014,2,15,130,147,03
Jackson,Superintendent of Public Instruction,John Cox,DEM,330016,1,0,12,13,
Jackson,Superintendent of Public Instruction,Jack Jr.,DEM,330016,1,0,19,20,
Jackson,Superintendent of Public Instruction,Ivan Holmes,DEM,330016,0,0,2,2,
Jackson,Superintendent of Public Instruction,Freda Deskin,DEM,330016,0,0,11,11,
Jackson,U.S. Senate,Patrick Michael Hayes,DEM,330016,0,0,8,8,
Jackson,U.S. Senate,Jim Rogers,DEM,330016,2,0,21,23,
Jackson,U.S. Senate,Connie Johnson,DEM,330016,0,0,12,12,
Jackson,Governor,Dax Ewbank,REP,330016,0,1,6,7,
Jackson,Governor,Chad Moody,REP,330016,0,4,8,12,
Jackson,Governor,Mary Fallin,REP,330016,0,4,65,69,
Jackson,Superintendent of Public Instruction,Brian Kelly,REP,330016,0,2,15,17,
Jackson,Superintendent of Public Instruction,Janet Costello Barresi,REP,330016,0,0,16,16,
Jackson,Superintendent of Public Instruction,Joy Hofmeister,REP,330016,0,5,45,50,
Jackson,Insurance Commissioner,Bill Viner,REP,330016,0,0,14,14,
Jackson,Insurance Commissioner,John Doak,REP,330016,0,6,56,62,
Jackson,Corporation Commissioner,Todd Hiett,REP,330016,0,2,41,43,
Jackson,Corporation Commissioner,Cliff Branan,REP,330016,0,5,32,37,
Jackson,U.S. Senate,Evelyn Rogers,REP,330016,0,0,2,2,
Jackson,U.S. Senate,Rob Moye,REP,330016,0,0,2,2,
Jackson,U.S. Senate,D. Jean Mcbride-Samuels,REP,330016,0,0,1,1,
Jackson,U.S. Senate,Jim Inhofe,REP,330016,0,8,67,75,
Jackson,U.S. Senate,Erick Paul Wyatt,REP,330016,0,0,4,4,
Jackson,U.S. Senate,Andy Craig,REP,330016,0,0,0,0,
Jackson,U.S. Senate,T. Shannon,REP,330016,0,6,47,53,
Jackson,U.S. Senate,Randy Brogdon,REP,330016,0,0,1,1,
Jackson,U.S. Senate,Eric Mccray,REP,330016,0,0,1,1,
Jackson,U.S. Senate,Kevin Crow,REP,330016,0,0,1,1,
Jackson,U.S. Senate,James Lankford,REP,330016,0,2,27,29,
Jackson,U.S. Senate,Jason Weger,REP,330016,0,0,0,0,
Jackson,U.S. House,Timothy Ray Murray,REP,330016,0,0,3,3,03
Jackson,U.S. House,Robert Hubbard,REP,330016,0,0,1,1,03
Jackson,U.S. House,Frank Lucas,REP,330016,0,9,74,83,03
Jackson,Superintendent of Public Instruction,John Cox,DEM,330017,0,0,6,6,
Jackson,Superintendent of Public Instruction,Jack Jr.,DEM,330017,1,0,9,10,
Jackson,Superintendent of Public Instruction,Ivan Holmes,DEM,330017,0,0,6,6,
Jackson,Superintendent of Public Instruction,Freda Deskin,DEM,330017,0,0,6,6,
Jackson,U.S. Senate,Patrick Michael Hayes,DEM,330017,0,0,5,5,
Jackson,U.S. Senate,Jim Rogers,DEM,330017,1,0,18,19,
Jackson,U.S. Senate,Connie Johnson,DEM,330017,0,0,4,4,
Jackson,Governor,Dax Ewbank,REP,330017,0,1,5,6,
Jackson,Governor,Chad Moody,REP,330017,0,2,4,6,
Jackson,Governor,Mary Fallin,REP,330017,0,5,40,45,
Jackson,Superintendent of Public Instruction,Brian Kelly,REP,330017,0,2,8,10,
Jackson,Superintendent of Public Instruction,Janet Costello Barresi,REP,330017,0,3,6,9,
Jackson,Superintendent of Public Instruction,Joy Hofmeister,REP,330017,0,3,37,40,
Jackson,Insurance Commissioner,Bill Viner,REP,330017,0,2,14,16,
Jackson,Insurance Commissioner,John Doak,REP,330017,0,6,27,33,
Jackson,Corporation Commissioner,Todd Hiett,REP,330017,0,4,24,28,
Jackson,Corporation Commissioner,Cliff Branan,REP,330017,0,3,16,19,
Jackson,U.S. Senate,Evelyn Rogers,REP,330017,0,0,0,0,
Jackson,U.S. Senate,Rob Moye,REP,330017,0,0,0,0,
Jackson,U.S. Senate,D. Jean Mcbride-Samuels,REP,330017,0,0,0,0,
Jackson,U.S. Senate,Jim Inhofe,REP,330017,0,8,44,52,
Jackson,U.S. Senate,Erick Paul Wyatt,REP,330017,0,0,5,5,
Jackson,U.S. Senate,Andy Craig,REP,330017,0,0,0,0,
Jackson,U.S. Senate,T. Shannon,REP,330017,0,2,24,26,
Jackson,U.S. Senate,Randy Brogdon,REP,330017,0,0,2,2,
Jackson,U.S. Senate,Eric Mccray,REP,330017,0,0,0,0,
Jackson,U.S. Senate,Kevin Crow,REP,330017,0,0,1,1,
Jackson,U.S. Senate,James Lankford,REP,330017,0,6,24,30,
Jackson,U.S. Senate,Jason Weger,REP,330017,0,0,0,0,
Jackson,U.S. House,Timothy Ray Murray,REP,330017,0,0,3,3,03
Jackson,U.S. House,Robert Hubbard,REP,330017,0,0,6,6,03
Jackson,U.S. House,Frank Lucas,REP,330017,0,8,40,48,03
Jackson,Superintendent of Public Instruction,John Cox,DEM,330018,0,0,5,5,
Jackson,Superintendent of Public Instruction,Jack Jr.,DEM,330018,0,0,8,8,
Jackson,Superintendent of Public Instruction,Ivan Holmes,DEM,330018,0,0,4,4,
Jackson,Superintendent of Public Instruction,Freda Deskin,DEM,330018,0,0,7,7,
Jackson,U.S. Senate,Patrick Michael Hayes,DEM,330018,0,0,5,5,
Jackson,U.S. Senate,Jim Rogers,DEM,330018,0,0,13,13,
Jackson,U.S. Senate,Connie Johnson,DEM,330018,0,0,5,5,
Jackson,Governor,Dax Ewbank,REP,330018,0,0,0,0,
Jackson,Governor,Chad Moody,REP,330018,0,0,2,2,
Jackson,Governor,Mary Fallin,REP,330018,0,0,15,15,
Jackson,Superintendent of Public Instruction,Brian Kelly,REP,330018,0,0,2,2,
Jackson,Superintendent of Public Instruction,Janet Costello Barresi,REP,330018,0,0,4,4,
Jackson,Superintendent of Public Instruction,Joy Hofmeister,REP,330018,0,0,12,12,
Jackson,Insurance Commissioner,Bill Viner,REP,330018,0,0,2,2,
Jackson,Insurance Commissioner,John Doak,REP,330018,0,0,10,10,
Jackson,Corporation Commissioner,Todd Hiett,REP,330018,0,0,11,11,
Jackson,Corporation Commissioner,Cliff Branan,REP,330018,0,0,2,2,
Jackson,U.S. Senate,Evelyn Rogers,REP,330018,0,0,1,1,
Jackson,U.S. Senate,Rob Moye,REP,330018,0,0,0,0,
Jackson,U.S. Senate,D. Jean Mcbride-Samuels,REP,330018,0,0,0,0,
Jackson,U.S. Senate,Jim Inhofe,REP,330018,0,0,16,16,
Jackson,U.S. Senate,Erick Paul Wyatt,REP,330018,0,0,0,0,
Jackson,U.S. Senate,Andy Craig,REP,330018,0,0,0,0,
Jackson,U.S. Senate,T. Shannon,REP,330018,0,0,11,11,
Jackson,U.S. Senate,Randy Brogdon,REP,330018,0,0,0,0,
Jackson,U.S. Senate,Eric Mccray,REP,330018,0,0,0,0,
Jackson,U.S. Senate,Kevin Crow,REP,330018,0,0,0,0,
Jackson,U.S. Senate,James Lankford,REP,330018,0,0,7,7,
Jackson,U.S. Senate,Jason Weger,REP,330018,0,0,0,0,
Jackson,U.S. House,Timothy Ray Murray,REP,330018,0,0,0,0,03
Jackson,U.S. House,Robert Hubbard,REP,330018,0,0,1,1,03
Jackson,U.S. House,Frank Lucas,REP,330018,0,0,17,17,03
Jackson,Superintendent of Public Instruction,John Cox,DEM,330019,0,0,6,6,
Jackson,Superintendent of Public Instruction,Jack Jr.,DEM,330019,0,1,9,10,
Jackson,Superintendent of Public Instruction,Ivan Holmes,DEM,330019,0,0,2,2,
Jackson,Superintendent of Public Instruction,Freda Deskin,DEM,330019,0,0,3,3,
Jackson,U.S. Senate,Patrick Michael Hayes,DEM,330019,0,1,3,4,
Jackson,U.S. Senate,Jim Rogers,DEM,330019,0,0,5,5,
Jackson,U.S. Senate,Connie Johnson,DEM,330019,0,0,8,8,
Jackson,Governor,Dax Ewbank,REP,330019,0,0,0,0,
Jackson,Governor,Chad Moody,REP,330019,0,0,3,3,
Jackson,Governor,Mary Fallin,REP,330019,2,1,26,29,
Jackson,Superintendent of Public Instruction,Brian Kelly,REP,330019,0,0,12,12,
Jackson,Superintendent of Public Instruction,Janet Costello Barresi,REP,330019,2,0,2,4,
Jackson,Superintendent of Public Instruction,Joy Hofmeister,REP,330019,0,1,15,16,
Jackson,Insurance Commissioner,Bill Viner,REP,330019,1,0,5,6,
Jackson,Insurance Commissioner,John Doak,REP,330019,1,1,22,24,
Jackson,Corporation Commissioner,Todd Hiett,REP,330019,1,0,13,14,
Jackson,Corporation Commissioner,Cliff Branan,REP,330019,0,1,13,14,
Jackson,U.S. Senate,Evelyn Rogers,REP,330019,0,0,1,1,
Jackson,U.S. Senate,Rob Moye,REP,330019,0,0,0,0,
Jackson,U.S. Senate,D. Jean Mcbride-Samuels,REP,330019,0,0,0,0,
Jackson,U.S. Senate,Jim Inhofe,REP,330019,2,1,28,31,
Jackson,U.S. Senate,Erick Paul Wyatt,REP,330019,0,0,1,1,
Jackson,U.S. Senate,Andy Craig,REP,330019,0,0,0,0,
Jackson,U.S. Senate,T. Shannon,REP,330019,2,1,16,19,
Jackson,U.S. Senate,Randy Brogdon,REP,330019,0,0,0,0,
Jackson,U.S. Senate,Eric Mccray,REP,330019,0,0,1,1,
Jackson,U.S. Senate,Kevin Crow,REP,330019,0,0,1,1,
Jackson,U.S. Senate,James Lankford,REP,330019,0,0,12,12,
Jackson,U.S. Senate,Jason Weger,REP,330019,0,0,0,0,
Jackson,U.S. House,Timothy Ray Murray,REP,330019,0,0,2,2,03
Jackson,U.S. House,Robert Hubbard,REP,330019,1,0,1,2,03
Jackson,U.S. House,Frank Lucas,REP,330019,0,1,27,28,03
Jackson,Superintendent of Public Instruction,John Cox,DEM,330020,0,2,14,16,
Jackson,Superintendent of Public Instruction,Jack Jr.,DEM,330020,0,0,24,24,
Jackson,Superintendent of Public Instruction,Ivan Holmes,DEM,330020,0,0,5,5,
Jackson,Superintendent of Public Instruction,Freda Deskin,DEM,330020,0,1,9,10,
Jackson,U.S. Senate,Patrick Michael Hayes,DEM,330020,0,1,9,10,
Jackson,U.S. Senate,Jim Rogers,DEM,330020,0,1,24,25,
Jackson,U.S. Senate,Connie Johnson,DEM,330020,0,1,18,19,
Jackson,Governor,Dax Ewbank,REP,330020,0,0,7,7,
Jackson,Governor,Chad Moody,REP,330020,0,4,15,19,
Jackson,Governor,Mary Fallin,REP,330020,7,21,114,142,
Jackson,Superintendent of Public Instruction,Brian Kelly,REP,330020,4,2,28,34,
Jackson,Superintendent of Public Instruction,Janet Costello Barresi,REP,330020,1,6,28,35,
Jackson,Superintendent of Public Instruction,Joy Hofmeister,REP,330020,1,17,75,93,
Jackson,Insurance Commissioner,Bill Viner,REP,330020,1,4,31,36,
Jackson,Insurance Commissioner,John Doak,REP,330020,5,20,97,122,
Jackson,Corporation Commissioner,Todd Hiett,REP,330020,2,12,71,85,
Jackson,Corporation Commissioner,Cliff Branan,REP,330020,4,13,59,76,
Jackson,U.S. Senate,Evelyn Rogers,REP,330020,0,0,5,5,
Jackson,U.S. Senate,Rob Moye,REP,330020,0,2,0,2,
Jackson,U.S. Senate,D. Jean Mcbride-Samuels,REP,330020,0,0,0,0,
Jackson,U.S. Senate,Jim Inhofe,REP,330020,7,21,127,155,
Jackson,U.S. Senate,Erick Paul Wyatt,REP,330020,0,2,5,7,
Jackson,U.S. Senate,Andy Craig,REP,330020,0,0,1,1,
Jackson,U.S. Senate,T. Shannon,REP,330020,6,5,71,82,
Jackson,U.S. Senate,Randy Brogdon,REP,330020,0,0,4,4,
Jackson,U.S. Senate,Eric Mccray,REP,330020,0,0,0,0,
Jackson,U.S. Senate,Kevin Crow,REP,330020,0,0,1,1,
Jackson,U.S. Senate,James Lankford,REP,330020,0,20,59,79,
Jackson,U.S. Senate,Jason Weger,REP,330020,0,0,0,0,
Jackson,U.S. House,Timothy Ray Murray,REP,330020,0,2,9,11,03
Jackson,U.S. House,Robert Hubbard,REP,330020,0,1,12,13,03
Jackson,U.S. House,Frank Lucas,REP,330020,7,22,116,145,03
Jackson,Superintendent of Public Instruction,John Cox,DEM,330021,0,0,4,4,
Jackson,Superintendent of Public Instruction,Jack Jr.,DEM,330021,0,0,3,3,
Jackson,Superintendent of Public Instruction,Ivan Holmes,DEM,330021,0,0,2,2,
Jackson,Superintendent of Public Instruction,Freda Deskin,DEM,330021,0,0,5,5,
Jackson,U.S. Senate,Patrick Michael Hayes,DEM,330021,0,0,4,4,
Jackson,U.S. Senate,Jim Rogers,DEM,330021,0,0,4,4,
Jackson,U.S. Senate,Connie Johnson,DEM,330021,0,0,4,4,
Jackson,Governor,Dax Ewbank,REP,330021,0,0,0,0,
Jackson,Governor,Chad Moody,REP,330021,0,2,1,3,
Jackson,Governor,Mary Fallin,REP,330021,1,3,21,25,
Jackson,Superintendent of Public Instruction,Brian Kelly,REP,330021,0,0,3,3,
Jackson,Superintendent of Public Instruction,Janet Costello Barresi,REP,330021,0,0,3,3,
Jackson,Superintendent of Public Instruction,Joy Hofmeister,REP,330021,1,5,16,22,
Jackson,Insurance Commissioner,Bill Viner,REP,330021,0,1,5,6,
Jackson,Insurance Commissioner,John Doak,REP,330021,1,4,17,22,
Jackson,Corporation Commissioner,Todd Hiett,REP,330021,1,2,4,7,
Jackson,Corporation Commissioner,Cliff Branan,REP,330021,0,3,17,20,
Jackson,U.S. Senate,Evelyn Rogers,REP,330021,0,0,1,1,
Jackson,U.S. Senate,Rob Moye,REP,330021,0,0,0,0,
Jackson,U.S. Senate,D. Jean Mcbride-Samuels,REP,330021,0,0,0,0,
Jackson,U.S. Senate,Jim Inhofe,REP,330021,1,5,21,27,
Jackson,U.S. Senate,Erick Paul Wyatt,REP,330021,0,0,0,0,
Jackson,U.S. Senate,Andy Craig,REP,330021,0,0,0,0,
Jackson,U.S. Senate,T. Shannon,REP,330021,1,2,7,10,
Jackson,U.S. Senate,Randy Brogdon,REP,330021,0,0,0,0,
Jackson,U.S. Senate,Eric Mccray,REP,330021,0,0,0,0,
Jackson,U.S. Senate,Kevin Crow,REP,330021,0,0,0,0,
Jackson,U.S. Senate,James Lankford,REP,330021,0,3,15,18,
Jackson,U.S. Senate,Jason Weger,REP,330021,0,0,0,0,
Jackson,U.S. House,Timothy Ray Murray,REP,330021,0,0,0,0,03
Jackson,U.S. House,Robert Hubbard,REP,330021,0,0,2,2,03
Jackson,U.S. House,Frank Lucas,REP,330021,1,5,20,26,03
Jackson,Superintendent of Public Instruction,John Cox,DEM,330023,0,3,12,15,
Jackson,Superintendent of Public Instruction,Jack Jr.,DEM,330023,0,2,11,13,
Jackson,Superintendent of Public Instruction,Ivan Holmes,DEM,330023,0,0,1,1,
Jackson,Superintendent of Public Instruction,Freda Deskin,DEM,330023,0,0,9,9,
Jackson,U.S. Senate,Patrick Michael Hayes,DEM,330023,0,1,10,11,
Jackson,U.S. Senate,Jim Rogers,DEM,330023,0,3,10,13,
Jackson,U.S. Senate,Connie Johnson,DEM,330023,0,0,11,11,
Jackson,Governor,Dax Ewbank,REP,330023,0,1,3,4,
Jackson,Governor,Chad Moody,REP,330023,0,0,10,10,
Jackson,Governor,Mary Fallin,REP,330023,3,8,70,81,
Jackson,Superintendent of Public Instruction,Brian Kelly,REP,330023,0,2,16,18,
Jackson,Superintendent of Public Instruction,Janet Costello Barresi,REP,330023,3,1,13,17,
Jackson,Superintendent of Public Instruction,Joy Hofmeister,REP,330023,0,6,51,57,
Jackson,Insurance Commissioner,Bill Viner,REP,330023,0,0,20,20,
Jackson,Insurance Commissioner,John Doak,REP,330023,3,6,54,63,
Jackson,Corporation Commissioner,Todd Hiett,REP,330023,3,1,42,46,
Jackson,Corporation Commissioner,Cliff Branan,REP,330023,0,5,35,40,
Jackson,U.S. Senate,Evelyn Rogers,REP,330023,0,0,2,2,
Jackson,U.S. Senate,Rob Moye,REP,330023,0,0,1,1,
Jackson,U.S. Senate,D. Jean Mcbride-Samuels,REP,330023,0,0,0,0,
Jackson,U.S. Senate,Jim Inhofe,REP,330023,3,9,78,90,
Jackson,U.S. Senate,Erick Paul Wyatt,REP,330023,0,0,3,3,
Jackson,U.S. Senate,Andy Craig,REP,330023,0,0,1,1,
Jackson,U.S. Senate,T. Shannon,REP,330023,1,5,32,38,
Jackson,U.S. Senate,Randy Brogdon,REP,330023,0,0,4,4,
Jackson,U.S. Senate,Eric Mccray,REP,330023,0,0,1,1,
Jackson,U.S. Senate,Kevin Crow,REP,330023,0,0,0,0,
Jackson,U.S. Senate,James Lankford,REP,330023,2,4,43,49,
Jackson,U.S. Senate,Jason Weger,REP,330023,0,0,1,1,
Jackson,U.S. House,Timothy Ray Murray,REP,330023,0,0,1,1,03
Jackson,U.S. House,Robert Hubbard,REP,330023,0,0,11,11,03
Jackson,U.S. House,Frank Lucas,REP,330023,3,9,71,83,03
Jackson,Superintendent of Public Instruction,John Cox,DEM,330024,0,0,11,11,
Jackson,Superintendent of Public Instruction,Jack Jr.,DEM,330024,0,0,8,8,
Jackson,Superintendent of Public Instruction,Ivan Holmes,DEM,330024,0,0,2,2,
Jackson,Superintendent of Public Instruction,Freda Deskin,DEM,330024,0,0,5,5,
Jackson,U.S. Senate,Patrick Michael Hayes,DEM,330024,0,0,5,5,
Jackson,U.S. Senate,Jim Rogers,DEM,330024,0,0,14,14,
Jackson,U.S. Senate,Connie Johnson,DEM,330024,0,0,6,6,
Jackson,Governor,Dax Ewbank,REP,330024,0,0,0,0,
Jackson,Governor,Chad Moody,REP,330024,0,1,4,5,
Jackson,Governor,Mary Fallin,REP,330024,0,3,19,22,
Jackson,Superintendent of Public Instruction,Brian Kelly,REP,330024,0,1,7,8,
Jackson,Superintendent of Public Instruction,Janet Costello Barresi,REP,330024,0,1,1,2,
Jackson,Superintendent of Public Instruction,Joy Hofmeister,REP,330024,0,2,15,17,
Jackson,Insurance Commissioner,Bill Viner,REP,330024,0,1,3,4,
Jackson,Insurance Commissioner,John Doak,REP,330024,0,3,17,20,
Jackson,Corporation Commissioner,Todd Hiett,REP,330024,0,3,12,15,
Jackson,Corporation Commissioner,Cliff Branan,REP,330024,0,1,9,10,
Jackson,U.S. Senate,Evelyn Rogers,REP,330024,0,0,1,1,
Jackson,U.S. Senate,Rob Moye,REP,330024,0,0,0,0,
Jackson,U.S. Senate,D. Jean Mcbride-Samuels,REP,330024,0,1,0,1,
Jackson,U.S. Senate,Jim Inhofe,REP,330024,0,3,22,25,
Jackson,U.S. Senate,Erick Paul Wyatt,REP,330024,0,0,0,0,
Jackson,U.S. Senate,Andy Craig,REP,330024,0,1,0,1,
Jackson,U.S. Senate,T. Shannon,REP,330024,0,1,14,15,
Jackson,U.S. Senate,Randy Brogdon,REP,330024,0,0,0,0,
Jackson,U.S. Senate,Eric Mccray,REP,330024,0,0,0,0,
Jackson,U.S. Senate,Kevin Crow,REP,330024,0,0,0,0,
Jackson,U.S. Senate,James Lankford,REP,330024,0,2,9,11,
Jackson,U.S. Senate,Jason Weger,REP,330024,0,0,0,0,
Jackson,U.S. House,Timothy Ray Murray,REP,330024,0,1,0,1,03
Jackson,U.S. House,Robert Hubbard,REP,330024,0,0,0,0,03
Jackson,U.S. House,Frank Lucas,REP,330024,0,3,23,26,03
Jefferson,Superintendent of Public Instruction,John Cox,DEM,340001,1,6,36,43,
Jefferson,Superintendent of Public Instruction,Jack Jr.,DEM,340001,0,0,9,9,
Jefferson,Superintendent of Public Instruction,Ivan Holmes,DEM,340001,0,1,5,6,
Jefferson,Superintendent of Public Instruction,Freda Deskin,DEM,340001,0,1,9,10,
Jefferson,U.S. Senate,Patrick Michael Hayes,DEM,340001,1,1,14,16,
Jefferson,U.S. Senate,Jim Rogers,DEM,340001,0,5,28,33,
Jefferson,U.S. Senate,Connie Johnson,DEM,340001,0,1,15,16,
Jefferson,U.S. House,Bert Smith,DEM,340001,1,5,47,53,04
Jefferson,U.S. House,Tae Si,DEM,340001,0,1,8,9,04
Jefferson,Governor,Dax Ewbank,REP,340001,0,0,13,13,
Jefferson,Governor,Chad Moody,REP,340001,0,3,6,9,
Jefferson,Governor,Mary Fallin,REP,340001,2,5,13,20,
Jefferson,Superintendent of Public Instruction,Brian Kelly,REP,340001,2,4,11,17,
Jefferson,Superintendent of Public Instruction,Janet Costello Barresi,REP,340001,0,1,1,2,
Jefferson,Superintendent of Public Instruction,Joy Hofmeister,REP,340001,0,3,20,23,
Jefferson,Insurance Commissioner,Bill Viner,REP,340001,0,2,10,12,
Jefferson,Insurance Commissioner,John Doak,REP,340001,2,5,20,27,
Jefferson,Corporation Commissioner,Todd Hiett,REP,340001,2,4,15,21,
Jefferson,Corporation Commissioner,Cliff Branan,REP,340001,0,2,14,16,
Jefferson,U.S. Senate,Evelyn Rogers,REP,340001,0,0,1,1,
Jefferson,U.S. Senate,Rob Moye,REP,340001,0,0,1,1,
Jefferson,U.S. Senate,D. Jean Mcbride-Samuels,REP,340001,0,0,1,1,
Jefferson,U.S. Senate,Jim Inhofe,REP,340001,2,8,25,35,
Jefferson,U.S. Senate,Erick Paul Wyatt,REP,340001,0,0,2,2,
Jefferson,U.S. Senate,Andy Craig,REP,340001,0,0,0,0,
Jefferson,U.S. Senate,T. Shannon,REP,340001,1,2,18,21,
Jefferson,U.S. Senate,Randy Brogdon,REP,340001,1,0,0,1,
Jefferson,U.S. Senate,Eric Mccray,REP,340001,0,0,1,1,
Jefferson,U.S. Senate,Kevin Crow,REP,340001,0,0,1,1,
Jefferson,U.S. Senate,James Lankford,REP,340001,0,6,9,15,
Jefferson,U.S. Senate,Jason Weger,REP,340001,0,0,1,1,
Jefferson,U.S. House,Anna Flatt,REP,340001,0,0,8,8,04
Jefferson,U.S. House,Tom Cole,REP,340001,2,8,23,33,04
Jefferson,Superintendent of Public Instruction,John Cox,DEM,340002,0,5,42,47,
Jefferson,Superintendent of Public Instruction,Jack Jr.,DEM,340002,0,1,3,4,
Jefferson,Superintendent of Public Instruction,Ivan Holmes,DEM,340002,0,0,1,1,
Jefferson,Superintendent of Public Instruction,Freda Deskin,DEM,340002,0,0,2,2,
Jefferson,U.S. Senate,Patrick Michael Hayes,DEM,340002,0,2,16,18,
Jefferson,U.S. Senate,Jim Rogers,DEM,340002,0,3,21,24,
Jefferson,U.S. Senate,Connie Johnson,DEM,340002,0,1,6,7,
Jefferson,U.S. House,Bert Smith,DEM,340002,0,5,34,39,04
Jefferson,U.S. House,Tae Si,DEM,340002,0,0,7,7,04
Jefferson,Governor,Dax Ewbank,REP,340002,1,4,14,19,
Jefferson,Governor,Chad Moody,REP,340002,0,0,5,5,
Jefferson,Governor,Mary Fallin,REP,340002,0,4,5,9,
Jefferson,Superintendent of Public Instruction,Brian Kelly,REP,340002,0,1,4,5,
Jefferson,Superintendent of Public Instruction,Janet Costello Barresi,REP,340002,0,0,2,2,
Jefferson,Superintendent of Public Instruction,Joy Hofmeister,REP,340002,1,7,18,26,
Jefferson,Insurance Commissioner,Bill Viner,REP,340002,0,2,8,10,
Jefferson,Insurance Commissioner,John Doak,REP,340002,1,6,16,23,
Jefferson,Corporation Commissioner,Todd Hiett,REP,340002,0,6,18,24,
Jefferson,Corporation Commissioner,Cliff Branan,REP,340002,1,2,6,9,
Jefferson,U.S. Senate,Evelyn Rogers,REP,340002,0,1,0,1,
Jefferson,U.S. Senate,Rob Moye,REP,340002,0,0,0,0,
Jefferson,U.S. Senate,D. Jean Mcbride-Samuels,REP,340002,0,0,1,1,
Jefferson,U.S. Senate,Jim Inhofe,REP,340002,1,4,17,22,
Jefferson,U.S. Senate,Erick Paul Wyatt,REP,340002,0,3,5,8,
Jefferson,U.S. Senate,Andy Craig,REP,340002,0,0,0,0,
Jefferson,U.S. Senate,T. Shannon,REP,340002,0,3,3,6,
Jefferson,U.S. Senate,Randy Brogdon,REP,340002,0,3,3,6,
Jefferson,U.S. Senate,Eric Mccray,REP,340002,0,0,0,0,
Jefferson,U.S. Senate,Kevin Crow,REP,340002,0,1,0,1,
Jefferson,U.S. Senate,James Lankford,REP,340002,1,1,16,18,
Jefferson,U.S. Senate,Jason Weger,REP,340002,0,0,2,2,
Jefferson,U.S. House,Anna Flatt,REP,340002,0,3,9,12,04
Jefferson,U.S. House,Tom Cole,REP,340002,1,5,15,21,04
Jefferson,Superintendent of Public Instruction,John Cox,DEM,340003,0,3,15,18,
Jefferson,Superintendent of Public Instruction,Jack Jr.,DEM,340003,0,1,3,4,
Jefferson,Superintendent of Public Instruction,Ivan Holmes,DEM,340003,0,0,2,2,
Jefferson,Superintendent of Public Instruction,Freda Deskin,DEM,340003,0,1,3,4,
Jefferson,U.S. Senate,Patrick Michael Hayes,DEM,340003,0,2,9,11,
Jefferson,U.S. Senate,Jim Rogers,DEM,340003,0,1,6,7,
Jefferson,U.S. Senate,Connie Johnson,DEM,340003,0,0,8,8,
Jefferson,U.S. House,Bert Smith,DEM,340003,0,3,18,21,04
Jefferson,U.S. House,Tae Si,DEM,340003,0,0,2,2,04
Jefferson,Governor,Dax Ewbank,REP,340003,0,0,2,2,
Jefferson,Governor,Chad Moody,REP,340003,0,1,1,2,
Jefferson,Governor,Mary Fallin,REP,340003,0,0,8,8,
Jefferson,Superintendent of Public Instruction,Brian Kelly,REP,340003,0,1,3,4,
Jefferson,Superintendent of Public Instruction,Janet Costello Barresi,REP,340003,0,0,2,2,
Jefferson,Superintendent of Public Instruction,Joy Hofmeister,REP,340003,0,0,6,6,
Jefferson,Insurance Commissioner,Bill Viner,REP,340003,0,0,3,3,
Jefferson,Insurance Commissioner,John Doak,REP,340003,0,0,7,7,
Jefferson,Corporation Commissioner,Todd Hiett,REP,340003,0,0,4,4,
Jefferson,Corporation Commissioner,Cliff Branan,REP,340003,0,0,6,6,
Jefferson,U.S. Senate,Evelyn Rogers,REP,340003,0,0,0,0,
Jefferson,U.S. Senate,Rob Moye,REP,340003,0,0,0,0,
Jefferson,U.S. Senate,D. Jean Mcbride-Samuels,REP,340003,0,0,0,0,
Jefferson,U.S. Senate,Jim Inhofe,REP,340003,0,1,10,11,
Jefferson,U.S. Senate,Erick Paul Wyatt,REP,340003,0,0,1,1,
Jefferson,U.S. Senate,Andy Craig,REP,340003,0,1,0,1,
Jefferson,U.S. Senate,T. Shannon,REP,340003,0,0,4,4,
Jefferson,U.S. Senate,Randy Brogdon,REP,340003,0,0,1,1,
Jefferson,U.S. Senate,Eric Mccray,REP,340003,0,0,0,0,
Jefferson,U.S. Senate,Kevin Crow,REP,340003,0,0,0,0,
Jefferson,U.S. Senate,James Lankford,REP,340003,0,0,8,8,
Jefferson,U.S. Senate,Jason Weger,REP,340003,0,0,0,0,
Jefferson,U.S. House,Anna Flatt,REP,340003,0,0,2,2,04
Jefferson,U.S. House,Tom Cole,REP,340003,0,1,9,10,04
Jefferson,Superintendent of Public Instruction,John Cox,DEM,340004,0,0,5,5,
Jefferson,Superintendent of Public Instruction,Jack Jr.,DEM,340004,0,0,4,4,
Jefferson,Superintendent of Public Instruction,Ivan Holmes,DEM,340004,0,0,1,1,
Jefferson,Superintendent of Public Instruction,Freda Deskin,DEM,340004,0,1,1,2,
Jefferson,U.S. Senate,Patrick Michael Hayes,DEM,340004,0,0,2,2,
Jefferson,U.S. Senate,Jim Rogers,DEM,340004,0,0,6,6,
Jefferson,U.S. Senate,Connie Johnson,DEM,340004,1,1,3,5,
Jefferson,U.S. House,Bert Smith,DEM,340004,0,1,11,12,04
Jefferson,U.S. House,Tae Si,DEM,340004,0,0,0,0,04
Jefferson,Governor,Dax Ewbank,REP,340004,0,0,2,2,
Jefferson,Governor,Chad Moody,REP,340004,0,0,0,0,
Jefferson,Governor,Mary Fallin,REP,340004,0,0,4,4,
Jefferson,Superintendent of Public Instruction,Brian Kelly,REP,340004,0,0,3,3,
Jefferson,Superintendent of Public Instruction,Janet Costello Barresi,REP,340004,0,0,0,0,
Jefferson,Superintendent of Public Instruction,Joy Hofmeister,REP,340004,0,0,3,3,
Jefferson,Insurance Commissioner,Bill Viner,REP,340004,0,0,2,2,
Jefferson,Insurance Commissioner,John Doak,REP,340004,0,0,4,4,
Jefferson,Corporation Commissioner,Todd Hiett,REP,340004,0,0,2,2,
Jefferson,Corporation Commissioner,Cliff Branan,REP,340004,0,0,4,4,
Jefferson,U.S. Senate,Evelyn Rogers,REP,340004,0,0,0,0,
Jefferson,U.S. Senate,Rob Moye,REP,340004,0,0,0,0,
Jefferson,U.S. Senate,D. Jean Mcbride-Samuels,REP,340004,0,0,0,0,
Jefferson,U.S. Senate,Jim Inhofe,REP,340004,0,0,6,6,
Jefferson,U.S. Senate,Erick Paul Wyatt,REP,340004,0,0,0,0,
Jefferson,U.S. Senate,Andy Craig,REP,340004,0,0,0,0,
Jefferson,U.S. Senate,T. Shannon,REP,340004,0,0,4,4,
Jefferson,U.S. Senate,Randy Brogdon,REP,340004,0,0,0,0,
Jefferson,U.S. Senate,Eric Mccray,REP,340004,0,0,0,0,
Jefferson,U.S. Senate,Kevin Crow,REP,340004,0,0,0,0,
Jefferson,U.S. Senate,James Lankford,REP,340004,0,0,1,1,
Jefferson,U.S. Senate,Jason Weger,REP,340004,0,0,1,1,
Jefferson,U.S. House,Anna Flatt,REP,340004,0,0,2,2,04
Jefferson,U.S. House,Tom Cole,REP,340004,0,0,4,4,04
Jefferson,Superintendent of Public Instruction,John Cox,DEM,340005,1,0,7,8,
Jefferson,Superintendent of Public Instruction,Jack Jr.,DEM,340005,0,1,7,8,
Jefferson,Superintendent of Public Instruction,Ivan Holmes,DEM,340005,0,0,1,1,
Jefferson,Superintendent of Public Instruction,Freda Deskin,DEM,340005,0,0,1,1,
Jefferson,U.S. Senate,Patrick Michael Hayes,DEM,340005,1,1,3,5,
Jefferson,U.S. Senate,Jim Rogers,DEM,340005,0,0,4,4,
Jefferson,U.S. Senate,Connie Johnson,DEM,340005,0,0,9,9,
Jefferson,U.S. House,Bert Smith,DEM,340005,1,1,15,17,04
Jefferson,U.S. House,Tae Si,DEM,340005,0,0,1,1,04
Jefferson,Governor,Dax Ewbank,REP,340005,0,0,4,4,
Jefferson,Governor,Chad Moody,REP,340005,0,0,2,2,
Jefferson,Governor,Mary Fallin,REP,340005,0,1,3,4,
Jefferson,Superintendent of Public Instruction,Brian Kelly,REP,340005,0,1,3,4,
Jefferson,Superintendent of Public Instruction,Janet Costello Barresi,REP,340005,0,0,1,1,
Jefferson,Superintendent of Public Instruction,Joy Hofmeister,REP,340005,0,0,4,4,
Jefferson,Insurance Commissioner,Bill Viner,REP,340005,0,0,2,2,
Jefferson,Insurance Commissioner,John Doak,REP,340005,0,1,4,5,
Jefferson,Corporation Commissioner,Todd Hiett,REP,340005,0,0,1,1,
Jefferson,Corporation Commissioner,Cliff Branan,REP,340005,0,1,5,6,
Jefferson,U.S. Senate,Evelyn Rogers,REP,340005,0,0,0,0,
Jefferson,U.S. Senate,Rob Moye,REP,340005,0,0,0,0,
Jefferson,U.S. Senate,D. Jean Mcbride-Samuels,REP,340005,0,0,0,0,
Jefferson,U.S. Senate,Jim Inhofe,REP,340005,0,1,8,9,
Jefferson,U.S. Senate,Erick Paul Wyatt,REP,340005,0,0,0,0,
Jefferson,U.S. Senate,Andy Craig,REP,340005,0,0,0,0,
Jefferson,U.S. Senate,T. Shannon,REP,340005,0,1,3,4,
Jefferson,U.S. Senate,Randy Brogdon,REP,340005,0,0,0,0,
Jefferson,U.S. Senate,Eric Mccray,REP,340005,0,0,0,0,
Jefferson,U.S. Senate,Kevin Crow,REP,340005,0,0,1,1,
Jefferson,U.S. Senate,James Lankford,REP,340005,0,0,4,4,
Jefferson,U.S. Senate,Jason Weger,REP,340005,0,0,0,0,
Jefferson,U.S. House,Anna Flatt,REP,340005,0,0,2,2,04
Jefferson,U.S. House,Tom Cole,REP,340005,0,1,5,6,04
Jefferson,Superintendent of Public Instruction,John Cox,DEM,340006,2,4,59,65,
Jefferson,Superintendent of Public Instruction,Jack Jr.,DEM,340006,0,0,24,24,
Jefferson,Superintendent of Public Instruction,Ivan Holmes,DEM,340006,0,0,13,13,
Jefferson,Superintendent of Public Instruction,Freda Deskin,DEM,340006,0,1,24,25,
Jefferson,U.S. Senate,Patrick Michael Hayes,DEM,340006,0,2,33,35,
Jefferson,U.S. Senate,Jim Rogers,DEM,340006,1,2,48,51,
Jefferson,U.S. Senate,Connie Johnson,DEM,340006,1,1,27,29,
Jefferson,U.S. House,Bert Smith,DEM,340006,0,4,98,102,04
Jefferson,U.S. House,Tae Si,DEM,340006,1,0,10,11,04
Jefferson,Governor,Dax Ewbank,REP,340006,0,0,8,8,
Jefferson,Governor,Chad Moody,REP,340006,0,0,9,9,
Jefferson,Governor,Mary Fallin,REP,340006,1,1,18,20,
Jefferson,Superintendent of Public Instruction,Brian Kelly,REP,340006,0,1,5,6,
Jefferson,Superintendent of Public Instruction,Janet Costello Barresi,REP,340006,1,0,3,4,
Jefferson,Superintendent of Public Instruction,Joy Hofmeister,REP,340006,1,0,26,27,
Jefferson,Insurance Commissioner,Bill Viner,REP,340006,0,0,7,7,
Jefferson,Insurance Commissioner,John Doak,REP,340006,1,1,26,28,
Jefferson,Corporation Commissioner,Todd Hiett,REP,340006,1,1,20,22,
Jefferson,Corporation Commissioner,Cliff Branan,REP,340006,0,0,12,12,
Jefferson,U.S. Senate,Evelyn Rogers,REP,340006,0,0,2,2,
Jefferson,U.S. Senate,Rob Moye,REP,340006,0,0,2,2,
Jefferson,U.S. Senate,D. Jean Mcbride-Samuels,REP,340006,1,0,0,1,
Jefferson,U.S. Senate,Jim Inhofe,REP,340006,1,1,28,30,
Jefferson,U.S. Senate,Erick Paul Wyatt,REP,340006,0,0,2,2,
Jefferson,U.S. Senate,Andy Craig,REP,340006,0,0,1,1,
Jefferson,U.S. Senate,T. Shannon,REP,340006,1,2,20,23,
Jefferson,U.S. Senate,Randy Brogdon,REP,340006,0,0,3,3,
Jefferson,U.S. Senate,Eric Mccray,REP,340006,0,0,1,1,
Jefferson,U.S. Senate,Kevin Crow,REP,340006,1,0,1,2,
Jefferson,U.S. Senate,James Lankford,REP,340006,0,0,8,8,
Jefferson,U.S. Senate,Jason Weger,REP,340006,0,0,0,0,
Jefferson,U.S. House,Anna Flatt,REP,340006,1,1,7,9,04
Jefferson,U.S. House,Tom Cole,REP,340006,1,0,28,29,04
Jefferson,Superintendent of Public Instruction,John Cox,DEM,340007,1,1,50,52,
Jefferson,Superintendent of Public Instruction,Jack Jr.,DEM,340007,0,0,14,14,
Jefferson,Superintendent of Public Instruction,Ivan Holmes,DEM,340007,0,0,3,3,
Jefferson,Superintendent of Public Instruction,Freda Deskin,DEM,340007,0,0,22,22,
Jefferson,U.S. Senate,Patrick Michael Hayes,DEM,340007,0,0,20,20,
Jefferson,U.S. Senate,Jim Rogers,DEM,340007,0,1,29,30,
Jefferson,U.S. Senate,Connie Johnson,DEM,340007,1,0,34,35,
Jefferson,U.S. House,Bert Smith,DEM,340007,3,1,78,82,04
Jefferson,U.S. House,Tae Si,DEM,340007,0,0,4,4,04
Jefferson,Governor,Dax Ewbank,REP,340007,0,0,0,0,
Jefferson,Governor,Chad Moody,REP,340007,0,1,4,5,
Jefferson,Governor,Mary Fallin,REP,340007,0,0,13,13,
Jefferson,Superintendent of Public Instruction,Brian Kelly,REP,340007,0,0,8,8,
Jefferson,Superintendent of Public Instruction,Janet Costello Barresi,REP,340007,0,0,4,4,
Jefferson,Superintendent of Public Instruction,Joy Hofmeister,REP,340007,0,0,4,4,
Jefferson,Insurance Commissioner,Bill Viner,REP,340007,0,0,5,5,
Jefferson,Insurance Commissioner,John Doak,REP,340007,0,1,9,10,
Jefferson,Corporation Commissioner,Todd Hiett,REP,340007,0,0,5,5,
Jefferson,Corporation Commissioner,Cliff Branan,REP,340007,0,0,9,9,
Jefferson,U.S. Senate,Evelyn Rogers,REP,340007,0,0,2,2,
Jefferson,U.S. Senate,Rob Moye,REP,340007,0,0,1,1,
Jefferson,U.S. Senate,D. Jean Mcbride-Samuels,REP,340007,0,0,0,0,
Jefferson,U.S. Senate,Jim Inhofe,REP,340007,0,1,11,12,
Jefferson,U.S. Senate,Erick Paul Wyatt,REP,340007,0,0,2,2,
Jefferson,U.S. Senate,Andy Craig,REP,340007,0,0,2,2,
Jefferson,U.S. Senate,T. Shannon,REP,340007,0,0,5,5,
Jefferson,U.S. Senate,Randy Brogdon,REP,340007,0,0,0,0,
Jefferson,U.S. Senate,Eric Mccray,REP,340007,0,0,0,0,
Jefferson,U.S. Senate,Kevin Crow,REP,340007,0,0,2,2,
Jefferson,U.S. Senate,James Lankford,REP,340007,0,1,7,8,
Jefferson,U.S. Senate,Jason Weger,REP,340007,0,0,1,1,
Jefferson,U.S. House,Anna Flatt,REP,340007,0,0,4,4,04
Jefferson,U.S. House,Tom Cole,REP,340007,0,1,13,14,04
Jefferson,Superintendent of Public Instruction,John Cox,DEM,340008,0,0,5,5,
Jefferson,Superintendent of Public Instruction,Jack Jr.,DEM,340008,0,0,0,0,
Jefferson,Superintendent of Public Instruction,Ivan Holmes,DEM,340008,0,0,0,0,
Jefferson,Superintendent of Public Instruction,Freda Deskin,DEM,340008,0,0,1,1,
Jefferson,U.S. Senate,Patrick Michael Hayes,DEM,340008,0,0,1,1,
Jefferson,U.S. Senate,Jim Rogers,DEM,340008,0,0,2,2,
Jefferson,U.S. Senate,Connie Johnson,DEM,340008,0,0,2,2,
Jefferson,U.S. House,Bert Smith,DEM,340008,0,0,5,5,04
Jefferson,U.S. House,Tae Si,DEM,340008,0,0,0,0,04
Jefferson,Governor,Dax Ewbank,REP,340008,0,0,2,2,
Jefferson,Governor,Chad Moody,REP,340008,0,0,0,0,
Jefferson,Governor,Mary Fallin,REP,340008,0,0,4,4,
Jefferson,Superintendent of Public Instruction,Brian Kelly,REP,340008,0,0,0,0,
Jefferson,Superintendent of Public Instruction,Janet Costello Barresi,REP,340008,0,0,2,2,
Jefferson,Superintendent of Public Instruction,Joy Hofmeister,REP,340008,0,0,4,4,
Jefferson,Insurance Commissioner,Bill Viner,REP,340008,0,0,0,0,
Jefferson,Insurance Commissioner,John Doak,REP,340008,0,0,6,6,
Jefferson,Corporation Commissioner,Todd Hiett,REP,340008,0,0,3,3,
Jefferson,Corporation Commissioner,Cliff Branan,REP,340008,0,0,3,3,
Jefferson,U.S. Senate,Evelyn Rogers,REP,340008,0,0,0,0,
Jefferson,U.S. Senate,Rob Moye,REP,340008,0,0,0,0,
Jefferson,U.S. Senate,D. Jean Mcbride-Samuels,REP,340008,0,0,0,0,
Jefferson,U.S. Senate,Jim Inhofe,REP,340008,0,0,6,6,
Jefferson,U.S. Senate,Erick Paul Wyatt,REP,340008,0,0,0,0,
Jefferson,U.S. Senate,Andy Craig,REP,340008,0,0,0,0,
Jefferson,U.S. Senate,T. Shannon,REP,340008,0,0,2,2,
Jefferson,U.S. Senate,Randy Brogdon,REP,340008,0,0,0,0,
Jefferson,U.S. Senate,Eric Mccray,REP,340008,0,0,0,0,
Jefferson,U.S. Senate,Kevin Crow,REP,340008,0,0,0,0,
Jefferson,U.S. Senate,James Lankford,REP,340008,0,0,4,4,
Jefferson,U.S. Senate,Jason Weger,REP,340008,0,0,0,0,
Jefferson,U.S. House,Anna Flatt,REP,340008,0,0,0,0,04
Jefferson,U.S. House,Tom Cole,REP,340008,0,0,5,5,04
Jefferson,Superintendent of Public Instruction,John Cox,DEM,340009,0,0,67,67,
Jefferson,Superintendent of Public Instruction,Jack Jr.,DEM,340009,0,0,15,15,
Jefferson,Superintendent of Public Instruction,Ivan Holmes,DEM,340009,0,0,6,6,
Jefferson,Superintendent of Public Instruction,Freda Deskin,DEM,340009,0,0,27,27,
Jefferson,U.S. Senate,Patrick Michael Hayes,DEM,340009,0,0,32,32,
Jefferson,U.S. Senate,Jim Rogers,DEM,340009,0,0,49,49,
Jefferson,U.S. Senate,Connie Johnson,DEM,340009,0,0,32,32,
Jefferson,U.S. House,Bert Smith,DEM,340009,0,0,105,105,04
Jefferson,U.S. House,Tae Si,DEM,340009,0,0,9,9,04
Jefferson,Governor,Dax Ewbank,REP,340009,0,1,2,3,
Jefferson,Governor,Chad Moody,REP,340009,0,0,10,10,
Jefferson,Governor,Mary Fallin,REP,340009,0,4,21,25,
Jefferson,Superintendent of Public Instruction,Brian Kelly,REP,340009,0,2,5,7,
Jefferson,Superintendent of Public Instruction,Janet Costello Barresi,REP,340009,0,0,3,3,
Jefferson,Superintendent of Public Instruction,Joy Hofmeister,REP,340009,0,3,24,27,
Jefferson,Insurance Commissioner,Bill Viner,REP,340009,0,0,11,11,
Jefferson,Insurance Commissioner,John Doak,REP,340009,0,5,17,22,
Jefferson,Corporation Commissioner,Todd Hiett,REP,340009,0,3,20,23,
Jefferson,Corporation Commissioner,Cliff Branan,REP,340009,0,2,9,11,
Jefferson,U.S. Senate,Evelyn Rogers,REP,340009,0,0,0,0,
Jefferson,U.S. Senate,Rob Moye,REP,340009,0,0,0,0,
Jefferson,U.S. Senate,D. Jean Mcbride-Samuels,REP,340009,0,0,0,0,
Jefferson,U.S. Senate,Jim Inhofe,REP,340009,0,5,29,34,
Jefferson,U.S. Senate,Erick Paul Wyatt,REP,340009,0,0,2,2,
Jefferson,U.S. Senate,Andy Craig,REP,340009,0,0,1,1,
Jefferson,U.S. Senate,T. Shannon,REP,340009,0,1,14,15,
Jefferson,U.S. Senate,Randy Brogdon,REP,340009,0,0,0,0,
Jefferson,U.S. Senate,Eric Mccray,REP,340009,0,1,0,1,
Jefferson,U.S. Senate,Kevin Crow,REP,340009,0,0,0,0,
Jefferson,U.S. Senate,James Lankford,REP,340009,0,3,16,19,
Jefferson,U.S. Senate,Jason Weger,REP,340009,0,0,0,0,
Jefferson,U.S. House,Anna Flatt,REP,340009,0,0,2,2,04
Jefferson,U.S. House,Tom Cole,REP,340009,0,5,30,35,04
Jefferson,Superintendent of Public Instruction,John Cox,DEM,340010,0,0,8,8,
Jefferson,Superintendent of Public Instruction,Jack Jr.,DEM,340010,0,0,3,3,
Jefferson,Superintendent of Public Instruction,Ivan Holmes,DEM,340010,0,0,0,0,
Jefferson,Superintendent of Public Instruction,Freda Deskin,DEM,340010,0,0,1,1,
Jefferson,U.S. Senate,Patrick Michael Hayes,DEM,340010,0,0,2,2,
Jefferson,U.S. Senate,Jim Rogers,DEM,340010,0,0,7,7,
Jefferson,U.S. Senate,Connie Johnson,DEM,340010,0,0,3,3,
Jefferson,U.S. House,Bert Smith,DEM,340010,0,0,12,12,04
Jefferson,U.S. House,Tae Si,DEM,340010,0,0,0,0,04
Jefferson,Governor,Dax Ewbank,REP,340010,0,0,0,0,
Jefferson,Governor,Chad Moody,REP,340010,0,0,0,0,
Jefferson,Governor,Mary Fallin,REP,340010,0,0,6,6,
Jefferson,Superintendent of Public Instruction,Brian Kelly,REP,340010,0,0,1,1,
Jefferson,Superintendent of Public Instruction,Janet Costello Barresi,REP,340010,0,0,3,3,
Jefferson,Superintendent of Public Instruction,Joy Hofmeister,REP,340010,0,0,1,1,
Jefferson,Insurance Commissioner,Bill Viner,REP,340010,0,0,1,1,
Jefferson,Insurance Commissioner,John Doak,REP,340010,0,0,4,4,
Jefferson,Corporation Commissioner,Todd Hiett,REP,340010,0,0,2,2,
Jefferson,Corporation Commissioner,Cliff Branan,REP,340010,0,0,2,2,
Jefferson,U.S. Senate,Evelyn Rogers,REP,340010,0,0,0,0,
Jefferson,U.S. Senate,Rob Moye,REP,340010,0,0,0,0,
Jefferson,U.S. Senate,D. Jean Mcbride-Samuels,REP,340010,0,0,1,1,
Jefferson,U.S. Senate,Jim Inhofe,REP,340010,0,0,5,5,
Jefferson,U.S. Senate,Erick Paul Wyatt,REP,340010,0,0,0,0,
Jefferson,U.S. Senate,Andy Craig,REP,340010,0,0,0,0,
Jefferson,U.S. Senate,T. Shannon,REP,340010,0,0,2,2,
Jefferson,U.S. Senate,Randy Brogdon,REP,340010,0,0,0,0,
Jefferson,U.S. Senate,Eric Mccray,REP,340010,0,0,0,0,
Jefferson,U.S. Senate,Kevin Crow,REP,340010,0,0,0,0,
Jefferson,U.S. Senate,James Lankford,REP,340010,0,0,3,3,
Jefferson,U.S. Senate,Jason Weger,REP,340010,0,0,0,0,
Jefferson,U.S. House,Anna Flatt,REP,340010,0,0,1,1,04
Jefferson,U.S. House,Tom Cole,REP,340010,0,0,5,5,04
Johnston,Superintendent of Public Instruction,John Cox,DEM,350001,0,0,25,25,
Johnston,Superintendent of Public Instruction,Jack Jr.,DEM,350001,0,1,1,2,
Johnston,Superintendent of Public Instruction,Ivan Holmes,DEM,350001,0,0,2,2,
Johnston,Superintendent of Public Instruction,Freda Deskin,DEM,350001,0,1,12,13,
Johnston,U.S. Senate,Patrick Michael Hayes,DEM,350001,0,0,14,14,
Johnston,U.S. Senate,Jim Rogers,DEM,350001,0,1,15,16,
Johnston,U.S. Senate,Connie Johnson,DEM,350001,0,1,11,12,
Johnston,U.S. House,Earl Everett,DEM,350001,0,1,24,25,02
Johnston,U.S. House,Joshua Harris-Till,DEM,350001,0,1,15,16,02
Johnston,Governor,Dax Ewbank,REP,350001,0,1,5,6,
Johnston,Governor,Chad Moody,REP,350001,0,1,4,5,
Johnston,Governor,Mary Fallin,REP,350001,0,3,23,26,
Johnston,Superintendent of Public Instruction,Brian Kelly,REP,350001,0,0,8,8,
Johnston,Superintendent of Public Instruction,Janet Costello Barresi,REP,350001,0,2,5,7,
Johnston,Superintendent of Public Instruction,Joy Hofmeister,REP,350001,0,3,18,21,
Johnston,Insurance Commissioner,Bill Viner,REP,350001,0,2,9,11,
Johnston,Insurance Commissioner,John Doak,REP,350001,0,3,21,24,
Johnston,Corporation Commissioner,Todd Hiett,REP,350001,0,4,19,23,
Johnston,Corporation Commissioner,Cliff Branan,REP,350001,0,0,12,12,
Johnston,U.S. Senate,Evelyn Rogers,REP,350001,0,0,1,1,
Johnston,U.S. Senate,Rob Moye,REP,350001,0,0,0,0,
Johnston,U.S. Senate,D. Jean Mcbride-Samuels,REP,350001,0,0,1,1,
Johnston,U.S. Senate,Jim Inhofe,REP,350001,0,5,28,33,
Johnston,U.S. Senate,Erick Paul Wyatt,REP,350001,0,0,1,1,
Johnston,U.S. Senate,Andy Craig,REP,350001,0,0,0,0,
Johnston,U.S. Senate,T. Shannon,REP,350001,0,1,9,10,
Johnston,U.S. Senate,Randy Brogdon,REP,350001,0,0,2,2,
Johnston,U.S. Senate,Eric Mccray,REP,350001,0,0,1,1,
Johnston,U.S. Senate,Kevin Crow,REP,350001,0,0,1,1,
Johnston,U.S. Senate,James Lankford,REP,350001,0,4,19,23,
Johnston,U.S. Senate,Jason Weger,REP,350001,0,0,0,0,
Johnston,U.S. House,Darrel Robertson,REP,350001,0,0,15,15,02
Johnston,U.S. House,Markwayne Mullin,REP,350001,0,4,17,21,02
Johnston,Superintendent of Public Instruction,John Cox,DEM,350002,0,1,16,17,
Johnston,Superintendent of Public Instruction,Jack Jr.,DEM,350002,0,0,5,5,
Johnston,Superintendent of Public Instruction,Ivan Holmes,DEM,350002,0,0,3,3,
Johnston,Superintendent of Public Instruction,Freda Deskin,DEM,350002,0,1,12,13,
Johnston,U.S. Senate,Patrick Michael Hayes,DEM,350002,0,0,11,11,
Johnston,U.S. Senate,Jim Rogers,DEM,350002,0,1,12,13,
Johnston,U.S. Senate,Connie Johnson,DEM,350002,0,1,12,13,
Johnston,U.S. House,Earl Everett,DEM,350002,0,0,17,17,02
Johnston,U.S. House,Joshua Harris-Till,DEM,350002,0,2,16,18,02
Johnston,Governor,Dax Ewbank,REP,350002,0,0,1,1,
Johnston,Governor,Chad Moody,REP,350002,0,0,6,6,
Johnston,Governor,Mary Fallin,REP,350002,2,1,13,16,
Johnston,Superintendent of Public Instruction,Brian Kelly,REP,350002,0,0,5,5,
Johnston,Superintendent of Public Instruction,Janet Costello Barresi,REP,350002,0,0,0,0,
Johnston,Superintendent of Public Instruction,Joy Hofmeister,REP,350002,2,1,15,18,
Johnston,Insurance Commissioner,Bill Viner,REP,350002,0,0,7,7,
Johnston,Insurance Commissioner,John Doak,REP,350002,2,1,12,15,
Johnston,Corporation Commissioner,Todd Hiett,REP,350002,0,0,9,9,
Johnston,Corporation Commissioner,Cliff Branan,REP,350002,2,1,11,14,
Johnston,U.S. Senate,Evelyn Rogers,REP,350002,0,0,1,1,
Johnston,U.S. Senate,Rob Moye,REP,350002,0,0,0,0,
Johnston,U.S. Senate,D. Jean Mcbride-Samuels,REP,350002,0,0,0,0,
Johnston,U.S. Senate,Jim Inhofe,REP,350002,2,1,19,22,
Johnston,U.S. Senate,Erick Paul Wyatt,REP,350002,0,0,0,0,
Johnston,U.S. Senate,Andy Craig,REP,350002,0,0,1,1,
Johnston,U.S. Senate,T. Shannon,REP,350002,2,1,5,8,
Johnston,U.S. Senate,Randy Brogdon,REP,350002,0,0,1,1,
Johnston,U.S. Senate,Eric Mccray,REP,350002,0,0,0,0,
Johnston,U.S. Senate,Kevin Crow,REP,350002,0,0,0,0,
Johnston,U.S. Senate,James Lankford,REP,350002,0,0,11,11,
Johnston,U.S. Senate,Jason Weger,REP,350002,0,0,2,2,
Johnston,U.S. House,Darrel Robertson,REP,350002,0,0,10,10,02
Johnston,U.S. House,Markwayne Mullin,REP,350002,2,1,10,13,02
Johnston,Superintendent of Public Instruction,John Cox,DEM,350003,0,1,11,12,
Johnston,Superintendent of Public Instruction,Jack Jr.,DEM,350003,0,1,1,2,
Johnston,Superintendent of Public Instruction,Ivan Holmes,DEM,350003,0,0,2,2,
Johnston,Superintendent of Public Instruction,Freda Deskin,DEM,350003,1,0,11,12,
Johnston,U.S. Senate,Patrick Michael Hayes,DEM,350003,0,0,8,8,
Johnston,U.S. Senate,Jim Rogers,DEM,350003,0,2,8,10,
Johnston,U.S. Senate,Connie Johnson,DEM,350003,1,0,9,10,
Johnston,U.S. House,Earl Everett,DEM,350003,0,1,13,14,02
Johnston,U.S. House,Joshua Harris-Till,DEM,350003,1,1,10,12,02
Johnston,Governor,Dax Ewbank,REP,350003,0,0,0,0,
Johnston,Governor,Chad Moody,REP,350003,0,0,8,8,
Johnston,Governor,Mary Fallin,REP,350003,0,2,7,9,
Johnston,Superintendent of Public Instruction,Brian Kelly,REP,350003,0,1,3,4,
Johnston,Superintendent of Public Instruction,Janet Costello Barresi,REP,350003,0,0,2,2,
Johnston,Superintendent of Public Instruction,Joy Hofmeister,REP,350003,0,1,10,11,
Johnston,Insurance Commissioner,Bill Viner,REP,350003,0,1,6,7,
Johnston,Insurance Commissioner,John Doak,REP,350003,0,1,9,10,
Johnston,Corporation Commissioner,Todd Hiett,REP,350003,0,1,8,9,
Johnston,Corporation Commissioner,Cliff Branan,REP,350003,0,1,5,6,
Johnston,U.S. Senate,Evelyn Rogers,REP,350003,0,0,0,0,
Johnston,U.S. Senate,Rob Moye,REP,350003,0,1,0,1,
Johnston,U.S. Senate,D. Jean Mcbride-Samuels,REP,350003,0,0,0,0,
Johnston,U.S. Senate,Jim Inhofe,REP,350003,0,1,15,16,
Johnston,U.S. Senate,Erick Paul Wyatt,REP,350003,0,0,0,0,
Johnston,U.S. Senate,Andy Craig,REP,350003,0,0,0,0,
Johnston,U.S. Senate,T. Shannon,REP,350003,0,1,7,8,
Johnston,U.S. Senate,Randy Brogdon,REP,350003,0,0,2,2,
Johnston,U.S. Senate,Eric Mccray,REP,350003,0,0,0,0,
Johnston,U.S. Senate,Kevin Crow,REP,350003,0,1,1,2,
Johnston,U.S. Senate,James Lankford,REP,350003,0,0,4,4,
Johnston,U.S. Senate,Jason Weger,REP,350003,0,0,1,1,
Johnston,U.S. House,Darrel Robertson,REP,350003,0,0,6,6,02
Johnston,U.S. House,Markwayne Mullin,REP,350003,0,2,10,12,02
Johnston,Superintendent of Public Instruction,John Cox,DEM,350004,3,6,29,38,
Johnston,Superintendent of Public Instruction,Jack Jr.,DEM,350004,0,1,5,6,
Johnston,Superintendent of Public Instruction,Ivan Holmes,DEM,350004,0,3,4,7,
Johnston,Superintendent of Public Instruction,Freda Deskin,DEM,350004,3,8,26,37,
Johnston,U.S. Senate,Patrick Michael Hayes,DEM,350004,0,1,13,14,
Johnston,U.S. Senate,Jim Rogers,DEM,350004,2,8,34,44,
Johnston,U.S. Senate,Connie Johnson,DEM,350004,4,9,13,26,
Johnston,U.S. House,Earl Everett,DEM,350004,2,9,40,51,02
Johnston,U.S. House,Joshua Harris-Till,DEM,350004,3,8,19,30,02
Johnston,Governor,Dax Ewbank,REP,350004,0,2,4,6,
Johnston,Governor,Chad Moody,REP,350004,0,3,12,15,
Johnston,Governor,Mary Fallin,REP,350004,3,2,37,42,
Johnston,Superintendent of Public Instruction,Brian Kelly,REP,350004,2,4,10,16,
Johnston,Superintendent of Public Instruction,Janet Costello Barresi,REP,350004,0,1,4,5,
Johnston,Superintendent of Public Instruction,Joy Hofmeister,REP,350004,1,2,37,40,
Johnston,Insurance Commissioner,Bill Viner,REP,350004,0,5,13,18,
Johnston,Insurance Commissioner,John Doak,REP,350004,3,1,37,41,
Johnston,Corporation Commissioner,Todd Hiett,REP,350004,3,5,27,35,
Johnston,Corporation Commissioner,Cliff Branan,REP,350004,0,2,21,23,
Johnston,U.S. Senate,Evelyn Rogers,REP,350004,0,1,3,4,
Johnston,U.S. Senate,Rob Moye,REP,350004,0,0,2,2,
Johnston,U.S. Senate,D. Jean Mcbride-Samuels,REP,350004,0,0,1,1,
Johnston,U.S. Senate,Jim Inhofe,REP,350004,3,4,41,48,
Johnston,U.S. Senate,Erick Paul Wyatt,REP,350004,0,2,5,7,
Johnston,U.S. Senate,Andy Craig,REP,350004,0,1,2,3,
Johnston,U.S. Senate,T. Shannon,REP,350004,1,3,20,24,
Johnston,U.S. Senate,Randy Brogdon,REP,350004,0,0,2,2,
Johnston,U.S. Senate,Eric Mccray,REP,350004,0,0,1,1,
Johnston,U.S. Senate,Kevin Crow,REP,350004,0,0,1,1,
Johnston,U.S. Senate,James Lankford,REP,350004,2,2,26,30,
Johnston,U.S. Senate,Jason Weger,REP,350004,0,0,0,0,
Johnston,U.S. House,Darrel Robertson,REP,350004,0,3,17,20,02
Johnston,U.S. House,Markwayne Mullin,REP,350004,3,4,34,41,02
Johnston,Superintendent of Public Instruction,John Cox,DEM,350005,0,0,29,29,
Johnston,Superintendent of Public Instruction,Jack Jr.,DEM,350005,0,0,18,18,
Johnston,Superintendent of Public Instruction,Ivan Holmes,DEM,350005,0,0,8,8,
Johnston,Superintendent of Public Instruction,Freda Deskin,DEM,350005,0,1,27,28,
Johnston,U.S. Senate,Patrick Michael Hayes,DEM,350005,0,0,17,17,
Johnston,U.S. Senate,Jim Rogers,DEM,350005,0,1,39,40,
Johnston,U.S. Senate,Connie Johnson,DEM,350005,0,0,19,19,
Johnston,U.S. House,Earl Everett,DEM,350005,0,1,37,38,02
Johnston,U.S. House,Joshua Harris-Till,DEM,350005,0,0,36,36,02
Johnston,Governor,Dax Ewbank,REP,350005,0,1,5,6,
Johnston,Governor,Chad Moody,REP,350005,0,0,4,4,
Johnston,Governor,Mary Fallin,REP,350005,0,2,21,23,
Johnston,Superintendent of Public Instruction,Brian Kelly,REP,350005,0,1,11,12,
Johnston,Superintendent of Public Instruction,Janet Costello Barresi,REP,350005,0,1,8,9,
Johnston,Superintendent of Public Instruction,Joy Hofmeister,REP,350005,0,1,11,12,
Johnston,Insurance Commissioner,Bill Viner,REP,350005,0,0,11,11,
Johnston,Insurance Commissioner,John Doak,REP,350005,0,3,17,20,
Johnston,Corporation Commissioner,Todd Hiett,REP,350005,0,2,18,20,
Johnston,Corporation Commissioner,Cliff Branan,REP,350005,0,1,9,10,
Johnston,U.S. Senate,Evelyn Rogers,REP,350005,0,0,2,2,
Johnston,U.S. Senate,Rob Moye,REP,350005,0,0,0,0,
Johnston,U.S. Senate,D. Jean Mcbride-Samuels,REP,350005,0,0,0,0,
Johnston,U.S. Senate,Jim Inhofe,REP,350005,0,3,26,29,
Johnston,U.S. Senate,Erick Paul Wyatt,REP,350005,0,0,2,2,
Johnston,U.S. Senate,Andy Craig,REP,350005,0,0,1,1,
Johnston,U.S. Senate,T. Shannon,REP,350005,0,1,21,22,
Johnston,U.S. Senate,Randy Brogdon,REP,350005,0,2,2,4,
Johnston,U.S. Senate,Eric Mccray,REP,350005,0,0,0,0,
Johnston,U.S. Senate,Kevin Crow,REP,350005,0,0,0,0,
Johnston,U.S. Senate,James Lankford,REP,350005,0,0,6,6,
Johnston,U.S. Senate,Jason Weger,REP,350005,0,0,0,0,
Johnston,U.S. House,Darrel Robertson,REP,350005,0,2,9,11,02
Johnston,U.S. House,Markwayne Mullin,REP,350005,0,1,19,20,02
Johnston,Superintendent of Public Instruction,John Cox,DEM,350006,0,0,17,17,
Johnston,Superintendent of Public Instruction,Jack Jr.,DEM,350006,0,0,5,5,
Johnston,Superintendent of Public Instruction,Ivan Holmes,DEM,350006,0,0,3,3,
Johnston,Superintendent of Public Instruction,Freda Deskin,DEM,350006,0,1,14,15,
Johnston,U.S. Senate,Patrick Michael Hayes,DEM,350006,0,1,10,11,
Johnston,U.S. Senate,Jim Rogers,DEM,350006,0,0,18,18,
Johnston,U.S. Senate,Connie Johnson,DEM,350006,0,0,11,11,
Johnston,U.S. House,Earl Everett,DEM,350006,0,0,19,19,02
Johnston,U.S. House,Joshua Harris-Till,DEM,350006,0,1,20,21,02
Johnston,Governor,Dax Ewbank,REP,350006,0,0,1,1,
Johnston,Governor,Chad Moody,REP,350006,0,0,4,4,
Johnston,Governor,Mary Fallin,REP,350006,0,0,8,8,
Johnston,Superintendent of Public Instruction,Brian Kelly,REP,350006,0,0,4,4,
Johnston,Superintendent of Public Instruction,Janet Costello Barresi,REP,350006,0,0,0,0,
Johnston,Superintendent of Public Instruction,Joy Hofmeister,REP,350006,0,0,9,9,
Johnston,Insurance Commissioner,Bill Viner,REP,350006,0,0,7,7,
Johnston,Insurance Commissioner,John Doak,REP,350006,0,0,6,6,
Johnston,Corporation Commissioner,Todd Hiett,REP,350006,0,0,3,3,
Johnston,Corporation Commissioner,Cliff Branan,REP,350006,0,0,9,9,
Johnston,U.S. Senate,Evelyn Rogers,REP,350006,0,0,4,4,
Johnston,U.S. Senate,Rob Moye,REP,350006,0,0,1,1,
Johnston,U.S. Senate,D. Jean Mcbride-Samuels,REP,350006,0,0,0,0,
Johnston,U.S. Senate,Jim Inhofe,REP,350006,0,0,8,8,
Johnston,U.S. Senate,Erick Paul Wyatt,REP,350006,0,0,0,0,
Johnston,U.S. Senate,Andy Craig,REP,350006,0,0,0,0,
Johnston,U.S. Senate,T. Shannon,REP,350006,0,0,6,6,
Johnston,U.S. Senate,Randy Brogdon,REP,350006,0,0,0,0,
Johnston,U.S. Senate,Eric Mccray,REP,350006,0,0,0,0,
Johnston,U.S. Senate,Kevin Crow,REP,350006,0,0,0,0,
Johnston,U.S. Senate,James Lankford,REP,350006,0,0,7,7,
Johnston,U.S. Senate,Jason Weger,REP,350006,0,0,0,0,
Johnston,U.S. House,Darrel Robertson,REP,350006,0,0,0,0,02
Johnston,U.S. House,Markwayne Mullin,REP,350006,0,0,12,12,02
Johnston,Superintendent of Public Instruction,John Cox,DEM,350007,0,0,0,0,
Johnston,Superintendent of Public Instruction,Jack Jr.,DEM,350007,0,0,0,0,
Johnston,Superintendent of Public Instruction,Ivan Holmes,DEM,350007,0,0,0,0,
Johnston,Superintendent of Public Instruction,Freda Deskin,DEM,350007,0,0,0,0,
Johnston,U.S. Senate,Patrick Michael Hayes,DEM,350007,0,0,0,0,
Johnston,U.S. Senate,Jim Rogers,DEM,350007,0,0,0,0,
Johnston,U.S. Senate,Connie Johnson,DEM,350007,0,0,0,0,
Johnston,U.S. House,Earl Everett,DEM,350007,0,0,0,0,02
Johnston,U.S. House,Joshua Harris-Till,DEM,350007,0,0,0,0,02
Johnston,Governor,Dax Ewbank,REP,350007,0,0,0,0,
Johnston,Governor,Chad Moody,REP,350007,0,0,1,1,
Johnston,Governor,Mary Fallin,REP,350007,0,0,1,1,
Johnston,Superintendent of Public Instruction,Brian Kelly,REP,350007,0,0,0,0,
Johnston,Superintendent of Public Instruction,Janet Costello Barresi,REP,350007,0,0,2,2,
Johnston,Superintendent of Public Instruction,Joy Hofmeister,REP,350007,0,0,0,0,
Johnston,Insurance Commissioner,Bill Viner,REP,350007,0,0,2,2,
Johnston,Insurance Commissioner,John Doak,REP,350007,0,0,0,0,
Johnston,Corporation Commissioner,Todd Hiett,REP,350007,0,0,1,1,
Johnston,Corporation Commissioner,Cliff Branan,REP,350007,0,0,0,0,
Johnston,U.S. Senate,Evelyn Rogers,REP,350007,0,0,0,0,
Johnston,U.S. Senate,Rob Moye,REP,350007,0,0,0,0,
Johnston,U.S. Senate,D. Jean Mcbride-Samuels,REP,350007,0,0,0,0,
Johnston,U.S. Senate,Jim Inhofe,REP,350007,0,0,2,2,
Johnston,U.S. Senate,Erick Paul Wyatt,REP,350007,0,0,0,0,
Johnston,U.S. Senate,Andy Craig,REP,350007,0,0,0,0,
Johnston,U.S. Senate,T. Shannon,REP,350007,0,0,2,2,
Johnston,U.S. Senate,Randy Brogdon,REP,350007,0,0,0,0,
Johnston,U.S. Senate,Eric Mccray,REP,350007,0,0,0,0,
Johnston,U.S. Senate,Kevin Crow,REP,350007,0,0,0,0,
Johnston,U.S. Senate,James Lankford,REP,350007,0,0,0,0,
Johnston,U.S. Senate,Jason Weger,REP,350007,0,0,0,0,
Johnston,U.S. House,Darrel Robertson,REP,350007,0,0,0,0,02
Johnston,U.S. House,Markwayne Mullin,REP,350007,0,0,2,2,02
Johnston,Superintendent of Public Instruction,John Cox,DEM,350008,0,0,14,14,
Johnston,Superintendent of Public Instruction,Jack Jr.,DEM,350008,0,0,11,11,
Johnston,Superintendent of Public Instruction,Ivan Holmes,DEM,350008,0,0,3,3,
Johnston,Superintendent of Public Instruction,Freda Deskin,DEM,350008,0,0,24,24,
Johnston,U.S. Senate,Patrick Michael Hayes,DEM,350008,0,0,15,15,
Johnston,U.S. Senate,Jim Rogers,DEM,350008,0,0,22,22,
Johnston,U.S. Senate,Connie Johnson,DEM,350008,0,0,12,12,
Johnston,U.S. House,Earl Everett,DEM,350008,0,0,24,24,02
Johnston,U.S. House,Joshua Harris-Till,DEM,350008,0,0,25,25,02
Johnston,Governor,Dax Ewbank,REP,350008,0,0,1,1,
Johnston,Governor,Chad Moody,REP,350008,0,0,1,1,
Johnston,Governor,Mary Fallin,REP,350008,0,0,9,9,
Johnston,Superintendent of Public Instruction,Brian Kelly,REP,350008,0,0,4,4,
Johnston,Superintendent of Public Instruction,Janet Costello Barresi,REP,350008,0,0,3,3,
Johnston,Superintendent of Public Instruction,Joy Hofmeister,REP,350008,0,0,3,3,
Johnston,Insurance Commissioner,Bill Viner,REP,350008,0,0,2,2,
Johnston,Insurance Commissioner,John Doak,REP,350008,0,0,8,8,
Johnston,Corporation Commissioner,Todd Hiett,REP,350008,0,0,6,6,
Johnston,Corporation Commissioner,Cliff Branan,REP,350008,0,0,4,4,
Johnston,U.S. Senate,Evelyn Rogers,REP,350008,0,0,0,0,
Johnston,U.S. Senate,Rob Moye,REP,350008,0,0,0,0,
Johnston,U.S. Senate,D. Jean Mcbride-Samuels,REP,350008,0,0,0,0,
Johnston,U.S. Senate,Jim Inhofe,REP,350008,0,0,9,9,
Johnston,U.S. Senate,Erick Paul Wyatt,REP,350008,0,0,1,1,
Johnston,U.S. Senate,Andy Craig,REP,350008,0,0,0,0,
Johnston,U.S. Senate,T. Shannon,REP,350008,0,0,3,3,
Johnston,U.S. Senate,Randy Brogdon,REP,350008,0,0,0,0,
Johnston,U.S. Senate,Eric Mccray,REP,350008,0,0,0,0,
Johnston,U.S. Senate,Kevin Crow,REP,350008,0,0,1,1,
Johnston,U.S. Senate,James Lankford,REP,350008,0,0,6,6,
Johnston,U.S. Senate,Jason Weger,REP,350008,0,0,1,1,
Johnston,U.S. House,Darrel Robertson,REP,350008,0,0,1,1,02
Johnston,U.S. House,Markwayne Mullin,REP,350008,0,0,10,10,02
Johnston,Superintendent of Public Instruction,John Cox,DEM,350009,0,2,5,7,
Johnston,Superintendent of Public Instruction,Jack Jr.,DEM,350009,0,0,4,4,
Johnston,Superintendent of Public Instruction,Ivan Holmes,DEM,350009,2,0,5,7,
Johnston,Superintendent of Public Instruction,Freda Deskin,DEM,350009,0,0,11,11,
Johnston,U.S. Senate,Patrick Michael Hayes,DEM,350009,1,0,12,13,
Johnston,U.S. Senate,Jim Rogers,DEM,350009,1,2,9,12,
Johnston,U.S. Senate,Connie Johnson,DEM,350009,0,0,3,3,
Johnston,U.S. House,Earl Everett,DEM,350009,2,1,12,15,02
Johnston,U.S. House,Joshua Harris-Till,DEM,350009,0,1,11,12,02
Johnston,Governor,Dax Ewbank,REP,350009,0,1,0,1,
Johnston,Governor,Chad Moody,REP,350009,0,0,0,0,
Johnston,Governor,Mary Fallin,REP,350009,0,0,9,9,
Johnston,Superintendent of Public Instruction,Brian Kelly,REP,350009,0,0,2,2,
Johnston,Superintendent of Public Instruction,Janet Costello Barresi,REP,350009,0,0,2,2,
Johnston,Superintendent of Public Instruction,Joy Hofmeister,REP,350009,0,1,4,5,
Johnston,Insurance Commissioner,Bill Viner,REP,350009,0,0,1,1,
Johnston,Insurance Commissioner,John Doak,REP,350009,0,1,6,7,
Johnston,Corporation Commissioner,Todd Hiett,REP,350009,0,1,3,4,
Johnston,Corporation Commissioner,Cliff Branan,REP,350009,0,0,4,4,
Johnston,U.S. Senate,Evelyn Rogers,REP,350009,0,0,0,0,
Johnston,U.S. Senate,Rob Moye,REP,350009,0,0,0,0,
Johnston,U.S. Senate,D. Jean Mcbride-Samuels,REP,350009,0,0,0,0,
Johnston,U.S. Senate,Jim Inhofe,REP,350009,0,1,8,9,
Johnston,U.S. Senate,Erick Paul Wyatt,REP,350009,0,0,1,1,
Johnston,U.S. Senate,Andy Craig,REP,350009,0,0,0,0,
Johnston,U.S. Senate,T. Shannon,REP,350009,0,0,5,5,
Johnston,U.S. Senate,Randy Brogdon,REP,350009,0,0,0,0,
Johnston,U.S. Senate,Eric Mccray,REP,350009,0,0,0,0,
Johnston,U.S. Senate,Kevin Crow,REP,350009,0,0,0,0,
Johnston,U.S. Senate,James Lankford,REP,350009,0,1,4,5,
Johnston,U.S. Senate,Jason Weger,REP,350009,0,0,0,0,
Johnston,U.S. House,Darrel Robertson,REP,350009,0,0,1,1,02
Johnston,U.S. House,Markwayne Mullin,REP,350009,0,1,7,8,02
Johnston,Superintendent of Public Instruction,John Cox,DEM,350010,0,0,7,7,
Johnston,Superintendent of Public Instruction,Jack Jr.,DEM,350010,0,0,0,0,
Johnston,Superintendent of Public Instruction,Ivan Holmes,DEM,350010,0,0,2,2,
Johnston,Superintendent of Public Instruction,Freda Deskin,DEM,350010,0,0,9,9,
Johnston,U.S. Senate,Patrick Michael Hayes,DEM,350010,0,0,1,1,
Johnston,U.S. Senate,Jim Rogers,DEM,350010,0,0,6,6,
Johnston,U.S. Senate,Connie Johnson,DEM,350010,0,0,8,8,
Johnston,U.S. House,Earl Everett,DEM,350010,0,0,7,7,02
Johnston,U.S. House,Joshua Harris-Till,DEM,350010,0,0,6,6,02
Johnston,Governor,Dax Ewbank,REP,350010,0,0,2,2,
Johnston,Governor,Chad Moody,REP,350010,0,0,2,2,
Johnston,Governor,Mary Fallin,REP,350010,0,1,6,7,
Johnston,Superintendent of Public Instruction,Brian Kelly,REP,350010,0,0,3,3,
Johnston,Superintendent of Public Instruction,Janet Costello Barresi,REP,350010,0,0,1,1,
Johnston,Superintendent of Public Instruction,Joy Hofmeister,REP,350010,0,1,6,7,
Johnston,Insurance Commissioner,Bill Viner,REP,350010,0,0,4,4,
Johnston,Insurance Commissioner,John Doak,REP,350010,0,1,6,7,
Johnston,Corporation Commissioner,Todd Hiett,REP,350010,0,1,4,5,
Johnston,Corporation Commissioner,Cliff Branan,REP,350010,0,0,5,5,
Johnston,U.S. Senate,Evelyn Rogers,REP,350010,0,0,0,0,
Johnston,U.S. Senate,Rob Moye,REP,350010,0,1,0,1,
Johnston,U.S. Senate,D. Jean Mcbride-Samuels,REP,350010,0,0,0,0,
Johnston,U.S. Senate,Jim Inhofe,REP,350010,0,0,8,8,
Johnston,U.S. Senate,Erick Paul Wyatt,REP,350010,0,0,2,2,
Johnston,U.S. Senate,Andy Craig,REP,350010,0,0,0,0,
Johnston,U.S. Senate,T. Shannon,REP,350010,0,1,5,6,
Johnston,U.S. Senate,Randy Brogdon,REP,350010,0,0,0,0,
Johnston,U.S. Senate,Eric Mccray,REP,350010,0,0,0,0,
Johnston,U.S. Senate,Kevin Crow,REP,350010,0,0,0,0,
Johnston,U.S. Senate,James Lankford,REP,350010,0,0,5,5,
Johnston,U.S. Senate,Jason Weger,REP,350010,0,0,0,0,
Johnston,U.S. House,Darrel Robertson,REP,350010,0,0,1,1,02
Johnston,U.S. House,Markwayne Mullin,REP,350010,0,1,9,10,02
Johnston,Superintendent of Public Instruction,John Cox,DEM,350011,1,0,21,22,
Johnston,Superintendent of Public Instruction,Jack Jr.,DEM,350011,0,0,3,3,
Johnston,Superintendent of Public Instruction,Ivan Holmes,DEM,350011,0,0,1,1,
Johnston,Superintendent of Public Instruction,Freda Deskin,DEM,350011,0,0,13,13,
Johnston,U.S. Senate,Patrick Michael Hayes,DEM,350011,0,0,11,11,
Johnston,U.S. Senate,Jim Rogers,DEM,350011,0,0,12,12,
Johnston,U.S. Senate,Connie Johnson,DEM,350011,1,0,11,12,
Johnston,U.S. House,Earl Everett,DEM,350011,0,0,20,20,02
Johnston,U.S. House,Joshua Harris-Till,DEM,350011,1,0,13,14,02
Johnston,Governor,Dax Ewbank,REP,350011,0,0,0,0,
Johnston,Governor,Chad Moody,REP,350011,0,0,1,1,
Johnston,Governor,Mary Fallin,REP,350011,1,0,5,6,
Johnston,Superintendent of Public Instruction,Brian Kelly,REP,350011,0,0,2,2,
Johnston,Superintendent of Public Instruction,Janet Costello Barresi,REP,350011,0,0,0,0,
Johnston,Superintendent of Public Instruction,Joy Hofmeister,REP,350011,1,0,3,4,
Johnston,Insurance Commissioner,Bill Viner,REP,350011,0,0,0,0,
Johnston,Insurance Commissioner,John Doak,REP,350011,1,0,4,5,
Johnston,Corporation Commissioner,Todd Hiett,REP,350011,1,0,3,4,
Johnston,Corporation Commissioner,Cliff Branan,REP,350011,0,0,1,1,
Johnston,U.S. Senate,Evelyn Rogers,REP,350011,0,0,0,0,
Johnston,U.S. Senate,Rob Moye,REP,350011,0,0,0,0,
Johnston,U.S. Senate,D. Jean Mcbride-Samuels,REP,350011,0,0,0,0,
Johnston,U.S. Senate,Jim Inhofe,REP,350011,1,0,5,6,
Johnston,U.S. Senate,Erick Paul Wyatt,REP,350011,0,0,0,0,
Johnston,U.S. Senate,Andy Craig,REP,350011,0,0,0,0,
Johnston,U.S. Senate,T. Shannon,REP,350011,0,0,6,6,
Johnston,U.S. Senate,Randy Brogdon,REP,350011,0,0,0,0,
Johnston,U.S. Senate,Eric Mccray,REP,350011,0,0,0,0,
Johnston,U.S. Senate,Kevin Crow,REP,350011,0,0,0,0,
Johnston,U.S. Senate,James Lankford,REP,350011,1,0,0,1,
Johnston,U.S. Senate,Jason Weger,REP,350011,0,0,0,0,
Johnston,U.S. House,Darrel Robertson,REP,350011,1,0,4,5,02
Johnston,U.S. House,Markwayne Mullin,REP,350011,0,0,2,2,02
Johnston,Superintendent of Public Instruction,John Cox,DEM,350012,1,0,43,44,
Johnston,Superintendent of Public Instruction,Jack Jr.,DEM,350012,0,0,3,3,
Johnston,Superintendent of Public Instruction,Ivan Holmes,DEM,350012,0,0,4,4,
Johnston,Superintendent of Public Instruction,Freda Deskin,DEM,350012,0,0,18,18,
Johnston,U.S. Senate,Patrick Michael Hayes,DEM,350012,0,0,17,17,
Johnston,U.S. Senate,Jim Rogers,DEM,350012,0,0,35,35,
Johnston,U.S. Senate,Connie Johnson,DEM,350012,1,0,13,14,
Johnston,U.S. House,Earl Everett,DEM,350012,0,0,41,41,02
Johnston,U.S. House,Joshua Harris-Till,DEM,350012,1,0,22,23,02
Johnston,Governor,Dax Ewbank,REP,350012,0,0,3,3,
Johnston,Governor,Chad Moody,REP,350012,0,0,8,8,
Johnston,Governor,Mary Fallin,REP,350012,1,1,22,24,
Johnston,Superintendent of Public Instruction,Brian Kelly,REP,350012,0,0,6,6,
Johnston,Superintendent of Public Instruction,Janet Costello Barresi,REP,350012,0,0,10,10,
Johnston,Superintendent of Public Instruction,Joy Hofmeister,REP,350012,1,1,16,18,
Johnston,Insurance Commissioner,Bill Viner,REP,350012,0,1,7,8,
Johnston,Insurance Commissioner,John Doak,REP,350012,1,0,23,24,
Johnston,Corporation Commissioner,Todd Hiett,REP,350012,0,0,16,16,
Johnston,Corporation Commissioner,Cliff Branan,REP,350012,1,1,13,15,
Johnston,U.S. Senate,Evelyn Rogers,REP,350012,0,1,4,5,
Johnston,U.S. Senate,Rob Moye,REP,350012,0,0,3,3,
Johnston,U.S. Senate,D. Jean Mcbride-Samuels,REP,350012,0,0,1,1,
Johnston,U.S. Senate,Jim Inhofe,REP,350012,1,0,22,23,
Johnston,U.S. Senate,Erick Paul Wyatt,REP,350012,0,0,2,2,
Johnston,U.S. Senate,Andy Craig,REP,350012,0,0,2,2,
Johnston,U.S. Senate,T. Shannon,REP,350012,1,0,9,10,
Johnston,U.S. Senate,Randy Brogdon,REP,350012,0,0,5,5,
Johnston,U.S. Senate,Eric Mccray,REP,350012,0,1,1,2,
Johnston,U.S. Senate,Kevin Crow,REP,350012,0,0,3,3,
Johnston,U.S. Senate,James Lankford,REP,350012,0,0,12,12,
Johnston,U.S. Senate,Jason Weger,REP,350012,0,0,0,0,
Johnston,U.S. House,Darrel Robertson,REP,350012,1,0,8,9,02
Johnston,U.S. House,Markwayne Mullin,REP,350012,0,1,25,26,02
Johnston,Superintendent of Public Instruction,John Cox,DEM,350013,0,2,30,32,
Johnston,Superintendent of Public Instruction,Jack Jr.,DEM,350013,0,0,8,8,
Johnston,Superintendent of Public Instruction,Ivan Holmes,DEM,350013,0,0,6,6,
Johnston,Superintendent of Public Instruction,Freda Deskin,DEM,350013,0,1,22,23,
Johnston,U.S. Senate,Patrick Michael Hayes,DEM,350013,0,0,16,16,
Johnston,U.S. Senate,Jim Rogers,DEM,350013,0,3,25,28,
Johnston,U.S. Senate,Connie Johnson,DEM,350013,0,0,20,20,
Johnston,U.S. House,Earl Everett,DEM,350013,0,2,31,33,02
Johnston,U.S. House,Joshua Harris-Till,DEM,350013,0,1,27,28,02
Johnston,Governor,Dax Ewbank,REP,350013,0,2,5,7,
Johnston,Governor,Chad Moody,REP,350013,0,0,6,6,
Johnston,Governor,Mary Fallin,REP,350013,0,1,33,34,
Johnston,Superintendent of Public Instruction,Brian Kelly,REP,350013,0,3,15,18,
Johnston,Superintendent of Public Instruction,Janet Costello Barresi,REP,350013,0,0,4,4,
Johnston,Superintendent of Public Instruction,Joy Hofmeister,REP,350013,1,0,22,23,
Johnston,Insurance Commissioner,Bill Viner,REP,350013,0,0,13,13,
Johnston,Insurance Commissioner,John Doak,REP,350013,1,2,24,27,
Johnston,Corporation Commissioner,Todd Hiett,REP,350013,1,1,23,25,
Johnston,Corporation Commissioner,Cliff Branan,REP,350013,0,1,16,17,
Johnston,U.S. Senate,Evelyn Rogers,REP,350013,0,1,2,3,
Johnston,U.S. Senate,Rob Moye,REP,350013,0,0,2,2,
Johnston,U.S. Senate,D. Jean Mcbride-Samuels,REP,350013,0,0,1,1,
Johnston,U.S. Senate,Jim Inhofe,REP,350013,1,2,37,40,
Johnston,U.S. Senate,Erick Paul Wyatt,REP,350013,0,0,2,2,
Johnston,U.S. Senate,Andy Craig,REP,350013,0,0,0,0,
Johnston,U.S. Senate,T. Shannon,REP,350013,0,1,18,19,
Johnston,U.S. Senate,Randy Brogdon,REP,350013,1,0,0,1,
Johnston,U.S. Senate,Eric Mccray,REP,350013,0,0,1,1,
Johnston,U.S. Senate,Kevin Crow,REP,350013,0,0,0,0,
Johnston,U.S. Senate,James Lankford,REP,350013,0,2,25,27,
Johnston,U.S. Senate,Jason Weger,REP,350013,0,0,0,0,
Johnston,U.S. House,Darrel Robertson,REP,350013,1,1,9,11,02
Johnston,U.S. House,Markwayne Mullin,REP,350013,0,2,34,36,02
Johnston,Superintendent of Public Instruction,John Cox,DEM,350014,0,0,4,4,
Johnston,Superintendent of Public Instruction,Jack Jr.,DEM,350014,0,0,6,6,
Johnston,Superintendent of Public Instruction,Ivan Holmes,DEM,350014,0,0,1,1,
Johnston,Superintendent of Public Instruction,Freda Deskin,DEM,350014,0,0,7,7,
Johnston,U.S. Senate,Patrick Michael Hayes,DEM,350014,0,0,6,6,
Johnston,U.S. Senate,Jim Rogers,DEM,350014,0,0,5,5,
Johnston,U.S. Senate,Connie Johnson,DEM,350014,0,0,8,8,
Johnston,U.S. House,Earl Everett,DEM,350014,0,0,10,10,02
Johnston,U.S. House,Joshua Harris-Till,DEM,350014,0,0,9,9,02
Johnston,Governor,Dax Ewbank,REP,350014,0,0,0,0,
Johnston,Governor,Chad Moody,REP,350014,0,0,3,3,
Johnston,Governor,Mary Fallin,REP,350014,0,2,3,5,
Johnston,Superintendent of Public Instruction,Brian Kelly,REP,350014,0,1,3,4,
Johnston,Superintendent of Public Instruction,Janet Costello Barresi,REP,350014,0,1,2,3,
Johnston,Superintendent of Public Instruction,Joy Hofmeister,REP,350014,0,0,1,1,
Johnston,Insurance Commissioner,Bill Viner,REP,350014,0,1,3,4,
Johnston,Insurance Commissioner,John Doak,REP,350014,0,1,3,4,
Johnston,Corporation Commissioner,Todd Hiett,REP,350014,0,1,5,6,
Johnston,Corporation Commissioner,Cliff Branan,REP,350014,0,1,1,2,
Johnston,U.S. Senate,Evelyn Rogers,REP,350014,0,2,0,2,
Johnston,U.S. Senate,Rob Moye,REP,350014,0,0,2,2,
Johnston,U.S. Senate,D. Jean Mcbride-Samuels,REP,350014,0,0,0,0,
Johnston,U.S. Senate,Jim Inhofe,REP,350014,0,0,4,4,
Johnston,U.S. Senate,Erick Paul Wyatt,REP,350014,0,0,0,0,
Johnston,U.S. Senate,Andy Craig,REP,350014,0,1,0,1,
Johnston,U.S. Senate,T. Shannon,REP,350014,0,0,4,4,
Johnston,U.S. Senate,Randy Brogdon,REP,350014,0,0,0,0,
Johnston,U.S. Senate,Eric Mccray,REP,350014,0,0,0,0,
Johnston,U.S. Senate,Kevin Crow,REP,350014,0,0,0,0,
Johnston,U.S. Senate,James Lankford,REP,350014,0,1,2,3,
Johnston,U.S. Senate,Jason Weger,REP,350014,0,0,0,0,
Johnston,U.S. House,Darrel Robertson,REP,350014,0,0,3,3,02
Johnston,U.S. House,Markwayne Mullin,REP,350014,0,2,3,5,02
Kay,Superintendent of Public Instruction,John Cox,DEM,360001,0,2,32,34,
Kay,Superintendent of Public Instruction,Jack Jr.,DEM,360001,0,2,8,10,
Kay,Superintendent of Public Instruction,Ivan Holmes,DEM,360001,1,2,8,11,
Kay,Superintendent of Public Instruction,Freda Deskin,DEM,360001,0,3,38,41,
Kay,U.S. Senate,Patrick Michael Hayes,DEM,360001,1,3,15,19,
Kay,U.S. Senate,Jim Rogers,DEM,360001,1,5,37,43,
Kay,U.S. Senate,Connie Johnson,DEM,360001,0,1,34,35,
Kay,Governor,Dax Ewbank,REP,360001,0,2,39,41,
Kay,Governor,Chad Moody,REP,360001,1,8,35,44,
Kay,Governor,Mary Fallin,REP,360001,5,32,157,194,
Kay,Superintendent of Public Instruction,Brian Kelly,REP,360001,1,14,66,81,
Kay,Superintendent of Public Instruction,Janet Costello Barresi,REP,360001,2,4,19,25,
Kay,Superintendent of Public Instruction,Joy Hofmeister,REP,360001,3,22,139,164,
Kay,Insurance Commissioner,Bill Viner,REP,360001,1,15,81,97,
Kay,Insurance Commissioner,John Doak,REP,360001,5,23,128,156,
Kay,Corporation Commissioner,Todd Hiett,REP,360001,3,16,96,115,
Kay,Corporation Commissioner,Cliff Branan,REP,360001,3,23,118,144,
Kay,U.S. Senate,Evelyn Rogers,REP,360001,0,7,13,20,
Kay,U.S. Senate,Rob Moye,REP,360001,0,2,7,9,
Kay,U.S. Senate,D. Jean Mcbride-Samuels,REP,360001,0,1,3,4,
Kay,U.S. Senate,Jim Inhofe,REP,360001,6,30,187,223,
Kay,U.S. Senate,Erick Paul Wyatt,REP,360001,0,2,15,17,
Kay,U.S. Senate,Andy Craig,REP,360001,0,0,2,2,
Kay,U.S. Senate,T. Shannon,REP,360001,3,13,71,87,
Kay,U.S. Senate,Randy Brogdon,REP,360001,0,0,11,11,
Kay,U.S. Senate,Eric Mccray,REP,360001,0,0,6,6,
Kay,U.S. Senate,Kevin Crow,REP,360001,0,2,7,9,
Kay,U.S. Senate,James Lankford,REP,360001,3,24,123,150,
Kay,U.S. Senate,Jason Weger,REP,360001,0,2,6,8,
Kay,U.S. House,Timothy Ray Murray,REP,360001,0,3,12,15,03
Kay,U.S. House,Robert Hubbard,REP,360001,0,6,30,36,03
Kay,U.S. House,Frank Lucas,REP,360001,6,33,180,219,03
Kay,State House,Roy Chaney,REP,360001,4,18,110,132,38
Kay,State House,Niki Schrader,REP,360001,1,1,6,8,38
Kay,State House,Jason Warren,REP,360001,0,2,12,14,38
Kay,State House,Ralph Meade,REP,360001,0,0,9,9,38
Kay,State House,John Pfeiffer,REP,360001,1,12,48,61,38
Kay,State House,Harold Levalley,REP,360001,0,9,47,56,38
Kay,Superintendent of Public Instruction,John Cox,DEM,360101,0,2,33,35,
Kay,Superintendent of Public Instruction,Jack Jr.,DEM,360101,0,0,9,9,
Kay,Superintendent of Public Instruction,Ivan Holmes,DEM,360101,0,1,6,7,
Kay,Superintendent of Public Instruction,Freda Deskin,DEM,360101,0,1,22,23,
Kay,U.S. Senate,Patrick Michael Hayes,DEM,360101,0,0,11,11,
Kay,U.S. Senate,Jim Rogers,DEM,360101,0,0,31,31,
Kay,U.S. Senate,Connie Johnson,DEM,360101,0,4,26,30,
Kay,Governor,Dax Ewbank,REP,360101,0,4,28,32,
Kay,Governor,Chad Moody,REP,360101,0,2,37,39,
Kay,Governor,Mary Fallin,REP,360101,1,5,114,120,
Kay,Superintendent of Public Instruction,Brian Kelly,REP,360101,0,3,56,59,
Kay,Superintendent of Public Instruction,Janet Costello Barresi,REP,360101,1,0,24,25,
Kay,Superintendent of Public Instruction,Joy Hofmeister,REP,360101,0,7,94,101,
Kay,Insurance Commissioner,Bill Viner,REP,360101,0,1,46,47,
Kay,Insurance Commissioner,John Doak,REP,360101,1,8,125,134,
Kay,Corporation Commissioner,Todd Hiett,REP,360101,0,6,86,92,
Kay,Corporation Commissioner,Cliff Branan,REP,360101,0,3,83,86,
Kay,U.S. Senate,Evelyn Rogers,REP,360101,0,2,10,12,
Kay,U.S. Senate,Rob Moye,REP,360101,0,0,6,6,
Kay,U.S. Senate,D. Jean Mcbride-Samuels,REP,360101,0,0,1,1,
Kay,U.S. Senate,Jim Inhofe,REP,360101,1,6,147,154,
Kay,U.S. Senate,Erick Paul Wyatt,REP,360101,0,3,16,19,
Kay,U.S. Senate,Andy Craig,REP,360101,0,0,2,2,
Kay,U.S. Senate,T. Shannon,REP,360101,1,5,56,62,
Kay,U.S. Senate,Randy Brogdon,REP,360101,0,3,13,16,
Kay,U.S. Senate,Eric Mccray,REP,360101,0,0,4,4,
Kay,U.S. Senate,Kevin Crow,REP,360101,0,0,3,3,
Kay,U.S. Senate,James Lankford,REP,360101,0,3,97,100,
Kay,U.S. Senate,Jason Weger,REP,360101,0,0,3,3,
Kay,U.S. House,Timothy Ray Murray,REP,360101,0,0,8,8,03
Kay,U.S. House,Robert Hubbard,REP,360101,0,5,17,22,03
Kay,U.S. House,Frank Lucas,REP,360101,1,6,153,160,03
Kay,State House,Roy Chaney,REP,360101,1,1,61,63,38
Kay,State House,Niki Schrader,REP,360101,0,0,6,6,38
Kay,State House,Jason Warren,REP,360101,0,2,9,11,38
Kay,State House,Ralph Meade,REP,360101,0,0,10,10,38
Kay,State House,John Pfeiffer,REP,360101,0,2,29,31,38
Kay,State House,Harold Levalley,REP,360101,0,5,62,67,38
Kay,Superintendent of Public Instruction,John Cox,DEM,360103,0,0,24,24,
Kay,Superintendent of Public Instruction,Jack Jr.,DEM,360103,0,0,11,11,
Kay,Superintendent of Public Instruction,Ivan Holmes,DEM,360103,0,0,9,9,
Kay,Superintendent of Public Instruction,Freda Deskin,DEM,360103,0,0,25,25,
Kay,U.S. Senate,Patrick Michael Hayes,DEM,360103,0,0,13,13,
Kay,U.S. Senate,Jim Rogers,DEM,360103,0,0,30,30,
Kay,U.S. Senate,Connie Johnson,DEM,360103,0,0,23,23,
Kay,Governor,Dax Ewbank,REP,360103,0,0,20,20,
Kay,Governor,Chad Moody,REP,360103,2,1,49,52,
Kay,Governor,Mary Fallin,REP,360103,3,1,115,119,
Kay,Superintendent of Public Instruction,Brian Kelly,REP,360103,0,1,51,52,
Kay,Superintendent of Public Instruction,Janet Costello Barresi,REP,360103,0,0,22,22,
Kay,Superintendent of Public Instruction,Joy Hofmeister,REP,360103,5,1,111,117,
Kay,Insurance Commissioner,Bill Viner,REP,360103,2,1,41,44,
Kay,Insurance Commissioner,John Doak,REP,360103,3,1,137,141,
Kay,Corporation Commissioner,Todd Hiett,REP,360103,4,0,94,98,
Kay,Corporation Commissioner,Cliff Branan,REP,360103,1,2,87,90,
Kay,U.S. Senate,Evelyn Rogers,REP,360103,0,0,10,10,
Kay,U.S. Senate,Rob Moye,REP,360103,1,0,1,2,
Kay,U.S. Senate,D. Jean Mcbride-Samuels,REP,360103,0,1,1,2,
Kay,U.S. Senate,Jim Inhofe,REP,360103,4,1,159,164,
Kay,U.S. Senate,Erick Paul Wyatt,REP,360103,0,0,13,13,
Kay,U.S. Senate,Andy Craig,REP,360103,0,0,3,3,
Kay,U.S. Senate,T. Shannon,REP,360103,5,1,64,70,
Kay,U.S. Senate,Randy Brogdon,REP,360103,0,0,7,7,
Kay,U.S. Senate,Eric Mccray,REP,360103,0,0,4,4,
Kay,U.S. Senate,Kevin Crow,REP,360103,0,0,5,5,
Kay,U.S. Senate,James Lankford,REP,360103,0,0,98,98,
Kay,U.S. Senate,Jason Weger,REP,360103,0,1,3,4,
Kay,U.S. House,Timothy Ray Murray,REP,360103,0,1,12,13,03
Kay,U.S. House,Robert Hubbard,REP,360103,1,0,20,21,03
Kay,U.S. House,Frank Lucas,REP,360103,4,1,152,157,03
Kay,State House,Roy Chaney,REP,360103,0,1,26,27,38
Kay,State House,Niki Schrader,REP,360103,1,0,12,13,38
Kay,State House,Jason Warren,REP,360103,0,0,27,27,38
Kay,State House,Ralph Meade,REP,360103,0,0,3,3,38
Kay,State House,John Pfeiffer,REP,360103,2,0,53,55,38
Kay,State House,Harold Levalley,REP,360103,2,1,63,66,38
Kay,Superintendent of Public Instruction,John Cox,DEM,360202,0,1,72,73,
Kay,Superintendent of Public Instruction,Jack Jr.,DEM,360202,2,0,20,22,
Kay,Superintendent of Public Instruction,Ivan Holmes,DEM,360202,0,0,27,27,
Kay,Superintendent of Public Instruction,Freda Deskin,DEM,360202,1,0,54,55,
Kay,U.S. Senate,Patrick Michael Hayes,DEM,360202,0,0,27,27,
Kay,U.S. Senate,Jim Rogers,DEM,360202,2,1,94,97,
Kay,U.S. Senate,Connie Johnson,DEM,360202,1,0,47,48,
Kay,Governor,Dax Ewbank,REP,360202,0,2,22,24,
Kay,Governor,Chad Moody,REP,360202,0,1,57,58,
Kay,Governor,Mary Fallin,REP,360202,4,4,178,186,
Kay,Superintendent of Public Instruction,Brian Kelly,REP,360202,1,3,73,77,
Kay,Superintendent of Public Instruction,Janet Costello Barresi,REP,360202,0,0,38,38,
Kay,Superintendent of Public Instruction,Joy Hofmeister,REP,360202,4,4,144,152,
Kay,Insurance Commissioner,Bill Viner,REP,360202,1,1,67,69,
Kay,Insurance Commissioner,John Doak,REP,360202,4,4,176,184,
Kay,Corporation Commissioner,Todd Hiett,REP,360202,4,3,129,136,
Kay,Corporation Commissioner,Cliff Branan,REP,360202,0,3,115,118,
Kay,U.S. Senate,Evelyn Rogers,REP,360202,0,0,16,16,
Kay,U.S. Senate,Rob Moye,REP,360202,0,0,7,7,
Kay,U.S. Senate,D. Jean Mcbride-Samuels,REP,360202,0,0,4,4,
Kay,U.S. Senate,Jim Inhofe,REP,360202,3,6,213,222,
Kay,U.S. Senate,Erick Paul Wyatt,REP,360202,0,0,15,15,
Kay,U.S. Senate,Andy Craig,REP,360202,0,0,5,5,
Kay,U.S. Senate,T. Shannon,REP,360202,2,3,96,101,
Kay,U.S. Senate,Randy Brogdon,REP,360202,0,0,11,11,
Kay,U.S. Senate,Eric Mccray,REP,360202,0,0,7,7,
Kay,U.S. Senate,Kevin Crow,REP,360202,0,0,13,13,
Kay,U.S. Senate,James Lankford,REP,360202,3,4,121,128,
Kay,U.S. Senate,Jason Weger,REP,360202,0,0,2,2,
Kay,U.S. House,Timothy Ray Murray,REP,360202,0,0,20,20,03
Kay,U.S. House,Robert Hubbard,REP,360202,0,1,26,27,03
Kay,U.S. House,Frank Lucas,REP,360202,4,6,209,219,03
Kay,State House,Roy Chaney,REP,360202,1,5,49,55,38
Kay,State House,Niki Schrader,REP,360202,0,0,12,12,38
Kay,State House,Jason Warren,REP,360202,2,0,26,28,38
Kay,State House,Ralph Meade,REP,360202,0,0,16,16,38
Kay,State House,John Pfeiffer,REP,360202,0,0,52,52,38
Kay,State House,Harold Levalley,REP,360202,2,2,103,107,38
Kay,Superintendent of Public Instruction,John Cox,DEM,360205,1,2,63,66,
Kay,Superintendent of Public Instruction,Jack Jr.,DEM,360205,0,0,29,29,
Kay,Superintendent of Public Instruction,Ivan Holmes,DEM,360205,0,0,32,32,
Kay,Superintendent of Public Instruction,Freda Deskin,DEM,360205,0,0,61,61,
Kay,U.S. Senate,Patrick Michael Hayes,DEM,360205,0,1,26,27,
Kay,U.S. Senate,Jim Rogers,DEM,360205,1,1,105,107,
Kay,U.S. Senate,Connie Johnson,DEM,360205,0,0,56,56,
Kay,Governor,Dax Ewbank,REP,360205,0,1,16,17,
Kay,Governor,Chad Moody,REP,360205,0,1,66,67,
Kay,Governor,Mary Fallin,REP,360205,2,10,168,180,
Kay,Superintendent of Public Instruction,Brian Kelly,REP,360205,0,4,83,87,
Kay,Superintendent of Public Instruction,Janet Costello Barresi,REP,360205,1,1,38,40,
Kay,Superintendent of Public Instruction,Joy Hofmeister,REP,360205,1,7,120,128,
Kay,Insurance Commissioner,Bill Viner,REP,360205,1,3,74,78,
Kay,Insurance Commissioner,John Doak,REP,360205,0,8,162,170,
Kay,Corporation Commissioner,Todd Hiett,REP,360205,0,6,124,130,
Kay,Corporation Commissioner,Cliff Branan,REP,360205,1,6,111,118,
Kay,U.S. Senate,Evelyn Rogers,REP,360205,0,1,16,17,
Kay,U.S. Senate,Rob Moye,REP,360205,0,0,8,8,
Kay,U.S. Senate,D. Jean Mcbride-Samuels,REP,360205,0,0,13,13,
Kay,U.S. Senate,Jim Inhofe,REP,360205,2,11,194,207,
Kay,U.S. Senate,Erick Paul Wyatt,REP,360205,0,0,18,18,
Kay,U.S. Senate,Andy Craig,REP,360205,0,2,7,9,
Kay,U.S. Senate,T. Shannon,REP,360205,1,3,103,107,
Kay,U.S. Senate,Randy Brogdon,REP,360205,0,0,12,12,
Kay,U.S. Senate,Eric Mccray,REP,360205,0,0,11,11,
Kay,U.S. Senate,Kevin Crow,REP,360205,0,0,8,8,
Kay,U.S. Senate,James Lankford,REP,360205,1,7,105,113,
Kay,U.S. Senate,Jason Weger,REP,360205,0,0,3,3,
Kay,U.S. House,Timothy Ray Murray,REP,360205,0,0,18,18,03
Kay,U.S. House,Robert Hubbard,REP,360205,0,0,41,41,03
Kay,U.S. House,Frank Lucas,REP,360205,2,12,184,198,03
Kay,State House,Roy Chaney,REP,360205,0,2,48,50,38
Kay,State House,Niki Schrader,REP,360205,1,0,7,8,38
Kay,State House,Jason Warren,REP,360205,0,0,24,24,38
Kay,State House,Ralph Meade,REP,360205,0,1,22,23,38
Kay,State House,John Pfeiffer,REP,360205,0,6,43,49,38
Kay,State House,Harold Levalley,REP,360205,1,3,104,108,38
Kay,Superintendent of Public Instruction,John Cox,DEM,360206,1,1,74,76,
Kay,Superintendent of Public Instruction,Jack Jr.,DEM,360206,2,0,31,33,
Kay,Superintendent of Public Instruction,Ivan Holmes,DEM,360206,0,0,22,22,
Kay,Superintendent of Public Instruction,Freda Deskin,DEM,360206,1,3,72,76,
Kay,U.S. Senate,Patrick Michael Hayes,DEM,360206,0,1,43,44,
Kay,U.S. Senate,Jim Rogers,DEM,360206,1,1,104,106,
Kay,U.S. Senate,Connie Johnson,DEM,360206,3,2,52,57,
Kay,Governor,Dax Ewbank,REP,360206,2,1,44,47,
Kay,Governor,Chad Moody,REP,360206,1,5,90,96,
Kay,Governor,Mary Fallin,REP,360206,8,10,347,365,
Kay,Superintendent of Public Instruction,Brian Kelly,REP,360206,2,5,135,142,
Kay,Superintendent of Public Instruction,Janet Costello Barresi,REP,360206,1,1,61,63,
Kay,Superintendent of Public Instruction,Joy Hofmeister,REP,360206,8,10,283,301,
Kay,Insurance Commissioner,Bill Viner,REP,360206,0,7,127,134,
Kay,Insurance Commissioner,John Doak,REP,360206,11,8,329,348,
Kay,Corporation Commissioner,Todd Hiett,REP,360206,8,4,266,278,
Kay,Corporation Commissioner,Cliff Branan,REP,360206,3,12,196,211,
Kay,U.S. Senate,Evelyn Rogers,REP,360206,0,0,25,25,
Kay,U.S. Senate,Rob Moye,REP,360206,0,0,13,13,
Kay,U.S. Senate,D. Jean Mcbride-Samuels,REP,360206,0,0,7,7,
Kay,U.S. Senate,Jim Inhofe,REP,360206,9,15,413,437,
Kay,U.S. Senate,Erick Paul Wyatt,REP,360206,2,1,26,29,
Kay,U.S. Senate,Andy Craig,REP,360206,0,0,9,9,
Kay,U.S. Senate,T. Shannon,REP,360206,8,5,170,183,
Kay,U.S. Senate,Randy Brogdon,REP,360206,0,0,15,15,
Kay,U.S. Senate,Eric Mccray,REP,360206,0,0,9,9,
Kay,U.S. Senate,Kevin Crow,REP,360206,0,0,20,20,
Kay,U.S. Senate,James Lankford,REP,360206,3,11,256,270,
Kay,U.S. Senate,Jason Weger,REP,360206,0,0,3,3,
Kay,U.S. House,Timothy Ray Murray,REP,360206,0,0,23,23,03
Kay,U.S. House,Robert Hubbard,REP,360206,2,2,70,74,03
Kay,U.S. House,Frank Lucas,REP,360206,9,13,388,410,03
Kay,State House,Roy Chaney,REP,360206,7,2,80,89,38
Kay,State House,Niki Schrader,REP,360206,0,2,31,33,38
Kay,State House,Jason Warren,REP,360206,0,1,19,20,38
Kay,State House,Ralph Meade,REP,360206,0,1,18,19,38
Kay,State House,John Pfeiffer,REP,360206,0,1,107,108,38
Kay,State House,Harold Levalley,REP,360206,4,9,233,246,38
Kay,Superintendent of Public Instruction,John Cox,DEM,360400,0,0,2,2,
Kay,Superintendent of Public Instruction,Jack Jr.,DEM,360400,0,0,1,1,
Kay,Superintendent of Public Instruction,Ivan Holmes,DEM,360400,0,0,2,2,
Kay,Superintendent of Public Instruction,Freda Deskin,DEM,360400,0,1,3,4,
Kay,U.S. Senate,Patrick Michael Hayes,DEM,360400,0,0,2,2,
Kay,U.S. Senate,Jim Rogers,DEM,360400,0,1,5,6,
Kay,U.S. Senate,Connie Johnson,DEM,360400,0,0,1,1,
Kay,Governor,Dax Ewbank,REP,360400,0,0,2,2,
Kay,Governor,Chad Moody,REP,360400,0,0,10,10,
Kay,Governor,Mary Fallin,REP,360400,0,0,20,20,
Kay,Superintendent of Public Instruction,Brian Kelly,REP,360400,0,0,10,10,
Kay,Superintendent of Public Instruction,Janet Costello Barresi,REP,360400,0,0,2,2,
Kay,Superintendent of Public Instruction,Joy Hofmeister,REP,360400,2,0,19,21,
Kay,Insurance Commissioner,Bill Viner,REP,360400,0,0,10,10,
Kay,Insurance Commissioner,John Doak,REP,360400,0,0,21,21,
Kay,Corporation Commissioner,Todd Hiett,REP,360400,2,0,12,14,
Kay,Corporation Commissioner,Cliff Branan,REP,360400,0,0,17,17,
Kay,U.S. Senate,Evelyn Rogers,REP,360400,0,0,4,4,
Kay,U.S. Senate,Rob Moye,REP,360400,0,0,1,1,
Kay,U.S. Senate,D. Jean Mcbride-Samuels,REP,360400,0,0,0,0,
Kay,U.S. Senate,Jim Inhofe,REP,360400,0,0,28,28,
Kay,U.S. Senate,Erick Paul Wyatt,REP,360400,2,0,0,2,
Kay,U.S. Senate,Andy Craig,REP,360400,0,0,0,0,
Kay,U.S. Senate,T. Shannon,REP,360400,0,0,15,15,
Kay,U.S. Senate,Randy Brogdon,REP,360400,0,0,0,0,
Kay,U.S. Senate,Eric Mccray,REP,360400,0,0,1,1,
Kay,U.S. Senate,Kevin Crow,REP,360400,0,0,0,0,
Kay,U.S. Senate,James Lankford,REP,360400,2,0,17,19,
Kay,U.S. Senate,Jason Weger,REP,360400,0,0,0,0,
Kay,U.S. House,Timothy Ray Murray,REP,360400,0,0,2,2,03
Kay,U.S. House,Robert Hubbard,REP,360400,2,0,5,7,03
Kay,U.S. House,Frank Lucas,REP,360400,0,0,26,26,03
Kay,Superintendent of Public Instruction,John Cox,DEM,360401,0,0,0,0,
Kay,Superintendent of Public Instruction,Jack Jr.,DEM,360401,0,0,0,0,
Kay,Superintendent of Public Instruction,Ivan Holmes,DEM,360401,0,0,1,1,
Kay,Superintendent of Public Instruction,Freda Deskin,DEM,360401,0,0,0,0,
Kay,U.S. Senate,Patrick Michael Hayes,DEM,360401,0,0,0,0,
Kay,U.S. Senate,Jim Rogers,DEM,360401,0,0,0,0,
Kay,U.S. Senate,Connie Johnson,DEM,360401,0,0,1,1,
Kay,Governor,Dax Ewbank,REP,360401,0,0,1,1,
Kay,Governor,Chad Moody,REP,360401,0,0,1,1,
Kay,Governor,Mary Fallin,REP,360401,4,1,14,19,
Kay,Superintendent of Public Instruction,Brian Kelly,REP,360401,0,1,5,6,
Kay,Superintendent of Public Instruction,Janet Costello Barresi,REP,360401,2,0,4,6,
Kay,Superintendent of Public Instruction,Joy Hofmeister,REP,360401,2,0,6,8,
Kay,Insurance Commissioner,Bill Viner,REP,360401,0,0,3,3,
Kay,Insurance Commissioner,John Doak,REP,360401,4,1,11,16,
Kay,Corporation Commissioner,Todd Hiett,REP,360401,4,0,8,12,
Kay,Corporation Commissioner,Cliff Branan,REP,360401,0,1,7,8,
Kay,U.S. Senate,Evelyn Rogers,REP,360401,0,0,1,1,
Kay,U.S. Senate,Rob Moye,REP,360401,0,0,1,1,
Kay,U.S. Senate,D. Jean Mcbride-Samuels,REP,360401,0,0,0,0,
Kay,U.S. Senate,Jim Inhofe,REP,360401,4,1,13,18,
Kay,U.S. Senate,Erick Paul Wyatt,REP,360401,0,0,1,1,
Kay,U.S. Senate,Andy Craig,REP,360401,0,0,0,0,
Kay,U.S. Senate,T. Shannon,REP,360401,0,1,8,9,
Kay,U.S. Senate,Randy Brogdon,REP,360401,0,0,0,0,
Kay,U.S. Senate,Eric Mccray,REP,360401,0,0,0,0,
Kay,U.S. Senate,Kevin Crow,REP,360401,0,0,0,0,
Kay,U.S. Senate,James Lankford,REP,360401,4,0,7,11,
Kay,U.S. Senate,Jason Weger,REP,360401,0,0,1,1,
Kay,U.S. House,Timothy Ray Murray,REP,360401,0,0,0,0,03
Kay,U.S. House,Robert Hubbard,REP,360401,0,0,1,1,03
Kay,U.S. House,Frank Lucas,REP,360401,4,1,15,20,03
Kay,Superintendent of Public Instruction,John Cox,DEM,360403,0,0,14,14,
Kay,Superintendent of Public Instruction,Jack Jr.,DEM,360403,0,0,2,2,
Kay,Superintendent of Public Instruction,Ivan Holmes,DEM,360403,0,0,1,1,
Kay,Superintendent of Public Instruction,Freda Deskin,DEM,360403,0,1,10,11,
Kay,U.S. Senate,Patrick Michael Hayes,DEM,360403,0,1,3,4,
Kay,U.S. Senate,Jim Rogers,DEM,360403,0,0,11,11,
Kay,U.S. Senate,Connie Johnson,DEM,360403,0,0,13,13,
Kay,Governor,Dax Ewbank,REP,360403,2,3,10,15,
Kay,Governor,Chad Moody,REP,360403,0,0,9,9,
Kay,Governor,Mary Fallin,REP,360403,1,8,91,100,
Kay,Superintendent of Public Instruction,Brian Kelly,REP,360403,0,4,28,32,
Kay,Superintendent of Public Instruction,Janet Costello Barresi,REP,360403,0,1,17,18,
Kay,Superintendent of Public Instruction,Joy Hofmeister,REP,360403,3,6,64,73,
Kay,Insurance Commissioner,Bill Viner,REP,360403,1,3,24,28,
Kay,Insurance Commissioner,John Doak,REP,360403,2,9,82,93,
Kay,Corporation Commissioner,Todd Hiett,REP,360403,2,7,63,72,
Kay,Corporation Commissioner,Cliff Branan,REP,360403,1,4,42,47,
Kay,U.S. Senate,Evelyn Rogers,REP,360403,0,0,6,6,
Kay,U.S. Senate,Rob Moye,REP,360403,0,0,1,1,
Kay,U.S. Senate,D. Jean Mcbride-Samuels,REP,360403,0,0,3,3,
Kay,U.S. Senate,Jim Inhofe,REP,360403,3,11,90,104,
Kay,U.S. Senate,Erick Paul Wyatt,REP,360403,0,0,10,10,
Kay,U.S. Senate,Andy Craig,REP,360403,0,0,0,0,
Kay,U.S. Senate,T. Shannon,REP,360403,0,3,38,41,
Kay,U.S. Senate,Randy Brogdon,REP,360403,2,2,3,7,
Kay,U.S. Senate,Eric Mccray,REP,360403,0,0,1,1,
Kay,U.S. Senate,Kevin Crow,REP,360403,0,0,2,2,
Kay,U.S. Senate,James Lankford,REP,360403,1,7,65,73,
Kay,U.S. Senate,Jason Weger,REP,360403,0,0,1,1,
Kay,U.S. House,Timothy Ray Murray,REP,360403,0,0,11,11,03
Kay,U.S. House,Robert Hubbard,REP,360403,1,3,12,16,03
Kay,U.S. House,Frank Lucas,REP,360403,2,9,86,97,03
Kay,State House,Roy Chaney,REP,360403,1,7,42,50,38
Kay,State House,Niki Schrader,REP,360403,0,0,4,4,38
Kay,State House,Jason Warren,REP,360403,2,0,11,13,38
Kay,State House,Ralph Meade,REP,360403,0,0,5,5,38
Kay,State House,John Pfeiffer,REP,360403,0,4,33,37,38
Kay,State House,Harold Levalley,REP,360403,0,1,14,15,38
Kay,Superintendent of Public Instruction,John Cox,DEM,360404,0,0,5,5,
Kay,Superintendent of Public Instruction,Jack Jr.,DEM,360404,0,0,2,2,
Kay,Superintendent of Public Instruction,Ivan Holmes,DEM,360404,0,1,3,4,
Kay,Superintendent of Public Instruction,Freda Deskin,DEM,360404,0,0,4,4,
Kay,U.S. Senate,Patrick Michael Hayes,DEM,360404,0,0,6,6,
Kay,U.S. Senate,Jim Rogers,DEM,360404,0,0,3,3,
Kay,U.S. Senate,Connie Johnson,DEM,360404,0,1,5,6,
Kay,Governor,Dax Ewbank,REP,360404,0,1,6,7,
Kay,Governor,Chad Moody,REP,360404,0,0,10,10,
Kay,Governor,Mary Fallin,REP,360404,0,0,41,41,
Kay,Superintendent of Public Instruction,Brian Kelly,REP,360404,0,0,21,21,
Kay,Superintendent of Public Instruction,Janet Costello Barresi,REP,360404,0,0,2,2,
Kay,Superintendent of Public Instruction,Joy Hofmeister,REP,360404,0,2,34,36,
Kay,Insurance Commissioner,Bill Viner,REP,360404,0,0,21,21,
Kay,Insurance Commissioner,John Doak,REP,360404,0,1,36,37,
Kay,Corporation Commissioner,Todd Hiett,REP,360404,0,0,32,32,
Kay,Corporation Commissioner,Cliff Branan,REP,360404,0,1,25,26,
Kay,U.S. Senate,Evelyn Rogers,REP,360404,0,0,5,5,
Kay,U.S. Senate,Rob Moye,REP,360404,0,0,4,4,
Kay,U.S. Senate,D. Jean Mcbride-Samuels,REP,360404,0,0,0,0,
Kay,U.S. Senate,Jim Inhofe,REP,360404,0,1,45,46,
Kay,U.S. Senate,Erick Paul Wyatt,REP,360404,0,1,3,4,
Kay,U.S. Senate,Andy Craig,REP,360404,0,0,0,0,
Kay,U.S. Senate,T. Shannon,REP,360404,0,1,19,20,
Kay,U.S. Senate,Randy Brogdon,REP,360404,0,0,3,3,
Kay,U.S. Senate,Eric Mccray,REP,360404,0,0,0,0,
Kay,U.S. Senate,Kevin Crow,REP,360404,0,0,1,1,
Kay,U.S. Senate,James Lankford,REP,360404,0,1,33,34,
Kay,U.S. Senate,Jason Weger,REP,360404,0,0,1,1,
Kay,U.S. House,Timothy Ray Murray,REP,360404,0,0,4,4,03
Kay,U.S. House,Robert Hubbard,REP,360404,0,1,5,6,03
Kay,U.S. House,Frank Lucas,REP,360404,0,0,47,47,03
Kay,State House,Roy Chaney,REP,360404,0,1,9,10,38
Kay,State House,Niki Schrader,REP,360404,0,0,3,3,38
Kay,State House,Jason Warren,REP,360404,0,0,1,1,38
Kay,State House,Ralph Meade,REP,360404,0,0,0,0,38
Kay,State House,John Pfeiffer,REP,360404,0,1,15,16,38
Kay,State House,Harold Levalley,REP,360404,0,0,28,28,38
Kay,Superintendent of Public Instruction,John Cox,DEM,360406,0,1,8,9,
Kay,Superintendent of Public Instruction,Jack Jr.,DEM,360406,0,0,4,4,
Kay,Superintendent of Public Instruction,Ivan Holmes,DEM,360406,0,0,2,2,
Kay,Superintendent of Public Instruction,Freda Deskin,DEM,360406,0,1,6,7,
Kay,U.S. Senate,Patrick Michael Hayes,DEM,360406,0,0,2,2,
Kay,U.S. Senate,Jim Rogers,DEM,360406,0,0,13,13,
Kay,U.S. Senate,Connie Johnson,DEM,360406,0,2,5,7,
Kay,Governor,Dax Ewbank,REP,360406,2,0,7,9,
Kay,Governor,Chad Moody,REP,360406,0,0,14,14,
Kay,Governor,Mary Fallin,REP,360406,1,3,83,87,
Kay,Superintendent of Public Instruction,Brian Kelly,REP,360406,0,0,36,36,
Kay,Superintendent of Public Instruction,Janet Costello Barresi,REP,360406,0,1,11,12,
Kay,Superintendent of Public Instruction,Joy Hofmeister,REP,360406,3,2,52,57,
Kay,Insurance Commissioner,Bill Viner,REP,360406,0,0,26,26,
Kay,Insurance Commissioner,John Doak,REP,360406,3,3,72,78,
Kay,Corporation Commissioner,Todd Hiett,REP,360406,3,3,55,61,
Kay,Corporation Commissioner,Cliff Branan,REP,360406,0,0,45,45,
Kay,U.S. Senate,Evelyn Rogers,REP,360406,0,0,3,3,
Kay,U.S. Senate,Rob Moye,REP,360406,0,0,0,0,
Kay,U.S. Senate,D. Jean Mcbride-Samuels,REP,360406,0,0,2,2,
Kay,U.S. Senate,Jim Inhofe,REP,360406,1,3,89,93,
Kay,U.S. Senate,Erick Paul Wyatt,REP,360406,2,0,8,10,
Kay,U.S. Senate,Andy Craig,REP,360406,0,0,3,3,
Kay,U.S. Senate,T. Shannon,REP,360406,0,2,41,43,
Kay,U.S. Senate,Randy Brogdon,REP,360406,0,0,0,0,
Kay,U.S. Senate,Eric Mccray,REP,360406,0,0,2,2,
Kay,U.S. Senate,Kevin Crow,REP,360406,0,0,1,1,
Kay,U.S. Senate,James Lankford,REP,360406,3,1,53,57,
Kay,U.S. Senate,Jason Weger,REP,360406,0,0,1,1,
Kay,U.S. House,Timothy Ray Murray,REP,360406,0,0,6,6,03
Kay,U.S. House,Robert Hubbard,REP,360406,0,0,9,9,03
Kay,U.S. House,Frank Lucas,REP,360406,3,3,89,95,03
Kay,State House,Roy Chaney,REP,360406,0,0,13,13,38
Kay,State House,Niki Schrader,REP,360406,0,0,1,1,38
Kay,State House,Jason Warren,REP,360406,0,0,1,1,38
Kay,State House,Ralph Meade,REP,360406,0,0,4,4,38
Kay,State House,John Pfeiffer,REP,360406,0,0,15,15,38
Kay,State House,Harold Levalley,REP,360406,3,3,72,78,38
Kay,Superintendent of Public Instruction,John Cox,DEM,360407,0,0,1,1,
Kay,Superintendent of Public Instruction,Jack Jr.,DEM,360407,0,0,0,0,
Kay,Superintendent of Public Instruction,Ivan Holmes,DEM,360407,0,0,1,1,
Kay,Superintendent of Public Instruction,Freda Deskin,DEM,360407,0,0,2,2,
Kay,U.S. Senate,Patrick Michael Hayes,DEM,360407,0,0,1,1,
Kay,U.S. Senate,Jim Rogers,DEM,360407,0,0,1,1,
Kay,U.S. Senate,Connie Johnson,DEM,360407,0,0,2,2,
Kay,Governor,Dax Ewbank,REP,360407,0,0,2,2,
Kay,Governor,Chad Moody,REP,360407,0,0,0,0,
Kay,Governor,Mary Fallin,REP,360407,0,0,10,10,
Kay,Superintendent of Public Instruction,Brian Kelly,REP,360407,0,0,4,4,
Kay,Superintendent of Public Instruction,Janet Costello Barresi,REP,360407,0,0,2,2,
Kay,Superintendent of Public Instruction,Joy Hofmeister,REP,360407,0,0,6,6,
Kay,Insurance Commissioner,Bill Viner,REP,360407,0,0,4,4,
Kay,Insurance Commissioner,John Doak,REP,360407,0,0,8,8,
Kay,Corporation Commissioner,Todd Hiett,REP,360407,0,0,6,6,
Kay,Corporation Commissioner,Cliff Branan,REP,360407,0,0,6,6,
Kay,U.S. Senate,Evelyn Rogers,REP,360407,0,0,0,0,
Kay,U.S. Senate,Rob Moye,REP,360407,0,0,1,1,
Kay,U.S. Senate,D. Jean Mcbride-Samuels,REP,360407,0,0,0,0,
Kay,U.S. Senate,Jim Inhofe,REP,360407,0,0,9,9,
Kay,U.S. Senate,Erick Paul Wyatt,REP,360407,0,0,2,2,
Kay,U.S. Senate,Andy Craig,REP,360407,0,0,0,0,
Kay,U.S. Senate,T. Shannon,REP,360407,0,0,4,4,
Kay,U.S. Senate,Randy Brogdon,REP,360407,0,0,0,0,
Kay,U.S. Senate,Eric Mccray,REP,360407,0,0,1,1,
Kay,U.S. Senate,Kevin Crow,REP,360407,0,0,0,0,
Kay,U.S. Senate,James Lankford,REP,360407,0,0,6,6,
Kay,U.S. Senate,Jason Weger,REP,360407,0,0,1,1,
Kay,U.S. House,Timothy Ray Murray,REP,360407,0,0,1,1,03
Kay,U.S. House,Robert Hubbard,REP,360407,0,0,2,2,03
Kay,U.S. House,Frank Lucas,REP,360407,0,0,9,9,03
Kay,State House,Roy Chaney,REP,360407,0,0,6,6,38
Kay,State House,Niki Schrader,REP,360407,0,0,0,0,38
Kay,State House,Jason Warren,REP,360407,0,0,1,1,38
Kay,State House,Ralph Meade,REP,360407,0,0,0,0,38
Kay,State House,John Pfeiffer,REP,360407,0,0,3,3,38
Kay,State House,Harold Levalley,REP,360407,0,0,2,2,38
Kay,Superintendent of Public Instruction,John Cox,DEM,360409,0,0,3,3,
Kay,Superintendent of Public Instruction,Jack Jr.,DEM,360409,0,0,0,0,
Kay,Superintendent of Public Instruction,Ivan Holmes,DEM,360409,0,0,1,1,
Kay,Superintendent of Public Instruction,Freda Deskin,DEM,360409,0,0,3,3,
Kay,U.S. Senate,Patrick Michael Hayes,DEM,360409,0,0,1,1,
Kay,U.S. Senate,Jim Rogers,DEM,360409,0,0,5,5,
Kay,U.S. Senate,Connie Johnson,DEM,360409,0,0,1,1,
Kay,Governor,Dax Ewbank,REP,360409,0,1,0,1,
Kay,Governor,Chad Moody,REP,360409,0,2,3,5,
Kay,Governor,Mary Fallin,REP,360409,1,1,15,17,
Kay,Superintendent of Public Instruction,Brian Kelly,REP,360409,0,1,5,6,
Kay,Superintendent of Public Instruction,Janet Costello Barresi,REP,360409,0,0,2,2,
Kay,Superintendent of Public Instruction,Joy Hofmeister,REP,360409,1,3,10,14,
Kay,Insurance Commissioner,Bill Viner,REP,360409,0,0,5,5,
Kay,Insurance Commissioner,John Doak,REP,360409,1,4,12,17,
Kay,Corporation Commissioner,Todd Hiett,REP,360409,0,2,10,12,
Kay,Corporation Commissioner,Cliff Branan,REP,360409,1,2,5,8,
Kay,U.S. Senate,Evelyn Rogers,REP,360409,0,0,1,1,
Kay,U.S. Senate,Rob Moye,REP,360409,0,0,1,1,
Kay,U.S. Senate,D. Jean Mcbride-Samuels,REP,360409,0,0,0,0,
Kay,U.S. Senate,Jim Inhofe,REP,360409,1,4,14,19,
Kay,U.S. Senate,Erick Paul Wyatt,REP,360409,0,0,2,2,
Kay,U.S. Senate,Andy Craig,REP,360409,0,0,0,0,
Kay,U.S. Senate,T. Shannon,REP,360409,0,1,12,13,
Kay,U.S. Senate,Randy Brogdon,REP,360409,0,0,0,0,
Kay,U.S. Senate,Eric Mccray,REP,360409,0,0,0,0,
Kay,U.S. Senate,Kevin Crow,REP,360409,0,0,0,0,
Kay,U.S. Senate,James Lankford,REP,360409,1,3,5,9,
Kay,U.S. Senate,Jason Weger,REP,360409,0,0,0,0,
Kay,U.S. House,Timothy Ray Murray,REP,360409,0,0,1,1,03
Kay,U.S. House,Robert Hubbard,REP,360409,0,0,2,2,03
Kay,U.S. House,Frank Lucas,REP,360409,1,4,15,20,03
Kay,State House,Roy Chaney,REP,360409,1,1,1,3,38
Kay,State House,Niki Schrader,REP,360409,0,1,1,2,38
Kay,State House,Jason Warren,REP,360409,0,0,2,2,38
Kay,State House,Ralph Meade,REP,360409,0,0,4,4,38
Kay,State House,John Pfeiffer,REP,360409,0,1,4,5,38
Kay,State House,Harold Levalley,REP,360409,0,1,5,6,38
Kay,Superintendent of Public Instruction,John Cox,DEM,360411,0,0,7,7,
Kay,Superintendent of Public Instruction,Jack Jr.,DEM,360411,0,0,3,3,
Kay,Superintendent of Public Instruction,Ivan Holmes,DEM,360411,0,0,4,4,
Kay,Superintendent of Public Instruction,Freda Deskin,DEM,360411,0,0,6,6,
Kay,U.S. Senate,Patrick Michael Hayes,DEM,360411,0,0,5,5,
Kay,U.S. Senate,Jim Rogers,DEM,360411,0,0,11,11,
Kay,U.S. Senate,Connie Johnson,DEM,360411,0,0,4,4,
Kay,Governor,Dax Ewbank,REP,360411,0,0,4,4,
Kay,Governor,Chad Moody,REP,360411,0,0,6,6,
Kay,Governor,Mary Fallin,REP,360411,0,1,32,33,
Kay,Superintendent of Public Instruction,Brian Kelly,REP,360411,0,0,11,11,
Kay,Superintendent of Public Instruction,Janet Costello Barresi,REP,360411,0,0,5,5,
Kay,Superintendent of Public Instruction,Joy Hofmeister,REP,360411,0,1,26,27,
Kay,Insurance Commissioner,Bill Viner,REP,360411,0,0,6,6,
Kay,Insurance Commissioner,John Doak,REP,360411,0,1,36,37,
Kay,Corporation Commissioner,Todd Hiett,REP,360411,0,1,21,22,
Kay,Corporation Commissioner,Cliff Branan,REP,360411,0,0,19,19,
Kay,U.S. Senate,Evelyn Rogers,REP,360411,0,0,3,3,
Kay,U.S. Senate,Rob Moye,REP,360411,0,0,0,0,
Kay,U.S. Senate,D. Jean Mcbride-Samuels,REP,360411,0,0,0,0,
Kay,U.S. Senate,Jim Inhofe,REP,360411,0,1,34,35,
Kay,U.S. Senate,Erick Paul Wyatt,REP,360411,0,0,2,2,
Kay,U.S. Senate,Andy Craig,REP,360411,0,0,1,1,
Kay,U.S. Senate,T. Shannon,REP,360411,0,0,18,18,
Kay,U.S. Senate,Randy Brogdon,REP,360411,0,0,4,4,
Kay,U.S. Senate,Eric Mccray,REP,360411,0,0,0,0,
Kay,U.S. Senate,Kevin Crow,REP,360411,0,0,1,1,
Kay,U.S. Senate,James Lankford,REP,360411,0,1,18,19,
Kay,U.S. Senate,Jason Weger,REP,360411,0,0,0,0,
Kay,U.S. House,Timothy Ray Murray,REP,360411,0,0,1,1,03
Kay,U.S. House,Robert Hubbard,REP,360411,0,1,5,6,03
Kay,U.S. House,Frank Lucas,REP,360411,0,0,35,35,03
Kay,Superintendent of Public Instruction,John Cox,DEM,360412,0,0,8,8,
Kay,Superintendent of Public Instruction,Jack Jr.,DEM,360412,0,0,4,4,
Kay,Superintendent of Public Instruction,Ivan Holmes,DEM,360412,0,0,2,2,
Kay,Superintendent of Public Instruction,Freda Deskin,DEM,360412,0,0,5,5,
Kay,U.S. Senate,Patrick Michael Hayes,DEM,360412,0,0,5,5,
Kay,U.S. Senate,Jim Rogers,DEM,360412,0,0,5,5,
Kay,U.S. Senate,Connie Johnson,DEM,360412,0,0,8,8,
Kay,Governor,Dax Ewbank,REP,360412,0,0,4,4,
Kay,Governor,Chad Moody,REP,360412,0,0,5,5,
Kay,Governor,Mary Fallin,REP,360412,0,0,29,29,
Kay,Superintendent of Public Instruction,Brian Kelly,REP,360412,0,0,14,14,
Kay,Superintendent of Public Instruction,Janet Costello Barresi,REP,360412,0,0,4,4,
Kay,Superintendent of Public Instruction,Joy Hofmeister,REP,360412,0,0,19,19,
Kay,Insurance Commissioner,Bill Viner,REP,360412,0,0,14,14,
Kay,Insurance Commissioner,John Doak,REP,360412,0,0,19,19,
Kay,Corporation Commissioner,Todd Hiett,REP,360412,0,0,18,18,
Kay,Corporation Commissioner,Cliff Branan,REP,360412,0,0,16,16,
Kay,U.S. Senate,Evelyn Rogers,REP,360412,0,0,2,2,
Kay,U.S. Senate,Rob Moye,REP,360412,0,0,2,2,
Kay,U.S. Senate,D. Jean Mcbride-Samuels,REP,360412,0,0,1,1,
Kay,U.S. Senate,Jim Inhofe,REP,360412,0,0,26,26,
Kay,U.S. Senate,Erick Paul Wyatt,REP,360412,0,0,5,5,
Kay,U.S. Senate,Andy Craig,REP,360412,0,0,0,0,
Kay,U.S. Senate,T. Shannon,REP,360412,0,0,21,21,
Kay,U.S. Senate,Randy Brogdon,REP,360412,0,0,3,3,
Kay,U.S. Senate,Eric Mccray,REP,360412,0,0,0,0,
Kay,U.S. Senate,Kevin Crow,REP,360412,0,0,0,0,
Kay,U.S. Senate,James Lankford,REP,360412,0,0,12,12,
Kay,U.S. Senate,Jason Weger,REP,360412,0,0,0,0,
Kay,U.S. House,Timothy Ray Murray,REP,360412,0,0,4,4,03
Kay,U.S. House,Robert Hubbard,REP,360412,0,0,6,6,03
Kay,U.S. House,Frank Lucas,REP,360412,0,0,27,27,03
Kay,Superintendent of Public Instruction,John Cox,DEM,360413,2,1,23,26,
Kay,Superintendent of Public Instruction,Jack Jr.,DEM,360413,0,0,10,10,
Kay,Superintendent of Public Instruction,Ivan Holmes,DEM,360413,0,0,2,2,
Kay,Superintendent of Public Instruction,Freda Deskin,DEM,360413,0,0,18,18,
Kay,U.S. Senate,Patrick Michael Hayes,DEM,360413,0,0,11,11,
Kay,U.S. Senate,Jim Rogers,DEM,360413,0,1,18,19,
Kay,U.S. Senate,Connie Johnson,DEM,360413,2,0,20,22,
Kay,Governor,Dax Ewbank,REP,360413,0,0,21,21,
Kay,Governor,Chad Moody,REP,360413,1,0,27,28,
Kay,Governor,Mary Fallin,REP,360413,4,4,182,190,
Kay,Superintendent of Public Instruction,Brian Kelly,REP,360413,0,0,51,51,
Kay,Superintendent of Public Instruction,Janet Costello Barresi,REP,360413,2,0,47,49,
Kay,Superintendent of Public Instruction,Joy Hofmeister,REP,360413,3,4,131,138,
Kay,Insurance Commissioner,Bill Viner,REP,360413,0,1,61,62,
Kay,Insurance Commissioner,John Doak,REP,360413,5,2,150,157,
Kay,Corporation Commissioner,Todd Hiett,REP,360413,0,2,108,110,
Kay,Corporation Commissioner,Cliff Branan,REP,360413,3,1,104,108,
Kay,U.S. Senate,Evelyn Rogers,REP,360413,0,1,10,11,
Kay,U.S. Senate,Rob Moye,REP,360413,0,0,5,5,
Kay,U.S. Senate,D. Jean Mcbride-Samuels,REP,360413,0,0,3,3,
Kay,U.S. Senate,Jim Inhofe,REP,360413,5,3,195,203,
Kay,U.S. Senate,Erick Paul Wyatt,REP,360413,0,0,14,14,
Kay,U.S. Senate,Andy Craig,REP,360413,0,1,0,1,
Kay,U.S. Senate,T. Shannon,REP,360413,1,0,87,88,
Kay,U.S. Senate,Randy Brogdon,REP,360413,0,0,9,9,
Kay,U.S. Senate,Eric Mccray,REP,360413,0,0,2,2,
Kay,U.S. Senate,Kevin Crow,REP,360413,0,0,0,0,
Kay,U.S. Senate,James Lankford,REP,360413,2,3,133,138,
Kay,U.S. Senate,Jason Weger,REP,360413,0,0,0,0,
Kay,U.S. House,Timothy Ray Murray,REP,360413,0,0,7,7,03
Kay,U.S. House,Robert Hubbard,REP,360413,0,0,32,32,03
Kay,U.S. House,Frank Lucas,REP,360413,5,4,188,197,03
Kay,Superintendent of Public Instruction,John Cox,DEM,360419,0,1,25,26,
Kay,Superintendent of Public Instruction,Jack Jr.,DEM,360419,0,0,6,6,
Kay,Superintendent of Public Instruction,Ivan Holmes,DEM,360419,0,0,0,0,
Kay,Superintendent of Public Instruction,Freda Deskin,DEM,360419,1,0,14,15,
Kay,U.S. Senate,Patrick Michael Hayes,DEM,360419,0,0,12,12,
Kay,U.S. Senate,Jim Rogers,DEM,360419,0,1,13,14,
Kay,U.S. Senate,Connie Johnson,DEM,360419,1,0,18,19,
Kay,Governor,Dax Ewbank,REP,360419,0,0,14,14,
Kay,Governor,Chad Moody,REP,360419,0,1,5,6,
Kay,Governor,Mary Fallin,REP,360419,0,2,63,65,
Kay,Superintendent of Public Instruction,Brian Kelly,REP,360419,0,2,28,30,
Kay,Superintendent of Public Instruction,Janet Costello Barresi,REP,360419,0,0,7,7,
Kay,Superintendent of Public Instruction,Joy Hofmeister,REP,360419,0,1,45,46,
Kay,Insurance Commissioner,Bill Viner,REP,360419,0,1,28,29,
Kay,Insurance Commissioner,John Doak,REP,360419,0,2,49,51,
Kay,Corporation Commissioner,Todd Hiett,REP,360419,0,3,36,39,
Kay,Corporation Commissioner,Cliff Branan,REP,360419,0,0,42,42,
Kay,U.S. Senate,Evelyn Rogers,REP,360419,0,0,5,5,
Kay,U.S. Senate,Rob Moye,REP,360419,0,0,2,2,
Kay,U.S. Senate,D. Jean Mcbride-Samuels,REP,360419,0,0,1,1,
Kay,U.S. Senate,Jim Inhofe,REP,360419,0,3,70,73,
Kay,U.S. Senate,Erick Paul Wyatt,REP,360419,0,0,4,4,
Kay,U.S. Senate,Andy Craig,REP,360419,0,0,0,0,
Kay,U.S. Senate,T. Shannon,REP,360419,0,1,34,35,
Kay,U.S. Senate,Randy Brogdon,REP,360419,0,0,1,1,
Kay,U.S. Senate,Eric Mccray,REP,360419,0,0,3,3,
Kay,U.S. Senate,Kevin Crow,REP,360419,0,1,0,1,
Kay,U.S. Senate,James Lankford,REP,360419,0,1,43,44,
Kay,U.S. Senate,Jason Weger,REP,360419,0,0,2,2,
Kay,U.S. House,Timothy Ray Murray,REP,360419,0,0,2,2,03
Kay,U.S. House,Robert Hubbard,REP,360419,0,0,10,10,03
Kay,U.S. House,Frank Lucas,REP,360419,0,3,70,73,03
Kay,Superintendent of Public Instruction,John Cox,DEM,360420,0,1,6,7,
Kay,Superintendent of Public Instruction,Jack Jr.,DEM,360420,0,0,4,4,
Kay,Superintendent of Public Instruction,Ivan Holmes,DEM,360420,0,0,1,1,
Kay,Superintendent of Public Instruction,Freda Deskin,DEM,360420,0,0,13,13,
Kay,U.S. Senate,Patrick Michael Hayes,DEM,360420,0,0,7,7,
Kay,U.S. Senate,Jim Rogers,DEM,360420,0,1,6,7,
Kay,U.S. Senate,Connie Johnson,DEM,360420,0,0,11,11,
Kay,Governor,Dax Ewbank,REP,360420,0,0,4,4,
Kay,Governor,Chad Moody,REP,360420,0,0,5,5,
Kay,Governor,Mary Fallin,REP,360420,2,3,51,56,
Kay,Superintendent of Public Instruction,Brian Kelly,REP,360420,1,0,29,30,
Kay,Superintendent of Public Instruction,Janet Costello Barresi,REP,360420,1,0,7,8,
Kay,Superintendent of Public Instruction,Joy Hofmeister,REP,360420,0,3,24,27,
Kay,Insurance Commissioner,Bill Viner,REP,360420,0,2,20,22,
Kay,Insurance Commissioner,John Doak,REP,360420,1,1,37,39,
Kay,Corporation Commissioner,Todd Hiett,REP,360420,0,2,24,26,
Kay,Corporation Commissioner,Cliff Branan,REP,360420,1,1,34,36,
Kay,U.S. Senate,Evelyn Rogers,REP,360420,1,0,0,1,
Kay,U.S. Senate,Rob Moye,REP,360420,0,0,1,1,
Kay,U.S. Senate,D. Jean Mcbride-Samuels,REP,360420,0,0,0,0,
Kay,U.S. Senate,Jim Inhofe,REP,360420,1,2,55,58,
Kay,U.S. Senate,Erick Paul Wyatt,REP,360420,0,1,4,5,
Kay,U.S. Senate,Andy Craig,REP,360420,0,0,1,1,
Kay,U.S. Senate,T. Shannon,REP,360420,1,0,23,24,
Kay,U.S. Senate,Randy Brogdon,REP,360420,0,0,0,0,
Kay,U.S. Senate,Eric Mccray,REP,360420,0,0,0,0,
Kay,U.S. Senate,Kevin Crow,REP,360420,0,0,1,1,
Kay,U.S. Senate,James Lankford,REP,360420,1,3,34,38,
Kay,U.S. Senate,Jason Weger,REP,360420,0,0,1,1,
Kay,U.S. House,Timothy Ray Murray,REP,360420,0,0,3,3,03
Kay,U.S. House,Robert Hubbard,REP,360420,0,0,6,6,03
Kay,U.S. House,Frank Lucas,REP,360420,2,3,51,56,03
Kay,State House,Roy Chaney,REP,360420,0,3,18,21,38
Kay,State House,Niki Schrader,REP,360420,1,0,3,4,38
Kay,State House,Jason Warren,REP,360420,0,0,5,5,38
Kay,State House,Ralph Meade,REP,360420,0,0,3,3,38
Kay,State House,John Pfeiffer,REP,360420,0,0,18,18,38
Kay,State House,Harold Levalley,REP,360420,1,0,13,14,38
Kay,Superintendent of Public Instruction,John Cox,DEM,360503,0,0,18,18,
Kay,Superintendent of Public Instruction,Jack Jr.,DEM,360503,0,0,14,14,
Kay,Superintendent of Public Instruction,Ivan Holmes,DEM,360503,0,2,2,4,
Kay,Superintendent of Public Instruction,Freda Deskin,DEM,360503,0,0,20,20,
Kay,U.S. Senate,Patrick Michael Hayes,DEM,360503,0,0,12,12,
Kay,U.S. Senate,Jim Rogers,DEM,360503,0,1,23,24,
Kay,U.S. Senate,Connie Johnson,DEM,360503,0,1,19,20,
Kay,Governor,Dax Ewbank,REP,360503,1,0,29,30,
Kay,Governor,Chad Moody,REP,360503,0,0,25,25,
Kay,Governor,Mary Fallin,REP,360503,6,4,149,159,
Kay,Superintendent of Public Instruction,Brian Kelly,REP,360503,0,1,47,48,
Kay,Superintendent of Public Instruction,Janet Costello Barresi,REP,360503,5,1,35,41,
Kay,Superintendent of Public Instruction,Joy Hofmeister,REP,360503,2,2,122,126,
Kay,Insurance Commissioner,Bill Viner,REP,360503,0,0,57,57,
Kay,Insurance Commissioner,John Doak,REP,360503,7,4,127,138,
Kay,Corporation Commissioner,Todd Hiett,REP,360503,6,2,86,94,
Kay,Corporation Commissioner,Cliff Branan,REP,360503,1,2,104,107,
Kay,U.S. Senate,Evelyn Rogers,REP,360503,0,0,9,9,
Kay,U.S. Senate,Rob Moye,REP,360503,0,0,7,7,
Kay,U.S. Senate,D. Jean Mcbride-Samuels,REP,360503,0,0,3,3,
Kay,U.S. Senate,Jim Inhofe,REP,360503,7,4,174,185,
Kay,U.S. Senate,Erick Paul Wyatt,REP,360503,0,0,11,11,
Kay,U.S. Senate,Andy Craig,REP,360503,0,0,2,2,
Kay,U.S. Senate,T. Shannon,REP,360503,5,3,79,87,
Kay,U.S. Senate,Randy Brogdon,REP,360503,0,0,7,7,
Kay,U.S. Senate,Eric Mccray,REP,360503,0,0,2,2,
Kay,U.S. Senate,Kevin Crow,REP,360503,0,0,2,2,
Kay,U.S. Senate,James Lankford,REP,360503,2,1,112,115,
Kay,U.S. Senate,Jason Weger,REP,360503,0,0,1,1,
Kay,U.S. House,Timothy Ray Murray,REP,360503,0,0,11,11,03
Kay,U.S. House,Robert Hubbard,REP,360503,0,0,27,27,03
Kay,U.S. House,Frank Lucas,REP,360503,7,4,164,175,03
Kay,Superintendent of Public Instruction,John Cox,DEM,360507,0,0,11,11,
Kay,Superintendent of Public Instruction,Jack Jr.,DEM,360507,0,0,8,8,
Kay,Superintendent of Public Instruction,Ivan Holmes,DEM,360507,0,0,3,3,
Kay,Superintendent of Public Instruction,Freda Deskin,DEM,360507,1,1,11,13,
Kay,U.S. Senate,Patrick Michael Hayes,DEM,360507,0,0,12,12,
Kay,U.S. Senate,Jim Rogers,DEM,360507,0,1,17,18,
Kay,U.S. Senate,Connie Johnson,DEM,360507,1,0,3,4,
Kay,Governor,Dax Ewbank,REP,360507,0,0,8,8,
Kay,Governor,Chad Moody,REP,360507,2,0,13,15,
Kay,Governor,Mary Fallin,REP,360507,1,0,68,69,
Kay,Superintendent of Public Instruction,Brian Kelly,REP,360507,3,0,30,33,
Kay,Superintendent of Public Instruction,Janet Costello Barresi,REP,360507,0,0,18,18,
Kay,Superintendent of Public Instruction,Joy Hofmeister,REP,360507,0,0,42,42,
Kay,Insurance Commissioner,Bill Viner,REP,360507,0,0,25,25,
Kay,Insurance Commissioner,John Doak,REP,360507,3,0,60,63,
Kay,Corporation Commissioner,Todd Hiett,REP,360507,3,0,43,46,
Kay,Corporation Commissioner,Cliff Branan,REP,360507,0,0,44,44,
Kay,U.S. Senate,Evelyn Rogers,REP,360507,0,0,4,4,
Kay,U.S. Senate,Rob Moye,REP,360507,0,0,0,0,
Kay,U.S. Senate,D. Jean Mcbride-Samuels,REP,360507,0,0,0,0,
Kay,U.S. Senate,Jim Inhofe,REP,360507,1,0,78,79,
Kay,U.S. Senate,Erick Paul Wyatt,REP,360507,2,0,8,10,
Kay,U.S. Senate,Andy Craig,REP,360507,0,0,2,2,
Kay,U.S. Senate,T. Shannon,REP,360507,3,0,43,46,
Kay,U.S. Senate,Randy Brogdon,REP,360507,0,0,3,3,
Kay,U.S. Senate,Eric Mccray,REP,360507,0,0,1,1,
Kay,U.S. Senate,Kevin Crow,REP,360507,0,0,3,3,
Kay,U.S. Senate,James Lankford,REP,360507,0,0,37,37,
Kay,U.S. Senate,Jason Weger,REP,360507,0,0,0,0,
Kay,U.S. House,Timothy Ray Murray,REP,360507,0,0,10,10,03
Kay,U.S. House,Robert Hubbard,REP,360507,2,0,12,14,03
Kay,U.S. House,Frank Lucas,REP,360507,1,0,63,64,03
Kay,Superintendent of Public Instruction,John Cox,DEM,360516,0,0,9,9,
Kay,Superintendent of Public Instruction,Jack Jr.,DEM,360516,0,0,1,1,
Kay,Superintendent of Public Instruction,Ivan Holmes,DEM,360516,0,0,3,3,
Kay,Superintendent of Public Instruction,Freda Deskin,DEM,360516,0,0,17,17,
Kay,U.S. Senate,Patrick Michael Hayes,DEM,360516,0,0,10,10,
Kay,U.S. Senate,Jim Rogers,DEM,360516,0,0,12,12,
Kay,U.S. Senate,Connie Johnson,DEM,360516,0,0,8,8,
Kay,Governor,Dax Ewbank,REP,360516,0,0,12,12,
Kay,Governor,Chad Moody,REP,360516,0,0,17,17,
Kay,Governor,Mary Fallin,REP,360516,0,0,25,25,
Kay,Superintendent of Public Instruction,Brian Kelly,REP,360516,0,0,21,21,
Kay,Superintendent of Public Instruction,Janet Costello Barresi,REP,360516,0,0,9,9,
Kay,Superintendent of Public Instruction,Joy Hofmeister,REP,360516,0,0,25,25,
Kay,Insurance Commissioner,Bill Viner,REP,360516,0,0,26,26,
Kay,Insurance Commissioner,John Doak,REP,360516,0,0,28,28,
Kay,Corporation Commissioner,Todd Hiett,REP,360516,0,0,26,26,
Kay,Corporation Commissioner,Cliff Branan,REP,360516,0,0,25,25,
Kay,U.S. Senate,Evelyn Rogers,REP,360516,0,0,5,5,
Kay,U.S. Senate,Rob Moye,REP,360516,0,0,3,3,
Kay,U.S. Senate,D. Jean Mcbride-Samuels,REP,360516,0,0,2,2,
Kay,U.S. Senate,Jim Inhofe,REP,360516,0,0,42,42,
Kay,U.S. Senate,Erick Paul Wyatt,REP,360516,0,0,2,2,
Kay,U.S. Senate,Andy Craig,REP,360516,0,0,1,1,
Kay,U.S. Senate,T. Shannon,REP,360516,0,0,29,29,
Kay,U.S. Senate,Randy Brogdon,REP,360516,0,0,2,2,
Kay,U.S. Senate,Eric Mccray,REP,360516,0,0,1,1,
Kay,U.S. Senate,Kevin Crow,REP,360516,0,0,3,3,
Kay,U.S. Senate,James Lankford,REP,360516,0,0,17,17,
Kay,U.S. Senate,Jason Weger,REP,360516,0,0,2,2,
Kay,U.S. House,Timothy Ray Murray,REP,360516,0,0,12,12,03
Kay,U.S. House,Robert Hubbard,REP,360516,0,0,13,13,03
Kay,U.S. House,Frank Lucas,REP,360516,0,0,29,29,03
Kay,Superintendent of Public Instruction,John Cox,DEM,360517,0,0,17,17,
Kay,Superintendent of Public Instruction,Jack Jr.,DEM,360517,0,0,2,2,
Kay,Superintendent of Public Instruction,Ivan Holmes,DEM,360517,0,0,3,3,
Kay,Superintendent of Public Instruction,Freda Deskin,DEM,360517,0,0,17,17,
Kay,U.S. Senate,Patrick Michael Hayes,DEM,360517,0,0,3,3,
Kay,U.S. Senate,Jim Rogers,DEM,360517,0,0,16,16,
Kay,U.S. Senate,Connie Johnson,DEM,360517,0,0,20,20,
Kay,Governor,Dax Ewbank,REP,360517,0,0,8,8,
Kay,Governor,Chad Moody,REP,360517,1,1,19,21,
Kay,Governor,Mary Fallin,REP,360517,1,3,71,75,
Kay,Superintendent of Public Instruction,Brian Kelly,REP,360517,1,0,32,33,
Kay,Superintendent of Public Instruction,Janet Costello Barresi,REP,360517,0,0,12,12,
Kay,Superintendent of Public Instruction,Joy Hofmeister,REP,360517,1,4,53,58,
Kay,Insurance Commissioner,Bill Viner,REP,360517,1,1,42,44,
Kay,Insurance Commissioner,John Doak,REP,360517,1,2,49,52,
Kay,Corporation Commissioner,Todd Hiett,REP,360517,1,3,44,48,
Kay,Corporation Commissioner,Cliff Branan,REP,360517,1,1,47,49,
Kay,U.S. Senate,Evelyn Rogers,REP,360517,0,2,14,16,
Kay,U.S. Senate,Rob Moye,REP,360517,0,0,1,1,
Kay,U.S. Senate,D. Jean Mcbride-Samuels,REP,360517,1,0,1,2,
Kay,U.S. Senate,Jim Inhofe,REP,360517,0,1,76,77,
Kay,U.S. Senate,Erick Paul Wyatt,REP,360517,1,1,6,8,
Kay,U.S. Senate,Andy Craig,REP,360517,0,0,0,0,
Kay,U.S. Senate,T. Shannon,REP,360517,0,2,46,48,
Kay,U.S. Senate,Randy Brogdon,REP,360517,0,0,3,3,
Kay,U.S. Senate,Eric Mccray,REP,360517,0,0,4,4,
Kay,U.S. Senate,Kevin Crow,REP,360517,1,0,1,2,
Kay,U.S. Senate,James Lankford,REP,360517,1,2,41,44,
Kay,U.S. Senate,Jason Weger,REP,360517,0,0,1,1,
Kay,U.S. House,Timothy Ray Murray,REP,360517,1,1,7,9,03
Kay,U.S. House,Robert Hubbard,REP,360517,0,1,16,17,03
Kay,U.S. House,Frank Lucas,REP,360517,1,2,74,77,03
Kay,Superintendent of Public Instruction,John Cox,DEM,360527,0,1,19,20,
Kay,Superintendent of Public Instruction,Jack Jr.,DEM,360527,0,0,6,6,
Kay,Superintendent of Public Instruction,Ivan Holmes,DEM,360527,1,0,5,6,
Kay,Superintendent of Public Instruction,Freda Deskin,DEM,360527,0,1,17,18,
Kay,U.S. Senate,Patrick Michael Hayes,DEM,360527,0,0,7,7,
Kay,U.S. Senate,Jim Rogers,DEM,360527,0,0,23,23,
Kay,U.S. Senate,Connie Johnson,DEM,360527,1,2,17,20,
Kay,Governor,Dax Ewbank,REP,360527,1,0,19,20,
Kay,Governor,Chad Moody,REP,360527,0,1,33,34,
Kay,Governor,Mary Fallin,REP,360527,3,4,164,171,
Kay,Superintendent of Public Instruction,Brian Kelly,REP,360527,1,0,43,44,
Kay,Superintendent of Public Instruction,Janet Costello Barresi,REP,360527,1,2,49,52,
Kay,Superintendent of Public Instruction,Joy Hofmeister,REP,360527,2,3,123,128,
Kay,Insurance Commissioner,Bill Viner,REP,360527,1,0,58,59,
Kay,Insurance Commissioner,John Doak,REP,360527,3,5,141,149,
Kay,Corporation Commissioner,Todd Hiett,REP,360527,1,5,101,107,
Kay,Corporation Commissioner,Cliff Branan,REP,360527,3,0,100,103,
Kay,U.S. Senate,Evelyn Rogers,REP,360527,0,0,9,9,
Kay,U.S. Senate,Rob Moye,REP,360527,1,0,7,8,
Kay,U.S. Senate,D. Jean Mcbride-Samuels,REP,360527,0,0,1,1,
Kay,U.S. Senate,Jim Inhofe,REP,360527,3,5,186,194,
Kay,U.S. Senate,Erick Paul Wyatt,REP,360527,0,0,12,12,
Kay,U.S. Senate,Andy Craig,REP,360527,0,0,0,0,
Kay,U.S. Senate,T. Shannon,REP,360527,1,0,84,85,
Kay,U.S. Senate,Randy Brogdon,REP,360527,1,0,14,15,
Kay,U.S. Senate,Eric Mccray,REP,360527,0,0,2,2,
Kay,U.S. Senate,Kevin Crow,REP,360527,0,0,3,3,
Kay,U.S. Senate,James Lankford,REP,360527,2,5,111,118,
Kay,U.S. Senate,Jason Weger,REP,360527,0,0,2,2,
Kay,U.S. House,Timothy Ray Murray,REP,360527,0,0,13,13,03
Kay,U.S. House,Robert Hubbard,REP,360527,0,0,27,27,03
Kay,U.S. House,Frank Lucas,REP,360527,4,5,169,178,03
Kay,Superintendent of Public Instruction,John Cox,DEM,360530,0,0,14,14,
Kay,Superintendent of Public Instruction,Jack Jr.,DEM,360530,0,0,7,7,
Kay,Superintendent of Public Instruction,Ivan Holmes,DEM,360530,0,0,4,4,
Kay,Superintendent of Public Instruction,Freda Deskin,DEM,360530,0,1,15,16,
Kay,U.S. Senate,Patrick Michael Hayes,DEM,360530,0,0,4,4,
Kay,U.S. Senate,Jim Rogers,DEM,360530,0,0,18,18,
Kay,U.S. Senate,Connie Johnson,DEM,360530,0,1,18,19,
Kay,Governor,Dax Ewbank,REP,360530,1,0,17,18,
Kay,Governor,Chad Moody,REP,360530,0,0,23,23,
Kay,Governor,Mary Fallin,REP,360530,4,7,101,112,
Kay,Superintendent of Public Instruction,Brian Kelly,REP,360530,2,2,44,48,
Kay,Superintendent of Public Instruction,Janet Costello Barresi,REP,360530,1,3,25,29,
Kay,Superintendent of Public Instruction,Joy Hofmeister,REP,360530,2,1,73,76,
Kay,Insurance Commissioner,Bill Viner,REP,360530,3,2,41,46,
Kay,Insurance Commissioner,John Doak,REP,360530,2,4,92,98,
Kay,Corporation Commissioner,Todd Hiett,REP,360530,2,1,62,65,
Kay,Corporation Commissioner,Cliff Branan,REP,360530,3,5,76,84,
Kay,U.S. Senate,Evelyn Rogers,REP,360530,1,0,8,9,
Kay,U.S. Senate,Rob Moye,REP,360530,0,0,2,2,
Kay,U.S. Senate,D. Jean Mcbride-Samuels,REP,360530,0,0,0,0,
Kay,U.S. Senate,Jim Inhofe,REP,360530,3,7,118,128,
Kay,U.S. Senate,Erick Paul Wyatt,REP,360530,1,0,13,14,
Kay,U.S. Senate,Andy Craig,REP,360530,0,0,1,1,
Kay,U.S. Senate,T. Shannon,REP,360530,2,7,62,71,
Kay,U.S. Senate,Randy Brogdon,REP,360530,0,0,2,2,
Kay,U.S. Senate,Eric Mccray,REP,360530,0,0,2,2,
Kay,U.S. Senate,Kevin Crow,REP,360530,0,0,1,1,
Kay,U.S. Senate,James Lankford,REP,360530,3,0,71,74,
Kay,U.S. Senate,Jason Weger,REP,360530,0,0,2,2,
Kay,U.S. House,Timothy Ray Murray,REP,360530,1,0,6,7,03
Kay,U.S. House,Robert Hubbard,REP,360530,1,1,23,25,03
Kay,U.S. House,Frank Lucas,REP,360530,3,5,112,120,03
Kay,Superintendent of Public Instruction,John Cox,DEM,360532,0,0,23,23,
Kay,Superintendent of Public Instruction,Jack Jr.,DEM,360532,0,0,9,9,
Kay,Superintendent of Public Instruction,Ivan Holmes,DEM,360532,0,0,5,5,
Kay,Superintendent of Public Instruction,Freda Deskin,DEM,360532,0,0,25,25,
Kay,U.S. Senate,Patrick Michael Hayes,DEM,360532,0,0,11,11,
Kay,U.S. Senate,Jim Rogers,DEM,360532,0,0,20,20,
Kay,U.S. Senate,Connie Johnson,DEM,360532,0,0,29,29,
Kay,Governor,Dax Ewbank,REP,360532,1,1,20,22,
Kay,Governor,Chad Moody,REP,360532,1,4,25,30,
Kay,Governor,Mary Fallin,REP,360532,0,3,174,177,
Kay,Superintendent of Public Instruction,Brian Kelly,REP,360532,1,0,60,61,
Kay,Superintendent of Public Instruction,Janet Costello Barresi,REP,360532,0,0,35,35,
Kay,Superintendent of Public Instruction,Joy Hofmeister,REP,360532,1,8,124,133,
Kay,Insurance Commissioner,Bill Viner,REP,360532,1,0,60,61,
Kay,Insurance Commissioner,John Doak,REP,360532,1,7,143,151,
Kay,Corporation Commissioner,Todd Hiett,REP,360532,1,4,113,118,
Kay,Corporation Commissioner,Cliff Branan,REP,360532,0,4,91,95,
Kay,U.S. Senate,Evelyn Rogers,REP,360532,0,0,9,9,
Kay,U.S. Senate,Rob Moye,REP,360532,0,0,4,4,
Kay,U.S. Senate,D. Jean Mcbride-Samuels,REP,360532,0,0,2,2,
Kay,U.S. Senate,Jim Inhofe,REP,360532,2,7,190,199,
Kay,U.S. Senate,Erick Paul Wyatt,REP,360532,0,1,13,14,
Kay,U.S. Senate,Andy Craig,REP,360532,0,0,2,2,
Kay,U.S. Senate,T. Shannon,REP,360532,0,1,80,81,
Kay,U.S. Senate,Randy Brogdon,REP,360532,1,0,3,4,
Kay,U.S. Senate,Eric Mccray,REP,360532,0,0,3,3,
Kay,U.S. Senate,Kevin Crow,REP,360532,0,0,1,1,
Kay,U.S. Senate,James Lankford,REP,360532,3,7,131,141,
Kay,U.S. Senate,Jason Weger,REP,360532,0,0,1,1,
Kay,U.S. House,Timothy Ray Murray,REP,360532,0,0,11,11,03
Kay,U.S. House,Robert Hubbard,REP,360532,1,0,24,25,03
Kay,U.S. House,Frank Lucas,REP,360532,1,8,183,192,03
Kay,Superintendent of Public Instruction,John Cox,DEM,360533,0,1,17,18,
Kay,Superintendent of Public Instruction,Jack Jr.,DEM,360533,0,0,4,4,
Kay,Superintendent of Public Instruction,Ivan Holmes,DEM,360533,0,0,3,3,
Kay,Superintendent of Public Instruction,Freda Deskin,DEM,360533,0,1,20,21,
Kay,U.S. Senate,Patrick Michael Hayes,DEM,360533,0,0,7,7,
Kay,U.S. Senate,Jim Rogers,DEM,360533,0,1,17,18,
Kay,U.S. Senate,Connie Johnson,DEM,360533,0,1,20,21,
Kay,Governor,Dax Ewbank,REP,360533,1,0,23,24,
Kay,Governor,Chad Moody,REP,360533,0,2,22,24,
Kay,Governor,Mary Fallin,REP,360533,2,2,143,147,
Kay,Superintendent of Public Instruction,Brian Kelly,REP,360533,1,1,54,56,
Kay,Superintendent of Public Instruction,Janet Costello Barresi,REP,360533,0,0,22,22,
Kay,Superintendent of Public Instruction,Joy Hofmeister,REP,360533,2,3,103,108,
Kay,Insurance Commissioner,Bill Viner,REP,360533,1,2,57,60,
Kay,Insurance Commissioner,John Doak,REP,360533,0,2,96,98,
Kay,Corporation Commissioner,Todd Hiett,REP,360533,0,1,87,88,
Kay,Corporation Commissioner,Cliff Branan,REP,360533,1,3,77,81,
Kay,U.S. Senate,Evelyn Rogers,REP,360533,0,1,6,7,
Kay,U.S. Senate,Rob Moye,REP,360533,0,0,6,6,
Kay,U.S. Senate,D. Jean Mcbride-Samuels,REP,360533,0,0,1,1,
Kay,U.S. Senate,Jim Inhofe,REP,360533,3,3,152,158,
Kay,U.S. Senate,Erick Paul Wyatt,REP,360533,0,0,16,16,
Kay,U.S. Senate,Andy Craig,REP,360533,1,0,4,5,
Kay,U.S. Senate,T. Shannon,REP,360533,0,2,65,67,
Kay,U.S. Senate,Randy Brogdon,REP,360533,0,0,9,9,
Kay,U.S. Senate,Eric Mccray,REP,360533,0,0,1,1,
Kay,U.S. Senate,Kevin Crow,REP,360533,0,0,1,1,
Kay,U.S. Senate,James Lankford,REP,360533,2,2,104,108,
Kay,U.S. Senate,Jason Weger,REP,360533,0,0,2,2,
Kay,U.S. House,Timothy Ray Murray,REP,360533,0,1,9,10,03
Kay,U.S. House,Robert Hubbard,REP,360533,0,0,31,31,03
Kay,U.S. House,Frank Lucas,REP,360533,3,3,140,146,03
Kay,Superintendent of Public Instruction,John Cox,DEM,360534,0,0,23,23,
Kay,Superintendent of Public Instruction,Jack Jr.,DEM,360534,0,0,15,15,
Kay,Superintendent of Public Instruction,Ivan Holmes,DEM,360534,0,0,7,7,
Kay,Superintendent of Public Instruction,Freda Deskin,DEM,360534,1,1,27,29,
Kay,U.S. Senate,Patrick Michael Hayes,DEM,360534,0,0,14,14,
Kay,U.S. Senate,Jim Rogers,DEM,360534,1,0,30,31,
Kay,U.S. Senate,Connie Johnson,DEM,360534,0,1,26,27,
Kay,Governor,Dax Ewbank,REP,360534,1,1,28,30,
Kay,Governor,Chad Moody,REP,360534,1,0,46,47,
Kay,Governor,Mary Fallin,REP,360534,1,6,235,242,
Kay,Superintendent of Public Instruction,Brian Kelly,REP,360534,0,0,77,77,
Kay,Superintendent of Public Instruction,Janet Costello Barresi,REP,360534,0,1,48,49,
Kay,Superintendent of Public Instruction,Joy Hofmeister,REP,360534,3,6,180,189,
Kay,Insurance Commissioner,Bill Viner,REP,360534,0,1,95,96,
Kay,Insurance Commissioner,John Doak,REP,360534,3,5,184,192,
Kay,Corporation Commissioner,Todd Hiett,REP,360534,0,5,151,156,
Kay,Corporation Commissioner,Cliff Branan,REP,360534,2,1,138,141,
Kay,U.S. Senate,Evelyn Rogers,REP,360534,0,1,18,19,
Kay,U.S. Senate,Rob Moye,REP,360534,0,0,6,6,
Kay,U.S. Senate,D. Jean Mcbride-Samuels,REP,360534,0,0,3,3,
Kay,U.S. Senate,Jim Inhofe,REP,360534,1,6,270,277,
Kay,U.S. Senate,Erick Paul Wyatt,REP,360534,1,0,11,12,
Kay,U.S. Senate,Andy Craig,REP,360534,0,1,2,3,
Kay,U.S. Senate,T. Shannon,REP,360534,2,2,101,105,
Kay,U.S. Senate,Randy Brogdon,REP,360534,0,0,9,9,
Kay,U.S. Senate,Eric Mccray,REP,360534,1,0,3,4,
Kay,U.S. Senate,Kevin Crow,REP,360534,0,0,2,2,
Kay,U.S. Senate,James Lankford,REP,360534,0,4,188,192,
Kay,U.S. Senate,Jason Weger,REP,360534,0,0,2,2,
Kay,U.S. House,Timothy Ray Murray,REP,360534,0,0,19,19,03
Kay,U.S. House,Robert Hubbard,REP,360534,0,1,45,46,03
Kay,U.S. House,Frank Lucas,REP,360534,2,6,242,250,03
Kay,Superintendent of Public Instruction,John Cox,DEM,360535,0,0,10,10,
Kay,Superintendent of Public Instruction,Jack Jr.,DEM,360535,0,0,9,9,
Kay,Superintendent of Public Instruction,Ivan Holmes,DEM,360535,0,1,5,6,
Kay,Superintendent of Public Instruction,Freda Deskin,DEM,360535,0,1,23,24,
Kay,U.S. Senate,Patrick Michael Hayes,DEM,360535,0,1,12,13,
Kay,U.S. Senate,Jim Rogers,DEM,360535,0,0,15,15,
Kay,U.S. Senate,Connie Johnson,DEM,360535,0,1,20,21,
Kay,Governor,Dax Ewbank,REP,360535,0,3,15,18,
Kay,Governor,Chad Moody,REP,360535,0,4,28,32,
Kay,Governor,Mary Fallin,REP,360535,10,8,225,243,
Kay,Superintendent of Public Instruction,Brian Kelly,REP,360535,0,2,55,57,
Kay,Superintendent of Public Instruction,Janet Costello Barresi,REP,360535,1,2,56,59,
Kay,Superintendent of Public Instruction,Joy Hofmeister,REP,360535,9,10,158,177,
Kay,Insurance Commissioner,Bill Viner,REP,360535,0,5,78,83,
Kay,Insurance Commissioner,John Doak,REP,360535,9,9,167,185,
Kay,Corporation Commissioner,Todd Hiett,REP,360535,7,8,141,156,
Kay,Corporation Commissioner,Cliff Branan,REP,360535,2,6,116,124,
Kay,U.S. Senate,Evelyn Rogers,REP,360535,0,2,11,13,
Kay,U.S. Senate,Rob Moye,REP,360535,0,0,3,3,
Kay,U.S. Senate,D. Jean Mcbride-Samuels,REP,360535,0,0,6,6,
Kay,U.S. Senate,Jim Inhofe,REP,360535,10,10,240,260,
Kay,U.S. Senate,Erick Paul Wyatt,REP,360535,0,2,8,10,
Kay,U.S. Senate,Andy Craig,REP,360535,0,1,2,3,
Kay,U.S. Senate,T. Shannon,REP,360535,5,2,98,105,
Kay,U.S. Senate,Randy Brogdon,REP,360535,0,1,5,6,
Kay,U.S. Senate,Eric Mccray,REP,360535,0,0,1,1,
Kay,U.S. Senate,Kevin Crow,REP,360535,0,0,0,0,
Kay,U.S. Senate,James Lankford,REP,360535,5,11,163,179,
Kay,U.S. Senate,Jason Weger,REP,360535,0,0,1,1,
Kay,U.S. House,Timothy Ray Murray,REP,360535,0,2,7,9,03
Kay,U.S. House,Robert Hubbard,REP,360535,0,1,37,38,03
Kay,U.S. House,Frank Lucas,REP,360535,10,11,218,239,03
Kingfisher,Superintendent of Public Instruction,John Cox,DEM,370101,0,3,32,35,
Kingfisher,Superintendent of Public Instruction,Jack Jr.,DEM,370101,2,1,6,9,
Kingfisher,Superintendent of Public Instruction,Ivan Holmes,DEM,370101,3,0,11,14,
Kingfisher,Superintendent of Public Instruction,Freda Deskin,DEM,370101,0,4,29,33,
Kingfisher,U.S. Senate,Patrick Michael Hayes,DEM,370101,0,2,23,25,
Kingfisher,U.S. Senate,Jim Rogers,DEM,370101,4,2,25,31,
Kingfisher,U.S. Senate,Connie Johnson,DEM,370101,0,4,27,31,
Kingfisher,Governor,Dax Ewbank,REP,370101,0,3,26,29,
Kingfisher,Governor,Chad Moody,REP,370101,0,8,46,54,
Kingfisher,Governor,Mary Fallin,REP,370101,4,29,279,312,
Kingfisher,Superintendent of Public Instruction,Brian Kelly,REP,370101,1,7,77,85,
Kingfisher,Superintendent of Public Instruction,Janet Costello Barresi,REP,370101,1,9,64,74,
Kingfisher,Superintendent of Public Instruction,Joy Hofmeister,REP,370101,2,24,209,235,
Kingfisher,Insurance Commissioner,Bill Viner,REP,370101,0,9,61,70,
Kingfisher,Insurance Commissioner,John Doak,REP,370101,4,30,279,313,
Kingfisher,Corporation Commissioner,Todd Hiett,REP,370101,2,16,139,157,
Kingfisher,Corporation Commissioner,Cliff Branan,REP,370101,2,20,197,219,
Kingfisher,U.S. Senate,Evelyn Rogers,REP,370101,0,2,11,13,
Kingfisher,U.S. Senate,Rob Moye,REP,370101,0,0,8,8,
Kingfisher,U.S. Senate,D. Jean Mcbride-Samuels,REP,370101,0,0,6,6,
Kingfisher,U.S. Senate,Jim Inhofe,REP,370101,3,38,319,360,
Kingfisher,U.S. Senate,Erick Paul Wyatt,REP,370101,1,0,8,9,
Kingfisher,U.S. Senate,Andy Craig,REP,370101,0,0,2,2,
Kingfisher,U.S. Senate,T. Shannon,REP,370101,2,6,136,144,
Kingfisher,U.S. Senate,Randy Brogdon,REP,370101,0,1,6,7,
Kingfisher,U.S. Senate,Eric Mccray,REP,370101,0,0,4,4,
Kingfisher,U.S. Senate,Kevin Crow,REP,370101,0,0,4,4,
Kingfisher,U.S. Senate,James Lankford,REP,370101,2,32,202,236,
Kingfisher,U.S. Senate,Jason Weger,REP,370101,0,1,0,1,
Kingfisher,U.S. House,Timothy Ray Murray,REP,370101,0,2,8,10,03
Kingfisher,U.S. House,Robert Hubbard,REP,370101,0,2,30,32,03
Kingfisher,U.S. House,Frank Lucas,REP,370101,4,36,316,356,03
Kingfisher,State Senate,Darcy Jech,REP,370101,2,36,292,330,26
Kingfisher,State Senate,Dan Gambill,REP,370101,2,4,64,70,26
Kingfisher,Superintendent of Public Instruction,John Cox,DEM,370102,0,0,3,3,
Kingfisher,Superintendent of Public Instruction,Jack Jr.,DEM,370102,0,0,1,1,
Kingfisher,Superintendent of Public Instruction,Ivan Holmes,DEM,370102,0,0,2,2,
Kingfisher,Superintendent of Public Instruction,Freda Deskin,DEM,370102,0,0,5,5,
Kingfisher,U.S. Senate,Patrick Michael Hayes,DEM,370102,0,0,3,3,
Kingfisher,U.S. Senate,Jim Rogers,DEM,370102,0,0,2,2,
Kingfisher,U.S. Senate,Connie Johnson,DEM,370102,0,0,5,5,
Kingfisher,Governor,Dax Ewbank,REP,370102,0,0,7,7,
Kingfisher,Governor,Chad Moody,REP,370102,0,1,6,7,
Kingfisher,Governor,Mary Fallin,REP,370102,4,1,68,73,
Kingfisher,Superintendent of Public Instruction,Brian Kelly,REP,370102,0,0,20,20,
Kingfisher,Superintendent of Public Instruction,Janet Costello Barresi,REP,370102,1,2,15,18,
Kingfisher,Superintendent of Public Instruction,Joy Hofmeister,REP,370102,3,1,46,50,
Kingfisher,Insurance Commissioner,Bill Viner,REP,370102,1,0,16,17,
Kingfisher,Insurance Commissioner,John Doak,REP,370102,3,2,64,69,
Kingfisher,Corporation Commissioner,Todd Hiett,REP,370102,2,0,41,43,
Kingfisher,Corporation Commissioner,Cliff Branan,REP,370102,1,2,37,40,
Kingfisher,U.S. Senate,Evelyn Rogers,REP,370102,0,0,4,4,
Kingfisher,U.S. Senate,Rob Moye,REP,370102,0,0,2,2,
Kingfisher,U.S. Senate,D. Jean Mcbride-Samuels,REP,370102,0,0,0,0,
Kingfisher,U.S. Senate,Jim Inhofe,REP,370102,4,2,72,78,
Kingfisher,U.S. Senate,Erick Paul Wyatt,REP,370102,0,0,3,3,
Kingfisher,U.S. Senate,Andy Craig,REP,370102,0,0,1,1,
Kingfisher,U.S. Senate,T. Shannon,REP,370102,3,0,21,24,
Kingfisher,U.S. Senate,Randy Brogdon,REP,370102,0,0,1,1,
Kingfisher,U.S. Senate,Eric Mccray,REP,370102,0,0,1,1,
Kingfisher,U.S. Senate,Kevin Crow,REP,370102,0,0,0,0,
Kingfisher,U.S. Senate,James Lankford,REP,370102,1,2,57,60,
Kingfisher,U.S. Senate,Jason Weger,REP,370102,0,0,0,0,
Kingfisher,U.S. House,Timothy Ray Murray,REP,370102,0,0,1,1,03
Kingfisher,U.S. House,Robert Hubbard,REP,370102,0,0,6,6,03
Kingfisher,U.S. House,Frank Lucas,REP,370102,4,2,74,80,03
Kingfisher,State Senate,Dan Ladd,REP,370102,0,1,26,27,20
Kingfisher,State Senate,A Griffin,REP,370102,4,1,55,60,20
Kingfisher,Superintendent of Public Instruction,John Cox,DEM,370103,0,0,4,4,
Kingfisher,Superintendent of Public Instruction,Jack Jr.,DEM,370103,0,1,0,1,
Kingfisher,Superintendent of Public Instruction,Ivan Holmes,DEM,370103,0,0,1,1,
Kingfisher,Superintendent of Public Instruction,Freda Deskin,DEM,370103,0,1,3,4,
Kingfisher,U.S. Senate,Patrick Michael Hayes,DEM,370103,0,0,0,0,
Kingfisher,U.S. Senate,Jim Rogers,DEM,370103,0,1,6,7,
Kingfisher,U.S. Senate,Connie Johnson,DEM,370103,0,1,2,3,
Kingfisher,Governor,Dax Ewbank,REP,370103,0,0,8,8,
Kingfisher,Governor,Chad Moody,REP,370103,0,4,6,10,
Kingfisher,Governor,Mary Fallin,REP,370103,3,16,76,95,
Kingfisher,Superintendent of Public Instruction,Brian Kelly,REP,370103,0,2,20,22,
Kingfisher,Superintendent of Public Instruction,Janet Costello Barresi,REP,370103,2,8,10,20,
Kingfisher,Superintendent of Public Instruction,Joy Hofmeister,REP,370103,1,10,60,71,
Kingfisher,Insurance Commissioner,Bill Viner,REP,370103,1,0,11,12,
Kingfisher,Insurance Commissioner,John Doak,REP,370103,2,20,79,101,
Kingfisher,Corporation Commissioner,Todd Hiett,REP,370103,0,9,47,56,
Kingfisher,Corporation Commissioner,Cliff Branan,REP,370103,3,11,41,55,
Kingfisher,U.S. Senate,Evelyn Rogers,REP,370103,0,1,3,4,
Kingfisher,U.S. Senate,Rob Moye,REP,370103,0,0,0,0,
Kingfisher,U.S. Senate,D. Jean Mcbride-Samuels,REP,370103,1,0,0,1,
Kingfisher,U.S. Senate,Jim Inhofe,REP,370103,2,19,82,103,
Kingfisher,U.S. Senate,Erick Paul Wyatt,REP,370103,0,0,6,6,
Kingfisher,U.S. Senate,Andy Craig,REP,370103,0,0,2,2,
Kingfisher,U.S. Senate,T. Shannon,REP,370103,1,11,34,46,
Kingfisher,U.S. Senate,Randy Brogdon,REP,370103,0,0,5,5,
Kingfisher,U.S. Senate,Eric Mccray,REP,370103,0,0,1,1,
Kingfisher,U.S. Senate,Kevin Crow,REP,370103,0,0,0,0,
Kingfisher,U.S. Senate,James Lankford,REP,370103,2,9,49,60,
Kingfisher,U.S. Senate,Jason Weger,REP,370103,0,0,0,0,
Kingfisher,U.S. House,Timothy Ray Murray,REP,370103,0,1,4,5,03
Kingfisher,U.S. House,Robert Hubbard,REP,370103,1,1,7,9,03
Kingfisher,U.S. House,Frank Lucas,REP,370103,2,18,79,99,03
Kingfisher,State Senate,Dan Ladd,REP,370103,0,1,26,27,20
Kingfisher,State Senate,A Griffin,REP,370103,3,19,62,84,20
Kingfisher,Superintendent of Public Instruction,John Cox,DEM,370105,0,0,11,11,
Kingfisher,Superintendent of Public Instruction,Jack Jr.,DEM,370105,0,0,3,3,
Kingfisher,Superintendent of Public Instruction,Ivan Holmes,DEM,370105,0,0,2,2,
Kingfisher,Superintendent of Public Instruction,Freda Deskin,DEM,370105,0,2,18,20,
Kingfisher,U.S. Senate,Patrick Michael Hayes,DEM,370105,0,1,8,9,
Kingfisher,U.S. Senate,Jim Rogers,DEM,370105,0,0,12,12,
Kingfisher,U.S. Senate,Connie Johnson,DEM,370105,0,1,15,16,
Kingfisher,Governor,Dax Ewbank,REP,370105,0,0,14,14,
Kingfisher,Governor,Chad Moody,REP,370105,1,3,21,25,
Kingfisher,Governor,Mary Fallin,REP,370105,1,2,86,89,
Kingfisher,Superintendent of Public Instruction,Brian Kelly,REP,370105,1,3,37,41,
Kingfisher,Superintendent of Public Instruction,Janet Costello Barresi,REP,370105,0,0,25,25,
Kingfisher,Superintendent of Public Instruction,Joy Hofmeister,REP,370105,1,2,63,66,
Kingfisher,Insurance Commissioner,Bill Viner,REP,370105,0,2,22,24,
Kingfisher,Insurance Commissioner,John Doak,REP,370105,1,3,97,101,
Kingfisher,Corporation Commissioner,Todd Hiett,REP,370105,0,4,63,67,
Kingfisher,Corporation Commissioner,Cliff Branan,REP,370105,1,1,56,58,
Kingfisher,U.S. Senate,Evelyn Rogers,REP,370105,0,0,6,6,
Kingfisher,U.S. Senate,Rob Moye,REP,370105,0,0,3,3,
Kingfisher,U.S. Senate,D. Jean Mcbride-Samuels,REP,370105,0,0,2,2,
Kingfisher,U.S. Senate,Jim Inhofe,REP,370105,2,5,108,115,
Kingfisher,U.S. Senate,Erick Paul Wyatt,REP,370105,0,0,3,3,
Kingfisher,U.S. Senate,Andy Craig,REP,370105,0,0,0,0,
Kingfisher,U.S. Senate,T. Shannon,REP,370105,1,2,36,39,
Kingfisher,U.S. Senate,Randy Brogdon,REP,370105,0,1,7,8,
Kingfisher,U.S. Senate,Eric Mccray,REP,370105,0,0,2,2,
Kingfisher,U.S. Senate,Kevin Crow,REP,370105,0,0,1,1,
Kingfisher,U.S. Senate,James Lankford,REP,370105,1,2,76,79,
Kingfisher,U.S. Senate,Jason Weger,REP,370105,0,0,1,1,
Kingfisher,U.S. House,Timothy Ray Murray,REP,370105,0,0,3,3,03
Kingfisher,U.S. House,Robert Hubbard,REP,370105,0,0,26,26,03
Kingfisher,U.S. House,Frank Lucas,REP,370105,2,5,90,97,03
Kingfisher,State Senate,Dan Ladd,REP,370105,1,2,44,47,20
Kingfisher,State Senate,A Griffin,REP,370105,0,3,74,77,20
Kingfisher,State House,Ross Vanhooser,REP,370105,1,1,45,47,41
Kingfisher,State House,John Enns,REP,370105,0,4,72,76,41
Kingfisher,Superintendent of Public Instruction,John Cox,DEM,370106,0,0,0,0,
Kingfisher,Superintendent of Public Instruction,Jack Jr.,DEM,370106,0,0,1,1,
Kingfisher,Superintendent of Public Instruction,Ivan Holmes,DEM,370106,1,0,1,2,
Kingfisher,Superintendent of Public Instruction,Freda Deskin,DEM,370106,0,0,1,1,
Kingfisher,U.S. Senate,Patrick Michael Hayes,DEM,370106,0,0,0,0,
Kingfisher,U.S. Senate,Jim Rogers,DEM,370106,0,0,0,0,
Kingfisher,U.S. Senate,Connie Johnson,DEM,370106,1,0,3,4,
Kingfisher,Governor,Dax Ewbank,REP,370106,0,0,2,2,
Kingfisher,Governor,Chad Moody,REP,370106,1,0,3,4,
Kingfisher,Governor,Mary Fallin,REP,370106,1,1,31,33,
Kingfisher,Superintendent of Public Instruction,Brian Kelly,REP,370106,2,1,3,6,
Kingfisher,Superintendent of Public Instruction,Janet Costello Barresi,REP,370106,0,0,7,7,
Kingfisher,Superintendent of Public Instruction,Joy Hofmeister,REP,370106,0,0,26,26,
Kingfisher,Insurance Commissioner,Bill Viner,REP,370106,0,0,5,5,
Kingfisher,Insurance Commissioner,John Doak,REP,370106,2,1,31,34,
Kingfisher,Corporation Commissioner,Todd Hiett,REP,370106,1,0,18,19,
Kingfisher,Corporation Commissioner,Cliff Branan,REP,370106,1,1,18,20,
Kingfisher,U.S. Senate,Evelyn Rogers,REP,370106,0,0,1,1,
Kingfisher,U.S. Senate,Rob Moye,REP,370106,0,0,0,0,
Kingfisher,U.S. Senate,D. Jean Mcbride-Samuels,REP,370106,0,0,1,1,
Kingfisher,U.S. Senate,Jim Inhofe,REP,370106,2,1,32,35,
Kingfisher,U.S. Senate,Erick Paul Wyatt,REP,370106,0,0,2,2,
Kingfisher,U.S. Senate,Andy Craig,REP,370106,0,0,0,0,
Kingfisher,U.S. Senate,T. Shannon,REP,370106,0,0,10,10,
Kingfisher,U.S. Senate,Randy Brogdon,REP,370106,0,0,3,3,
Kingfisher,U.S. Senate,Eric Mccray,REP,370106,0,0,0,0,
Kingfisher,U.S. Senate,Kevin Crow,REP,370106,0,0,0,0,
Kingfisher,U.S. Senate,James Lankford,REP,370106,2,1,23,26,
Kingfisher,U.S. Senate,Jason Weger,REP,370106,0,0,0,0,
Kingfisher,U.S. House,Timothy Ray Murray,REP,370106,0,0,2,2,03
Kingfisher,U.S. House,Robert Hubbard,REP,370106,0,0,0,0,03
Kingfisher,U.S. House,Frank Lucas,REP,370106,2,1,34,37,03
Kingfisher,State Senate,Dan Ladd,REP,370106,1,1,8,10,20
Kingfisher,State Senate,A Griffin,REP,370106,1,0,28,29,20
Kingfisher,State House,Ross Vanhooser,REP,370106,0,0,10,10,41
Kingfisher,State House,John Enns,REP,370106,2,1,26,29,41
Kingfisher,Superintendent of Public Instruction,John Cox,DEM,370201,2,0,26,28,
Kingfisher,Superintendent of Public Instruction,Jack Jr.,DEM,370201,1,0,16,17,
Kingfisher,Superintendent of Public Instruction,Ivan Holmes,DEM,370201,0,0,5,5,
Kingfisher,Superintendent of Public Instruction,Freda Deskin,DEM,370201,0,1,26,27,
Kingfisher,U.S. Senate,Patrick Michael Hayes,DEM,370201,0,0,20,20,
Kingfisher,U.S. Senate,Jim Rogers,DEM,370201,1,0,23,24,
Kingfisher,U.S. Senate,Connie Johnson,DEM,370201,2,1,28,31,
Kingfisher,Governor,Dax Ewbank,REP,370201,0,4,77,81,
Kingfisher,Governor,Chad Moody,REP,370201,1,1,49,51,
Kingfisher,Governor,Mary Fallin,REP,370201,2,7,222,231,
Kingfisher,Superintendent of Public Instruction,Brian Kelly,REP,370201,0,1,69,70,
Kingfisher,Superintendent of Public Instruction,Janet Costello Barresi,REP,370201,1,1,35,37,
Kingfisher,Superintendent of Public Instruction,Joy Hofmeister,REP,370201,2,10,244,256,
Kingfisher,Insurance Commissioner,Bill Viner,REP,370201,0,3,71,74,
Kingfisher,Insurance Commissioner,John Doak,REP,370201,3,8,264,275,
Kingfisher,Corporation Commissioner,Todd Hiett,REP,370201,2,9,184,195,
Kingfisher,Corporation Commissioner,Cliff Branan,REP,370201,1,3,153,157,
Kingfisher,U.S. Senate,Evelyn Rogers,REP,370201,0,2,14,16,
Kingfisher,U.S. Senate,Rob Moye,REP,370201,0,0,10,10,
Kingfisher,U.S. Senate,D. Jean Mcbride-Samuels,REP,370201,0,0,2,2,
Kingfisher,U.S. Senate,Jim Inhofe,REP,370201,3,10,311,324,
Kingfisher,U.S. Senate,Erick Paul Wyatt,REP,370201,0,0,11,11,
Kingfisher,U.S. Senate,Andy Craig,REP,370201,0,0,3,3,
Kingfisher,U.S. Senate,T. Shannon,REP,370201,3,5,106,114,
Kingfisher,U.S. Senate,Randy Brogdon,REP,370201,0,0,3,3,
Kingfisher,U.S. Senate,Eric Mccray,REP,370201,0,0,1,1,
Kingfisher,U.S. Senate,Kevin Crow,REP,370201,0,1,2,3,
Kingfisher,U.S. Senate,James Lankford,REP,370201,0,6,233,239,
Kingfisher,U.S. Senate,Jason Weger,REP,370201,0,0,3,3,
Kingfisher,U.S. House,Timothy Ray Murray,REP,370201,0,1,20,21,03
Kingfisher,U.S. House,Robert Hubbard,REP,370201,1,0,34,35,03
Kingfisher,U.S. House,Frank Lucas,REP,370201,2,11,294,307,03
Kingfisher,State Senate,Dan Ladd,REP,370201,2,0,56,58,20
Kingfisher,State Senate,A Griffin,REP,370201,1,12,292,305,20
Kingfisher,Superintendent of Public Instruction,John Cox,DEM,370203,0,0,7,7,
Kingfisher,Superintendent of Public Instruction,Jack Jr.,DEM,370203,0,0,1,1,
Kingfisher,Superintendent of Public Instruction,Ivan Holmes,DEM,370203,1,0,3,4,
Kingfisher,Superintendent of Public Instruction,Freda Deskin,DEM,370203,0,0,2,2,
Kingfisher,U.S. Senate,Patrick Michael Hayes,DEM,370203,0,0,3,3,
Kingfisher,U.S. Senate,Jim Rogers,DEM,370203,0,0,4,4,
Kingfisher,U.S. Senate,Connie Johnson,DEM,370203,0,0,5,5,
Kingfisher,Governor,Dax Ewbank,REP,370203,0,0,18,18,
Kingfisher,Governor,Chad Moody,REP,370203,0,0,2,2,
Kingfisher,Governor,Mary Fallin,REP,370203,7,2,23,32,
Kingfisher,Superintendent of Public Instruction,Brian Kelly,REP,370203,0,0,12,12,
Kingfisher,Superintendent of Public Instruction,Janet Costello Barresi,REP,370203,4,0,5,9,
Kingfisher,Superintendent of Public Instruction,Joy Hofmeister,REP,370203,2,2,25,29,
Kingfisher,Insurance Commissioner,Bill Viner,REP,370203,1,0,3,4,
Kingfisher,Insurance Commissioner,John Doak,REP,370203,5,2,37,44,
Kingfisher,Corporation Commissioner,Todd Hiett,REP,370203,6,0,26,32,
Kingfisher,Corporation Commissioner,Cliff Branan,REP,370203,0,2,15,17,
Kingfisher,U.S. Senate,Evelyn Rogers,REP,370203,0,0,1,1,
Kingfisher,U.S. Senate,Rob Moye,REP,370203,0,1,1,2,
Kingfisher,U.S. Senate,D. Jean Mcbride-Samuels,REP,370203,0,0,0,0,
Kingfisher,U.S. Senate,Jim Inhofe,REP,370203,8,1,41,50,
Kingfisher,U.S. Senate,Erick Paul Wyatt,REP,370203,0,0,0,0,
Kingfisher,U.S. Senate,Andy Craig,REP,370203,0,0,0,0,
Kingfisher,U.S. Senate,T. Shannon,REP,370203,4,0,23,27,
Kingfisher,U.S. Senate,Randy Brogdon,REP,370203,0,0,0,0,
Kingfisher,U.S. Senate,Eric Mccray,REP,370203,0,0,1,1,
Kingfisher,U.S. Senate,Kevin Crow,REP,370203,0,0,0,0,
Kingfisher,U.S. Senate,James Lankford,REP,370203,3,2,19,24,
Kingfisher,U.S. Senate,Jason Weger,REP,370203,0,0,0,0,
Kingfisher,U.S. House,Timothy Ray Murray,REP,370203,0,0,0,0,03
Kingfisher,U.S. House,Robert Hubbard,REP,370203,0,0,4,4,03
Kingfisher,U.S. House,Frank Lucas,REP,370203,8,2,39,49,03
Kingfisher,State Senate,Dan Ladd,REP,370203,0,1,9,10,20
Kingfisher,State Senate,A Griffin,REP,370203,6,1,34,41,20
Kingfisher,State House,Ross Vanhooser,REP,370203,0,1,17,18,41
Kingfisher,State House,John Enns,REP,370203,6,1,26,33,41
Kingfisher,Superintendent of Public Instruction,John Cox,DEM,370204,0,0,10,10,
Kingfisher,Superintendent of Public Instruction,Jack Jr.,DEM,370204,0,0,6,6,
Kingfisher,Superintendent of Public Instruction,Ivan Holmes,DEM,370204,0,0,1,1,
Kingfisher,Superintendent of Public Instruction,Freda Deskin,DEM,370204,2,2,15,19,
Kingfisher,U.S. Senate,Patrick Michael Hayes,DEM,370204,0,1,8,9,
Kingfisher,U.S. Senate,Jim Rogers,DEM,370204,2,0,12,14,
Kingfisher,U.S. Senate,Connie Johnson,DEM,370204,0,1,12,13,
Kingfisher,Governor,Dax Ewbank,REP,370204,0,3,9,12,
Kingfisher,Governor,Chad Moody,REP,370204,0,1,8,9,
Kingfisher,Governor,Mary Fallin,REP,370204,2,2,53,57,
Kingfisher,Superintendent of Public Instruction,Brian Kelly,REP,370204,0,0,20,20,
Kingfisher,Superintendent of Public Instruction,Janet Costello Barresi,REP,370204,1,0,10,11,
Kingfisher,Superintendent of Public Instruction,Joy Hofmeister,REP,370204,1,6,41,48,
Kingfisher,Insurance Commissioner,Bill Viner,REP,370204,0,0,13,13,
Kingfisher,Insurance Commissioner,John Doak,REP,370204,2,6,56,64,
Kingfisher,Corporation Commissioner,Todd Hiett,REP,370204,1,3,32,36,
Kingfisher,Corporation Commissioner,Cliff Branan,REP,370204,0,3,36,39,
Kingfisher,U.S. Senate,Evelyn Rogers,REP,370204,0,0,1,1,
Kingfisher,U.S. Senate,Rob Moye,REP,370204,0,0,4,4,
Kingfisher,U.S. Senate,D. Jean Mcbride-Samuels,REP,370204,0,0,0,0,
Kingfisher,U.S. Senate,Jim Inhofe,REP,370204,2,6,65,73,
Kingfisher,U.S. Senate,Erick Paul Wyatt,REP,370204,0,0,2,2,
Kingfisher,U.S. Senate,Andy Craig,REP,370204,0,0,1,1,
Kingfisher,U.S. Senate,T. Shannon,REP,370204,2,3,24,29,
Kingfisher,U.S. Senate,Randy Brogdon,REP,370204,0,0,1,1,
Kingfisher,U.S. Senate,Eric Mccray,REP,370204,0,0,1,1,
Kingfisher,U.S. Senate,Kevin Crow,REP,370204,0,0,0,0,
Kingfisher,U.S. Senate,James Lankford,REP,370204,0,3,45,48,
Kingfisher,U.S. Senate,Jason Weger,REP,370204,0,0,0,0,
Kingfisher,U.S. House,Timothy Ray Murray,REP,370204,1,0,3,4,03
Kingfisher,U.S. House,Robert Hubbard,REP,370204,0,0,2,2,03
Kingfisher,U.S. House,Frank Lucas,REP,370204,1,6,66,73,03
Kingfisher,State Senate,Dan Ladd,REP,370204,0,1,20,21,20
Kingfisher,State Senate,A Griffin,REP,370204,2,5,51,58,20
Kingfisher,Superintendent of Public Instruction,John Cox,DEM,370301,0,4,41,45,
Kingfisher,Superintendent of Public Instruction,Jack Jr.,DEM,370301,0,5,11,16,
Kingfisher,Superintendent of Public Instruction,Ivan Holmes,DEM,370301,1,6,3,10,
Kingfisher,Superintendent of Public Instruction,Freda Deskin,DEM,370301,0,3,50,53,
Kingfisher,U.S. Senate,Patrick Michael Hayes,DEM,370301,0,4,21,25,
Kingfisher,U.S. Senate,Jim Rogers,DEM,370301,0,3,37,40,
Kingfisher,U.S. Senate,Connie Johnson,DEM,370301,1,8,44,53,
Kingfisher,Governor,Dax Ewbank,REP,370301,0,2,19,21,
Kingfisher,Governor,Chad Moody,REP,370301,1,5,54,60,
Kingfisher,Governor,Mary Fallin,REP,370301,9,31,264,304,
Kingfisher,Superintendent of Public Instruction,Brian Kelly,REP,370301,0,11,68,79,
Kingfisher,Superintendent of Public Instruction,Janet Costello Barresi,REP,370301,3,7,45,55,
Kingfisher,Superintendent of Public Instruction,Joy Hofmeister,REP,370301,6,20,223,249,
Kingfisher,Insurance Commissioner,Bill Viner,REP,370301,2,10,61,73,
Kingfisher,Insurance Commissioner,John Doak,REP,370301,7,26,266,299,
Kingfisher,Corporation Commissioner,Todd Hiett,REP,370301,4,18,150,172,
Kingfisher,Corporation Commissioner,Cliff Branan,REP,370301,4,19,169,192,
Kingfisher,U.S. Senate,Evelyn Rogers,REP,370301,0,3,14,17,
Kingfisher,U.S. Senate,Rob Moye,REP,370301,0,0,7,7,
Kingfisher,U.S. Senate,D. Jean Mcbride-Samuels,REP,370301,0,0,3,3,
Kingfisher,U.S. Senate,Jim Inhofe,REP,370301,10,33,301,344,
Kingfisher,U.S. Senate,Erick Paul Wyatt,REP,370301,0,2,12,14,
Kingfisher,U.S. Senate,Andy Craig,REP,370301,0,0,0,0,
Kingfisher,U.S. Senate,T. Shannon,REP,370301,1,17,137,155,
Kingfisher,U.S. Senate,Randy Brogdon,REP,370301,0,0,4,4,
Kingfisher,U.S. Senate,Eric Mccray,REP,370301,0,0,3,3,
Kingfisher,U.S. Senate,Kevin Crow,REP,370301,0,0,4,4,
Kingfisher,U.S. Senate,James Lankford,REP,370301,8,20,189,217,
Kingfisher,U.S. Senate,Jason Weger,REP,370301,0,1,1,2,
Kingfisher,U.S. House,Timothy Ray Murray,REP,370301,0,1,15,16,03
Kingfisher,U.S. House,Robert Hubbard,REP,370301,0,2,25,27,03
Kingfisher,U.S. House,Frank Lucas,REP,370301,10,35,297,342,03
Kingfisher,State Senate,Darcy Jech,REP,370301,9,25,281,315,26
Kingfisher,State Senate,Dan Gambill,REP,370301,1,13,59,73,26
Kingfisher,Superintendent of Public Instruction,John Cox,DEM,370302,0,0,16,16,
Kingfisher,Superintendent of Public Instruction,Jack Jr.,DEM,370302,0,0,5,5,
Kingfisher,Superintendent of Public Instruction,Ivan Holmes,DEM,370302,0,0,1,1,
Kingfisher,Superintendent of Public Instruction,Freda Deskin,DEM,370302,1,0,13,14,
Kingfisher,U.S. Senate,Patrick Michael Hayes,DEM,370302,1,0,6,7,
Kingfisher,U.S. Senate,Jim Rogers,DEM,370302,0,0,16,16,
Kingfisher,U.S. Senate,Connie Johnson,DEM,370302,0,0,13,13,
Kingfisher,Governor,Dax Ewbank,REP,370302,0,0,16,16,
Kingfisher,Governor,Chad Moody,REP,370302,1,0,17,18,
Kingfisher,Governor,Mary Fallin,REP,370302,2,2,121,125,
Kingfisher,Superintendent of Public Instruction,Brian Kelly,REP,370302,0,1,24,25,
Kingfisher,Superintendent of Public Instruction,Janet Costello Barresi,REP,370302,2,1,27,30,
Kingfisher,Superintendent of Public Instruction,Joy Hofmeister,REP,370302,1,0,102,103,
Kingfisher,Insurance Commissioner,Bill Viner,REP,370302,0,0,13,13,
Kingfisher,Insurance Commissioner,John Doak,REP,370302,3,2,137,142,
Kingfisher,Corporation Commissioner,Todd Hiett,REP,370302,2,0,64,66,
Kingfisher,Corporation Commissioner,Cliff Branan,REP,370302,1,2,83,86,
Kingfisher,U.S. Senate,Evelyn Rogers,REP,370302,0,0,5,5,
Kingfisher,U.S. Senate,Rob Moye,REP,370302,0,0,1,1,
Kingfisher,U.S. Senate,D. Jean Mcbride-Samuels,REP,370302,0,0,1,1,
Kingfisher,U.S. Senate,Jim Inhofe,REP,370302,3,2,143,148,
Kingfisher,U.S. Senate,Erick Paul Wyatt,REP,370302,0,0,3,3,
Kingfisher,U.S. Senate,Andy Craig,REP,370302,0,0,1,1,
Kingfisher,U.S. Senate,T. Shannon,REP,370302,0,1,44,45,
Kingfisher,U.S. Senate,Randy Brogdon,REP,370302,0,0,4,4,
Kingfisher,U.S. Senate,Eric Mccray,REP,370302,0,0,0,0,
Kingfisher,U.S. Senate,Kevin Crow,REP,370302,0,0,1,1,
Kingfisher,U.S. Senate,James Lankford,REP,370302,3,1,104,108,
Kingfisher,U.S. Senate,Jason Weger,REP,370302,0,0,2,2,
Kingfisher,U.S. House,Timothy Ray Murray,REP,370302,0,0,8,8,03
Kingfisher,U.S. House,Robert Hubbard,REP,370302,0,0,6,6,03
Kingfisher,U.S. House,Frank Lucas,REP,370302,3,2,141,146,03
Kingfisher,Superintendent of Public Instruction,John Cox,DEM,370303,0,0,2,2,
Kingfisher,Superintendent of Public Instruction,Jack Jr.,DEM,370303,0,0,2,2,
Kingfisher,Superintendent of Public Instruction,Ivan Holmes,DEM,370303,0,0,0,0,
Kingfisher,Superintendent of Public Instruction,Freda Deskin,DEM,370303,0,0,1,1,
Kingfisher,U.S. Senate,Patrick Michael Hayes,DEM,370303,0,0,3,3,
Kingfisher,U.S. Senate,Jim Rogers,DEM,370303,0,0,2,2,
Kingfisher,U.S. Senate,Connie Johnson,DEM,370303,0,0,0,0,
Kingfisher,Governor,Dax Ewbank,REP,370303,0,0,1,1,
Kingfisher,Governor,Chad Moody,REP,370303,0,1,9,10,
Kingfisher,Governor,Mary Fallin,REP,370303,0,2,28,30,
Kingfisher,Superintendent of Public Instruction,Brian Kelly,REP,370303,0,0,6,6,
Kingfisher,Superintendent of Public Instruction,Janet Costello Barresi,REP,370303,0,2,9,11,
Kingfisher,Superintendent of Public Instruction,Joy Hofmeister,REP,370303,0,1,24,25,
Kingfisher,Insurance Commissioner,Bill Viner,REP,370303,0,0,10,10,
Kingfisher,Insurance Commissioner,John Doak,REP,370303,0,3,29,32,
Kingfisher,Corporation Commissioner,Todd Hiett,REP,370303,0,2,18,20,
Kingfisher,Corporation Commissioner,Cliff Branan,REP,370303,0,1,21,22,
Kingfisher,U.S. Senate,Evelyn Rogers,REP,370303,0,0,2,2,
Kingfisher,U.S. Senate,Rob Moye,REP,370303,0,0,0,0,
Kingfisher,U.S. Senate,D. Jean Mcbride-Samuels,REP,370303,0,0,0,0,
Kingfisher,U.S. Senate,Jim Inhofe,REP,370303,0,3,33,36,
Kingfisher,U.S. Senate,Erick Paul Wyatt,REP,370303,0,0,4,4,
Kingfisher,U.S. Senate,Andy Craig,REP,370303,0,0,0,0,
Kingfisher,U.S. Senate,T. Shannon,REP,370303,0,2,21,23,
Kingfisher,U.S. Senate,Randy Brogdon,REP,370303,0,0,1,1,
Kingfisher,U.S. Senate,Eric Mccray,REP,370303,0,0,0,0,
Kingfisher,U.S. Senate,Kevin Crow,REP,370303,0,0,0,0,
Kingfisher,U.S. Senate,James Lankford,REP,370303,0,1,17,18,
Kingfisher,U.S. Senate,Jason Weger,REP,370303,0,0,0,0,
Kingfisher,U.S. House,Timothy Ray Murray,REP,370303,0,0,0,0,03
Kingfisher,U.S. House,Robert Hubbard,REP,370303,0,0,4,4,03
Kingfisher,U.S. House,Frank Lucas,REP,370303,0,3,35,38,03
Kingfisher,State Senate,Darcy Jech,REP,370303,0,3,30,33,26
Kingfisher,State Senate,Dan Gambill,REP,370303,0,0,9,9,26
Kingfisher,Superintendent of Public Instruction,John Cox,DEM,370304,0,0,5,5,
Kingfisher,Superintendent of Public Instruction,Jack Jr.,DEM,370304,0,0,0,0,
Kingfisher,Superintendent of Public Instruction,Ivan Holmes,DEM,370304,0,0,0,0,
Kingfisher,Superintendent of Public Instruction,Freda Deskin,DEM,370304,0,0,5,5,
Kingfisher,U.S. Senate,Patrick Michael Hayes,DEM,370304,0,0,3,3,
Kingfisher,U.S. Senate,Jim Rogers,DEM,370304,0,0,3,3,
Kingfisher,U.S. Senate,Connie Johnson,DEM,370304,0,0,4,4,
Kingfisher,Governor,Dax Ewbank,REP,370304,0,0,10,10,
Kingfisher,Governor,Chad Moody,REP,370304,0,1,6,7,
Kingfisher,Governor,Mary Fallin,REP,370304,1,2,46,49,
Kingfisher,Superintendent of Public Instruction,Brian Kelly,REP,370304,0,0,16,16,
Kingfisher,Superintendent of Public Instruction,Janet Costello Barresi,REP,370304,0,0,11,11,
Kingfisher,Superintendent of Public Instruction,Joy Hofmeister,REP,370304,1,3,35,39,
Kingfisher,Insurance Commissioner,Bill Viner,REP,370304,0,0,9,9,
Kingfisher,Insurance Commissioner,John Doak,REP,370304,1,3,50,54,
Kingfisher,Corporation Commissioner,Todd Hiett,REP,370304,1,0,33,34,
Kingfisher,Corporation Commissioner,Cliff Branan,REP,370304,0,3,24,27,
Kingfisher,U.S. Senate,Evelyn Rogers,REP,370304,0,0,0,0,
Kingfisher,U.S. Senate,Rob Moye,REP,370304,0,0,0,0,
Kingfisher,U.S. Senate,D. Jean Mcbride-Samuels,REP,370304,0,0,1,1,
Kingfisher,U.S. Senate,Jim Inhofe,REP,370304,1,2,59,62,
Kingfisher,U.S. Senate,Erick Paul Wyatt,REP,370304,0,1,1,2,
Kingfisher,U.S. Senate,Andy Craig,REP,370304,0,0,1,1,
Kingfisher,U.S. Senate,T. Shannon,REP,370304,0,1,17,18,
Kingfisher,U.S. Senate,Randy Brogdon,REP,370304,0,0,10,10,
Kingfisher,U.S. Senate,Eric Mccray,REP,370304,0,0,1,1,
Kingfisher,U.S. Senate,Kevin Crow,REP,370304,0,0,0,0,
Kingfisher,U.S. Senate,James Lankford,REP,370304,1,2,33,36,
Kingfisher,U.S. Senate,Jason Weger,REP,370304,0,0,0,0,
Kingfisher,U.S. House,Timothy Ray Murray,REP,370304,0,0,1,1,03
Kingfisher,U.S. House,Robert Hubbard,REP,370304,0,0,10,10,03
Kingfisher,U.S. House,Frank Lucas,REP,370304,1,3,48,52,03
Kingfisher,State Senate,Dan Ladd,REP,370304,0,0,33,33,20
Kingfisher,State Senate,A Griffin,REP,370304,1,3,27,31,20
Kingfisher,Superintendent of Public Instruction,John Cox,DEM,370305,0,0,4,4,
Kingfisher,Superintendent of Public Instruction,Jack Jr.,DEM,370305,0,0,1,1,
Kingfisher,Superintendent of Public Instruction,Ivan Holmes,DEM,370305,0,0,0,0,
Kingfisher,Superintendent of Public Instruction,Freda Deskin,DEM,370305,0,1,3,4,
Kingfisher,U.S. Senate,Patrick Michael Hayes,DEM,370305,0,0,2,2,
Kingfisher,U.S. Senate,Jim Rogers,DEM,370305,0,1,4,5,
Kingfisher,U.S. Senate,Connie Johnson,DEM,370305,0,0,2,2,
Kingfisher,Governor,Dax Ewbank,REP,370305,0,0,7,7,
Kingfisher,Governor,Chad Moody,REP,370305,0,0,2,2,
Kingfisher,Governor,Mary Fallin,REP,370305,4,4,51,59,
Kingfisher,Superintendent of Public Instruction,Brian Kelly,REP,370305,0,3,13,16,
Kingfisher,Superintendent of Public Instruction,Janet Costello Barresi,REP,370305,2,0,13,15,
Kingfisher,Superintendent of Public Instruction,Joy Hofmeister,REP,370305,2,1,33,36,
Kingfisher,Insurance Commissioner,Bill Viner,REP,370305,0,0,11,11,
Kingfisher,Insurance Commissioner,John Doak,REP,370305,4,4,45,53,
Kingfisher,Corporation Commissioner,Todd Hiett,REP,370305,2,1,23,26,
Kingfisher,Corporation Commissioner,Cliff Branan,REP,370305,2,3,34,39,
Kingfisher,U.S. Senate,Evelyn Rogers,REP,370305,0,0,2,2,
Kingfisher,U.S. Senate,Rob Moye,REP,370305,0,0,0,0,
Kingfisher,U.S. Senate,D. Jean Mcbride-Samuels,REP,370305,0,0,1,1,
Kingfisher,U.S. Senate,Jim Inhofe,REP,370305,4,4,56,64,
Kingfisher,U.S. Senate,Erick Paul Wyatt,REP,370305,0,0,0,0,
Kingfisher,U.S. Senate,Andy Craig,REP,370305,0,0,0,0,
Kingfisher,U.S. Senate,T. Shannon,REP,370305,0,2,22,24,
Kingfisher,U.S. Senate,Randy Brogdon,REP,370305,0,0,4,4,
Kingfisher,U.S. Senate,Eric Mccray,REP,370305,0,0,0,0,
Kingfisher,U.S. Senate,Kevin Crow,REP,370305,0,0,0,0,
Kingfisher,U.S. Senate,James Lankford,REP,370305,4,2,33,39,
Kingfisher,U.S. Senate,Jason Weger,REP,370305,0,0,1,1,
Kingfisher,U.S. House,Timothy Ray Murray,REP,370305,0,0,2,2,03
Kingfisher,U.S. House,Robert Hubbard,REP,370305,0,0,7,7,03
Kingfisher,U.S. House,Frank Lucas,REP,370305,4,4,49,57,03
Kingfisher,State Senate,Dan Ladd,REP,370305,1,2,17,20,20
Kingfisher,State Senate,A Griffin,REP,370305,3,2,41,46,20
Kingfisher,Superintendent of Public Instruction,John Cox,DEM,370306,0,0,0,0,
Kingfisher,Superintendent of Public Instruction,Jack Jr.,DEM,370306,0,0,0,0,
Kingfisher,Superintendent of Public Instruction,Ivan Holmes,DEM,370306,0,0,0,0,
Kingfisher,Superintendent of Public Instruction,Freda Deskin,DEM,370306,0,0,0,0,
Kingfisher,U.S. Senate,Patrick Michael Hayes,DEM,370306,0,0,0,0,
Kingfisher,U.S. Senate,Jim Rogers,DEM,370306,0,0,0,0,
Kingfisher,U.S. Senate,Connie Johnson,DEM,370306,0,0,0,0,
Kingfisher,Governor,Dax Ewbank,REP,370306,0,0,0,0,
Kingfisher,Governor,Chad Moody,REP,370306,0,0,0,0,
Kingfisher,Governor,Mary Fallin,REP,370306,0,0,3,3,
Kingfisher,Superintendent of Public Instruction,Brian Kelly,REP,370306,0,0,2,2,
Kingfisher,Superintendent of Public Instruction,Janet Costello Barresi,REP,370306,0,0,0,0,
Kingfisher,Superintendent of Public Instruction,Joy Hofmeister,REP,370306,0,0,2,2,
Kingfisher,Insurance Commissioner,Bill Viner,REP,370306,0,0,0,0,
Kingfisher,Insurance Commissioner,John Doak,REP,370306,0,0,3,3,
Kingfisher,Corporation Commissioner,Todd Hiett,REP,370306,0,0,1,1,
Kingfisher,Corporation Commissioner,Cliff Branan,REP,370306,0,0,2,2,
Kingfisher,U.S. Senate,Evelyn Rogers,REP,370306,0,0,0,0,
Kingfisher,U.S. Senate,Rob Moye,REP,370306,0,0,0,0,
Kingfisher,U.S. Senate,D. Jean Mcbride-Samuels,REP,370306,0,0,0,0,
Kingfisher,U.S. Senate,Jim Inhofe,REP,370306,0,0,3,3,
Kingfisher,U.S. Senate,Erick Paul Wyatt,REP,370306,0,0,0,0,
Kingfisher,U.S. Senate,Andy Craig,REP,370306,0,0,0,0,
Kingfisher,U.S. Senate,T. Shannon,REP,370306,0,0,1,1,
Kingfisher,U.S. Senate,Randy Brogdon,REP,370306,0,0,0,0,
Kingfisher,U.S. Senate,Eric Mccray,REP,370306,0,0,0,0,
Kingfisher,U.S. Senate,Kevin Crow,REP,370306,0,0,0,0,
Kingfisher,U.S. Senate,James Lankford,REP,370306,0,0,2,2,
Kingfisher,U.S. Senate,Jason Weger,REP,370306,0,0,0,0,
Kingfisher,U.S. House,Timothy Ray Murray,REP,370306,0,0,0,0,03
Kingfisher,U.S. House,Robert Hubbard,REP,370306,0,0,0,0,03
Kingfisher,U.S. House,Frank Lucas,REP,370306,0,0,3,3,03
Kingfisher,State Senate,Dan Ladd,REP,370306,0,0,1,1,20
Kingfisher,State Senate,A Griffin,REP,370306,0,0,2,2,20
Kiowa,Superintendent of Public Instruction,John Cox,DEM,380001,2,0,43,45,
Kiowa,Superintendent of Public Instruction,Jack Jr.,DEM,380001,2,3,22,27,
Kiowa,Superintendent of Public Instruction,Ivan Holmes,DEM,380001,0,0,7,7,
Kiowa,Superintendent of Public Instruction,Freda Deskin,DEM,380001,1,1,33,35,
Kiowa,U.S. Senate,Patrick Michael Hayes,DEM,380001,2,2,26,30,
Kiowa,U.S. Senate,Jim Rogers,DEM,380001,4,2,48,54,
Kiowa,U.S. Senate,Connie Johnson,DEM,380001,0,0,25,25,
Kiowa,Governor,Dax Ewbank,REP,380001,1,1,18,20,
Kiowa,Governor,Chad Moody,REP,380001,0,4,19,23,
Kiowa,Governor,Mary Fallin,REP,380001,1,4,81,86,
Kiowa,Superintendent of Public Instruction,Brian Kelly,REP,380001,0,1,15,16,
Kiowa,Superintendent of Public Instruction,Janet Costello Barresi,REP,380001,1,0,8,9,
Kiowa,Superintendent of Public Instruction,Joy Hofmeister,REP,380001,1,8,96,105,
Kiowa,Insurance Commissioner,Bill Viner,REP,380001,0,2,21,23,
Kiowa,Insurance Commissioner,John Doak,REP,380001,2,6,90,98,
Kiowa,Corporation Commissioner,Todd Hiett,REP,380001,0,4,57,61,
Kiowa,Corporation Commissioner,Cliff Branan,REP,380001,1,4,53,58,
Kiowa,U.S. Senate,Evelyn Rogers,REP,380001,0,1,7,8,
Kiowa,U.S. Senate,Rob Moye,REP,380001,0,0,2,2,
Kiowa,U.S. Senate,D. Jean Mcbride-Samuels,REP,380001,0,0,0,0,
Kiowa,U.S. Senate,Jim Inhofe,REP,380001,2,8,109,119,
Kiowa,U.S. Senate,Erick Paul Wyatt,REP,380001,0,0,0,0,
Kiowa,U.S. Senate,Andy Craig,REP,380001,0,0,0,0,
Kiowa,U.S. Senate,T. Shannon,REP,380001,0,3,55,58,
Kiowa,U.S. Senate,Randy Brogdon,REP,380001,0,0,1,1,
Kiowa,U.S. Senate,Eric Mccray,REP,380001,0,0,0,0,
Kiowa,U.S. Senate,Kevin Crow,REP,380001,0,0,1,1,
Kiowa,U.S. Senate,James Lankford,REP,380001,2,5,59,66,
Kiowa,U.S. Senate,Jason Weger,REP,380001,0,1,2,3,
Kiowa,U.S. House,Timothy Ray Murray,REP,380001,0,0,7,7,03
Kiowa,U.S. House,Robert Hubbard,REP,380001,0,1,8,9,03
Kiowa,U.S. House,Frank Lucas,REP,380001,2,8,100,110,03
Kiowa,Superintendent of Public Instruction,John Cox,DEM,380002,0,1,5,6,
Kiowa,Superintendent of Public Instruction,Jack Jr.,DEM,380002,0,0,5,5,
Kiowa,Superintendent of Public Instruction,Ivan Holmes,DEM,380002,0,0,1,1,
Kiowa,Superintendent of Public Instruction,Freda Deskin,DEM,380002,0,0,7,7,
Kiowa,U.S. Senate,Patrick Michael Hayes,DEM,380002,0,0,6,6,
Kiowa,U.S. Senate,Jim Rogers,DEM,380002,0,0,5,5,
Kiowa,U.S. Senate,Connie Johnson,DEM,380002,0,1,6,7,
Kiowa,Governor,Dax Ewbank,REP,380002,0,0,3,3,
Kiowa,Governor,Chad Moody,REP,380002,0,0,4,4,
Kiowa,Governor,Mary Fallin,REP,380002,0,0,22,22,
Kiowa,Superintendent of Public Instruction,Brian Kelly,REP,380002,0,0,1,1,
Kiowa,Superintendent of Public Instruction,Janet Costello Barresi,REP,380002,0,0,0,0,
Kiowa,Superintendent of Public Instruction,Joy Hofmeister,REP,380002,0,0,28,28,
Kiowa,Insurance Commissioner,Bill Viner,REP,380002,0,0,4,4,
Kiowa,Insurance Commissioner,John Doak,REP,380002,0,0,24,24,
Kiowa,Corporation Commissioner,Todd Hiett,REP,380002,0,0,20,20,
Kiowa,Corporation Commissioner,Cliff Branan,REP,380002,0,0,8,8,
Kiowa,U.S. Senate,Evelyn Rogers,REP,380002,0,0,1,1,
Kiowa,U.S. Senate,Rob Moye,REP,380002,0,0,0,0,
Kiowa,U.S. Senate,D. Jean Mcbride-Samuels,REP,380002,0,0,0,0,
Kiowa,U.S. Senate,Jim Inhofe,REP,380002,0,0,28,28,
Kiowa,U.S. Senate,Erick Paul Wyatt,REP,380002,0,0,0,0,
Kiowa,U.S. Senate,Andy Craig,REP,380002,0,0,0,0,
Kiowa,U.S. Senate,T. Shannon,REP,380002,0,0,11,11,
Kiowa,U.S. Senate,Randy Brogdon,REP,380002,0,0,0,0,
Kiowa,U.S. Senate,Eric Mccray,REP,380002,0,0,0,0,
Kiowa,U.S. Senate,Kevin Crow,REP,380002,0,0,0,0,
Kiowa,U.S. Senate,James Lankford,REP,380002,0,0,17,17,
Kiowa,U.S. Senate,Jason Weger,REP,380002,0,0,1,1,
Kiowa,U.S. House,Timothy Ray Murray,REP,380002,0,0,2,2,03
Kiowa,U.S. House,Robert Hubbard,REP,380002,0,0,0,0,03
Kiowa,U.S. House,Frank Lucas,REP,380002,0,0,27,27,03
Kiowa,Superintendent of Public Instruction,John Cox,DEM,380004,0,6,18,24,
Kiowa,Superintendent of Public Instruction,Jack Jr.,DEM,380004,0,0,4,4,
Kiowa,Superintendent of Public Instruction,Ivan Holmes,DEM,380004,0,0,6,6,
Kiowa,Superintendent of Public Instruction,Freda Deskin,DEM,380004,0,3,19,22,
Kiowa,U.S. Senate,Patrick Michael Hayes,DEM,380004,0,3,9,12,
Kiowa,U.S. Senate,Jim Rogers,DEM,380004,0,3,20,23,
Kiowa,U.S. Senate,Connie Johnson,DEM,380004,0,3,19,22,
Kiowa,Governor,Dax Ewbank,REP,380004,0,0,5,5,
Kiowa,Governor,Chad Moody,REP,380004,0,3,16,19,
Kiowa,Governor,Mary Fallin,REP,380004,0,5,44,49,
Kiowa,Superintendent of Public Instruction,Brian Kelly,REP,380004,0,0,7,7,
Kiowa,Superintendent of Public Instruction,Janet Costello Barresi,REP,380004,0,1,7,8,
Kiowa,Superintendent of Public Instruction,Joy Hofmeister,REP,380004,0,7,54,61,
Kiowa,Insurance Commissioner,Bill Viner,REP,380004,0,2,13,15,
Kiowa,Insurance Commissioner,John Doak,REP,380004,0,6,43,49,
Kiowa,Corporation Commissioner,Todd Hiett,REP,380004,0,5,28,33,
Kiowa,Corporation Commissioner,Cliff Branan,REP,380004,0,2,30,32,
Kiowa,U.S. Senate,Evelyn Rogers,REP,380004,0,0,0,0,
Kiowa,U.S. Senate,Rob Moye,REP,380004,0,0,1,1,
Kiowa,U.S. Senate,D. Jean Mcbride-Samuels,REP,380004,0,0,1,1,
Kiowa,U.S. Senate,Jim Inhofe,REP,380004,0,7,59,66,
Kiowa,U.S. Senate,Erick Paul Wyatt,REP,380004,0,1,3,4,
Kiowa,U.S. Senate,Andy Craig,REP,380004,0,0,2,2,
Kiowa,U.S. Senate,T. Shannon,REP,380004,0,2,23,25,
Kiowa,U.S. Senate,Randy Brogdon,REP,380004,0,0,5,5,
Kiowa,U.S. Senate,Eric Mccray,REP,380004,0,0,1,1,
Kiowa,U.S. Senate,Kevin Crow,REP,380004,0,0,0,0,
Kiowa,U.S. Senate,James Lankford,REP,380004,0,6,36,42,
Kiowa,U.S. Senate,Jason Weger,REP,380004,0,0,0,0,
Kiowa,U.S. House,Timothy Ray Murray,REP,380004,0,0,2,2,03
Kiowa,U.S. House,Robert Hubbard,REP,380004,0,1,4,5,03
Kiowa,U.S. House,Frank Lucas,REP,380004,0,6,58,64,03
Kiowa,Superintendent of Public Instruction,John Cox,DEM,380005,0,1,2,3,
Kiowa,Superintendent of Public Instruction,Jack Jr.,DEM,380005,0,0,0,0,
Kiowa,Superintendent of Public Instruction,Ivan Holmes,DEM,380005,0,0,1,1,
Kiowa,Superintendent of Public Instruction,Freda Deskin,DEM,380005,0,1,1,2,
Kiowa,U.S. Senate,Patrick Michael Hayes,DEM,380005,0,1,0,1,
Kiowa,U.S. Senate,Jim Rogers,DEM,380005,0,0,1,1,
Kiowa,U.S. Senate,Connie Johnson,DEM,380005,0,1,3,4,
Kiowa,Governor,Dax Ewbank,REP,380005,0,0,0,0,
Kiowa,Governor,Chad Moody,REP,380005,0,0,1,1,
Kiowa,Governor,Mary Fallin,REP,380005,0,0,1,1,
Kiowa,Superintendent of Public Instruction,Brian Kelly,REP,380005,0,0,0,0,
Kiowa,Superintendent of Public Instruction,Janet Costello Barresi,REP,380005,0,0,0,0,
Kiowa,Superintendent of Public Instruction,Joy Hofmeister,REP,380005,0,0,2,2,
Kiowa,Insurance Commissioner,Bill Viner,REP,380005,0,0,0,0,
Kiowa,Insurance Commissioner,John Doak,REP,380005,0,0,2,2,
Kiowa,Corporation Commissioner,Todd Hiett,REP,380005,0,0,1,1,
Kiowa,Corporation Commissioner,Cliff Branan,REP,380005,0,0,1,1,
Kiowa,U.S. Senate,Evelyn Rogers,REP,380005,0,0,0,0,
Kiowa,U.S. Senate,Rob Moye,REP,380005,0,0,0,0,
Kiowa,U.S. Senate,D. Jean Mcbride-Samuels,REP,380005,0,0,0,0,
Kiowa,U.S. Senate,Jim Inhofe,REP,380005,0,0,1,1,
Kiowa,U.S. Senate,Erick Paul Wyatt,REP,380005,0,0,0,0,
Kiowa,U.S. Senate,Andy Craig,REP,380005,0,0,0,0,
Kiowa,U.S. Senate,T. Shannon,REP,380005,0,0,1,1,
Kiowa,U.S. Senate,Randy Brogdon,REP,380005,0,0,1,1,
Kiowa,U.S. Senate,Eric Mccray,REP,380005,0,0,0,0,
Kiowa,U.S. Senate,Kevin Crow,REP,380005,0,0,0,0,
Kiowa,U.S. Senate,James Lankford,REP,380005,0,0,0,0,
Kiowa,U.S. Senate,Jason Weger,REP,380005,0,0,0,0,
Kiowa,U.S. House,Timothy Ray Murray,REP,380005,0,0,0,0,03
Kiowa,U.S. House,Robert Hubbard,REP,380005,0,0,0,0,03
Kiowa,U.S. House,Frank Lucas,REP,380005,0,0,2,2,03
Kiowa,Superintendent of Public Instruction,John Cox,DEM,380006,0,1,27,28,
Kiowa,Superintendent of Public Instruction,Jack Jr.,DEM,380006,0,0,1,1,
Kiowa,Superintendent of Public Instruction,Ivan Holmes,DEM,380006,0,0,1,1,
Kiowa,Superintendent of Public Instruction,Freda Deskin,DEM,380006,2,0,9,11,
Kiowa,U.S. Senate,Patrick Michael Hayes,DEM,380006,0,0,10,10,
Kiowa,U.S. Senate,Jim Rogers,DEM,380006,1,0,7,8,
Kiowa,U.S. Senate,Connie Johnson,DEM,380006,1,1,20,22,
Kiowa,Governor,Dax Ewbank,REP,380006,0,0,2,2,
Kiowa,Governor,Chad Moody,REP,380006,0,1,1,2,
Kiowa,Governor,Mary Fallin,REP,380006,0,0,21,21,
Kiowa,Superintendent of Public Instruction,Brian Kelly,REP,380006,0,0,5,5,
Kiowa,Superintendent of Public Instruction,Janet Costello Barresi,REP,380006,0,0,1,1,
Kiowa,Superintendent of Public Instruction,Joy Hofmeister,REP,380006,0,1,18,19,
Kiowa,Insurance Commissioner,Bill Viner,REP,380006,0,0,6,6,
Kiowa,Insurance Commissioner,John Doak,REP,380006,0,1,16,17,
Kiowa,Corporation Commissioner,Todd Hiett,REP,380006,0,1,10,11,
Kiowa,Corporation Commissioner,Cliff Branan,REP,380006,0,0,12,12,
Kiowa,U.S. Senate,Evelyn Rogers,REP,380006,0,0,1,1,
Kiowa,U.S. Senate,Rob Moye,REP,380006,0,0,0,0,
Kiowa,U.S. Senate,D. Jean Mcbride-Samuels,REP,380006,0,0,1,1,
Kiowa,U.S. Senate,Jim Inhofe,REP,380006,0,1,21,22,
Kiowa,U.S. Senate,Erick Paul Wyatt,REP,380006,0,0,1,1,
Kiowa,U.S. Senate,Andy Craig,REP,380006,0,0,0,0,
Kiowa,U.S. Senate,T. Shannon,REP,380006,0,1,5,6,
Kiowa,U.S. Senate,Randy Brogdon,REP,380006,0,0,0,0,
Kiowa,U.S. Senate,Eric Mccray,REP,380006,0,0,0,0,
Kiowa,U.S. Senate,Kevin Crow,REP,380006,0,0,0,0,
Kiowa,U.S. Senate,James Lankford,REP,380006,0,0,19,19,
Kiowa,U.S. Senate,Jason Weger,REP,380006,0,0,0,0,
Kiowa,U.S. House,Timothy Ray Murray,REP,380006,0,0,1,1,03
Kiowa,U.S. House,Robert Hubbard,REP,380006,0,0,3,3,03
Kiowa,U.S. House,Frank Lucas,REP,380006,0,1,20,21,03
Kiowa,Superintendent of Public Instruction,John Cox,DEM,380007,0,0,0,0,
Kiowa,Superintendent of Public Instruction,Jack Jr.,DEM,380007,0,0,0,0,
Kiowa,Superintendent of Public Instruction,Ivan Holmes,DEM,380007,0,0,0,0,
Kiowa,Superintendent of Public Instruction,Freda Deskin,DEM,380007,0,0,0,0,
Kiowa,U.S. Senate,Patrick Michael Hayes,DEM,380007,0,0,0,0,
Kiowa,U.S. Senate,Jim Rogers,DEM,380007,0,0,0,0,
Kiowa,U.S. Senate,Connie Johnson,DEM,380007,0,0,0,0,
Kiowa,Governor,Dax Ewbank,REP,380007,0,0,0,0,
Kiowa,Governor,Chad Moody,REP,380007,0,0,0,0,
Kiowa,Governor,Mary Fallin,REP,380007,0,0,2,2,
Kiowa,Superintendent of Public Instruction,Brian Kelly,REP,380007,0,0,0,0,
Kiowa,Superintendent of Public Instruction,Janet Costello Barresi,REP,380007,0,0,0,0,
Kiowa,Superintendent of Public Instruction,Joy Hofmeister,REP,380007,0,0,2,2,
Kiowa,Insurance Commissioner,Bill Viner,REP,380007,0,0,0,0,
Kiowa,Insurance Commissioner,John Doak,REP,380007,0,0,2,2,
Kiowa,Corporation Commissioner,Todd Hiett,REP,380007,0,0,2,2,
Kiowa,Corporation Commissioner,Cliff Branan,REP,380007,0,0,0,0,
Kiowa,U.S. Senate,Evelyn Rogers,REP,380007,0,0,0,0,
Kiowa,U.S. Senate,Rob Moye,REP,380007,0,0,0,0,
Kiowa,U.S. Senate,D. Jean Mcbride-Samuels,REP,380007,0,0,0,0,
Kiowa,U.S. Senate,Jim Inhofe,REP,380007,0,0,2,2,
Kiowa,U.S. Senate,Erick Paul Wyatt,REP,380007,0,0,0,0,
Kiowa,U.S. Senate,Andy Craig,REP,380007,0,0,0,0,
Kiowa,U.S. Senate,T. Shannon,REP,380007,0,0,1,1,
Kiowa,U.S. Senate,Randy Brogdon,REP,380007,0,0,0,0,
Kiowa,U.S. Senate,Eric Mccray,REP,380007,0,0,0,0,
Kiowa,U.S. Senate,Kevin Crow,REP,380007,0,0,0,0,
Kiowa,U.S. Senate,James Lankford,REP,380007,0,0,1,1,
Kiowa,U.S. Senate,Jason Weger,REP,380007,0,0,0,0,
Kiowa,U.S. House,Timothy Ray Murray,REP,380007,0,0,0,0,03
Kiowa,U.S. House,Robert Hubbard,REP,380007,0,0,0,0,03
Kiowa,U.S. House,Frank Lucas,REP,380007,0,0,2,2,03
Kiowa,Superintendent of Public Instruction,John Cox,DEM,380008,1,1,22,24,
Kiowa,Superintendent of Public Instruction,Jack Jr.,DEM,380008,0,0,4,4,
Kiowa,Superintendent of Public Instruction,Ivan Holmes,DEM,380008,0,0,0,0,
Kiowa,Superintendent of Public Instruction,Freda Deskin,DEM,380008,0,0,16,16,
Kiowa,U.S. Senate,Patrick Michael Hayes,DEM,380008,0,0,18,18,
Kiowa,U.S. Senate,Jim Rogers,DEM,380008,1,1,8,10,
Kiowa,U.S. Senate,Connie Johnson,DEM,380008,0,0,14,14,
Kiowa,Governor,Dax Ewbank,REP,380008,0,0,3,3,
Kiowa,Governor,Chad Moody,REP,380008,0,0,7,7,
Kiowa,Governor,Mary Fallin,REP,380008,0,2,20,22,
Kiowa,Superintendent of Public Instruction,Brian Kelly,REP,380008,0,0,5,5,
Kiowa,Superintendent of Public Instruction,Janet Costello Barresi,REP,380008,0,0,5,5,
Kiowa,Superintendent of Public Instruction,Joy Hofmeister,REP,380008,0,2,19,21,
Kiowa,Insurance Commissioner,Bill Viner,REP,380008,0,0,5,5,
Kiowa,Insurance Commissioner,John Doak,REP,380008,0,1,20,21,
Kiowa,Corporation Commissioner,Todd Hiett,REP,380008,0,2,12,14,
Kiowa,Corporation Commissioner,Cliff Branan,REP,380008,0,0,14,14,
Kiowa,U.S. Senate,Evelyn Rogers,REP,380008,0,0,1,1,
Kiowa,U.S. Senate,Rob Moye,REP,380008,0,0,0,0,
Kiowa,U.S. Senate,D. Jean Mcbride-Samuels,REP,380008,0,0,0,0,
Kiowa,U.S. Senate,Jim Inhofe,REP,380008,0,2,28,30,
Kiowa,U.S. Senate,Erick Paul Wyatt,REP,380008,0,0,1,1,
Kiowa,U.S. Senate,Andy Craig,REP,380008,0,0,0,0,
Kiowa,U.S. Senate,T. Shannon,REP,380008,0,0,12,12,
Kiowa,U.S. Senate,Randy Brogdon,REP,380008,0,0,0,0,
Kiowa,U.S. Senate,Eric Mccray,REP,380008,0,0,1,1,
Kiowa,U.S. Senate,Kevin Crow,REP,380008,0,0,1,1,
Kiowa,U.S. Senate,James Lankford,REP,380008,0,2,17,19,
Kiowa,U.S. Senate,Jason Weger,REP,380008,0,0,0,0,
Kiowa,U.S. House,Timothy Ray Murray,REP,380008,0,0,3,3,03
Kiowa,U.S. House,Robert Hubbard,REP,380008,0,0,1,1,03
Kiowa,U.S. House,Frank Lucas,REP,380008,0,2,26,28,03
Kiowa,Superintendent of Public Instruction,John Cox,DEM,380009,0,0,6,6,
Kiowa,Superintendent of Public Instruction,Jack Jr.,DEM,380009,0,0,0,0,
Kiowa,Superintendent of Public Instruction,Ivan Holmes,DEM,380009,0,0,2,2,
Kiowa,Superintendent of Public Instruction,Freda Deskin,DEM,380009,0,0,2,2,
Kiowa,U.S. Senate,Patrick Michael Hayes,DEM,380009,0,0,4,4,
Kiowa,U.S. Senate,Jim Rogers,DEM,380009,0,0,4,4,
Kiowa,U.S. Senate,Connie Johnson,DEM,380009,0,0,2,2,
Kiowa,Governor,Dax Ewbank,REP,380009,0,0,0,0,
Kiowa,Governor,Chad Moody,REP,380009,0,0,1,1,
Kiowa,Governor,Mary Fallin,REP,380009,0,0,3,3,
Kiowa,Superintendent of Public Instruction,Brian Kelly,REP,380009,0,0,0,0,
Kiowa,Superintendent of Public Instruction,Janet Costello Barresi,REP,380009,0,0,0,0,
Kiowa,Superintendent of Public Instruction,Joy Hofmeister,REP,380009,0,0,4,4,
Kiowa,Insurance Commissioner,Bill Viner,REP,380009,0,0,1,1,
Kiowa,Insurance Commissioner,John Doak,REP,380009,0,0,1,1,
Kiowa,Corporation Commissioner,Todd Hiett,REP,380009,0,0,2,2,
Kiowa,Corporation Commissioner,Cliff Branan,REP,380009,0,0,1,1,
Kiowa,U.S. Senate,Evelyn Rogers,REP,380009,0,0,0,0,
Kiowa,U.S. Senate,Rob Moye,REP,380009,0,0,0,0,
Kiowa,U.S. Senate,D. Jean Mcbride-Samuels,REP,380009,0,0,0,0,
Kiowa,U.S. Senate,Jim Inhofe,REP,380009,0,0,4,4,
Kiowa,U.S. Senate,Erick Paul Wyatt,REP,380009,0,0,0,0,
Kiowa,U.S. Senate,Andy Craig,REP,380009,0,0,0,0,
Kiowa,U.S. Senate,T. Shannon,REP,380009,0,0,0,0,
Kiowa,U.S. Senate,Randy Brogdon,REP,380009,0,0,0,0,
Kiowa,U.S. Senate,Eric Mccray,REP,380009,0,0,0,0,
Kiowa,U.S. Senate,Kevin Crow,REP,380009,0,0,0,0,
Kiowa,U.S. Senate,James Lankford,REP,380009,0,0,4,4,
Kiowa,U.S. Senate,Jason Weger,REP,380009,0,0,0,0,
Kiowa,U.S. House,Timothy Ray Murray,REP,380009,0,0,0,0,03
Kiowa,U.S. House,Robert Hubbard,REP,380009,0,0,0,0,03
Kiowa,U.S. House,Frank Lucas,REP,380009,0,0,4,4,03
Kiowa,Superintendent of Public Instruction,John Cox,DEM,380010,2,0,55,57,
Kiowa,Superintendent of Public Instruction,Jack Jr.,DEM,380010,0,0,10,10,
Kiowa,Superintendent of Public Instruction,Ivan Holmes,DEM,380010,1,0,4,5,
Kiowa,Superintendent of Public Instruction,Freda Deskin,DEM,380010,0,0,17,17,
Kiowa,U.S. Senate,Patrick Michael Hayes,DEM,380010,2,0,18,20,
Kiowa,U.S. Senate,Jim Rogers,DEM,380010,1,0,31,32,
Kiowa,U.S. Senate,Connie Johnson,DEM,380010,0,0,37,37,
Kiowa,Governor,Dax Ewbank,REP,380010,0,0,6,6,
Kiowa,Governor,Chad Moody,REP,380010,0,0,11,11,
Kiowa,Governor,Mary Fallin,REP,380010,0,0,43,43,
Kiowa,Superintendent of Public Instruction,Brian Kelly,REP,380010,0,0,12,12,
Kiowa,Superintendent of Public Instruction,Janet Costello Barresi,REP,380010,0,0,10,10,
Kiowa,Superintendent of Public Instruction,Joy Hofmeister,REP,380010,0,0,37,37,
Kiowa,Insurance Commissioner,Bill Viner,REP,380010,0,0,16,16,
Kiowa,Insurance Commissioner,John Doak,REP,380010,0,0,39,39,
Kiowa,Corporation Commissioner,Todd Hiett,REP,380010,0,0,37,37,
Kiowa,Corporation Commissioner,Cliff Branan,REP,380010,0,0,19,19,
Kiowa,U.S. Senate,Evelyn Rogers,REP,380010,0,0,0,0,
Kiowa,U.S. Senate,Rob Moye,REP,380010,0,0,0,0,
Kiowa,U.S. Senate,D. Jean Mcbride-Samuels,REP,380010,0,0,0,0,
Kiowa,U.S. Senate,Jim Inhofe,REP,380010,0,0,56,56,
Kiowa,U.S. Senate,Erick Paul Wyatt,REP,380010,0,0,3,3,
Kiowa,U.S. Senate,Andy Craig,REP,380010,0,0,1,1,
Kiowa,U.S. Senate,T. Shannon,REP,380010,0,0,22,22,
Kiowa,U.S. Senate,Randy Brogdon,REP,380010,0,0,1,1,
Kiowa,U.S. Senate,Eric Mccray,REP,380010,0,0,0,0,
Kiowa,U.S. Senate,Kevin Crow,REP,380010,0,0,0,0,
Kiowa,U.S. Senate,James Lankford,REP,380010,0,0,37,37,
Kiowa,U.S. Senate,Jason Weger,REP,380010,0,0,0,0,
Kiowa,U.S. House,Timothy Ray Murray,REP,380010,0,0,1,1,03
Kiowa,U.S. House,Robert Hubbard,REP,380010,0,0,5,5,03
Kiowa,U.S. House,Frank Lucas,REP,380010,0,0,52,52,03
Kiowa,Superintendent of Public Instruction,John Cox,DEM,380011,0,0,5,5,
Kiowa,Superintendent of Public Instruction,Jack Jr.,DEM,380011,0,0,4,4,
Kiowa,Superintendent of Public Instruction,Ivan Holmes,DEM,380011,0,0,2,2,
Kiowa,Superintendent of Public Instruction,Freda Deskin,DEM,380011,0,0,8,8,
Kiowa,U.S. Senate,Patrick Michael Hayes,DEM,380011,0,0,5,5,
Kiowa,U.S. Senate,Jim Rogers,DEM,380011,0,0,12,12,
Kiowa,U.S. Senate,Connie Johnson,DEM,380011,0,0,3,3,
Kiowa,Governor,Dax Ewbank,REP,380011,0,0,2,2,
Kiowa,Governor,Chad Moody,REP,380011,0,0,1,1,
Kiowa,Governor,Mary Fallin,REP,380011,0,0,18,18,
Kiowa,Superintendent of Public Instruction,Brian Kelly,REP,380011,0,0,2,2,
Kiowa,Superintendent of Public Instruction,Janet Costello Barresi,REP,380011,0,0,5,5,
Kiowa,Superintendent of Public Instruction,Joy Hofmeister,REP,380011,0,0,14,14,
Kiowa,Insurance Commissioner,Bill Viner,REP,380011,0,0,5,5,
Kiowa,Insurance Commissioner,John Doak,REP,380011,0,0,16,16,
Kiowa,Corporation Commissioner,Todd Hiett,REP,380011,0,0,8,8,
Kiowa,Corporation Commissioner,Cliff Branan,REP,380011,0,0,11,11,
Kiowa,U.S. Senate,Evelyn Rogers,REP,380011,0,0,0,0,
Kiowa,U.S. Senate,Rob Moye,REP,380011,0,0,0,0,
Kiowa,U.S. Senate,D. Jean Mcbride-Samuels,REP,380011,0,0,0,0,
Kiowa,U.S. Senate,Jim Inhofe,REP,380011,0,0,19,19,
Kiowa,U.S. Senate,Erick Paul Wyatt,REP,380011,0,0,1,1,
Kiowa,U.S. Senate,Andy Craig,REP,380011,0,0,0,0,
Kiowa,U.S. Senate,T. Shannon,REP,380011,0,0,9,9,
Kiowa,U.S. Senate,Randy Brogdon,REP,380011,0,0,0,0,
Kiowa,U.S. Senate,Eric Mccray,REP,380011,0,0,0,0,
Kiowa,U.S. Senate,Kevin Crow,REP,380011,0,0,0,0,
Kiowa,U.S. Senate,James Lankford,REP,380011,0,0,12,12,
Kiowa,U.S. Senate,Jason Weger,REP,380011,0,0,0,0,
Kiowa,U.S. House,Timothy Ray Murray,REP,380011,0,0,0,0,03
Kiowa,U.S. House,Robert Hubbard,REP,380011,0,0,2,2,03
Kiowa,U.S. House,Frank Lucas,REP,380011,0,0,19,19,03
Kiowa,Superintendent of Public Instruction,John Cox,DEM,380014,2,0,54,56,
Kiowa,Superintendent of Public Instruction,Jack Jr.,DEM,380014,0,0,13,13,
Kiowa,Superintendent of Public Instruction,Ivan Holmes,DEM,380014,0,0,9,9,
Kiowa,Superintendent of Public Instruction,Freda Deskin,DEM,380014,0,0,20,20,
Kiowa,U.S. Senate,Patrick Michael Hayes,DEM,380014,0,0,16,16,
Kiowa,U.S. Senate,Jim Rogers,DEM,380014,2,0,47,49,
Kiowa,U.S. Senate,Connie Johnson,DEM,380014,0,0,31,31,
Kiowa,Governor,Dax Ewbank,REP,380014,0,0,4,4,
Kiowa,Governor,Chad Moody,REP,380014,1,0,11,12,
Kiowa,Governor,Mary Fallin,REP,380014,1,1,53,55,
Kiowa,Superintendent of Public Instruction,Brian Kelly,REP,380014,0,0,11,11,
Kiowa,Superintendent of Public Instruction,Janet Costello Barresi,REP,380014,1,1,11,13,
Kiowa,Superintendent of Public Instruction,Joy Hofmeister,REP,380014,1,0,46,47,
Kiowa,Insurance Commissioner,Bill Viner,REP,380014,2,0,14,16,
Kiowa,Insurance Commissioner,John Doak,REP,380014,0,0,54,54,
Kiowa,Corporation Commissioner,Todd Hiett,REP,380014,1,0,29,30,
Kiowa,Corporation Commissioner,Cliff Branan,REP,380014,1,1,38,40,
Kiowa,U.S. Senate,Evelyn Rogers,REP,380014,0,0,6,6,
Kiowa,U.S. Senate,Rob Moye,REP,380014,0,0,0,0,
Kiowa,U.S. Senate,D. Jean Mcbride-Samuels,REP,380014,1,0,0,1,
Kiowa,U.S. Senate,Jim Inhofe,REP,380014,1,1,57,59,
Kiowa,U.S. Senate,Erick Paul Wyatt,REP,380014,0,0,5,5,
Kiowa,U.S. Senate,Andy Craig,REP,380014,0,0,0,0,
Kiowa,U.S. Senate,T. Shannon,REP,380014,0,0,28,28,
Kiowa,U.S. Senate,Randy Brogdon,REP,380014,0,0,0,0,
Kiowa,U.S. Senate,Eric Mccray,REP,380014,1,0,1,2,
Kiowa,U.S. Senate,Kevin Crow,REP,380014,0,0,1,1,
Kiowa,U.S. Senate,James Lankford,REP,380014,1,1,38,40,
Kiowa,U.S. Senate,Jason Weger,REP,380014,0,0,0,0,
Kiowa,U.S. House,Timothy Ray Murray,REP,380014,0,0,1,1,03
Kiowa,U.S. House,Robert Hubbard,REP,380014,0,0,8,8,03
Kiowa,U.S. House,Frank Lucas,REP,380014,2,1,58,61,03
Kiowa,Superintendent of Public Instruction,John Cox,DEM,380015,0,1,13,14,
Kiowa,Superintendent of Public Instruction,Jack Jr.,DEM,380015,0,0,1,1,
Kiowa,Superintendent of Public Instruction,Ivan Holmes,DEM,380015,0,0,1,1,
Kiowa,Superintendent of Public Instruction,Freda Deskin,DEM,380015,0,1,5,6,
Kiowa,U.S. Senate,Patrick Michael Hayes,DEM,380015,0,1,7,8,
Kiowa,U.S. Senate,Jim Rogers,DEM,380015,0,0,8,8,
Kiowa,U.S. Senate,Connie Johnson,DEM,380015,0,1,5,6,
Kiowa,Governor,Dax Ewbank,REP,380015,0,0,6,6,
Kiowa,Governor,Chad Moody,REP,380015,0,0,4,4,
Kiowa,Governor,Mary Fallin,REP,380015,0,1,6,7,
Kiowa,Superintendent of Public Instruction,Brian Kelly,REP,380015,0,1,6,7,
Kiowa,Superintendent of Public Instruction,Janet Costello Barresi,REP,380015,0,0,2,2,
Kiowa,Superintendent of Public Instruction,Joy Hofmeister,REP,380015,0,0,8,8,
Kiowa,Insurance Commissioner,Bill Viner,REP,380015,0,0,4,4,
Kiowa,Insurance Commissioner,John Doak,REP,380015,0,1,11,12,
Kiowa,Corporation Commissioner,Todd Hiett,REP,380015,0,1,8,9,
Kiowa,Corporation Commissioner,Cliff Branan,REP,380015,0,0,7,7,
Kiowa,U.S. Senate,Evelyn Rogers,REP,380015,0,0,1,1,
Kiowa,U.S. Senate,Rob Moye,REP,380015,0,0,0,0,
Kiowa,U.S. Senate,D. Jean Mcbride-Samuels,REP,380015,0,0,0,0,
Kiowa,U.S. Senate,Jim Inhofe,REP,380015,0,1,13,14,
Kiowa,U.S. Senate,Erick Paul Wyatt,REP,380015,0,0,2,2,
Kiowa,U.S. Senate,Andy Craig,REP,380015,0,0,0,0,
Kiowa,U.S. Senate,T. Shannon,REP,380015,0,0,7,7,
Kiowa,U.S. Senate,Randy Brogdon,REP,380015,0,0,0,0,
Kiowa,U.S. Senate,Eric Mccray,REP,380015,0,0,0,0,
Kiowa,U.S. Senate,Kevin Crow,REP,380015,0,0,0,0,
Kiowa,U.S. Senate,James Lankford,REP,380015,0,1,9,10,
Kiowa,U.S. Senate,Jason Weger,REP,380015,0,0,0,0,
Kiowa,U.S. House,Timothy Ray Murray,REP,380015,0,0,0,0,03
Kiowa,U.S. House,Robert Hubbard,REP,380015,0,0,1,1,03
Kiowa,U.S. House,Frank Lucas,REP,380015,0,1,14,15,03
Kiowa,Superintendent of Public Instruction,John Cox,DEM,380016,0,0,8,8,
Kiowa,Superintendent of Public Instruction,Jack Jr.,DEM,380016,0,0,0,0,
Kiowa,Superintendent of Public Instruction,Ivan Holmes,DEM,380016,0,0,0,0,
Kiowa,Superintendent of Public Instruction,Freda Deskin,DEM,380016,0,0,5,5,
Kiowa,U.S. Senate,Patrick Michael Hayes,DEM,380016,0,0,3,3,
Kiowa,U.S. Senate,Jim Rogers,DEM,380016,0,0,8,8,
Kiowa,U.S. Senate,Connie Johnson,DEM,380016,0,0,2,2,
Kiowa,Governor,Dax Ewbank,REP,380016,0,0,1,1,
Kiowa,Governor,Chad Moody,REP,380016,0,0,4,4,
Kiowa,Governor,Mary Fallin,REP,380016,0,0,15,15,
Kiowa,Superintendent of Public Instruction,Brian Kelly,REP,380016,0,0,1,1,
Kiowa,Superintendent of Public Instruction,Janet Costello Barresi,REP,380016,0,0,1,1,
Kiowa,Superintendent of Public Instruction,Joy Hofmeister,REP,380016,0,0,17,17,
Kiowa,Insurance Commissioner,Bill Viner,REP,380016,0,0,5,5,
Kiowa,Insurance Commissioner,John Doak,REP,380016,0,0,13,13,
Kiowa,Corporation Commissioner,Todd Hiett,REP,380016,0,0,3,3,
Kiowa,Corporation Commissioner,Cliff Branan,REP,380016,0,0,13,13,
Kiowa,U.S. Senate,Evelyn Rogers,REP,380016,0,0,0,0,
Kiowa,U.S. Senate,Rob Moye,REP,380016,0,0,0,0,
Kiowa,U.S. Senate,D. Jean Mcbride-Samuels,REP,380016,0,0,0,0,
Kiowa,U.S. Senate,Jim Inhofe,REP,380016,0,0,18,18,
Kiowa,U.S. Senate,Erick Paul Wyatt,REP,380016,0,0,1,1,
Kiowa,U.S. Senate,Andy Craig,REP,380016,0,0,0,0,
Kiowa,U.S. Senate,T. Shannon,REP,380016,0,0,7,7,
Kiowa,U.S. Senate,Randy Brogdon,REP,380016,0,0,1,1,
Kiowa,U.S. Senate,Eric Mccray,REP,380016,0,0,0,0,
Kiowa,U.S. Senate,Kevin Crow,REP,380016,0,0,0,0,
Kiowa,U.S. Senate,James Lankford,REP,380016,0,0,12,12,
Kiowa,U.S. Senate,Jason Weger,REP,380016,0,0,0,0,
Kiowa,U.S. House,Timothy Ray Murray,REP,380016,0,0,1,1,03
Kiowa,U.S. House,Robert Hubbard,REP,380016,0,0,0,0,03
Kiowa,U.S. House,Frank Lucas,REP,380016,0,0,17,17,03
Kiowa,Superintendent of Public Instruction,John Cox,DEM,380022,0,1,14,15,
Kiowa,Superintendent of Public Instruction,Jack Jr.,DEM,380022,1,0,12,13,
Kiowa,Superintendent of Public Instruction,Ivan Holmes,DEM,380022,0,0,5,5,
Kiowa,Superintendent of Public Instruction,Freda Deskin,DEM,380022,0,0,9,9,
Kiowa,U.S. Senate,Patrick Michael Hayes,DEM,380022,0,1,5,6,
Kiowa,U.S. Senate,Jim Rogers,DEM,380022,1,0,25,26,
Kiowa,U.S. Senate,Connie Johnson,DEM,380022,0,0,9,9,
Kiowa,Governor,Dax Ewbank,REP,380022,0,0,4,4,
Kiowa,Governor,Chad Moody,REP,380022,0,1,4,5,
Kiowa,Governor,Mary Fallin,REP,380022,0,1,19,20,
Kiowa,Superintendent of Public Instruction,Brian Kelly,REP,380022,0,1,8,9,
Kiowa,Superintendent of Public Instruction,Janet Costello Barresi,REP,380022,0,1,5,6,
Kiowa,Superintendent of Public Instruction,Joy Hofmeister,REP,380022,0,0,14,14,
Kiowa,Insurance Commissioner,Bill Viner,REP,380022,0,1,7,8,
Kiowa,Insurance Commissioner,John Doak,REP,380022,0,1,17,18,
Kiowa,Corporation Commissioner,Todd Hiett,REP,380022,0,2,10,12,
Kiowa,Corporation Commissioner,Cliff Branan,REP,380022,0,0,11,11,
Kiowa,U.S. Senate,Evelyn Rogers,REP,380022,0,0,0,0,
Kiowa,U.S. Senate,Rob Moye,REP,380022,0,0,0,0,
Kiowa,U.S. Senate,D. Jean Mcbride-Samuels,REP,380022,0,0,0,0,
Kiowa,U.S. Senate,Jim Inhofe,REP,380022,0,1,25,26,
Kiowa,U.S. Senate,Erick Paul Wyatt,REP,380022,0,1,1,2,
Kiowa,U.S. Senate,Andy Craig,REP,380022,0,0,1,1,
Kiowa,U.S. Senate,T. Shannon,REP,380022,0,2,14,16,
Kiowa,U.S. Senate,Randy Brogdon,REP,380022,0,0,0,0,
Kiowa,U.S. Senate,Eric Mccray,REP,380022,0,0,0,0,
Kiowa,U.S. Senate,Kevin Crow,REP,380022,0,0,0,0,
Kiowa,U.S. Senate,James Lankford,REP,380022,0,0,11,11,
Kiowa,U.S. Senate,Jason Weger,REP,380022,0,0,0,0,
Kiowa,U.S. House,Timothy Ray Murray,REP,380022,0,0,1,1,03
Kiowa,U.S. House,Robert Hubbard,REP,380022,0,1,0,1,03
Kiowa,U.S. House,Frank Lucas,REP,380022,0,1,25,26,03
Latimer,Superintendent of Public Instruction,John Cox,DEM,390001,1,19,82,102,
Latimer,Superintendent of Public Instruction,Jack Jr.,DEM,390001,1,0,41,42,
Latimer,Superintendent of Public Instruction,Ivan Holmes,DEM,390001,1,4,26,31,
Latimer,Superintendent of Public Instruction,Freda Deskin,DEM,390001,0,4,62,66,
Latimer,U.S. Senate,Patrick Michael Hayes,DEM,390001,0,7,50,57,
Latimer,U.S. Senate,Jim Rogers,DEM,390001,3,12,92,107,
Latimer,U.S. Senate,Connie Johnson,DEM,390001,1,8,60,69,
Latimer,U.S. House,Earl Everett,DEM,390001,2,14,114,130,02
Latimer,U.S. House,Joshua Harris-Till,DEM,390001,0,12,82,94,02
Latimer,Governor,Dax Ewbank,REP,390001,0,0,1,1,
Latimer,Governor,Chad Moody,REP,390001,0,1,6,7,
Latimer,Governor,Mary Fallin,REP,390001,0,1,14,15,
Latimer,Superintendent of Public Instruction,Brian Kelly,REP,390001,0,1,3,4,
Latimer,Superintendent of Public Instruction,Janet Costello Barresi,REP,390001,0,0,5,5,
Latimer,Superintendent of Public Instruction,Joy Hofmeister,REP,390001,0,1,13,14,
Latimer,Insurance Commissioner,Bill Viner,REP,390001,0,1,5,6,
Latimer,Insurance Commissioner,John Doak,REP,390001,0,1,14,15,
Latimer,Corporation Commissioner,Todd Hiett,REP,390001,0,1,11,12,
Latimer,Corporation Commissioner,Cliff Branan,REP,390001,0,1,8,9,
Latimer,U.S. Senate,Evelyn Rogers,REP,390001,0,0,1,1,
Latimer,U.S. Senate,Rob Moye,REP,390001,0,1,1,2,
Latimer,U.S. Senate,D. Jean Mcbride-Samuels,REP,390001,0,0,0,0,
Latimer,U.S. Senate,Jim Inhofe,REP,390001,0,1,18,19,
Latimer,U.S. Senate,Erick Paul Wyatt,REP,390001,0,0,0,0,
Latimer,U.S. Senate,Andy Craig,REP,390001,0,1,1,2,
Latimer,U.S. Senate,T. Shannon,REP,390001,0,0,5,5,
Latimer,U.S. Senate,Randy Brogdon,REP,390001,0,0,0,0,
Latimer,U.S. Senate,Eric Mccray,REP,390001,0,0,0,0,
Latimer,U.S. Senate,Kevin Crow,REP,390001,0,0,0,0,
Latimer,U.S. Senate,James Lankford,REP,390001,0,1,12,13,
Latimer,U.S. Senate,Jason Weger,REP,390001,0,0,1,1,
Latimer,U.S. House,Darrel Robertson,REP,390001,0,1,9,10,02
Latimer,U.S. House,Markwayne Mullin,REP,390001,0,1,11,12,02
Latimer,State House,Paul Marean,REP,390001,0,2,9,11,17
Latimer,State House,Micah Thompson,REP,390001,0,0,10,10,17
Latimer,Superintendent of Public Instruction,John Cox,DEM,390002,5,16,100,121,
Latimer,Superintendent of Public Instruction,Jack Jr.,DEM,390002,2,2,35,39,
Latimer,Superintendent of Public Instruction,Ivan Holmes,DEM,390002,0,6,14,20,
Latimer,Superintendent of Public Instruction,Freda Deskin,DEM,390002,2,4,65,71,
Latimer,U.S. Senate,Patrick Michael Hayes,DEM,390002,2,3,46,51,
Latimer,U.S. Senate,Jim Rogers,DEM,390002,1,14,102,117,
Latimer,U.S. Senate,Connie Johnson,DEM,390002,5,11,60,76,
Latimer,U.S. House,Earl Everett,DEM,390002,3,13,134,150,02
Latimer,U.S. House,Joshua Harris-Till,DEM,390002,5,14,67,86,02
Latimer,Governor,Dax Ewbank,REP,390002,0,0,4,4,
Latimer,Governor,Chad Moody,REP,390002,0,4,3,7,
Latimer,Governor,Mary Fallin,REP,390002,0,0,14,14,
Latimer,Superintendent of Public Instruction,Brian Kelly,REP,390002,0,1,3,4,
Latimer,Superintendent of Public Instruction,Janet Costello Barresi,REP,390002,0,0,5,5,
Latimer,Superintendent of Public Instruction,Joy Hofmeister,REP,390002,0,3,14,17,
Latimer,Insurance Commissioner,Bill Viner,REP,390002,0,0,3,3,
Latimer,Insurance Commissioner,John Doak,REP,390002,0,4,18,22,
Latimer,Corporation Commissioner,Todd Hiett,REP,390002,0,2,13,15,
Latimer,Corporation Commissioner,Cliff Branan,REP,390002,0,2,9,11,
Latimer,U.S. Senate,Evelyn Rogers,REP,390002,0,0,1,1,
Latimer,U.S. Senate,Rob Moye,REP,390002,0,1,1,2,
Latimer,U.S. Senate,D. Jean Mcbride-Samuels,REP,390002,0,1,1,2,
Latimer,U.S. Senate,Jim Inhofe,REP,390002,0,2,18,20,
Latimer,U.S. Senate,Erick Paul Wyatt,REP,390002,0,0,1,1,
Latimer,U.S. Senate,Andy Craig,REP,390002,0,0,0,0,
Latimer,U.S. Senate,T. Shannon,REP,390002,0,0,11,11,
Latimer,U.S. Senate,Randy Brogdon,REP,390002,0,1,0,1,
Latimer,U.S. Senate,Eric Mccray,REP,390002,0,0,0,0,
Latimer,U.S. Senate,Kevin Crow,REP,390002,0,0,0,0,
Latimer,U.S. Senate,James Lankford,REP,390002,0,2,11,13,
Latimer,U.S. Senate,Jason Weger,REP,390002,0,1,0,1,
Latimer,U.S. House,Darrel Robertson,REP,390002,0,2,11,13,02
Latimer,U.S. House,Markwayne Mullin,REP,390002,0,2,11,13,02
Latimer,State House,Paul Marean,REP,390002,0,2,7,9,17
Latimer,State House,Micah Thompson,REP,390002,0,2,14,16,17
Latimer,Superintendent of Public Instruction,John Cox,DEM,390003,2,10,59,71,
Latimer,Superintendent of Public Instruction,Jack Jr.,DEM,390003,0,1,16,17,
Latimer,Superintendent of Public Instruction,Ivan Holmes,DEM,390003,1,0,7,8,
Latimer,Superintendent of Public Instruction,Freda Deskin,DEM,390003,0,7,30,37,
Latimer,U.S. Senate,Patrick Michael Hayes,DEM,390003,3,5,32,40,
Latimer,U.S. Senate,Jim Rogers,DEM,390003,0,9,55,64,
Latimer,U.S. Senate,Connie Johnson,DEM,390003,0,3,18,21,
Latimer,U.S. House,Earl Everett,DEM,390003,3,15,65,83,02
Latimer,U.S. House,Joshua Harris-Till,DEM,390003,0,2,40,42,02
Latimer,Governor,Dax Ewbank,REP,390003,0,1,2,3,
Latimer,Governor,Chad Moody,REP,390003,0,1,3,4,
Latimer,Governor,Mary Fallin,REP,390003,0,2,13,15,
Latimer,Superintendent of Public Instruction,Brian Kelly,REP,390003,0,1,5,6,
Latimer,Superintendent of Public Instruction,Janet Costello Barresi,REP,390003,0,1,4,5,
Latimer,Superintendent of Public Instruction,Joy Hofmeister,REP,390003,0,2,9,11,
Latimer,Insurance Commissioner,Bill Viner,REP,390003,0,0,10,10,
Latimer,Insurance Commissioner,John Doak,REP,390003,0,4,7,11,
Latimer,Corporation Commissioner,Todd Hiett,REP,390003,0,3,11,14,
Latimer,Corporation Commissioner,Cliff Branan,REP,390003,0,1,6,7,
Latimer,U.S. Senate,Evelyn Rogers,REP,390003,0,1,1,2,
Latimer,U.S. Senate,Rob Moye,REP,390003,0,0,0,0,
Latimer,U.S. Senate,D. Jean Mcbride-Samuels,REP,390003,0,0,0,0,
Latimer,U.S. Senate,Jim Inhofe,REP,390003,0,3,16,19,
Latimer,U.S. Senate,Erick Paul Wyatt,REP,390003,0,0,1,1,
Latimer,U.S. Senate,Andy Craig,REP,390003,0,0,0,0,
Latimer,U.S. Senate,T. Shannon,REP,390003,0,1,10,11,
Latimer,U.S. Senate,Randy Brogdon,REP,390003,0,0,0,0,
Latimer,U.S. Senate,Eric Mccray,REP,390003,0,0,1,1,
Latimer,U.S. Senate,Kevin Crow,REP,390003,0,1,0,1,
Latimer,U.S. Senate,James Lankford,REP,390003,0,2,7,9,
Latimer,U.S. Senate,Jason Weger,REP,390003,0,0,0,0,
Latimer,U.S. House,Darrel Robertson,REP,390003,0,1,1,2,02
Latimer,U.S. House,Markwayne Mullin,REP,390003,0,3,17,20,02
Latimer,State House,Paul Marean,REP,390003,0,2,6,8,17
Latimer,State House,Micah Thompson,REP,390003,0,2,10,12,17
Latimer,Superintendent of Public Instruction,John Cox,DEM,390004,0,5,36,41,
Latimer,Superintendent of Public Instruction,Jack Jr.,DEM,390004,0,0,14,14,
Latimer,Superintendent of Public Instruction,Ivan Holmes,DEM,390004,0,1,11,12,
Latimer,Superintendent of Public Instruction,Freda Deskin,DEM,390004,0,3,15,18,
Latimer,U.S. Senate,Patrick Michael Hayes,DEM,390004,0,0,16,16,
Latimer,U.S. Senate,Jim Rogers,DEM,390004,0,4,37,41,
Latimer,U.S. Senate,Connie Johnson,DEM,390004,0,5,23,28,
Latimer,U.S. House,Earl Everett,DEM,390004,0,4,42,46,02
Latimer,U.S. House,Joshua Harris-Till,DEM,390004,0,5,27,32,02
Latimer,Governor,Dax Ewbank,REP,390004,0,0,0,0,
Latimer,Governor,Chad Moody,REP,390004,0,0,3,3,
Latimer,Governor,Mary Fallin,REP,390004,0,0,7,7,
Latimer,Superintendent of Public Instruction,Brian Kelly,REP,390004,0,0,2,2,
Latimer,Superintendent of Public Instruction,Janet Costello Barresi,REP,390004,0,0,0,0,
Latimer,Superintendent of Public Instruction,Joy Hofmeister,REP,390004,0,0,8,8,
Latimer,Insurance Commissioner,Bill Viner,REP,390004,0,0,4,4,
Latimer,Insurance Commissioner,John Doak,REP,390004,0,0,6,6,
Latimer,Corporation Commissioner,Todd Hiett,REP,390004,0,0,5,5,
Latimer,Corporation Commissioner,Cliff Branan,REP,390004,0,0,4,4,
Latimer,U.S. Senate,Evelyn Rogers,REP,390004,0,0,1,1,
Latimer,U.S. Senate,Rob Moye,REP,390004,0,0,0,0,
Latimer,U.S. Senate,D. Jean Mcbride-Samuels,REP,390004,0,0,0,0,
Latimer,U.S. Senate,Jim Inhofe,REP,390004,0,0,8,8,
Latimer,U.S. Senate,Erick Paul Wyatt,REP,390004,0,0,0,0,
Latimer,U.S. Senate,Andy Craig,REP,390004,0,0,0,0,
Latimer,U.S. Senate,T. Shannon,REP,390004,0,0,7,7,
Latimer,U.S. Senate,Randy Brogdon,REP,390004,0,0,0,0,
Latimer,U.S. Senate,Eric Mccray,REP,390004,0,0,0,0,
Latimer,U.S. Senate,Kevin Crow,REP,390004,0,0,0,0,
Latimer,U.S. Senate,James Lankford,REP,390004,0,0,3,3,
Latimer,U.S. Senate,Jason Weger,REP,390004,0,0,0,0,
Latimer,U.S. House,Darrel Robertson,REP,390004,0,0,0,0,02
Latimer,U.S. House,Markwayne Mullin,REP,390004,0,0,10,10,02
Latimer,State House,Paul Marean,REP,390004,0,0,3,3,17
Latimer,State House,Micah Thompson,REP,390004,0,0,6,6,17
Latimer,Superintendent of Public Instruction,John Cox,DEM,390005,0,3,61,64,
Latimer,Superintendent of Public Instruction,Jack Jr.,DEM,390005,0,0,10,10,
Latimer,Superintendent of Public Instruction,Ivan Holmes,DEM,390005,0,0,6,6,
Latimer,Superintendent of Public Instruction,Freda Deskin,DEM,390005,0,2,30,32,
Latimer,U.S. Senate,Patrick Michael Hayes,DEM,390005,0,1,29,30,
Latimer,U.S. Senate,Jim Rogers,DEM,390005,0,2,50,52,
Latimer,U.S. Senate,Connie Johnson,DEM,390005,0,2,21,23,
Latimer,U.S. House,Earl Everett,DEM,390005,0,4,61,65,02
Latimer,U.S. House,Joshua Harris-Till,DEM,390005,0,1,35,36,02
Latimer,Governor,Dax Ewbank,REP,390005,0,0,3,3,
Latimer,Governor,Chad Moody,REP,390005,1,4,1,6,
Latimer,Governor,Mary Fallin,REP,390005,1,4,15,20,
Latimer,Superintendent of Public Instruction,Brian Kelly,REP,390005,0,1,3,4,
Latimer,Superintendent of Public Instruction,Janet Costello Barresi,REP,390005,0,0,4,4,
Latimer,Superintendent of Public Instruction,Joy Hofmeister,REP,390005,2,7,12,21,
Latimer,Insurance Commissioner,Bill Viner,REP,390005,1,4,4,9,
Latimer,Insurance Commissioner,John Doak,REP,390005,1,2,13,16,
Latimer,Corporation Commissioner,Todd Hiett,REP,390005,1,4,10,15,
Latimer,Corporation Commissioner,Cliff Branan,REP,390005,1,1,8,10,
Latimer,U.S. Senate,Evelyn Rogers,REP,390005,0,0,1,1,
Latimer,U.S. Senate,Rob Moye,REP,390005,0,0,0,0,
Latimer,U.S. Senate,D. Jean Mcbride-Samuels,REP,390005,0,0,0,0,
Latimer,U.S. Senate,Jim Inhofe,REP,390005,2,7,18,27,
Latimer,U.S. Senate,Erick Paul Wyatt,REP,390005,0,1,0,1,
Latimer,U.S. Senate,Andy Craig,REP,390005,0,0,0,0,
Latimer,U.S. Senate,T. Shannon,REP,390005,2,3,10,15,
Latimer,U.S. Senate,Randy Brogdon,REP,390005,0,0,0,0,
Latimer,U.S. Senate,Eric Mccray,REP,390005,0,0,0,0,
Latimer,U.S. Senate,Kevin Crow,REP,390005,0,0,0,0,
Latimer,U.S. Senate,James Lankford,REP,390005,0,5,8,13,
Latimer,U.S. Senate,Jason Weger,REP,390005,0,0,1,1,
Latimer,U.S. House,Darrel Robertson,REP,390005,0,0,4,4,02
Latimer,U.S. House,Markwayne Mullin,REP,390005,2,8,15,25,02
Latimer,State House,Paul Marean,REP,390005,1,3,7,11,17
Latimer,State House,Micah Thompson,REP,390005,1,3,11,15,17
Latimer,Superintendent of Public Instruction,John Cox,DEM,390006,0,0,15,15,
Latimer,Superintendent of Public Instruction,Jack Jr.,DEM,390006,0,1,0,1,
Latimer,Superintendent of Public Instruction,Ivan Holmes,DEM,390006,0,0,2,2,
Latimer,Superintendent of Public Instruction,Freda Deskin,DEM,390006,0,0,10,10,
Latimer,U.S. Senate,Patrick Michael Hayes,DEM,390006,0,0,2,2,
Latimer,U.S. Senate,Jim Rogers,DEM,390006,0,0,5,5,
Latimer,U.S. Senate,Connie Johnson,DEM,390006,0,1,20,21,
Latimer,U.S. House,Earl Everett,DEM,390006,0,1,11,12,02
Latimer,U.S. House,Joshua Harris-Till,DEM,390006,0,0,12,12,02
Latimer,Governor,Dax Ewbank,REP,390006,0,0,1,1,
Latimer,Governor,Chad Moody,REP,390006,0,0,0,0,
Latimer,Governor,Mary Fallin,REP,390006,0,2,1,3,
Latimer,Superintendent of Public Instruction,Brian Kelly,REP,390006,0,0,1,1,
Latimer,Superintendent of Public Instruction,Janet Costello Barresi,REP,390006,0,0,1,1,
Latimer,Superintendent of Public Instruction,Joy Hofmeister,REP,390006,0,2,2,4,
Latimer,Insurance Commissioner,Bill Viner,REP,390006,0,0,1,1,
Latimer,Insurance Commissioner,John Doak,REP,390006,0,2,1,3,
Latimer,Corporation Commissioner,Todd Hiett,REP,390006,0,0,1,1,
Latimer,Corporation Commissioner,Cliff Branan,REP,390006,0,2,2,4,
Latimer,U.S. Senate,Evelyn Rogers,REP,390006,0,0,0,0,
Latimer,U.S. Senate,Rob Moye,REP,390006,0,0,1,1,
Latimer,U.S. Senate,D. Jean Mcbride-Samuels,REP,390006,0,0,0,0,
Latimer,U.S. Senate,Jim Inhofe,REP,390006,0,2,3,5,
Latimer,U.S. Senate,Erick Paul Wyatt,REP,390006,0,0,0,0,
Latimer,U.S. Senate,Andy Craig,REP,390006,0,0,0,0,
Latimer,U.S. Senate,T. Shannon,REP,390006,0,0,4,4,
Latimer,U.S. Senate,Randy Brogdon,REP,390006,0,0,0,0,
Latimer,U.S. Senate,Eric Mccray,REP,390006,0,0,0,0,
Latimer,U.S. Senate,Kevin Crow,REP,390006,0,0,0,0,
Latimer,U.S. Senate,James Lankford,REP,390006,0,2,0,2,
Latimer,U.S. Senate,Jason Weger,REP,390006,0,0,0,0,
Latimer,U.S. House,Darrel Robertson,REP,390006,0,0,0,0,02
Latimer,U.S. House,Markwayne Mullin,REP,390006,0,2,4,6,02
Latimer,State House,Paul Marean,REP,390006,0,0,0,0,17
Latimer,State House,Micah Thompson,REP,390006,0,2,4,6,17
Latimer,Superintendent of Public Instruction,John Cox,DEM,390007,0,1,5,6,
Latimer,Superintendent of Public Instruction,Jack Jr.,DEM,390007,0,1,1,2,
Latimer,Superintendent of Public Instruction,Ivan Holmes,DEM,390007,0,0,3,3,
Latimer,Superintendent of Public Instruction,Freda Deskin,DEM,390007,0,2,9,11,
Latimer,U.S. Senate,Patrick Michael Hayes,DEM,390007,0,2,9,11,
Latimer,U.S. Senate,Jim Rogers,DEM,390007,0,2,3,5,
Latimer,U.S. Senate,Connie Johnson,DEM,390007,0,0,8,8,
Latimer,U.S. House,Earl Everett,DEM,390007,0,3,9,12,02
Latimer,U.S. House,Joshua Harris-Till,DEM,390007,0,1,8,9,02
Latimer,Governor,Dax Ewbank,REP,390007,0,1,5,6,
Latimer,Governor,Chad Moody,REP,390007,0,2,6,8,
Latimer,Governor,Mary Fallin,REP,390007,0,0,7,7,
Latimer,Superintendent of Public Instruction,Brian Kelly,REP,390007,0,1,8,9,
Latimer,Superintendent of Public Instruction,Janet Costello Barresi,REP,390007,0,0,2,2,
Latimer,Superintendent of Public Instruction,Joy Hofmeister,REP,390007,0,2,8,10,
Latimer,Insurance Commissioner,Bill Viner,REP,390007,0,3,10,13,
Latimer,Insurance Commissioner,John Doak,REP,390007,0,0,8,8,
Latimer,Corporation Commissioner,Todd Hiett,REP,390007,0,2,5,7,
Latimer,Corporation Commissioner,Cliff Branan,REP,390007,0,1,12,13,
Latimer,U.S. Senate,Evelyn Rogers,REP,390007,0,0,1,1,
Latimer,U.S. Senate,Rob Moye,REP,390007,0,0,1,1,
Latimer,U.S. Senate,D. Jean Mcbride-Samuels,REP,390007,0,0,1,1,
Latimer,U.S. Senate,Jim Inhofe,REP,390007,0,2,13,15,
Latimer,U.S. Senate,Erick Paul Wyatt,REP,390007,0,1,2,3,
Latimer,U.S. Senate,Andy Craig,REP,390007,0,0,1,1,
Latimer,U.S. Senate,T. Shannon,REP,390007,0,0,5,5,
Latimer,U.S. Senate,Randy Brogdon,REP,390007,0,0,0,0,
Latimer,U.S. Senate,Eric Mccray,REP,390007,0,0,0,0,
Latimer,U.S. Senate,Kevin Crow,REP,390007,0,0,1,1,
Latimer,U.S. Senate,James Lankford,REP,390007,0,3,10,13,
Latimer,U.S. Senate,Jason Weger,REP,390007,0,0,1,1,
Latimer,U.S. House,Darrel Robertson,REP,390007,0,0,2,2,02
Latimer,U.S. House,Markwayne Mullin,REP,390007,0,3,16,19,02
Latimer,State House,Paul Marean,REP,390007,0,1,9,10,17
Latimer,State House,Micah Thompson,REP,390007,0,2,8,10,17
Latimer,Superintendent of Public Instruction,John Cox,DEM,390008,1,2,52,55,
Latimer,Superintendent of Public Instruction,Jack Jr.,DEM,390008,0,0,6,6,
Latimer,Superintendent of Public Instruction,Ivan Holmes,DEM,390008,0,0,8,8,
Latimer,Superintendent of Public Instruction,Freda Deskin,DEM,390008,0,0,10,10,
Latimer,U.S. Senate,Patrick Michael Hayes,DEM,390008,0,0,8,8,
Latimer,U.S. Senate,Jim Rogers,DEM,390008,0,0,30,30,
Latimer,U.S. Senate,Connie Johnson,DEM,390008,1,2,31,34,
Latimer,U.S. House,Earl Everett,DEM,390008,0,0,33,33,02
Latimer,U.S. House,Joshua Harris-Till,DEM,390008,1,2,30,33,02
Latimer,Governor,Dax Ewbank,REP,390008,0,0,2,2,
Latimer,Governor,Chad Moody,REP,390008,0,0,6,6,
Latimer,Governor,Mary Fallin,REP,390008,0,4,12,16,
Latimer,Superintendent of Public Instruction,Brian Kelly,REP,390008,0,1,10,11,
Latimer,Superintendent of Public Instruction,Janet Costello Barresi,REP,390008,0,0,2,2,
Latimer,Superintendent of Public Instruction,Joy Hofmeister,REP,390008,0,2,8,10,
Latimer,Insurance Commissioner,Bill Viner,REP,390008,0,4,8,12,
Latimer,Insurance Commissioner,John Doak,REP,390008,0,0,11,11,
Latimer,Corporation Commissioner,Todd Hiett,REP,390008,0,3,9,12,
Latimer,Corporation Commissioner,Cliff Branan,REP,390008,0,1,10,11,
Latimer,U.S. Senate,Evelyn Rogers,REP,390008,0,0,1,1,
Latimer,U.S. Senate,Rob Moye,REP,390008,0,0,1,1,
Latimer,U.S. Senate,D. Jean Mcbride-Samuels,REP,390008,0,0,0,0,
Latimer,U.S. Senate,Jim Inhofe,REP,390008,0,4,16,20,
Latimer,U.S. Senate,Erick Paul Wyatt,REP,390008,0,0,2,2,
Latimer,U.S. Senate,Andy Craig,REP,390008,0,0,0,0,
Latimer,U.S. Senate,T. Shannon,REP,390008,0,3,10,13,
Latimer,U.S. Senate,Randy Brogdon,REP,390008,0,0,2,2,
Latimer,U.S. Senate,Eric Mccray,REP,390008,0,0,0,0,
Latimer,U.S. Senate,Kevin Crow,REP,390008,0,0,2,2,
Latimer,U.S. Senate,James Lankford,REP,390008,0,1,7,8,
Latimer,U.S. Senate,Jason Weger,REP,390008,0,0,0,0,
Latimer,U.S. House,Darrel Robertson,REP,390008,0,0,3,3,02
Latimer,U.S. House,Markwayne Mullin,REP,390008,0,4,18,22,02
Latimer,State House,Paul Marean,REP,390008,0,2,9,11,17
Latimer,State House,Micah Thompson,REP,390008,0,2,12,14,17
Latimer,Superintendent of Public Instruction,John Cox,DEM,390009,0,0,31,31,
Latimer,Superintendent of Public Instruction,Jack Jr.,DEM,390009,0,0,4,4,
Latimer,Superintendent of Public Instruction,Ivan Holmes,DEM,390009,2,0,5,7,
Latimer,Superintendent of Public Instruction,Freda Deskin,DEM,390009,0,1,12,13,
Latimer,U.S. Senate,Patrick Michael Hayes,DEM,390009,0,0,11,11,
Latimer,U.S. Senate,Jim Rogers,DEM,390009,0,0,16,16,
Latimer,U.S. Senate,Connie Johnson,DEM,390009,2,1,23,26,
Latimer,U.S. House,Earl Everett,DEM,390009,0,0,23,23,02
Latimer,U.S. House,Joshua Harris-Till,DEM,390009,2,1,23,26,02
Latimer,Governor,Dax Ewbank,REP,390009,0,0,1,1,
Latimer,Governor,Chad Moody,REP,390009,0,0,3,3,
Latimer,Governor,Mary Fallin,REP,390009,0,0,13,13,
Latimer,Superintendent of Public Instruction,Brian Kelly,REP,390009,0,0,3,3,
Latimer,Superintendent of Public Instruction,Janet Costello Barresi,REP,390009,0,0,3,3,
Latimer,Superintendent of Public Instruction,Joy Hofmeister,REP,390009,0,0,11,11,
Latimer,Insurance Commissioner,Bill Viner,REP,390009,0,0,4,4,
Latimer,Insurance Commissioner,John Doak,REP,390009,0,0,12,12,
Latimer,Corporation Commissioner,Todd Hiett,REP,390009,0,0,9,9,
Latimer,Corporation Commissioner,Cliff Branan,REP,390009,0,0,7,7,
Latimer,U.S. Senate,Evelyn Rogers,REP,390009,0,0,0,0,
Latimer,U.S. Senate,Rob Moye,REP,390009,0,0,0,0,
Latimer,U.S. Senate,D. Jean Mcbride-Samuels,REP,390009,0,0,1,1,
Latimer,U.S. Senate,Jim Inhofe,REP,390009,0,0,16,16,
Latimer,U.S. Senate,Erick Paul Wyatt,REP,390009,0,0,0,0,
Latimer,U.S. Senate,Andy Craig,REP,390009,0,0,0,0,
Latimer,U.S. Senate,T. Shannon,REP,390009,0,0,7,7,
Latimer,U.S. Senate,Randy Brogdon,REP,390009,0,0,0,0,
Latimer,U.S. Senate,Eric Mccray,REP,390009,0,0,0,0,
Latimer,U.S. Senate,Kevin Crow,REP,390009,0,0,0,0,
Latimer,U.S. Senate,James Lankford,REP,390009,0,0,10,10,
Latimer,U.S. Senate,Jason Weger,REP,390009,0,0,0,0,
Latimer,U.S. House,Darrel Robertson,REP,390009,0,0,0,0,02
Latimer,U.S. House,Markwayne Mullin,REP,390009,0,0,17,17,02
Latimer,State House,Paul Marean,REP,390009,0,0,7,7,17
Latimer,State House,Micah Thompson,REP,390009,0,0,9,9,17
Latimer,Superintendent of Public Instruction,John Cox,DEM,390010,3,6,51,60,
Latimer,Superintendent of Public Instruction,Jack Jr.,DEM,390010,1,1,13,15,
Latimer,Superintendent of Public Instruction,Ivan Holmes,DEM,390010,1,1,11,13,
Latimer,Superintendent of Public Instruction,Freda Deskin,DEM,390010,0,0,27,27,
Latimer,U.S. Senate,Patrick Michael Hayes,DEM,390010,1,1,29,31,
Latimer,U.S. Senate,Jim Rogers,DEM,390010,2,4,47,53,
Latimer,U.S. Senate,Connie Johnson,DEM,390010,2,3,26,31,
Latimer,U.S. House,Earl Everett,DEM,390010,0,5,51,56,02
Latimer,U.S. House,Joshua Harris-Till,DEM,390010,3,3,42,48,02
Latimer,Governor,Dax Ewbank,REP,390010,0,0,1,1,
Latimer,Governor,Chad Moody,REP,390010,0,0,3,3,
Latimer,Governor,Mary Fallin,REP,390010,2,0,15,17,
Latimer,Superintendent of Public Instruction,Brian Kelly,REP,390010,0,0,1,1,
Latimer,Superintendent of Public Instruction,Janet Costello Barresi,REP,390010,1,0,3,4,
Latimer,Superintendent of Public Instruction,Joy Hofmeister,REP,390010,1,0,15,16,
Latimer,Insurance Commissioner,Bill Viner,REP,390010,0,0,5,5,
Latimer,Insurance Commissioner,John Doak,REP,390010,2,0,11,13,
Latimer,Corporation Commissioner,Todd Hiett,REP,390010,0,0,11,11,
Latimer,Corporation Commissioner,Cliff Branan,REP,390010,2,0,6,8,
Latimer,U.S. Senate,Evelyn Rogers,REP,390010,0,0,1,1,
Latimer,U.S. Senate,Rob Moye,REP,390010,0,0,0,0,
Latimer,U.S. Senate,D. Jean Mcbride-Samuels,REP,390010,0,0,1,1,
Latimer,U.S. Senate,Jim Inhofe,REP,390010,2,0,17,19,
Latimer,U.S. Senate,Erick Paul Wyatt,REP,390010,0,0,0,0,
Latimer,U.S. Senate,Andy Craig,REP,390010,0,0,0,0,
Latimer,U.S. Senate,T. Shannon,REP,390010,2,0,8,10,
Latimer,U.S. Senate,Randy Brogdon,REP,390010,0,0,0,0,
Latimer,U.S. Senate,Eric Mccray,REP,390010,0,0,0,0,
Latimer,U.S. Senate,Kevin Crow,REP,390010,0,0,1,1,
Latimer,U.S. Senate,James Lankford,REP,390010,0,0,9,9,
Latimer,U.S. Senate,Jason Weger,REP,390010,0,0,1,1,
Latimer,U.S. House,Darrel Robertson,REP,390010,0,0,4,4,02
Latimer,U.S. House,Markwayne Mullin,REP,390010,2,0,15,17,02
Latimer,State House,Paul Marean,REP,390010,0,0,3,3,17
Latimer,State House,Micah Thompson,REP,390010,2,0,13,15,17
Latimer,Superintendent of Public Instruction,John Cox,DEM,390011,23,12,162,197,
Latimer,Superintendent of Public Instruction,Jack Jr.,DEM,390011,5,0,22,27,
Latimer,Superintendent of Public Instruction,Ivan Holmes,DEM,390011,2,0,18,20,
Latimer,Superintendent of Public Instruction,Freda Deskin,DEM,390011,0,2,47,49,
Latimer,U.S. Senate,Patrick Michael Hayes,DEM,390011,6,1,48,55,
Latimer,U.S. Senate,Jim Rogers,DEM,390011,14,8,102,124,
Latimer,U.S. Senate,Connie Johnson,DEM,390011,9,3,71,83,
Latimer,U.S. House,Earl Everett,DEM,390011,21,7,127,155,02
Latimer,U.S. House,Joshua Harris-Till,DEM,390011,8,3,83,94,02
Latimer,Governor,Dax Ewbank,REP,390011,0,1,2,3,
Latimer,Governor,Chad Moody,REP,390011,0,2,5,7,
Latimer,Governor,Mary Fallin,REP,390011,0,3,10,13,
Latimer,Superintendent of Public Instruction,Brian Kelly,REP,390011,0,0,6,6,
Latimer,Superintendent of Public Instruction,Janet Costello Barresi,REP,390011,0,0,2,2,
Latimer,Superintendent of Public Instruction,Joy Hofmeister,REP,390011,0,6,8,14,
Latimer,Insurance Commissioner,Bill Viner,REP,390011,0,2,7,9,
Latimer,Insurance Commissioner,John Doak,REP,390011,0,3,10,13,
Latimer,Corporation Commissioner,Todd Hiett,REP,390011,0,3,4,7,
Latimer,Corporation Commissioner,Cliff Branan,REP,390011,0,3,12,15,
Latimer,U.S. Senate,Evelyn Rogers,REP,390011,0,0,1,1,
Latimer,U.S. Senate,Rob Moye,REP,390011,0,1,1,2,
Latimer,U.S. Senate,D. Jean Mcbride-Samuels,REP,390011,0,0,0,0,
Latimer,U.S. Senate,Jim Inhofe,REP,390011,0,5,14,19,
Latimer,U.S. Senate,Erick Paul Wyatt,REP,390011,0,0,0,0,
Latimer,U.S. Senate,Andy Craig,REP,390011,0,0,0,0,
Latimer,U.S. Senate,T. Shannon,REP,390011,0,1,7,8,
Latimer,U.S. Senate,Randy Brogdon,REP,390011,0,0,0,0,
Latimer,U.S. Senate,Eric Mccray,REP,390011,0,0,1,1,
Latimer,U.S. Senate,Kevin Crow,REP,390011,0,0,2,2,
Latimer,U.S. Senate,James Lankford,REP,390011,0,5,7,12,
Latimer,U.S. Senate,Jason Weger,REP,390011,0,0,0,0,
Latimer,U.S. House,Darrel Robertson,REP,390011,0,1,2,3,02
Latimer,U.S. House,Markwayne Mullin,REP,390011,0,5,15,20,02
Latimer,State House,Paul Marean,REP,390011,0,5,5,10,17
Latimer,State House,Micah Thompson,REP,390011,0,1,12,13,17
Latimer,Superintendent of Public Instruction,John Cox,DEM,390012,0,1,34,35,
Latimer,Superintendent of Public Instruction,Jack Jr.,DEM,390012,0,2,9,11,
Latimer,Superintendent of Public Instruction,Ivan Holmes,DEM,390012,0,0,5,5,
Latimer,Superintendent of Public Instruction,Freda Deskin,DEM,390012,4,0,23,27,
Latimer,U.S. Senate,Patrick Michael Hayes,DEM,390012,4,0,11,15,
Latimer,U.S. Senate,Jim Rogers,DEM,390012,0,2,35,37,
Latimer,U.S. Senate,Connie Johnson,DEM,390012,2,1,22,25,
Latimer,U.S. House,Earl Everett,DEM,390012,6,2,30,38,02
Latimer,U.S. House,Joshua Harris-Till,DEM,390012,1,1,32,34,02
Latimer,Governor,Dax Ewbank,REP,390012,0,0,0,0,
Latimer,Governor,Chad Moody,REP,390012,0,0,2,2,
Latimer,Governor,Mary Fallin,REP,390012,0,0,4,4,
Latimer,Superintendent of Public Instruction,Brian Kelly,REP,390012,0,0,2,2,
Latimer,Superintendent of Public Instruction,Janet Costello Barresi,REP,390012,0,0,0,0,
Latimer,Superintendent of Public Instruction,Joy Hofmeister,REP,390012,0,0,4,4,
Latimer,Insurance Commissioner,Bill Viner,REP,390012,0,0,1,1,
Latimer,Insurance Commissioner,John Doak,REP,390012,0,0,5,5,
Latimer,Corporation Commissioner,Todd Hiett,REP,390012,0,0,3,3,
Latimer,Corporation Commissioner,Cliff Branan,REP,390012,0,0,3,3,
Latimer,U.S. Senate,Evelyn Rogers,REP,390012,0,0,0,0,
Latimer,U.S. Senate,Rob Moye,REP,390012,0,0,0,0,
Latimer,U.S. Senate,D. Jean Mcbride-Samuels,REP,390012,0,0,0,0,
Latimer,U.S. Senate,Jim Inhofe,REP,390012,0,0,4,4,
Latimer,U.S. Senate,Erick Paul Wyatt,REP,390012,0,0,2,2,
Latimer,U.S. Senate,Andy Craig,REP,390012,0,0,0,0,
Latimer,U.S. Senate,T. Shannon,REP,390012,0,0,4,4,
Latimer,U.S. Senate,Randy Brogdon,REP,390012,0,0,1,1,
Latimer,U.S. Senate,Eric Mccray,REP,390012,0,0,0,0,
Latimer,U.S. Senate,Kevin Crow,REP,390012,0,0,0,0,
Latimer,U.S. Senate,James Lankford,REP,390012,0,0,1,1,
Latimer,U.S. Senate,Jason Weger,REP,390012,0,0,0,0,
Latimer,U.S. House,Darrel Robertson,REP,390012,0,0,0,0,02
Latimer,U.S. House,Markwayne Mullin,REP,390012,0,0,6,6,02
Latimer,State House,Paul Marean,REP,390012,0,0,2,2,17
Latimer,State House,Micah Thompson,REP,390012,0,0,4,4,17
Leflore,Superintendent of Public Instruction,John Cox,DEM,400101,0,0,37,37,
Leflore,Superintendent of Public Instruction,Jack Jr.,DEM,400101,0,0,3,3,
Leflore,Superintendent of Public Instruction,Ivan Holmes,DEM,400101,0,0,1,1,
Leflore,Superintendent of Public Instruction,Freda Deskin,DEM,400101,0,2,8,10,
Leflore,U.S. Senate,Patrick Michael Hayes,DEM,400101,0,0,11,11,
Leflore,U.S. Senate,Jim Rogers,DEM,400101,0,2,22,24,
Leflore,U.S. Senate,Connie Johnson,DEM,400101,0,0,14,14,
Leflore,U.S. House,Earl Everett,DEM,400101,0,0,28,28,02
Leflore,U.S. House,Joshua Harris-Till,DEM,400101,0,2,18,20,02
Leflore,Governor,Dax Ewbank,REP,400101,0,0,0,0,
Leflore,Governor,Chad Moody,REP,400101,0,0,2,2,
Leflore,Governor,Mary Fallin,REP,400101,0,1,16,17,
Leflore,Superintendent of Public Instruction,Brian Kelly,REP,400101,0,0,4,4,
Leflore,Superintendent of Public Instruction,Janet Costello Barresi,REP,400101,0,1,5,6,
Leflore,Superintendent of Public Instruction,Joy Hofmeister,REP,400101,0,0,7,7,
Leflore,Insurance Commissioner,Bill Viner,REP,400101,0,1,8,9,
Leflore,Insurance Commissioner,John Doak,REP,400101,0,0,6,6,
Leflore,Corporation Commissioner,Todd Hiett,REP,400101,0,0,8,8,
Leflore,Corporation Commissioner,Cliff Branan,REP,400101,0,1,8,9,
Leflore,U.S. Senate,Evelyn Rogers,REP,400101,0,1,0,1,
Leflore,U.S. Senate,Rob Moye,REP,400101,0,0,0,0,
Leflore,U.S. Senate,D. Jean Mcbride-Samuels,REP,400101,0,0,0,0,
Leflore,U.S. Senate,Jim Inhofe,REP,400101,0,0,17,17,
Leflore,U.S. Senate,Erick Paul Wyatt,REP,400101,0,0,1,1,
Leflore,U.S. Senate,Andy Craig,REP,400101,0,1,0,1,
Leflore,U.S. Senate,T. Shannon,REP,400101,0,0,12,12,
Leflore,U.S. Senate,Randy Brogdon,REP,400101,0,0,0,0,
Leflore,U.S. Senate,Eric Mccray,REP,400101,0,0,0,0,
Leflore,U.S. Senate,Kevin Crow,REP,400101,0,0,0,0,
Leflore,U.S. Senate,James Lankford,REP,400101,0,0,6,6,
Leflore,U.S. Senate,Jason Weger,REP,400101,0,0,0,0,
Leflore,U.S. House,Darrel Robertson,REP,400101,0,0,2,2,02
Leflore,U.S. House,Markwayne Mullin,REP,400101,0,1,16,17,02
Leflore,Superintendent of Public Instruction,John Cox,DEM,400102,2,1,48,51,
Leflore,Superintendent of Public Instruction,Jack Jr.,DEM,400102,0,0,9,9,
Leflore,Superintendent of Public Instruction,Ivan Holmes,DEM,400102,0,0,6,6,
Leflore,Superintendent of Public Instruction,Freda Deskin,DEM,400102,1,0,7,8,
Leflore,U.S. Senate,Patrick Michael Hayes,DEM,400102,0,0,13,13,
Leflore,U.S. Senate,Jim Rogers,DEM,400102,2,1,39,42,
Leflore,U.S. Senate,Connie Johnson,DEM,400102,1,0,13,14,
Leflore,U.S. House,Earl Everett,DEM,400102,3,1,31,35,02
Leflore,U.S. House,Joshua Harris-Till,DEM,400102,0,0,33,33,02
Leflore,Governor,Dax Ewbank,REP,400102,0,0,3,3,
Leflore,Governor,Chad Moody,REP,400102,0,0,4,4,
Leflore,Governor,Mary Fallin,REP,400102,0,0,22,22,
Leflore,Superintendent of Public Instruction,Brian Kelly,REP,400102,0,0,9,9,
Leflore,Superintendent of Public Instruction,Janet Costello Barresi,REP,400102,0,0,6,6,
Leflore,Superintendent of Public Instruction,Joy Hofmeister,REP,400102,0,0,11,11,
Leflore,Insurance Commissioner,Bill Viner,REP,400102,0,0,12,12,
Leflore,Insurance Commissioner,John Doak,REP,400102,0,0,15,15,
Leflore,Corporation Commissioner,Todd Hiett,REP,400102,0,0,15,15,
Leflore,Corporation Commissioner,Cliff Branan,REP,400102,0,0,12,12,
Leflore,U.S. Senate,Evelyn Rogers,REP,400102,0,0,2,2,
Leflore,U.S. Senate,Rob Moye,REP,400102,0,0,1,1,
Leflore,U.S. Senate,D. Jean Mcbride-Samuels,REP,400102,0,0,0,0,
Leflore,U.S. Senate,Jim Inhofe,REP,400102,0,0,21,21,
Leflore,U.S. Senate,Erick Paul Wyatt,REP,400102,0,0,4,4,
Leflore,U.S. Senate,Andy Craig,REP,400102,0,0,3,3,
Leflore,U.S. Senate,T. Shannon,REP,400102,0,0,10,10,
Leflore,U.S. Senate,Randy Brogdon,REP,400102,0,0,0,0,
Leflore,U.S. Senate,Eric Mccray,REP,400102,0,0,1,1,
Leflore,U.S. Senate,Kevin Crow,REP,400102,0,0,3,3,
Leflore,U.S. Senate,James Lankford,REP,400102,0,0,11,11,
Leflore,U.S. Senate,Jason Weger,REP,400102,0,0,0,0,
Leflore,U.S. House,Darrel Robertson,REP,400102,0,0,8,8,02
Leflore,U.S. House,Markwayne Mullin,REP,400102,0,0,21,21,02
Leflore,Superintendent of Public Instruction,John Cox,DEM,400103,0,2,53,55,
Leflore,Superintendent of Public Instruction,Jack Jr.,DEM,400103,0,0,7,7,
Leflore,Superintendent of Public Instruction,Ivan Holmes,DEM,400103,0,0,4,4,
Leflore,Superintendent of Public Instruction,Freda Deskin,DEM,400103,3,2,15,20,
Leflore,U.S. Senate,Patrick Michael Hayes,DEM,400103,0,2,14,16,
Leflore,U.S. Senate,Jim Rogers,DEM,400103,0,1,44,45,
Leflore,U.S. Senate,Connie Johnson,DEM,400103,3,1,15,19,
Leflore,U.S. House,Earl Everett,DEM,400103,2,3,45,50,02
Leflore,U.S. House,Joshua Harris-Till,DEM,400103,0,1,23,24,02
Leflore,Governor,Dax Ewbank,REP,400103,0,1,3,4,
Leflore,Governor,Chad Moody,REP,400103,0,1,1,2,
Leflore,Governor,Mary Fallin,REP,400103,0,2,19,21,
Leflore,Superintendent of Public Instruction,Brian Kelly,REP,400103,0,1,8,9,
Leflore,Superintendent of Public Instruction,Janet Costello Barresi,REP,400103,0,2,0,2,
Leflore,Superintendent of Public Instruction,Joy Hofmeister,REP,400103,1,1,12,14,
Leflore,Insurance Commissioner,Bill Viner,REP,400103,0,2,4,6,
Leflore,Insurance Commissioner,John Doak,REP,400103,0,2,16,18,
Leflore,Corporation Commissioner,Todd Hiett,REP,400103,0,4,11,15,
Leflore,Corporation Commissioner,Cliff Branan,REP,400103,0,0,8,8,
Leflore,U.S. Senate,Evelyn Rogers,REP,400103,0,0,3,3,
Leflore,U.S. Senate,Rob Moye,REP,400103,0,0,1,1,
Leflore,U.S. Senate,D. Jean Mcbride-Samuels,REP,400103,0,0,0,0,
Leflore,U.S. Senate,Jim Inhofe,REP,400103,1,4,18,23,
Leflore,U.S. Senate,Erick Paul Wyatt,REP,400103,0,0,0,0,
Leflore,U.S. Senate,Andy Craig,REP,400103,0,0,1,1,
Leflore,U.S. Senate,T. Shannon,REP,400103,0,3,12,15,
Leflore,U.S. Senate,Randy Brogdon,REP,400103,0,0,1,1,
Leflore,U.S. Senate,Eric Mccray,REP,400103,0,0,3,3,
Leflore,U.S. Senate,Kevin Crow,REP,400103,0,0,0,0,
Leflore,U.S. Senate,James Lankford,REP,400103,0,1,6,7,
Leflore,U.S. Senate,Jason Weger,REP,400103,0,0,0,0,
Leflore,U.S. House,Darrel Robertson,REP,400103,0,0,5,5,02
Leflore,U.S. House,Markwayne Mullin,REP,400103,1,4,17,22,02
Leflore,Superintendent of Public Instruction,John Cox,DEM,400104,0,0,17,17,
Leflore,Superintendent of Public Instruction,Jack Jr.,DEM,400104,0,1,8,9,
Leflore,Superintendent of Public Instruction,Ivan Holmes,DEM,400104,0,0,3,3,
Leflore,Superintendent of Public Instruction,Freda Deskin,DEM,400104,0,0,17,17,
Leflore,U.S. Senate,Patrick Michael Hayes,DEM,400104,0,0,8,8,
Leflore,U.S. Senate,Jim Rogers,DEM,400104,0,1,9,10,
Leflore,U.S. Senate,Connie Johnson,DEM,400104,0,0,29,29,
Leflore,U.S. House,Earl Everett,DEM,400104,0,0,24,24,02
Leflore,U.S. House,Joshua Harris-Till,DEM,400104,0,1,25,26,02
Leflore,Governor,Dax Ewbank,REP,400104,0,0,1,1,
Leflore,Governor,Chad Moody,REP,400104,0,0,0,0,
Leflore,Governor,Mary Fallin,REP,400104,0,2,3,5,
Leflore,Superintendent of Public Instruction,Brian Kelly,REP,400104,0,2,0,2,
Leflore,Superintendent of Public Instruction,Janet Costello Barresi,REP,400104,0,0,0,0,
Leflore,Superintendent of Public Instruction,Joy Hofmeister,REP,400104,0,0,4,4,
Leflore,Insurance Commissioner,Bill Viner,REP,400104,0,2,0,2,
Leflore,Insurance Commissioner,John Doak,REP,400104,0,0,2,2,
Leflore,Corporation Commissioner,Todd Hiett,REP,400104,0,2,0,2,
Leflore,Corporation Commissioner,Cliff Branan,REP,400104,0,0,2,2,
Leflore,U.S. Senate,Evelyn Rogers,REP,400104,0,0,1,1,
Leflore,U.S. Senate,Rob Moye,REP,400104,0,0,0,0,
Leflore,U.S. Senate,D. Jean Mcbride-Samuels,REP,400104,0,0,0,0,
Leflore,U.S. Senate,Jim Inhofe,REP,400104,0,2,3,5,
Leflore,U.S. Senate,Erick Paul Wyatt,REP,400104,0,0,0,0,
Leflore,U.S. Senate,Andy Craig,REP,400104,0,0,0,0,
Leflore,U.S. Senate,T. Shannon,REP,400104,0,0,4,4,
Leflore,U.S. Senate,Randy Brogdon,REP,400104,0,0,0,0,
Leflore,U.S. Senate,Eric Mccray,REP,400104,0,0,0,0,
Leflore,U.S. Senate,Kevin Crow,REP,400104,0,0,0,0,
Leflore,U.S. Senate,James Lankford,REP,400104,0,2,0,2,
Leflore,U.S. Senate,Jason Weger,REP,400104,0,0,0,0,
Leflore,U.S. House,Darrel Robertson,REP,400104,0,0,2,2,02
Leflore,U.S. House,Markwayne Mullin,REP,400104,0,2,2,4,02
Leflore,Superintendent of Public Instruction,John Cox,DEM,400105,0,3,49,52,
Leflore,Superintendent of Public Instruction,Jack Jr.,DEM,400105,0,1,15,16,
Leflore,Superintendent of Public Instruction,Ivan Holmes,DEM,400105,0,0,9,9,
Leflore,Superintendent of Public Instruction,Freda Deskin,DEM,400105,0,1,14,15,
Leflore,U.S. Senate,Patrick Michael Hayes,DEM,400105,0,3,14,17,
Leflore,U.S. Senate,Jim Rogers,DEM,400105,0,2,43,45,
Leflore,U.S. Senate,Connie Johnson,DEM,400105,0,0,28,28,
Leflore,U.S. House,Earl Everett,DEM,400105,0,2,52,54,02
Leflore,U.S. House,Joshua Harris-Till,DEM,400105,0,3,30,33,02
Leflore,Governor,Dax Ewbank,REP,400105,0,0,5,5,
Leflore,Governor,Chad Moody,REP,400105,0,0,3,3,
Leflore,Governor,Mary Fallin,REP,400105,0,0,27,27,
Leflore,Superintendent of Public Instruction,Brian Kelly,REP,400105,0,0,11,11,
Leflore,Superintendent of Public Instruction,Janet Costello Barresi,REP,400105,0,0,6,6,
Leflore,Superintendent of Public Instruction,Joy Hofmeister,REP,400105,0,0,18,18,
Leflore,Insurance Commissioner,Bill Viner,REP,400105,0,0,17,17,
Leflore,Insurance Commissioner,John Doak,REP,400105,0,0,17,17,
Leflore,Corporation Commissioner,Todd Hiett,REP,400105,0,0,8,8,
Leflore,Corporation Commissioner,Cliff Branan,REP,400105,0,0,25,25,
Leflore,U.S. Senate,Evelyn Rogers,REP,400105,0,0,1,1,
Leflore,U.S. Senate,Rob Moye,REP,400105,0,0,2,2,
Leflore,U.S. Senate,D. Jean Mcbride-Samuels,REP,400105,0,0,2,2,
Leflore,U.S. Senate,Jim Inhofe,REP,400105,0,0,29,29,
Leflore,U.S. Senate,Erick Paul Wyatt,REP,400105,0,0,2,2,
Leflore,U.S. Senate,Andy Craig,REP,400105,0,0,1,1,
Leflore,U.S. Senate,T. Shannon,REP,400105,0,0,19,19,
Leflore,U.S. Senate,Randy Brogdon,REP,400105,0,0,0,0,
Leflore,U.S. Senate,Eric Mccray,REP,400105,0,0,2,2,
Leflore,U.S. Senate,Kevin Crow,REP,400105,0,0,1,1,
Leflore,U.S. Senate,James Lankford,REP,400105,0,0,13,13,
Leflore,U.S. Senate,Jason Weger,REP,400105,0,0,0,0,
Leflore,U.S. House,Darrel Robertson,REP,400105,0,0,11,11,02
Leflore,U.S. House,Markwayne Mullin,REP,400105,0,0,23,23,02
Leflore,Superintendent of Public Instruction,John Cox,DEM,400106,0,1,26,27,
Leflore,Superintendent of Public Instruction,Jack Jr.,DEM,400106,0,0,23,23,
Leflore,Superintendent of Public Instruction,Ivan Holmes,DEM,400106,0,0,4,4,
Leflore,Superintendent of Public Instruction,Freda Deskin,DEM,400106,0,0,11,11,
Leflore,U.S. Senate,Patrick Michael Hayes,DEM,400106,0,0,12,12,
Leflore,U.S. Senate,Jim Rogers,DEM,400106,0,0,39,39,
Leflore,U.S. Senate,Connie Johnson,DEM,400106,0,1,12,13,
Leflore,U.S. House,Earl Everett,DEM,400106,0,0,34,34,02
Leflore,U.S. House,Joshua Harris-Till,DEM,400106,0,1,27,28,02
Leflore,Governor,Dax Ewbank,REP,400106,0,0,3,3,
Leflore,Governor,Chad Moody,REP,400106,0,2,5,7,
Leflore,Governor,Mary Fallin,REP,400106,0,0,35,35,
Leflore,Superintendent of Public Instruction,Brian Kelly,REP,400106,0,0,13,13,
Leflore,Superintendent of Public Instruction,Janet Costello Barresi,REP,400106,0,0,9,9,
Leflore,Superintendent of Public Instruction,Joy Hofmeister,REP,400106,0,2,18,20,
Leflore,Insurance Commissioner,Bill Viner,REP,400106,0,2,13,15,
Leflore,Insurance Commissioner,John Doak,REP,400106,0,0,27,27,
Leflore,Corporation Commissioner,Todd Hiett,REP,400106,0,0,15,15,
Leflore,Corporation Commissioner,Cliff Branan,REP,400106,0,2,22,24,
Leflore,U.S. Senate,Evelyn Rogers,REP,400106,0,0,4,4,
Leflore,U.S. Senate,Rob Moye,REP,400106,0,0,2,2,
Leflore,U.S. Senate,D. Jean Mcbride-Samuels,REP,400106,0,0,1,1,
Leflore,U.S. Senate,Jim Inhofe,REP,400106,0,2,34,36,
Leflore,U.S. Senate,Erick Paul Wyatt,REP,400106,0,0,1,1,
Leflore,U.S. Senate,Andy Craig,REP,400106,0,0,4,4,
Leflore,U.S. Senate,T. Shannon,REP,400106,0,1,13,14,
Leflore,U.S. Senate,Randy Brogdon,REP,400106,0,1,6,7,
Leflore,U.S. Senate,Eric Mccray,REP,400106,0,0,2,2,
Leflore,U.S. Senate,Kevin Crow,REP,400106,0,0,2,2,
Leflore,U.S. Senate,James Lankford,REP,400106,0,0,16,16,
Leflore,U.S. Senate,Jason Weger,REP,400106,0,0,0,0,
Leflore,U.S. House,Darrel Robertson,REP,400106,0,2,11,13,02
Leflore,U.S. House,Markwayne Mullin,REP,400106,0,0,30,30,02
Leflore,Superintendent of Public Instruction,John Cox,DEM,400107,2,5,43,50,
Leflore,Superintendent of Public Instruction,Jack Jr.,DEM,400107,0,2,15,17,
Leflore,Superintendent of Public Instruction,Ivan Holmes,DEM,400107,1,0,18,19,
Leflore,Superintendent of Public Instruction,Freda Deskin,DEM,400107,0,0,20,20,
Leflore,U.S. Senate,Patrick Michael Hayes,DEM,400107,1,1,20,22,
Leflore,U.S. Senate,Jim Rogers,DEM,400107,2,5,42,49,
Leflore,U.S. Senate,Connie Johnson,DEM,400107,0,1,29,30,
Leflore,U.S. House,Earl Everett,DEM,400107,1,2,59,62,02
Leflore,U.S. House,Joshua Harris-Till,DEM,400107,2,5,27,34,02
Leflore,Governor,Dax Ewbank,REP,400107,0,0,4,4,
Leflore,Governor,Chad Moody,REP,400107,0,0,3,3,
Leflore,Governor,Mary Fallin,REP,400107,1,0,47,48,
Leflore,Superintendent of Public Instruction,Brian Kelly,REP,400107,0,0,14,14,
Leflore,Superintendent of Public Instruction,Janet Costello Barresi,REP,400107,0,0,10,10,
Leflore,Superintendent of Public Instruction,Joy Hofmeister,REP,400107,0,0,29,29,
Leflore,Insurance Commissioner,Bill Viner,REP,400107,0,0,19,19,
Leflore,Insurance Commissioner,John Doak,REP,400107,1,0,29,30,
Leflore,Corporation Commissioner,Todd Hiett,REP,400107,1,0,25,26,
Leflore,Corporation Commissioner,Cliff Branan,REP,400107,0,0,23,23,
Leflore,U.S. Senate,Evelyn Rogers,REP,400107,0,0,3,3,
Leflore,U.S. Senate,Rob Moye,REP,400107,0,0,2,2,
Leflore,U.S. Senate,D. Jean Mcbride-Samuels,REP,400107,0,0,1,1,
Leflore,U.S. Senate,Jim Inhofe,REP,400107,1,0,43,44,
Leflore,U.S. Senate,Erick Paul Wyatt,REP,400107,0,0,5,5,
Leflore,U.S. Senate,Andy Craig,REP,400107,1,0,1,2,
Leflore,U.S. Senate,T. Shannon,REP,400107,0,0,26,26,
Leflore,U.S. Senate,Randy Brogdon,REP,400107,0,0,3,3,
Leflore,U.S. Senate,Eric Mccray,REP,400107,0,0,1,1,
Leflore,U.S. Senate,Kevin Crow,REP,400107,0,0,2,2,
Leflore,U.S. Senate,James Lankford,REP,400107,0,0,18,18,
Leflore,U.S. Senate,Jason Weger,REP,400107,0,0,2,2,
Leflore,U.S. House,Darrel Robertson,REP,400107,1,0,19,20,02
Leflore,U.S. House,Markwayne Mullin,REP,400107,0,0,32,32,02
Leflore,Superintendent of Public Instruction,John Cox,DEM,400108,0,2,30,32,
Leflore,Superintendent of Public Instruction,Jack Jr.,DEM,400108,0,0,10,10,
Leflore,Superintendent of Public Instruction,Ivan Holmes,DEM,400108,0,0,5,5,
Leflore,Superintendent of Public Instruction,Freda Deskin,DEM,400108,0,0,15,15,
Leflore,U.S. Senate,Patrick Michael Hayes,DEM,400108,0,2,17,19,
Leflore,U.S. Senate,Jim Rogers,DEM,400108,0,0,27,27,
Leflore,U.S. Senate,Connie Johnson,DEM,400108,0,0,13,13,
Leflore,U.S. House,Earl Everett,DEM,400108,0,0,39,39,02
Leflore,U.S. House,Joshua Harris-Till,DEM,400108,0,2,17,19,02
Leflore,Governor,Dax Ewbank,REP,400108,0,0,1,1,
Leflore,Governor,Chad Moody,REP,400108,0,0,1,1,
Leflore,Governor,Mary Fallin,REP,400108,0,0,30,30,
Leflore,Superintendent of Public Instruction,Brian Kelly,REP,400108,0,0,2,2,
Leflore,Superintendent of Public Instruction,Janet Costello Barresi,REP,400108,0,0,7,7,
Leflore,Superintendent of Public Instruction,Joy Hofmeister,REP,400108,0,0,21,21,
Leflore,Insurance Commissioner,Bill Viner,REP,400108,0,0,10,10,
Leflore,Insurance Commissioner,John Doak,REP,400108,0,0,19,19,
Leflore,Corporation Commissioner,Todd Hiett,REP,400108,0,0,20,20,
Leflore,Corporation Commissioner,Cliff Branan,REP,400108,0,0,6,6,
Leflore,U.S. Senate,Evelyn Rogers,REP,400108,0,0,1,1,
Leflore,U.S. Senate,Rob Moye,REP,400108,0,0,1,1,
Leflore,U.S. Senate,D. Jean Mcbride-Samuels,REP,400108,0,0,1,1,
Leflore,U.S. Senate,Jim Inhofe,REP,400108,0,0,27,27,
Leflore,U.S. Senate,Erick Paul Wyatt,REP,400108,0,0,2,2,
Leflore,U.S. Senate,Andy Craig,REP,400108,0,0,0,0,
Leflore,U.S. Senate,T. Shannon,REP,400108,0,0,23,23,
Leflore,U.S. Senate,Randy Brogdon,REP,400108,0,0,1,1,
Leflore,U.S. Senate,Eric Mccray,REP,400108,0,0,0,0,
Leflore,U.S. Senate,Kevin Crow,REP,400108,0,0,0,0,
Leflore,U.S. Senate,James Lankford,REP,400108,0,0,8,8,
Leflore,U.S. Senate,Jason Weger,REP,400108,0,0,0,0,
Leflore,U.S. House,Darrel Robertson,REP,400108,0,0,12,12,02
Leflore,U.S. House,Markwayne Mullin,REP,400108,0,0,19,19,02
Leflore,Superintendent of Public Instruction,John Cox,DEM,400109,1,8,57,66,
Leflore,Superintendent of Public Instruction,Jack Jr.,DEM,400109,0,0,26,26,
Leflore,Superintendent of Public Instruction,Ivan Holmes,DEM,400109,0,0,8,8,
Leflore,Superintendent of Public Instruction,Freda Deskin,DEM,400109,0,0,14,14,
Leflore,U.S. Senate,Patrick Michael Hayes,DEM,400109,0,3,20,23,
Leflore,U.S. Senate,Jim Rogers,DEM,400109,1,5,58,64,
Leflore,U.S. Senate,Connie Johnson,DEM,400109,0,0,26,26,
Leflore,U.S. House,Earl Everett,DEM,400109,0,4,75,79,02
Leflore,U.S. House,Joshua Harris-Till,DEM,400109,1,4,25,30,02
Leflore,Governor,Dax Ewbank,REP,400109,0,0,4,4,
Leflore,Governor,Chad Moody,REP,400109,0,1,9,10,
Leflore,Governor,Mary Fallin,REP,400109,1,3,35,39,
Leflore,Superintendent of Public Instruction,Brian Kelly,REP,400109,0,1,27,28,
Leflore,Superintendent of Public Instruction,Janet Costello Barresi,REP,400109,1,3,8,12,
Leflore,Superintendent of Public Instruction,Joy Hofmeister,REP,400109,0,0,12,12,
Leflore,Insurance Commissioner,Bill Viner,REP,400109,0,0,17,17,
Leflore,Insurance Commissioner,John Doak,REP,400109,1,4,28,33,
Leflore,Corporation Commissioner,Todd Hiett,REP,400109,1,3,24,28,
Leflore,Corporation Commissioner,Cliff Branan,REP,400109,0,1,19,20,
Leflore,U.S. Senate,Evelyn Rogers,REP,400109,0,0,0,0,
Leflore,U.S. Senate,Rob Moye,REP,400109,0,0,1,1,
Leflore,U.S. Senate,D. Jean Mcbride-Samuels,REP,400109,0,0,2,2,
Leflore,U.S. Senate,Jim Inhofe,REP,400109,0,3,43,46,
Leflore,U.S. Senate,Erick Paul Wyatt,REP,400109,1,1,2,4,
Leflore,U.S. Senate,Andy Craig,REP,400109,0,0,2,2,
Leflore,U.S. Senate,T. Shannon,REP,400109,1,3,23,27,
Leflore,U.S. Senate,Randy Brogdon,REP,400109,0,0,5,5,
Leflore,U.S. Senate,Eric Mccray,REP,400109,0,0,0,0,
Leflore,U.S. Senate,Kevin Crow,REP,400109,0,0,4,4,
Leflore,U.S. Senate,James Lankford,REP,400109,0,1,14,15,
Leflore,U.S. Senate,Jason Weger,REP,400109,0,0,0,0,
Leflore,U.S. House,Darrel Robertson,REP,400109,0,1,11,12,02
Leflore,U.S. House,Markwayne Mullin,REP,400109,1,3,34,38,02
Leflore,Superintendent of Public Instruction,John Cox,DEM,400110,0,2,53,55,
Leflore,Superintendent of Public Instruction,Jack Jr.,DEM,400110,0,0,18,18,
Leflore,Superintendent of Public Instruction,Ivan Holmes,DEM,400110,0,0,6,6,
Leflore,Superintendent of Public Instruction,Freda Deskin,DEM,400110,1,0,21,22,
Leflore,U.S. Senate,Patrick Michael Hayes,DEM,400110,1,1,18,20,
Leflore,U.S. Senate,Jim Rogers,DEM,400110,0,0,44,44,
Leflore,U.S. Senate,Connie Johnson,DEM,400110,0,1,33,34,
Leflore,U.S. House,Earl Everett,DEM,400110,1,1,57,59,02
Leflore,U.S. House,Joshua Harris-Till,DEM,400110,0,1,36,37,02
Leflore,Governor,Dax Ewbank,REP,400110,0,0,3,3,
Leflore,Governor,Chad Moody,REP,400110,0,0,0,0,
Leflore,Governor,Mary Fallin,REP,400110,0,0,12,12,
Leflore,Superintendent of Public Instruction,Brian Kelly,REP,400110,0,0,6,6,
Leflore,Superintendent of Public Instruction,Janet Costello Barresi,REP,400110,0,0,0,0,
Leflore,Superintendent of Public Instruction,Joy Hofmeister,REP,400110,0,0,9,9,
Leflore,Insurance Commissioner,Bill Viner,REP,400110,0,0,6,6,
Leflore,Insurance Commissioner,John Doak,REP,400110,0,0,9,9,
Leflore,Corporation Commissioner,Todd Hiett,REP,400110,0,0,5,5,
Leflore,Corporation Commissioner,Cliff Branan,REP,400110,0,0,10,10,
Leflore,U.S. Senate,Evelyn Rogers,REP,400110,0,0,1,1,
Leflore,U.S. Senate,Rob Moye,REP,400110,0,0,0,0,
Leflore,U.S. Senate,D. Jean Mcbride-Samuels,REP,400110,0,0,0,0,
Leflore,U.S. Senate,Jim Inhofe,REP,400110,0,0,14,14,
Leflore,U.S. Senate,Erick Paul Wyatt,REP,400110,0,0,0,0,
Leflore,U.S. Senate,Andy Craig,REP,400110,0,0,0,0,
Leflore,U.S. Senate,T. Shannon,REP,400110,0,0,2,2,
Leflore,U.S. Senate,Randy Brogdon,REP,400110,0,0,4,4,
Leflore,U.S. Senate,Eric Mccray,REP,400110,0,0,0,0,
Leflore,U.S. Senate,Kevin Crow,REP,400110,0,0,0,0,
Leflore,U.S. Senate,James Lankford,REP,400110,0,0,8,8,
Leflore,U.S. Senate,Jason Weger,REP,400110,0,0,0,0,
Leflore,U.S. House,Darrel Robertson,REP,400110,0,0,3,3,02
Leflore,U.S. House,Markwayne Mullin,REP,400110,0,0,12,12,02
Leflore,Superintendent of Public Instruction,John Cox,DEM,400111,0,2,46,48,
Leflore,Superintendent of Public Instruction,Jack Jr.,DEM,400111,0,0,15,15,
Leflore,Superintendent of Public Instruction,Ivan Holmes,DEM,400111,0,1,7,8,
Leflore,Superintendent of Public Instruction,Freda Deskin,DEM,400111,0,0,31,31,
Leflore,U.S. Senate,Patrick Michael Hayes,DEM,400111,0,0,17,17,
Leflore,U.S. Senate,Jim Rogers,DEM,400111,0,2,45,47,
Leflore,U.S. Senate,Connie Johnson,DEM,400111,0,0,34,34,
Leflore,U.S. House,Earl Everett,DEM,400111,0,2,55,57,02
Leflore,U.S. House,Joshua Harris-Till,DEM,400111,0,2,37,39,02
Leflore,Governor,Dax Ewbank,REP,400111,0,0,1,1,
Leflore,Governor,Chad Moody,REP,400111,0,2,8,10,
Leflore,Governor,Mary Fallin,REP,400111,0,0,34,34,
Leflore,Superintendent of Public Instruction,Brian Kelly,REP,400111,0,2,10,12,
Leflore,Superintendent of Public Instruction,Janet Costello Barresi,REP,400111,0,0,8,8,
Leflore,Superintendent of Public Instruction,Joy Hofmeister,REP,400111,0,0,21,21,
Leflore,Insurance Commissioner,Bill Viner,REP,400111,0,1,12,13,
Leflore,Insurance Commissioner,John Doak,REP,400111,0,1,25,26,
Leflore,Corporation Commissioner,Todd Hiett,REP,400111,0,0,20,20,
Leflore,Corporation Commissioner,Cliff Branan,REP,400111,0,2,17,19,
Leflore,U.S. Senate,Evelyn Rogers,REP,400111,0,0,1,1,
Leflore,U.S. Senate,Rob Moye,REP,400111,0,0,3,3,
Leflore,U.S. Senate,D. Jean Mcbride-Samuels,REP,400111,0,0,0,0,
Leflore,U.S. Senate,Jim Inhofe,REP,400111,0,2,35,37,
Leflore,U.S. Senate,Erick Paul Wyatt,REP,400111,0,0,2,2,
Leflore,U.S. Senate,Andy Craig,REP,400111,0,0,1,1,
Leflore,U.S. Senate,T. Shannon,REP,400111,0,0,20,20,
Leflore,U.S. Senate,Randy Brogdon,REP,400111,0,0,2,2,
Leflore,U.S. Senate,Eric Mccray,REP,400111,0,0,1,1,
Leflore,U.S. Senate,Kevin Crow,REP,400111,0,0,2,2,
Leflore,U.S. Senate,James Lankford,REP,400111,0,2,16,18,
Leflore,U.S. Senate,Jason Weger,REP,400111,0,0,0,0,
Leflore,U.S. House,Darrel Robertson,REP,400111,0,0,11,11,02
Leflore,U.S. House,Markwayne Mullin,REP,400111,0,2,30,32,02
Leflore,Superintendent of Public Instruction,John Cox,DEM,400112,0,0,8,8,
Leflore,Superintendent of Public Instruction,Jack Jr.,DEM,400112,0,1,6,7,
Leflore,Superintendent of Public Instruction,Ivan Holmes,DEM,400112,0,0,5,5,
Leflore,Superintendent of Public Instruction,Freda Deskin,DEM,400112,0,1,8,9,
Leflore,U.S. Senate,Patrick Michael Hayes,DEM,400112,0,1,7,8,
Leflore,U.S. Senate,Jim Rogers,DEM,400112,0,0,11,11,
Leflore,U.S. Senate,Connie Johnson,DEM,400112,0,0,8,8,
Leflore,U.S. House,Earl Everett,DEM,400112,0,1,17,18,02
Leflore,U.S. House,Joshua Harris-Till,DEM,400112,0,1,9,10,02
Leflore,Governor,Dax Ewbank,REP,400112,0,0,0,0,
Leflore,Governor,Chad Moody,REP,400112,0,0,3,3,
Leflore,Governor,Mary Fallin,REP,400112,0,1,7,8,
Leflore,Superintendent of Public Instruction,Brian Kelly,REP,400112,0,1,4,5,
Leflore,Superintendent of Public Instruction,Janet Costello Barresi,REP,400112,0,0,2,2,
Leflore,Superintendent of Public Instruction,Joy Hofmeister,REP,400112,0,0,4,4,
Leflore,Insurance Commissioner,Bill Viner,REP,400112,0,1,7,8,
Leflore,Insurance Commissioner,John Doak,REP,400112,0,0,2,2,
Leflore,Corporation Commissioner,Todd Hiett,REP,400112,0,0,5,5,
Leflore,Corporation Commissioner,Cliff Branan,REP,400112,0,1,4,5,
Leflore,U.S. Senate,Evelyn Rogers,REP,400112,0,0,0,0,
Leflore,U.S. Senate,Rob Moye,REP,400112,0,0,1,1,
Leflore,U.S. Senate,D. Jean Mcbride-Samuels,REP,400112,0,0,1,1,
Leflore,U.S. Senate,Jim Inhofe,REP,400112,0,1,8,9,
Leflore,U.S. Senate,Erick Paul Wyatt,REP,400112,0,0,0,0,
Leflore,U.S. Senate,Andy Craig,REP,400112,0,0,0,0,
Leflore,U.S. Senate,T. Shannon,REP,400112,0,1,4,5,
Leflore,U.S. Senate,Randy Brogdon,REP,400112,0,0,0,0,
Leflore,U.S. Senate,Eric Mccray,REP,400112,0,0,0,0,
Leflore,U.S. Senate,Kevin Crow,REP,400112,0,0,0,0,
Leflore,U.S. Senate,James Lankford,REP,400112,0,0,5,5,
Leflore,U.S. Senate,Jason Weger,REP,400112,0,0,0,0,
Leflore,U.S. House,Darrel Robertson,REP,400112,0,0,1,1,02
Leflore,U.S. House,Markwayne Mullin,REP,400112,0,1,9,10,02
Leflore,Superintendent of Public Instruction,John Cox,DEM,400113,0,3,37,40,
Leflore,Superintendent of Public Instruction,Jack Jr.,DEM,400113,0,0,4,4,
Leflore,Superintendent of Public Instruction,Ivan Holmes,DEM,400113,3,0,3,6,
Leflore,Superintendent of Public Instruction,Freda Deskin,DEM,400113,0,0,4,4,
Leflore,U.S. Senate,Patrick Michael Hayes,DEM,400113,0,0,14,14,
Leflore,U.S. Senate,Jim Rogers,DEM,400113,3,1,23,27,
Leflore,U.S. Senate,Connie Johnson,DEM,400113,0,1,11,12,
Leflore,U.S. House,Earl Everett,DEM,400113,1,2,30,33,02
Leflore,U.S. House,Joshua Harris-Till,DEM,400113,2,0,17,19,02
Leflore,Governor,Dax Ewbank,REP,400113,0,0,1,1,
Leflore,Governor,Chad Moody,REP,400113,0,0,2,2,
Leflore,Governor,Mary Fallin,REP,400113,0,0,11,11,
Leflore,Superintendent of Public Instruction,Brian Kelly,REP,400113,0,0,3,3,
Leflore,Superintendent of Public Instruction,Janet Costello Barresi,REP,400113,0,0,4,4,
Leflore,Superintendent of Public Instruction,Joy Hofmeister,REP,400113,0,0,7,7,
Leflore,Insurance Commissioner,Bill Viner,REP,400113,0,0,4,4,
Leflore,Insurance Commissioner,John Doak,REP,400113,0,0,10,10,
Leflore,Corporation Commissioner,Todd Hiett,REP,400113,0,0,6,6,
Leflore,Corporation Commissioner,Cliff Branan,REP,400113,0,0,8,8,
Leflore,U.S. Senate,Evelyn Rogers,REP,400113,0,0,2,2,
Leflore,U.S. Senate,Rob Moye,REP,400113,0,0,2,2,
Leflore,U.S. Senate,D. Jean Mcbride-Samuels,REP,400113,0,0,0,0,
Leflore,U.S. Senate,Jim Inhofe,REP,400113,0,0,10,10,
Leflore,U.S. Senate,Erick Paul Wyatt,REP,400113,0,0,0,0,
Leflore,U.S. Senate,Andy Craig,REP,400113,0,0,0,0,
Leflore,U.S. Senate,T. Shannon,REP,400113,0,0,6,6,
Leflore,U.S. Senate,Randy Brogdon,REP,400113,0,0,1,1,
Leflore,U.S. Senate,Eric Mccray,REP,400113,0,0,0,0,
Leflore,U.S. Senate,Kevin Crow,REP,400113,0,0,0,0,
Leflore,U.S. Senate,James Lankford,REP,400113,0,0,7,7,
Leflore,U.S. Senate,Jason Weger,REP,400113,0,0,0,0,
Leflore,U.S. House,Darrel Robertson,REP,400113,0,0,1,1,02
Leflore,U.S. House,Markwayne Mullin,REP,400113,0,0,13,13,02
Leflore,Superintendent of Public Instruction,John Cox,DEM,400114,0,2,15,17,
Leflore,Superintendent of Public Instruction,Jack Jr.,DEM,400114,0,0,7,7,
Leflore,Superintendent of Public Instruction,Ivan Holmes,DEM,400114,0,0,0,0,
Leflore,Superintendent of Public Instruction,Freda Deskin,DEM,400114,0,0,7,7,
Leflore,U.S. Senate,Patrick Michael Hayes,DEM,400114,0,0,9,9,
Leflore,U.S. Senate,Jim Rogers,DEM,400114,0,1,10,11,
Leflore,U.S. Senate,Connie Johnson,DEM,400114,0,1,6,7,
Leflore,U.S. House,Earl Everett,DEM,400114,0,1,14,15,02
Leflore,U.S. House,Joshua Harris-Till,DEM,400114,0,1,10,11,02
Leflore,Governor,Dax Ewbank,REP,400114,0,0,1,1,
Leflore,Governor,Chad Moody,REP,400114,0,0,0,0,
Leflore,Governor,Mary Fallin,REP,400114,0,0,4,4,
Leflore,Superintendent of Public Instruction,Brian Kelly,REP,400114,0,0,2,2,
Leflore,Superintendent of Public Instruction,Janet Costello Barresi,REP,400114,0,0,0,0,
Leflore,Superintendent of Public Instruction,Joy Hofmeister,REP,400114,0,0,3,3,
Leflore,Insurance Commissioner,Bill Viner,REP,400114,0,0,0,0,
Leflore,Insurance Commissioner,John Doak,REP,400114,0,0,5,5,
Leflore,Corporation Commissioner,Todd Hiett,REP,400114,0,0,1,1,
Leflore,Corporation Commissioner,Cliff Branan,REP,400114,0,0,3,3,
Leflore,U.S. Senate,Evelyn Rogers,REP,400114,0,0,1,1,
Leflore,U.S. Senate,Rob Moye,REP,400114,0,0,0,0,
Leflore,U.S. Senate,D. Jean Mcbride-Samuels,REP,400114,0,0,0,0,
Leflore,U.S. Senate,Jim Inhofe,REP,400114,0,0,4,4,
Leflore,U.S. Senate,Erick Paul Wyatt,REP,400114,0,0,0,0,
Leflore,U.S. Senate,Andy Craig,REP,400114,0,0,1,1,
Leflore,U.S. Senate,T. Shannon,REP,400114,0,0,1,1,
Leflore,U.S. Senate,Randy Brogdon,REP,400114,0,0,0,0,
Leflore,U.S. Senate,Eric Mccray,REP,400114,0,0,0,0,
Leflore,U.S. Senate,Kevin Crow,REP,400114,0,0,0,0,
Leflore,U.S. Senate,James Lankford,REP,400114,0,0,2,2,
Leflore,U.S. Senate,Jason Weger,REP,400114,0,0,1,1,
Leflore,U.S. House,Darrel Robertson,REP,400114,0,0,1,1,02
Leflore,U.S. House,Markwayne Mullin,REP,400114,0,0,3,3,02
Leflore,Superintendent of Public Instruction,John Cox,DEM,400201,0,0,10,10,
Leflore,Superintendent of Public Instruction,Jack Jr.,DEM,400201,0,0,4,4,
Leflore,Superintendent of Public Instruction,Ivan Holmes,DEM,400201,0,0,0,0,
Leflore,Superintendent of Public Instruction,Freda Deskin,DEM,400201,0,0,3,3,
Leflore,U.S. Senate,Patrick Michael Hayes,DEM,400201,0,0,5,5,
Leflore,U.S. Senate,Jim Rogers,DEM,400201,0,0,11,11,
Leflore,U.S. Senate,Connie Johnson,DEM,400201,0,0,1,1,
Leflore,U.S. House,Earl Everett,DEM,400201,0,0,13,13,02
Leflore,U.S. House,Joshua Harris-Till,DEM,400201,0,0,4,4,02
Leflore,Governor,Dax Ewbank,REP,400201,0,0,3,3,
Leflore,Governor,Chad Moody,REP,400201,0,2,2,4,
Leflore,Governor,Mary Fallin,REP,400201,0,0,6,6,
Leflore,Superintendent of Public Instruction,Brian Kelly,REP,400201,0,0,7,7,
Leflore,Superintendent of Public Instruction,Janet Costello Barresi,REP,400201,0,0,2,2,
Leflore,Superintendent of Public Instruction,Joy Hofmeister,REP,400201,0,2,2,4,
Leflore,Insurance Commissioner,Bill Viner,REP,400201,0,2,5,7,
Leflore,Insurance Commissioner,John Doak,REP,400201,0,0,6,6,
Leflore,Corporation Commissioner,Todd Hiett,REP,400201,0,2,6,8,
Leflore,Corporation Commissioner,Cliff Branan,REP,400201,0,0,5,5,
Leflore,U.S. Senate,Evelyn Rogers,REP,400201,0,0,2,2,
Leflore,U.S. Senate,Rob Moye,REP,400201,0,0,0,0,
Leflore,U.S. Senate,D. Jean Mcbride-Samuels,REP,400201,0,0,1,1,
Leflore,U.S. Senate,Jim Inhofe,REP,400201,0,2,7,9,
Leflore,U.S. Senate,Erick Paul Wyatt,REP,400201,0,0,1,1,
Leflore,U.S. Senate,Andy Craig,REP,400201,0,0,1,1,
Leflore,U.S. Senate,T. Shannon,REP,400201,0,2,4,6,
Leflore,U.S. Senate,Randy Brogdon,REP,400201,0,0,2,2,
Leflore,U.S. Senate,Eric Mccray,REP,400201,0,0,1,1,
Leflore,U.S. Senate,Kevin Crow,REP,400201,0,0,1,1,
Leflore,U.S. Senate,James Lankford,REP,400201,0,0,2,2,
Leflore,U.S. Senate,Jason Weger,REP,400201,0,0,0,0,
Leflore,U.S. House,Darrel Robertson,REP,400201,0,0,4,4,02
Leflore,U.S. House,Markwayne Mullin,REP,400201,0,2,7,9,02
Leflore,Superintendent of Public Instruction,John Cox,DEM,400202,0,1,34,35,
Leflore,Superintendent of Public Instruction,Jack Jr.,DEM,400202,0,0,8,8,
Leflore,Superintendent of Public Instruction,Ivan Holmes,DEM,400202,0,0,4,4,
Leflore,Superintendent of Public Instruction,Freda Deskin,DEM,400202,1,0,3,4,
Leflore,U.S. Senate,Patrick Michael Hayes,DEM,400202,0,1,8,9,
Leflore,U.S. Senate,Jim Rogers,DEM,400202,0,1,26,27,
Leflore,U.S. Senate,Connie Johnson,DEM,400202,1,0,10,11,
Leflore,U.S. House,Earl Everett,DEM,400202,0,0,31,31,02
Leflore,U.S. House,Joshua Harris-Till,DEM,400202,1,1,12,14,02
Leflore,Governor,Dax Ewbank,REP,400202,0,0,0,0,
Leflore,Governor,Chad Moody,REP,400202,0,0,1,1,
Leflore,Governor,Mary Fallin,REP,400202,0,0,5,5,
Leflore,Superintendent of Public Instruction,Brian Kelly,REP,400202,0,0,4,4,
Leflore,Superintendent of Public Instruction,Janet Costello Barresi,REP,400202,0,0,0,0,
Leflore,Superintendent of Public Instruction,Joy Hofmeister,REP,400202,0,0,1,1,
Leflore,Insurance Commissioner,Bill Viner,REP,400202,0,0,3,3,
Leflore,Insurance Commissioner,John Doak,REP,400202,0,0,2,2,
Leflore,Corporation Commissioner,Todd Hiett,REP,400202,0,0,2,2,
Leflore,Corporation Commissioner,Cliff Branan,REP,400202,0,0,3,3,
Leflore,U.S. Senate,Evelyn Rogers,REP,400202,0,0,1,1,
Leflore,U.S. Senate,Rob Moye,REP,400202,0,0,0,0,
Leflore,U.S. Senate,D. Jean Mcbride-Samuels,REP,400202,0,0,0,0,
Leflore,U.S. Senate,Jim Inhofe,REP,400202,0,0,5,5,
Leflore,U.S. Senate,Erick Paul Wyatt,REP,400202,0,0,0,0,
Leflore,U.S. Senate,Andy Craig,REP,400202,0,0,0,0,
Leflore,U.S. Senate,T. Shannon,REP,400202,0,0,2,2,
Leflore,U.S. Senate,Randy Brogdon,REP,400202,0,0,1,1,
Leflore,U.S. Senate,Eric Mccray,REP,400202,0,0,0,0,
Leflore,U.S. Senate,Kevin Crow,REP,400202,0,0,1,1,
Leflore,U.S. Senate,James Lankford,REP,400202,0,0,2,2,
Leflore,U.S. Senate,Jason Weger,REP,400202,0,0,0,0,
Leflore,U.S. House,Darrel Robertson,REP,400202,0,0,2,2,02
Leflore,U.S. House,Markwayne Mullin,REP,400202,0,0,4,4,02
Leflore,State Senate,Joseph Silk,REP,400202,0,0,5,5,5
Leflore,State Senate,Brent Shain,REP,400202,0,0,1,1,5
Leflore,Superintendent of Public Instruction,John Cox,DEM,400203,0,21,152,173,
Leflore,Superintendent of Public Instruction,Jack Jr.,DEM,400203,0,4,30,34,
Leflore,Superintendent of Public Instruction,Ivan Holmes,DEM,400203,0,3,18,21,
Leflore,Superintendent of Public Instruction,Freda Deskin,DEM,400203,0,3,52,55,
Leflore,U.S. Senate,Patrick Michael Hayes,DEM,400203,0,10,56,66,
Leflore,U.S. Senate,Jim Rogers,DEM,400203,0,9,120,129,
Leflore,U.S. Senate,Connie Johnson,DEM,400203,0,10,68,78,
Leflore,U.S. House,Earl Everett,DEM,400203,0,18,141,159,02
Leflore,U.S. House,Joshua Harris-Till,DEM,400203,0,13,96,109,02
Leflore,Governor,Dax Ewbank,REP,400203,0,2,9,11,
Leflore,Governor,Chad Moody,REP,400203,0,0,16,16,
Leflore,Governor,Mary Fallin,REP,400203,0,10,62,72,
Leflore,Superintendent of Public Instruction,Brian Kelly,REP,400203,0,3,27,30,
Leflore,Superintendent of Public Instruction,Janet Costello Barresi,REP,400203,0,5,22,27,
Leflore,Superintendent of Public Instruction,Joy Hofmeister,REP,400203,0,5,30,35,
Leflore,Insurance Commissioner,Bill Viner,REP,400203,0,3,25,28,
Leflore,Insurance Commissioner,John Doak,REP,400203,0,9,50,59,
Leflore,Corporation Commissioner,Todd Hiett,REP,400203,0,9,53,62,
Leflore,Corporation Commissioner,Cliff Branan,REP,400203,0,3,25,28,
Leflore,U.S. Senate,Evelyn Rogers,REP,400203,0,0,6,6,
Leflore,U.S. Senate,Rob Moye,REP,400203,0,0,2,2,
Leflore,U.S. Senate,D. Jean Mcbride-Samuels,REP,400203,0,0,1,1,
Leflore,U.S. Senate,Jim Inhofe,REP,400203,0,12,73,85,
Leflore,U.S. Senate,Erick Paul Wyatt,REP,400203,0,0,3,3,
Leflore,U.S. Senate,Andy Craig,REP,400203,0,0,5,5,
Leflore,U.S. Senate,T. Shannon,REP,400203,0,5,23,28,
Leflore,U.S. Senate,Randy Brogdon,REP,400203,0,2,6,8,
Leflore,U.S. Senate,Eric Mccray,REP,400203,0,0,2,2,
Leflore,U.S. Senate,Kevin Crow,REP,400203,0,1,0,1,
Leflore,U.S. Senate,James Lankford,REP,400203,0,4,51,55,
Leflore,U.S. Senate,Jason Weger,REP,400203,0,0,0,0,
Leflore,U.S. House,Darrel Robertson,REP,400203,0,2,23,25,02
Leflore,U.S. House,Markwayne Mullin,REP,400203,0,10,60,70,02
Leflore,Superintendent of Public Instruction,John Cox,DEM,400204,0,9,68,77,
Leflore,Superintendent of Public Instruction,Jack Jr.,DEM,400204,0,4,21,25,
Leflore,Superintendent of Public Instruction,Ivan Holmes,DEM,400204,0,1,11,12,
Leflore,Superintendent of Public Instruction,Freda Deskin,DEM,400204,0,5,36,41,
Leflore,U.S. Senate,Patrick Michael Hayes,DEM,400204,0,6,24,30,
Leflore,U.S. Senate,Jim Rogers,DEM,400204,0,8,61,69,
Leflore,U.S. Senate,Connie Johnson,DEM,400204,0,4,45,49,
Leflore,U.S. House,Earl Everett,DEM,400204,0,9,63,72,02
Leflore,U.S. House,Joshua Harris-Till,DEM,400204,0,9,65,74,02
Leflore,Governor,Dax Ewbank,REP,400204,0,0,10,10,
Leflore,Governor,Chad Moody,REP,400204,0,2,4,6,
Leflore,Governor,Mary Fallin,REP,400204,0,2,32,34,
Leflore,Superintendent of Public Instruction,Brian Kelly,REP,400204,0,1,9,10,
Leflore,Superintendent of Public Instruction,Janet Costello Barresi,REP,400204,0,1,10,11,
Leflore,Superintendent of Public Instruction,Joy Hofmeister,REP,400204,0,2,29,31,
Leflore,Insurance Commissioner,Bill Viner,REP,400204,0,1,11,12,
Leflore,Insurance Commissioner,John Doak,REP,400204,0,2,30,32,
Leflore,Corporation Commissioner,Todd Hiett,REP,400204,0,3,23,26,
Leflore,Corporation Commissioner,Cliff Branan,REP,400204,0,1,20,21,
Leflore,U.S. Senate,Evelyn Rogers,REP,400204,0,0,2,2,
Leflore,U.S. Senate,Rob Moye,REP,400204,0,0,2,2,
Leflore,U.S. Senate,D. Jean Mcbride-Samuels,REP,400204,0,0,0,0,
Leflore,U.S. Senate,Jim Inhofe,REP,400204,0,2,40,42,
Leflore,U.S. Senate,Erick Paul Wyatt,REP,400204,0,2,4,6,
Leflore,U.S. Senate,Andy Craig,REP,400204,0,0,3,3,
Leflore,U.S. Senate,T. Shannon,REP,400204,0,2,18,20,
Leflore,U.S. Senate,Randy Brogdon,REP,400204,0,0,6,6,
Leflore,U.S. Senate,Eric Mccray,REP,400204,0,0,1,1,
Leflore,U.S. Senate,Kevin Crow,REP,400204,0,0,0,0,
Leflore,U.S. Senate,James Lankford,REP,400204,0,2,17,19,
Leflore,U.S. Senate,Jason Weger,REP,400204,0,0,0,0,
Leflore,U.S. House,Darrel Robertson,REP,400204,0,1,12,13,02
Leflore,U.S. House,Markwayne Mullin,REP,400204,0,3,33,36,02
Leflore,Superintendent of Public Instruction,John Cox,DEM,400205,0,6,32,38,
Leflore,Superintendent of Public Instruction,Jack Jr.,DEM,400205,0,2,11,13,
Leflore,Superintendent of Public Instruction,Ivan Holmes,DEM,400205,0,0,8,8,
Leflore,Superintendent of Public Instruction,Freda Deskin,DEM,400205,1,0,17,18,
Leflore,U.S. Senate,Patrick Michael Hayes,DEM,400205,1,3,17,21,
Leflore,U.S. Senate,Jim Rogers,DEM,400205,0,3,21,24,
Leflore,U.S. Senate,Connie Johnson,DEM,400205,0,2,24,26,
Leflore,U.S. House,Earl Everett,DEM,400205,1,4,31,36,02
Leflore,U.S. House,Joshua Harris-Till,DEM,400205,0,4,30,34,02
Leflore,Governor,Dax Ewbank,REP,400205,1,0,7,8,
Leflore,Governor,Chad Moody,REP,400205,0,0,3,3,
Leflore,Governor,Mary Fallin,REP,400205,0,2,18,20,
Leflore,Superintendent of Public Instruction,Brian Kelly,REP,400205,0,0,8,8,
Leflore,Superintendent of Public Instruction,Janet Costello Barresi,REP,400205,0,1,5,6,
Leflore,Superintendent of Public Instruction,Joy Hofmeister,REP,400205,1,1,13,15,
Leflore,Insurance Commissioner,Bill Viner,REP,400205,0,0,11,11,
Leflore,Insurance Commissioner,John Doak,REP,400205,1,2,11,14,
Leflore,Corporation Commissioner,Todd Hiett,REP,400205,1,2,14,17,
Leflore,Corporation Commissioner,Cliff Branan,REP,400205,0,0,8,8,
Leflore,U.S. Senate,Evelyn Rogers,REP,400205,0,0,2,2,
Leflore,U.S. Senate,Rob Moye,REP,400205,0,0,1,1,
Leflore,U.S. Senate,D. Jean Mcbride-Samuels,REP,400205,1,0,0,1,
Leflore,U.S. Senate,Jim Inhofe,REP,400205,0,2,21,23,
Leflore,U.S. Senate,Erick Paul Wyatt,REP,400205,0,0,4,4,
Leflore,U.S. Senate,Andy Craig,REP,400205,0,0,2,2,
Leflore,U.S. Senate,T. Shannon,REP,400205,0,1,13,14,
Leflore,U.S. Senate,Randy Brogdon,REP,400205,0,0,3,3,
Leflore,U.S. Senate,Eric Mccray,REP,400205,0,0,0,0,
Leflore,U.S. Senate,Kevin Crow,REP,400205,0,0,0,0,
Leflore,U.S. Senate,James Lankford,REP,400205,1,1,9,11,
Leflore,U.S. Senate,Jason Weger,REP,400205,0,0,1,1,
Leflore,U.S. House,Darrel Robertson,REP,400205,0,0,10,10,02
Leflore,U.S. House,Markwayne Mullin,REP,400205,1,2,18,21,02
Leflore,Superintendent of Public Instruction,John Cox,DEM,400207,1,6,73,80,
Leflore,Superintendent of Public Instruction,Jack Jr.,DEM,400207,0,1,28,29,
Leflore,Superintendent of Public Instruction,Ivan Holmes,DEM,400207,0,1,14,15,
Leflore,Superintendent of Public Instruction,Freda Deskin,DEM,400207,1,4,25,30,
Leflore,U.S. Senate,Patrick Michael Hayes,DEM,400207,0,4,17,21,
Leflore,U.S. Senate,Jim Rogers,DEM,400207,1,3,73,77,
Leflore,U.S. Senate,Connie Johnson,DEM,400207,1,4,49,54,
Leflore,U.S. House,Earl Everett,DEM,400207,1,6,94,101,02
Leflore,U.S. House,Joshua Harris-Till,DEM,400207,1,5,41,47,02
Leflore,Governor,Dax Ewbank,REP,400207,0,3,6,9,
Leflore,Governor,Chad Moody,REP,400207,0,0,6,6,
Leflore,Governor,Mary Fallin,REP,400207,4,2,34,40,
Leflore,Superintendent of Public Instruction,Brian Kelly,REP,400207,1,2,13,16,
Leflore,Superintendent of Public Instruction,Janet Costello Barresi,REP,400207,1,2,12,15,
Leflore,Superintendent of Public Instruction,Joy Hofmeister,REP,400207,2,2,17,21,
Leflore,Insurance Commissioner,Bill Viner,REP,400207,0,1,21,22,
Leflore,Insurance Commissioner,John Doak,REP,400207,3,4,19,26,
Leflore,Corporation Commissioner,Todd Hiett,REP,400207,1,3,20,24,
Leflore,Corporation Commissioner,Cliff Branan,REP,400207,2,3,20,25,
Leflore,U.S. Senate,Evelyn Rogers,REP,400207,0,0,2,2,
Leflore,U.S. Senate,Rob Moye,REP,400207,0,0,5,5,
Leflore,U.S. Senate,D. Jean Mcbride-Samuels,REP,400207,0,0,1,1,
Leflore,U.S. Senate,Jim Inhofe,REP,400207,4,6,32,42,
Leflore,U.S. Senate,Erick Paul Wyatt,REP,400207,0,0,5,5,
Leflore,U.S. Senate,Andy Craig,REP,400207,0,0,1,1,
Leflore,U.S. Senate,T. Shannon,REP,400207,4,1,14,19,
Leflore,U.S. Senate,Randy Brogdon,REP,400207,0,2,5,7,
Leflore,U.S. Senate,Eric Mccray,REP,400207,0,0,0,0,
Leflore,U.S. Senate,Kevin Crow,REP,400207,0,0,3,3,
Leflore,U.S. Senate,James Lankford,REP,400207,0,3,19,22,
Leflore,U.S. Senate,Jason Weger,REP,400207,0,0,1,1,
Leflore,U.S. House,Darrel Robertson,REP,400207,0,3,9,12,02
Leflore,U.S. House,Markwayne Mullin,REP,400207,4,3,36,43,02
Leflore,Superintendent of Public Instruction,John Cox,DEM,400208,0,5,66,71,
Leflore,Superintendent of Public Instruction,Jack Jr.,DEM,400208,2,3,25,30,
Leflore,Superintendent of Public Instruction,Ivan Holmes,DEM,400208,0,0,9,9,
Leflore,Superintendent of Public Instruction,Freda Deskin,DEM,400208,1,4,33,38,
Leflore,U.S. Senate,Patrick Michael Hayes,DEM,400208,2,4,23,29,
Leflore,U.S. Senate,Jim Rogers,DEM,400208,1,3,78,82,
Leflore,U.S. Senate,Connie Johnson,DEM,400208,0,5,31,36,
Leflore,U.S. House,Earl Everett,DEM,400208,1,7,79,87,02
Leflore,U.S. House,Joshua Harris-Till,DEM,400208,2,5,48,55,02
Leflore,Governor,Dax Ewbank,REP,400208,0,0,5,5,
Leflore,Governor,Chad Moody,REP,400208,0,1,9,10,
Leflore,Governor,Mary Fallin,REP,400208,0,3,27,30,
Leflore,Superintendent of Public Instruction,Brian Kelly,REP,400208,0,2,11,13,
Leflore,Superintendent of Public Instruction,Janet Costello Barresi,REP,400208,0,0,8,8,
Leflore,Superintendent of Public Instruction,Joy Hofmeister,REP,400208,0,2,22,24,
Leflore,Insurance Commissioner,Bill Viner,REP,400208,0,2,16,18,
Leflore,Insurance Commissioner,John Doak,REP,400208,0,2,24,26,
Leflore,Corporation Commissioner,Todd Hiett,REP,400208,0,2,23,25,
Leflore,Corporation Commissioner,Cliff Branan,REP,400208,0,2,17,19,
Leflore,U.S. Senate,Evelyn Rogers,REP,400208,0,0,4,4,
Leflore,U.S. Senate,Rob Moye,REP,400208,0,0,0,0,
Leflore,U.S. Senate,D. Jean Mcbride-Samuels,REP,400208,0,0,1,1,
Leflore,U.S. Senate,Jim Inhofe,REP,400208,0,4,33,37,
Leflore,U.S. Senate,Erick Paul Wyatt,REP,400208,0,0,4,4,
Leflore,U.S. Senate,Andy Craig,REP,400208,0,0,1,1,
Leflore,U.S. Senate,T. Shannon,REP,400208,0,3,16,19,
Leflore,U.S. Senate,Randy Brogdon,REP,400208,0,0,7,7,
Leflore,U.S. Senate,Eric Mccray,REP,400208,0,1,0,1,
Leflore,U.S. Senate,Kevin Crow,REP,400208,0,0,2,2,
Leflore,U.S. Senate,James Lankford,REP,400208,0,0,16,16,
Leflore,U.S. Senate,Jason Weger,REP,400208,0,0,0,0,
Leflore,U.S. House,Darrel Robertson,REP,400208,0,1,7,8,02
Leflore,U.S. House,Markwayne Mullin,REP,400208,0,3,35,38,02
Leflore,Superintendent of Public Instruction,John Cox,DEM,400210,0,8,86,94,
Leflore,Superintendent of Public Instruction,Jack Jr.,DEM,400210,0,4,30,34,
Leflore,Superintendent of Public Instruction,Ivan Holmes,DEM,400210,0,2,12,14,
Leflore,Superintendent of Public Instruction,Freda Deskin,DEM,400210,0,3,20,23,
Leflore,U.S. Senate,Patrick Michael Hayes,DEM,400210,0,4,24,28,
Leflore,U.S. Senate,Jim Rogers,DEM,400210,0,9,86,95,
Leflore,U.S. Senate,Connie Johnson,DEM,400210,0,4,30,34,
Leflore,U.S. House,Earl Everett,DEM,400210,0,9,97,106,02
Leflore,U.S. House,Joshua Harris-Till,DEM,400210,0,8,43,51,02
Leflore,Governor,Dax Ewbank,REP,400210,2,0,9,11,
Leflore,Governor,Chad Moody,REP,400210,0,0,12,12,
Leflore,Governor,Mary Fallin,REP,400210,3,1,36,40,
Leflore,Superintendent of Public Instruction,Brian Kelly,REP,400210,1,0,19,20,
Leflore,Superintendent of Public Instruction,Janet Costello Barresi,REP,400210,0,0,8,8,
Leflore,Superintendent of Public Instruction,Joy Hofmeister,REP,400210,4,1,30,35,
Leflore,Insurance Commissioner,Bill Viner,REP,400210,0,0,21,21,
Leflore,Insurance Commissioner,John Doak,REP,400210,5,1,36,42,
Leflore,Corporation Commissioner,Todd Hiett,REP,400210,2,1,29,32,
Leflore,Corporation Commissioner,Cliff Branan,REP,400210,3,0,26,29,
Leflore,U.S. Senate,Evelyn Rogers,REP,400210,0,0,3,3,
Leflore,U.S. Senate,Rob Moye,REP,400210,0,0,1,1,
Leflore,U.S. Senate,D. Jean Mcbride-Samuels,REP,400210,0,0,1,1,
Leflore,U.S. Senate,Jim Inhofe,REP,400210,4,1,50,55,
Leflore,U.S. Senate,Erick Paul Wyatt,REP,400210,1,0,2,3,
Leflore,U.S. Senate,Andy Craig,REP,400210,0,0,0,0,
Leflore,U.S. Senate,T. Shannon,REP,400210,1,0,32,33,
Leflore,U.S. Senate,Randy Brogdon,REP,400210,2,1,9,12,
Leflore,U.S. Senate,Eric Mccray,REP,400210,0,0,1,1,
Leflore,U.S. Senate,Kevin Crow,REP,400210,0,0,0,0,
Leflore,U.S. Senate,James Lankford,REP,400210,2,0,14,16,
Leflore,U.S. Senate,Jason Weger,REP,400210,0,0,1,1,
Leflore,U.S. House,Darrel Robertson,REP,400210,2,0,22,24,02
Leflore,U.S. House,Markwayne Mullin,REP,400210,3,1,33,37,02
Leflore,Superintendent of Public Instruction,John Cox,DEM,400211,0,3,119,122,
Leflore,Superintendent of Public Instruction,Jack Jr.,DEM,400211,0,2,31,33,
Leflore,Superintendent of Public Instruction,Ivan Holmes,DEM,400211,0,2,5,7,
Leflore,Superintendent of Public Instruction,Freda Deskin,DEM,400211,0,3,21,24,
Leflore,U.S. Senate,Patrick Michael Hayes,DEM,400211,0,1,20,21,
Leflore,U.S. Senate,Jim Rogers,DEM,400211,0,3,104,107,
Leflore,U.S. Senate,Connie Johnson,DEM,400211,0,5,40,45,
Leflore,U.S. House,Earl Everett,DEM,400211,0,5,108,113,02
Leflore,U.S. House,Joshua Harris-Till,DEM,400211,0,3,47,50,02
Leflore,Governor,Dax Ewbank,REP,400211,0,0,11,11,
Leflore,Governor,Chad Moody,REP,400211,0,0,10,10,
Leflore,Governor,Mary Fallin,REP,400211,0,0,29,29,
Leflore,Superintendent of Public Instruction,Brian Kelly,REP,400211,0,0,27,27,
Leflore,Superintendent of Public Instruction,Janet Costello Barresi,REP,400211,0,0,4,4,
Leflore,Superintendent of Public Instruction,Joy Hofmeister,REP,400211,0,0,19,19,
Leflore,Insurance Commissioner,Bill Viner,REP,400211,0,0,20,20,
Leflore,Insurance Commissioner,John Doak,REP,400211,0,0,28,28,
Leflore,Corporation Commissioner,Todd Hiett,REP,400211,0,0,30,30,
Leflore,Corporation Commissioner,Cliff Branan,REP,400211,0,0,18,18,
Leflore,U.S. Senate,Evelyn Rogers,REP,400211,0,0,5,5,
Leflore,U.S. Senate,Rob Moye,REP,400211,0,0,1,1,
Leflore,U.S. Senate,D. Jean Mcbride-Samuels,REP,400211,0,0,1,1,
Leflore,U.S. Senate,Jim Inhofe,REP,400211,0,0,34,34,
Leflore,U.S. Senate,Erick Paul Wyatt,REP,400211,0,0,6,6,
Leflore,U.S. Senate,Andy Craig,REP,400211,0,0,4,4,
Leflore,U.S. Senate,T. Shannon,REP,400211,0,0,24,24,
Leflore,U.S. Senate,Randy Brogdon,REP,400211,0,0,3,3,
Leflore,U.S. Senate,Eric Mccray,REP,400211,0,0,2,2,
Leflore,U.S. Senate,Kevin Crow,REP,400211,0,0,3,3,
Leflore,U.S. Senate,James Lankford,REP,400211,0,0,14,14,
Leflore,U.S. Senate,Jason Weger,REP,400211,0,0,0,0,
Leflore,U.S. House,Darrel Robertson,REP,400211,0,0,13,13,02
Leflore,U.S. House,Markwayne Mullin,REP,400211,0,0,33,33,02
Leflore,State Senate,Joseph Silk,REP,400211,0,0,39,39,5
Leflore,State Senate,Brent Shain,REP,400211,0,0,6,6,5
Leflore,Superintendent of Public Instruction,John Cox,DEM,400212,0,9,179,188,
Leflore,Superintendent of Public Instruction,Jack Jr.,DEM,400212,0,1,38,39,
Leflore,Superintendent of Public Instruction,Ivan Holmes,DEM,400212,0,2,16,18,
Leflore,Superintendent of Public Instruction,Freda Deskin,DEM,400212,1,6,33,40,
Leflore,U.S. Senate,Patrick Michael Hayes,DEM,400212,0,0,51,51,
Leflore,U.S. Senate,Jim Rogers,DEM,400212,0,7,147,154,
Leflore,U.S. Senate,Connie Johnson,DEM,400212,0,8,60,68,
Leflore,U.S. House,Earl Everett,DEM,400212,0,6,178,184,02
Leflore,U.S. House,Joshua Harris-Till,DEM,400212,0,10,77,87,02
Leflore,Governor,Dax Ewbank,REP,400212,0,2,1,3,
Leflore,Governor,Chad Moody,REP,400212,0,2,8,10,
Leflore,Governor,Mary Fallin,REP,400212,2,3,48,53,
Leflore,Superintendent of Public Instruction,Brian Kelly,REP,400212,0,3,14,17,
Leflore,Superintendent of Public Instruction,Janet Costello Barresi,REP,400212,0,1,15,16,
Leflore,Superintendent of Public Instruction,Joy Hofmeister,REP,400212,2,3,22,27,
Leflore,Insurance Commissioner,Bill Viner,REP,400212,0,2,24,26,
Leflore,Insurance Commissioner,John Doak,REP,400212,2,4,23,29,
Leflore,Corporation Commissioner,Todd Hiett,REP,400212,0,4,24,28,
Leflore,Corporation Commissioner,Cliff Branan,REP,400212,2,2,21,25,
Leflore,U.S. Senate,Evelyn Rogers,REP,400212,0,0,3,3,
Leflore,U.S. Senate,Rob Moye,REP,400212,0,1,1,2,
Leflore,U.S. Senate,D. Jean Mcbride-Samuels,REP,400212,0,0,0,0,
Leflore,U.S. Senate,Jim Inhofe,REP,400212,2,6,50,58,
Leflore,U.S. Senate,Erick Paul Wyatt,REP,400212,0,0,3,3,
Leflore,U.S. Senate,Andy Craig,REP,400212,0,0,1,1,
Leflore,U.S. Senate,T. Shannon,REP,400212,0,5,28,33,
Leflore,U.S. Senate,Randy Brogdon,REP,400212,0,1,4,5,
Leflore,U.S. Senate,Eric Mccray,REP,400212,0,0,1,1,
Leflore,U.S. Senate,Kevin Crow,REP,400212,0,0,3,3,
Leflore,U.S. Senate,James Lankford,REP,400212,2,1,21,24,
Leflore,U.S. Senate,Jason Weger,REP,400212,0,0,0,0,
Leflore,U.S. House,Darrel Robertson,REP,400212,0,2,22,24,02
Leflore,U.S. House,Markwayne Mullin,REP,400212,2,5,34,41,02
Leflore,Superintendent of Public Instruction,John Cox,DEM,400213,0,1,20,21,
Leflore,Superintendent of Public Instruction,Jack Jr.,DEM,400213,0,0,0,0,
Leflore,Superintendent of Public Instruction,Ivan Holmes,DEM,400213,0,0,5,5,
Leflore,Superintendent of Public Instruction,Freda Deskin,DEM,400213,0,0,4,4,
Leflore,U.S. Senate,Patrick Michael Hayes,DEM,400213,0,0,5,5,
Leflore,U.S. Senate,Jim Rogers,DEM,400213,0,0,15,15,
Leflore,U.S. Senate,Connie Johnson,DEM,400213,0,1,8,9,
Leflore,U.S. House,Earl Everett,DEM,400213,0,0,17,17,02
Leflore,U.S. House,Joshua Harris-Till,DEM,400213,0,1,10,11,02
Leflore,Governor,Dax Ewbank,REP,400213,0,0,2,2,
Leflore,Governor,Chad Moody,REP,400213,0,0,3,3,
Leflore,Governor,Mary Fallin,REP,400213,0,0,6,6,
Leflore,Superintendent of Public Instruction,Brian Kelly,REP,400213,0,0,3,3,
Leflore,Superintendent of Public Instruction,Janet Costello Barresi,REP,400213,0,0,3,3,
Leflore,Superintendent of Public Instruction,Joy Hofmeister,REP,400213,0,0,4,4,
Leflore,Insurance Commissioner,Bill Viner,REP,400213,0,0,2,2,
Leflore,Insurance Commissioner,John Doak,REP,400213,0,0,9,9,
Leflore,Corporation Commissioner,Todd Hiett,REP,400213,0,0,5,5,
Leflore,Corporation Commissioner,Cliff Branan,REP,400213,0,0,6,6,
Leflore,U.S. Senate,Evelyn Rogers,REP,400213,0,0,0,0,
Leflore,U.S. Senate,Rob Moye,REP,400213,0,0,0,0,
Leflore,U.S. Senate,D. Jean Mcbride-Samuels,REP,400213,0,0,0,0,
Leflore,U.S. Senate,Jim Inhofe,REP,400213,0,0,9,9,
Leflore,U.S. Senate,Erick Paul Wyatt,REP,400213,0,0,2,2,
Leflore,U.S. Senate,Andy Craig,REP,400213,0,0,1,1,
Leflore,U.S. Senate,T. Shannon,REP,400213,0,0,4,4,
Leflore,U.S. Senate,Randy Brogdon,REP,400213,0,0,1,1,
Leflore,U.S. Senate,Eric Mccray,REP,400213,0,0,1,1,
Leflore,U.S. Senate,Kevin Crow,REP,400213,0,0,1,1,
Leflore,U.S. Senate,James Lankford,REP,400213,0,0,3,3,
Leflore,U.S. Senate,Jason Weger,REP,400213,0,0,0,0,
Leflore,U.S. House,Darrel Robertson,REP,400213,0,0,3,3,02
Leflore,U.S. House,Markwayne Mullin,REP,400213,0,0,8,8,02
Leflore,State Senate,Joseph Silk,REP,400213,0,0,7,7,5
Leflore,State Senate,Brent Shain,REP,400213,0,0,4,4,5
Leflore,State House,Paul Marean,REP,400213,0,0,5,5,17
Leflore,State House,Micah Thompson,REP,400213,0,0,6,6,17
Leflore,Superintendent of Public Instruction,John Cox,DEM,400214,1,0,32,33,
Leflore,Superintendent of Public Instruction,Jack Jr.,DEM,400214,0,1,1,2,
Leflore,Superintendent of Public Instruction,Ivan Holmes,DEM,400214,0,0,2,2,
Leflore,Superintendent of Public Instruction,Freda Deskin,DEM,400214,0,0,6,6,
Leflore,U.S. Senate,Patrick Michael Hayes,DEM,400214,1,1,12,14,
Leflore,U.S. Senate,Jim Rogers,DEM,400214,0,0,18,18,
Leflore,U.S. Senate,Connie Johnson,DEM,400214,0,0,9,9,
Leflore,U.S. House,Earl Everett,DEM,400214,0,0,25,25,02
Leflore,U.S. House,Joshua Harris-Till,DEM,400214,1,1,12,14,02
Leflore,Governor,Dax Ewbank,REP,400214,0,0,0,0,
Leflore,Governor,Chad Moody,REP,400214,0,0,3,3,
Leflore,Governor,Mary Fallin,REP,400214,0,0,4,4,
Leflore,Superintendent of Public Instruction,Brian Kelly,REP,400214,0,0,2,2,
Leflore,Superintendent of Public Instruction,Janet Costello Barresi,REP,400214,0,0,0,0,
Leflore,Superintendent of Public Instruction,Joy Hofmeister,REP,400214,0,0,3,3,
Leflore,Insurance Commissioner,Bill Viner,REP,400214,0,0,1,1,
Leflore,Insurance Commissioner,John Doak,REP,400214,0,0,3,3,
Leflore,Corporation Commissioner,Todd Hiett,REP,400214,0,0,2,2,
Leflore,Corporation Commissioner,Cliff Branan,REP,400214,0,0,1,1,
Leflore,U.S. Senate,Evelyn Rogers,REP,400214,0,0,0,0,
Leflore,U.S. Senate,Rob Moye,REP,400214,0,0,0,0,
Leflore,U.S. Senate,D. Jean Mcbride-Samuels,REP,400214,0,0,1,1,
Leflore,U.S. Senate,Jim Inhofe,REP,400214,0,0,5,5,
Leflore,U.S. Senate,Erick Paul Wyatt,REP,400214,0,0,1,1,
Leflore,U.S. Senate,Andy Craig,REP,400214,0,0,1,1,
Leflore,U.S. Senate,T. Shannon,REP,400214,0,0,2,2,
Leflore,U.S. Senate,Randy Brogdon,REP,400214,0,0,0,0,
Leflore,U.S. Senate,Eric Mccray,REP,400214,0,0,0,0,
Leflore,U.S. Senate,Kevin Crow,REP,400214,0,0,0,0,
Leflore,U.S. Senate,James Lankford,REP,400214,0,0,2,2,
Leflore,U.S. Senate,Jason Weger,REP,400214,0,0,1,1,
Leflore,U.S. House,Darrel Robertson,REP,400214,0,0,1,1,02
Leflore,U.S. House,Markwayne Mullin,REP,400214,0,0,4,4,02
Leflore,State Senate,Joseph Silk,REP,400214,0,0,1,1,5
Leflore,State Senate,Brent Shain,REP,400214,0,0,3,3,5
Leflore,State House,Paul Marean,REP,400214,0,0,3,3,17
Leflore,State House,Micah Thompson,REP,400214,0,0,1,1,17
Leflore,Superintendent of Public Instruction,John Cox,DEM,400215,3,0,51,54,
Leflore,Superintendent of Public Instruction,Jack Jr.,DEM,400215,0,0,4,4,
Leflore,Superintendent of Public Instruction,Ivan Holmes,DEM,400215,0,0,1,1,
Leflore,Superintendent of Public Instruction,Freda Deskin,DEM,400215,0,1,14,15,
Leflore,U.S. Senate,Patrick Michael Hayes,DEM,400215,0,0,24,24,
Leflore,U.S. Senate,Jim Rogers,DEM,400215,2,0,32,34,
Leflore,U.S. Senate,Connie Johnson,DEM,400215,0,0,9,9,
Leflore,U.S. House,Earl Everett,DEM,400215,2,0,34,36,02
Leflore,U.S. House,Joshua Harris-Till,DEM,400215,0,0,25,25,02
Leflore,Governor,Dax Ewbank,REP,400215,0,0,0,0,
Leflore,Governor,Chad Moody,REP,400215,0,0,4,4,
Leflore,Governor,Mary Fallin,REP,400215,0,0,8,8,
Leflore,Superintendent of Public Instruction,Brian Kelly,REP,400215,0,0,4,4,
Leflore,Superintendent of Public Instruction,Janet Costello Barresi,REP,400215,0,0,1,1,
Leflore,Superintendent of Public Instruction,Joy Hofmeister,REP,400215,0,0,6,6,
Leflore,Insurance Commissioner,Bill Viner,REP,400215,0,0,2,2,
Leflore,Insurance Commissioner,John Doak,REP,400215,0,0,7,7,
Leflore,Corporation Commissioner,Todd Hiett,REP,400215,0,0,3,3,
Leflore,Corporation Commissioner,Cliff Branan,REP,400215,0,0,6,6,
Leflore,U.S. Senate,Evelyn Rogers,REP,400215,0,0,0,0,
Leflore,U.S. Senate,Rob Moye,REP,400215,0,0,0,0,
Leflore,U.S. Senate,D. Jean Mcbride-Samuels,REP,400215,0,0,1,1,
Leflore,U.S. Senate,Jim Inhofe,REP,400215,0,0,10,10,
Leflore,U.S. Senate,Erick Paul Wyatt,REP,400215,0,0,0,0,
Leflore,U.S. Senate,Andy Craig,REP,400215,0,0,2,2,
Leflore,U.S. Senate,T. Shannon,REP,400215,0,0,7,7,
Leflore,U.S. Senate,Randy Brogdon,REP,400215,0,0,0,0,
Leflore,U.S. Senate,Eric Mccray,REP,400215,0,0,1,1,
Leflore,U.S. Senate,Kevin Crow,REP,400215,0,0,0,0,
Leflore,U.S. Senate,James Lankford,REP,400215,0,0,1,1,
Leflore,U.S. Senate,Jason Weger,REP,400215,0,0,0,0,
Leflore,U.S. House,Darrel Robertson,REP,400215,0,0,2,2,02
Leflore,U.S. House,Markwayne Mullin,REP,400215,0,0,9,9,02
Leflore,State Senate,Joseph Silk,REP,400215,0,0,7,7,5
Leflore,State Senate,Brent Shain,REP,400215,0,0,4,4,5
Leflore,State House,Paul Marean,REP,400215,0,0,4,4,17
Leflore,State House,Micah Thompson,REP,400215,0,0,6,6,17
Leflore,Superintendent of Public Instruction,John Cox,DEM,400301,1,0,50,51,
Leflore,Superintendent of Public Instruction,Jack Jr.,DEM,400301,0,0,19,19,
Leflore,Superintendent of Public Instruction,Ivan Holmes,DEM,400301,0,0,7,7,
Leflore,Superintendent of Public Instruction,Freda Deskin,DEM,400301,0,0,31,31,
Leflore,U.S. Senate,Patrick Michael Hayes,DEM,400301,0,0,23,23,
Leflore,U.S. Senate,Jim Rogers,DEM,400301,0,0,44,44,
Leflore,U.S. Senate,Connie Johnson,DEM,400301,0,0,33,33,
Leflore,U.S. House,Earl Everett,DEM,400301,0,0,69,69,02
Leflore,U.S. House,Joshua Harris-Till,DEM,400301,0,0,31,31,02
Leflore,Governor,Dax Ewbank,REP,400301,0,0,3,3,
Leflore,Governor,Chad Moody,REP,400301,0,0,4,4,
Leflore,Governor,Mary Fallin,REP,400301,3,1,22,26,
Leflore,Superintendent of Public Instruction,Brian Kelly,REP,400301,1,0,12,13,
Leflore,Superintendent of Public Instruction,Janet Costello Barresi,REP,400301,0,0,8,8,
Leflore,Superintendent of Public Instruction,Joy Hofmeister,REP,400301,2,1,8,11,
Leflore,Insurance Commissioner,Bill Viner,REP,400301,0,0,10,10,
Leflore,Insurance Commissioner,John Doak,REP,400301,3,1,16,20,
Leflore,Corporation Commissioner,Todd Hiett,REP,400301,0,0,17,17,
Leflore,Corporation Commissioner,Cliff Branan,REP,400301,3,1,7,11,
Leflore,U.S. Senate,Evelyn Rogers,REP,400301,0,0,5,5,
Leflore,U.S. Senate,Rob Moye,REP,400301,0,0,0,0,
Leflore,U.S. Senate,D. Jean Mcbride-Samuels,REP,400301,0,0,1,1,
Leflore,U.S. Senate,Jim Inhofe,REP,400301,3,1,20,24,
Leflore,U.S. Senate,Erick Paul Wyatt,REP,400301,0,0,3,3,
Leflore,U.S. Senate,Andy Craig,REP,400301,0,0,1,1,
Leflore,U.S. Senate,T. Shannon,REP,400301,3,1,9,13,
Leflore,U.S. Senate,Randy Brogdon,REP,400301,0,0,1,1,
Leflore,U.S. Senate,Eric Mccray,REP,400301,0,0,2,2,
Leflore,U.S. Senate,Kevin Crow,REP,400301,0,0,2,2,
Leflore,U.S. Senate,James Lankford,REP,400301,0,0,14,14,
Leflore,U.S. Senate,Jason Weger,REP,400301,0,0,0,0,
Leflore,U.S. House,Darrel Robertson,REP,400301,0,0,13,13,02
Leflore,U.S. House,Markwayne Mullin,REP,400301,3,1,15,19,02
Leflore,State Senate,Joseph Silk,REP,400301,3,1,18,22,5
Leflore,State Senate,Brent Shain,REP,400301,0,0,10,10,5
Leflore,State House,Paul Marean,REP,400301,3,0,11,14,17
Leflore,State House,Micah Thompson,REP,400301,0,1,15,16,17
Leflore,Superintendent of Public Instruction,John Cox,DEM,400302,0,2,108,110,
Leflore,Superintendent of Public Instruction,Jack Jr.,DEM,400302,0,1,19,20,
Leflore,Superintendent of Public Instruction,Ivan Holmes,DEM,400302,0,0,25,25,
Leflore,Superintendent of Public Instruction,Freda Deskin,DEM,400302,0,2,37,39,
Leflore,U.S. Senate,Patrick Michael Hayes,DEM,400302,0,1,41,42,
Leflore,U.S. Senate,Jim Rogers,DEM,400302,0,4,103,107,
Leflore,U.S. Senate,Connie Johnson,DEM,400302,0,0,38,38,
Leflore,U.S. House,Earl Everett,DEM,400302,0,2,95,97,02
Leflore,U.S. House,Joshua Harris-Till,DEM,400302,0,2,75,77,02
Leflore,State House,Johnny Tadlock,DEM,400302,0,3,88,91,1
Leflore,State House,Kent Hendon,DEM,400302,0,2,93,95,1
Leflore,Governor,Dax Ewbank,REP,400302,0,0,3,3,
Leflore,Governor,Chad Moody,REP,400302,0,0,14,14,
Leflore,Governor,Mary Fallin,REP,400302,2,2,26,30,
Leflore,Superintendent of Public Instruction,Brian Kelly,REP,400302,1,2,24,27,
Leflore,Superintendent of Public Instruction,Janet Costello Barresi,REP,400302,0,0,1,1,
Leflore,Superintendent of Public Instruction,Joy Hofmeister,REP,400302,1,0,17,18,
Leflore,Insurance Commissioner,Bill Viner,REP,400302,1,0,19,20,
Leflore,Insurance Commissioner,John Doak,REP,400302,1,2,22,25,
Leflore,Corporation Commissioner,Todd Hiett,REP,400302,1,1,18,20,
Leflore,Corporation Commissioner,Cliff Branan,REP,400302,1,1,22,24,
Leflore,U.S. Senate,Evelyn Rogers,REP,400302,0,0,0,0,
Leflore,U.S. Senate,Rob Moye,REP,400302,0,0,1,1,
Leflore,U.S. Senate,D. Jean Mcbride-Samuels,REP,400302,0,0,1,1,
Leflore,U.S. Senate,Jim Inhofe,REP,400302,2,2,36,40,
Leflore,U.S. Senate,Erick Paul Wyatt,REP,400302,0,0,5,5,
Leflore,U.S. Senate,Andy Craig,REP,400302,0,0,0,0,
Leflore,U.S. Senate,T. Shannon,REP,400302,0,1,21,22,
Leflore,U.S. Senate,Randy Brogdon,REP,400302,0,0,5,5,
Leflore,U.S. Senate,Eric Mccray,REP,400302,0,0,0,0,
Leflore,U.S. Senate,Kevin Crow,REP,400302,0,0,2,2,
Leflore,U.S. Senate,James Lankford,REP,400302,2,1,13,16,
Leflore,U.S. Senate,Jason Weger,REP,400302,0,0,2,2,
Leflore,U.S. House,Darrel Robertson,REP,400302,0,0,9,9,02
Leflore,U.S. House,Markwayne Mullin,REP,400302,2,2,34,38,02
Leflore,State Senate,Joseph Silk,REP,400302,1,2,26,29,5
Leflore,State Senate,Brent Shain,REP,400302,1,0,16,17,5
Leflore,Superintendent of Public Instruction,John Cox,DEM,400303,0,0,33,33,
Leflore,Superintendent of Public Instruction,Jack Jr.,DEM,400303,0,0,8,8,
Leflore,Superintendent of Public Instruction,Ivan Holmes,DEM,400303,0,0,4,4,
Leflore,Superintendent of Public Instruction,Freda Deskin,DEM,400303,0,0,15,15,
Leflore,U.S. Senate,Patrick Michael Hayes,DEM,400303,0,0,9,9,
Leflore,U.S. Senate,Jim Rogers,DEM,400303,0,0,32,32,
Leflore,U.S. Senate,Connie Johnson,DEM,400303,0,0,17,17,
Leflore,U.S. House,Earl Everett,DEM,400303,0,0,33,33,02
Leflore,U.S. House,Joshua Harris-Till,DEM,400303,0,0,24,24,02
Leflore,State House,Johnny Tadlock,DEM,400303,0,0,34,34,1
Leflore,State House,Kent Hendon,DEM,400303,0,0,27,27,1
Leflore,Governor,Dax Ewbank,REP,400303,0,0,3,3,
Leflore,Governor,Chad Moody,REP,400303,0,0,2,2,
Leflore,Governor,Mary Fallin,REP,400303,0,0,8,8,
Leflore,Superintendent of Public Instruction,Brian Kelly,REP,400303,0,0,4,4,
Leflore,Superintendent of Public Instruction,Janet Costello Barresi,REP,400303,0,0,2,2,
Leflore,Superintendent of Public Instruction,Joy Hofmeister,REP,400303,0,0,6,6,
Leflore,Insurance Commissioner,Bill Viner,REP,400303,0,0,6,6,
Leflore,Insurance Commissioner,John Doak,REP,400303,0,0,6,6,
Leflore,Corporation Commissioner,Todd Hiett,REP,400303,0,0,4,4,
Leflore,Corporation Commissioner,Cliff Branan,REP,400303,0,0,7,7,
Leflore,U.S. Senate,Evelyn Rogers,REP,400303,0,0,1,1,
Leflore,U.S. Senate,Rob Moye,REP,400303,0,0,0,0,
Leflore,U.S. Senate,D. Jean Mcbride-Samuels,REP,400303,0,0,1,1,
Leflore,U.S. Senate,Jim Inhofe,REP,400303,0,0,10,10,
Leflore,U.S. Senate,Erick Paul Wyatt,REP,400303,0,0,0,0,
Leflore,U.S. Senate,Andy Craig,REP,400303,0,0,0,0,
Leflore,U.S. Senate,T. Shannon,REP,400303,0,0,3,3,
Leflore,U.S. Senate,Randy Brogdon,REP,400303,0,0,4,4,
Leflore,U.S. Senate,Eric Mccray,REP,400303,0,0,2,2,
Leflore,U.S. Senate,Kevin Crow,REP,400303,0,0,1,1,
Leflore,U.S. Senate,James Lankford,REP,400303,0,0,2,2,
Leflore,U.S. Senate,Jason Weger,REP,400303,0,0,1,1,
Leflore,U.S. House,Darrel Robertson,REP,400303,0,0,3,3,02
Leflore,U.S. House,Markwayne Mullin,REP,400303,0,0,10,10,02
Leflore,State Senate,Joseph Silk,REP,400303,0,0,6,6,5
Leflore,State Senate,Brent Shain,REP,400303,0,0,7,7,5
Leflore,Superintendent of Public Instruction,John Cox,DEM,400304,0,0,42,42,
Leflore,Superintendent of Public Instruction,Jack Jr.,DEM,400304,0,0,9,9,
Leflore,Superintendent of Public Instruction,Ivan Holmes,DEM,400304,1,0,17,18,
Leflore,Superintendent of Public Instruction,Freda Deskin,DEM,400304,0,0,5,5,
Leflore,U.S. Senate,Patrick Michael Hayes,DEM,400304,1,0,19,20,
Leflore,U.S. Senate,Jim Rogers,DEM,400304,0,0,33,33,
Leflore,U.S. Senate,Connie Johnson,DEM,400304,0,0,17,17,
Leflore,U.S. House,Earl Everett,DEM,400304,1,0,47,48,02
Leflore,U.S. House,Joshua Harris-Till,DEM,400304,0,0,19,19,02
Leflore,State House,Johnny Tadlock,DEM,400304,1,0,36,37,1
Leflore,State House,Kent Hendon,DEM,400304,0,0,41,41,1
Leflore,Governor,Dax Ewbank,REP,400304,0,0,1,1,
Leflore,Governor,Chad Moody,REP,400304,0,0,7,7,
Leflore,Governor,Mary Fallin,REP,400304,0,0,19,19,
Leflore,Superintendent of Public Instruction,Brian Kelly,REP,400304,0,0,9,9,
Leflore,Superintendent of Public Instruction,Janet Costello Barresi,REP,400304,0,0,3,3,
Leflore,Superintendent of Public Instruction,Joy Hofmeister,REP,400304,0,0,13,13,
Leflore,Insurance Commissioner,Bill Viner,REP,400304,0,0,5,5,
Leflore,Insurance Commissioner,John Doak,REP,400304,0,0,13,13,
Leflore,Corporation Commissioner,Todd Hiett,REP,400304,0,0,10,10,
Leflore,Corporation Commissioner,Cliff Branan,REP,400304,0,0,10,10,
Leflore,U.S. Senate,Evelyn Rogers,REP,400304,0,0,0,0,
Leflore,U.S. Senate,Rob Moye,REP,400304,0,0,0,0,
Leflore,U.S. Senate,D. Jean Mcbride-Samuels,REP,400304,0,0,0,0,
Leflore,U.S. Senate,Jim Inhofe,REP,400304,0,0,25,25,
Leflore,U.S. Senate,Erick Paul Wyatt,REP,400304,0,0,0,0,
Leflore,U.S. Senate,Andy Craig,REP,400304,0,0,1,1,
Leflore,U.S. Senate,T. Shannon,REP,400304,0,0,13,13,
Leflore,U.S. Senate,Randy Brogdon,REP,400304,0,0,1,1,
Leflore,U.S. Senate,Eric Mccray,REP,400304,0,0,1,1,
Leflore,U.S. Senate,Kevin Crow,REP,400304,0,0,0,0,
Leflore,U.S. Senate,James Lankford,REP,400304,0,0,10,10,
Leflore,U.S. Senate,Jason Weger,REP,400304,0,0,0,0,
Leflore,U.S. House,Darrel Robertson,REP,400304,0,0,11,11,02
Leflore,U.S. House,Markwayne Mullin,REP,400304,0,0,16,16,02
Leflore,State Senate,Joseph Silk,REP,400304,0,0,18,18,5
Leflore,State Senate,Brent Shain,REP,400304,0,0,5,5,5
Leflore,Superintendent of Public Instruction,John Cox,DEM,400305,0,0,55,55,
Leflore,Superintendent of Public Instruction,Jack Jr.,DEM,400305,0,1,9,10,
Leflore,Superintendent of Public Instruction,Ivan Holmes,DEM,400305,0,0,5,5,
Leflore,Superintendent of Public Instruction,Freda Deskin,DEM,400305,0,0,12,12,
Leflore,U.S. Senate,Patrick Michael Hayes,DEM,400305,0,0,20,20,
Leflore,U.S. Senate,Jim Rogers,DEM,400305,0,1,42,43,
Leflore,U.S. Senate,Connie Johnson,DEM,400305,0,0,16,16,
Leflore,U.S. House,Earl Everett,DEM,400305,0,0,45,45,02
Leflore,U.S. House,Joshua Harris-Till,DEM,400305,0,1,27,28,02
Leflore,State House,Johnny Tadlock,DEM,400305,0,0,46,46,1
Leflore,State House,Kent Hendon,DEM,400305,0,1,32,33,1
Leflore,Governor,Dax Ewbank,REP,400305,0,0,1,1,
Leflore,Governor,Chad Moody,REP,400305,0,0,2,2,
Leflore,Governor,Mary Fallin,REP,400305,2,0,12,14,
Leflore,Superintendent of Public Instruction,Brian Kelly,REP,400305,0,0,3,3,
Leflore,Superintendent of Public Instruction,Janet Costello Barresi,REP,400305,0,0,2,2,
Leflore,Superintendent of Public Instruction,Joy Hofmeister,REP,400305,2,0,6,8,
Leflore,Insurance Commissioner,Bill Viner,REP,400305,0,0,4,4,
Leflore,Insurance Commissioner,John Doak,REP,400305,2,0,5,7,
Leflore,Corporation Commissioner,Todd Hiett,REP,400305,2,0,6,8,
Leflore,Corporation Commissioner,Cliff Branan,REP,400305,0,0,4,4,
Leflore,U.S. Senate,Evelyn Rogers,REP,400305,0,0,0,0,
Leflore,U.S. Senate,Rob Moye,REP,400305,0,0,0,0,
Leflore,U.S. Senate,D. Jean Mcbride-Samuels,REP,400305,0,0,1,1,
Leflore,U.S. Senate,Jim Inhofe,REP,400305,0,0,11,11,
Leflore,U.S. Senate,Erick Paul Wyatt,REP,400305,2,0,3,5,
Leflore,U.S. Senate,Andy Craig,REP,400305,0,0,1,1,
Leflore,U.S. Senate,T. Shannon,REP,400305,2,0,7,9,
Leflore,U.S. Senate,Randy Brogdon,REP,400305,0,0,0,0,
Leflore,U.S. Senate,Eric Mccray,REP,400305,0,0,0,0,
Leflore,U.S. Senate,Kevin Crow,REP,400305,0,0,1,1,
Leflore,U.S. Senate,James Lankford,REP,400305,0,0,3,3,
Leflore,U.S. Senate,Jason Weger,REP,400305,0,0,1,1,
Leflore,U.S. House,Darrel Robertson,REP,400305,0,0,4,4,02
Leflore,U.S. House,Markwayne Mullin,REP,400305,2,0,8,10,02
Leflore,State Senate,Joseph Silk,REP,400305,2,0,6,8,5
Leflore,State Senate,Brent Shain,REP,400305,0,0,3,3,5
Leflore,Superintendent of Public Instruction,John Cox,DEM,400306,0,2,26,28,
Leflore,Superintendent of Public Instruction,Jack Jr.,DEM,400306,0,0,11,11,
Leflore,Superintendent of Public Instruction,Ivan Holmes,DEM,400306,0,1,4,5,
Leflore,Superintendent of Public Instruction,Freda Deskin,DEM,400306,0,0,4,4,
Leflore,U.S. Senate,Patrick Michael Hayes,DEM,400306,0,0,8,8,
Leflore,U.S. Senate,Jim Rogers,DEM,400306,0,3,18,21,
Leflore,U.S. Senate,Connie Johnson,DEM,400306,0,0,11,11,
Leflore,U.S. House,Earl Everett,DEM,400306,0,3,19,22,02
Leflore,U.S. House,Joshua Harris-Till,DEM,400306,0,0,16,16,02
Leflore,State House,Johnny Tadlock,DEM,400306,0,2,18,20,1
Leflore,State House,Kent Hendon,DEM,400306,0,1,23,24,1
Leflore,Governor,Dax Ewbank,REP,400306,0,0,0,0,
Leflore,Governor,Chad Moody,REP,400306,0,0,2,2,
Leflore,Governor,Mary Fallin,REP,400306,0,0,7,7,
Leflore,Superintendent of Public Instruction,Brian Kelly,REP,400306,0,0,4,4,
Leflore,Superintendent of Public Instruction,Janet Costello Barresi,REP,400306,0,0,2,2,
Leflore,Superintendent of Public Instruction,Joy Hofmeister,REP,400306,0,0,2,2,
Leflore,Insurance Commissioner,Bill Viner,REP,400306,0,0,3,3,
Leflore,Insurance Commissioner,John Doak,REP,400306,0,0,6,6,
Leflore,Corporation Commissioner,Todd Hiett,REP,400306,0,0,6,6,
Leflore,Corporation Commissioner,Cliff Branan,REP,400306,0,0,1,1,
Leflore,U.S. Senate,Evelyn Rogers,REP,400306,0,0,1,1,
Leflore,U.S. Senate,Rob Moye,REP,400306,0,0,1,1,
Leflore,U.S. Senate,D. Jean Mcbride-Samuels,REP,400306,0,0,0,0,
Leflore,U.S. Senate,Jim Inhofe,REP,400306,0,0,7,7,
Leflore,U.S. Senate,Erick Paul Wyatt,REP,400306,0,0,1,1,
Leflore,U.S. Senate,Andy Craig,REP,400306,0,0,0,0,
Leflore,U.S. Senate,T. Shannon,REP,400306,0,0,4,4,
Leflore,U.S. Senate,Randy Brogdon,REP,400306,0,0,1,1,
Leflore,U.S. Senate,Eric Mccray,REP,400306,0,0,0,0,
Leflore,U.S. Senate,Kevin Crow,REP,400306,0,0,0,0,
Leflore,U.S. Senate,James Lankford,REP,400306,0,0,3,3,
Leflore,U.S. Senate,Jason Weger,REP,400306,0,0,0,0,
Leflore,U.S. House,Darrel Robertson,REP,400306,0,0,3,3,02
Leflore,U.S. House,Markwayne Mullin,REP,400306,0,0,7,7,02
Leflore,State Senate,Joseph Silk,REP,400306,0,0,7,7,5
Leflore,State Senate,Brent Shain,REP,400306,0,0,1,1,5
Leflore,Superintendent of Public Instruction,John Cox,DEM,400309,0,0,17,17,
Leflore,Superintendent of Public Instruction,Jack Jr.,DEM,400309,0,0,8,8,
Leflore,Superintendent of Public Instruction,Ivan Holmes,DEM,400309,0,0,3,3,
Leflore,Superintendent of Public Instruction,Freda Deskin,DEM,400309,0,0,5,5,
Leflore,U.S. Senate,Patrick Michael Hayes,DEM,400309,0,0,12,12,
Leflore,U.S. Senate,Jim Rogers,DEM,400309,0,0,16,16,
Leflore,U.S. Senate,Connie Johnson,DEM,400309,0,0,5,5,
Leflore,U.S. House,Earl Everett,DEM,400309,0,0,22,22,02
Leflore,U.S. House,Joshua Harris-Till,DEM,400309,0,0,8,8,02
Leflore,Governor,Dax Ewbank,REP,400309,0,0,0,0,
Leflore,Governor,Chad Moody,REP,400309,0,0,0,0,
Leflore,Governor,Mary Fallin,REP,400309,0,0,3,3,
Leflore,Superintendent of Public Instruction,Brian Kelly,REP,400309,0,0,1,1,
Leflore,Superintendent of Public Instruction,Janet Costello Barresi,REP,400309,0,0,1,1,
Leflore,Superintendent of Public Instruction,Joy Hofmeister,REP,400309,0,0,1,1,
Leflore,Insurance Commissioner,Bill Viner,REP,400309,0,0,0,0,
Leflore,Insurance Commissioner,John Doak,REP,400309,0,0,2,2,
Leflore,Corporation Commissioner,Todd Hiett,REP,400309,0,0,2,2,
Leflore,Corporation Commissioner,Cliff Branan,REP,400309,0,0,1,1,
Leflore,U.S. Senate,Evelyn Rogers,REP,400309,0,0,0,0,
Leflore,U.S. Senate,Rob Moye,REP,400309,0,0,0,0,
Leflore,U.S. Senate,D. Jean Mcbride-Samuels,REP,400309,0,0,0,0,
Leflore,U.S. Senate,Jim Inhofe,REP,400309,0,0,3,3,
Leflore,U.S. Senate,Erick Paul Wyatt,REP,400309,0,0,0,0,
Leflore,U.S. Senate,Andy Craig,REP,400309,0,0,0,0,
Leflore,U.S. Senate,T. Shannon,REP,400309,0,0,1,1,
Leflore,U.S. Senate,Randy Brogdon,REP,400309,0,0,0,0,
Leflore,U.S. Senate,Eric Mccray,REP,400309,0,0,0,0,
Leflore,U.S. Senate,Kevin Crow,REP,400309,0,0,0,0,
Leflore,U.S. Senate,James Lankford,REP,400309,0,0,2,2,
Leflore,U.S. Senate,Jason Weger,REP,400309,0,0,0,0,
Leflore,U.S. House,Darrel Robertson,REP,400309,0,0,0,0,02
Leflore,U.S. House,Markwayne Mullin,REP,400309,0,0,3,3,02
Leflore,State Senate,Joseph Silk,REP,400309,0,0,2,2,5
Leflore,State Senate,Brent Shain,REP,400309,0,0,1,1,5
Leflore,Superintendent of Public Instruction,John Cox,DEM,400310,0,10,149,159,
Leflore,Superintendent of Public Instruction,Jack Jr.,DEM,400310,1,4,52,57,
Leflore,Superintendent of Public Instruction,Ivan Holmes,DEM,400310,0,0,14,14,
Leflore,Superintendent of Public Instruction,Freda Deskin,DEM,400310,1,3,35,39,
Leflore,U.S. Senate,Patrick Michael Hayes,DEM,400310,1,4,51,56,
Leflore,U.S. Senate,Jim Rogers,DEM,400310,1,8,119,128,
Leflore,U.S. Senate,Connie Johnson,DEM,400310,0,5,52,57,
Leflore,U.S. House,Earl Everett,DEM,400310,1,8,147,156,02
Leflore,U.S. House,Joshua Harris-Till,DEM,400310,1,9,68,78,02
Leflore,Governor,Dax Ewbank,REP,400310,0,0,8,8,
Leflore,Governor,Chad Moody,REP,400310,0,0,17,17,
Leflore,Governor,Mary Fallin,REP,400310,0,2,30,32,
Leflore,Superintendent of Public Instruction,Brian Kelly,REP,400310,0,2,22,24,
Leflore,Superintendent of Public Instruction,Janet Costello Barresi,REP,400310,0,0,10,10,
Leflore,Superintendent of Public Instruction,Joy Hofmeister,REP,400310,0,0,23,23,
Leflore,Insurance Commissioner,Bill Viner,REP,400310,0,1,22,23,
Leflore,Insurance Commissioner,John Doak,REP,400310,0,0,31,31,
Leflore,Corporation Commissioner,Todd Hiett,REP,400310,0,2,24,26,
Leflore,Corporation Commissioner,Cliff Branan,REP,400310,0,0,28,28,
Leflore,U.S. Senate,Evelyn Rogers,REP,400310,0,0,8,8,
Leflore,U.S. Senate,Rob Moye,REP,400310,0,0,0,0,
Leflore,U.S. Senate,D. Jean Mcbride-Samuels,REP,400310,0,0,2,2,
Leflore,U.S. Senate,Jim Inhofe,REP,400310,0,2,38,40,
Leflore,U.S. Senate,Erick Paul Wyatt,REP,400310,0,0,6,6,
Leflore,U.S. Senate,Andy Craig,REP,400310,0,0,3,3,
Leflore,U.S. Senate,T. Shannon,REP,400310,0,2,20,22,
Leflore,U.S. Senate,Randy Brogdon,REP,400310,0,0,3,3,
Leflore,U.S. Senate,Eric Mccray,REP,400310,0,0,1,1,
Leflore,U.S. Senate,Kevin Crow,REP,400310,0,0,0,0,
Leflore,U.S. Senate,James Lankford,REP,400310,0,0,28,28,
Leflore,U.S. Senate,Jason Weger,REP,400310,0,0,0,0,
Leflore,U.S. House,Darrel Robertson,REP,400310,0,0,25,25,02
Leflore,U.S. House,Markwayne Mullin,REP,400310,0,2,31,33,02
Leflore,State Senate,Joseph Silk,REP,400310,0,2,35,37,5
Leflore,State Senate,Brent Shain,REP,400310,0,0,18,18,5
Leflore,Superintendent of Public Instruction,John Cox,DEM,400311,2,1,116,119,
Leflore,Superintendent of Public Instruction,Jack Jr.,DEM,400311,0,0,14,14,
Leflore,Superintendent of Public Instruction,Ivan Holmes,DEM,400311,0,0,18,18,
Leflore,Superintendent of Public Instruction,Freda Deskin,DEM,400311,1,3,23,27,
Leflore,U.S. Senate,Patrick Michael Hayes,DEM,400311,2,1,19,22,
Leflore,U.S. Senate,Jim Rogers,DEM,400311,0,1,92,93,
Leflore,U.S. Senate,Connie Johnson,DEM,400311,1,2,48,51,
Leflore,U.S. House,Earl Everett,DEM,400311,1,1,79,81,02
Leflore,U.S. House,Joshua Harris-Till,DEM,400311,2,3,72,77,02
Leflore,Governor,Dax Ewbank,REP,400311,0,0,1,1,
Leflore,Governor,Chad Moody,REP,400311,0,0,7,7,
Leflore,Governor,Mary Fallin,REP,400311,0,1,31,32,
Leflore,Superintendent of Public Instruction,Brian Kelly,REP,400311,0,1,12,13,
Leflore,Superintendent of Public Instruction,Janet Costello Barresi,REP,400311,0,0,11,11,
Leflore,Superintendent of Public Instruction,Joy Hofmeister,REP,400311,0,0,15,15,
Leflore,Insurance Commissioner,Bill Viner,REP,400311,0,0,12,12,
Leflore,Insurance Commissioner,John Doak,REP,400311,0,1,23,24,
Leflore,Corporation Commissioner,Todd Hiett,REP,400311,0,0,22,22,
Leflore,Corporation Commissioner,Cliff Branan,REP,400311,0,1,17,18,
Leflore,U.S. Senate,Evelyn Rogers,REP,400311,0,0,2,2,
Leflore,U.S. Senate,Rob Moye,REP,400311,0,0,2,2,
Leflore,U.S. Senate,D. Jean Mcbride-Samuels,REP,400311,0,0,2,2,
Leflore,U.S. Senate,Jim Inhofe,REP,400311,0,0,33,33,
Leflore,U.S. Senate,Erick Paul Wyatt,REP,400311,0,1,2,3,
Leflore,U.S. Senate,Andy Craig,REP,400311,0,0,3,3,
Leflore,U.S. Senate,T. Shannon,REP,400311,0,0,23,23,
Leflore,U.S. Senate,Randy Brogdon,REP,400311,0,0,2,2,
Leflore,U.S. Senate,Eric Mccray,REP,400311,0,0,0,0,
Leflore,U.S. Senate,Kevin Crow,REP,400311,0,0,0,0,
Leflore,U.S. Senate,James Lankford,REP,400311,0,1,13,14,
Leflore,U.S. Senate,Jason Weger,REP,400311,0,0,0,0,
Leflore,U.S. House,Darrel Robertson,REP,400311,0,0,8,8,02
Leflore,U.S. House,Markwayne Mullin,REP,400311,0,1,32,33,02
Leflore,State Senate,Joseph Silk,REP,400311,0,1,21,22,5
Leflore,State Senate,Brent Shain,REP,400311,0,0,15,15,5
Leflore,Superintendent of Public Instruction,John Cox,DEM,400312,0,10,121,131,
Leflore,Superintendent of Public Instruction,Jack Jr.,DEM,400312,0,1,16,17,
Leflore,Superintendent of Public Instruction,Ivan Holmes,DEM,400312,1,0,6,7,
Leflore,Superintendent of Public Instruction,Freda Deskin,DEM,400312,0,1,17,18,
Leflore,U.S. Senate,Patrick Michael Hayes,DEM,400312,0,3,29,32,
Leflore,U.S. Senate,Jim Rogers,DEM,400312,1,6,81,88,
Leflore,U.S. Senate,Connie Johnson,DEM,400312,0,3,31,34,
Leflore,U.S. House,Earl Everett,DEM,400312,1,5,82,88,02
Leflore,U.S. House,Joshua Harris-Till,DEM,400312,0,7,56,63,02
Leflore,Governor,Dax Ewbank,REP,400312,0,0,3,3,
Leflore,Governor,Chad Moody,REP,400312,0,1,2,3,
Leflore,Governor,Mary Fallin,REP,400312,0,1,16,17,
Leflore,Superintendent of Public Instruction,Brian Kelly,REP,400312,0,1,8,9,
Leflore,Superintendent of Public Instruction,Janet Costello Barresi,REP,400312,0,0,7,7,
Leflore,Superintendent of Public Instruction,Joy Hofmeister,REP,400312,0,1,7,8,
Leflore,Insurance Commissioner,Bill Viner,REP,400312,0,0,6,6,
Leflore,Insurance Commissioner,John Doak,REP,400312,0,2,15,17,
Leflore,Corporation Commissioner,Todd Hiett,REP,400312,0,2,11,13,
Leflore,Corporation Commissioner,Cliff Branan,REP,400312,0,0,8,8,
Leflore,U.S. Senate,Evelyn Rogers,REP,400312,0,0,0,0,
Leflore,U.S. Senate,Rob Moye,REP,400312,0,0,0,0,
Leflore,U.S. Senate,D. Jean Mcbride-Samuels,REP,400312,0,0,1,1,
Leflore,U.S. Senate,Jim Inhofe,REP,400312,0,2,21,23,
Leflore,U.S. Senate,Erick Paul Wyatt,REP,400312,0,0,0,0,
Leflore,U.S. Senate,Andy Craig,REP,400312,0,0,1,1,
Leflore,U.S. Senate,T. Shannon,REP,400312,0,0,4,4,
Leflore,U.S. Senate,Randy Brogdon,REP,400312,0,0,0,0,
Leflore,U.S. Senate,Eric Mccray,REP,400312,0,0,0,0,
Leflore,U.S. Senate,Kevin Crow,REP,400312,0,0,1,1,
Leflore,U.S. Senate,James Lankford,REP,400312,0,2,15,17,
Leflore,U.S. Senate,Jason Weger,REP,400312,0,0,1,1,
Leflore,U.S. House,Darrel Robertson,REP,400312,0,0,9,9,02
Leflore,U.S. House,Markwayne Mullin,REP,400312,0,2,13,15,02
Leflore,State Senate,Joseph Silk,REP,400312,0,2,16,18,5
Leflore,State Senate,Brent Shain,REP,400312,0,0,4,4,5
Lincoln,Superintendent of Public Instruction,John Cox,DEM,410001,2,2,29,33,
Lincoln,Superintendent of Public Instruction,Jack Jr.,DEM,410001,1,0,6,7,
Lincoln,Superintendent of Public Instruction,Ivan Holmes,DEM,410001,2,0,12,14,
Lincoln,Superintendent of Public Instruction,Freda Deskin,DEM,410001,1,0,29,30,
Lincoln,U.S. Senate,Patrick Michael Hayes,DEM,410001,3,0,22,25,
Lincoln,U.S. Senate,Jim Rogers,DEM,410001,3,1,27,31,
Lincoln,U.S. Senate,Connie Johnson,DEM,410001,0,1,24,25,
Lincoln,State Senate,Marilyn Rainwater,DEM,410001,6,2,51,59,28
Lincoln,State Senate,Billy Hinton,DEM,410001,0,0,21,21,28
Lincoln,State House,Jamey White,DEM,410001,2,2,17,21,32
Lincoln,State House,Michial Poteet,DEM,410001,4,0,55,59,32
Lincoln,Governor,Dax Ewbank,REP,410001,0,0,9,9,
Lincoln,Governor,Chad Moody,REP,410001,0,1,13,14,
Lincoln,Governor,Mary Fallin,REP,410001,5,5,114,124,
Lincoln,Superintendent of Public Instruction,Brian Kelly,REP,410001,1,2,35,38,
Lincoln,Superintendent of Public Instruction,Janet Costello Barresi,REP,410001,2,2,17,21,
Lincoln,Superintendent of Public Instruction,Joy Hofmeister,REP,410001,2,3,81,86,
Lincoln,Insurance Commissioner,Bill Viner,REP,410001,1,0,14,15,
Lincoln,Insurance Commissioner,John Doak,REP,410001,4,7,113,124,
Lincoln,Corporation Commissioner,Todd Hiett,REP,410001,4,6,60,70,
Lincoln,Corporation Commissioner,Cliff Branan,REP,410001,1,1,67,69,
Lincoln,U.S. Senate,Evelyn Rogers,REP,410001,0,0,10,10,
Lincoln,U.S. Senate,Rob Moye,REP,410001,0,0,1,1,
Lincoln,U.S. Senate,D. Jean Mcbride-Samuels,REP,410001,0,0,3,3,
Lincoln,U.S. Senate,Jim Inhofe,REP,410001,5,7,112,124,
Lincoln,U.S. Senate,Erick Paul Wyatt,REP,410001,0,0,6,6,
Lincoln,U.S. Senate,Andy Craig,REP,410001,0,0,0,0,
Lincoln,U.S. Senate,T. Shannon,REP,410001,0,3,50,53,
Lincoln,U.S. Senate,Randy Brogdon,REP,410001,0,0,3,3,
Lincoln,U.S. Senate,Eric Mccray,REP,410001,0,0,0,0,
Lincoln,U.S. Senate,Kevin Crow,REP,410001,0,0,1,1,
Lincoln,U.S. Senate,James Lankford,REP,410001,5,4,80,89,
Lincoln,U.S. Senate,Jason Weger,REP,410001,0,0,1,1,
Lincoln,U.S. House,Timothy Ray Murray,REP,410001,0,0,7,7,03
Lincoln,U.S. House,Robert Hubbard,REP,410001,0,0,14,14,03
Lincoln,U.S. House,Frank Lucas,REP,410001,5,7,110,122,03
Lincoln,State Senate,Jason Smalley,REP,410001,5,5,112,122,28
Lincoln,State Senate,Danny Williams,REP,410001,0,2,10,12,28
Lincoln,State Senate,Charles Mashek,REP,410001,0,0,1,1,28
Lincoln,State Senate,Joe Dobry,REP,410001,0,0,5,5,28
Lincoln,State Senate,Michael Ballard,REP,410001,0,0,7,7,28
Lincoln,State House,Kevin Wallace,REP,410001,4,7,98,109,32
Lincoln,State House,Ray Wade,REP,410001,1,0,32,33,32
Lincoln,Superintendent of Public Instruction,John Cox,DEM,410002,0,0,46,46,
Lincoln,Superintendent of Public Instruction,Jack Jr.,DEM,410002,0,0,9,9,
Lincoln,Superintendent of Public Instruction,Ivan Holmes,DEM,410002,0,0,11,11,
Lincoln,Superintendent of Public Instruction,Freda Deskin,DEM,410002,3,0,41,44,
Lincoln,U.S. Senate,Patrick Michael Hayes,DEM,410002,0,0,26,26,
Lincoln,U.S. Senate,Jim Rogers,DEM,410002,1,0,46,47,
Lincoln,U.S. Senate,Connie Johnson,DEM,410002,2,0,30,32,
Lincoln,State Senate,Marilyn Rainwater,DEM,410002,2,0,74,76,28
Lincoln,State Senate,Billy Hinton,DEM,410002,1,0,28,29,28
Lincoln,State House,Jamey White,DEM,410002,1,0,37,38,32
Lincoln,State House,Michial Poteet,DEM,410002,2,0,65,67,32
Lincoln,Governor,Dax Ewbank,REP,410002,0,1,8,9,
Lincoln,Governor,Chad Moody,REP,410002,0,1,22,23,
Lincoln,Governor,Mary Fallin,REP,410002,0,1,124,125,
Lincoln,Superintendent of Public Instruction,Brian Kelly,REP,410002,0,0,46,46,
Lincoln,Superintendent of Public Instruction,Janet Costello Barresi,REP,410002,0,2,28,30,
Lincoln,Superintendent of Public Instruction,Joy Hofmeister,REP,410002,0,1,79,80,
Lincoln,Insurance Commissioner,Bill Viner,REP,410002,0,1,30,31,
Lincoln,Insurance Commissioner,John Doak,REP,410002,0,2,117,119,
Lincoln,Corporation Commissioner,Todd Hiett,REP,410002,0,3,73,76,
Lincoln,Corporation Commissioner,Cliff Branan,REP,410002,0,0,75,75,
Lincoln,U.S. Senate,Evelyn Rogers,REP,410002,0,1,8,9,
Lincoln,U.S. Senate,Rob Moye,REP,410002,0,0,2,2,
Lincoln,U.S. Senate,D. Jean Mcbride-Samuels,REP,410002,0,0,3,3,
Lincoln,U.S. Senate,Jim Inhofe,REP,410002,0,2,136,138,
Lincoln,U.S. Senate,Erick Paul Wyatt,REP,410002,0,0,4,4,
Lincoln,U.S. Senate,Andy Craig,REP,410002,0,0,2,2,
Lincoln,U.S. Senate,T. Shannon,REP,410002,0,0,54,54,
Lincoln,U.S. Senate,Randy Brogdon,REP,410002,0,1,4,5,
Lincoln,U.S. Senate,Eric Mccray,REP,410002,0,0,1,1,
Lincoln,U.S. Senate,Kevin Crow,REP,410002,0,1,2,3,
Lincoln,U.S. Senate,James Lankford,REP,410002,0,1,91,92,
Lincoln,U.S. Senate,Jason Weger,REP,410002,0,0,1,1,
Lincoln,U.S. House,Timothy Ray Murray,REP,410002,0,0,6,6,03
Lincoln,U.S. House,Robert Hubbard,REP,410002,0,1,16,17,03
Lincoln,U.S. House,Frank Lucas,REP,410002,0,2,130,132,03
Lincoln,State Senate,Jason Smalley,REP,410002,0,2,128,130,28
Lincoln,State Senate,Danny Williams,REP,410002,0,0,13,13,28
Lincoln,State Senate,Charles Mashek,REP,410002,0,0,2,2,28
Lincoln,State Senate,Joe Dobry,REP,410002,0,1,13,14,28
Lincoln,State Senate,Michael Ballard,REP,410002,0,0,1,1,28
Lincoln,State House,Kevin Wallace,REP,410002,0,1,115,116,32
Lincoln,State House,Ray Wade,REP,410002,0,2,34,36,32
Lincoln,Superintendent of Public Instruction,John Cox,DEM,410003,2,2,44,48,
Lincoln,Superintendent of Public Instruction,Jack Jr.,DEM,410003,0,2,20,22,
Lincoln,Superintendent of Public Instruction,Ivan Holmes,DEM,410003,0,1,16,17,
Lincoln,Superintendent of Public Instruction,Freda Deskin,DEM,410003,2,3,26,31,
Lincoln,U.S. Senate,Patrick Michael Hayes,DEM,410003,1,2,27,30,
Lincoln,U.S. Senate,Jim Rogers,DEM,410003,1,2,57,60,
Lincoln,U.S. Senate,Connie Johnson,DEM,410003,1,3,19,23,
Lincoln,State Senate,Marilyn Rainwater,DEM,410003,1,6,55,62,28
Lincoln,State Senate,Billy Hinton,DEM,410003,3,2,53,58,28
Lincoln,State House,Jamey White,DEM,410003,2,0,31,33,32
Lincoln,State House,Michial Poteet,DEM,410003,2,8,76,86,32
Lincoln,Governor,Dax Ewbank,REP,410003,0,4,27,31,
Lincoln,Governor,Chad Moody,REP,410003,0,11,42,53,
Lincoln,Governor,Mary Fallin,REP,410003,3,8,114,125,
Lincoln,Superintendent of Public Instruction,Brian Kelly,REP,410003,1,6,54,61,
Lincoln,Superintendent of Public Instruction,Janet Costello Barresi,REP,410003,1,4,21,26,
Lincoln,Superintendent of Public Instruction,Joy Hofmeister,REP,410003,1,12,103,116,
Lincoln,Insurance Commissioner,Bill Viner,REP,410003,0,11,31,42,
Lincoln,Insurance Commissioner,John Doak,REP,410003,3,11,146,160,
Lincoln,Corporation Commissioner,Todd Hiett,REP,410003,0,15,95,110,
Lincoln,Corporation Commissioner,Cliff Branan,REP,410003,3,7,86,96,
Lincoln,U.S. Senate,Evelyn Rogers,REP,410003,0,1,7,8,
Lincoln,U.S. Senate,Rob Moye,REP,410003,0,1,5,6,
Lincoln,U.S. Senate,D. Jean Mcbride-Samuels,REP,410003,0,0,2,2,
Lincoln,U.S. Senate,Jim Inhofe,REP,410003,3,19,160,182,
Lincoln,U.S. Senate,Erick Paul Wyatt,REP,410003,0,2,9,11,
Lincoln,U.S. Senate,Andy Craig,REP,410003,0,0,1,1,
Lincoln,U.S. Senate,T. Shannon,REP,410003,0,4,65,69,
Lincoln,U.S. Senate,Randy Brogdon,REP,410003,0,1,3,4,
Lincoln,U.S. Senate,Eric Mccray,REP,410003,0,0,2,2,
Lincoln,U.S. Senate,Kevin Crow,REP,410003,0,0,8,8,
Lincoln,U.S. Senate,James Lankford,REP,410003,3,18,103,124,
Lincoln,U.S. Senate,Jason Weger,REP,410003,0,0,1,1,
Lincoln,U.S. House,Timothy Ray Murray,REP,410003,0,2,13,15,03
Lincoln,U.S. House,Robert Hubbard,REP,410003,0,2,27,29,03
Lincoln,U.S. House,Frank Lucas,REP,410003,3,19,143,165,03
Lincoln,State Senate,Jason Smalley,REP,410003,1,20,134,155,28
Lincoln,State Senate,Danny Williams,REP,410003,1,1,22,24,28
Lincoln,State Senate,Charles Mashek,REP,410003,0,0,6,6,28
Lincoln,State Senate,Joe Dobry,REP,410003,1,2,18,21,28
Lincoln,State Senate,Michael Ballard,REP,410003,0,0,3,3,28
Lincoln,State House,Kevin Wallace,REP,410003,2,16,118,136,32
Lincoln,State House,Ray Wade,REP,410003,0,7,64,71,32
Lincoln,Superintendent of Public Instruction,John Cox,DEM,410004,1,0,20,21,
Lincoln,Superintendent of Public Instruction,Jack Jr.,DEM,410004,0,0,8,8,
Lincoln,Superintendent of Public Instruction,Ivan Holmes,DEM,410004,0,0,2,2,
Lincoln,Superintendent of Public Instruction,Freda Deskin,DEM,410004,0,0,12,12,
Lincoln,U.S. Senate,Patrick Michael Hayes,DEM,410004,0,0,12,12,
Lincoln,U.S. Senate,Jim Rogers,DEM,410004,0,0,18,18,
Lincoln,U.S. Senate,Connie Johnson,DEM,410004,1,0,12,13,
Lincoln,State Senate,Marilyn Rainwater,DEM,410004,1,0,26,27,28
Lincoln,State Senate,Billy Hinton,DEM,410004,0,0,16,16,28
Lincoln,State House,Jamey White,DEM,410004,0,0,8,8,32
Lincoln,State House,Michial Poteet,DEM,410004,1,0,33,34,32
Lincoln,Governor,Dax Ewbank,REP,410004,1,0,4,5,
Lincoln,Governor,Chad Moody,REP,410004,0,0,25,25,
Lincoln,Governor,Mary Fallin,REP,410004,0,5,69,74,
Lincoln,Superintendent of Public Instruction,Brian Kelly,REP,410004,0,1,40,41,
Lincoln,Superintendent of Public Instruction,Janet Costello Barresi,REP,410004,0,1,12,13,
Lincoln,Superintendent of Public Instruction,Joy Hofmeister,REP,410004,1,3,46,50,
Lincoln,Insurance Commissioner,Bill Viner,REP,410004,0,0,22,22,
Lincoln,Insurance Commissioner,John Doak,REP,410004,1,5,72,78,
Lincoln,Corporation Commissioner,Todd Hiett,REP,410004,1,2,53,56,
Lincoln,Corporation Commissioner,Cliff Branan,REP,410004,0,3,43,46,
Lincoln,U.S. Senate,Evelyn Rogers,REP,410004,0,0,3,3,
Lincoln,U.S. Senate,Rob Moye,REP,410004,0,0,0,0,
Lincoln,U.S. Senate,D. Jean Mcbride-Samuels,REP,410004,0,0,4,4,
Lincoln,U.S. Senate,Jim Inhofe,REP,410004,0,5,87,92,
Lincoln,U.S. Senate,Erick Paul Wyatt,REP,410004,1,0,5,6,
Lincoln,U.S. Senate,Andy Craig,REP,410004,0,0,0,0,
Lincoln,U.S. Senate,T. Shannon,REP,410004,0,3,34,37,
Lincoln,U.S. Senate,Randy Brogdon,REP,410004,0,0,1,1,
Lincoln,U.S. Senate,Eric Mccray,REP,410004,0,0,1,1,
Lincoln,U.S. Senate,Kevin Crow,REP,410004,0,0,1,1,
Lincoln,U.S. Senate,James Lankford,REP,410004,1,2,62,65,
Lincoln,U.S. Senate,Jason Weger,REP,410004,0,0,0,0,
Lincoln,U.S. House,Timothy Ray Murray,REP,410004,0,0,5,5,03
Lincoln,U.S. House,Robert Hubbard,REP,410004,0,0,17,17,03
Lincoln,U.S. House,Frank Lucas,REP,410004,1,5,77,83,03
Lincoln,State Senate,Jason Smalley,REP,410004,1,3,65,69,28
Lincoln,State Senate,Danny Williams,REP,410004,0,0,11,11,28
Lincoln,State Senate,Charles Mashek,REP,410004,0,0,2,2,28
Lincoln,State Senate,Joe Dobry,REP,410004,0,2,15,17,28
Lincoln,State Senate,Michael Ballard,REP,410004,0,0,6,6,28
Lincoln,State House,Kevin Wallace,REP,410004,1,3,62,66,32
Lincoln,State House,Ray Wade,REP,410004,0,2,34,36,32
Lincoln,Superintendent of Public Instruction,John Cox,DEM,410005,0,4,52,56,
Lincoln,Superintendent of Public Instruction,Jack Jr.,DEM,410005,0,0,12,12,
Lincoln,Superintendent of Public Instruction,Ivan Holmes,DEM,410005,1,0,12,13,
Lincoln,Superintendent of Public Instruction,Freda Deskin,DEM,410005,3,0,46,49,
Lincoln,U.S. Senate,Patrick Michael Hayes,DEM,410005,0,2,32,34,
Lincoln,U.S. Senate,Jim Rogers,DEM,410005,1,1,48,50,
Lincoln,U.S. Senate,Connie Johnson,DEM,410005,3,1,40,44,
Lincoln,State Senate,Marilyn Rainwater,DEM,410005,3,2,62,67,28
Lincoln,State Senate,Billy Hinton,DEM,410005,1,2,56,59,28
Lincoln,State House,Jamey White,DEM,410005,0,1,10,11,32
Lincoln,State House,Michial Poteet,DEM,410005,5,3,124,132,32
Lincoln,Governor,Dax Ewbank,REP,410005,1,1,7,9,
Lincoln,Governor,Chad Moody,REP,410005,0,0,21,21,
Lincoln,Governor,Mary Fallin,REP,410005,3,10,92,105,
Lincoln,Superintendent of Public Instruction,Brian Kelly,REP,410005,2,6,31,39,
Lincoln,Superintendent of Public Instruction,Janet Costello Barresi,REP,410005,1,0,25,26,
Lincoln,Superintendent of Public Instruction,Joy Hofmeister,REP,410005,1,5,62,68,
Lincoln,Insurance Commissioner,Bill Viner,REP,410005,0,0,22,22,
Lincoln,Insurance Commissioner,John Doak,REP,410005,4,10,90,104,
Lincoln,Corporation Commissioner,Todd Hiett,REP,410005,3,8,60,71,
Lincoln,Corporation Commissioner,Cliff Branan,REP,410005,1,2,47,50,
Lincoln,U.S. Senate,Evelyn Rogers,REP,410005,0,0,3,3,
Lincoln,U.S. Senate,Rob Moye,REP,410005,0,0,0,0,
Lincoln,U.S. Senate,D. Jean Mcbride-Samuels,REP,410005,1,0,2,3,
Lincoln,U.S. Senate,Jim Inhofe,REP,410005,2,11,109,122,
Lincoln,U.S. Senate,Erick Paul Wyatt,REP,410005,1,0,5,6,
Lincoln,U.S. Senate,Andy Craig,REP,410005,0,0,1,1,
Lincoln,U.S. Senate,T. Shannon,REP,410005,1,1,42,44,
Lincoln,U.S. Senate,Randy Brogdon,REP,410005,0,0,6,6,
Lincoln,U.S. Senate,Eric Mccray,REP,410005,0,0,1,1,
Lincoln,U.S. Senate,Kevin Crow,REP,410005,0,0,0,0,
Lincoln,U.S. Senate,James Lankford,REP,410005,3,10,68,81,
Lincoln,U.S. Senate,Jason Weger,REP,410005,0,0,1,1,
Lincoln,U.S. House,Timothy Ray Murray,REP,410005,1,0,3,4,03
Lincoln,U.S. House,Robert Hubbard,REP,410005,3,1,17,21,03
Lincoln,U.S. House,Frank Lucas,REP,410005,0,10,98,108,03
Lincoln,State Senate,Jason Smalley,REP,410005,2,7,91,100,28
Lincoln,State Senate,Danny Williams,REP,410005,1,3,8,12,28
Lincoln,State Senate,Charles Mashek,REP,410005,0,1,5,6,28
Lincoln,State Senate,Joe Dobry,REP,410005,1,0,16,17,28
Lincoln,State Senate,Michael Ballard,REP,410005,0,0,1,1,28
Lincoln,State House,Kevin Wallace,REP,410005,3,8,71,82,32
Lincoln,State House,Ray Wade,REP,410005,1,3,40,44,32
Lincoln,Superintendent of Public Instruction,John Cox,DEM,410006,0,0,19,19,
Lincoln,Superintendent of Public Instruction,Jack Jr.,DEM,410006,0,0,6,6,
Lincoln,Superintendent of Public Instruction,Ivan Holmes,DEM,410006,0,0,3,3,
Lincoln,Superintendent of Public Instruction,Freda Deskin,DEM,410006,0,0,21,21,
Lincoln,U.S. Senate,Patrick Michael Hayes,DEM,410006,0,0,6,6,
Lincoln,U.S. Senate,Jim Rogers,DEM,410006,0,0,16,16,
Lincoln,U.S. Senate,Connie Johnson,DEM,410006,0,0,26,26,
Lincoln,State Senate,Marilyn Rainwater,DEM,410006,0,0,27,27,28
Lincoln,State Senate,Billy Hinton,DEM,410006,0,0,21,21,28
Lincoln,State House,Jamey White,DEM,410006,0,0,7,7,32
Lincoln,State House,Michial Poteet,DEM,410006,0,0,46,46,32
Lincoln,Governor,Dax Ewbank,REP,410006,0,0,4,4,
Lincoln,Governor,Chad Moody,REP,410006,0,0,6,6,
Lincoln,Governor,Mary Fallin,REP,410006,1,0,52,53,
Lincoln,Superintendent of Public Instruction,Brian Kelly,REP,410006,0,0,20,20,
Lincoln,Superintendent of Public Instruction,Janet Costello Barresi,REP,410006,0,0,14,14,
Lincoln,Superintendent of Public Instruction,Joy Hofmeister,REP,410006,1,0,29,30,
Lincoln,Insurance Commissioner,Bill Viner,REP,410006,0,0,14,14,
Lincoln,Insurance Commissioner,John Doak,REP,410006,1,0,47,48,
Lincoln,Corporation Commissioner,Todd Hiett,REP,410006,1,0,29,30,
Lincoln,Corporation Commissioner,Cliff Branan,REP,410006,0,0,32,32,
Lincoln,U.S. Senate,Evelyn Rogers,REP,410006,0,0,3,3,
Lincoln,U.S. Senate,Rob Moye,REP,410006,0,0,0,0,
Lincoln,U.S. Senate,D. Jean Mcbride-Samuels,REP,410006,0,0,1,1,
Lincoln,U.S. Senate,Jim Inhofe,REP,410006,1,0,53,54,
Lincoln,U.S. Senate,Erick Paul Wyatt,REP,410006,0,0,4,4,
Lincoln,U.S. Senate,Andy Craig,REP,410006,0,0,0,0,
Lincoln,U.S. Senate,T. Shannon,REP,410006,1,0,24,25,
Lincoln,U.S. Senate,Randy Brogdon,REP,410006,0,0,0,0,
Lincoln,U.S. Senate,Eric Mccray,REP,410006,0,0,0,0,
Lincoln,U.S. Senate,Kevin Crow,REP,410006,0,0,0,0,
Lincoln,U.S. Senate,James Lankford,REP,410006,0,0,38,38,
Lincoln,U.S. Senate,Jason Weger,REP,410006,0,0,1,1,
Lincoln,U.S. House,Timothy Ray Murray,REP,410006,0,0,4,4,03
Lincoln,U.S. House,Robert Hubbard,REP,410006,0,0,7,7,03
Lincoln,U.S. House,Frank Lucas,REP,410006,1,0,53,54,03
Lincoln,State Senate,Jason Smalley,REP,410006,1,0,47,48,28
Lincoln,State Senate,Danny Williams,REP,410006,0,0,3,3,28
Lincoln,State Senate,Charles Mashek,REP,410006,0,0,1,1,28
Lincoln,State Senate,Joe Dobry,REP,410006,0,0,10,10,28
Lincoln,State Senate,Michael Ballard,REP,410006,0,0,1,1,28
Lincoln,State House,Kevin Wallace,REP,410006,0,0,43,43,32
Lincoln,State House,Ray Wade,REP,410006,1,0,19,20,32
Lincoln,Superintendent of Public Instruction,John Cox,DEM,410007,2,0,30,32,
Lincoln,Superintendent of Public Instruction,Jack Jr.,DEM,410007,0,0,3,3,
Lincoln,Superintendent of Public Instruction,Ivan Holmes,DEM,410007,1,0,5,6,
Lincoln,Superintendent of Public Instruction,Freda Deskin,DEM,410007,0,0,20,20,
Lincoln,U.S. Senate,Patrick Michael Hayes,DEM,410007,0,0,21,21,
Lincoln,U.S. Senate,Jim Rogers,DEM,410007,0,0,20,20,
Lincoln,U.S. Senate,Connie Johnson,DEM,410007,3,0,16,19,
Lincoln,State Senate,Marilyn Rainwater,DEM,410007,3,0,36,39,28
Lincoln,State Senate,Billy Hinton,DEM,410007,0,0,23,23,28
Lincoln,State House,Jamey White,DEM,410007,1,0,15,16,32
Lincoln,State House,Michial Poteet,DEM,410007,2,0,54,56,32
Lincoln,Governor,Dax Ewbank,REP,410007,0,0,7,7,
Lincoln,Governor,Chad Moody,REP,410007,0,0,14,14,
Lincoln,Governor,Mary Fallin,REP,410007,3,2,62,67,
Lincoln,Superintendent of Public Instruction,Brian Kelly,REP,410007,1,2,33,36,
Lincoln,Superintendent of Public Instruction,Janet Costello Barresi,REP,410007,1,0,14,15,
Lincoln,Superintendent of Public Instruction,Joy Hofmeister,REP,410007,0,0,34,34,
Lincoln,Insurance Commissioner,Bill Viner,REP,410007,0,0,19,19,
Lincoln,Insurance Commissioner,John Doak,REP,410007,2,2,58,62,
Lincoln,Corporation Commissioner,Todd Hiett,REP,410007,1,2,39,42,
Lincoln,Corporation Commissioner,Cliff Branan,REP,410007,1,0,35,36,
Lincoln,U.S. Senate,Evelyn Rogers,REP,410007,0,0,4,4,
Lincoln,U.S. Senate,Rob Moye,REP,410007,0,0,0,0,
Lincoln,U.S. Senate,D. Jean Mcbride-Samuels,REP,410007,0,0,3,3,
Lincoln,U.S. Senate,Jim Inhofe,REP,410007,3,2,67,72,
Lincoln,U.S. Senate,Erick Paul Wyatt,REP,410007,0,0,5,5,
Lincoln,U.S. Senate,Andy Craig,REP,410007,0,0,2,2,
Lincoln,U.S. Senate,T. Shannon,REP,410007,1,0,24,25,
Lincoln,U.S. Senate,Randy Brogdon,REP,410007,0,0,0,0,
Lincoln,U.S. Senate,Eric Mccray,REP,410007,0,0,0,0,
Lincoln,U.S. Senate,Kevin Crow,REP,410007,0,0,5,5,
Lincoln,U.S. Senate,James Lankford,REP,410007,2,2,50,54,
Lincoln,U.S. Senate,Jason Weger,REP,410007,0,0,0,0,
Lincoln,U.S. House,Timothy Ray Murray,REP,410007,0,0,4,4,03
Lincoln,U.S. House,Robert Hubbard,REP,410007,0,2,8,10,03
Lincoln,U.S. House,Frank Lucas,REP,410007,3,0,68,71,03
Lincoln,State Senate,Jason Smalley,REP,410007,1,2,61,64,28
Lincoln,State Senate,Danny Williams,REP,410007,1,0,4,5,28
Lincoln,State Senate,Charles Mashek,REP,410007,0,0,2,2,28
Lincoln,State Senate,Joe Dobry,REP,410007,0,0,13,13,28
Lincoln,State Senate,Michael Ballard,REP,410007,0,0,3,3,28
Lincoln,State House,Kevin Wallace,REP,410007,0,2,47,49,32
Lincoln,State House,Ray Wade,REP,410007,2,0,34,36,32
Lincoln,Superintendent of Public Instruction,John Cox,DEM,410008,1,1,39,41,
Lincoln,Superintendent of Public Instruction,Jack Jr.,DEM,410008,0,0,10,10,
Lincoln,Superintendent of Public Instruction,Ivan Holmes,DEM,410008,0,1,7,8,
Lincoln,Superintendent of Public Instruction,Freda Deskin,DEM,410008,2,4,54,60,
Lincoln,U.S. Senate,Patrick Michael Hayes,DEM,410008,0,1,24,25,
Lincoln,U.S. Senate,Jim Rogers,DEM,410008,1,3,41,45,
Lincoln,U.S. Senate,Connie Johnson,DEM,410008,2,2,46,50,
Lincoln,State Senate,Marilyn Rainwater,DEM,410008,2,3,60,65,28
Lincoln,State Senate,Billy Hinton,DEM,410008,1,3,46,50,28
Lincoln,State House,Jamey White,DEM,410008,1,1,29,31,32
Lincoln,State House,Michial Poteet,DEM,410008,2,5,78,85,32
Lincoln,Governor,Dax Ewbank,REP,410008,0,0,22,22,
Lincoln,Governor,Chad Moody,REP,410008,4,1,56,61,
Lincoln,Governor,Mary Fallin,REP,410008,2,8,165,175,
Lincoln,Superintendent of Public Instruction,Brian Kelly,REP,410008,0,2,78,80,
Lincoln,Superintendent of Public Instruction,Janet Costello Barresi,REP,410008,2,1,42,45,
Lincoln,Superintendent of Public Instruction,Joy Hofmeister,REP,410008,3,6,119,128,
Lincoln,Insurance Commissioner,Bill Viner,REP,410008,4,1,65,70,
Lincoln,Insurance Commissioner,John Doak,REP,410008,2,8,171,181,
Lincoln,Corporation Commissioner,Todd Hiett,REP,410008,5,5,104,114,
Lincoln,Corporation Commissioner,Cliff Branan,REP,410008,0,3,132,135,
Lincoln,U.S. Senate,Evelyn Rogers,REP,410008,0,0,16,16,
Lincoln,U.S. Senate,Rob Moye,REP,410008,0,0,5,5,
Lincoln,U.S. Senate,D. Jean Mcbride-Samuels,REP,410008,0,0,6,6,
Lincoln,U.S. Senate,Jim Inhofe,REP,410008,6,8,202,216,
Lincoln,U.S. Senate,Erick Paul Wyatt,REP,410008,0,1,15,16,
Lincoln,U.S. Senate,Andy Craig,REP,410008,0,0,4,4,
Lincoln,U.S. Senate,T. Shannon,REP,410008,6,2,97,105,
Lincoln,U.S. Senate,Randy Brogdon,REP,410008,0,0,4,4,
Lincoln,U.S. Senate,Eric Mccray,REP,410008,0,0,3,3,
Lincoln,U.S. Senate,Kevin Crow,REP,410008,0,0,1,1,
Lincoln,U.S. Senate,James Lankford,REP,410008,2,7,132,141,
Lincoln,U.S. Senate,Jason Weger,REP,410008,0,0,1,1,
Lincoln,U.S. House,Timothy Ray Murray,REP,410008,0,0,16,16,03
Lincoln,U.S. House,Robert Hubbard,REP,410008,1,0,21,22,03
Lincoln,U.S. House,Frank Lucas,REP,410008,5,9,204,218,03
Lincoln,State Senate,Jason Smalley,REP,410008,6,7,185,198,28
Lincoln,State Senate,Danny Williams,REP,410008,2,2,24,28,28
Lincoln,State Senate,Charles Mashek,REP,410008,0,0,6,6,28
Lincoln,State Senate,Joe Dobry,REP,410008,0,0,13,13,28
Lincoln,State Senate,Michael Ballard,REP,410008,0,0,16,16,28
Lincoln,State House,Kevin Wallace,REP,410008,8,5,180,193,32
Lincoln,State House,Ray Wade,REP,410008,0,4,67,71,32
Lincoln,Superintendent of Public Instruction,John Cox,DEM,410009,0,4,24,28,
Lincoln,Superintendent of Public Instruction,Jack Jr.,DEM,410009,0,1,6,7,
Lincoln,Superintendent of Public Instruction,Ivan Holmes,DEM,410009,0,1,7,8,
Lincoln,Superintendent of Public Instruction,Freda Deskin,DEM,410009,1,2,25,28,
Lincoln,U.S. Senate,Patrick Michael Hayes,DEM,410009,1,1,12,14,
Lincoln,U.S. Senate,Jim Rogers,DEM,410009,0,3,29,32,
Lincoln,U.S. Senate,Connie Johnson,DEM,410009,0,4,20,24,
Lincoln,State Senate,Marilyn Rainwater,DEM,410009,0,5,28,33,28
Lincoln,State Senate,Billy Hinton,DEM,410009,1,3,34,38,28
Lincoln,State House,Jamey White,DEM,410009,0,3,20,23,32
Lincoln,State House,Michial Poteet,DEM,410009,1,5,42,48,32
Lincoln,Governor,Dax Ewbank,REP,410009,0,0,6,6,
Lincoln,Governor,Chad Moody,REP,410009,2,0,16,18,
Lincoln,Governor,Mary Fallin,REP,410009,6,9,100,115,
Lincoln,Superintendent of Public Instruction,Brian Kelly,REP,410009,5,4,29,38,
Lincoln,Superintendent of Public Instruction,Janet Costello Barresi,REP,410009,2,2,24,28,
Lincoln,Superintendent of Public Instruction,Joy Hofmeister,REP,410009,1,3,68,72,
Lincoln,Insurance Commissioner,Bill Viner,REP,410009,0,2,27,29,
Lincoln,Insurance Commissioner,John Doak,REP,410009,7,7,81,95,
Lincoln,Corporation Commissioner,Todd Hiett,REP,410009,7,7,54,68,
Lincoln,Corporation Commissioner,Cliff Branan,REP,410009,0,2,53,55,
Lincoln,U.S. Senate,Evelyn Rogers,REP,410009,0,0,6,6,
Lincoln,U.S. Senate,Rob Moye,REP,410009,0,1,3,4,
Lincoln,U.S. Senate,D. Jean Mcbride-Samuels,REP,410009,0,0,1,1,
Lincoln,U.S. Senate,Jim Inhofe,REP,410009,7,7,106,120,
Lincoln,U.S. Senate,Erick Paul Wyatt,REP,410009,0,1,3,4,
Lincoln,U.S. Senate,Andy Craig,REP,410009,0,0,1,1,
Lincoln,U.S. Senate,T. Shannon,REP,410009,2,4,51,57,
Lincoln,U.S. Senate,Randy Brogdon,REP,410009,0,2,1,3,
Lincoln,U.S. Senate,Eric Mccray,REP,410009,0,0,1,1,
Lincoln,U.S. Senate,Kevin Crow,REP,410009,0,0,0,0,
Lincoln,U.S. Senate,James Lankford,REP,410009,6,3,67,76,
Lincoln,U.S. Senate,Jason Weger,REP,410009,0,0,1,1,
Lincoln,U.S. House,Timothy Ray Murray,REP,410009,0,0,5,5,03
Lincoln,U.S. House,Robert Hubbard,REP,410009,0,2,13,15,03
Lincoln,U.S. House,Frank Lucas,REP,410009,8,6,101,115,03
Lincoln,State Senate,Jason Smalley,REP,410009,6,5,91,102,28
Lincoln,State Senate,Danny Williams,REP,410009,0,2,6,8,28
Lincoln,State Senate,Charles Mashek,REP,410009,0,2,4,6,28
Lincoln,State Senate,Joe Dobry,REP,410009,0,0,14,14,28
Lincoln,State Senate,Michael Ballard,REP,410009,1,0,3,4,28
Lincoln,State House,Kevin Wallace,REP,410009,7,9,84,100,32
Lincoln,State House,Ray Wade,REP,410009,0,0,36,36,32
Lincoln,Superintendent of Public Instruction,John Cox,DEM,410010,0,5,36,41,
Lincoln,Superintendent of Public Instruction,Jack Jr.,DEM,410010,0,0,6,6,
Lincoln,Superintendent of Public Instruction,Ivan Holmes,DEM,410010,0,1,1,2,
Lincoln,Superintendent of Public Instruction,Freda Deskin,DEM,410010,0,5,33,38,
Lincoln,U.S. Senate,Patrick Michael Hayes,DEM,410010,0,5,17,22,
Lincoln,U.S. Senate,Jim Rogers,DEM,410010,0,4,28,32,
Lincoln,U.S. Senate,Connie Johnson,DEM,410010,0,2,30,32,
Lincoln,State Senate,Marilyn Rainwater,DEM,410010,0,8,47,55,28
Lincoln,State Senate,Billy Hinton,DEM,410010,0,3,26,29,28
Lincoln,State House,Jamey White,DEM,410010,0,3,8,11,32
Lincoln,State House,Michial Poteet,DEM,410010,0,8,69,77,32
Lincoln,Governor,Dax Ewbank,REP,410010,0,2,9,11,
Lincoln,Governor,Chad Moody,REP,410010,0,2,40,42,
Lincoln,Governor,Mary Fallin,REP,410010,1,32,174,207,
Lincoln,Superintendent of Public Instruction,Brian Kelly,REP,410010,0,12,53,65,
Lincoln,Superintendent of Public Instruction,Janet Costello Barresi,REP,410010,0,10,48,58,
Lincoln,Superintendent of Public Instruction,Joy Hofmeister,REP,410010,1,14,122,137,
Lincoln,Insurance Commissioner,Bill Viner,REP,410010,0,6,42,48,
Lincoln,Insurance Commissioner,John Doak,REP,410010,1,29,168,198,
Lincoln,Corporation Commissioner,Todd Hiett,REP,410010,1,16,108,125,
Lincoln,Corporation Commissioner,Cliff Branan,REP,410010,0,19,104,123,
Lincoln,U.S. Senate,Evelyn Rogers,REP,410010,0,1,11,12,
Lincoln,U.S. Senate,Rob Moye,REP,410010,0,0,4,4,
Lincoln,U.S. Senate,D. Jean Mcbride-Samuels,REP,410010,0,0,5,5,
Lincoln,U.S. Senate,Jim Inhofe,REP,410010,1,33,199,233,
Lincoln,U.S. Senate,Erick Paul Wyatt,REP,410010,0,2,5,7,
Lincoln,U.S. Senate,Andy Craig,REP,410010,0,0,2,2,
Lincoln,U.S. Senate,T. Shannon,REP,410010,1,13,72,86,
Lincoln,U.S. Senate,Randy Brogdon,REP,410010,0,1,7,8,
Lincoln,U.S. Senate,Eric Mccray,REP,410010,0,0,4,4,
Lincoln,U.S. Senate,Kevin Crow,REP,410010,0,0,2,2,
Lincoln,U.S. Senate,James Lankford,REP,410010,0,22,139,161,
Lincoln,U.S. Senate,Jason Weger,REP,410010,0,0,0,0,
Lincoln,U.S. House,Timothy Ray Murray,REP,410010,0,2,13,15,03
Lincoln,U.S. House,Robert Hubbard,REP,410010,0,7,22,29,03
Lincoln,U.S. House,Frank Lucas,REP,410010,1,27,185,213,03
Lincoln,State Senate,Jason Smalley,REP,410010,1,26,169,196,28
Lincoln,State Senate,Danny Williams,REP,410010,0,1,19,20,28
Lincoln,State Senate,Charles Mashek,REP,410010,0,0,4,4,28
Lincoln,State Senate,Joe Dobry,REP,410010,0,9,26,35,28
Lincoln,State Senate,Michael Ballard,REP,410010,0,0,5,5,28
Lincoln,State House,Kevin Wallace,REP,410010,1,25,162,188,32
Lincoln,State House,Ray Wade,REP,410010,0,11,56,67,32
Lincoln,Superintendent of Public Instruction,John Cox,DEM,410011,0,5,25,30,
Lincoln,Superintendent of Public Instruction,Jack Jr.,DEM,410011,0,4,14,18,
Lincoln,Superintendent of Public Instruction,Ivan Holmes,DEM,410011,0,3,3,6,
Lincoln,Superintendent of Public Instruction,Freda Deskin,DEM,410011,1,5,25,31,
Lincoln,U.S. Senate,Patrick Michael Hayes,DEM,410011,2,2,12,16,
Lincoln,U.S. Senate,Jim Rogers,DEM,410011,0,9,23,32,
Lincoln,U.S. Senate,Connie Johnson,DEM,410011,0,6,31,37,
Lincoln,State Senate,Marilyn Rainwater,DEM,410011,2,13,30,45,28
Lincoln,State Senate,Billy Hinton,DEM,410011,0,4,34,38,28
Lincoln,State House,Jamey White,DEM,410011,1,3,9,13,32
Lincoln,State House,Michial Poteet,DEM,410011,1,15,56,72,32
Lincoln,Governor,Dax Ewbank,REP,410011,0,0,12,12,
Lincoln,Governor,Chad Moody,REP,410011,0,7,27,34,
Lincoln,Governor,Mary Fallin,REP,410011,3,16,121,140,
Lincoln,Superintendent of Public Instruction,Brian Kelly,REP,410011,0,8,44,52,
Lincoln,Superintendent of Public Instruction,Janet Costello Barresi,REP,410011,2,0,25,27,
Lincoln,Superintendent of Public Instruction,Joy Hofmeister,REP,410011,1,14,93,108,
Lincoln,Insurance Commissioner,Bill Viner,REP,410011,1,9,39,49,
Lincoln,Insurance Commissioner,John Doak,REP,410011,2,12,108,122,
Lincoln,Corporation Commissioner,Todd Hiett,REP,410011,1,7,81,89,
Lincoln,Corporation Commissioner,Cliff Branan,REP,410011,2,14,67,83,
Lincoln,U.S. Senate,Evelyn Rogers,REP,410011,0,1,5,6,
Lincoln,U.S. Senate,Rob Moye,REP,410011,0,0,2,2,
Lincoln,U.S. Senate,D. Jean Mcbride-Samuels,REP,410011,0,0,2,2,
Lincoln,U.S. Senate,Jim Inhofe,REP,410011,3,20,141,164,
Lincoln,U.S. Senate,Erick Paul Wyatt,REP,410011,0,1,9,10,
Lincoln,U.S. Senate,Andy Craig,REP,410011,0,0,3,3,
Lincoln,U.S. Senate,T. Shannon,REP,410011,3,5,44,52,
Lincoln,U.S. Senate,Randy Brogdon,REP,410011,0,0,5,5,
Lincoln,U.S. Senate,Eric Mccray,REP,410011,0,0,2,2,
Lincoln,U.S. Senate,Kevin Crow,REP,410011,0,0,0,0,
Lincoln,U.S. Senate,James Lankford,REP,410011,0,17,107,124,
Lincoln,U.S. Senate,Jason Weger,REP,410011,0,0,0,0,
Lincoln,U.S. House,Timothy Ray Murray,REP,410011,0,0,10,10,03
Lincoln,U.S. House,Robert Hubbard,REP,410011,0,2,20,22,03
Lincoln,U.S. House,Frank Lucas,REP,410011,3,19,126,148,03
Lincoln,State Senate,Jason Smalley,REP,410011,3,11,96,110,28
Lincoln,State Senate,Danny Williams,REP,410011,0,2,13,15,28
Lincoln,State Senate,Charles Mashek,REP,410011,0,1,4,5,28
Lincoln,State Senate,Joe Dobry,REP,410011,0,8,37,45,28
Lincoln,State Senate,Michael Ballard,REP,410011,0,0,10,10,28
Lincoln,State House,Kevin Wallace,REP,410011,3,13,122,138,32
Lincoln,State House,Ray Wade,REP,410011,0,9,33,42,32
Lincoln,Superintendent of Public Instruction,John Cox,DEM,410012,0,7,22,29,
Lincoln,Superintendent of Public Instruction,Jack Jr.,DEM,410012,0,5,11,16,
Lincoln,Superintendent of Public Instruction,Ivan Holmes,DEM,410012,2,0,5,7,
Lincoln,Superintendent of Public Instruction,Freda Deskin,DEM,410012,0,1,34,35,
Lincoln,U.S. Senate,Patrick Michael Hayes,DEM,410012,2,3,13,18,
Lincoln,U.S. Senate,Jim Rogers,DEM,410012,0,4,27,31,
Lincoln,U.S. Senate,Connie Johnson,DEM,410012,0,6,32,38,
Lincoln,State Senate,Marilyn Rainwater,DEM,410012,0,9,46,55,28
Lincoln,State Senate,Billy Hinton,DEM,410012,2,4,27,33,28
Lincoln,State House,Jamey White,DEM,410012,0,1,20,21,32
Lincoln,State House,Michial Poteet,DEM,410012,2,13,53,68,32
Lincoln,Governor,Dax Ewbank,REP,410012,3,2,8,13,
Lincoln,Governor,Chad Moody,REP,410012,3,1,20,24,
Lincoln,Governor,Mary Fallin,REP,410012,2,22,101,125,
Lincoln,Superintendent of Public Instruction,Brian Kelly,REP,410012,2,7,40,49,
Lincoln,Superintendent of Public Instruction,Janet Costello Barresi,REP,410012,1,10,21,32,
Lincoln,Superintendent of Public Instruction,Joy Hofmeister,REP,410012,4,9,65,78,
Lincoln,Insurance Commissioner,Bill Viner,REP,410012,4,8,19,31,
Lincoln,Insurance Commissioner,John Doak,REP,410012,4,16,102,122,
Lincoln,Corporation Commissioner,Todd Hiett,REP,410012,3,13,69,85,
Lincoln,Corporation Commissioner,Cliff Branan,REP,410012,5,11,52,68,
Lincoln,U.S. Senate,Evelyn Rogers,REP,410012,0,0,2,2,
Lincoln,U.S. Senate,Rob Moye,REP,410012,1,0,5,6,
Lincoln,U.S. Senate,D. Jean Mcbride-Samuels,REP,410012,0,1,1,2,
Lincoln,U.S. Senate,Jim Inhofe,REP,410012,5,23,110,138,
Lincoln,U.S. Senate,Erick Paul Wyatt,REP,410012,2,1,9,12,
Lincoln,U.S. Senate,Andy Craig,REP,410012,0,0,2,2,
Lincoln,U.S. Senate,T. Shannon,REP,410012,5,8,47,60,
Lincoln,U.S. Senate,Randy Brogdon,REP,410012,0,0,4,4,
Lincoln,U.S. Senate,Eric Mccray,REP,410012,0,0,0,0,
Lincoln,U.S. Senate,Kevin Crow,REP,410012,0,0,0,0,
Lincoln,U.S. Senate,James Lankford,REP,410012,3,17,75,95,
Lincoln,U.S. Senate,Jason Weger,REP,410012,0,0,2,2,
Lincoln,U.S. House,Timothy Ray Murray,REP,410012,0,1,6,7,03
Lincoln,U.S. House,Robert Hubbard,REP,410012,3,1,10,14,03
Lincoln,U.S. House,Frank Lucas,REP,410012,5,23,111,139,03
Lincoln,State Senate,Jason Smalley,REP,410012,5,15,103,123,28
Lincoln,State Senate,Danny Williams,REP,410012,0,2,7,9,28
Lincoln,State Senate,Charles Mashek,REP,410012,0,0,3,3,28
Lincoln,State Senate,Joe Dobry,REP,410012,2,8,17,27,28
Lincoln,State Senate,Michael Ballard,REP,410012,1,0,2,3,28
Lincoln,State House,Kevin Wallace,REP,410012,5,20,87,112,32
Lincoln,State House,Ray Wade,REP,410012,2,5,37,44,32
Lincoln,Superintendent of Public Instruction,John Cox,DEM,410013,0,1,9,10,
Lincoln,Superintendent of Public Instruction,Jack Jr.,DEM,410013,0,0,4,4,
Lincoln,Superintendent of Public Instruction,Ivan Holmes,DEM,410013,0,0,5,5,
Lincoln,Superintendent of Public Instruction,Freda Deskin,DEM,410013,0,0,5,5,
Lincoln,U.S. Senate,Patrick Michael Hayes,DEM,410013,0,0,2,2,
Lincoln,U.S. Senate,Jim Rogers,DEM,410013,0,1,15,16,
Lincoln,U.S. Senate,Connie Johnson,DEM,410013,0,0,4,4,
Lincoln,State Senate,Marilyn Rainwater,DEM,410013,0,1,7,8,28
Lincoln,State Senate,Billy Hinton,DEM,410013,0,0,14,14,28
Lincoln,State House,Jamey White,DEM,410013,0,1,6,7,32
Lincoln,State House,Michial Poteet,DEM,410013,0,0,17,17,32
Lincoln,Governor,Dax Ewbank,REP,410013,1,0,5,6,
Lincoln,Governor,Chad Moody,REP,410013,0,1,4,5,
Lincoln,Governor,Mary Fallin,REP,410013,0,0,46,46,
Lincoln,Superintendent of Public Instruction,Brian Kelly,REP,410013,0,0,16,16,
Lincoln,Superintendent of Public Instruction,Janet Costello Barresi,REP,410013,0,0,14,14,
Lincoln,Superintendent of Public Instruction,Joy Hofmeister,REP,410013,1,1,24,26,
Lincoln,Insurance Commissioner,Bill Viner,REP,410013,0,0,11,11,
Lincoln,Insurance Commissioner,John Doak,REP,410013,1,1,42,44,
Lincoln,Corporation Commissioner,Todd Hiett,REP,410013,1,1,23,25,
Lincoln,Corporation Commissioner,Cliff Branan,REP,410013,0,0,26,26,
Lincoln,U.S. Senate,Evelyn Rogers,REP,410013,0,0,2,2,
Lincoln,U.S. Senate,Rob Moye,REP,410013,0,0,0,0,
Lincoln,U.S. Senate,D. Jean Mcbride-Samuels,REP,410013,0,0,0,0,
Lincoln,U.S. Senate,Jim Inhofe,REP,410013,0,1,50,51,
Lincoln,U.S. Senate,Erick Paul Wyatt,REP,410013,1,0,2,3,
Lincoln,U.S. Senate,Andy Craig,REP,410013,0,0,0,0,
Lincoln,U.S. Senate,T. Shannon,REP,410013,0,1,19,20,
Lincoln,U.S. Senate,Randy Brogdon,REP,410013,0,0,3,3,
Lincoln,U.S. Senate,Eric Mccray,REP,410013,0,0,0,0,
Lincoln,U.S. Senate,Kevin Crow,REP,410013,1,0,0,1,
Lincoln,U.S. Senate,James Lankford,REP,410013,0,0,32,32,
Lincoln,U.S. Senate,Jason Weger,REP,410013,0,0,1,1,
Lincoln,U.S. House,Timothy Ray Murray,REP,410013,0,0,3,3,03
Lincoln,U.S. House,Robert Hubbard,REP,410013,1,0,7,8,03
Lincoln,U.S. House,Frank Lucas,REP,410013,0,1,44,45,03
Lincoln,State Senate,Jason Smalley,REP,410013,0,1,42,43,28
Lincoln,State Senate,Danny Williams,REP,410013,0,0,3,3,28
Lincoln,State Senate,Charles Mashek,REP,410013,0,0,1,1,28
Lincoln,State Senate,Joe Dobry,REP,410013,0,0,5,5,28
Lincoln,State Senate,Michael Ballard,REP,410013,1,0,3,4,28
Lincoln,State House,Kevin Wallace,REP,410013,1,1,42,44,32
Lincoln,State House,Ray Wade,REP,410013,0,0,11,11,32
Lincoln,Superintendent of Public Instruction,John Cox,DEM,410015,1,0,28,29,
Lincoln,Superintendent of Public Instruction,Jack Jr.,DEM,410015,0,0,10,10,
Lincoln,Superintendent of Public Instruction,Ivan Holmes,DEM,410015,0,0,8,8,
Lincoln,Superintendent of Public Instruction,Freda Deskin,DEM,410015,1,0,30,31,
Lincoln,U.S. Senate,Patrick Michael Hayes,DEM,410015,1,0,21,22,
Lincoln,U.S. Senate,Jim Rogers,DEM,410015,0,0,30,30,
Lincoln,U.S. Senate,Connie Johnson,DEM,410015,1,0,26,27,
Lincoln,State Senate,Marilyn Rainwater,DEM,410015,2,0,47,49,28
Lincoln,State Senate,Billy Hinton,DEM,410015,0,0,29,29,28
Lincoln,State House,Jamey White,DEM,410015,0,0,28,28,32
Lincoln,State House,Michial Poteet,DEM,410015,2,0,49,51,32
Lincoln,Governor,Dax Ewbank,REP,410015,2,0,12,14,
Lincoln,Governor,Chad Moody,REP,410015,0,1,37,38,
Lincoln,Governor,Mary Fallin,REP,410015,5,3,142,150,
Lincoln,Superintendent of Public Instruction,Brian Kelly,REP,410015,0,1,49,50,
Lincoln,Superintendent of Public Instruction,Janet Costello Barresi,REP,410015,0,1,43,44,
Lincoln,Superintendent of Public Instruction,Joy Hofmeister,REP,410015,7,2,97,106,
Lincoln,Insurance Commissioner,Bill Viner,REP,410015,0,1,49,50,
Lincoln,Insurance Commissioner,John Doak,REP,410015,7,3,134,144,
Lincoln,Corporation Commissioner,Todd Hiett,REP,410015,4,2,102,108,
Lincoln,Corporation Commissioner,Cliff Branan,REP,410015,3,2,81,86,
Lincoln,U.S. Senate,Evelyn Rogers,REP,410015,1,0,5,6,
Lincoln,U.S. Senate,Rob Moye,REP,410015,0,0,3,3,
Lincoln,U.S. Senate,D. Jean Mcbride-Samuels,REP,410015,0,0,1,1,
Lincoln,U.S. Senate,Jim Inhofe,REP,410015,6,4,164,174,
Lincoln,U.S. Senate,Erick Paul Wyatt,REP,410015,0,0,15,15,
Lincoln,U.S. Senate,Andy Craig,REP,410015,0,0,0,0,
Lincoln,U.S. Senate,T. Shannon,REP,410015,0,4,71,75,
Lincoln,U.S. Senate,Randy Brogdon,REP,410015,1,0,9,10,
Lincoln,U.S. Senate,Eric Mccray,REP,410015,0,0,2,2,
Lincoln,U.S. Senate,Kevin Crow,REP,410015,0,0,1,1,
Lincoln,U.S. Senate,James Lankford,REP,410015,5,0,108,113,
Lincoln,U.S. Senate,Jason Weger,REP,410015,0,0,0,0,
Lincoln,U.S. House,Timothy Ray Murray,REP,410015,0,0,16,16,03
Lincoln,U.S. House,Robert Hubbard,REP,410015,2,1,27,30,03
Lincoln,U.S. House,Frank Lucas,REP,410015,5,3,146,154,03
Lincoln,State Senate,Jason Smalley,REP,410015,1,4,125,130,28
Lincoln,State Senate,Danny Williams,REP,410015,2,0,20,22,28
Lincoln,State Senate,Charles Mashek,REP,410015,0,0,6,6,28
Lincoln,State Senate,Joe Dobry,REP,410015,2,0,24,26,28
Lincoln,State Senate,Michael Ballard,REP,410015,2,0,10,12,28
Lincoln,State House,Kevin Wallace,REP,410015,5,3,144,152,32
Lincoln,State House,Ray Wade,REP,410015,2,1,34,37,32
Lincoln,Superintendent of Public Instruction,John Cox,DEM,410016,0,1,39,40,
Lincoln,Superintendent of Public Instruction,Jack Jr.,DEM,410016,0,0,7,7,
Lincoln,Superintendent of Public Instruction,Ivan Holmes,DEM,410016,0,0,6,6,
Lincoln,Superintendent of Public Instruction,Freda Deskin,DEM,410016,0,1,30,31,
Lincoln,U.S. Senate,Patrick Michael Hayes,DEM,410016,0,0,23,23,
Lincoln,U.S. Senate,Jim Rogers,DEM,410016,0,0,24,24,
Lincoln,U.S. Senate,Connie Johnson,DEM,410016,0,2,35,37,
Lincoln,State Senate,Marilyn Rainwater,DEM,410016,0,1,49,50,28
Lincoln,State Senate,Billy Hinton,DEM,410016,0,1,30,31,28
Lincoln,State House,Jamey White,DEM,410016,0,0,23,23,32
Lincoln,State House,Michial Poteet,DEM,410016,0,2,61,63,32
Lincoln,Governor,Dax Ewbank,REP,410016,2,0,9,11,
Lincoln,Governor,Chad Moody,REP,410016,0,0,24,24,
Lincoln,Governor,Mary Fallin,REP,410016,3,4,110,117,
Lincoln,Superintendent of Public Instruction,Brian Kelly,REP,410016,0,0,44,44,
Lincoln,Superintendent of Public Instruction,Janet Costello Barresi,REP,410016,4,2,24,30,
Lincoln,Superintendent of Public Instruction,Joy Hofmeister,REP,410016,1,2,75,78,
Lincoln,Insurance Commissioner,Bill Viner,REP,410016,0,0,26,26,
Lincoln,Insurance Commissioner,John Doak,REP,410016,4,3,110,117,
Lincoln,Corporation Commissioner,Todd Hiett,REP,410016,3,2,69,74,
Lincoln,Corporation Commissioner,Cliff Branan,REP,410016,1,1,69,71,
Lincoln,U.S. Senate,Evelyn Rogers,REP,410016,0,0,6,6,
Lincoln,U.S. Senate,Rob Moye,REP,410016,0,0,4,4,
Lincoln,U.S. Senate,D. Jean Mcbride-Samuels,REP,410016,0,0,2,2,
Lincoln,U.S. Senate,Jim Inhofe,REP,410016,5,3,127,135,
Lincoln,U.S. Senate,Erick Paul Wyatt,REP,410016,0,0,5,5,
Lincoln,U.S. Senate,Andy Craig,REP,410016,0,0,0,0,
Lincoln,U.S. Senate,T. Shannon,REP,410016,0,0,50,50,
Lincoln,U.S. Senate,Randy Brogdon,REP,410016,0,0,3,3,
Lincoln,U.S. Senate,Eric Mccray,REP,410016,0,0,1,1,
Lincoln,U.S. Senate,Kevin Crow,REP,410016,0,0,1,1,
Lincoln,U.S. Senate,James Lankford,REP,410016,5,4,89,98,
Lincoln,U.S. Senate,Jason Weger,REP,410016,0,0,0,0,
Lincoln,U.S. House,Timothy Ray Murray,REP,410016,0,0,6,6,03
Lincoln,U.S. House,Robert Hubbard,REP,410016,0,0,18,18,03
Lincoln,U.S. House,Frank Lucas,REP,410016,5,3,118,126,03
Lincoln,State Senate,Jason Smalley,REP,410016,3,1,79,83,28
Lincoln,State Senate,Danny Williams,REP,410016,0,0,21,21,28
Lincoln,State Senate,Charles Mashek,REP,410016,2,0,7,9,28
Lincoln,State Senate,Joe Dobry,REP,410016,0,2,24,26,28
Lincoln,State Senate,Michael Ballard,REP,410016,0,0,11,11,28
Lincoln,State House,Kevin Wallace,REP,410016,2,3,115,120,32
Lincoln,State House,Ray Wade,REP,410016,2,0,28,30,32
Lincoln,Superintendent of Public Instruction,John Cox,DEM,410017,0,3,11,14,
Lincoln,Superintendent of Public Instruction,Jack Jr.,DEM,410017,2,2,4,8,
Lincoln,Superintendent of Public Instruction,Ivan Holmes,DEM,410017,0,0,2,2,
Lincoln,Superintendent of Public Instruction,Freda Deskin,DEM,410017,0,0,14,14,
Lincoln,U.S. Senate,Patrick Michael Hayes,DEM,410017,0,1,8,9,
Lincoln,U.S. Senate,Jim Rogers,DEM,410017,0,4,11,15,
Lincoln,U.S. Senate,Connie Johnson,DEM,410017,2,0,12,14,
Lincoln,State Senate,Marilyn Rainwater,DEM,410017,2,2,16,20,28
Lincoln,State Senate,Billy Hinton,DEM,410017,0,3,16,19,28
Lincoln,State House,Jamey White,DEM,410017,0,0,13,13,32
Lincoln,State House,Michial Poteet,DEM,410017,2,5,19,26,32
Lincoln,Governor,Dax Ewbank,REP,410017,0,0,3,3,
Lincoln,Governor,Chad Moody,REP,410017,0,1,4,5,
Lincoln,Governor,Mary Fallin,REP,410017,3,1,35,39,
Lincoln,Superintendent of Public Instruction,Brian Kelly,REP,410017,0,1,16,17,
Lincoln,Superintendent of Public Instruction,Janet Costello Barresi,REP,410017,0,0,0,0,
Lincoln,Superintendent of Public Instruction,Joy Hofmeister,REP,410017,3,1,26,30,
Lincoln,Insurance Commissioner,Bill Viner,REP,410017,0,1,12,13,
Lincoln,Insurance Commissioner,John Doak,REP,410017,3,1,30,34,
Lincoln,Corporation Commissioner,Todd Hiett,REP,410017,1,1,20,22,
Lincoln,Corporation Commissioner,Cliff Branan,REP,410017,2,1,21,24,
Lincoln,U.S. Senate,Evelyn Rogers,REP,410017,0,0,0,0,
Lincoln,U.S. Senate,Rob Moye,REP,410017,0,0,1,1,
Lincoln,U.S. Senate,D. Jean Mcbride-Samuels,REP,410017,0,0,1,1,
Lincoln,U.S. Senate,Jim Inhofe,REP,410017,3,2,35,40,
Lincoln,U.S. Senate,Erick Paul Wyatt,REP,410017,0,0,4,4,
Lincoln,U.S. Senate,Andy Craig,REP,410017,0,0,0,0,
Lincoln,U.S. Senate,T. Shannon,REP,410017,2,2,10,14,
Lincoln,U.S. Senate,Randy Brogdon,REP,410017,0,0,3,3,
Lincoln,U.S. Senate,Eric Mccray,REP,410017,0,0,0,0,
Lincoln,U.S. Senate,Kevin Crow,REP,410017,0,0,0,0,
Lincoln,U.S. Senate,James Lankford,REP,410017,1,0,29,30,
Lincoln,U.S. Senate,Jason Weger,REP,410017,0,0,0,0,
Lincoln,U.S. House,Timothy Ray Murray,REP,410017,0,1,1,2,03
Lincoln,U.S. House,Robert Hubbard,REP,410017,0,1,7,8,03
Lincoln,U.S. House,Frank Lucas,REP,410017,3,0,33,36,03
Lincoln,State Senate,Jason Smalley,REP,410017,3,1,31,35,28
Lincoln,State Senate,Danny Williams,REP,410017,0,0,2,2,28
Lincoln,State Senate,Charles Mashek,REP,410017,0,0,0,0,28
Lincoln,State Senate,Joe Dobry,REP,410017,0,1,8,9,28
Lincoln,State Senate,Michael Ballard,REP,410017,0,0,1,1,28
Lincoln,State House,Kevin Wallace,REP,410017,2,2,25,29,32
Lincoln,State House,Ray Wade,REP,410017,1,0,15,16,32
Lincoln,Superintendent of Public Instruction,John Cox,DEM,410018,0,1,29,30,
Lincoln,Superintendent of Public Instruction,Jack Jr.,DEM,410018,0,0,14,14,
Lincoln,Superintendent of Public Instruction,Ivan Holmes,DEM,410018,0,1,3,4,
Lincoln,Superintendent of Public Instruction,Freda Deskin,DEM,410018,0,2,17,19,
Lincoln,U.S. Senate,Patrick Michael Hayes,DEM,410018,0,1,18,19,
Lincoln,U.S. Senate,Jim Rogers,DEM,410018,0,1,24,25,
Lincoln,U.S. Senate,Connie Johnson,DEM,410018,0,2,19,21,
Lincoln,State Senate,Marilyn Rainwater,DEM,410018,0,2,34,36,28
Lincoln,State Senate,Billy Hinton,DEM,410018,0,2,28,30,28
Lincoln,State House,Jamey White,DEM,410018,0,1,15,16,32
Lincoln,State House,Michial Poteet,DEM,410018,0,3,48,51,32
Lincoln,Governor,Dax Ewbank,REP,410018,0,0,11,11,
Lincoln,Governor,Chad Moody,REP,410018,0,2,10,12,
Lincoln,Governor,Mary Fallin,REP,410018,3,0,60,63,
Lincoln,Superintendent of Public Instruction,Brian Kelly,REP,410018,1,0,34,35,
Lincoln,Superintendent of Public Instruction,Janet Costello Barresi,REP,410018,0,0,14,14,
Lincoln,Superintendent of Public Instruction,Joy Hofmeister,REP,410018,2,2,33,37,
Lincoln,Insurance Commissioner,Bill Viner,REP,410018,1,1,15,17,
Lincoln,Insurance Commissioner,John Doak,REP,410018,2,1,58,61,
Lincoln,Corporation Commissioner,Todd Hiett,REP,410018,3,2,38,43,
Lincoln,Corporation Commissioner,Cliff Branan,REP,410018,0,0,38,38,
Lincoln,U.S. Senate,Evelyn Rogers,REP,410018,1,0,0,1,
Lincoln,U.S. Senate,Rob Moye,REP,410018,0,0,1,1,
Lincoln,U.S. Senate,D. Jean Mcbride-Samuels,REP,410018,0,0,0,0,
Lincoln,U.S. Senate,Jim Inhofe,REP,410018,1,2,73,76,
Lincoln,U.S. Senate,Erick Paul Wyatt,REP,410018,1,0,5,6,
Lincoln,U.S. Senate,Andy Craig,REP,410018,0,0,0,0,
Lincoln,U.S. Senate,T. Shannon,REP,410018,2,0,27,29,
Lincoln,U.S. Senate,Randy Brogdon,REP,410018,0,0,2,2,
Lincoln,U.S. Senate,Eric Mccray,REP,410018,1,0,0,1,
Lincoln,U.S. Senate,Kevin Crow,REP,410018,0,0,0,0,
Lincoln,U.S. Senate,James Lankford,REP,410018,0,2,52,54,
Lincoln,U.S. Senate,Jason Weger,REP,410018,0,0,0,0,
Lincoln,U.S. House,Timothy Ray Murray,REP,410018,0,0,5,5,03
Lincoln,U.S. House,Robert Hubbard,REP,410018,2,0,8,10,03
Lincoln,U.S. House,Frank Lucas,REP,410018,1,2,65,68,03
Lincoln,State Senate,Jason Smalley,REP,410018,0,2,54,56,28
Lincoln,State Senate,Danny Williams,REP,410018,2,0,16,18,28
Lincoln,State Senate,Charles Mashek,REP,410018,0,0,3,3,28
Lincoln,State Senate,Joe Dobry,REP,410018,0,0,4,4,28
Lincoln,State Senate,Michael Ballard,REP,410018,1,0,1,2,28
Lincoln,State House,Kevin Wallace,REP,410018,2,2,56,60,32
Lincoln,State House,Ray Wade,REP,410018,1,0,18,19,32
Lincoln,Superintendent of Public Instruction,John Cox,DEM,410019,0,0,40,40,
Lincoln,Superintendent of Public Instruction,Jack Jr.,DEM,410019,2,0,14,16,
Lincoln,Superintendent of Public Instruction,Ivan Holmes,DEM,410019,0,0,8,8,
Lincoln,Superintendent of Public Instruction,Freda Deskin,DEM,410019,1,0,19,20,
Lincoln,U.S. Senate,Patrick Michael Hayes,DEM,410019,1,0,20,21,
Lincoln,U.S. Senate,Jim Rogers,DEM,410019,0,0,29,29,
Lincoln,U.S. Senate,Connie Johnson,DEM,410019,1,0,30,31,
Lincoln,State Senate,Marilyn Rainwater,DEM,410019,0,0,35,35,28
Lincoln,State Senate,Billy Hinton,DEM,410019,2,0,44,46,28
Lincoln,State House,Jamey White,DEM,410019,2,0,15,17,32
Lincoln,State House,Michial Poteet,DEM,410019,1,0,64,65,32
Lincoln,Governor,Dax Ewbank,REP,410019,0,0,15,15,
Lincoln,Governor,Chad Moody,REP,410019,0,0,21,21,
Lincoln,Governor,Mary Fallin,REP,410019,2,4,112,118,
Lincoln,Superintendent of Public Instruction,Brian Kelly,REP,410019,0,1,39,40,
Lincoln,Superintendent of Public Instruction,Janet Costello Barresi,REP,410019,0,1,26,27,
Lincoln,Superintendent of Public Instruction,Joy Hofmeister,REP,410019,2,2,81,85,
Lincoln,Insurance Commissioner,Bill Viner,REP,410019,0,0,30,30,
Lincoln,Insurance Commissioner,John Doak,REP,410019,2,4,110,116,
Lincoln,Corporation Commissioner,Todd Hiett,REP,410019,0,3,71,74,
Lincoln,Corporation Commissioner,Cliff Branan,REP,410019,2,1,68,71,
Lincoln,U.S. Senate,Evelyn Rogers,REP,410019,0,0,4,4,
Lincoln,U.S. Senate,Rob Moye,REP,410019,0,0,6,6,
Lincoln,U.S. Senate,D. Jean Mcbride-Samuels,REP,410019,0,0,6,6,
Lincoln,U.S. Senate,Jim Inhofe,REP,410019,1,4,118,123,
Lincoln,U.S. Senate,Erick Paul Wyatt,REP,410019,1,0,11,12,
Lincoln,U.S. Senate,Andy Craig,REP,410019,0,0,3,3,
Lincoln,U.S. Senate,T. Shannon,REP,410019,1,2,48,51,
Lincoln,U.S. Senate,Randy Brogdon,REP,410019,0,0,6,6,
Lincoln,U.S. Senate,Eric Mccray,REP,410019,0,0,1,1,
Lincoln,U.S. Senate,Kevin Crow,REP,410019,0,0,1,1,
Lincoln,U.S. Senate,James Lankford,REP,410019,1,2,86,89,
Lincoln,U.S. Senate,Jason Weger,REP,410019,0,0,2,2,
Lincoln,U.S. House,Timothy Ray Murray,REP,410019,0,0,12,12,03
Lincoln,U.S. House,Robert Hubbard,REP,410019,0,0,24,24,03
Lincoln,U.S. House,Frank Lucas,REP,410019,2,4,108,114,03
Lincoln,State Senate,Jason Smalley,REP,410019,0,2,95,97,28
Lincoln,State Senate,Danny Williams,REP,410019,0,0,15,15,28
Lincoln,State Senate,Charles Mashek,REP,410019,0,0,12,12,28
Lincoln,State Senate,Joe Dobry,REP,410019,1,1,15,17,28
Lincoln,State Senate,Michael Ballard,REP,410019,1,0,9,10,28
Lincoln,State House,Kevin Wallace,REP,410019,1,3,111,115,32
Lincoln,State House,Ray Wade,REP,410019,1,0,29,30,32
Lincoln,Superintendent of Public Instruction,John Cox,DEM,410020,1,0,9,10,
Lincoln,Superintendent of Public Instruction,Jack Jr.,DEM,410020,0,0,7,7,
Lincoln,Superintendent of Public Instruction,Ivan Holmes,DEM,410020,0,0,2,2,
Lincoln,Superintendent of Public Instruction,Freda Deskin,DEM,410020,0,0,10,10,
Lincoln,U.S. Senate,Patrick Michael Hayes,DEM,410020,1,0,4,5,
Lincoln,U.S. Senate,Jim Rogers,DEM,410020,0,0,7,7,
Lincoln,U.S. Senate,Connie Johnson,DEM,410020,0,0,17,17,
Lincoln,State Senate,Marilyn Rainwater,DEM,410020,1,0,22,23,28
Lincoln,State Senate,Billy Hinton,DEM,410020,0,0,6,6,28
Lincoln,State House,Jamey White,DEM,410020,1,0,14,15,32
Lincoln,State House,Michial Poteet,DEM,410020,0,0,12,12,32
Lincoln,Governor,Dax Ewbank,REP,410020,0,0,11,11,
Lincoln,Governor,Chad Moody,REP,410020,1,1,11,13,
Lincoln,Governor,Mary Fallin,REP,410020,1,3,71,75,
Lincoln,Superintendent of Public Instruction,Brian Kelly,REP,410020,1,1,38,40,
Lincoln,Superintendent of Public Instruction,Janet Costello Barresi,REP,410020,0,1,20,21,
Lincoln,Superintendent of Public Instruction,Joy Hofmeister,REP,410020,1,2,32,35,
Lincoln,Insurance Commissioner,Bill Viner,REP,410020,1,0,18,19,
Lincoln,Insurance Commissioner,John Doak,REP,410020,1,3,69,73,
Lincoln,Corporation Commissioner,Todd Hiett,REP,410020,2,1,46,49,
Lincoln,Corporation Commissioner,Cliff Branan,REP,410020,0,2,43,45,
Lincoln,U.S. Senate,Evelyn Rogers,REP,410020,0,0,5,5,
Lincoln,U.S. Senate,Rob Moye,REP,410020,0,0,3,3,
Lincoln,U.S. Senate,D. Jean Mcbride-Samuels,REP,410020,1,0,2,3,
Lincoln,U.S. Senate,Jim Inhofe,REP,410020,1,4,70,75,
Lincoln,U.S. Senate,Erick Paul Wyatt,REP,410020,0,0,9,9,
Lincoln,U.S. Senate,Andy Craig,REP,410020,0,0,2,2,
Lincoln,U.S. Senate,T. Shannon,REP,410020,0,1,37,38,
Lincoln,U.S. Senate,Randy Brogdon,REP,410020,1,0,7,8,
Lincoln,U.S. Senate,Eric Mccray,REP,410020,0,0,1,1,
Lincoln,U.S. Senate,Kevin Crow,REP,410020,0,0,1,1,
Lincoln,U.S. Senate,James Lankford,REP,410020,1,3,44,48,
Lincoln,U.S. Senate,Jason Weger,REP,410020,0,0,1,1,
Lincoln,U.S. House,Timothy Ray Murray,REP,410020,0,0,11,11,03
Lincoln,U.S. House,Robert Hubbard,REP,410020,1,0,12,13,03
Lincoln,U.S. House,Frank Lucas,REP,410020,1,4,69,74,03
Lincoln,State Senate,Jason Smalley,REP,410020,1,3,66,70,28
Lincoln,State Senate,Danny Williams,REP,410020,0,1,11,12,28
Lincoln,State Senate,Charles Mashek,REP,410020,1,0,1,2,28
Lincoln,State Senate,Joe Dobry,REP,410020,0,0,9,9,28
Lincoln,State Senate,Michael Ballard,REP,410020,0,0,5,5,28
Lincoln,State House,Kevin Wallace,REP,410020,1,3,67,71,32
Lincoln,State House,Ray Wade,REP,410020,1,1,22,24,32
Lincoln,Superintendent of Public Instruction,John Cox,DEM,410021,1,0,37,38,
Lincoln,Superintendent of Public Instruction,Jack Jr.,DEM,410021,1,2,23,26,
Lincoln,Superintendent of Public Instruction,Ivan Holmes,DEM,410021,0,0,6,6,
Lincoln,Superintendent of Public Instruction,Freda Deskin,DEM,410021,1,0,32,33,
Lincoln,U.S. Senate,Patrick Michael Hayes,DEM,410021,0,0,23,23,
Lincoln,U.S. Senate,Jim Rogers,DEM,410021,1,2,43,46,
Lincoln,U.S. Senate,Connie Johnson,DEM,410021,2,0,32,34,
Lincoln,State Senate,Marilyn Rainwater,DEM,410021,1,1,50,52,28
Lincoln,State Senate,Billy Hinton,DEM,410021,2,1,47,50,28
Lincoln,State House,Jamey White,DEM,410021,1,1,42,44,32
Lincoln,State House,Michial Poteet,DEM,410021,2,1,56,59,32
Lincoln,Governor,Dax Ewbank,REP,410021,0,0,13,13,
Lincoln,Governor,Chad Moody,REP,410021,2,2,29,33,
Lincoln,Governor,Mary Fallin,REP,410021,2,4,115,121,
Lincoln,Superintendent of Public Instruction,Brian Kelly,REP,410021,2,3,41,46,
Lincoln,Superintendent of Public Instruction,Janet Costello Barresi,REP,410021,0,0,31,31,
Lincoln,Superintendent of Public Instruction,Joy Hofmeister,REP,410021,2,3,82,87,
Lincoln,Insurance Commissioner,Bill Viner,REP,410021,2,1,37,40,
Lincoln,Insurance Commissioner,John Doak,REP,410021,1,5,114,120,
Lincoln,Corporation Commissioner,Todd Hiett,REP,410021,3,1,75,79,
Lincoln,Corporation Commissioner,Cliff Branan,REP,410021,1,5,80,86,
Lincoln,U.S. Senate,Evelyn Rogers,REP,410021,2,0,7,9,
Lincoln,U.S. Senate,Rob Moye,REP,410021,0,0,4,4,
Lincoln,U.S. Senate,D. Jean Mcbride-Samuels,REP,410021,0,0,4,4,
Lincoln,U.S. Senate,Jim Inhofe,REP,410021,2,6,133,141,
Lincoln,U.S. Senate,Erick Paul Wyatt,REP,410021,0,0,10,10,
Lincoln,U.S. Senate,Andy Craig,REP,410021,0,0,1,1,
Lincoln,U.S. Senate,T. Shannon,REP,410021,1,4,51,56,
Lincoln,U.S. Senate,Randy Brogdon,REP,410021,0,0,6,6,
Lincoln,U.S. Senate,Eric Mccray,REP,410021,0,0,2,2,
Lincoln,U.S. Senate,Kevin Crow,REP,410021,0,0,3,3,
Lincoln,U.S. Senate,James Lankford,REP,410021,3,2,95,100,
Lincoln,U.S. Senate,Jason Weger,REP,410021,0,0,1,1,
Lincoln,U.S. House,Timothy Ray Murray,REP,410021,0,0,13,13,03
Lincoln,U.S. House,Robert Hubbard,REP,410021,2,0,21,23,03
Lincoln,U.S. House,Frank Lucas,REP,410021,2,6,121,129,03
Lincoln,State Senate,Jason Smalley,REP,410021,1,2,120,123,28
Lincoln,State Senate,Danny Williams,REP,410021,0,0,18,18,28
Lincoln,State Senate,Charles Mashek,REP,410021,0,1,6,7,28
Lincoln,State Senate,Joe Dobry,REP,410021,1,3,9,13,28
Lincoln,State Senate,Michael Ballard,REP,410021,2,0,5,7,28
Lincoln,State House,Kevin Wallace,REP,410021,4,6,121,131,32
Lincoln,State House,Ray Wade,REP,410021,0,0,31,31,32
Lincoln,Superintendent of Public Instruction,John Cox,DEM,410022,1,0,69,70,
Lincoln,Superintendent of Public Instruction,Jack Jr.,DEM,410022,0,0,16,16,
Lincoln,Superintendent of Public Instruction,Ivan Holmes,DEM,410022,0,0,4,4,
Lincoln,Superintendent of Public Instruction,Freda Deskin,DEM,410022,0,4,36,40,
Lincoln,U.S. Senate,Patrick Michael Hayes,DEM,410022,0,0,24,24,
Lincoln,U.S. Senate,Jim Rogers,DEM,410022,0,1,60,61,
Lincoln,U.S. Senate,Connie Johnson,DEM,410022,1,3,37,41,
Lincoln,State Senate,Marilyn Rainwater,DEM,410022,1,0,56,57,28
Lincoln,State Senate,Billy Hinton,DEM,410022,0,4,66,70,28
Lincoln,State House,Jamey White,DEM,410022,1,1,62,64,32
Lincoln,State House,Michial Poteet,DEM,410022,0,3,66,69,32
Lincoln,Governor,Dax Ewbank,REP,410022,0,0,15,15,
Lincoln,Governor,Chad Moody,REP,410022,1,0,38,39,
Lincoln,Governor,Mary Fallin,REP,410022,5,0,145,150,
Lincoln,Superintendent of Public Instruction,Brian Kelly,REP,410022,0,0,52,52,
Lincoln,Superintendent of Public Instruction,Janet Costello Barresi,REP,410022,2,0,40,42,
Lincoln,Superintendent of Public Instruction,Joy Hofmeister,REP,410022,4,0,107,111,
Lincoln,Insurance Commissioner,Bill Viner,REP,410022,0,0,42,42,
Lincoln,Insurance Commissioner,John Doak,REP,410022,6,0,144,150,
Lincoln,Corporation Commissioner,Todd Hiett,REP,410022,4,0,96,100,
Lincoln,Corporation Commissioner,Cliff Branan,REP,410022,2,0,98,100,
Lincoln,U.S. Senate,Evelyn Rogers,REP,410022,0,0,5,5,
Lincoln,U.S. Senate,Rob Moye,REP,410022,0,0,4,4,
Lincoln,U.S. Senate,D. Jean Mcbride-Samuels,REP,410022,0,0,4,4,
Lincoln,U.S. Senate,Jim Inhofe,REP,410022,6,0,174,180,
Lincoln,U.S. Senate,Erick Paul Wyatt,REP,410022,0,0,10,10,
Lincoln,U.S. Senate,Andy Craig,REP,410022,1,0,0,1,
Lincoln,U.S. Senate,T. Shannon,REP,410022,2,0,47,49,
Lincoln,U.S. Senate,Randy Brogdon,REP,410022,0,0,3,3,
Lincoln,U.S. Senate,Eric Mccray,REP,410022,0,0,0,0,
Lincoln,U.S. Senate,Kevin Crow,REP,410022,0,0,1,1,
Lincoln,U.S. Senate,James Lankford,REP,410022,3,0,149,152,
Lincoln,U.S. Senate,Jason Weger,REP,410022,0,0,1,1,
Lincoln,U.S. House,Timothy Ray Murray,REP,410022,0,0,16,16,03
Lincoln,U.S. House,Robert Hubbard,REP,410022,0,0,14,14,03
Lincoln,U.S. House,Frank Lucas,REP,410022,6,0,168,174,03
Lincoln,State Senate,Jason Smalley,REP,410022,6,0,146,152,28
Lincoln,State Senate,Danny Williams,REP,410022,0,0,20,20,28
Lincoln,State Senate,Charles Mashek,REP,410022,0,0,9,9,28
Lincoln,State Senate,Joe Dobry,REP,410022,0,0,22,22,28
Lincoln,State Senate,Michael Ballard,REP,410022,0,0,2,2,28
Lincoln,State House,Kevin Wallace,REP,410022,3,0,160,163,32
Lincoln,State House,Ray Wade,REP,410022,3,0,27,30,32
Logan,Superintendent of Public Instruction,John Cox,DEM,420101,0,0,5,5,
Logan,Superintendent of Public Instruction,Jack Jr.,DEM,420101,2,0,1,3,
Logan,Superintendent of Public Instruction,Ivan Holmes,DEM,420101,0,0,0,0,
Logan,Superintendent of Public Instruction,Freda Deskin,DEM,420101,0,0,8,8,
Logan,U.S. Senate,Patrick Michael Hayes,DEM,420101,0,0,2,2,
Logan,U.S. Senate,Jim Rogers,DEM,420101,0,0,8,8,
Logan,U.S. Senate,Connie Johnson,DEM,420101,2,0,4,6,
Logan,Governor,Dax Ewbank,REP,420101,3,2,13,18,
Logan,Governor,Chad Moody,REP,420101,0,0,14,14,
Logan,Governor,Mary Fallin,REP,420101,6,8,109,123,
Logan,Superintendent of Public Instruction,Brian Kelly,REP,420101,2,2,23,27,
Logan,Superintendent of Public Instruction,Janet Costello Barresi,REP,420101,0,5,48,53,
Logan,Superintendent of Public Instruction,Joy Hofmeister,REP,420101,6,3,65,74,
Logan,Insurance Commissioner,Bill Viner,REP,420101,3,3,24,30,
Logan,Insurance Commissioner,John Doak,REP,420101,5,7,105,117,
Logan,Corporation Commissioner,Todd Hiett,REP,420101,5,7,68,80,
Logan,Corporation Commissioner,Cliff Branan,REP,420101,3,3,57,63,
Logan,U.S. Senate,Evelyn Rogers,REP,420101,0,0,4,4,
Logan,U.S. Senate,Rob Moye,REP,420101,0,0,0,0,
Logan,U.S. Senate,D. Jean Mcbride-Samuels,REP,420101,0,0,1,1,
Logan,U.S. Senate,Jim Inhofe,REP,420101,7,10,122,139,
Logan,U.S. Senate,Erick Paul Wyatt,REP,420101,2,0,7,9,
Logan,U.S. Senate,Andy Craig,REP,420101,0,0,1,1,
Logan,U.S. Senate,T. Shannon,REP,420101,1,2,44,47,
Logan,U.S. Senate,Randy Brogdon,REP,420101,1,0,3,4,
Logan,U.S. Senate,Eric Mccray,REP,420101,0,0,0,0,
Logan,U.S. Senate,Kevin Crow,REP,420101,0,0,0,0,
Logan,U.S. Senate,James Lankford,REP,420101,5,8,86,99,
Logan,U.S. Senate,Jason Weger,REP,420101,2,0,2,4,
Logan,U.S. House,Timothy Ray Murray,REP,420101,0,0,6,6,03
Logan,U.S. House,Robert Hubbard,REP,420101,2,1,15,18,03
Logan,U.S. House,Frank Lucas,REP,420101,6,9,112,127,03
Logan,State Senate,Dan Ladd,REP,420101,1,4,67,72,20
Logan,State Senate,A Griffin,REP,420101,6,6,66,78,20
Logan,State House,Jason Murphey,REP,420101,8,10,120,138,31
Logan,State House,Andrew Muchmore,REP,420101,1,0,12,13,31
Logan,Superintendent of Public Instruction,John Cox,DEM,420102,0,0,17,17,
Logan,Superintendent of Public Instruction,Jack Jr.,DEM,420102,0,2,8,10,
Logan,Superintendent of Public Instruction,Ivan Holmes,DEM,420102,0,3,8,11,
Logan,Superintendent of Public Instruction,Freda Deskin,DEM,420102,1,6,14,21,
Logan,U.S. Senate,Patrick Michael Hayes,DEM,420102,0,2,12,14,
Logan,U.S. Senate,Jim Rogers,DEM,420102,0,3,15,18,
Logan,U.S. Senate,Connie Johnson,DEM,420102,1,5,19,25,
Logan,Governor,Dax Ewbank,REP,420102,0,0,23,23,
Logan,Governor,Chad Moody,REP,420102,1,4,13,18,
Logan,Governor,Mary Fallin,REP,420102,9,30,168,207,
Logan,Superintendent of Public Instruction,Brian Kelly,REP,420102,2,7,58,67,
Logan,Superintendent of Public Instruction,Janet Costello Barresi,REP,420102,2,10,51,63,
Logan,Superintendent of Public Instruction,Joy Hofmeister,REP,420102,6,14,90,110,
Logan,Insurance Commissioner,Bill Viner,REP,420102,0,4,33,37,
Logan,Insurance Commissioner,John Doak,REP,420102,10,26,162,198,
Logan,Corporation Commissioner,Todd Hiett,REP,420102,10,17,88,115,
Logan,Corporation Commissioner,Cliff Branan,REP,420102,0,15,103,118,
Logan,U.S. Senate,Evelyn Rogers,REP,420102,1,1,9,11,
Logan,U.S. Senate,Rob Moye,REP,420102,0,0,2,2,
Logan,U.S. Senate,D. Jean Mcbride-Samuels,REP,420102,0,2,3,5,
Logan,U.S. Senate,Jim Inhofe,REP,420102,9,31,185,225,
Logan,U.S. Senate,Erick Paul Wyatt,REP,420102,0,0,3,3,
Logan,U.S. Senate,Andy Craig,REP,420102,0,0,1,1,
Logan,U.S. Senate,T. Shannon,REP,420102,5,12,50,67,
Logan,U.S. Senate,Randy Brogdon,REP,420102,0,0,9,9,
Logan,U.S. Senate,Eric Mccray,REP,420102,1,0,0,1,
Logan,U.S. Senate,Kevin Crow,REP,420102,0,0,1,1,
Logan,U.S. Senate,James Lankford,REP,420102,4,22,143,169,
Logan,U.S. Senate,Jason Weger,REP,420102,0,0,0,0,
Logan,U.S. House,Timothy Ray Murray,REP,420102,0,4,14,18,03
Logan,U.S. House,Robert Hubbard,REP,420102,0,3,24,27,03
Logan,U.S. House,Frank Lucas,REP,420102,10,26,160,196,03
Logan,State Senate,Dan Ladd,REP,420102,2,14,68,84,20
Logan,State Senate,A Griffin,REP,420102,8,19,134,161,20
Logan,State House,Jason Murphey,REP,420102,9,30,153,192,31
Logan,State House,Andrew Muchmore,REP,420102,1,3,45,49,31
Logan,Superintendent of Public Instruction,John Cox,DEM,420103,1,0,11,12,
Logan,Superintendent of Public Instruction,Jack Jr.,DEM,420103,2,0,13,15,
Logan,Superintendent of Public Instruction,Ivan Holmes,DEM,420103,2,0,4,6,
Logan,Superintendent of Public Instruction,Freda Deskin,DEM,420103,0,2,35,37,
Logan,U.S. Senate,Patrick Michael Hayes,DEM,420103,1,0,6,7,
Logan,U.S. Senate,Jim Rogers,DEM,420103,0,0,20,20,
Logan,U.S. Senate,Connie Johnson,DEM,420103,3,2,34,39,
Logan,Governor,Dax Ewbank,REP,420103,3,4,45,52,
Logan,Governor,Chad Moody,REP,420103,1,1,70,72,
Logan,Governor,Mary Fallin,REP,420103,20,21,392,433,
Logan,Superintendent of Public Instruction,Brian Kelly,REP,420103,10,5,113,128,
Logan,Superintendent of Public Instruction,Janet Costello Barresi,REP,420103,4,7,113,124,
Logan,Superintendent of Public Instruction,Joy Hofmeister,REP,420103,9,14,267,290,
Logan,Insurance Commissioner,Bill Viner,REP,420103,9,5,105,119,
Logan,Insurance Commissioner,John Doak,REP,420103,14,19,359,392,
Logan,Corporation Commissioner,Todd Hiett,REP,420103,5,9,255,269,
Logan,Corporation Commissioner,Cliff Branan,REP,420103,17,16,205,238,
Logan,U.S. Senate,Evelyn Rogers,REP,420103,2,1,19,22,
Logan,U.S. Senate,Rob Moye,REP,420103,0,0,3,3,
Logan,U.S. Senate,D. Jean Mcbride-Samuels,REP,420103,0,1,8,9,
Logan,U.S. Senate,Jim Inhofe,REP,420103,18,23,451,492,
Logan,U.S. Senate,Erick Paul Wyatt,REP,420103,4,1,19,24,
Logan,U.S. Senate,Andy Craig,REP,420103,0,0,2,2,
Logan,U.S. Senate,T. Shannon,REP,420103,4,8,149,161,
Logan,U.S. Senate,Randy Brogdon,REP,420103,2,2,16,20,
Logan,U.S. Senate,Eric Mccray,REP,420103,1,1,7,9,
Logan,U.S. Senate,Kevin Crow,REP,420103,0,0,4,4,
Logan,U.S. Senate,James Lankford,REP,420103,17,15,332,364,
Logan,U.S. Senate,Jason Weger,REP,420103,0,0,1,1,
Logan,U.S. House,Timothy Ray Murray,REP,420103,2,2,38,42,03
Logan,U.S. House,Robert Hubbard,REP,420103,2,5,65,72,03
Logan,U.S. House,Frank Lucas,REP,420103,20,19,379,418,03
Logan,State Senate,Dan Ladd,REP,420103,10,9,229,248,20
Logan,State Senate,A Griffin,REP,420103,13,16,236,265,20
Logan,State House,Jason Murphey,REP,420103,18,21,421,460,31
Logan,State House,Andrew Muchmore,REP,420103,6,3,53,62,31
Logan,Superintendent of Public Instruction,John Cox,DEM,420104,0,1,14,15,
Logan,Superintendent of Public Instruction,Jack Jr.,DEM,420104,3,0,3,6,
Logan,Superintendent of Public Instruction,Ivan Holmes,DEM,420104,0,0,7,7,
Logan,Superintendent of Public Instruction,Freda Deskin,DEM,420104,0,1,18,19,
Logan,U.S. Senate,Patrick Michael Hayes,DEM,420104,0,1,7,8,
Logan,U.S. Senate,Jim Rogers,DEM,420104,1,0,10,11,
Logan,U.S. Senate,Connie Johnson,DEM,420104,2,1,24,27,
Logan,Governor,Dax Ewbank,REP,420104,1,2,46,49,
Logan,Governor,Chad Moody,REP,420104,1,1,47,49,
Logan,Governor,Mary Fallin,REP,420104,13,15,237,265,
Logan,Superintendent of Public Instruction,Brian Kelly,REP,420104,6,5,89,100,
Logan,Superintendent of Public Instruction,Janet Costello Barresi,REP,420104,8,5,82,95,
Logan,Superintendent of Public Instruction,Joy Hofmeister,REP,420104,1,7,157,165,
Logan,Insurance Commissioner,Bill Viner,REP,420104,1,4,66,71,
Logan,Insurance Commissioner,John Doak,REP,420104,14,13,240,267,
Logan,Corporation Commissioner,Todd Hiett,REP,420104,6,13,147,166,
Logan,Corporation Commissioner,Cliff Branan,REP,420104,8,3,151,162,
Logan,U.S. Senate,Evelyn Rogers,REP,420104,0,2,13,15,
Logan,U.S. Senate,Rob Moye,REP,420104,0,0,9,9,
Logan,U.S. Senate,D. Jean Mcbride-Samuels,REP,420104,0,0,1,1,
Logan,U.S. Senate,Jim Inhofe,REP,420104,15,13,295,323,
Logan,U.S. Senate,Erick Paul Wyatt,REP,420104,0,2,11,13,
Logan,U.S. Senate,Andy Craig,REP,420104,0,0,6,6,
Logan,U.S. Senate,T. Shannon,REP,420104,5,2,86,93,
Logan,U.S. Senate,Randy Brogdon,REP,420104,0,2,18,20,
Logan,U.S. Senate,Eric Mccray,REP,420104,0,0,2,2,
Logan,U.S. Senate,Kevin Crow,REP,420104,0,0,1,1,
Logan,U.S. Senate,James Lankford,REP,420104,9,14,220,243,
Logan,U.S. Senate,Jason Weger,REP,420104,1,0,2,3,
Logan,U.S. House,Timothy Ray Murray,REP,420104,2,2,20,24,03
Logan,U.S. House,Robert Hubbard,REP,420104,1,5,50,56,03
Logan,U.S. House,Frank Lucas,REP,420104,12,10,247,269,03
Logan,State Senate,Dan Ladd,REP,420104,3,7,159,169,20
Logan,State Senate,A Griffin,REP,420104,11,10,153,174,20
Logan,State House,Jason Murphey,REP,420104,13,10,280,303,31
Logan,State House,Andrew Muchmore,REP,420104,1,7,37,45,31
Logan,Superintendent of Public Instruction,John Cox,DEM,420105,1,3,19,23,
Logan,Superintendent of Public Instruction,Jack Jr.,DEM,420105,0,0,6,6,
Logan,Superintendent of Public Instruction,Ivan Holmes,DEM,420105,0,1,3,4,
Logan,Superintendent of Public Instruction,Freda Deskin,DEM,420105,0,2,17,19,
Logan,U.S. Senate,Patrick Michael Hayes,DEM,420105,0,1,9,10,
Logan,U.S. Senate,Jim Rogers,DEM,420105,1,3,10,14,
Logan,U.S. Senate,Connie Johnson,DEM,420105,0,2,22,24,
Logan,Governor,Dax Ewbank,REP,420105,2,9,24,35,
Logan,Governor,Chad Moody,REP,420105,0,3,29,32,
Logan,Governor,Mary Fallin,REP,420105,2,19,159,180,
Logan,Superintendent of Public Instruction,Brian Kelly,REP,420105,0,7,50,57,
Logan,Superintendent of Public Instruction,Janet Costello Barresi,REP,420105,0,3,61,64,
Logan,Superintendent of Public Instruction,Joy Hofmeister,REP,420105,5,21,94,120,
Logan,Insurance Commissioner,Bill Viner,REP,420105,2,5,38,45,
Logan,Insurance Commissioner,John Doak,REP,420105,3,26,162,191,
Logan,Corporation Commissioner,Todd Hiett,REP,420105,3,12,107,122,
Logan,Corporation Commissioner,Cliff Branan,REP,420105,2,18,92,112,
Logan,U.S. Senate,Evelyn Rogers,REP,420105,2,0,8,10,
Logan,U.S. Senate,Rob Moye,REP,420105,0,0,6,6,
Logan,U.S. Senate,D. Jean Mcbride-Samuels,REP,420105,0,0,4,4,
Logan,U.S. Senate,Jim Inhofe,REP,420105,3,27,185,215,
Logan,U.S. Senate,Erick Paul Wyatt,REP,420105,0,4,7,11,
Logan,U.S. Senate,Andy Craig,REP,420105,0,0,0,0,
Logan,U.S. Senate,T. Shannon,REP,420105,0,8,73,81,
Logan,U.S. Senate,Randy Brogdon,REP,420105,0,6,18,24,
Logan,U.S. Senate,Eric Mccray,REP,420105,0,0,1,1,
Logan,U.S. Senate,Kevin Crow,REP,420105,0,0,1,1,
Logan,U.S. Senate,James Lankford,REP,420105,5,17,120,142,
Logan,U.S. Senate,Jason Weger,REP,420105,0,0,2,2,
Logan,U.S. House,Timothy Ray Murray,REP,420105,2,1,13,16,03
Logan,U.S. House,Robert Hubbard,REP,420105,0,6,32,38,03
Logan,U.S. House,Frank Lucas,REP,420105,3,24,162,189,03
Logan,State Senate,Dan Ladd,REP,420105,1,5,89,95,20
Logan,State Senate,A Griffin,REP,420105,4,25,118,147,20
Logan,State House,Jason Murphey,REP,420105,3,22,180,205,31
Logan,State House,Andrew Muchmore,REP,420105,2,9,27,38,31
Logan,Superintendent of Public Instruction,John Cox,DEM,420106,0,0,15,15,
Logan,Superintendent of Public Instruction,Jack Jr.,DEM,420106,0,1,6,7,
Logan,Superintendent of Public Instruction,Ivan Holmes,DEM,420106,0,0,2,2,
Logan,Superintendent of Public Instruction,Freda Deskin,DEM,420106,1,1,27,29,
Logan,U.S. Senate,Patrick Michael Hayes,DEM,420106,1,1,11,13,
Logan,U.S. Senate,Jim Rogers,DEM,420106,0,0,10,10,
Logan,U.S. Senate,Connie Johnson,DEM,420106,4,0,27,31,
Logan,Governor,Dax Ewbank,REP,420106,4,0,32,36,
Logan,Governor,Chad Moody,REP,420106,2,1,41,44,
Logan,Governor,Mary Fallin,REP,420106,12,18,254,284,
Logan,Superintendent of Public Instruction,Brian Kelly,REP,420106,7,5,86,98,
Logan,Superintendent of Public Instruction,Janet Costello Barresi,REP,420106,3,5,80,88,
Logan,Superintendent of Public Instruction,Joy Hofmeister,REP,420106,8,8,157,173,
Logan,Insurance Commissioner,Bill Viner,REP,420106,8,2,69,79,
Logan,Insurance Commissioner,John Doak,REP,420106,10,16,230,256,
Logan,Corporation Commissioner,Todd Hiett,REP,420106,8,5,134,147,
Logan,Corporation Commissioner,Cliff Branan,REP,420106,10,9,165,184,
Logan,U.S. Senate,Evelyn Rogers,REP,420106,1,0,18,19,
Logan,U.S. Senate,Rob Moye,REP,420106,0,0,7,7,
Logan,U.S. Senate,D. Jean Mcbride-Samuels,REP,420106,1,0,3,4,
Logan,U.S. Senate,Jim Inhofe,REP,420106,15,18,283,316,
Logan,U.S. Senate,Erick Paul Wyatt,REP,420106,1,1,13,15,
Logan,U.S. Senate,Andy Craig,REP,420106,0,0,5,5,
Logan,U.S. Senate,T. Shannon,REP,420106,6,7,99,112,
Logan,U.S. Senate,Randy Brogdon,REP,420106,0,1,17,18,
Logan,U.S. Senate,Eric Mccray,REP,420106,2,0,1,3,
Logan,U.S. Senate,Kevin Crow,REP,420106,0,0,1,1,
Logan,U.S. Senate,James Lankford,REP,420106,10,11,207,228,
Logan,U.S. Senate,Jason Weger,REP,420106,0,0,0,0,
Logan,U.S. House,Timothy Ray Murray,REP,420106,0,3,25,28,03
Logan,U.S. House,Robert Hubbard,REP,420106,4,1,35,40,03
Logan,U.S. House,Frank Lucas,REP,420106,14,15,253,282,03
Logan,State Senate,Dan Ladd,REP,420106,10,9,172,191,20
Logan,State Senate,A Griffin,REP,420106,8,10,132,150,20
Logan,State House,Jason Murphey,REP,420106,11,18,272,301,31
Logan,State House,Andrew Muchmore,REP,420106,6,0,38,44,31
Logan,Superintendent of Public Instruction,John Cox,DEM,420201,0,0,9,9,
Logan,Superintendent of Public Instruction,Jack Jr.,DEM,420201,0,0,2,2,
Logan,Superintendent of Public Instruction,Ivan Holmes,DEM,420201,0,0,2,2,
Logan,Superintendent of Public Instruction,Freda Deskin,DEM,420201,0,0,8,8,
Logan,U.S. Senate,Patrick Michael Hayes,DEM,420201,0,0,4,4,
Logan,U.S. Senate,Jim Rogers,DEM,420201,0,0,5,5,
Logan,U.S. Senate,Connie Johnson,DEM,420201,0,0,11,11,
Logan,Governor,Dax Ewbank,REP,420201,0,0,2,2,
Logan,Governor,Chad Moody,REP,420201,0,0,9,9,
Logan,Governor,Mary Fallin,REP,420201,0,0,21,21,
Logan,Superintendent of Public Instruction,Brian Kelly,REP,420201,0,0,4,4,
Logan,Superintendent of Public Instruction,Janet Costello Barresi,REP,420201,0,0,6,6,
Logan,Superintendent of Public Instruction,Joy Hofmeister,REP,420201,0,0,22,22,
Logan,Insurance Commissioner,Bill Viner,REP,420201,0,0,6,6,
Logan,Insurance Commissioner,John Doak,REP,420201,0,0,24,24,
Logan,Corporation Commissioner,Todd Hiett,REP,420201,0,0,10,10,
Logan,Corporation Commissioner,Cliff Branan,REP,420201,0,0,19,19,
Logan,U.S. Senate,Evelyn Rogers,REP,420201,0,0,4,4,
Logan,U.S. Senate,Rob Moye,REP,420201,0,0,0,0,
Logan,U.S. Senate,D. Jean Mcbride-Samuels,REP,420201,0,0,3,3,
Logan,U.S. Senate,Jim Inhofe,REP,420201,0,0,23,23,
Logan,U.S. Senate,Erick Paul Wyatt,REP,420201,0,0,2,2,
Logan,U.S. Senate,Andy Craig,REP,420201,0,0,0,0,
Logan,U.S. Senate,T. Shannon,REP,420201,0,0,12,12,
Logan,U.S. Senate,Randy Brogdon,REP,420201,0,0,0,0,
Logan,U.S. Senate,Eric Mccray,REP,420201,0,0,0,0,
Logan,U.S. Senate,Kevin Crow,REP,420201,0,0,1,1,
Logan,U.S. Senate,James Lankford,REP,420201,0,0,18,18,
Logan,U.S. Senate,Jason Weger,REP,420201,0,0,1,1,
Logan,U.S. House,Timothy Ray Murray,REP,420201,0,0,1,1,03
Logan,U.S. House,Robert Hubbard,REP,420201,0,0,5,5,03
Logan,U.S. House,Frank Lucas,REP,420201,0,0,26,26,03
Logan,State Senate,Dan Ladd,REP,420201,0,0,9,9,20
Logan,State Senate,A Griffin,REP,420201,0,0,23,23,20
Logan,Superintendent of Public Instruction,John Cox,DEM,420203,1,0,15,16,
Logan,Superintendent of Public Instruction,Jack Jr.,DEM,420203,0,0,4,4,
Logan,Superintendent of Public Instruction,Ivan Holmes,DEM,420203,0,0,3,3,
Logan,Superintendent of Public Instruction,Freda Deskin,DEM,420203,0,0,11,11,
Logan,U.S. Senate,Patrick Michael Hayes,DEM,420203,0,0,9,9,
Logan,U.S. Senate,Jim Rogers,DEM,420203,1,0,6,7,
Logan,U.S. Senate,Connie Johnson,DEM,420203,0,0,18,18,
Logan,State House,Jamey White,DEM,420203,1,0,13,14,32
Logan,State House,Michial Poteet,DEM,420203,0,0,19,19,32
Logan,Governor,Dax Ewbank,REP,420203,2,1,6,9,
Logan,Governor,Chad Moody,REP,420203,1,0,14,15,
Logan,Governor,Mary Fallin,REP,420203,7,6,33,46,
Logan,Superintendent of Public Instruction,Brian Kelly,REP,420203,2,4,21,27,
Logan,Superintendent of Public Instruction,Janet Costello Barresi,REP,420203,2,0,5,7,
Logan,Superintendent of Public Instruction,Joy Hofmeister,REP,420203,6,3,28,37,
Logan,Insurance Commissioner,Bill Viner,REP,420203,0,1,16,17,
Logan,Insurance Commissioner,John Doak,REP,420203,10,6,36,52,
Logan,Corporation Commissioner,Todd Hiett,REP,420203,10,1,20,31,
Logan,Corporation Commissioner,Cliff Branan,REP,420203,0,6,33,39,
Logan,U.S. Senate,Evelyn Rogers,REP,420203,0,2,3,5,
Logan,U.S. Senate,Rob Moye,REP,420203,0,0,0,0,
Logan,U.S. Senate,D. Jean Mcbride-Samuels,REP,420203,0,0,1,1,
Logan,U.S. Senate,Jim Inhofe,REP,420203,10,5,49,64,
Logan,U.S. Senate,Erick Paul Wyatt,REP,420203,0,0,0,0,
Logan,U.S. Senate,Andy Craig,REP,420203,0,0,0,0,
Logan,U.S. Senate,T. Shannon,REP,420203,5,2,20,27,
Logan,U.S. Senate,Randy Brogdon,REP,420203,0,0,3,3,
Logan,U.S. Senate,Eric Mccray,REP,420203,0,0,1,1,
Logan,U.S. Senate,Kevin Crow,REP,420203,0,1,1,2,
Logan,U.S. Senate,James Lankford,REP,420203,5,4,28,37,
Logan,U.S. Senate,Jason Weger,REP,420203,0,0,1,1,
Logan,U.S. House,Timothy Ray Murray,REP,420203,1,1,6,8,03
Logan,U.S. House,Robert Hubbard,REP,420203,2,0,5,7,03
Logan,U.S. House,Frank Lucas,REP,420203,7,6,41,54,03
Logan,State Senate,Dan Ladd,REP,420203,7,3,19,29,20
Logan,State Senate,A Griffin,REP,420203,3,4,33,40,20
Logan,State House,Kevin Wallace,REP,420203,8,4,42,54,32
Logan,State House,Ray Wade,REP,420203,1,3,7,11,32
Logan,Superintendent of Public Instruction,John Cox,DEM,420204,0,3,23,26,
Logan,Superintendent of Public Instruction,Jack Jr.,DEM,420204,0,1,18,19,
Logan,Superintendent of Public Instruction,Ivan Holmes,DEM,420204,0,0,7,7,
Logan,Superintendent of Public Instruction,Freda Deskin,DEM,420204,1,3,38,42,
Logan,U.S. Senate,Patrick Michael Hayes,DEM,420204,0,3,20,23,
Logan,U.S. Senate,Jim Rogers,DEM,420204,1,3,20,24,
Logan,U.S. Senate,Connie Johnson,DEM,420204,0,1,45,46,
Logan,Governor,Dax Ewbank,REP,420204,0,2,35,37,
Logan,Governor,Chad Moody,REP,420204,2,7,37,46,
Logan,Governor,Mary Fallin,REP,420204,4,36,170,210,
Logan,Superintendent of Public Instruction,Brian Kelly,REP,420204,1,8,56,65,
Logan,Superintendent of Public Instruction,Janet Costello Barresi,REP,420204,1,12,52,65,
Logan,Superintendent of Public Instruction,Joy Hofmeister,REP,420204,3,25,133,161,
Logan,Insurance Commissioner,Bill Viner,REP,420204,1,7,48,56,
Logan,Insurance Commissioner,John Doak,REP,420204,2,36,183,221,
Logan,Corporation Commissioner,Todd Hiett,REP,420204,3,19,102,124,
Logan,Corporation Commissioner,Cliff Branan,REP,420204,0,24,125,149,
Logan,U.S. Senate,Evelyn Rogers,REP,420204,1,4,8,13,
Logan,U.S. Senate,Rob Moye,REP,420204,0,1,3,4,
Logan,U.S. Senate,D. Jean Mcbride-Samuels,REP,420204,0,0,3,3,
Logan,U.S. Senate,Jim Inhofe,REP,420204,5,40,219,264,
Logan,U.S. Senate,Erick Paul Wyatt,REP,420204,0,0,10,10,
Logan,U.S. Senate,Andy Craig,REP,420204,0,1,0,1,
Logan,U.S. Senate,T. Shannon,REP,420204,1,8,96,105,
Logan,U.S. Senate,Randy Brogdon,REP,420204,0,4,10,14,
Logan,U.S. Senate,Eric Mccray,REP,420204,0,0,2,2,
Logan,U.S. Senate,Kevin Crow,REP,420204,0,1,1,2,
Logan,U.S. Senate,James Lankford,REP,420204,4,31,131,166,
Logan,U.S. Senate,Jason Weger,REP,420204,1,0,3,4,
Logan,U.S. House,Timothy Ray Murray,REP,420204,0,2,10,12,03
Logan,U.S. House,Robert Hubbard,REP,420204,0,4,27,31,03
Logan,U.S. House,Frank Lucas,REP,420204,5,39,202,246,03
Logan,State Senate,Dan Ladd,REP,420204,0,9,63,72,20
Logan,State Senate,A Griffin,REP,420204,5,36,181,222,20
Logan,State House,Jason Murphey,REP,420204,3,27,164,194,31
Logan,State House,Andrew Muchmore,REP,420204,2,18,78,98,31
Logan,Superintendent of Public Instruction,John Cox,DEM,420205,1,1,27,29,
Logan,Superintendent of Public Instruction,Jack Jr.,DEM,420205,0,0,25,25,
Logan,Superintendent of Public Instruction,Ivan Holmes,DEM,420205,0,1,1,2,
Logan,Superintendent of Public Instruction,Freda Deskin,DEM,420205,4,1,29,34,
Logan,U.S. Senate,Patrick Michael Hayes,DEM,420205,0,0,26,26,
Logan,U.S. Senate,Jim Rogers,DEM,420205,2,2,23,27,
Logan,U.S. Senate,Connie Johnson,DEM,420205,3,1,31,35,
Logan,Governor,Dax Ewbank,REP,420205,1,2,55,58,
Logan,Governor,Chad Moody,REP,420205,1,6,65,72,
Logan,Governor,Mary Fallin,REP,420205,3,16,263,282,
Logan,Superintendent of Public Instruction,Brian Kelly,REP,420205,2,5,96,103,
Logan,Superintendent of Public Instruction,Janet Costello Barresi,REP,420205,0,9,95,104,
Logan,Superintendent of Public Instruction,Joy Hofmeister,REP,420205,3,10,188,201,
Logan,Insurance Commissioner,Bill Viner,REP,420205,2,1,91,94,
Logan,Insurance Commissioner,John Doak,REP,420205,3,23,276,302,
Logan,Corporation Commissioner,Todd Hiett,REP,420205,3,19,188,210,
Logan,Corporation Commissioner,Cliff Branan,REP,420205,2,5,175,182,
Logan,U.S. Senate,Evelyn Rogers,REP,420205,0,3,16,19,
Logan,U.S. Senate,Rob Moye,REP,420205,0,0,16,16,
Logan,U.S. Senate,D. Jean Mcbride-Samuels,REP,420205,0,0,7,7,
Logan,U.S. Senate,Jim Inhofe,REP,420205,5,20,319,344,
Logan,U.S. Senate,Erick Paul Wyatt,REP,420205,0,1,20,21,
Logan,U.S. Senate,Andy Craig,REP,420205,0,0,3,3,
Logan,U.S. Senate,T. Shannon,REP,420205,3,10,143,156,
Logan,U.S. Senate,Randy Brogdon,REP,420205,0,1,33,34,
Logan,U.S. Senate,Eric Mccray,REP,420205,0,0,1,1,
Logan,U.S. Senate,Kevin Crow,REP,420205,0,0,6,6,
Logan,U.S. Senate,James Lankford,REP,420205,2,13,197,212,
Logan,U.S. Senate,Jason Weger,REP,420205,0,0,2,2,
Logan,U.S. House,Timothy Ray Murray,REP,420205,0,2,30,32,03
Logan,U.S. House,Robert Hubbard,REP,420205,2,3,55,60,03
Logan,U.S. House,Frank Lucas,REP,420205,3,19,292,314,03
Logan,State Senate,Dan Ladd,REP,420205,1,10,156,167,20
Logan,State Senate,A Griffin,REP,420205,4,14,218,236,20
Logan,State House,Jason Murphey,REP,420205,4,18,311,333,31
Logan,State House,Andrew Muchmore,REP,420205,1,6,66,73,31
Logan,Superintendent of Public Instruction,John Cox,DEM,420206,0,2,17,19,
Logan,Superintendent of Public Instruction,Jack Jr.,DEM,420206,0,0,16,16,
Logan,Superintendent of Public Instruction,Ivan Holmes,DEM,420206,0,0,6,6,
Logan,Superintendent of Public Instruction,Freda Deskin,DEM,420206,0,1,30,31,
Logan,U.S. Senate,Patrick Michael Hayes,DEM,420206,0,0,15,15,
Logan,U.S. Senate,Jim Rogers,DEM,420206,0,0,21,21,
Logan,U.S. Senate,Connie Johnson,DEM,420206,0,3,32,35,
Logan,Governor,Dax Ewbank,REP,420206,0,5,49,54,
Logan,Governor,Chad Moody,REP,420206,0,5,31,36,
Logan,Governor,Mary Fallin,REP,420206,8,11,157,176,
Logan,Superintendent of Public Instruction,Brian Kelly,REP,420206,0,3,61,64,
Logan,Superintendent of Public Instruction,Janet Costello Barresi,REP,420206,1,5,77,83,
Logan,Superintendent of Public Instruction,Joy Hofmeister,REP,420206,7,14,88,109,
Logan,Insurance Commissioner,Bill Viner,REP,420206,3,4,48,55,
Logan,Insurance Commissioner,John Doak,REP,420206,5,16,174,195,
Logan,Corporation Commissioner,Todd Hiett,REP,420206,3,8,122,133,
Logan,Corporation Commissioner,Cliff Branan,REP,420206,5,12,101,118,
Logan,U.S. Senate,Evelyn Rogers,REP,420206,0,1,12,13,
Logan,U.S. Senate,Rob Moye,REP,420206,0,1,8,9,
Logan,U.S. Senate,D. Jean Mcbride-Samuels,REP,420206,0,0,3,3,
Logan,U.S. Senate,Jim Inhofe,REP,420206,7,18,197,222,
Logan,U.S. Senate,Erick Paul Wyatt,REP,420206,1,1,13,15,
Logan,U.S. Senate,Andy Craig,REP,420206,0,0,1,1,
Logan,U.S. Senate,T. Shannon,REP,420206,4,10,64,78,
Logan,U.S. Senate,Randy Brogdon,REP,420206,0,2,34,36,
Logan,U.S. Senate,Eric Mccray,REP,420206,0,0,1,1,
Logan,U.S. Senate,Kevin Crow,REP,420206,0,0,3,3,
Logan,U.S. Senate,James Lankford,REP,420206,4,10,133,147,
Logan,U.S. Senate,Jason Weger,REP,420206,0,0,1,1,
Logan,U.S. House,Timothy Ray Murray,REP,420206,1,2,20,23,03
Logan,U.S. House,Robert Hubbard,REP,420206,1,6,55,62,03
Logan,U.S. House,Frank Lucas,REP,420206,6,13,148,167,03
Logan,State Senate,Dan Ladd,REP,420206,4,8,118,130,20
Logan,State Senate,A Griffin,REP,420206,4,12,110,126,20
Logan,State House,Jason Murphey,REP,420206,7,18,205,230,31
Logan,State House,Andrew Muchmore,REP,420206,1,3,26,30,31
Logan,Superintendent of Public Instruction,John Cox,DEM,420207,1,2,25,28,
Logan,Superintendent of Public Instruction,Jack Jr.,DEM,420207,5,0,2,7,
Logan,Superintendent of Public Instruction,Ivan Holmes,DEM,420207,0,0,5,5,
Logan,Superintendent of Public Instruction,Freda Deskin,DEM,420207,0,0,21,21,
Logan,U.S. Senate,Patrick Michael Hayes,DEM,420207,3,0,15,18,
Logan,U.S. Senate,Jim Rogers,DEM,420207,3,0,17,20,
Logan,U.S. Senate,Connie Johnson,DEM,420207,0,2,21,23,
Logan,Governor,Dax Ewbank,REP,420207,0,4,42,46,
Logan,Governor,Chad Moody,REP,420207,0,0,44,44,
Logan,Governor,Mary Fallin,REP,420207,8,12,200,220,
Logan,Superintendent of Public Instruction,Brian Kelly,REP,420207,3,3,68,74,
Logan,Superintendent of Public Instruction,Janet Costello Barresi,REP,420207,3,10,85,98,
Logan,Superintendent of Public Instruction,Joy Hofmeister,REP,420207,2,3,126,131,
Logan,Insurance Commissioner,Bill Viner,REP,420207,0,2,49,51,
Logan,Insurance Commissioner,John Doak,REP,420207,8,14,213,235,
Logan,Corporation Commissioner,Todd Hiett,REP,420207,6,10,132,148,
Logan,Corporation Commissioner,Cliff Branan,REP,420207,2,5,137,144,
Logan,U.S. Senate,Evelyn Rogers,REP,420207,2,0,15,17,
Logan,U.S. Senate,Rob Moye,REP,420207,0,0,9,9,
Logan,U.S. Senate,D. Jean Mcbride-Samuels,REP,420207,0,0,1,1,
Logan,U.S. Senate,Jim Inhofe,REP,420207,6,14,252,272,
Logan,U.S. Senate,Erick Paul Wyatt,REP,420207,0,1,8,9,
Logan,U.S. Senate,Andy Craig,REP,420207,0,0,1,1,
Logan,U.S. Senate,T. Shannon,REP,420207,5,4,83,92,
Logan,U.S. Senate,Randy Brogdon,REP,420207,0,2,28,30,
Logan,U.S. Senate,Eric Mccray,REP,420207,0,0,2,2,
Logan,U.S. Senate,Kevin Crow,REP,420207,0,0,1,1,
Logan,U.S. Senate,James Lankford,REP,420207,3,10,175,188,
Logan,U.S. Senate,Jason Weger,REP,420207,0,0,1,1,
Logan,U.S. House,Timothy Ray Murray,REP,420207,2,0,14,16,03
Logan,U.S. House,Robert Hubbard,REP,420207,0,3,43,46,03
Logan,U.S. House,Frank Lucas,REP,420207,6,13,227,246,03
Logan,State Senate,Dan Ladd,REP,420207,2,3,156,161,20
Logan,State Senate,A Griffin,REP,420207,6,12,121,139,20
Logan,State House,Jason Murphey,REP,420207,8,13,245,266,31
Logan,State House,Andrew Muchmore,REP,420207,0,3,31,34,31
Logan,Superintendent of Public Instruction,John Cox,DEM,420301,0,0,7,7,
Logan,Superintendent of Public Instruction,Jack Jr.,DEM,420301,0,0,1,1,
Logan,Superintendent of Public Instruction,Ivan Holmes,DEM,420301,0,0,2,2,
Logan,Superintendent of Public Instruction,Freda Deskin,DEM,420301,0,0,1,1,
Logan,U.S. Senate,Patrick Michael Hayes,DEM,420301,0,0,3,3,
Logan,U.S. Senate,Jim Rogers,DEM,420301,0,0,6,6,
Logan,U.S. Senate,Connie Johnson,DEM,420301,0,0,2,2,
Logan,Governor,Dax Ewbank,REP,420301,0,0,5,5,
Logan,Governor,Chad Moody,REP,420301,3,1,8,12,
Logan,Governor,Mary Fallin,REP,420301,0,5,47,52,
Logan,Superintendent of Public Instruction,Brian Kelly,REP,420301,0,3,11,14,
Logan,Superintendent of Public Instruction,Janet Costello Barresi,REP,420301,0,0,5,5,
Logan,Superintendent of Public Instruction,Joy Hofmeister,REP,420301,3,3,42,48,
Logan,Insurance Commissioner,Bill Viner,REP,420301,0,0,14,14,
Logan,Insurance Commissioner,John Doak,REP,420301,3,6,45,54,
Logan,Corporation Commissioner,Todd Hiett,REP,420301,2,6,26,34,
Logan,Corporation Commissioner,Cliff Branan,REP,420301,0,0,29,29,
Logan,U.S. Senate,Evelyn Rogers,REP,420301,0,0,2,2,
Logan,U.S. Senate,Rob Moye,REP,420301,0,0,0,0,
Logan,U.S. Senate,D. Jean Mcbride-Samuels,REP,420301,0,0,0,0,
Logan,U.S. Senate,Jim Inhofe,REP,420301,3,6,53,62,
Logan,U.S. Senate,Erick Paul Wyatt,REP,420301,0,0,5,5,
Logan,U.S. Senate,Andy Craig,REP,420301,0,0,0,0,
Logan,U.S. Senate,T. Shannon,REP,420301,0,5,22,27,
Logan,U.S. Senate,Randy Brogdon,REP,420301,0,0,0,0,
Logan,U.S. Senate,Eric Mccray,REP,420301,0,0,1,1,
Logan,U.S. Senate,Kevin Crow,REP,420301,0,0,0,0,
Logan,U.S. Senate,James Lankford,REP,420301,3,1,37,41,
Logan,U.S. Senate,Jason Weger,REP,420301,0,0,0,0,
Logan,U.S. House,Timothy Ray Murray,REP,420301,0,0,7,7,03
Logan,U.S. House,Robert Hubbard,REP,420301,0,0,1,1,03
Logan,U.S. House,Frank Lucas,REP,420301,3,6,52,61,03
Logan,State Senate,Dan Ladd,REP,420301,3,0,20,23,20
Logan,State Senate,A Griffin,REP,420301,0,6,39,45,20
Logan,State House,Roy Chaney,REP,420301,0,0,2,2,38
Logan,State House,Niki Schrader,REP,420301,0,3,13,16,38
Logan,State House,Jason Warren,REP,420301,0,0,1,1,38
Logan,State House,Ralph Meade,REP,420301,0,0,1,1,38
Logan,State House,John Pfeiffer,REP,420301,3,3,42,48,38
Logan,State House,Harold Levalley,REP,420301,0,0,1,1,38
Logan,Superintendent of Public Instruction,John Cox,DEM,420302,0,0,5,5,
Logan,Superintendent of Public Instruction,Jack Jr.,DEM,420302,0,0,3,3,
Logan,Superintendent of Public Instruction,Ivan Holmes,DEM,420302,0,0,3,3,
Logan,Superintendent of Public Instruction,Freda Deskin,DEM,420302,0,0,12,12,
Logan,U.S. Senate,Patrick Michael Hayes,DEM,420302,0,0,6,6,
Logan,U.S. Senate,Jim Rogers,DEM,420302,0,0,7,7,
Logan,U.S. Senate,Connie Johnson,DEM,420302,0,0,10,10,
Logan,Governor,Dax Ewbank,REP,420302,0,0,4,4,
Logan,Governor,Chad Moody,REP,420302,1,1,8,10,
Logan,Governor,Mary Fallin,REP,420302,0,0,29,29,
Logan,Superintendent of Public Instruction,Brian Kelly,REP,420302,1,0,9,10,
Logan,Superintendent of Public Instruction,Janet Costello Barresi,REP,420302,0,0,5,5,
Logan,Superintendent of Public Instruction,Joy Hofmeister,REP,420302,0,1,27,28,
Logan,Insurance Commissioner,Bill Viner,REP,420302,0,0,7,7,
Logan,Insurance Commissioner,John Doak,REP,420302,1,1,34,36,
Logan,Corporation Commissioner,Todd Hiett,REP,420302,1,1,24,26,
Logan,Corporation Commissioner,Cliff Branan,REP,420302,0,0,17,17,
Logan,U.S. Senate,Evelyn Rogers,REP,420302,0,0,3,3,
Logan,U.S. Senate,Rob Moye,REP,420302,0,0,1,1,
Logan,U.S. Senate,D. Jean Mcbride-Samuels,REP,420302,0,0,0,0,
Logan,U.S. Senate,Jim Inhofe,REP,420302,1,1,33,35,
Logan,U.S. Senate,Erick Paul Wyatt,REP,420302,0,0,4,4,
Logan,U.S. Senate,Andy Craig,REP,420302,0,0,0,0,
Logan,U.S. Senate,T. Shannon,REP,420302,0,1,22,23,
Logan,U.S. Senate,Randy Brogdon,REP,420302,0,0,0,0,
Logan,U.S. Senate,Eric Mccray,REP,420302,0,0,0,0,
Logan,U.S. Senate,Kevin Crow,REP,420302,0,0,2,2,
Logan,U.S. Senate,James Lankford,REP,420302,1,0,16,17,
Logan,U.S. Senate,Jason Weger,REP,420302,0,0,1,1,
Logan,U.S. House,Timothy Ray Murray,REP,420302,0,0,2,2,03
Logan,U.S. House,Robert Hubbard,REP,420302,0,0,4,4,03
Logan,U.S. House,Frank Lucas,REP,420302,1,1,35,37,03
Logan,State Senate,Dan Ladd,REP,420302,1,0,9,10,20
Logan,State Senate,A Griffin,REP,420302,0,1,31,32,20
Logan,State House,Roy Chaney,REP,420302,0,0,3,3,38
Logan,State House,Niki Schrader,REP,420302,0,0,2,2,38
Logan,State House,Jason Warren,REP,420302,0,0,1,1,38
Logan,State House,Ralph Meade,REP,420302,0,0,1,1,38
Logan,State House,John Pfeiffer,REP,420302,1,1,32,34,38
Logan,State House,Harold Levalley,REP,420302,0,0,1,1,38
Logan,Superintendent of Public Instruction,John Cox,DEM,420303,1,1,34,36,
Logan,Superintendent of Public Instruction,Jack Jr.,DEM,420303,2,0,16,18,
Logan,Superintendent of Public Instruction,Ivan Holmes,DEM,420303,0,0,6,6,
Logan,Superintendent of Public Instruction,Freda Deskin,DEM,420303,0,1,29,30,
Logan,U.S. Senate,Patrick Michael Hayes,DEM,420303,1,1,26,28,
Logan,U.S. Senate,Jim Rogers,DEM,420303,0,0,32,32,
Logan,U.S. Senate,Connie Johnson,DEM,420303,2,1,25,28,
Logan,Governor,Dax Ewbank,REP,420303,3,0,56,59,
Logan,Governor,Chad Moody,REP,420303,1,3,41,45,
Logan,Governor,Mary Fallin,REP,420303,6,6,250,262,
Logan,Superintendent of Public Instruction,Brian Kelly,REP,420303,4,0,83,87,
Logan,Superintendent of Public Instruction,Janet Costello Barresi,REP,420303,3,2,56,61,
Logan,Superintendent of Public Instruction,Joy Hofmeister,REP,420303,3,8,206,217,
Logan,Insurance Commissioner,Bill Viner,REP,420303,2,0,71,73,
Logan,Insurance Commissioner,John Doak,REP,420303,8,9,270,287,
Logan,Corporation Commissioner,Todd Hiett,REP,420303,6,5,166,177,
Logan,Corporation Commissioner,Cliff Branan,REP,420303,4,4,169,177,
Logan,U.S. Senate,Evelyn Rogers,REP,420303,2,1,11,14,
Logan,U.S. Senate,Rob Moye,REP,420303,0,1,11,12,
Logan,U.S. Senate,D. Jean Mcbride-Samuels,REP,420303,0,0,3,3,
Logan,U.S. Senate,Jim Inhofe,REP,420303,7,5,298,310,
Logan,U.S. Senate,Erick Paul Wyatt,REP,420303,1,2,23,26,
Logan,U.S. Senate,Andy Craig,REP,420303,0,0,1,1,
Logan,U.S. Senate,T. Shannon,REP,420303,0,2,100,102,
Logan,U.S. Senate,Randy Brogdon,REP,420303,2,2,30,34,
Logan,U.S. Senate,Eric Mccray,REP,420303,0,0,0,0,
Logan,U.S. Senate,Kevin Crow,REP,420303,0,0,2,2,
Logan,U.S. Senate,James Lankford,REP,420303,8,6,213,227,
Logan,U.S. Senate,Jason Weger,REP,420303,0,1,3,4,
Logan,U.S. House,Timothy Ray Murray,REP,420303,2,1,22,25,03
Logan,U.S. House,Robert Hubbard,REP,420303,3,3,37,43,03
Logan,U.S. House,Frank Lucas,REP,420303,5,6,288,299,03
Logan,State Senate,Dan Ladd,REP,420303,6,6,133,145,20
Logan,State Senate,A Griffin,REP,420303,4,5,211,220,20
Logan,State House,Roy Chaney,REP,420303,1,0,38,39,38
Logan,State House,Niki Schrader,REP,420303,0,1,56,57,38
Logan,State House,Jason Warren,REP,420303,3,0,30,33,38
Logan,State House,Ralph Meade,REP,420303,0,0,6,6,38
Logan,State House,John Pfeiffer,REP,420303,6,8,184,198,38
Logan,State House,Harold Levalley,REP,420303,0,1,28,29,38
Logan,Superintendent of Public Instruction,John Cox,DEM,420304,0,0,13,13,
Logan,Superintendent of Public Instruction,Jack Jr.,DEM,420304,0,0,5,5,
Logan,Superintendent of Public Instruction,Ivan Holmes,DEM,420304,0,0,4,4,
Logan,Superintendent of Public Instruction,Freda Deskin,DEM,420304,0,3,9,12,
Logan,U.S. Senate,Patrick Michael Hayes,DEM,420304,0,0,9,9,
Logan,U.S. Senate,Jim Rogers,DEM,420304,0,1,13,14,
Logan,U.S. Senate,Connie Johnson,DEM,420304,0,2,8,10,
Logan,Governor,Dax Ewbank,REP,420304,0,1,8,9,
Logan,Governor,Chad Moody,REP,420304,0,1,13,14,
Logan,Governor,Mary Fallin,REP,420304,3,2,94,99,
Logan,Superintendent of Public Instruction,Brian Kelly,REP,420304,1,0,30,31,
Logan,Superintendent of Public Instruction,Janet Costello Barresi,REP,420304,0,1,22,23,
Logan,Superintendent of Public Instruction,Joy Hofmeister,REP,420304,2,2,64,68,
Logan,Insurance Commissioner,Bill Viner,REP,420304,0,1,18,19,
Logan,Insurance Commissioner,John Doak,REP,420304,3,3,92,98,
Logan,Corporation Commissioner,Todd Hiett,REP,420304,0,1,66,67,
Logan,Corporation Commissioner,Cliff Branan,REP,420304,2,3,45,50,
Logan,U.S. Senate,Evelyn Rogers,REP,420304,0,1,5,6,
Logan,U.S. Senate,Rob Moye,REP,420304,0,0,2,2,
Logan,U.S. Senate,D. Jean Mcbride-Samuels,REP,420304,0,0,1,1,
Logan,U.S. Senate,Jim Inhofe,REP,420304,3,1,104,108,
Logan,U.S. Senate,Erick Paul Wyatt,REP,420304,0,2,3,5,
Logan,U.S. Senate,Andy Craig,REP,420304,0,0,1,1,
Logan,U.S. Senate,T. Shannon,REP,420304,0,2,33,35,
Logan,U.S. Senate,Randy Brogdon,REP,420304,0,0,1,1,
Logan,U.S. Senate,Eric Mccray,REP,420304,0,0,2,2,
Logan,U.S. Senate,Kevin Crow,REP,420304,0,0,0,0,
Logan,U.S. Senate,James Lankford,REP,420304,3,2,78,83,
Logan,U.S. Senate,Jason Weger,REP,420304,0,0,2,2,
Logan,U.S. House,Timothy Ray Murray,REP,420304,0,1,3,4,03
Logan,U.S. House,Robert Hubbard,REP,420304,0,0,11,11,03
Logan,U.S. House,Frank Lucas,REP,420304,3,3,100,106,03
Logan,State Senate,Dan Ladd,REP,420304,0,0,34,34,20
Logan,State Senate,A Griffin,REP,420304,3,4,81,88,20
Logan,State House,Roy Chaney,REP,420304,0,0,7,7,38
Logan,State House,Niki Schrader,REP,420304,0,0,8,8,38
Logan,State House,Jason Warren,REP,420304,0,0,0,0,38
Logan,State House,Ralph Meade,REP,420304,0,0,4,4,38
Logan,State House,John Pfeiffer,REP,420304,3,3,89,95,38
Logan,State House,Harold Levalley,REP,420304,0,1,7,8,38
Logan,Superintendent of Public Instruction,John Cox,DEM,420305,0,0,16,16,
Logan,Superintendent of Public Instruction,Jack Jr.,DEM,420305,0,3,11,14,
Logan,Superintendent of Public Instruction,Ivan Holmes,DEM,420305,0,1,2,3,
Logan,Superintendent of Public Instruction,Freda Deskin,DEM,420305,1,7,25,33,
Logan,U.S. Senate,Patrick Michael Hayes,DEM,420305,0,2,11,13,
Logan,U.S. Senate,Jim Rogers,DEM,420305,0,4,14,18,
Logan,U.S. Senate,Connie Johnson,DEM,420305,1,5,28,34,
Logan,Governor,Dax Ewbank,REP,420305,1,3,16,20,
Logan,Governor,Chad Moody,REP,420305,2,1,26,29,
Logan,Governor,Mary Fallin,REP,420305,11,14,135,160,
Logan,Superintendent of Public Instruction,Brian Kelly,REP,420305,2,3,51,56,
Logan,Superintendent of Public Instruction,Janet Costello Barresi,REP,420305,4,6,38,48,
Logan,Superintendent of Public Instruction,Joy Hofmeister,REP,420305,8,9,83,100,
Logan,Insurance Commissioner,Bill Viner,REP,420305,0,5,24,29,
Logan,Insurance Commissioner,John Doak,REP,420305,12,13,147,172,
Logan,Corporation Commissioner,Todd Hiett,REP,420305,7,7,89,103,
Logan,Corporation Commissioner,Cliff Branan,REP,420305,5,12,82,99,
Logan,U.S. Senate,Evelyn Rogers,REP,420305,0,2,8,10,
Logan,U.S. Senate,Rob Moye,REP,420305,0,1,1,2,
Logan,U.S. Senate,D. Jean Mcbride-Samuels,REP,420305,0,0,2,2,
Logan,U.S. Senate,Jim Inhofe,REP,420305,12,16,158,186,
Logan,U.S. Senate,Erick Paul Wyatt,REP,420305,1,0,7,8,
Logan,U.S. Senate,Andy Craig,REP,420305,0,0,0,0,
Logan,U.S. Senate,T. Shannon,REP,420305,5,4,58,67,
Logan,U.S. Senate,Randy Brogdon,REP,420305,0,0,8,8,
Logan,U.S. Senate,Eric Mccray,REP,420305,0,1,1,2,
Logan,U.S. Senate,Kevin Crow,REP,420305,0,0,0,0,
Logan,U.S. Senate,James Lankford,REP,420305,7,14,109,130,
Logan,U.S. Senate,Jason Weger,REP,420305,0,0,1,1,
Logan,U.S. House,Timothy Ray Murray,REP,420305,0,1,12,13,03
Logan,U.S. House,Robert Hubbard,REP,420305,2,0,23,25,03
Logan,U.S. House,Frank Lucas,REP,420305,11,17,141,169,03
Logan,State Senate,Dan Ladd,REP,420305,2,3,57,62,20
Logan,State Senate,A Griffin,REP,420305,12,15,119,146,20
Logan,State House,Roy Chaney,REP,420305,2,2,16,20,38
Logan,State House,Niki Schrader,REP,420305,3,1,10,14,38
Logan,State House,Jason Warren,REP,420305,1,0,12,13,38
Logan,State House,Ralph Meade,REP,420305,0,1,6,7,38
Logan,State House,John Pfeiffer,REP,420305,5,13,112,130,38
Logan,State House,Harold Levalley,REP,420305,3,2,15,20,38
Logan,Superintendent of Public Instruction,John Cox,DEM,420306,0,0,11,11,
Logan,Superintendent of Public Instruction,Jack Jr.,DEM,420306,1,0,5,6,
Logan,Superintendent of Public Instruction,Ivan Holmes,DEM,420306,1,0,1,2,
Logan,Superintendent of Public Instruction,Freda Deskin,DEM,420306,0,1,13,14,
Logan,U.S. Senate,Patrick Michael Hayes,DEM,420306,1,1,12,14,
Logan,U.S. Senate,Jim Rogers,DEM,420306,0,0,6,6,
Logan,U.S. Senate,Connie Johnson,DEM,420306,1,0,11,12,
Logan,Governor,Dax Ewbank,REP,420306,0,0,16,16,
Logan,Governor,Chad Moody,REP,420306,0,1,11,12,
Logan,Governor,Mary Fallin,REP,420306,1,3,55,59,
Logan,Superintendent of Public Instruction,Brian Kelly,REP,420306,0,2,22,24,
Logan,Superintendent of Public Instruction,Janet Costello Barresi,REP,420306,0,0,24,24,
Logan,Superintendent of Public Instruction,Joy Hofmeister,REP,420306,1,2,35,38,
Logan,Insurance Commissioner,Bill Viner,REP,420306,0,0,14,14,
Logan,Insurance Commissioner,John Doak,REP,420306,0,4,65,69,
Logan,Corporation Commissioner,Todd Hiett,REP,420306,0,1,37,38,
Logan,Corporation Commissioner,Cliff Branan,REP,420306,0,3,37,40,
Logan,U.S. Senate,Evelyn Rogers,REP,420306,0,0,8,8,
Logan,U.S. Senate,Rob Moye,REP,420306,0,0,0,0,
Logan,U.S. Senate,D. Jean Mcbride-Samuels,REP,420306,0,0,0,0,
Logan,U.S. Senate,Jim Inhofe,REP,420306,1,4,70,75,
Logan,U.S. Senate,Erick Paul Wyatt,REP,420306,0,0,3,3,
Logan,U.S. Senate,Andy Craig,REP,420306,0,0,1,1,
Logan,U.S. Senate,T. Shannon,REP,420306,0,1,29,30,
Logan,U.S. Senate,Randy Brogdon,REP,420306,0,2,4,6,
Logan,U.S. Senate,Eric Mccray,REP,420306,0,0,1,1,
Logan,U.S. Senate,Kevin Crow,REP,420306,0,0,1,1,
Logan,U.S. Senate,James Lankford,REP,420306,0,1,43,44,
Logan,U.S. Senate,Jason Weger,REP,420306,0,0,2,2,
Logan,U.S. House,Timothy Ray Murray,REP,420306,0,0,8,8,03
Logan,U.S. House,Robert Hubbard,REP,420306,0,2,7,9,03
Logan,U.S. House,Frank Lucas,REP,420306,0,2,66,68,03
Logan,State Senate,Dan Ladd,REP,420306,0,3,31,34,20
Logan,State Senate,A Griffin,REP,420306,0,1,50,51,20
Logan,State House,Jason Murphey,REP,420306,1,2,64,67,31
Logan,State House,Andrew Muchmore,REP,420306,0,2,17,19,31
Logan,Superintendent of Public Instruction,John Cox,DEM,420307,2,3,30,35,
Logan,Superintendent of Public Instruction,Jack Jr.,DEM,420307,3,3,18,24,
Logan,Superintendent of Public Instruction,Ivan Holmes,DEM,420307,1,0,5,6,
Logan,Superintendent of Public Instruction,Freda Deskin,DEM,420307,2,2,30,34,
Logan,U.S. Senate,Patrick Michael Hayes,DEM,420307,3,0,17,20,
Logan,U.S. Senate,Jim Rogers,DEM,420307,2,3,23,28,
Logan,U.S. Senate,Connie Johnson,DEM,420307,3,5,44,52,
Logan,Governor,Dax Ewbank,REP,420307,0,3,27,30,
Logan,Governor,Chad Moody,REP,420307,1,1,42,44,
Logan,Governor,Mary Fallin,REP,420307,15,28,146,189,
Logan,Superintendent of Public Instruction,Brian Kelly,REP,420307,4,8,48,60,
Logan,Superintendent of Public Instruction,Janet Costello Barresi,REP,420307,5,9,43,57,
Logan,Superintendent of Public Instruction,Joy Hofmeister,REP,420307,6,14,118,138,
Logan,Insurance Commissioner,Bill Viner,REP,420307,1,7,40,48,
Logan,Insurance Commissioner,John Doak,REP,420307,13,21,162,196,
Logan,Corporation Commissioner,Todd Hiett,REP,420307,7,17,108,132,
Logan,Corporation Commissioner,Cliff Branan,REP,420307,7,12,86,105,
Logan,U.S. Senate,Evelyn Rogers,REP,420307,0,1,10,11,
Logan,U.S. Senate,Rob Moye,REP,420307,1,1,8,10,
Logan,U.S. Senate,D. Jean Mcbride-Samuels,REP,420307,1,2,2,5,
Logan,U.S. Senate,Jim Inhofe,REP,420307,14,26,188,228,
Logan,U.S. Senate,Erick Paul Wyatt,REP,420307,0,2,7,9,
Logan,U.S. Senate,Andy Craig,REP,420307,0,0,2,2,
Logan,U.S. Senate,T. Shannon,REP,420307,3,8,62,73,
Logan,U.S. Senate,Randy Brogdon,REP,420307,0,3,14,17,
Logan,U.S. Senate,Eric Mccray,REP,420307,0,0,2,2,
Logan,U.S. Senate,Kevin Crow,REP,420307,1,0,1,2,
Logan,U.S. Senate,James Lankford,REP,420307,11,22,132,165,
Logan,U.S. Senate,Jason Weger,REP,420307,0,0,0,0,
Logan,U.S. House,Timothy Ray Murray,REP,420307,0,0,8,8,03
Logan,U.S. House,Robert Hubbard,REP,420307,1,5,31,37,03
Logan,U.S. House,Frank Lucas,REP,420307,14,26,168,208,03
Logan,State Senate,Dan Ladd,REP,420307,4,7,68,79,20
Logan,State Senate,A Griffin,REP,420307,12,26,148,186,20
Logan,State House,Jason Murphey,REP,420307,10,11,141,162,31
Logan,State House,Andrew Muchmore,REP,420307,4,20,74,98,31
Logan,Superintendent of Public Instruction,John Cox,DEM,420308,0,4,27,31,
Logan,Superintendent of Public Instruction,Jack Jr.,DEM,420308,1,1,17,19,
Logan,Superintendent of Public Instruction,Ivan Holmes,DEM,420308,0,0,6,6,
Logan,Superintendent of Public Instruction,Freda Deskin,DEM,420308,3,1,24,28,
Logan,U.S. Senate,Patrick Michael Hayes,DEM,420308,0,0,10,10,
Logan,U.S. Senate,Jim Rogers,DEM,420308,0,1,19,20,
Logan,U.S. Senate,Connie Johnson,DEM,420308,4,6,44,54,
Logan,Governor,Dax Ewbank,REP,420308,0,3,21,24,
Logan,Governor,Chad Moody,REP,420308,1,6,25,32,
Logan,Governor,Mary Fallin,REP,420308,5,14,112,131,
Logan,Superintendent of Public Instruction,Brian Kelly,REP,420308,0,11,35,46,
Logan,Superintendent of Public Instruction,Janet Costello Barresi,REP,420308,2,5,31,38,
Logan,Superintendent of Public Instruction,Joy Hofmeister,REP,420308,2,6,92,100,
Logan,Insurance Commissioner,Bill Viner,REP,420308,0,7,29,36,
Logan,Insurance Commissioner,John Doak,REP,420308,5,14,128,147,
Logan,Corporation Commissioner,Todd Hiett,REP,420308,5,11,76,92,
Logan,Corporation Commissioner,Cliff Branan,REP,420308,0,10,77,87,
Logan,U.S. Senate,Evelyn Rogers,REP,420308,0,0,8,8,
Logan,U.S. Senate,Rob Moye,REP,420308,0,0,4,4,
Logan,U.S. Senate,D. Jean Mcbride-Samuels,REP,420308,0,1,2,3,
Logan,U.S. Senate,Jim Inhofe,REP,420308,6,21,137,164,
Logan,U.S. Senate,Erick Paul Wyatt,REP,420308,0,0,6,6,
Logan,U.S. Senate,Andy Craig,REP,420308,0,1,0,1,
Logan,U.S. Senate,T. Shannon,REP,420308,1,10,50,61,
Logan,U.S. Senate,Randy Brogdon,REP,420308,0,0,8,8,
Logan,U.S. Senate,Eric Mccray,REP,420308,0,0,5,5,
Logan,U.S. Senate,Kevin Crow,REP,420308,0,0,2,2,
Logan,U.S. Senate,James Lankford,REP,420308,5,11,92,108,
Logan,U.S. Senate,Jason Weger,REP,420308,0,0,1,1,
Logan,U.S. House,Timothy Ray Murray,REP,420308,0,1,5,6,03
Logan,U.S. House,Robert Hubbard,REP,420308,0,0,17,17,03
Logan,U.S. House,Frank Lucas,REP,420308,6,21,136,163,03
Logan,State Senate,Dan Ladd,REP,420308,1,5,29,35,20
Logan,State Senate,A Griffin,REP,420308,5,18,128,151,20
Logan,State House,Jason Murphey,REP,420308,3,15,111,129,31
Logan,State House,Andrew Muchmore,REP,420308,3,8,45,56,31
Logan,Superintendent of Public Instruction,John Cox,DEM,420309,0,1,1,2,
Logan,Superintendent of Public Instruction,Jack Jr.,DEM,420309,0,0,2,2,
Logan,Superintendent of Public Instruction,Ivan Holmes,DEM,420309,0,0,1,1,
Logan,Superintendent of Public Instruction,Freda Deskin,DEM,420309,0,0,0,0,
Logan,U.S. Senate,Patrick Michael Hayes,DEM,420309,0,0,0,0,
Logan,U.S. Senate,Jim Rogers,DEM,420309,0,0,2,2,
Logan,U.S. Senate,Connie Johnson,DEM,420309,0,1,2,3,
Logan,Governor,Dax Ewbank,REP,420309,0,0,0,0,
Logan,Governor,Chad Moody,REP,420309,0,0,0,0,
Logan,Governor,Mary Fallin,REP,420309,0,0,2,2,
Logan,Superintendent of Public Instruction,Brian Kelly,REP,420309,0,1,2,3,
Logan,Superintendent of Public Instruction,Janet Costello Barresi,REP,420309,0,0,0,0,
Logan,Superintendent of Public Instruction,Joy Hofmeister,REP,420309,0,0,0,0,
Logan,Insurance Commissioner,Bill Viner,REP,420309,0,1,0,1,
Logan,Insurance Commissioner,John Doak,REP,420309,0,0,2,2,
Logan,Corporation Commissioner,Todd Hiett,REP,420309,0,1,0,1,
Logan,Corporation Commissioner,Cliff Branan,REP,420309,0,0,1,1,
Logan,U.S. Senate,Evelyn Rogers,REP,420309,0,0,0,0,
Logan,U.S. Senate,Rob Moye,REP,420309,0,0,0,0,
Logan,U.S. Senate,D. Jean Mcbride-Samuels,REP,420309,0,0,0,0,
Logan,U.S. Senate,Jim Inhofe,REP,420309,0,1,2,3,
Logan,U.S. Senate,Erick Paul Wyatt,REP,420309,0,0,0,0,
Logan,U.S. Senate,Andy Craig,REP,420309,0,0,0,0,
Logan,U.S. Senate,T. Shannon,REP,420309,0,0,0,0,
Logan,U.S. Senate,Randy Brogdon,REP,420309,0,0,0,0,
Logan,U.S. Senate,Eric Mccray,REP,420309,0,0,0,0,
Logan,U.S. Senate,Kevin Crow,REP,420309,0,0,0,0,
Logan,U.S. Senate,James Lankford,REP,420309,0,1,2,3,
Logan,U.S. Senate,Jason Weger,REP,420309,0,0,0,0,
Logan,U.S. House,Timothy Ray Murray,REP,420309,0,0,0,0,03
Logan,U.S. House,Robert Hubbard,REP,420309,0,0,2,2,03
Logan,U.S. House,Frank Lucas,REP,420309,0,1,0,1,03
Logan,State Senate,Dan Ladd,REP,420309,0,0,0,0,20
Logan,State Senate,A Griffin,REP,420309,0,1,1,2,20
Logan,Superintendent of Public Instruction,John Cox,DEM,420310,2,0,5,7,
Logan,Superintendent of Public Instruction,Jack Jr.,DEM,420310,0,1,8,9,
Logan,Superintendent of Public Instruction,Ivan Holmes,DEM,420310,0,0,1,1,
Logan,Superintendent of Public Instruction,Freda Deskin,DEM,420310,0,0,19,19,
Logan,U.S. Senate,Patrick Michael Hayes,DEM,420310,0,0,2,2,
Logan,U.S. Senate,Jim Rogers,DEM,420310,0,0,0,0,
Logan,U.S. Senate,Connie Johnson,DEM,420310,2,1,31,34,
Logan,State House,Jamey White,DEM,420310,1,0,8,9,32
Logan,State House,Michial Poteet,DEM,420310,1,1,24,26,32
Logan,Governor,Dax Ewbank,REP,420310,0,0,0,0,
Logan,Governor,Chad Moody,REP,420310,0,0,0,0,
Logan,Governor,Mary Fallin,REP,420310,0,1,0,1,
Logan,Superintendent of Public Instruction,Brian Kelly,REP,420310,0,0,0,0,
Logan,Superintendent of Public Instruction,Janet Costello Barresi,REP,420310,0,1,0,1,
Logan,Superintendent of Public Instruction,Joy Hofmeister,REP,420310,0,0,0,0,
Logan,Insurance Commissioner,Bill Viner,REP,420310,0,1,0,1,
Logan,Insurance Commissioner,John Doak,REP,420310,0,0,0,0,
Logan,Corporation Commissioner,Todd Hiett,REP,420310,0,0,0,0,
Logan,Corporation Commissioner,Cliff Branan,REP,420310,0,1,0,1,
Logan,U.S. Senate,Evelyn Rogers,REP,420310,0,1,0,1,
Logan,U.S. Senate,Rob Moye,REP,420310,0,0,0,0,
Logan,U.S. Senate,D. Jean Mcbride-Samuels,REP,420310,0,0,0,0,
Logan,U.S. Senate,Jim Inhofe,REP,420310,0,0,0,0,
Logan,U.S. Senate,Erick Paul Wyatt,REP,420310,0,0,0,0,
Logan,U.S. Senate,Andy Craig,REP,420310,0,0,0,0,
Logan,U.S. Senate,T. Shannon,REP,420310,0,0,0,0,
Logan,U.S. Senate,Randy Brogdon,REP,420310,0,0,0,0,
Logan,U.S. Senate,Eric Mccray,REP,420310,0,1,0,1,
Logan,U.S. Senate,Kevin Crow,REP,420310,0,0,0,0,
Logan,U.S. Senate,James Lankford,REP,420310,0,0,0,0,
Logan,U.S. Senate,Jason Weger,REP,420310,0,0,0,0,
Logan,U.S. House,Timothy Ray Murray,REP,420310,0,0,0,0,03
Logan,U.S. House,Robert Hubbard,REP,420310,0,1,0,1,03
Logan,U.S. House,Frank Lucas,REP,420310,0,0,0,0,03
Logan,State Senate,Dan Ladd,REP,420310,0,0,0,0,20
Logan,State Senate,A Griffin,REP,420310,0,1,0,1,20
Logan,State House,Kevin Wallace,REP,420310,0,0,0,0,32
Logan,State House,Ray Wade,REP,420310,0,1,0,1,32
Love,Superintendent of Public Instruction,John Cox,DEM,430101,0,2,32,34,
Love,Superintendent of Public Instruction,Jack Jr.,DEM,430101,0,2,14,16,
Love,Superintendent of Public Instruction,Ivan Holmes,DEM,430101,1,1,6,8,
Love,Superintendent of Public Instruction,Freda Deskin,DEM,430101,0,1,23,24,
Love,U.S. Senate,Patrick Michael Hayes,DEM,430101,0,1,30,31,
Love,U.S. Senate,Jim Rogers,DEM,430101,0,1,24,25,
Love,U.S. Senate,Connie Johnson,DEM,430101,2,4,19,25,
Love,U.S. House,Bert Smith,DEM,430101,1,5,59,65,04
Love,U.S. House,Tae Si,DEM,430101,0,1,13,14,04
Love,Governor,Dax Ewbank,REP,430101,0,0,1,1,
Love,Governor,Chad Moody,REP,430101,0,0,3,3,
Love,Governor,Mary Fallin,REP,430101,2,3,10,15,
Love,Superintendent of Public Instruction,Brian Kelly,REP,430101,0,1,3,4,
Love,Superintendent of Public Instruction,Janet Costello Barresi,REP,430101,0,1,5,6,
Love,Superintendent of Public Instruction,Joy Hofmeister,REP,430101,2,1,4,7,
Love,Insurance Commissioner,Bill Viner,REP,430101,0,1,2,3,
Love,Insurance Commissioner,John Doak,REP,430101,2,2,11,15,
Love,Corporation Commissioner,Todd Hiett,REP,430101,0,2,6,8,
Love,Corporation Commissioner,Cliff Branan,REP,430101,2,0,7,9,
Love,U.S. Senate,Evelyn Rogers,REP,430101,0,0,0,0,
Love,U.S. Senate,Rob Moye,REP,430101,0,0,0,0,
Love,U.S. Senate,D. Jean Mcbride-Samuels,REP,430101,0,1,1,2,
Love,U.S. Senate,Jim Inhofe,REP,430101,2,2,11,15,
Love,U.S. Senate,Erick Paul Wyatt,REP,430101,0,0,1,1,
Love,U.S. Senate,Andy Craig,REP,430101,0,0,2,2,
Love,U.S. Senate,T. Shannon,REP,430101,0,1,5,6,
Love,U.S. Senate,Randy Brogdon,REP,430101,0,0,0,0,
Love,U.S. Senate,Eric Mccray,REP,430101,0,0,0,0,
Love,U.S. Senate,Kevin Crow,REP,430101,0,0,0,0,
Love,U.S. Senate,James Lankford,REP,430101,2,2,6,10,
Love,U.S. Senate,Jason Weger,REP,430101,0,0,1,1,
Love,U.S. House,Anna Flatt,REP,430101,0,0,1,1,04
Love,U.S. House,Tom Cole,REP,430101,2,3,13,18,04
Love,State House,Tommy Hardin,REP,430101,2,2,11,15,49
Love,State House,Kyle Reid Chatham,REP,430101,0,1,3,4,49
Love,Superintendent of Public Instruction,John Cox,DEM,430102,0,1,29,30,
Love,Superintendent of Public Instruction,Jack Jr.,DEM,430102,0,0,3,3,
Love,Superintendent of Public Instruction,Ivan Holmes,DEM,430102,0,1,2,3,
Love,Superintendent of Public Instruction,Freda Deskin,DEM,430102,0,3,21,24,
Love,U.S. Senate,Patrick Michael Hayes,DEM,430102,0,1,8,9,
Love,U.S. Senate,Jim Rogers,DEM,430102,0,0,22,22,
Love,U.S. Senate,Connie Johnson,DEM,430102,0,4,18,22,
Love,U.S. House,Bert Smith,DEM,430102,0,4,44,48,04
Love,U.S. House,Tae Si,DEM,430102,0,1,3,4,04
Love,Governor,Dax Ewbank,REP,430102,0,0,1,1,
Love,Governor,Chad Moody,REP,430102,0,0,2,2,
Love,Governor,Mary Fallin,REP,430102,0,1,14,15,
Love,Superintendent of Public Instruction,Brian Kelly,REP,430102,0,0,5,5,
Love,Superintendent of Public Instruction,Janet Costello Barresi,REP,430102,0,1,5,6,
Love,Superintendent of Public Instruction,Joy Hofmeister,REP,430102,0,0,5,5,
Love,Insurance Commissioner,Bill Viner,REP,430102,0,0,6,6,
Love,Insurance Commissioner,John Doak,REP,430102,0,1,7,8,
Love,Corporation Commissioner,Todd Hiett,REP,430102,0,0,8,8,
Love,Corporation Commissioner,Cliff Branan,REP,430102,0,1,3,4,
Love,U.S. Senate,Evelyn Rogers,REP,430102,0,1,0,1,
Love,U.S. Senate,Rob Moye,REP,430102,0,0,0,0,
Love,U.S. Senate,D. Jean Mcbride-Samuels,REP,430102,0,0,0,0,
Love,U.S. Senate,Jim Inhofe,REP,430102,0,0,17,17,
Love,U.S. Senate,Erick Paul Wyatt,REP,430102,0,0,0,0,
Love,U.S. Senate,Andy Craig,REP,430102,0,0,0,0,
Love,U.S. Senate,T. Shannon,REP,430102,0,1,8,9,
Love,U.S. Senate,Randy Brogdon,REP,430102,0,0,0,0,
Love,U.S. Senate,Eric Mccray,REP,430102,0,0,1,1,
Love,U.S. Senate,Kevin Crow,REP,430102,0,0,0,0,
Love,U.S. Senate,James Lankford,REP,430102,0,0,8,8,
Love,U.S. Senate,Jason Weger,REP,430102,0,0,0,0,
Love,U.S. House,Anna Flatt,REP,430102,0,0,1,1,04
Love,U.S. House,Tom Cole,REP,430102,0,1,15,16,04
Love,State House,Tommy Hardin,REP,430102,0,1,11,12,49
Love,State House,Kyle Reid Chatham,REP,430102,0,0,6,6,49
Love,Superintendent of Public Instruction,John Cox,DEM,430103,0,0,17,17,
Love,Superintendent of Public Instruction,Jack Jr.,DEM,430103,0,0,8,8,
Love,Superintendent of Public Instruction,Ivan Holmes,DEM,430103,0,1,6,7,
Love,Superintendent of Public Instruction,Freda Deskin,DEM,430103,0,1,19,20,
Love,U.S. Senate,Patrick Michael Hayes,DEM,430103,0,1,8,9,
Love,U.S. Senate,Jim Rogers,DEM,430103,0,0,26,26,
Love,U.S. Senate,Connie Johnson,DEM,430103,0,1,13,14,
Love,U.S. House,Bert Smith,DEM,430103,0,2,45,47,04
Love,U.S. House,Tae Si,DEM,430103,0,0,3,3,04
Love,Governor,Dax Ewbank,REP,430103,0,0,1,1,
Love,Governor,Chad Moody,REP,430103,0,0,1,1,
Love,Governor,Mary Fallin,REP,430103,0,0,9,9,
Love,Superintendent of Public Instruction,Brian Kelly,REP,430103,0,0,0,0,
Love,Superintendent of Public Instruction,Janet Costello Barresi,REP,430103,0,0,4,4,
Love,Superintendent of Public Instruction,Joy Hofmeister,REP,430103,0,0,5,5,
Love,Insurance Commissioner,Bill Viner,REP,430103,0,0,1,1,
Love,Insurance Commissioner,John Doak,REP,430103,0,0,6,6,
Love,Corporation Commissioner,Todd Hiett,REP,430103,0,0,2,2,
Love,Corporation Commissioner,Cliff Branan,REP,430103,0,0,6,6,
Love,U.S. Senate,Evelyn Rogers,REP,430103,0,0,1,1,
Love,U.S. Senate,Rob Moye,REP,430103,0,0,0,0,
Love,U.S. Senate,D. Jean Mcbride-Samuels,REP,430103,0,0,0,0,
Love,U.S. Senate,Jim Inhofe,REP,430103,0,0,8,8,
Love,U.S. Senate,Erick Paul Wyatt,REP,430103,0,0,0,0,
Love,U.S. Senate,Andy Craig,REP,430103,0,0,1,1,
Love,U.S. Senate,T. Shannon,REP,430103,0,0,4,4,
Love,U.S. Senate,Randy Brogdon,REP,430103,0,0,0,0,
Love,U.S. Senate,Eric Mccray,REP,430103,0,0,0,0,
Love,U.S. Senate,Kevin Crow,REP,430103,0,0,0,0,
Love,U.S. Senate,James Lankford,REP,430103,0,0,5,5,
Love,U.S. Senate,Jason Weger,REP,430103,0,0,0,0,
Love,U.S. House,Anna Flatt,REP,430103,0,0,2,2,04
Love,U.S. House,Tom Cole,REP,430103,0,0,8,8,04
Love,State House,Tommy Hardin,REP,430103,0,0,9,9,49
Love,State House,Kyle Reid Chatham,REP,430103,0,0,1,1,49
Love,Superintendent of Public Instruction,John Cox,DEM,430204,0,1,19,20,
Love,Superintendent of Public Instruction,Jack Jr.,DEM,430204,0,0,7,7,
Love,Superintendent of Public Instruction,Ivan Holmes,DEM,430204,0,0,4,4,
Love,Superintendent of Public Instruction,Freda Deskin,DEM,430204,0,1,19,20,
Love,U.S. Senate,Patrick Michael Hayes,DEM,430204,0,1,9,10,
Love,U.S. Senate,Jim Rogers,DEM,430204,0,0,15,15,
Love,U.S. Senate,Connie Johnson,DEM,430204,0,1,19,20,
Love,U.S. House,Bert Smith,DEM,430204,0,1,37,38,04
Love,U.S. House,Tae Si,DEM,430204,0,1,5,6,04
Love,Governor,Dax Ewbank,REP,430204,0,0,0,0,
Love,Governor,Chad Moody,REP,430204,0,0,0,0,
Love,Governor,Mary Fallin,REP,430204,0,1,5,6,
Love,Superintendent of Public Instruction,Brian Kelly,REP,430204,0,1,2,3,
Love,Superintendent of Public Instruction,Janet Costello Barresi,REP,430204,0,0,1,1,
Love,Superintendent of Public Instruction,Joy Hofmeister,REP,430204,0,0,2,2,
Love,Insurance Commissioner,Bill Viner,REP,430204,0,0,0,0,
Love,Insurance Commissioner,John Doak,REP,430204,0,1,4,5,
Love,Corporation Commissioner,Todd Hiett,REP,430204,0,0,2,2,
Love,Corporation Commissioner,Cliff Branan,REP,430204,0,0,2,2,
Love,U.S. Senate,Evelyn Rogers,REP,430204,0,0,0,0,
Love,U.S. Senate,Rob Moye,REP,430204,0,0,0,0,
Love,U.S. Senate,D. Jean Mcbride-Samuels,REP,430204,0,0,0,0,
Love,U.S. Senate,Jim Inhofe,REP,430204,0,1,5,6,
Love,U.S. Senate,Erick Paul Wyatt,REP,430204,0,0,0,0,
Love,U.S. Senate,Andy Craig,REP,430204,0,0,0,0,
Love,U.S. Senate,T. Shannon,REP,430204,0,1,2,3,
Love,U.S. Senate,Randy Brogdon,REP,430204,0,0,0,0,
Love,U.S. Senate,Eric Mccray,REP,430204,0,0,0,0,
Love,U.S. Senate,Kevin Crow,REP,430204,0,0,0,0,
Love,U.S. Senate,James Lankford,REP,430204,0,0,3,3,
Love,U.S. Senate,Jason Weger,REP,430204,0,0,0,0,
Love,U.S. House,Anna Flatt,REP,430204,0,0,1,1,04
Love,U.S. House,Tom Cole,REP,430204,0,1,4,5,04
Love,State House,Tommy Hardin,REP,430204,0,1,3,4,49
Love,State House,Kyle Reid Chatham,REP,430204,0,0,1,1,49
Love,Superintendent of Public Instruction,John Cox,DEM,430205,0,6,29,35,
Love,Superintendent of Public Instruction,Jack Jr.,DEM,430205,0,2,9,11,
Love,Superintendent of Public Instruction,Ivan Holmes,DEM,430205,0,1,2,3,
Love,Superintendent of Public Instruction,Freda Deskin,DEM,430205,0,0,23,23,
Love,U.S. Senate,Patrick Michael Hayes,DEM,430205,0,4,11,15,
Love,U.S. Senate,Jim Rogers,DEM,430205,0,5,23,28,
Love,U.S. Senate,Connie Johnson,DEM,430205,0,0,22,22,
Love,U.S. House,Bert Smith,DEM,430205,0,9,48,57,04
Love,U.S. House,Tae Si,DEM,430205,0,0,7,7,04
Love,Governor,Dax Ewbank,REP,430205,0,0,3,3,
Love,Governor,Chad Moody,REP,430205,0,2,5,7,
Love,Governor,Mary Fallin,REP,430205,0,0,35,35,
Love,Superintendent of Public Instruction,Brian Kelly,REP,430205,0,0,16,16,
Love,Superintendent of Public Instruction,Janet Costello Barresi,REP,430205,0,0,11,11,
Love,Superintendent of Public Instruction,Joy Hofmeister,REP,430205,0,2,16,18,
Love,Insurance Commissioner,Bill Viner,REP,430205,0,0,12,12,
Love,Insurance Commissioner,John Doak,REP,430205,0,1,28,29,
Love,Corporation Commissioner,Todd Hiett,REP,430205,0,1,26,27,
Love,Corporation Commissioner,Cliff Branan,REP,430205,0,0,14,14,
Love,U.S. Senate,Evelyn Rogers,REP,430205,0,0,3,3,
Love,U.S. Senate,Rob Moye,REP,430205,0,0,0,0,
Love,U.S. Senate,D. Jean Mcbride-Samuels,REP,430205,0,0,0,0,
Love,U.S. Senate,Jim Inhofe,REP,430205,0,1,35,36,
Love,U.S. Senate,Erick Paul Wyatt,REP,430205,0,0,6,6,
Love,U.S. Senate,Andy Craig,REP,430205,0,0,4,4,
Love,U.S. Senate,T. Shannon,REP,430205,0,0,23,23,
Love,U.S. Senate,Randy Brogdon,REP,430205,0,0,0,0,
Love,U.S. Senate,Eric Mccray,REP,430205,0,0,1,1,
Love,U.S. Senate,Kevin Crow,REP,430205,0,0,0,0,
Love,U.S. Senate,James Lankford,REP,430205,0,1,16,17,
Love,U.S. Senate,Jason Weger,REP,430205,0,1,0,1,
Love,U.S. House,Anna Flatt,REP,430205,0,0,8,8,04
Love,U.S. House,Tom Cole,REP,430205,0,2,36,38,04
Love,State House,Tommy Hardin,REP,430205,0,0,35,35,49
Love,State House,Kyle Reid Chatham,REP,430205,0,1,7,8,49
Love,Superintendent of Public Instruction,John Cox,DEM,430206,0,2,19,21,
Love,Superintendent of Public Instruction,Jack Jr.,DEM,430206,0,0,2,2,
Love,Superintendent of Public Instruction,Ivan Holmes,DEM,430206,0,0,1,1,
Love,Superintendent of Public Instruction,Freda Deskin,DEM,430206,0,0,15,15,
Love,U.S. Senate,Patrick Michael Hayes,DEM,430206,0,0,7,7,
Love,U.S. Senate,Jim Rogers,DEM,430206,0,0,20,20,
Love,U.S. Senate,Connie Johnson,DEM,430206,0,2,7,9,
Love,U.S. House,Bert Smith,DEM,430206,0,2,23,25,04
Love,U.S. House,Tae Si,DEM,430206,0,0,6,6,04
Love,Governor,Dax Ewbank,REP,430206,0,0,1,1,
Love,Governor,Chad Moody,REP,430206,0,0,2,2,
Love,Governor,Mary Fallin,REP,430206,0,0,6,6,
Love,Superintendent of Public Instruction,Brian Kelly,REP,430206,0,0,6,6,
Love,Superintendent of Public Instruction,Janet Costello Barresi,REP,430206,0,0,1,1,
Love,Superintendent of Public Instruction,Joy Hofmeister,REP,430206,0,0,2,2,
Love,Insurance Commissioner,Bill Viner,REP,430206,0,0,2,2,
Love,Insurance Commissioner,John Doak,REP,430206,0,0,6,6,
Love,Corporation Commissioner,Todd Hiett,REP,430206,0,0,2,2,
Love,Corporation Commissioner,Cliff Branan,REP,430206,0,0,6,6,
Love,U.S. Senate,Evelyn Rogers,REP,430206,0,0,0,0,
Love,U.S. Senate,Rob Moye,REP,430206,0,0,0,0,
Love,U.S. Senate,D. Jean Mcbride-Samuels,REP,430206,0,0,0,0,
Love,U.S. Senate,Jim Inhofe,REP,430206,0,0,7,7,
Love,U.S. Senate,Erick Paul Wyatt,REP,430206,0,0,2,2,
Love,U.S. Senate,Andy Craig,REP,430206,0,0,2,2,
Love,U.S. Senate,T. Shannon,REP,430206,0,0,2,2,
Love,U.S. Senate,Randy Brogdon,REP,430206,0,0,1,1,
Love,U.S. Senate,Eric Mccray,REP,430206,0,0,0,0,
Love,U.S. Senate,Kevin Crow,REP,430206,0,0,0,0,
Love,U.S. Senate,James Lankford,REP,430206,0,0,1,1,
Love,U.S. Senate,Jason Weger,REP,430206,0,0,2,2,
Love,U.S. House,Anna Flatt,REP,430206,0,0,0,0,04
Love,U.S. House,Tom Cole,REP,430206,0,0,9,9,04
Love,State House,Tommy Hardin,REP,430206,0,0,7,7,49
Love,State House,Kyle Reid Chatham,REP,430206,0,0,1,1,49
Love,Superintendent of Public Instruction,John Cox,DEM,430207,0,5,11,16,
Love,Superintendent of Public Instruction,Jack Jr.,DEM,430207,0,0,1,1,
Love,Superintendent of Public Instruction,Ivan Holmes,DEM,430207,0,0,1,1,
Love,Superintendent of Public Instruction,Freda Deskin,DEM,430207,0,0,9,9,
Love,U.S. Senate,Patrick Michael Hayes,DEM,430207,0,1,5,6,
Love,U.S. Senate,Jim Rogers,DEM,430207,0,1,5,6,
Love,U.S. Senate,Connie Johnson,DEM,430207,0,3,11,14,
Love,U.S. House,Bert Smith,DEM,430207,0,5,20,25,04
Love,U.S. House,Tae Si,DEM,430207,0,0,1,1,04
Love,Governor,Dax Ewbank,REP,430207,0,0,0,0,
Love,Governor,Chad Moody,REP,430207,0,0,0,0,
Love,Governor,Mary Fallin,REP,430207,0,0,3,3,
Love,Superintendent of Public Instruction,Brian Kelly,REP,430207,0,0,1,1,
Love,Superintendent of Public Instruction,Janet Costello Barresi,REP,430207,0,0,2,2,
Love,Superintendent of Public Instruction,Joy Hofmeister,REP,430207,0,0,0,0,
Love,Insurance Commissioner,Bill Viner,REP,430207,0,0,1,1,
Love,Insurance Commissioner,John Doak,REP,430207,0,0,2,2,
Love,Corporation Commissioner,Todd Hiett,REP,430207,0,0,3,3,
Love,Corporation Commissioner,Cliff Branan,REP,430207,0,0,0,0,
Love,U.S. Senate,Evelyn Rogers,REP,430207,0,0,0,0,
Love,U.S. Senate,Rob Moye,REP,430207,0,0,0,0,
Love,U.S. Senate,D. Jean Mcbride-Samuels,REP,430207,0,0,1,1,
Love,U.S. Senate,Jim Inhofe,REP,430207,0,0,1,1,
Love,U.S. Senate,Erick Paul Wyatt,REP,430207,0,0,1,1,
Love,U.S. Senate,Andy Craig,REP,430207,0,0,0,0,
Love,U.S. Senate,T. Shannon,REP,430207,0,0,0,0,
Love,U.S. Senate,Randy Brogdon,REP,430207,0,0,0,0,
Love,U.S. Senate,Eric Mccray,REP,430207,0,0,0,0,
Love,U.S. Senate,Kevin Crow,REP,430207,0,0,0,0,
Love,U.S. Senate,James Lankford,REP,430207,0,0,2,2,
Love,U.S. Senate,Jason Weger,REP,430207,0,0,1,1,
Love,U.S. House,Anna Flatt,REP,430207,0,0,0,0,04
Love,U.S. House,Tom Cole,REP,430207,0,0,3,3,04
Love,State House,Tommy Hardin,REP,430207,0,0,3,3,49
Love,State House,Kyle Reid Chatham,REP,430207,0,0,0,0,49
Love,Superintendent of Public Instruction,John Cox,DEM,430208,0,2,9,11,
Love,Superintendent of Public Instruction,Jack Jr.,DEM,430208,0,0,1,1,
Love,Superintendent of Public Instruction,Ivan Holmes,DEM,430208,0,0,1,1,
Love,Superintendent of Public Instruction,Freda Deskin,DEM,430208,0,0,3,3,
Love,U.S. Senate,Patrick Michael Hayes,DEM,430208,0,0,2,2,
Love,U.S. Senate,Jim Rogers,DEM,430208,0,2,9,11,
Love,U.S. Senate,Connie Johnson,DEM,430208,0,0,2,2,
Love,U.S. House,Bert Smith,DEM,430208,0,2,13,15,04
Love,U.S. House,Tae Si,DEM,430208,0,0,0,0,04
Love,Governor,Dax Ewbank,REP,430208,0,0,0,0,
Love,Governor,Chad Moody,REP,430208,0,0,1,1,
Love,Governor,Mary Fallin,REP,430208,0,0,1,1,
Love,Superintendent of Public Instruction,Brian Kelly,REP,430208,0,0,1,1,
Love,Superintendent of Public Instruction,Janet Costello Barresi,REP,430208,0,0,0,0,
Love,Superintendent of Public Instruction,Joy Hofmeister,REP,430208,0,0,1,1,
Love,Insurance Commissioner,Bill Viner,REP,430208,0,0,0,0,
Love,Insurance Commissioner,John Doak,REP,430208,0,0,2,2,
Love,Corporation Commissioner,Todd Hiett,REP,430208,0,0,2,2,
Love,Corporation Commissioner,Cliff Branan,REP,430208,0,0,0,0,
Love,U.S. Senate,Evelyn Rogers,REP,430208,0,0,0,0,
Love,U.S. Senate,Rob Moye,REP,430208,0,0,0,0,
Love,U.S. Senate,D. Jean Mcbride-Samuels,REP,430208,0,0,0,0,
Love,U.S. Senate,Jim Inhofe,REP,430208,0,0,2,2,
Love,U.S. Senate,Erick Paul Wyatt,REP,430208,0,0,0,0,
Love,U.S. Senate,Andy Craig,REP,430208,0,0,0,0,
Love,U.S. Senate,T. Shannon,REP,430208,0,0,2,2,
Love,U.S. Senate,Randy Brogdon,REP,430208,0,0,0,0,
Love,U.S. Senate,Eric Mccray,REP,430208,0,0,0,0,
Love,U.S. Senate,Kevin Crow,REP,430208,0,0,0,0,
Love,U.S. Senate,James Lankford,REP,430208,0,0,0,0,
Love,U.S. Senate,Jason Weger,REP,430208,0,0,0,0,
Love,U.S. House,Anna Flatt,REP,430208,0,0,0,0,04
Love,U.S. House,Tom Cole,REP,430208,0,0,2,2,04
Love,State House,Tommy Hardin,REP,430208,0,0,2,2,49
Love,State House,Kyle Reid Chatham,REP,430208,0,0,0,0,49
Love,Superintendent of Public Instruction,John Cox,DEM,430310,0,2,14,16,
Love,Superintendent of Public Instruction,Jack Jr.,DEM,430310,1,0,9,10,
Love,Superintendent of Public Instruction,Ivan Holmes,DEM,430310,0,0,4,4,
Love,Superintendent of Public Instruction,Freda Deskin,DEM,430310,0,1,26,27,
Love,U.S. Senate,Patrick Michael Hayes,DEM,430310,1,1,8,10,
Love,U.S. Senate,Jim Rogers,DEM,430310,0,0,19,19,
Love,U.S. Senate,Connie Johnson,DEM,430310,0,2,25,27,
Love,U.S. House,Bert Smith,DEM,430310,1,3,50,54,04
Love,U.S. House,Tae Si,DEM,430310,0,0,2,2,04
Love,Governor,Dax Ewbank,REP,430310,0,0,1,1,
Love,Governor,Chad Moody,REP,430310,0,0,3,3,
Love,Governor,Mary Fallin,REP,430310,0,0,5,5,
Love,Superintendent of Public Instruction,Brian Kelly,REP,430310,0,0,3,3,
Love,Superintendent of Public Instruction,Janet Costello Barresi,REP,430310,0,0,3,3,
Love,Superintendent of Public Instruction,Joy Hofmeister,REP,430310,0,0,3,3,
Love,Insurance Commissioner,Bill Viner,REP,430310,0,0,6,6,
Love,Insurance Commissioner,John Doak,REP,430310,0,0,3,3,
Love,Corporation Commissioner,Todd Hiett,REP,430310,0,0,6,6,
Love,Corporation Commissioner,Cliff Branan,REP,430310,0,0,3,3,
Love,U.S. Senate,Evelyn Rogers,REP,430310,0,0,1,1,
Love,U.S. Senate,Rob Moye,REP,430310,0,0,0,0,
Love,U.S. Senate,D. Jean Mcbride-Samuels,REP,430310,0,0,1,1,
Love,U.S. Senate,Jim Inhofe,REP,430310,0,0,6,6,
Love,U.S. Senate,Erick Paul Wyatt,REP,430310,0,0,1,1,
Love,U.S. Senate,Andy Craig,REP,430310,0,0,1,1,
Love,U.S. Senate,T. Shannon,REP,430310,0,0,1,1,
Love,U.S. Senate,Randy Brogdon,REP,430310,0,0,0,0,
Love,U.S. Senate,Eric Mccray,REP,430310,0,0,0,0,
Love,U.S. Senate,Kevin Crow,REP,430310,0,0,0,0,
Love,U.S. Senate,James Lankford,REP,430310,0,0,7,7,
Love,U.S. Senate,Jason Weger,REP,430310,0,0,0,0,
Love,U.S. House,Anna Flatt,REP,430310,0,0,2,2,04
Love,U.S. House,Tom Cole,REP,430310,0,0,7,7,04
Love,State House,Tommy Hardin,REP,430310,0,0,7,7,49
Love,State House,Kyle Reid Chatham,REP,430310,0,0,2,2,49
Love,Superintendent of Public Instruction,John Cox,DEM,430311,1,0,22,23,
Love,Superintendent of Public Instruction,Jack Jr.,DEM,430311,0,0,7,7,
Love,Superintendent of Public Instruction,Ivan Holmes,DEM,430311,0,0,3,3,
Love,Superintendent of Public Instruction,Freda Deskin,DEM,430311,0,0,26,26,
Love,U.S. Senate,Patrick Michael Hayes,DEM,430311,0,0,13,13,
Love,U.S. Senate,Jim Rogers,DEM,430311,0,0,28,28,
Love,U.S. Senate,Connie Johnson,DEM,430311,1,0,15,16,
Love,U.S. House,Bert Smith,DEM,430311,1,0,46,47,04
Love,U.S. House,Tae Si,DEM,430311,0,0,9,9,04
Love,Governor,Dax Ewbank,REP,430311,0,0,0,0,
Love,Governor,Chad Moody,REP,430311,0,2,6,8,
Love,Governor,Mary Fallin,REP,430311,0,2,26,28,
Love,Superintendent of Public Instruction,Brian Kelly,REP,430311,0,0,11,11,
Love,Superintendent of Public Instruction,Janet Costello Barresi,REP,430311,0,0,7,7,
Love,Superintendent of Public Instruction,Joy Hofmeister,REP,430311,0,4,12,16,
Love,Insurance Commissioner,Bill Viner,REP,430311,0,2,8,10,
Love,Insurance Commissioner,John Doak,REP,430311,0,1,19,20,
Love,Corporation Commissioner,Todd Hiett,REP,430311,0,4,17,21,
Love,Corporation Commissioner,Cliff Branan,REP,430311,0,0,11,11,
Love,U.S. Senate,Evelyn Rogers,REP,430311,0,0,2,2,
Love,U.S. Senate,Rob Moye,REP,430311,0,0,0,0,
Love,U.S. Senate,D. Jean Mcbride-Samuels,REP,430311,0,0,1,1,
Love,U.S. Senate,Jim Inhofe,REP,430311,0,4,26,30,
Love,U.S. Senate,Erick Paul Wyatt,REP,430311,0,0,3,3,
Love,U.S. Senate,Andy Craig,REP,430311,0,0,0,0,
Love,U.S. Senate,T. Shannon,REP,430311,0,2,15,17,
Love,U.S. Senate,Randy Brogdon,REP,430311,0,0,1,1,
Love,U.S. Senate,Eric Mccray,REP,430311,0,0,0,0,
Love,U.S. Senate,Kevin Crow,REP,430311,0,0,0,0,
Love,U.S. Senate,James Lankford,REP,430311,0,2,15,17,
Love,U.S. Senate,Jason Weger,REP,430311,0,0,0,0,
Love,U.S. House,Anna Flatt,REP,430311,0,0,10,10,04
Love,U.S. House,Tom Cole,REP,430311,0,4,22,26,04
Love,State House,Tommy Hardin,REP,430311,0,4,26,30,49
Love,State House,Kyle Reid Chatham,REP,430311,0,0,6,6,49
Love,Superintendent of Public Instruction,John Cox,DEM,430312,0,3,13,16,
Love,Superintendent of Public Instruction,Jack Jr.,DEM,430312,0,0,6,6,
Love,Superintendent of Public Instruction,Ivan Holmes,DEM,430312,0,0,4,4,
Love,Superintendent of Public Instruction,Freda Deskin,DEM,430312,0,1,26,27,
Love,U.S. Senate,Patrick Michael Hayes,DEM,430312,0,3,15,18,
Love,U.S. Senate,Jim Rogers,DEM,430312,0,1,16,17,
Love,U.S. Senate,Connie Johnson,DEM,430312,0,0,18,18,
Love,U.S. House,Bert Smith,DEM,430312,0,4,46,50,04
Love,U.S. House,Tae Si,DEM,430312,0,0,2,2,04
Love,Governor,Dax Ewbank,REP,430312,0,0,3,3,
Love,Governor,Chad Moody,REP,430312,0,0,3,3,
Love,Governor,Mary Fallin,REP,430312,0,0,14,14,
Love,Superintendent of Public Instruction,Brian Kelly,REP,430312,0,0,4,4,
Love,Superintendent of Public Instruction,Janet Costello Barresi,REP,430312,0,0,9,9,
Love,Superintendent of Public Instruction,Joy Hofmeister,REP,430312,0,1,6,7,
Love,Insurance Commissioner,Bill Viner,REP,430312,0,0,7,7,
Love,Insurance Commissioner,John Doak,REP,430312,0,1,12,13,
Love,Corporation Commissioner,Todd Hiett,REP,430312,0,1,10,11,
Love,Corporation Commissioner,Cliff Branan,REP,430312,0,0,9,9,
Love,U.S. Senate,Evelyn Rogers,REP,430312,0,0,0,0,
Love,U.S. Senate,Rob Moye,REP,430312,0,0,0,0,
Love,U.S. Senate,D. Jean Mcbride-Samuels,REP,430312,0,0,1,1,
Love,U.S. Senate,Jim Inhofe,REP,430312,0,1,18,19,
Love,U.S. Senate,Erick Paul Wyatt,REP,430312,0,0,0,0,
Love,U.S. Senate,Andy Craig,REP,430312,0,1,2,3,
Love,U.S. Senate,T. Shannon,REP,430312,0,0,9,9,
Love,U.S. Senate,Randy Brogdon,REP,430312,0,0,0,0,
Love,U.S. Senate,Eric Mccray,REP,430312,0,0,1,1,
Love,U.S. Senate,Kevin Crow,REP,430312,0,0,0,0,
Love,U.S. Senate,James Lankford,REP,430312,0,0,8,8,
Love,U.S. Senate,Jason Weger,REP,430312,0,0,0,0,
Love,U.S. House,Anna Flatt,REP,430312,0,0,2,2,04
Love,U.S. House,Tom Cole,REP,430312,0,1,18,19,04
Love,State House,Tommy Hardin,REP,430312,0,1,16,17,49
Love,State House,Kyle Reid Chatham,REP,430312,0,0,3,3,49
Love,Superintendent of Public Instruction,John Cox,DEM,430313,0,0,14,14,
Love,Superintendent of Public Instruction,Jack Jr.,DEM,430313,0,0,7,7,
Love,Superintendent of Public Instruction,Ivan Holmes,DEM,430313,0,0,1,1,
Love,Superintendent of Public Instruction,Freda Deskin,DEM,430313,0,0,9,9,
Love,U.S. Senate,Patrick Michael Hayes,DEM,430313,0,0,3,3,
Love,U.S. Senate,Jim Rogers,DEM,430313,0,0,16,16,
Love,U.S. Senate,Connie Johnson,DEM,430313,0,0,9,9,
Love,U.S. House,Bert Smith,DEM,430313,0,0,27,27,04
Love,U.S. House,Tae Si,DEM,430313,0,0,1,1,04
Love,Governor,Dax Ewbank,REP,430313,0,0,0,0,
Love,Governor,Chad Moody,REP,430313,0,0,2,2,
Love,Governor,Mary Fallin,REP,430313,0,0,5,5,
Love,Superintendent of Public Instruction,Brian Kelly,REP,430313,0,0,1,1,
Love,Superintendent of Public Instruction,Janet Costello Barresi,REP,430313,0,0,3,3,
Love,Superintendent of Public Instruction,Joy Hofmeister,REP,430313,0,0,2,2,
Love,Insurance Commissioner,Bill Viner,REP,430313,0,0,2,2,
Love,Insurance Commissioner,John Doak,REP,430313,0,0,3,3,
Love,Corporation Commissioner,Todd Hiett,REP,430313,0,0,4,4,
Love,Corporation Commissioner,Cliff Branan,REP,430313,0,0,1,1,
Love,U.S. Senate,Evelyn Rogers,REP,430313,0,0,0,0,
Love,U.S. Senate,Rob Moye,REP,430313,0,0,0,0,
Love,U.S. Senate,D. Jean Mcbride-Samuels,REP,430313,0,0,0,0,
Love,U.S. Senate,Jim Inhofe,REP,430313,0,0,7,7,
Love,U.S. Senate,Erick Paul Wyatt,REP,430313,0,0,0,0,
Love,U.S. Senate,Andy Craig,REP,430313,0,0,1,1,
Love,U.S. Senate,T. Shannon,REP,430313,0,0,2,2,
Love,U.S. Senate,Randy Brogdon,REP,430313,0,0,0,0,
Love,U.S. Senate,Eric Mccray,REP,430313,0,0,0,0,
Love,U.S. Senate,Kevin Crow,REP,430313,0,0,0,0,
Love,U.S. Senate,James Lankford,REP,430313,0,0,4,4,
Love,U.S. Senate,Jason Weger,REP,430313,0,0,0,0,
Love,U.S. House,Anna Flatt,REP,430313,0,0,0,0,04
Love,U.S. House,Tom Cole,REP,430313,0,0,7,7,04
Love,State House,Tommy Hardin,REP,430313,0,0,5,5,49
Love,State House,Kyle Reid Chatham,REP,430313,0,0,1,1,49
Mcclain,Superintendent of Public Instruction,John Cox,DEM,440001,0,0,14,14,
Mcclain,Superintendent of Public Instruction,Jack Jr.,DEM,440001,0,0,1,1,
Mcclain,Superintendent of Public Instruction,Ivan Holmes,DEM,440001,0,0,4,4,
Mcclain,Superintendent of Public Instruction,Freda Deskin,DEM,440001,0,0,14,14,
Mcclain,U.S. Senate,Patrick Michael Hayes,DEM,440001,0,0,9,9,
Mcclain,U.S. Senate,Jim Rogers,DEM,440001,0,0,13,13,
Mcclain,U.S. Senate,Connie Johnson,DEM,440001,0,0,10,10,
Mcclain,U.S. House,Bert Smith,DEM,440001,0,0,30,30,04
Mcclain,U.S. House,Tae Si,DEM,440001,0,0,2,2,04
Mcclain,Governor,Dax Ewbank,REP,440001,0,0,3,3,
Mcclain,Governor,Chad Moody,REP,440001,0,0,6,6,
Mcclain,Governor,Mary Fallin,REP,440001,1,0,48,49,
Mcclain,Superintendent of Public Instruction,Brian Kelly,REP,440001,0,0,16,16,
Mcclain,Superintendent of Public Instruction,Janet Costello Barresi,REP,440001,0,0,8,8,
Mcclain,Superintendent of Public Instruction,Joy Hofmeister,REP,440001,1,0,30,31,
Mcclain,Insurance Commissioner,Bill Viner,REP,440001,0,0,10,10,
Mcclain,Insurance Commissioner,John Doak,REP,440001,1,0,42,43,
Mcclain,Corporation Commissioner,Todd Hiett,REP,440001,1,0,28,29,
Mcclain,Corporation Commissioner,Cliff Branan,REP,440001,0,0,23,23,
Mcclain,U.S. Senate,Evelyn Rogers,REP,440001,0,0,0,0,
Mcclain,U.S. Senate,Rob Moye,REP,440001,0,0,0,0,
Mcclain,U.S. Senate,D. Jean Mcbride-Samuels,REP,440001,0,0,0,0,
Mcclain,U.S. Senate,Jim Inhofe,REP,440001,1,0,53,54,
Mcclain,U.S. Senate,Erick Paul Wyatt,REP,440001,0,0,4,4,
Mcclain,U.S. Senate,Andy Craig,REP,440001,0,0,0,0,
Mcclain,U.S. Senate,T. Shannon,REP,440001,0,0,19,19,
Mcclain,U.S. Senate,Randy Brogdon,REP,440001,0,0,2,2,
Mcclain,U.S. Senate,Eric Mccray,REP,440001,0,0,0,0,
Mcclain,U.S. Senate,Kevin Crow,REP,440001,0,0,0,0,
Mcclain,U.S. Senate,James Lankford,REP,440001,1,0,36,37,
Mcclain,U.S. Senate,Jason Weger,REP,440001,0,0,0,0,
Mcclain,U.S. House,Anna Flatt,REP,440001,0,0,6,6,04
Mcclain,U.S. House,Tom Cole,REP,440001,1,0,51,52,04
Mcclain,Superintendent of Public Instruction,John Cox,DEM,440002,0,2,8,10,
Mcclain,Superintendent of Public Instruction,Jack Jr.,DEM,440002,2,0,0,2,
Mcclain,Superintendent of Public Instruction,Ivan Holmes,DEM,440002,0,0,2,2,
Mcclain,Superintendent of Public Instruction,Freda Deskin,DEM,440002,3,2,17,22,
Mcclain,U.S. Senate,Patrick Michael Hayes,DEM,440002,1,0,8,9,
Mcclain,U.S. Senate,Jim Rogers,DEM,440002,0,1,12,13,
Mcclain,U.S. Senate,Connie Johnson,DEM,440002,4,3,5,12,
Mcclain,U.S. House,Bert Smith,DEM,440002,4,4,18,26,04
Mcclain,U.S. House,Tae Si,DEM,440002,0,0,4,4,04
Mcclain,Governor,Dax Ewbank,REP,440002,0,0,0,0,
Mcclain,Governor,Chad Moody,REP,440002,0,0,6,6,
Mcclain,Governor,Mary Fallin,REP,440002,3,0,41,44,
Mcclain,Superintendent of Public Instruction,Brian Kelly,REP,440002,2,0,9,11,
Mcclain,Superintendent of Public Instruction,Janet Costello Barresi,REP,440002,0,0,7,7,
Mcclain,Superintendent of Public Instruction,Joy Hofmeister,REP,440002,1,0,31,32,
Mcclain,Insurance Commissioner,Bill Viner,REP,440002,1,0,12,13,
Mcclain,Insurance Commissioner,John Doak,REP,440002,2,0,32,34,
Mcclain,Corporation Commissioner,Todd Hiett,REP,440002,2,0,26,28,
Mcclain,Corporation Commissioner,Cliff Branan,REP,440002,1,0,19,20,
Mcclain,U.S. Senate,Evelyn Rogers,REP,440002,0,0,0,0,
Mcclain,U.S. Senate,Rob Moye,REP,440002,0,0,0,0,
Mcclain,U.S. Senate,D. Jean Mcbride-Samuels,REP,440002,0,0,1,1,
Mcclain,U.S. Senate,Jim Inhofe,REP,440002,3,0,44,47,
Mcclain,U.S. Senate,Erick Paul Wyatt,REP,440002,0,0,3,3,
Mcclain,U.S. Senate,Andy Craig,REP,440002,0,0,0,0,
Mcclain,U.S. Senate,T. Shannon,REP,440002,2,0,11,13,
Mcclain,U.S. Senate,Randy Brogdon,REP,440002,0,0,0,0,
Mcclain,U.S. Senate,Eric Mccray,REP,440002,0,0,0,0,
Mcclain,U.S. Senate,Kevin Crow,REP,440002,0,0,0,0,
Mcclain,U.S. Senate,James Lankford,REP,440002,1,0,36,37,
Mcclain,U.S. Senate,Jason Weger,REP,440002,0,0,1,1,
Mcclain,U.S. House,Anna Flatt,REP,440002,0,0,8,8,04
Mcclain,U.S. House,Tom Cole,REP,440002,3,0,40,43,04
Mcclain,Superintendent of Public Instruction,John Cox,DEM,440003,0,1,1,2,
Mcclain,Superintendent of Public Instruction,Jack Jr.,DEM,440003,0,0,1,1,
Mcclain,Superintendent of Public Instruction,Ivan Holmes,DEM,440003,0,0,0,0,
Mcclain,Superintendent of Public Instruction,Freda Deskin,DEM,440003,1,2,22,25,
Mcclain,U.S. Senate,Patrick Michael Hayes,DEM,440003,0,2,3,5,
Mcclain,U.S. Senate,Jim Rogers,DEM,440003,0,0,9,9,
Mcclain,U.S. Senate,Connie Johnson,DEM,440003,0,1,11,12,
Mcclain,U.S. House,Bert Smith,DEM,440003,1,2,21,24,04
Mcclain,U.S. House,Tae Si,DEM,440003,0,1,2,3,04
Mcclain,Governor,Dax Ewbank,REP,440003,0,3,4,7,
Mcclain,Governor,Chad Moody,REP,440003,0,0,5,5,
Mcclain,Governor,Mary Fallin,REP,440003,0,1,20,21,
Mcclain,Superintendent of Public Instruction,Brian Kelly,REP,440003,0,1,6,7,
Mcclain,Superintendent of Public Instruction,Janet Costello Barresi,REP,440003,0,0,7,7,
Mcclain,Superintendent of Public Instruction,Joy Hofmeister,REP,440003,0,3,16,19,
Mcclain,Insurance Commissioner,Bill Viner,REP,440003,0,0,12,12,
Mcclain,Insurance Commissioner,John Doak,REP,440003,0,4,17,21,
Mcclain,Corporation Commissioner,Todd Hiett,REP,440003,0,4,15,19,
Mcclain,Corporation Commissioner,Cliff Branan,REP,440003,0,1,13,14,
Mcclain,U.S. Senate,Evelyn Rogers,REP,440003,0,0,1,1,
Mcclain,U.S. Senate,Rob Moye,REP,440003,0,0,0,0,
Mcclain,U.S. Senate,D. Jean Mcbride-Samuels,REP,440003,0,0,0,0,
Mcclain,U.S. Senate,Jim Inhofe,REP,440003,0,4,23,27,
Mcclain,U.S. Senate,Erick Paul Wyatt,REP,440003,0,0,5,5,
Mcclain,U.S. Senate,Andy Craig,REP,440003,0,0,0,0,
Mcclain,U.S. Senate,T. Shannon,REP,440003,0,4,10,14,
Mcclain,U.S. Senate,Randy Brogdon,REP,440003,0,0,2,2,
Mcclain,U.S. Senate,Eric Mccray,REP,440003,0,0,0,0,
Mcclain,U.S. Senate,Kevin Crow,REP,440003,0,0,0,0,
Mcclain,U.S. Senate,James Lankford,REP,440003,0,1,17,18,
Mcclain,U.S. Senate,Jason Weger,REP,440003,0,0,0,0,
Mcclain,U.S. House,Anna Flatt,REP,440003,0,4,10,14,04
Mcclain,U.S. House,Tom Cole,REP,440003,0,1,18,19,04
Mcclain,Superintendent of Public Instruction,John Cox,DEM,440004,0,0,19,19,
Mcclain,Superintendent of Public Instruction,Jack Jr.,DEM,440004,0,0,12,12,
Mcclain,Superintendent of Public Instruction,Ivan Holmes,DEM,440004,0,0,1,1,
Mcclain,Superintendent of Public Instruction,Freda Deskin,DEM,440004,2,0,34,36,
Mcclain,U.S. Senate,Patrick Michael Hayes,DEM,440004,0,0,16,16,
Mcclain,U.S. Senate,Jim Rogers,DEM,440004,1,0,26,27,
Mcclain,U.S. Senate,Connie Johnson,DEM,440004,1,0,23,24,
Mcclain,U.S. House,Bert Smith,DEM,440004,2,0,54,56,04
Mcclain,U.S. House,Tae Si,DEM,440004,0,0,6,6,04
Mcclain,Governor,Dax Ewbank,REP,440004,0,0,9,9,
Mcclain,Governor,Chad Moody,REP,440004,0,1,10,11,
Mcclain,Governor,Mary Fallin,REP,440004,0,3,30,33,
Mcclain,Superintendent of Public Instruction,Brian Kelly,REP,440004,0,1,17,18,
Mcclain,Superintendent of Public Instruction,Janet Costello Barresi,REP,440004,0,0,8,8,
Mcclain,Superintendent of Public Instruction,Joy Hofmeister,REP,440004,0,3,23,26,
Mcclain,Insurance Commissioner,Bill Viner,REP,440004,0,1,11,12,
Mcclain,Insurance Commissioner,John Doak,REP,440004,0,3,33,36,
Mcclain,Corporation Commissioner,Todd Hiett,REP,440004,0,3,31,34,
Mcclain,Corporation Commissioner,Cliff Branan,REP,440004,0,1,14,15,
Mcclain,U.S. Senate,Evelyn Rogers,REP,440004,0,1,3,4,
Mcclain,U.S. Senate,Rob Moye,REP,440004,0,0,0,0,
Mcclain,U.S. Senate,D. Jean Mcbride-Samuels,REP,440004,0,0,0,0,
Mcclain,U.S. Senate,Jim Inhofe,REP,440004,0,3,43,46,
Mcclain,U.S. Senate,Erick Paul Wyatt,REP,440004,0,0,2,2,
Mcclain,U.S. Senate,Andy Craig,REP,440004,0,0,1,1,
Mcclain,U.S. Senate,T. Shannon,REP,440004,0,0,19,19,
Mcclain,U.S. Senate,Randy Brogdon,REP,440004,0,0,4,4,
Mcclain,U.S. Senate,Eric Mccray,REP,440004,0,0,0,0,
Mcclain,U.S. Senate,Kevin Crow,REP,440004,0,0,0,0,
Mcclain,U.S. Senate,James Lankford,REP,440004,0,4,25,29,
Mcclain,U.S. Senate,Jason Weger,REP,440004,0,0,0,0,
Mcclain,U.S. House,Anna Flatt,REP,440004,0,0,7,7,04
Mcclain,U.S. House,Tom Cole,REP,440004,0,4,40,44,04
Mcclain,Superintendent of Public Instruction,John Cox,DEM,440005,0,1,24,25,
Mcclain,Superintendent of Public Instruction,Jack Jr.,DEM,440005,2,0,5,7,
Mcclain,Superintendent of Public Instruction,Ivan Holmes,DEM,440005,0,0,1,1,
Mcclain,Superintendent of Public Instruction,Freda Deskin,DEM,440005,5,1,30,36,
Mcclain,U.S. Senate,Patrick Michael Hayes,DEM,440005,2,0,19,21,
Mcclain,U.S. Senate,Jim Rogers,DEM,440005,4,2,23,29,
Mcclain,U.S. Senate,Connie Johnson,DEM,440005,1,0,15,16,
Mcclain,U.S. House,Bert Smith,DEM,440005,7,2,51,60,04
Mcclain,U.S. House,Tae Si,DEM,440005,0,0,5,5,04
Mcclain,Governor,Dax Ewbank,REP,440005,0,0,6,6,
Mcclain,Governor,Chad Moody,REP,440005,0,3,14,17,
Mcclain,Governor,Mary Fallin,REP,440005,7,1,65,73,
Mcclain,Superintendent of Public Instruction,Brian Kelly,REP,440005,3,2,27,32,
Mcclain,Superintendent of Public Instruction,Janet Costello Barresi,REP,440005,0,1,10,11,
Mcclain,Superintendent of Public Instruction,Joy Hofmeister,REP,440005,3,1,51,55,
Mcclain,Insurance Commissioner,Bill Viner,REP,440005,0,0,24,24,
Mcclain,Insurance Commissioner,John Doak,REP,440005,6,4,60,70,
Mcclain,Corporation Commissioner,Todd Hiett,REP,440005,3,2,44,49,
Mcclain,Corporation Commissioner,Cliff Branan,REP,440005,1,2,41,44,
Mcclain,U.S. Senate,Evelyn Rogers,REP,440005,0,0,6,6,
Mcclain,U.S. Senate,Rob Moye,REP,440005,0,0,1,1,
Mcclain,U.S. Senate,D. Jean Mcbride-Samuels,REP,440005,0,0,4,4,
Mcclain,U.S. Senate,Jim Inhofe,REP,440005,7,4,74,85,
Mcclain,U.S. Senate,Erick Paul Wyatt,REP,440005,0,0,6,6,
Mcclain,U.S. Senate,Andy Craig,REP,440005,0,0,1,1,
Mcclain,U.S. Senate,T. Shannon,REP,440005,0,1,31,32,
Mcclain,U.S. Senate,Randy Brogdon,REP,440005,0,0,0,0,
Mcclain,U.S. Senate,Eric Mccray,REP,440005,0,0,2,2,
Mcclain,U.S. Senate,Kevin Crow,REP,440005,0,0,0,0,
Mcclain,U.S. Senate,James Lankford,REP,440005,7,3,54,64,
Mcclain,U.S. Senate,Jason Weger,REP,440005,0,0,4,4,
Mcclain,U.S. House,Anna Flatt,REP,440005,0,0,15,15,04
Mcclain,U.S. House,Tom Cole,REP,440005,7,4,75,86,04
Mcclain,Superintendent of Public Instruction,John Cox,DEM,440006,1,8,17,26,
Mcclain,Superintendent of Public Instruction,Jack Jr.,DEM,440006,0,1,6,7,
Mcclain,Superintendent of Public Instruction,Ivan Holmes,DEM,440006,0,2,1,3,
Mcclain,Superintendent of Public Instruction,Freda Deskin,DEM,440006,1,2,31,34,
Mcclain,U.S. Senate,Patrick Michael Hayes,DEM,440006,0,5,16,21,
Mcclain,U.S. Senate,Jim Rogers,DEM,440006,0,3,17,20,
Mcclain,U.S. Senate,Connie Johnson,DEM,440006,1,4,15,20,
Mcclain,U.S. House,Bert Smith,DEM,440006,1,11,42,54,04
Mcclain,U.S. House,Tae Si,DEM,440006,0,1,6,7,04
Mcclain,Governor,Dax Ewbank,REP,440006,1,1,22,24,
Mcclain,Governor,Chad Moody,REP,440006,0,4,27,31,
Mcclain,Governor,Mary Fallin,REP,440006,2,14,115,131,
Mcclain,Superintendent of Public Instruction,Brian Kelly,REP,440006,1,8,38,47,
Mcclain,Superintendent of Public Instruction,Janet Costello Barresi,REP,440006,0,2,22,24,
Mcclain,Superintendent of Public Instruction,Joy Hofmeister,REP,440006,2,9,107,118,
Mcclain,Insurance Commissioner,Bill Viner,REP,440006,2,4,36,42,
Mcclain,Insurance Commissioner,John Doak,REP,440006,1,13,118,132,
Mcclain,Corporation Commissioner,Todd Hiett,REP,440006,2,6,86,94,
Mcclain,Corporation Commissioner,Cliff Branan,REP,440006,1,11,64,76,
Mcclain,U.S. Senate,Evelyn Rogers,REP,440006,0,0,6,6,
Mcclain,U.S. Senate,Rob Moye,REP,440006,0,0,3,3,
Mcclain,U.S. Senate,D. Jean Mcbride-Samuels,REP,440006,0,0,1,1,
Mcclain,U.S. Senate,Jim Inhofe,REP,440006,2,19,152,173,
Mcclain,U.S. Senate,Erick Paul Wyatt,REP,440006,1,0,5,6,
Mcclain,U.S. Senate,Andy Craig,REP,440006,0,0,0,0,
Mcclain,U.S. Senate,T. Shannon,REP,440006,2,4,54,60,
Mcclain,U.S. Senate,Randy Brogdon,REP,440006,0,1,5,6,
Mcclain,U.S. Senate,Eric Mccray,REP,440006,0,0,2,2,
Mcclain,U.S. Senate,Kevin Crow,REP,440006,0,0,0,0,
Mcclain,U.S. Senate,James Lankford,REP,440006,1,14,106,121,
Mcclain,U.S. Senate,Jason Weger,REP,440006,0,0,2,2,
Mcclain,U.S. House,Anna Flatt,REP,440006,1,1,18,20,04
Mcclain,U.S. House,Tom Cole,REP,440006,2,18,146,166,04
Mcclain,Superintendent of Public Instruction,John Cox,DEM,440007,2,2,10,14,
Mcclain,Superintendent of Public Instruction,Jack Jr.,DEM,440007,0,2,5,7,
Mcclain,Superintendent of Public Instruction,Ivan Holmes,DEM,440007,0,0,1,1,
Mcclain,Superintendent of Public Instruction,Freda Deskin,DEM,440007,0,2,13,15,
Mcclain,U.S. Senate,Patrick Michael Hayes,DEM,440007,0,2,7,9,
Mcclain,U.S. Senate,Jim Rogers,DEM,440007,0,1,10,11,
Mcclain,U.S. Senate,Connie Johnson,DEM,440007,2,2,11,15,
Mcclain,U.S. House,Bert Smith,DEM,440007,2,5,23,30,04
Mcclain,U.S. House,Tae Si,DEM,440007,0,0,1,1,04
Mcclain,Governor,Dax Ewbank,REP,440007,0,0,4,4,
Mcclain,Governor,Chad Moody,REP,440007,0,0,2,2,
Mcclain,Governor,Mary Fallin,REP,440007,1,1,30,32,
Mcclain,Superintendent of Public Instruction,Brian Kelly,REP,440007,0,0,7,7,
Mcclain,Superintendent of Public Instruction,Janet Costello Barresi,REP,440007,0,1,5,6,
Mcclain,Superintendent of Public Instruction,Joy Hofmeister,REP,440007,0,0,23,23,
Mcclain,Insurance Commissioner,Bill Viner,REP,440007,0,0,2,2,
Mcclain,Insurance Commissioner,John Doak,REP,440007,0,1,30,31,
Mcclain,Corporation Commissioner,Todd Hiett,REP,440007,0,1,17,18,
Mcclain,Corporation Commissioner,Cliff Branan,REP,440007,0,0,16,16,
Mcclain,U.S. Senate,Evelyn Rogers,REP,440007,0,0,2,2,
Mcclain,U.S. Senate,Rob Moye,REP,440007,0,0,0,0,
Mcclain,U.S. Senate,D. Jean Mcbride-Samuels,REP,440007,0,0,0,0,
Mcclain,U.S. Senate,Jim Inhofe,REP,440007,1,1,31,33,
Mcclain,U.S. Senate,Erick Paul Wyatt,REP,440007,0,0,3,3,
Mcclain,U.S. Senate,Andy Craig,REP,440007,0,0,0,0,
Mcclain,U.S. Senate,T. Shannon,REP,440007,0,1,11,12,
Mcclain,U.S. Senate,Randy Brogdon,REP,440007,0,0,1,1,
Mcclain,U.S. Senate,Eric Mccray,REP,440007,0,0,0,0,
Mcclain,U.S. Senate,Kevin Crow,REP,440007,0,0,0,0,
Mcclain,U.S. Senate,James Lankford,REP,440007,1,0,24,25,
Mcclain,U.S. Senate,Jason Weger,REP,440007,0,0,0,0,
Mcclain,U.S. House,Anna Flatt,REP,440007,0,0,3,3,04
Mcclain,U.S. House,Tom Cole,REP,440007,1,1,32,34,04
Mcclain,Superintendent of Public Instruction,John Cox,DEM,440008,0,0,16,16,
Mcclain,Superintendent of Public Instruction,Jack Jr.,DEM,440008,1,0,5,6,
Mcclain,Superintendent of Public Instruction,Ivan Holmes,DEM,440008,0,0,1,1,
Mcclain,Superintendent of Public Instruction,Freda Deskin,DEM,440008,0,3,42,45,
Mcclain,U.S. Senate,Patrick Michael Hayes,DEM,440008,0,0,13,13,
Mcclain,U.S. Senate,Jim Rogers,DEM,440008,1,1,31,33,
Mcclain,U.S. Senate,Connie Johnson,DEM,440008,0,2,19,21,
Mcclain,U.S. House,Bert Smith,DEM,440008,1,2,55,58,04
Mcclain,U.S. House,Tae Si,DEM,440008,0,1,4,5,04
Mcclain,Governor,Dax Ewbank,REP,440008,0,0,10,10,
Mcclain,Governor,Chad Moody,REP,440008,4,0,16,20,
Mcclain,Governor,Mary Fallin,REP,440008,2,1,103,106,
Mcclain,Superintendent of Public Instruction,Brian Kelly,REP,440008,0,1,21,22,
Mcclain,Superintendent of Public Instruction,Janet Costello Barresi,REP,440008,0,0,21,21,
Mcclain,Superintendent of Public Instruction,Joy Hofmeister,REP,440008,6,1,89,96,
Mcclain,Insurance Commissioner,Bill Viner,REP,440008,0,0,27,27,
Mcclain,Insurance Commissioner,John Doak,REP,440008,6,2,94,102,
Mcclain,Corporation Commissioner,Todd Hiett,REP,440008,2,2,71,75,
Mcclain,Corporation Commissioner,Cliff Branan,REP,440008,4,0,51,55,
Mcclain,U.S. Senate,Evelyn Rogers,REP,440008,0,0,3,3,
Mcclain,U.S. Senate,Rob Moye,REP,440008,0,0,2,2,
Mcclain,U.S. Senate,D. Jean Mcbride-Samuels,REP,440008,0,0,0,0,
Mcclain,U.S. Senate,Jim Inhofe,REP,440008,6,2,114,122,
Mcclain,U.S. Senate,Erick Paul Wyatt,REP,440008,0,0,6,6,
Mcclain,U.S. Senate,Andy Craig,REP,440008,0,0,0,0,
Mcclain,U.S. Senate,T. Shannon,REP,440008,0,0,38,38,
Mcclain,U.S. Senate,Randy Brogdon,REP,440008,0,0,4,4,
Mcclain,U.S. Senate,Eric Mccray,REP,440008,0,0,0,0,
Mcclain,U.S. Senate,Kevin Crow,REP,440008,0,0,0,0,
Mcclain,U.S. Senate,James Lankford,REP,440008,6,2,93,101,
Mcclain,U.S. Senate,Jason Weger,REP,440008,0,0,0,0,
Mcclain,U.S. House,Anna Flatt,REP,440008,0,0,16,16,04
Mcclain,U.S. House,Tom Cole,REP,440008,6,2,117,125,04
Mcclain,Superintendent of Public Instruction,John Cox,DEM,440009,0,0,13,13,
Mcclain,Superintendent of Public Instruction,Jack Jr.,DEM,440009,0,0,8,8,
Mcclain,Superintendent of Public Instruction,Ivan Holmes,DEM,440009,0,0,1,1,
Mcclain,Superintendent of Public Instruction,Freda Deskin,DEM,440009,1,0,30,31,
Mcclain,U.S. Senate,Patrick Michael Hayes,DEM,440009,0,0,11,11,
Mcclain,U.S. Senate,Jim Rogers,DEM,440009,0,0,11,11,
Mcclain,U.S. Senate,Connie Johnson,DEM,440009,1,0,24,25,
Mcclain,U.S. House,Bert Smith,DEM,440009,1,0,31,32,04
Mcclain,U.S. House,Tae Si,DEM,440009,0,0,12,12,04
Mcclain,Governor,Dax Ewbank,REP,440009,0,0,4,4,
Mcclain,Governor,Chad Moody,REP,440009,3,1,16,20,
Mcclain,Governor,Mary Fallin,REP,440009,3,1,88,92,
Mcclain,Superintendent of Public Instruction,Brian Kelly,REP,440009,1,0,23,24,
Mcclain,Superintendent of Public Instruction,Janet Costello Barresi,REP,440009,2,0,29,31,
Mcclain,Superintendent of Public Instruction,Joy Hofmeister,REP,440009,3,2,56,61,
Mcclain,Insurance Commissioner,Bill Viner,REP,440009,4,1,14,19,
Mcclain,Insurance Commissioner,John Doak,REP,440009,1,1,89,91,
Mcclain,Corporation Commissioner,Todd Hiett,REP,440009,5,2,52,59,
Mcclain,Corporation Commissioner,Cliff Branan,REP,440009,1,0,48,49,
Mcclain,U.S. Senate,Evelyn Rogers,REP,440009,0,0,3,3,
Mcclain,U.S. Senate,Rob Moye,REP,440009,2,0,1,3,
Mcclain,U.S. Senate,D. Jean Mcbride-Samuels,REP,440009,0,0,2,2,
Mcclain,U.S. Senate,Jim Inhofe,REP,440009,4,2,97,103,
Mcclain,U.S. Senate,Erick Paul Wyatt,REP,440009,0,0,4,4,
Mcclain,U.S. Senate,Andy Craig,REP,440009,0,0,2,2,
Mcclain,U.S. Senate,T. Shannon,REP,440009,2,1,38,41,
Mcclain,U.S. Senate,Randy Brogdon,REP,440009,1,0,2,3,
Mcclain,U.S. Senate,Eric Mccray,REP,440009,0,0,0,0,
Mcclain,U.S. Senate,Kevin Crow,REP,440009,0,0,0,0,
Mcclain,U.S. Senate,James Lankford,REP,440009,1,1,67,69,
Mcclain,U.S. Senate,Jason Weger,REP,440009,2,0,1,3,
Mcclain,U.S. House,Anna Flatt,REP,440009,2,0,20,22,04
Mcclain,U.S. House,Tom Cole,REP,440009,4,2,87,93,04
Mcclain,Superintendent of Public Instruction,John Cox,DEM,440010,0,0,6,6,
Mcclain,Superintendent of Public Instruction,Jack Jr.,DEM,440010,0,1,6,7,
Mcclain,Superintendent of Public Instruction,Ivan Holmes,DEM,440010,0,0,0,0,
Mcclain,Superintendent of Public Instruction,Freda Deskin,DEM,440010,0,0,7,7,
Mcclain,U.S. Senate,Patrick Michael Hayes,DEM,440010,0,0,6,6,
Mcclain,U.S. Senate,Jim Rogers,DEM,440010,0,1,5,6,
Mcclain,U.S. Senate,Connie Johnson,DEM,440010,0,0,7,7,
Mcclain,U.S. House,Bert Smith,DEM,440010,0,1,15,16,04
Mcclain,U.S. House,Tae Si,DEM,440010,0,0,2,2,04
Mcclain,Governor,Dax Ewbank,REP,440010,0,0,4,4,
Mcclain,Governor,Chad Moody,REP,440010,1,0,7,8,
Mcclain,Governor,Mary Fallin,REP,440010,1,4,29,34,
Mcclain,Superintendent of Public Instruction,Brian Kelly,REP,440010,0,1,9,10,
Mcclain,Superintendent of Public Instruction,Janet Costello Barresi,REP,440010,0,0,8,8,
Mcclain,Superintendent of Public Instruction,Joy Hofmeister,REP,440010,2,3,24,29,
Mcclain,Insurance Commissioner,Bill Viner,REP,440010,0,1,12,13,
Mcclain,Insurance Commissioner,John Doak,REP,440010,2,2,26,30,
Mcclain,Corporation Commissioner,Todd Hiett,REP,440010,1,2,19,22,
Mcclain,Corporation Commissioner,Cliff Branan,REP,440010,1,1,20,22,
Mcclain,U.S. Senate,Evelyn Rogers,REP,440010,0,0,2,2,
Mcclain,U.S. Senate,Rob Moye,REP,440010,0,0,0,0,
Mcclain,U.S. Senate,D. Jean Mcbride-Samuels,REP,440010,0,0,0,0,
Mcclain,U.S. Senate,Jim Inhofe,REP,440010,2,4,32,38,
Mcclain,U.S. Senate,Erick Paul Wyatt,REP,440010,0,0,5,5,
Mcclain,U.S. Senate,Andy Craig,REP,440010,0,0,1,1,
Mcclain,U.S. Senate,T. Shannon,REP,440010,1,2,15,18,
Mcclain,U.S. Senate,Randy Brogdon,REP,440010,0,0,2,2,
Mcclain,U.S. Senate,Eric Mccray,REP,440010,0,0,0,0,
Mcclain,U.S. Senate,Kevin Crow,REP,440010,0,0,0,0,
Mcclain,U.S. Senate,James Lankford,REP,440010,1,2,21,24,
Mcclain,U.S. Senate,Jason Weger,REP,440010,0,0,2,2,
Mcclain,U.S. House,Anna Flatt,REP,440010,0,1,9,10,04
Mcclain,U.S. House,Tom Cole,REP,440010,2,3,32,37,04
Mcclain,Superintendent of Public Instruction,John Cox,DEM,440011,0,0,3,3,
Mcclain,Superintendent of Public Instruction,Jack Jr.,DEM,440011,0,0,4,4,
Mcclain,Superintendent of Public Instruction,Ivan Holmes,DEM,440011,0,0,0,0,
Mcclain,Superintendent of Public Instruction,Freda Deskin,DEM,440011,0,0,12,12,
Mcclain,U.S. Senate,Patrick Michael Hayes,DEM,440011,0,0,5,5,
Mcclain,U.S. Senate,Jim Rogers,DEM,440011,0,0,7,7,
Mcclain,U.S. Senate,Connie Johnson,DEM,440011,0,0,7,7,
Mcclain,U.S. House,Bert Smith,DEM,440011,0,0,14,14,04
Mcclain,U.S. House,Tae Si,DEM,440011,0,0,4,4,04
Mcclain,Governor,Dax Ewbank,REP,440011,1,0,12,13,
Mcclain,Governor,Chad Moody,REP,440011,0,0,7,7,
Mcclain,Governor,Mary Fallin,REP,440011,1,0,47,48,
Mcclain,Superintendent of Public Instruction,Brian Kelly,REP,440011,1,0,21,22,
Mcclain,Superintendent of Public Instruction,Janet Costello Barresi,REP,440011,1,0,18,19,
Mcclain,Superintendent of Public Instruction,Joy Hofmeister,REP,440011,0,0,26,26,
Mcclain,Insurance Commissioner,Bill Viner,REP,440011,1,0,16,17,
Mcclain,Insurance Commissioner,John Doak,REP,440011,1,0,45,46,
Mcclain,Corporation Commissioner,Todd Hiett,REP,440011,2,0,33,35,
Mcclain,Corporation Commissioner,Cliff Branan,REP,440011,0,0,30,30,
Mcclain,U.S. Senate,Evelyn Rogers,REP,440011,0,0,5,5,
Mcclain,U.S. Senate,Rob Moye,REP,440011,0,0,1,1,
Mcclain,U.S. Senate,D. Jean Mcbride-Samuels,REP,440011,0,0,2,2,
Mcclain,U.S. Senate,Jim Inhofe,REP,440011,1,0,52,53,
Mcclain,U.S. Senate,Erick Paul Wyatt,REP,440011,1,0,7,8,
Mcclain,U.S. Senate,Andy Craig,REP,440011,0,0,0,0,
Mcclain,U.S. Senate,T. Shannon,REP,440011,1,0,17,18,
Mcclain,U.S. Senate,Randy Brogdon,REP,440011,0,0,7,7,
Mcclain,U.S. Senate,Eric Mccray,REP,440011,0,0,0,0,
Mcclain,U.S. Senate,Kevin Crow,REP,440011,0,0,0,0,
Mcclain,U.S. Senate,James Lankford,REP,440011,1,0,43,44,
Mcclain,U.S. Senate,Jason Weger,REP,440011,0,0,0,0,
Mcclain,U.S. House,Anna Flatt,REP,440011,1,0,13,14,04
Mcclain,U.S. House,Tom Cole,REP,440011,1,0,53,54,04
Mcclain,Superintendent of Public Instruction,John Cox,DEM,440012,1,0,23,24,
Mcclain,Superintendent of Public Instruction,Jack Jr.,DEM,440012,2,0,18,20,
Mcclain,Superintendent of Public Instruction,Ivan Holmes,DEM,440012,0,2,3,5,
Mcclain,Superintendent of Public Instruction,Freda Deskin,DEM,440012,4,0,38,42,
Mcclain,U.S. Senate,Patrick Michael Hayes,DEM,440012,3,0,16,19,
Mcclain,U.S. Senate,Jim Rogers,DEM,440012,1,1,38,40,
Mcclain,U.S. Senate,Connie Johnson,DEM,440012,3,0,26,29,
Mcclain,U.S. House,Bert Smith,DEM,440012,4,1,70,75,04
Mcclain,U.S. House,Tae Si,DEM,440012,2,0,5,7,04
Mcclain,Governor,Dax Ewbank,REP,440012,1,0,25,26,
Mcclain,Governor,Chad Moody,REP,440012,0,1,46,47,
Mcclain,Governor,Mary Fallin,REP,440012,5,2,140,147,
Mcclain,Superintendent of Public Instruction,Brian Kelly,REP,440012,3,1,64,68,
Mcclain,Superintendent of Public Instruction,Janet Costello Barresi,REP,440012,1,1,34,36,
Mcclain,Superintendent of Public Instruction,Joy Hofmeister,REP,440012,2,1,114,117,
Mcclain,Insurance Commissioner,Bill Viner,REP,440012,0,2,57,59,
Mcclain,Insurance Commissioner,John Doak,REP,440012,7,1,141,149,
Mcclain,Corporation Commissioner,Todd Hiett,REP,440012,3,0,102,105,
Mcclain,Corporation Commissioner,Cliff Branan,REP,440012,2,3,99,104,
Mcclain,U.S. Senate,Evelyn Rogers,REP,440012,0,0,10,10,
Mcclain,U.S. Senate,Rob Moye,REP,440012,0,0,5,5,
Mcclain,U.S. Senate,D. Jean Mcbride-Samuels,REP,440012,0,0,3,3,
Mcclain,U.S. Senate,Jim Inhofe,REP,440012,7,3,192,202,
Mcclain,U.S. Senate,Erick Paul Wyatt,REP,440012,0,0,5,5,
Mcclain,U.S. Senate,Andy Craig,REP,440012,0,0,0,0,
Mcclain,U.S. Senate,T. Shannon,REP,440012,1,1,66,68,
Mcclain,U.S. Senate,Randy Brogdon,REP,440012,2,0,8,10,
Mcclain,U.S. Senate,Eric Mccray,REP,440012,0,0,1,1,
Mcclain,U.S. Senate,Kevin Crow,REP,440012,0,0,3,3,
Mcclain,U.S. Senate,James Lankford,REP,440012,4,2,140,146,
Mcclain,U.S. Senate,Jason Weger,REP,440012,0,0,1,1,
Mcclain,U.S. House,Anna Flatt,REP,440012,1,1,36,38,04
Mcclain,U.S. House,Tom Cole,REP,440012,5,2,178,185,04
Mcclain,Superintendent of Public Instruction,John Cox,DEM,440013,1,0,42,43,
Mcclain,Superintendent of Public Instruction,Jack Jr.,DEM,440013,2,0,10,12,
Mcclain,Superintendent of Public Instruction,Ivan Holmes,DEM,440013,0,0,4,4,
Mcclain,Superintendent of Public Instruction,Freda Deskin,DEM,440013,1,2,36,39,
Mcclain,U.S. Senate,Patrick Michael Hayes,DEM,440013,0,0,23,23,
Mcclain,U.S. Senate,Jim Rogers,DEM,440013,3,0,40,43,
Mcclain,U.S. Senate,Connie Johnson,DEM,440013,1,2,28,31,
Mcclain,U.S. House,Bert Smith,DEM,440013,4,0,79,83,04
Mcclain,U.S. House,Tae Si,DEM,440013,0,2,9,11,04
Mcclain,Governor,Dax Ewbank,REP,440013,1,0,21,22,
Mcclain,Governor,Chad Moody,REP,440013,0,1,45,46,
Mcclain,Governor,Mary Fallin,REP,440013,20,2,245,267,
Mcclain,Superintendent of Public Instruction,Brian Kelly,REP,440013,5,2,74,81,
Mcclain,Superintendent of Public Instruction,Janet Costello Barresi,REP,440013,4,1,65,70,
Mcclain,Superintendent of Public Instruction,Joy Hofmeister,REP,440013,10,0,168,178,
Mcclain,Insurance Commissioner,Bill Viner,REP,440013,3,0,61,64,
Mcclain,Insurance Commissioner,John Doak,REP,440013,15,3,229,247,
Mcclain,Corporation Commissioner,Todd Hiett,REP,440013,12,1,117,130,
Mcclain,Corporation Commissioner,Cliff Branan,REP,440013,7,2,169,178,
Mcclain,U.S. Senate,Evelyn Rogers,REP,440013,1,0,13,14,
Mcclain,U.S. Senate,Rob Moye,REP,440013,0,0,6,6,
Mcclain,U.S. Senate,D. Jean Mcbride-Samuels,REP,440013,0,0,6,6,
Mcclain,U.S. Senate,Jim Inhofe,REP,440013,17,3,270,290,
Mcclain,U.S. Senate,Erick Paul Wyatt,REP,440013,4,0,14,18,
Mcclain,U.S. Senate,Andy Craig,REP,440013,0,0,1,1,
Mcclain,U.S. Senate,T. Shannon,REP,440013,6,1,86,93,
Mcclain,U.S. Senate,Randy Brogdon,REP,440013,0,0,8,8,
Mcclain,U.S. Senate,Eric Mccray,REP,440013,0,0,1,1,
Mcclain,U.S. Senate,Kevin Crow,REP,440013,0,0,3,3,
Mcclain,U.S. Senate,James Lankford,REP,440013,15,2,217,234,
Mcclain,U.S. Senate,Jason Weger,REP,440013,0,0,1,1,
Mcclain,U.S. House,Anna Flatt,REP,440013,4,0,46,50,04
Mcclain,U.S. House,Tom Cole,REP,440013,18,3,262,283,04
Mcclain,Superintendent of Public Instruction,John Cox,DEM,440014,1,0,9,10,
Mcclain,Superintendent of Public Instruction,Jack Jr.,DEM,440014,0,0,0,0,
Mcclain,Superintendent of Public Instruction,Ivan Holmes,DEM,440014,0,0,1,1,
Mcclain,Superintendent of Public Instruction,Freda Deskin,DEM,440014,1,0,11,12,
Mcclain,U.S. Senate,Patrick Michael Hayes,DEM,440014,0,0,5,5,
Mcclain,U.S. Senate,Jim Rogers,DEM,440014,0,0,3,3,
Mcclain,U.S. Senate,Connie Johnson,DEM,440014,2,0,14,16,
Mcclain,U.S. House,Bert Smith,DEM,440014,1,0,18,19,04
Mcclain,U.S. House,Tae Si,DEM,440014,1,0,4,5,04
Mcclain,Governor,Dax Ewbank,REP,440014,0,0,7,7,
Mcclain,Governor,Chad Moody,REP,440014,0,0,13,13,
Mcclain,Governor,Mary Fallin,REP,440014,5,0,106,111,
Mcclain,Superintendent of Public Instruction,Brian Kelly,REP,440014,1,0,33,34,
Mcclain,Superintendent of Public Instruction,Janet Costello Barresi,REP,440014,0,0,28,28,
Mcclain,Superintendent of Public Instruction,Joy Hofmeister,REP,440014,5,0,63,68,
Mcclain,Insurance Commissioner,Bill Viner,REP,440014,1,0,23,24,
Mcclain,Insurance Commissioner,John Doak,REP,440014,5,0,89,94,
Mcclain,Corporation Commissioner,Todd Hiett,REP,440014,3,0,53,56,
Mcclain,Corporation Commissioner,Cliff Branan,REP,440014,3,0,58,61,
Mcclain,U.S. Senate,Evelyn Rogers,REP,440014,0,0,6,6,
Mcclain,U.S. Senate,Rob Moye,REP,440014,0,0,3,3,
Mcclain,U.S. Senate,D. Jean Mcbride-Samuels,REP,440014,0,0,1,1,
Mcclain,U.S. Senate,Jim Inhofe,REP,440014,6,0,111,117,
Mcclain,U.S. Senate,Erick Paul Wyatt,REP,440014,0,0,3,3,
Mcclain,U.S. Senate,Andy Craig,REP,440014,0,0,0,0,
Mcclain,U.S. Senate,T. Shannon,REP,440014,3,0,41,44,
Mcclain,U.S. Senate,Randy Brogdon,REP,440014,0,0,3,3,
Mcclain,U.S. Senate,Eric Mccray,REP,440014,0,0,1,1,
Mcclain,U.S. Senate,Kevin Crow,REP,440014,0,0,0,0,
Mcclain,U.S. Senate,James Lankford,REP,440014,3,0,80,83,
Mcclain,U.S. Senate,Jason Weger,REP,440014,0,0,2,2,
Mcclain,U.S. House,Anna Flatt,REP,440014,1,0,17,18,04
Mcclain,U.S. House,Tom Cole,REP,440014,5,0,105,110,04
Mcclain,Superintendent of Public Instruction,John Cox,DEM,440015,3,0,24,27,
Mcclain,Superintendent of Public Instruction,Jack Jr.,DEM,440015,0,0,6,6,
Mcclain,Superintendent of Public Instruction,Ivan Holmes,DEM,440015,1,0,1,2,
Mcclain,Superintendent of Public Instruction,Freda Deskin,DEM,440015,0,0,30,30,
Mcclain,U.S. Senate,Patrick Michael Hayes,DEM,440015,0,0,8,8,
Mcclain,U.S. Senate,Jim Rogers,DEM,440015,2,0,16,18,
Mcclain,U.S. Senate,Connie Johnson,DEM,440015,2,0,32,34,
Mcclain,U.S. House,Bert Smith,DEM,440015,4,0,42,46,04
Mcclain,U.S. House,Tae Si,DEM,440015,0,0,13,13,04
Mcclain,Governor,Dax Ewbank,REP,440015,2,0,9,11,
Mcclain,Governor,Chad Moody,REP,440015,3,0,28,31,
Mcclain,Governor,Mary Fallin,REP,440015,10,4,143,157,
Mcclain,Superintendent of Public Instruction,Brian Kelly,REP,440015,2,0,38,40,
Mcclain,Superintendent of Public Instruction,Janet Costello Barresi,REP,440015,8,0,41,49,
Mcclain,Superintendent of Public Instruction,Joy Hofmeister,REP,440015,6,4,98,108,
Mcclain,Insurance Commissioner,Bill Viner,REP,440015,3,1,37,41,
Mcclain,Insurance Commissioner,John Doak,REP,440015,13,3,132,148,
Mcclain,Corporation Commissioner,Todd Hiett,REP,440015,12,1,80,93,
Mcclain,Corporation Commissioner,Cliff Branan,REP,440015,3,3,92,98,
Mcclain,U.S. Senate,Evelyn Rogers,REP,440015,0,1,9,10,
Mcclain,U.S. Senate,Rob Moye,REP,440015,0,0,2,2,
Mcclain,U.S. Senate,D. Jean Mcbride-Samuels,REP,440015,1,0,3,4,
Mcclain,U.S. Senate,Jim Inhofe,REP,440015,12,3,160,175,
Mcclain,U.S. Senate,Erick Paul Wyatt,REP,440015,2,0,6,8,
Mcclain,U.S. Senate,Andy Craig,REP,440015,0,0,0,0,
Mcclain,U.S. Senate,T. Shannon,REP,440015,1,3,50,54,
Mcclain,U.S. Senate,Randy Brogdon,REP,440015,2,0,12,14,
Mcclain,U.S. Senate,Eric Mccray,REP,440015,0,0,1,1,
Mcclain,U.S. Senate,Kevin Crow,REP,440015,0,0,4,4,
Mcclain,U.S. Senate,James Lankford,REP,440015,11,1,114,126,
Mcclain,U.S. Senate,Jason Weger,REP,440015,1,0,0,1,
Mcclain,U.S. House,Anna Flatt,REP,440015,7,0,28,35,04
Mcclain,U.S. House,Tom Cole,REP,440015,8,4,152,164,04
Mcclain,Superintendent of Public Instruction,John Cox,DEM,440016,3,0,54,57,
Mcclain,Superintendent of Public Instruction,Jack Jr.,DEM,440016,0,0,17,17,
Mcclain,Superintendent of Public Instruction,Ivan Holmes,DEM,440016,0,0,4,4,
Mcclain,Superintendent of Public Instruction,Freda Deskin,DEM,440016,4,1,65,70,
Mcclain,U.S. Senate,Patrick Michael Hayes,DEM,440016,0,0,28,28,
Mcclain,U.S. Senate,Jim Rogers,DEM,440016,4,0,68,72,
Mcclain,U.S. Senate,Connie Johnson,DEM,440016,3,1,42,46,
Mcclain,U.S. House,Bert Smith,DEM,440016,6,1,116,123,04
Mcclain,U.S. House,Tae Si,DEM,440016,1,0,18,19,04
Mcclain,Governor,Dax Ewbank,REP,440016,0,0,16,16,
Mcclain,Governor,Chad Moody,REP,440016,1,0,34,35,
Mcclain,Governor,Mary Fallin,REP,440016,7,4,114,125,
Mcclain,Superintendent of Public Instruction,Brian Kelly,REP,440016,0,1,37,38,
Mcclain,Superintendent of Public Instruction,Janet Costello Barresi,REP,440016,2,2,21,25,
Mcclain,Superintendent of Public Instruction,Joy Hofmeister,REP,440016,6,1,104,111,
Mcclain,Insurance Commissioner,Bill Viner,REP,440016,1,0,35,36,
Mcclain,Insurance Commissioner,John Doak,REP,440016,6,4,115,125,
Mcclain,Corporation Commissioner,Todd Hiett,REP,440016,6,3,78,87,
Mcclain,Corporation Commissioner,Cliff Branan,REP,440016,1,1,77,79,
Mcclain,U.S. Senate,Evelyn Rogers,REP,440016,0,0,4,4,
Mcclain,U.S. Senate,Rob Moye,REP,440016,0,0,2,2,
Mcclain,U.S. Senate,D. Jean Mcbride-Samuels,REP,440016,0,0,4,4,
Mcclain,U.S. Senate,Jim Inhofe,REP,440016,8,4,149,161,
Mcclain,U.S. Senate,Erick Paul Wyatt,REP,440016,0,0,4,4,
Mcclain,U.S. Senate,Andy Craig,REP,440016,0,0,1,1,
Mcclain,U.S. Senate,T. Shannon,REP,440016,3,0,40,43,
Mcclain,U.S. Senate,Randy Brogdon,REP,440016,1,0,6,7,
Mcclain,U.S. Senate,Eric Mccray,REP,440016,0,0,1,1,
Mcclain,U.S. Senate,Kevin Crow,REP,440016,0,0,4,4,
Mcclain,U.S. Senate,James Lankford,REP,440016,4,4,111,119,
Mcclain,U.S. Senate,Jason Weger,REP,440016,0,0,1,1,
Mcclain,U.S. House,Anna Flatt,REP,440016,1,0,29,30,04
Mcclain,U.S. House,Tom Cole,REP,440016,7,4,134,145,04
Mcclain,Superintendent of Public Instruction,John Cox,DEM,440017,0,0,3,3,
Mcclain,Superintendent of Public Instruction,Jack Jr.,DEM,440017,1,0,4,5,
Mcclain,Superintendent of Public Instruction,Ivan Holmes,DEM,440017,0,0,1,1,
Mcclain,Superintendent of Public Instruction,Freda Deskin,DEM,440017,0,0,5,5,
Mcclain,U.S. Senate,Patrick Michael Hayes,DEM,440017,0,0,3,3,
Mcclain,U.S. Senate,Jim Rogers,DEM,440017,1,0,7,8,
Mcclain,U.S. Senate,Connie Johnson,DEM,440017,0,0,3,3,
Mcclain,U.S. House,Bert Smith,DEM,440017,0,0,12,12,04
Mcclain,U.S. House,Tae Si,DEM,440017,1,0,1,2,04
Mcclain,Governor,Dax Ewbank,REP,440017,0,0,2,2,
Mcclain,Governor,Chad Moody,REP,440017,0,0,1,1,
Mcclain,Governor,Mary Fallin,REP,440017,2,0,30,32,
Mcclain,Superintendent of Public Instruction,Brian Kelly,REP,440017,1,0,8,9,
Mcclain,Superintendent of Public Instruction,Janet Costello Barresi,REP,440017,1,0,11,12,
Mcclain,Superintendent of Public Instruction,Joy Hofmeister,REP,440017,0,0,14,14,
Mcclain,Insurance Commissioner,Bill Viner,REP,440017,0,0,4,4,
Mcclain,Insurance Commissioner,John Doak,REP,440017,1,0,26,27,
Mcclain,Corporation Commissioner,Todd Hiett,REP,440017,2,0,17,19,
Mcclain,Corporation Commissioner,Cliff Branan,REP,440017,0,0,12,12,
Mcclain,U.S. Senate,Evelyn Rogers,REP,440017,0,0,0,0,
Mcclain,U.S. Senate,Rob Moye,REP,440017,0,0,0,0,
Mcclain,U.S. Senate,D. Jean Mcbride-Samuels,REP,440017,0,0,0,0,
Mcclain,U.S. Senate,Jim Inhofe,REP,440017,1,0,33,34,
Mcclain,U.S. Senate,Erick Paul Wyatt,REP,440017,1,0,0,1,
Mcclain,U.S. Senate,Andy Craig,REP,440017,0,0,0,0,
Mcclain,U.S. Senate,T. Shannon,REP,440017,0,0,6,6,
Mcclain,U.S. Senate,Randy Brogdon,REP,440017,0,0,0,0,
Mcclain,U.S. Senate,Eric Mccray,REP,440017,0,0,0,0,
Mcclain,U.S. Senate,Kevin Crow,REP,440017,0,0,0,0,
Mcclain,U.S. Senate,James Lankford,REP,440017,2,0,27,29,
Mcclain,U.S. Senate,Jason Weger,REP,440017,0,0,0,0,
Mcclain,U.S. House,Anna Flatt,REP,440017,1,0,2,3,04
Mcclain,U.S. House,Tom Cole,REP,440017,1,0,30,31,04
Mcclain,Superintendent of Public Instruction,John Cox,DEM,440018,3,0,8,11,
Mcclain,Superintendent of Public Instruction,Jack Jr.,DEM,440018,0,0,5,5,
Mcclain,Superintendent of Public Instruction,Ivan Holmes,DEM,440018,0,0,5,5,
Mcclain,Superintendent of Public Instruction,Freda Deskin,DEM,440018,0,0,17,17,
Mcclain,U.S. Senate,Patrick Michael Hayes,DEM,440018,0,0,7,7,
Mcclain,U.S. Senate,Jim Rogers,DEM,440018,3,0,15,18,
Mcclain,U.S. Senate,Connie Johnson,DEM,440018,0,0,13,13,
Mcclain,U.S. House,Bert Smith,DEM,440018,3,0,31,34,04
Mcclain,U.S. House,Tae Si,DEM,440018,0,0,3,3,04
Mcclain,Governor,Dax Ewbank,REP,440018,0,1,10,11,
Mcclain,Governor,Chad Moody,REP,440018,0,0,15,15,
Mcclain,Governor,Mary Fallin,REP,440018,1,1,69,71,
Mcclain,Superintendent of Public Instruction,Brian Kelly,REP,440018,0,2,24,26,
Mcclain,Superintendent of Public Instruction,Janet Costello Barresi,REP,440018,0,0,24,24,
Mcclain,Superintendent of Public Instruction,Joy Hofmeister,REP,440018,1,0,46,47,
Mcclain,Insurance Commissioner,Bill Viner,REP,440018,0,0,18,18,
Mcclain,Insurance Commissioner,John Doak,REP,440018,1,2,73,76,
Mcclain,Corporation Commissioner,Todd Hiett,REP,440018,1,2,42,45,
Mcclain,Corporation Commissioner,Cliff Branan,REP,440018,0,0,48,48,
Mcclain,U.S. Senate,Evelyn Rogers,REP,440018,0,0,0,0,
Mcclain,U.S. Senate,Rob Moye,REP,440018,0,0,3,3,
Mcclain,U.S. Senate,D. Jean Mcbride-Samuels,REP,440018,0,0,1,1,
Mcclain,U.S. Senate,Jim Inhofe,REP,440018,1,2,83,86,
Mcclain,U.S. Senate,Erick Paul Wyatt,REP,440018,0,0,7,7,
Mcclain,U.S. Senate,Andy Craig,REP,440018,0,0,1,1,
Mcclain,U.S. Senate,T. Shannon,REP,440018,0,0,42,42,
Mcclain,U.S. Senate,Randy Brogdon,REP,440018,0,2,0,2,
Mcclain,U.S. Senate,Eric Mccray,REP,440018,0,0,0,0,
Mcclain,U.S. Senate,Kevin Crow,REP,440018,0,0,2,2,
Mcclain,U.S. Senate,James Lankford,REP,440018,1,0,49,50,
Mcclain,U.S. Senate,Jason Weger,REP,440018,0,0,1,1,
Mcclain,U.S. House,Anna Flatt,REP,440018,0,2,11,13,04
Mcclain,U.S. House,Tom Cole,REP,440018,1,0,84,85,04
Mcclain,Superintendent of Public Instruction,John Cox,DEM,440019,3,0,13,16,
Mcclain,Superintendent of Public Instruction,Jack Jr.,DEM,440019,2,0,6,8,
Mcclain,Superintendent of Public Instruction,Ivan Holmes,DEM,440019,0,0,3,3,
Mcclain,Superintendent of Public Instruction,Freda Deskin,DEM,440019,3,0,26,29,
Mcclain,U.S. Senate,Patrick Michael Hayes,DEM,440019,2,0,13,15,
Mcclain,U.S. Senate,Jim Rogers,DEM,440019,3,0,18,21,
Mcclain,U.S. Senate,Connie Johnson,DEM,440019,3,0,15,18,
Mcclain,U.S. House,Bert Smith,DEM,440019,7,0,41,48,04
Mcclain,U.S. House,Tae Si,DEM,440019,1,0,3,4,04
Mcclain,Governor,Dax Ewbank,REP,440019,0,0,9,9,
Mcclain,Governor,Chad Moody,REP,440019,0,0,15,15,
Mcclain,Governor,Mary Fallin,REP,440019,2,0,75,77,
Mcclain,Superintendent of Public Instruction,Brian Kelly,REP,440019,0,0,27,27,
Mcclain,Superintendent of Public Instruction,Janet Costello Barresi,REP,440019,0,0,10,10,
Mcclain,Superintendent of Public Instruction,Joy Hofmeister,REP,440019,0,0,61,61,
Mcclain,Insurance Commissioner,Bill Viner,REP,440019,0,0,19,19,
Mcclain,Insurance Commissioner,John Doak,REP,440019,0,0,69,69,
Mcclain,Corporation Commissioner,Todd Hiett,REP,440019,2,0,44,46,
Mcclain,Corporation Commissioner,Cliff Branan,REP,440019,0,0,45,45,
Mcclain,U.S. Senate,Evelyn Rogers,REP,440019,0,0,1,1,
Mcclain,U.S. Senate,Rob Moye,REP,440019,0,0,2,2,
Mcclain,U.S. Senate,D. Jean Mcbride-Samuels,REP,440019,0,0,3,3,
Mcclain,U.S. Senate,Jim Inhofe,REP,440019,2,0,90,92,
Mcclain,U.S. Senate,Erick Paul Wyatt,REP,440019,0,0,4,4,
Mcclain,U.S. Senate,Andy Craig,REP,440019,0,0,0,0,
Mcclain,U.S. Senate,T. Shannon,REP,440019,0,0,39,39,
Mcclain,U.S. Senate,Randy Brogdon,REP,440019,0,0,4,4,
Mcclain,U.S. Senate,Eric Mccray,REP,440019,0,0,1,1,
Mcclain,U.S. Senate,Kevin Crow,REP,440019,0,0,2,2,
Mcclain,U.S. Senate,James Lankford,REP,440019,0,0,53,53,
Mcclain,U.S. Senate,Jason Weger,REP,440019,0,0,1,1,
Mcclain,U.S. House,Anna Flatt,REP,440019,0,0,18,18,04
Mcclain,U.S. House,Tom Cole,REP,440019,2,0,80,82,04
Mcclain,Superintendent of Public Instruction,John Cox,DEM,440020,1,1,13,15,
Mcclain,Superintendent of Public Instruction,Jack Jr.,DEM,440020,0,0,9,9,
Mcclain,Superintendent of Public Instruction,Ivan Holmes,DEM,440020,0,1,0,1,
Mcclain,Superintendent of Public Instruction,Freda Deskin,DEM,440020,0,0,30,30,
Mcclain,U.S. Senate,Patrick Michael Hayes,DEM,440020,0,1,12,13,
Mcclain,U.S. Senate,Jim Rogers,DEM,440020,0,0,16,16,
Mcclain,U.S. Senate,Connie Johnson,DEM,440020,1,1,22,24,
Mcclain,U.S. House,Bert Smith,DEM,440020,1,1,43,45,04
Mcclain,U.S. House,Tae Si,DEM,440020,0,1,6,7,04
Mcclain,Governor,Dax Ewbank,REP,440020,0,0,9,9,
Mcclain,Governor,Chad Moody,REP,440020,0,1,17,18,
Mcclain,Governor,Mary Fallin,REP,440020,2,1,72,75,
Mcclain,Superintendent of Public Instruction,Brian Kelly,REP,440020,0,1,23,24,
Mcclain,Superintendent of Public Instruction,Janet Costello Barresi,REP,440020,2,1,12,15,
Mcclain,Superintendent of Public Instruction,Joy Hofmeister,REP,440020,0,0,63,63,
Mcclain,Insurance Commissioner,Bill Viner,REP,440020,0,1,15,16,
Mcclain,Insurance Commissioner,John Doak,REP,440020,2,1,78,81,
Mcclain,Corporation Commissioner,Todd Hiett,REP,440020,0,1,55,56,
Mcclain,Corporation Commissioner,Cliff Branan,REP,440020,2,1,32,35,
Mcclain,U.S. Senate,Evelyn Rogers,REP,440020,0,0,2,2,
Mcclain,U.S. Senate,Rob Moye,REP,440020,0,2,0,2,
Mcclain,U.S. Senate,D. Jean Mcbride-Samuels,REP,440020,0,0,0,0,
Mcclain,U.S. Senate,Jim Inhofe,REP,440020,2,0,94,96,
Mcclain,U.S. Senate,Erick Paul Wyatt,REP,440020,0,0,2,2,
Mcclain,U.S. Senate,Andy Craig,REP,440020,0,1,0,1,
Mcclain,U.S. Senate,T. Shannon,REP,440020,0,0,31,31,
Mcclain,U.S. Senate,Randy Brogdon,REP,440020,0,0,1,1,
Mcclain,U.S. Senate,Eric Mccray,REP,440020,0,0,1,1,
Mcclain,U.S. Senate,Kevin Crow,REP,440020,0,0,1,1,
Mcclain,U.S. Senate,James Lankford,REP,440020,1,1,65,67,
Mcclain,U.S. Senate,Jason Weger,REP,440020,1,0,0,1,
Mcclain,U.S. House,Anna Flatt,REP,440020,0,1,12,13,04
Mcclain,U.S. House,Tom Cole,REP,440020,2,1,87,90,04
Mcclain,Superintendent of Public Instruction,John Cox,DEM,440021,0,2,10,12,
Mcclain,Superintendent of Public Instruction,Jack Jr.,DEM,440021,0,2,6,8,
Mcclain,Superintendent of Public Instruction,Ivan Holmes,DEM,440021,0,0,1,1,
Mcclain,Superintendent of Public Instruction,Freda Deskin,DEM,440021,2,7,40,49,
Mcclain,U.S. Senate,Patrick Michael Hayes,DEM,440021,0,2,16,18,
Mcclain,U.S. Senate,Jim Rogers,DEM,440021,0,6,21,27,
Mcclain,U.S. Senate,Connie Johnson,DEM,440021,2,3,19,24,
Mcclain,U.S. House,Bert Smith,DEM,440021,2,10,42,54,04
Mcclain,U.S. House,Tae Si,DEM,440021,0,1,13,14,04
Mcclain,Governor,Dax Ewbank,REP,440021,0,0,12,12,
Mcclain,Governor,Chad Moody,REP,440021,1,1,9,11,
Mcclain,Governor,Mary Fallin,REP,440021,0,4,37,41,
Mcclain,Superintendent of Public Instruction,Brian Kelly,REP,440021,1,1,18,20,
Mcclain,Superintendent of Public Instruction,Janet Costello Barresi,REP,440021,0,1,8,9,
Mcclain,Superintendent of Public Instruction,Joy Hofmeister,REP,440021,0,3,30,33,
Mcclain,Insurance Commissioner,Bill Viner,REP,440021,1,1,12,14,
Mcclain,Insurance Commissioner,John Doak,REP,440021,0,4,42,46,
Mcclain,Corporation Commissioner,Todd Hiett,REP,440021,1,4,29,34,
Mcclain,Corporation Commissioner,Cliff Branan,REP,440021,0,1,28,29,
Mcclain,U.S. Senate,Evelyn Rogers,REP,440021,0,1,2,3,
Mcclain,U.S. Senate,Rob Moye,REP,440021,0,0,0,0,
Mcclain,U.S. Senate,D. Jean Mcbride-Samuels,REP,440021,1,0,1,2,
Mcclain,U.S. Senate,Jim Inhofe,REP,440021,0,4,53,57,
Mcclain,U.S. Senate,Erick Paul Wyatt,REP,440021,0,0,2,2,
Mcclain,U.S. Senate,Andy Craig,REP,440021,0,0,1,1,
Mcclain,U.S. Senate,T. Shannon,REP,440021,0,1,20,21,
Mcclain,U.S. Senate,Randy Brogdon,REP,440021,0,0,1,1,
Mcclain,U.S. Senate,Eric Mccray,REP,440021,0,0,1,1,
Mcclain,U.S. Senate,Kevin Crow,REP,440021,1,0,0,1,
Mcclain,U.S. Senate,James Lankford,REP,440021,0,4,35,39,
Mcclain,U.S. Senate,Jason Weger,REP,440021,0,0,0,0,
Mcclain,U.S. House,Anna Flatt,REP,440021,1,1,9,11,04
Mcclain,U.S. House,Tom Cole,REP,440021,0,4,49,53,04
Mcclain,Superintendent of Public Instruction,John Cox,DEM,440023,0,1,12,13,
Mcclain,Superintendent of Public Instruction,Jack Jr.,DEM,440023,1,0,2,3,
Mcclain,Superintendent of Public Instruction,Ivan Holmes,DEM,440023,0,0,1,1,
Mcclain,Superintendent of Public Instruction,Freda Deskin,DEM,440023,2,1,50,53,
Mcclain,U.S. Senate,Patrick Michael Hayes,DEM,440023,1,0,13,14,
Mcclain,U.S. Senate,Jim Rogers,DEM,440023,1,1,21,23,
Mcclain,U.S. Senate,Connie Johnson,DEM,440023,0,1,25,26,
Mcclain,U.S. House,Bert Smith,DEM,440023,2,2,51,55,04
Mcclain,U.S. House,Tae Si,DEM,440023,0,0,7,7,04
Mcclain,Governor,Dax Ewbank,REP,440023,0,0,18,18,
Mcclain,Governor,Chad Moody,REP,440023,1,0,13,14,
Mcclain,Governor,Mary Fallin,REP,440023,2,6,96,104,
Mcclain,Superintendent of Public Instruction,Brian Kelly,REP,440023,1,1,24,26,
Mcclain,Superintendent of Public Instruction,Janet Costello Barresi,REP,440023,2,1,26,29,
Mcclain,Superintendent of Public Instruction,Joy Hofmeister,REP,440023,0,4,76,80,
Mcclain,Insurance Commissioner,Bill Viner,REP,440023,0,0,22,22,
Mcclain,Insurance Commissioner,John Doak,REP,440023,3,6,97,106,
Mcclain,Corporation Commissioner,Todd Hiett,REP,440023,3,3,63,69,
Mcclain,Corporation Commissioner,Cliff Branan,REP,440023,0,3,60,63,
Mcclain,U.S. Senate,Evelyn Rogers,REP,440023,0,0,5,5,
Mcclain,U.S. Senate,Rob Moye,REP,440023,0,0,1,1,
Mcclain,U.S. Senate,D. Jean Mcbride-Samuels,REP,440023,0,0,0,0,
Mcclain,U.S. Senate,Jim Inhofe,REP,440023,3,6,117,126,
Mcclain,U.S. Senate,Erick Paul Wyatt,REP,440023,0,0,4,4,
Mcclain,U.S. Senate,Andy Craig,REP,440023,0,0,0,0,
Mcclain,U.S. Senate,T. Shannon,REP,440023,2,1,31,34,
Mcclain,U.S. Senate,Randy Brogdon,REP,440023,0,1,5,6,
Mcclain,U.S. Senate,Eric Mccray,REP,440023,0,0,1,1,
Mcclain,U.S. Senate,Kevin Crow,REP,440023,0,0,0,0,
Mcclain,U.S. Senate,James Lankford,REP,440023,1,4,92,97,
Mcclain,U.S. Senate,Jason Weger,REP,440023,0,0,0,0,
Mcclain,U.S. House,Anna Flatt,REP,440023,0,0,19,19,04
Mcclain,U.S. House,Tom Cole,REP,440023,3,6,107,116,04
Mcclain,Superintendent of Public Instruction,John Cox,DEM,440024,6,3,24,33,
Mcclain,Superintendent of Public Instruction,Jack Jr.,DEM,440024,1,0,7,8,
Mcclain,Superintendent of Public Instruction,Ivan Holmes,DEM,440024,0,2,3,5,
Mcclain,Superintendent of Public Instruction,Freda Deskin,DEM,440024,6,5,59,70,
Mcclain,U.S. Senate,Patrick Michael Hayes,DEM,440024,3,1,28,32,
Mcclain,U.S. Senate,Jim Rogers,DEM,440024,3,5,31,39,
Mcclain,U.S. Senate,Connie Johnson,DEM,440024,6,4,31,41,
Mcclain,U.S. House,Bert Smith,DEM,440024,10,6,82,98,04
Mcclain,U.S. House,Tae Si,DEM,440024,2,4,4,10,04
Mcclain,Governor,Dax Ewbank,REP,440024,0,2,12,14,
Mcclain,Governor,Chad Moody,REP,440024,1,1,21,23,
Mcclain,Governor,Mary Fallin,REP,440024,2,8,72,82,
Mcclain,Superintendent of Public Instruction,Brian Kelly,REP,440024,1,4,23,28,
Mcclain,Superintendent of Public Instruction,Janet Costello Barresi,REP,440024,1,0,16,17,
Mcclain,Superintendent of Public Instruction,Joy Hofmeister,REP,440024,1,7,65,73,
Mcclain,Insurance Commissioner,Bill Viner,REP,440024,3,2,19,24,
Mcclain,Insurance Commissioner,John Doak,REP,440024,0,9,82,91,
Mcclain,Corporation Commissioner,Todd Hiett,REP,440024,3,2,49,54,
Mcclain,Corporation Commissioner,Cliff Branan,REP,440024,0,9,52,61,
Mcclain,U.S. Senate,Evelyn Rogers,REP,440024,0,1,5,6,
Mcclain,U.S. Senate,Rob Moye,REP,440024,1,0,3,4,
Mcclain,U.S. Senate,D. Jean Mcbride-Samuels,REP,440024,0,0,0,0,
Mcclain,U.S. Senate,Jim Inhofe,REP,440024,1,9,93,103,
Mcclain,U.S. Senate,Erick Paul Wyatt,REP,440024,1,1,4,6,
Mcclain,U.S. Senate,Andy Craig,REP,440024,0,0,2,2,
Mcclain,U.S. Senate,T. Shannon,REP,440024,2,5,29,36,
Mcclain,U.S. Senate,Randy Brogdon,REP,440024,0,0,1,1,
Mcclain,U.S. Senate,Eric Mccray,REP,440024,1,0,1,2,
Mcclain,U.S. Senate,Kevin Crow,REP,440024,0,0,3,3,
Mcclain,U.S. Senate,James Lankford,REP,440024,0,6,68,74,
Mcclain,U.S. Senate,Jason Weger,REP,440024,0,0,2,2,
Mcclain,U.S. House,Anna Flatt,REP,440024,2,2,17,21,04
Mcclain,U.S. House,Tom Cole,REP,440024,1,9,90,100,04
Mcclain,Superintendent of Public Instruction,John Cox,DEM,440026,0,0,5,5,
Mcclain,Superintendent of Public Instruction,Jack Jr.,DEM,440026,0,4,1,5,
Mcclain,Superintendent of Public Instruction,Ivan Holmes,DEM,440026,0,0,0,0,
Mcclain,Superintendent of Public Instruction,Freda Deskin,DEM,440026,0,2,6,8,
Mcclain,U.S. Senate,Patrick Michael Hayes,DEM,440026,0,1,2,3,
Mcclain,U.S. Senate,Jim Rogers,DEM,440026,0,1,8,9,
Mcclain,U.S. Senate,Connie Johnson,DEM,440026,0,3,2,5,
Mcclain,U.S. House,Bert Smith,DEM,440026,0,4,12,16,04
Mcclain,U.S. House,Tae Si,DEM,440026,0,1,0,1,04
Mcclain,Governor,Dax Ewbank,REP,440026,0,0,1,1,
Mcclain,Governor,Chad Moody,REP,440026,0,2,3,5,
Mcclain,Governor,Mary Fallin,REP,440026,1,5,20,26,
Mcclain,Superintendent of Public Instruction,Brian Kelly,REP,440026,0,2,7,9,
Mcclain,Superintendent of Public Instruction,Janet Costello Barresi,REP,440026,0,1,6,7,
Mcclain,Superintendent of Public Instruction,Joy Hofmeister,REP,440026,0,5,10,15,
Mcclain,Insurance Commissioner,Bill Viner,REP,440026,0,2,4,6,
Mcclain,Insurance Commissioner,John Doak,REP,440026,0,5,17,22,
Mcclain,Corporation Commissioner,Todd Hiett,REP,440026,0,5,11,16,
Mcclain,Corporation Commissioner,Cliff Branan,REP,440026,0,2,11,13,
Mcclain,U.S. Senate,Evelyn Rogers,REP,440026,0,1,0,1,
Mcclain,U.S. Senate,Rob Moye,REP,440026,0,0,0,0,
Mcclain,U.S. Senate,D. Jean Mcbride-Samuels,REP,440026,0,0,0,0,
Mcclain,U.S. Senate,Jim Inhofe,REP,440026,1,7,24,32,
Mcclain,U.S. Senate,Erick Paul Wyatt,REP,440026,0,0,0,0,
Mcclain,U.S. Senate,Andy Craig,REP,440026,0,0,0,0,
Mcclain,U.S. Senate,T. Shannon,REP,440026,0,4,6,10,
Mcclain,U.S. Senate,Randy Brogdon,REP,440026,0,0,0,0,
Mcclain,U.S. Senate,Eric Mccray,REP,440026,0,0,0,0,
Mcclain,U.S. Senate,Kevin Crow,REP,440026,0,0,0,0,
Mcclain,U.S. Senate,James Lankford,REP,440026,0,4,18,22,
Mcclain,U.S. Senate,Jason Weger,REP,440026,0,0,0,0,
Mcclain,U.S. House,Anna Flatt,REP,440026,0,2,3,5,04
Mcclain,U.S. House,Tom Cole,REP,440026,1,6,21,28,04
Mcclain,Superintendent of Public Instruction,John Cox,DEM,440027,0,0,9,9,
Mcclain,Superintendent of Public Instruction,Jack Jr.,DEM,440027,0,0,2,2,
Mcclain,Superintendent of Public Instruction,Ivan Holmes,DEM,440027,1,0,1,2,
Mcclain,Superintendent of Public Instruction,Freda Deskin,DEM,440027,0,0,12,12,
Mcclain,U.S. Senate,Patrick Michael Hayes,DEM,440027,0,0,9,9,
Mcclain,U.S. Senate,Jim Rogers,DEM,440027,1,0,8,9,
Mcclain,U.S. Senate,Connie Johnson,DEM,440027,0,0,7,7,
Mcclain,U.S. House,Bert Smith,DEM,440027,1,0,18,19,04
Mcclain,U.S. House,Tae Si,DEM,440027,0,0,2,2,04
Mcclain,Governor,Dax Ewbank,REP,440027,0,0,6,6,
Mcclain,Governor,Chad Moody,REP,440027,0,1,7,8,
Mcclain,Governor,Mary Fallin,REP,440027,3,0,67,70,
Mcclain,Superintendent of Public Instruction,Brian Kelly,REP,440027,0,1,25,26,
Mcclain,Superintendent of Public Instruction,Janet Costello Barresi,REP,440027,1,0,9,10,
Mcclain,Superintendent of Public Instruction,Joy Hofmeister,REP,440027,2,0,46,48,
Mcclain,Insurance Commissioner,Bill Viner,REP,440027,0,1,15,16,
Mcclain,Insurance Commissioner,John Doak,REP,440027,3,0,59,62,
Mcclain,Corporation Commissioner,Todd Hiett,REP,440027,2,1,28,31,
Mcclain,Corporation Commissioner,Cliff Branan,REP,440027,0,0,44,44,
Mcclain,U.S. Senate,Evelyn Rogers,REP,440027,0,0,2,2,
Mcclain,U.S. Senate,Rob Moye,REP,440027,0,0,1,1,
Mcclain,U.S. Senate,D. Jean Mcbride-Samuels,REP,440027,0,0,1,1,
Mcclain,U.S. Senate,Jim Inhofe,REP,440027,3,1,72,76,
Mcclain,U.S. Senate,Erick Paul Wyatt,REP,440027,0,0,4,4,
Mcclain,U.S. Senate,Andy Craig,REP,440027,0,0,0,0,
Mcclain,U.S. Senate,T. Shannon,REP,440027,1,0,26,27,
Mcclain,U.S. Senate,Randy Brogdon,REP,440027,0,0,1,1,
Mcclain,U.S. Senate,Eric Mccray,REP,440027,0,0,1,1,
Mcclain,U.S. Senate,Kevin Crow,REP,440027,0,0,0,0,
Mcclain,U.S. Senate,James Lankford,REP,440027,2,1,53,56,
Mcclain,U.S. Senate,Jason Weger,REP,440027,0,0,0,0,
Mcclain,U.S. House,Anna Flatt,REP,440027,0,0,8,8,04
Mcclain,U.S. House,Tom Cole,REP,440027,3,1,71,75,04
Mcclain,Superintendent of Public Instruction,John Cox,DEM,440028,0,0,5,5,
Mcclain,Superintendent of Public Instruction,Jack Jr.,DEM,440028,0,0,1,1,
Mcclain,Superintendent of Public Instruction,Ivan Holmes,DEM,440028,2,0,3,5,
Mcclain,Superintendent of Public Instruction,Freda Deskin,DEM,440028,1,0,14,15,
Mcclain,U.S. Senate,Patrick Michael Hayes,DEM,440028,1,0,5,6,
Mcclain,U.S. Senate,Jim Rogers,DEM,440028,0,0,6,6,
Mcclain,U.S. Senate,Connie Johnson,DEM,440028,2,0,12,14,
Mcclain,U.S. House,Bert Smith,DEM,440028,1,0,14,15,04
Mcclain,U.S. House,Tae Si,DEM,440028,2,0,8,10,04
Mcclain,Governor,Dax Ewbank,REP,440028,0,0,5,5,
Mcclain,Governor,Chad Moody,REP,440028,0,0,6,6,
Mcclain,Governor,Mary Fallin,REP,440028,4,2,65,71,
Mcclain,Superintendent of Public Instruction,Brian Kelly,REP,440028,4,1,19,24,
Mcclain,Superintendent of Public Instruction,Janet Costello Barresi,REP,440028,0,0,21,21,
Mcclain,Superintendent of Public Instruction,Joy Hofmeister,REP,440028,0,1,33,34,
Mcclain,Insurance Commissioner,Bill Viner,REP,440028,2,1,11,14,
Mcclain,Insurance Commissioner,John Doak,REP,440028,2,1,59,62,
Mcclain,Corporation Commissioner,Todd Hiett,REP,440028,2,2,36,40,
Mcclain,Corporation Commissioner,Cliff Branan,REP,440028,2,0,32,34,
Mcclain,U.S. Senate,Evelyn Rogers,REP,440028,0,0,2,2,
Mcclain,U.S. Senate,Rob Moye,REP,440028,0,0,0,0,
Mcclain,U.S. Senate,D. Jean Mcbride-Samuels,REP,440028,0,0,1,1,
Mcclain,U.S. Senate,Jim Inhofe,REP,440028,4,2,68,74,
Mcclain,U.S. Senate,Erick Paul Wyatt,REP,440028,0,0,5,5,
Mcclain,U.S. Senate,Andy Craig,REP,440028,0,0,0,0,
Mcclain,U.S. Senate,T. Shannon,REP,440028,2,0,28,30,
Mcclain,U.S. Senate,Randy Brogdon,REP,440028,0,0,2,2,
Mcclain,U.S. Senate,Eric Mccray,REP,440028,0,0,0,0,
Mcclain,U.S. Senate,Kevin Crow,REP,440028,0,0,0,0,
Mcclain,U.S. Senate,James Lankford,REP,440028,2,2,45,49,
Mcclain,U.S. Senate,Jason Weger,REP,440028,0,0,1,1,
Mcclain,U.S. House,Anna Flatt,REP,440028,0,0,13,13,04
Mcclain,U.S. House,Tom Cole,REP,440028,4,2,61,67,04
Mccurtain,Superintendent of Public Instruction,John Cox,DEM,450002,0,1,11,12,
Mccurtain,Superintendent of Public Instruction,Jack Jr.,DEM,450002,0,0,7,7,
Mccurtain,Superintendent of Public Instruction,Ivan Holmes,DEM,450002,0,0,2,2,
Mccurtain,Superintendent of Public Instruction,Freda Deskin,DEM,450002,0,0,8,8,
Mccurtain,U.S. Senate,Patrick Michael Hayes,DEM,450002,0,0,9,9,
Mccurtain,U.S. Senate,Jim Rogers,DEM,450002,0,0,13,13,
Mccurtain,U.S. Senate,Connie Johnson,DEM,450002,0,0,5,5,
Mccurtain,U.S. House,Earl Everett,DEM,450002,0,0,15,15,02
Mccurtain,U.S. House,Joshua Harris-Till,DEM,450002,0,0,9,9,02
Mccurtain,State House,Johnny Tadlock,DEM,450002,0,2,29,31,1
Mccurtain,State House,Kent Hendon,DEM,450002,0,0,4,4,1
Mccurtain,Governor,Dax Ewbank,REP,450002,0,0,0,0,
Mccurtain,Governor,Chad Moody,REP,450002,0,0,1,1,
Mccurtain,Governor,Mary Fallin,REP,450002,0,0,6,6,
Mccurtain,Superintendent of Public Instruction,Brian Kelly,REP,450002,0,0,1,1,
Mccurtain,Superintendent of Public Instruction,Janet Costello Barresi,REP,450002,0,0,3,3,
Mccurtain,Superintendent of Public Instruction,Joy Hofmeister,REP,450002,0,0,1,1,
Mccurtain,Insurance Commissioner,Bill Viner,REP,450002,0,0,0,0,
Mccurtain,Insurance Commissioner,John Doak,REP,450002,0,0,5,5,
Mccurtain,Corporation Commissioner,Todd Hiett,REP,450002,0,0,3,3,
Mccurtain,Corporation Commissioner,Cliff Branan,REP,450002,0,0,2,2,
Mccurtain,U.S. Senate,Evelyn Rogers,REP,450002,0,0,0,0,
Mccurtain,U.S. Senate,Rob Moye,REP,450002,0,0,0,0,
Mccurtain,U.S. Senate,D. Jean Mcbride-Samuels,REP,450002,0,0,0,0,
Mccurtain,U.S. Senate,Jim Inhofe,REP,450002,0,0,7,7,
Mccurtain,U.S. Senate,Erick Paul Wyatt,REP,450002,0,0,0,0,
Mccurtain,U.S. Senate,Andy Craig,REP,450002,0,0,0,0,
Mccurtain,U.S. Senate,T. Shannon,REP,450002,0,0,1,1,
Mccurtain,U.S. Senate,Randy Brogdon,REP,450002,0,0,0,0,
Mccurtain,U.S. Senate,Eric Mccray,REP,450002,0,0,1,1,
Mccurtain,U.S. Senate,Kevin Crow,REP,450002,0,0,0,0,
Mccurtain,U.S. Senate,James Lankford,REP,450002,0,0,4,4,
Mccurtain,U.S. Senate,Jason Weger,REP,450002,0,0,0,0,
Mccurtain,U.S. House,Darrel Robertson,REP,450002,0,0,0,0,02
Mccurtain,U.S. House,Markwayne Mullin,REP,450002,0,0,6,6,02
Mccurtain,State Senate,Joseph Silk,REP,450002,0,0,6,6,5
Mccurtain,State Senate,Brent Shain,REP,450002,0,0,0,0,5
Mccurtain,Superintendent of Public Instruction,John Cox,DEM,450004,0,8,53,61,
Mccurtain,Superintendent of Public Instruction,Jack Jr.,DEM,450004,1,6,41,48,
Mccurtain,Superintendent of Public Instruction,Ivan Holmes,DEM,450004,1,7,6,14,
Mccurtain,Superintendent of Public Instruction,Freda Deskin,DEM,450004,1,5,22,28,
Mccurtain,U.S. Senate,Patrick Michael Hayes,DEM,450004,1,7,28,36,
Mccurtain,U.S. Senate,Jim Rogers,DEM,450004,1,12,50,63,
Mccurtain,U.S. Senate,Connie Johnson,DEM,450004,0,7,36,43,
Mccurtain,U.S. House,Earl Everett,DEM,450004,1,19,82,102,02
Mccurtain,U.S. House,Joshua Harris-Till,DEM,450004,2,3,26,31,02
Mccurtain,State House,Johnny Tadlock,DEM,450004,3,24,95,122,1
Mccurtain,State House,Kent Hendon,DEM,450004,0,7,45,52,1
Mccurtain,Governor,Dax Ewbank,REP,450004,0,1,3,4,
Mccurtain,Governor,Chad Moody,REP,450004,0,1,7,8,
Mccurtain,Governor,Mary Fallin,REP,450004,0,3,34,37,
Mccurtain,Superintendent of Public Instruction,Brian Kelly,REP,450004,0,3,12,15,
Mccurtain,Superintendent of Public Instruction,Janet Costello Barresi,REP,450004,0,1,5,6,
Mccurtain,Superintendent of Public Instruction,Joy Hofmeister,REP,450004,0,1,26,27,
Mccurtain,Insurance Commissioner,Bill Viner,REP,450004,0,1,8,9,
Mccurtain,Insurance Commissioner,John Doak,REP,450004,0,2,29,31,
Mccurtain,Corporation Commissioner,Todd Hiett,REP,450004,0,1,23,24,
Mccurtain,Corporation Commissioner,Cliff Branan,REP,450004,0,1,14,15,
Mccurtain,U.S. Senate,Evelyn Rogers,REP,450004,0,0,0,0,
Mccurtain,U.S. Senate,Rob Moye,REP,450004,0,0,1,1,
Mccurtain,U.S. Senate,D. Jean Mcbride-Samuels,REP,450004,0,0,1,1,
Mccurtain,U.S. Senate,Jim Inhofe,REP,450004,0,5,38,43,
Mccurtain,U.S. Senate,Erick Paul Wyatt,REP,450004,0,0,1,1,
Mccurtain,U.S. Senate,Andy Craig,REP,450004,0,0,1,1,
Mccurtain,U.S. Senate,T. Shannon,REP,450004,0,2,10,12,
Mccurtain,U.S. Senate,Randy Brogdon,REP,450004,0,0,0,0,
Mccurtain,U.S. Senate,Eric Mccray,REP,450004,0,0,1,1,
Mccurtain,U.S. Senate,Kevin Crow,REP,450004,0,0,1,1,
Mccurtain,U.S. Senate,James Lankford,REP,450004,0,3,27,30,
Mccurtain,U.S. Senate,Jason Weger,REP,450004,0,0,1,1,
Mccurtain,U.S. House,Darrel Robertson,REP,450004,0,1,7,8,02
Mccurtain,U.S. House,Markwayne Mullin,REP,450004,0,4,37,41,02
Mccurtain,State Senate,Joseph Silk,REP,450004,0,5,36,41,5
Mccurtain,State Senate,Brent Shain,REP,450004,0,0,9,9,5
Mccurtain,Superintendent of Public Instruction,John Cox,DEM,450005,0,0,20,20,
Mccurtain,Superintendent of Public Instruction,Jack Jr.,DEM,450005,2,0,5,7,
Mccurtain,Superintendent of Public Instruction,Ivan Holmes,DEM,450005,0,0,4,4,
Mccurtain,Superintendent of Public Instruction,Freda Deskin,DEM,450005,0,0,12,12,
Mccurtain,U.S. Senate,Patrick Michael Hayes,DEM,450005,0,0,7,7,
Mccurtain,U.S. Senate,Jim Rogers,DEM,450005,1,0,13,14,
Mccurtain,U.S. Senate,Connie Johnson,DEM,450005,2,0,21,23,
Mccurtain,U.S. House,Earl Everett,DEM,450005,2,0,26,28,02
Mccurtain,U.S. House,Joshua Harris-Till,DEM,450005,0,0,15,15,02
Mccurtain,State House,Johnny Tadlock,DEM,450005,2,0,34,36,1
Mccurtain,State House,Kent Hendon,DEM,450005,1,0,8,9,1
Mccurtain,Governor,Dax Ewbank,REP,450005,0,0,1,1,
Mccurtain,Governor,Chad Moody,REP,450005,0,0,0,0,
Mccurtain,Governor,Mary Fallin,REP,450005,0,0,1,1,
Mccurtain,Superintendent of Public Instruction,Brian Kelly,REP,450005,0,0,1,1,
Mccurtain,Superintendent of Public Instruction,Janet Costello Barresi,REP,450005,0,0,1,1,
Mccurtain,Superintendent of Public Instruction,Joy Hofmeister,REP,450005,0,0,0,0,
Mccurtain,Insurance Commissioner,Bill Viner,REP,450005,0,0,0,0,
Mccurtain,Insurance Commissioner,John Doak,REP,450005,0,0,2,2,
Mccurtain,Corporation Commissioner,Todd Hiett,REP,450005,0,0,0,0,
Mccurtain,Corporation Commissioner,Cliff Branan,REP,450005,0,0,2,2,
Mccurtain,U.S. Senate,Evelyn Rogers,REP,450005,0,0,0,0,
Mccurtain,U.S. Senate,Rob Moye,REP,450005,0,0,0,0,
Mccurtain,U.S. Senate,D. Jean Mcbride-Samuels,REP,450005,0,0,0,0,
Mccurtain,U.S. Senate,Jim Inhofe,REP,450005,0,0,2,2,
Mccurtain,U.S. Senate,Erick Paul Wyatt,REP,450005,0,0,0,0,
Mccurtain,U.S. Senate,Andy Craig,REP,450005,0,0,0,0,
Mccurtain,U.S. Senate,T. Shannon,REP,450005,0,0,1,1,
Mccurtain,U.S. Senate,Randy Brogdon,REP,450005,0,0,0,0,
Mccurtain,U.S. Senate,Eric Mccray,REP,450005,0,0,0,0,
Mccurtain,U.S. Senate,Kevin Crow,REP,450005,0,0,1,1,
Mccurtain,U.S. Senate,James Lankford,REP,450005,0,0,0,0,
Mccurtain,U.S. Senate,Jason Weger,REP,450005,0,0,0,0,
Mccurtain,U.S. House,Darrel Robertson,REP,450005,0,0,0,0,02
Mccurtain,U.S. House,Markwayne Mullin,REP,450005,0,0,2,2,02
Mccurtain,State Senate,Joseph Silk,REP,450005,0,0,1,1,5
Mccurtain,State Senate,Brent Shain,REP,450005,0,0,1,1,5
Mccurtain,Superintendent of Public Instruction,John Cox,DEM,450006,0,7,62,69,
Mccurtain,Superintendent of Public Instruction,Jack Jr.,DEM,450006,2,5,49,56,
Mccurtain,Superintendent of Public Instruction,Ivan Holmes,DEM,450006,0,2,7,9,
Mccurtain,Superintendent of Public Instruction,Freda Deskin,DEM,450006,2,3,27,32,
Mccurtain,U.S. Senate,Patrick Michael Hayes,DEM,450006,2,4,29,35,
Mccurtain,U.S. Senate,Jim Rogers,DEM,450006,0,9,74,83,
Mccurtain,U.S. Senate,Connie Johnson,DEM,450006,3,3,35,41,
Mccurtain,U.S. House,Earl Everett,DEM,450006,2,16,86,104,02
Mccurtain,U.S. House,Joshua Harris-Till,DEM,450006,3,0,44,47,02
Mccurtain,State House,Johnny Tadlock,DEM,450006,5,16,126,147,1
Mccurtain,State House,Kent Hendon,DEM,450006,2,3,38,43,1
Mccurtain,Governor,Dax Ewbank,REP,450006,0,0,2,2,
Mccurtain,Governor,Chad Moody,REP,450006,0,1,4,5,
Mccurtain,Governor,Mary Fallin,REP,450006,0,6,18,24,
Mccurtain,Superintendent of Public Instruction,Brian Kelly,REP,450006,0,1,2,3,
Mccurtain,Superintendent of Public Instruction,Janet Costello Barresi,REP,450006,0,1,8,9,
Mccurtain,Superintendent of Public Instruction,Joy Hofmeister,REP,450006,0,5,14,19,
Mccurtain,Insurance Commissioner,Bill Viner,REP,450006,0,2,4,6,
Mccurtain,Insurance Commissioner,John Doak,REP,450006,0,3,17,20,
Mccurtain,Corporation Commissioner,Todd Hiett,REP,450006,0,3,14,17,
Mccurtain,Corporation Commissioner,Cliff Branan,REP,450006,0,3,7,10,
Mccurtain,U.S. Senate,Evelyn Rogers,REP,450006,0,0,0,0,
Mccurtain,U.S. Senate,Rob Moye,REP,450006,0,0,0,0,
Mccurtain,U.S. Senate,D. Jean Mcbride-Samuels,REP,450006,0,0,2,2,
Mccurtain,U.S. Senate,Jim Inhofe,REP,450006,0,6,21,27,
Mccurtain,U.S. Senate,Erick Paul Wyatt,REP,450006,0,0,0,0,
Mccurtain,U.S. Senate,Andy Craig,REP,450006,0,0,0,0,
Mccurtain,U.S. Senate,T. Shannon,REP,450006,0,3,6,9,
Mccurtain,U.S. Senate,Randy Brogdon,REP,450006,0,1,1,2,
Mccurtain,U.S. Senate,Eric Mccray,REP,450006,0,0,1,1,
Mccurtain,U.S. Senate,Kevin Crow,REP,450006,0,0,1,1,
Mccurtain,U.S. Senate,James Lankford,REP,450006,0,2,14,16,
Mccurtain,U.S. Senate,Jason Weger,REP,450006,0,0,0,0,
Mccurtain,U.S. House,Darrel Robertson,REP,450006,0,0,5,5,02
Mccurtain,U.S. House,Markwayne Mullin,REP,450006,0,6,19,25,02
Mccurtain,State Senate,Joseph Silk,REP,450006,0,6,20,26,5
Mccurtain,State Senate,Brent Shain,REP,450006,0,1,4,5,5
Mccurtain,Superintendent of Public Instruction,John Cox,DEM,450008,0,4,72,76,
Mccurtain,Superintendent of Public Instruction,Jack Jr.,DEM,450008,0,1,28,29,
Mccurtain,Superintendent of Public Instruction,Ivan Holmes,DEM,450008,0,1,2,3,
Mccurtain,Superintendent of Public Instruction,Freda Deskin,DEM,450008,0,3,26,29,
Mccurtain,U.S. Senate,Patrick Michael Hayes,DEM,450008,0,3,28,31,
Mccurtain,U.S. Senate,Jim Rogers,DEM,450008,0,2,51,53,
Mccurtain,U.S. Senate,Connie Johnson,DEM,450008,0,5,37,42,
Mccurtain,U.S. House,Earl Everett,DEM,450008,0,6,85,91,02
Mccurtain,U.S. House,Joshua Harris-Till,DEM,450008,0,3,25,28,02
Mccurtain,State House,Johnny Tadlock,DEM,450008,1,7,110,118,1
Mccurtain,State House,Kent Hendon,DEM,450008,0,3,33,36,1
Mccurtain,Governor,Dax Ewbank,REP,450008,0,0,0,0,
Mccurtain,Governor,Chad Moody,REP,450008,0,2,7,9,
Mccurtain,Governor,Mary Fallin,REP,450008,0,2,25,27,
Mccurtain,Superintendent of Public Instruction,Brian Kelly,REP,450008,0,2,3,5,
Mccurtain,Superintendent of Public Instruction,Janet Costello Barresi,REP,450008,0,1,7,8,
Mccurtain,Superintendent of Public Instruction,Joy Hofmeister,REP,450008,0,0,19,19,
Mccurtain,Insurance Commissioner,Bill Viner,REP,450008,0,2,6,8,
Mccurtain,Insurance Commissioner,John Doak,REP,450008,0,0,23,23,
Mccurtain,Corporation Commissioner,Todd Hiett,REP,450008,0,1,14,15,
Mccurtain,Corporation Commissioner,Cliff Branan,REP,450008,0,1,14,15,
Mccurtain,U.S. Senate,Evelyn Rogers,REP,450008,0,0,2,2,
Mccurtain,U.S. Senate,Rob Moye,REP,450008,0,0,0,0,
Mccurtain,U.S. Senate,D. Jean Mcbride-Samuels,REP,450008,0,1,0,1,
Mccurtain,U.S. Senate,Jim Inhofe,REP,450008,0,3,30,33,
Mccurtain,U.S. Senate,Erick Paul Wyatt,REP,450008,0,0,0,0,
Mccurtain,U.S. Senate,Andy Craig,REP,450008,0,0,0,0,
Mccurtain,U.S. Senate,T. Shannon,REP,450008,0,3,15,18,
Mccurtain,U.S. Senate,Randy Brogdon,REP,450008,0,0,0,0,
Mccurtain,U.S. Senate,Eric Mccray,REP,450008,0,0,2,2,
Mccurtain,U.S. Senate,Kevin Crow,REP,450008,0,0,2,2,
Mccurtain,U.S. Senate,James Lankford,REP,450008,0,0,10,10,
Mccurtain,U.S. Senate,Jason Weger,REP,450008,0,0,2,2,
Mccurtain,U.S. House,Darrel Robertson,REP,450008,0,0,5,5,02
Mccurtain,U.S. House,Markwayne Mullin,REP,450008,0,4,27,31,02
Mccurtain,State Senate,Joseph Silk,REP,450008,0,0,24,24,5
Mccurtain,State Senate,Brent Shain,REP,450008,0,0,7,7,5
Mccurtain,Superintendent of Public Instruction,John Cox,DEM,450009,0,3,45,48,
Mccurtain,Superintendent of Public Instruction,Jack Jr.,DEM,450009,0,6,31,37,
Mccurtain,Superintendent of Public Instruction,Ivan Holmes,DEM,450009,0,1,11,12,
Mccurtain,Superintendent of Public Instruction,Freda Deskin,DEM,450009,0,3,14,17,
Mccurtain,U.S. Senate,Patrick Michael Hayes,DEM,450009,0,6,15,21,
Mccurtain,U.S. Senate,Jim Rogers,DEM,450009,0,3,47,50,
Mccurtain,U.S. Senate,Connie Johnson,DEM,450009,0,4,30,34,
Mccurtain,U.S. House,Earl Everett,DEM,450009,0,11,59,70,02
Mccurtain,U.S. House,Joshua Harris-Till,DEM,450009,0,2,31,33,02
Mccurtain,State House,Johnny Tadlock,DEM,450009,0,12,89,101,1
Mccurtain,State House,Kent Hendon,DEM,450009,0,1,20,21,1
Mccurtain,Governor,Dax Ewbank,REP,450009,0,0,1,1,
Mccurtain,Governor,Chad Moody,REP,450009,0,1,3,4,
Mccurtain,Governor,Mary Fallin,REP,450009,2,2,26,30,
Mccurtain,Superintendent of Public Instruction,Brian Kelly,REP,450009,1,1,7,9,
Mccurtain,Superintendent of Public Instruction,Janet Costello Barresi,REP,450009,1,1,7,9,
Mccurtain,Superintendent of Public Instruction,Joy Hofmeister,REP,450009,0,1,13,14,
Mccurtain,Insurance Commissioner,Bill Viner,REP,450009,0,1,7,8,
Mccurtain,Insurance Commissioner,John Doak,REP,450009,1,2,17,20,
Mccurtain,Corporation Commissioner,Todd Hiett,REP,450009,0,2,15,17,
Mccurtain,Corporation Commissioner,Cliff Branan,REP,450009,2,1,10,13,
Mccurtain,U.S. Senate,Evelyn Rogers,REP,450009,0,0,1,1,
Mccurtain,U.S. Senate,Rob Moye,REP,450009,0,0,0,0,
Mccurtain,U.S. Senate,D. Jean Mcbride-Samuels,REP,450009,0,0,0,0,
Mccurtain,U.S. Senate,Jim Inhofe,REP,450009,2,3,27,32,
Mccurtain,U.S. Senate,Erick Paul Wyatt,REP,450009,0,0,2,2,
Mccurtain,U.S. Senate,Andy Craig,REP,450009,0,0,0,0,
Mccurtain,U.S. Senate,T. Shannon,REP,450009,0,0,12,12,
Mccurtain,U.S. Senate,Randy Brogdon,REP,450009,0,0,2,2,
Mccurtain,U.S. Senate,Eric Mccray,REP,450009,0,0,0,0,
Mccurtain,U.S. Senate,Kevin Crow,REP,450009,0,0,0,0,
Mccurtain,U.S. Senate,James Lankford,REP,450009,1,3,15,19,
Mccurtain,U.S. Senate,Jason Weger,REP,450009,0,0,0,0,
Mccurtain,U.S. House,Darrel Robertson,REP,450009,0,1,4,5,02
Mccurtain,U.S. House,Markwayne Mullin,REP,450009,2,2,27,31,02
Mccurtain,State Senate,Joseph Silk,REP,450009,1,2,25,28,5
Mccurtain,State Senate,Brent Shain,REP,450009,1,1,5,7,5
Mccurtain,Superintendent of Public Instruction,John Cox,DEM,450011,0,8,20,28,
Mccurtain,Superintendent of Public Instruction,Jack Jr.,DEM,450011,0,0,11,11,
Mccurtain,Superintendent of Public Instruction,Ivan Holmes,DEM,450011,0,0,1,1,
Mccurtain,Superintendent of Public Instruction,Freda Deskin,DEM,450011,0,4,2,6,
Mccurtain,U.S. Senate,Patrick Michael Hayes,DEM,450011,0,2,3,5,
Mccurtain,U.S. Senate,Jim Rogers,DEM,450011,0,5,21,26,
Mccurtain,U.S. Senate,Connie Johnson,DEM,450011,0,1,5,6,
Mccurtain,U.S. House,Earl Everett,DEM,450011,0,3,19,22,02
Mccurtain,U.S. House,Joshua Harris-Till,DEM,450011,0,5,12,17,02
Mccurtain,State House,Johnny Tadlock,DEM,450011,0,12,30,42,1
Mccurtain,State House,Kent Hendon,DEM,450011,0,1,9,10,1
Mccurtain,Governor,Dax Ewbank,REP,450011,0,0,5,5,
Mccurtain,Governor,Chad Moody,REP,450011,0,0,0,0,
Mccurtain,Governor,Mary Fallin,REP,450011,0,0,3,3,
Mccurtain,Superintendent of Public Instruction,Brian Kelly,REP,450011,0,0,5,5,
Mccurtain,Superintendent of Public Instruction,Janet Costello Barresi,REP,450011,0,0,0,0,
Mccurtain,Superintendent of Public Instruction,Joy Hofmeister,REP,450011,0,0,3,3,
Mccurtain,Insurance Commissioner,Bill Viner,REP,450011,0,0,2,2,
Mccurtain,Insurance Commissioner,John Doak,REP,450011,0,0,6,6,
Mccurtain,Corporation Commissioner,Todd Hiett,REP,450011,0,0,4,4,
Mccurtain,Corporation Commissioner,Cliff Branan,REP,450011,0,0,4,4,
Mccurtain,U.S. Senate,Evelyn Rogers,REP,450011,0,0,0,0,
Mccurtain,U.S. Senate,Rob Moye,REP,450011,0,0,0,0,
Mccurtain,U.S. Senate,D. Jean Mcbride-Samuels,REP,450011,0,0,0,0,
Mccurtain,U.S. Senate,Jim Inhofe,REP,450011,0,0,9,9,
Mccurtain,U.S. Senate,Erick Paul Wyatt,REP,450011,0,0,0,0,
Mccurtain,U.S. Senate,Andy Craig,REP,450011,0,0,0,0,
Mccurtain,U.S. Senate,T. Shannon,REP,450011,0,0,3,3,
Mccurtain,U.S. Senate,Randy Brogdon,REP,450011,0,0,0,0,
Mccurtain,U.S. Senate,Eric Mccray,REP,450011,0,0,0,0,
Mccurtain,U.S. Senate,Kevin Crow,REP,450011,0,0,0,0,
Mccurtain,U.S. Senate,James Lankford,REP,450011,0,0,6,6,
Mccurtain,U.S. Senate,Jason Weger,REP,450011,0,0,0,0,
Mccurtain,U.S. House,Darrel Robertson,REP,450011,0,0,4,4,02
Mccurtain,U.S. House,Markwayne Mullin,REP,450011,0,0,5,5,02
Mccurtain,State Senate,Joseph Silk,REP,450011,0,0,8,8,5
Mccurtain,State Senate,Brent Shain,REP,450011,0,0,1,1,5
Mccurtain,Superintendent of Public Instruction,John Cox,DEM,450012,0,0,9,9,
Mccurtain,Superintendent of Public Instruction,Jack Jr.,DEM,450012,0,0,10,10,
Mccurtain,Superintendent of Public Instruction,Ivan Holmes,DEM,450012,0,0,0,0,
Mccurtain,Superintendent of Public Instruction,Freda Deskin,DEM,450012,0,0,2,2,
Mccurtain,U.S. Senate,Patrick Michael Hayes,DEM,450012,0,0,4,4,
Mccurtain,U.S. Senate,Jim Rogers,DEM,450012,0,0,7,7,
Mccurtain,U.S. Senate,Connie Johnson,DEM,450012,0,0,11,11,
Mccurtain,U.S. House,Earl Everett,DEM,450012,0,0,11,11,02
Mccurtain,U.S. House,Joshua Harris-Till,DEM,450012,0,0,10,10,02
Mccurtain,State House,Johnny Tadlock,DEM,450012,0,0,25,25,1
Mccurtain,State House,Kent Hendon,DEM,450012,0,0,3,3,1
Mccurtain,Governor,Dax Ewbank,REP,450012,0,0,0,0,
Mccurtain,Governor,Chad Moody,REP,450012,0,0,0,0,
Mccurtain,Governor,Mary Fallin,REP,450012,0,0,0,0,
Mccurtain,Superintendent of Public Instruction,Brian Kelly,REP,450012,0,0,0,0,
Mccurtain,Superintendent of Public Instruction,Janet Costello Barresi,REP,450012,0,0,0,0,
Mccurtain,Superintendent of Public Instruction,Joy Hofmeister,REP,450012,0,0,0,0,
Mccurtain,Insurance Commissioner,Bill Viner,REP,450012,0,0,0,0,
Mccurtain,Insurance Commissioner,John Doak,REP,450012,0,0,0,0,
Mccurtain,Corporation Commissioner,Todd Hiett,REP,450012,0,0,0,0,
Mccurtain,Corporation Commissioner,Cliff Branan,REP,450012,0,0,0,0,
Mccurtain,U.S. Senate,Evelyn Rogers,REP,450012,0,0,0,0,
Mccurtain,U.S. Senate,Rob Moye,REP,450012,0,0,0,0,
Mccurtain,U.S. Senate,D. Jean Mcbride-Samuels,REP,450012,0,0,0,0,
Mccurtain,U.S. Senate,Jim Inhofe,REP,450012,0,0,0,0,
Mccurtain,U.S. Senate,Erick Paul Wyatt,REP,450012,0,0,0,0,
Mccurtain,U.S. Senate,Andy Craig,REP,450012,0,0,0,0,
Mccurtain,U.S. Senate,T. Shannon,REP,450012,0,0,0,0,
Mccurtain,U.S. Senate,Randy Brogdon,REP,450012,0,0,0,0,
Mccurtain,U.S. Senate,Eric Mccray,REP,450012,0,0,0,0,
Mccurtain,U.S. Senate,Kevin Crow,REP,450012,0,0,0,0,
Mccurtain,U.S. Senate,James Lankford,REP,450012,0,0,0,0,
Mccurtain,U.S. Senate,Jason Weger,REP,450012,0,0,0,0,
Mccurtain,U.S. House,Darrel Robertson,REP,450012,0,0,0,0,02
Mccurtain,U.S. House,Markwayne Mullin,REP,450012,0,0,0,0,02
Mccurtain,State Senate,Joseph Silk,REP,450012,0,0,0,0,5
Mccurtain,State Senate,Brent Shain,REP,450012,0,0,0,0,5
Mccurtain,Superintendent of Public Instruction,John Cox,DEM,450013,0,4,39,43,
Mccurtain,Superintendent of Public Instruction,Jack Jr.,DEM,450013,0,2,11,13,
Mccurtain,Superintendent of Public Instruction,Ivan Holmes,DEM,450013,0,0,3,3,
Mccurtain,Superintendent of Public Instruction,Freda Deskin,DEM,450013,0,1,5,6,
Mccurtain,U.S. Senate,Patrick Michael Hayes,DEM,450013,0,1,12,13,
Mccurtain,U.S. Senate,Jim Rogers,DEM,450013,0,5,26,31,
Mccurtain,U.S. Senate,Connie Johnson,DEM,450013,0,0,13,13,
Mccurtain,U.S. House,Earl Everett,DEM,450013,0,3,35,38,02
Mccurtain,U.S. House,Joshua Harris-Till,DEM,450013,0,1,18,19,02
Mccurtain,State House,Johnny Tadlock,DEM,450013,0,7,58,65,1
Mccurtain,State House,Kent Hendon,DEM,450013,0,3,16,19,1
Mccurtain,Governor,Dax Ewbank,REP,450013,0,0,3,3,
Mccurtain,Governor,Chad Moody,REP,450013,0,1,1,2,
Mccurtain,Governor,Mary Fallin,REP,450013,0,0,9,9,
Mccurtain,Superintendent of Public Instruction,Brian Kelly,REP,450013,0,1,4,5,
Mccurtain,Superintendent of Public Instruction,Janet Costello Barresi,REP,450013,0,0,0,0,
Mccurtain,Superintendent of Public Instruction,Joy Hofmeister,REP,450013,0,0,6,6,
Mccurtain,Insurance Commissioner,Bill Viner,REP,450013,0,0,4,4,
Mccurtain,Insurance Commissioner,John Doak,REP,450013,0,1,6,7,
Mccurtain,Corporation Commissioner,Todd Hiett,REP,450013,0,0,7,7,
Mccurtain,Corporation Commissioner,Cliff Branan,REP,450013,0,1,5,6,
Mccurtain,U.S. Senate,Evelyn Rogers,REP,450013,0,0,3,3,
Mccurtain,U.S. Senate,Rob Moye,REP,450013,0,0,0,0,
Mccurtain,U.S. Senate,D. Jean Mcbride-Samuels,REP,450013,0,0,0,0,
Mccurtain,U.S. Senate,Jim Inhofe,REP,450013,0,1,5,6,
Mccurtain,U.S. Senate,Erick Paul Wyatt,REP,450013,0,0,2,2,
Mccurtain,U.S. Senate,Andy Craig,REP,450013,0,1,2,3,
Mccurtain,U.S. Senate,T. Shannon,REP,450013,0,0,4,4,
Mccurtain,U.S. Senate,Randy Brogdon,REP,450013,0,0,0,0,
Mccurtain,U.S. Senate,Eric Mccray,REP,450013,0,0,0,0,
Mccurtain,U.S. Senate,Kevin Crow,REP,450013,0,0,0,0,
Mccurtain,U.S. Senate,James Lankford,REP,450013,0,0,5,5,
Mccurtain,U.S. Senate,Jason Weger,REP,450013,0,0,0,0,
Mccurtain,U.S. House,Darrel Robertson,REP,450013,0,0,0,0,02
Mccurtain,U.S. House,Markwayne Mullin,REP,450013,0,1,11,12,02
Mccurtain,State Senate,Joseph Silk,REP,450013,0,1,5,6,5
Mccurtain,State Senate,Brent Shain,REP,450013,0,0,5,5,5
Mccurtain,Superintendent of Public Instruction,John Cox,DEM,450014,0,0,24,24,
Mccurtain,Superintendent of Public Instruction,Jack Jr.,DEM,450014,0,0,11,11,
Mccurtain,Superintendent of Public Instruction,Ivan Holmes,DEM,450014,0,0,1,1,
Mccurtain,Superintendent of Public Instruction,Freda Deskin,DEM,450014,0,0,6,6,
Mccurtain,U.S. Senate,Patrick Michael Hayes,DEM,450014,0,0,12,12,
Mccurtain,U.S. Senate,Jim Rogers,DEM,450014,0,0,21,21,
Mccurtain,U.S. Senate,Connie Johnson,DEM,450014,0,0,9,9,
Mccurtain,U.S. House,Earl Everett,DEM,450014,0,0,27,27,02
Mccurtain,U.S. House,Joshua Harris-Till,DEM,450014,0,0,12,12,02
Mccurtain,State House,Johnny Tadlock,DEM,450014,0,0,40,40,1
Mccurtain,State House,Kent Hendon,DEM,450014,0,0,8,8,1
Mccurtain,Governor,Dax Ewbank,REP,450014,0,0,0,0,
Mccurtain,Governor,Chad Moody,REP,450014,0,0,0,0,
Mccurtain,Governor,Mary Fallin,REP,450014,0,1,4,5,
Mccurtain,Superintendent of Public Instruction,Brian Kelly,REP,450014,0,0,1,1,
Mccurtain,Superintendent of Public Instruction,Janet Costello Barresi,REP,450014,0,0,0,0,
Mccurtain,Superintendent of Public Instruction,Joy Hofmeister,REP,450014,0,1,3,4,
Mccurtain,Insurance Commissioner,Bill Viner,REP,450014,0,0,1,1,
Mccurtain,Insurance Commissioner,John Doak,REP,450014,0,1,3,4,
Mccurtain,Corporation Commissioner,Todd Hiett,REP,450014,0,0,2,2,
Mccurtain,Corporation Commissioner,Cliff Branan,REP,450014,0,1,2,3,
Mccurtain,U.S. Senate,Evelyn Rogers,REP,450014,0,0,0,0,
Mccurtain,U.S. Senate,Rob Moye,REP,450014,0,0,0,0,
Mccurtain,U.S. Senate,D. Jean Mcbride-Samuels,REP,450014,0,0,0,0,
Mccurtain,U.S. Senate,Jim Inhofe,REP,450014,0,1,4,5,
Mccurtain,U.S. Senate,Erick Paul Wyatt,REP,450014,0,0,0,0,
Mccurtain,U.S. Senate,Andy Craig,REP,450014,0,0,0,0,
Mccurtain,U.S. Senate,T. Shannon,REP,450014,0,0,3,3,
Mccurtain,U.S. Senate,Randy Brogdon,REP,450014,0,0,0,0,
Mccurtain,U.S. Senate,Eric Mccray,REP,450014,0,0,0,0,
Mccurtain,U.S. Senate,Kevin Crow,REP,450014,0,0,1,1,
Mccurtain,U.S. Senate,James Lankford,REP,450014,0,0,0,0,
Mccurtain,U.S. Senate,Jason Weger,REP,450014,0,1,0,1,
Mccurtain,U.S. House,Darrel Robertson,REP,450014,0,0,0,0,02
Mccurtain,U.S. House,Markwayne Mullin,REP,450014,0,1,4,5,02
Mccurtain,State Senate,Joseph Silk,REP,450014,0,1,4,5,5
Mccurtain,State Senate,Brent Shain,REP,450014,0,0,0,0,5
Mccurtain,Superintendent of Public Instruction,John Cox,DEM,450015,0,2,22,24,
Mccurtain,Superintendent of Public Instruction,Jack Jr.,DEM,450015,0,2,4,6,
Mccurtain,Superintendent of Public Instruction,Ivan Holmes,DEM,450015,0,0,2,2,
Mccurtain,Superintendent of Public Instruction,Freda Deskin,DEM,450015,0,0,7,7,
Mccurtain,U.S. Senate,Patrick Michael Hayes,DEM,450015,0,0,13,13,
Mccurtain,U.S. Senate,Jim Rogers,DEM,450015,0,4,10,14,
Mccurtain,U.S. Senate,Connie Johnson,DEM,450015,0,0,10,10,
Mccurtain,U.S. House,Earl Everett,DEM,450015,0,4,24,28,02
Mccurtain,U.S. House,Joshua Harris-Till,DEM,450015,0,0,8,8,02
Mccurtain,State House,Johnny Tadlock,DEM,450015,0,4,34,38,1
Mccurtain,State House,Kent Hendon,DEM,450015,0,0,6,6,1
Mccurtain,Governor,Dax Ewbank,REP,450015,0,0,0,0,
Mccurtain,Governor,Chad Moody,REP,450015,0,0,2,2,
Mccurtain,Governor,Mary Fallin,REP,450015,0,0,6,6,
Mccurtain,Superintendent of Public Instruction,Brian Kelly,REP,450015,0,0,1,1,
Mccurtain,Superintendent of Public Instruction,Janet Costello Barresi,REP,450015,0,0,3,3,
Mccurtain,Superintendent of Public Instruction,Joy Hofmeister,REP,450015,0,0,4,4,
Mccurtain,Insurance Commissioner,Bill Viner,REP,450015,0,0,1,1,
Mccurtain,Insurance Commissioner,John Doak,REP,450015,0,0,6,6,
Mccurtain,Corporation Commissioner,Todd Hiett,REP,450015,0,0,2,2,
Mccurtain,Corporation Commissioner,Cliff Branan,REP,450015,0,0,5,5,
Mccurtain,U.S. Senate,Evelyn Rogers,REP,450015,0,0,2,2,
Mccurtain,U.S. Senate,Rob Moye,REP,450015,0,0,0,0,
Mccurtain,U.S. Senate,D. Jean Mcbride-Samuels,REP,450015,0,0,0,0,
Mccurtain,U.S. Senate,Jim Inhofe,REP,450015,0,0,5,5,
Mccurtain,U.S. Senate,Erick Paul Wyatt,REP,450015,0,0,1,1,
Mccurtain,U.S. Senate,Andy Craig,REP,450015,0,0,2,2,
Mccurtain,U.S. Senate,T. Shannon,REP,450015,0,0,5,5,
Mccurtain,U.S. Senate,Randy Brogdon,REP,450015,0,0,0,0,
Mccurtain,U.S. Senate,Eric Mccray,REP,450015,0,0,0,0,
Mccurtain,U.S. Senate,Kevin Crow,REP,450015,0,0,0,0,
Mccurtain,U.S. Senate,James Lankford,REP,450015,0,0,0,0,
Mccurtain,U.S. Senate,Jason Weger,REP,450015,0,0,1,1,
Mccurtain,U.S. House,Darrel Robertson,REP,450015,0,0,1,1,02
Mccurtain,U.S. House,Markwayne Mullin,REP,450015,0,0,6,6,02
Mccurtain,State Senate,Joseph Silk,REP,450015,0,0,5,5,5
Mccurtain,State Senate,Brent Shain,REP,450015,0,0,2,2,5
Mccurtain,Superintendent of Public Instruction,John Cox,DEM,450017,0,1,34,35,
Mccurtain,Superintendent of Public Instruction,Jack Jr.,DEM,450017,1,1,23,25,
Mccurtain,Superintendent of Public Instruction,Ivan Holmes,DEM,450017,0,0,4,4,
Mccurtain,Superintendent of Public Instruction,Freda Deskin,DEM,450017,0,1,15,16,
Mccurtain,U.S. Senate,Patrick Michael Hayes,DEM,450017,0,1,16,17,
Mccurtain,U.S. Senate,Jim Rogers,DEM,450017,1,1,31,33,
Mccurtain,U.S. Senate,Connie Johnson,DEM,450017,0,1,24,25,
Mccurtain,U.S. House,Earl Everett,DEM,450017,1,3,45,49,02
Mccurtain,U.S. House,Joshua Harris-Till,DEM,450017,0,0,20,20,02
Mccurtain,State House,Johnny Tadlock,DEM,450017,1,2,49,52,1
Mccurtain,State House,Kent Hendon,DEM,450017,0,1,35,36,1
Mccurtain,Governor,Dax Ewbank,REP,450017,0,0,5,5,
Mccurtain,Governor,Chad Moody,REP,450017,0,0,3,3,
Mccurtain,Governor,Mary Fallin,REP,450017,0,0,15,15,
Mccurtain,Superintendent of Public Instruction,Brian Kelly,REP,450017,0,0,4,4,
Mccurtain,Superintendent of Public Instruction,Janet Costello Barresi,REP,450017,0,0,3,3,
Mccurtain,Superintendent of Public Instruction,Joy Hofmeister,REP,450017,0,0,12,12,
Mccurtain,Insurance Commissioner,Bill Viner,REP,450017,0,0,7,7,
Mccurtain,Insurance Commissioner,John Doak,REP,450017,0,0,12,12,
Mccurtain,Corporation Commissioner,Todd Hiett,REP,450017,0,0,7,7,
Mccurtain,Corporation Commissioner,Cliff Branan,REP,450017,0,0,12,12,
Mccurtain,U.S. Senate,Evelyn Rogers,REP,450017,0,0,0,0,
Mccurtain,U.S. Senate,Rob Moye,REP,450017,0,0,0,0,
Mccurtain,U.S. Senate,D. Jean Mcbride-Samuels,REP,450017,0,0,0,0,
Mccurtain,U.S. Senate,Jim Inhofe,REP,450017,0,0,22,22,
Mccurtain,U.S. Senate,Erick Paul Wyatt,REP,450017,0,0,1,1,
Mccurtain,U.S. Senate,Andy Craig,REP,450017,0,0,1,1,
Mccurtain,U.S. Senate,T. Shannon,REP,450017,0,0,3,3,
Mccurtain,U.S. Senate,Randy Brogdon,REP,450017,0,0,0,0,
Mccurtain,U.S. Senate,Eric Mccray,REP,450017,0,0,0,0,
Mccurtain,U.S. Senate,Kevin Crow,REP,450017,0,0,0,0,
Mccurtain,U.S. Senate,James Lankford,REP,450017,0,0,14,14,
Mccurtain,U.S. Senate,Jason Weger,REP,450017,0,0,2,2,
Mccurtain,U.S. House,Darrel Robertson,REP,450017,0,0,6,6,02
Mccurtain,U.S. House,Markwayne Mullin,REP,450017,0,0,17,17,02
Mccurtain,State Senate,Joseph Silk,REP,450017,0,0,18,18,5
Mccurtain,State Senate,Brent Shain,REP,450017,0,0,5,5,5
Mccurtain,Superintendent of Public Instruction,John Cox,DEM,450018,3,4,126,133,
Mccurtain,Superintendent of Public Instruction,Jack Jr.,DEM,450018,0,0,32,32,
Mccurtain,Superintendent of Public Instruction,Ivan Holmes,DEM,450018,0,0,14,14,
Mccurtain,Superintendent of Public Instruction,Freda Deskin,DEM,450018,0,2,20,22,
Mccurtain,U.S. Senate,Patrick Michael Hayes,DEM,450018,2,3,39,44,
Mccurtain,U.S. Senate,Jim Rogers,DEM,450018,1,3,83,87,
Mccurtain,U.S. Senate,Connie Johnson,DEM,450018,0,0,56,56,
Mccurtain,U.S. House,Earl Everett,DEM,450018,0,6,128,134,02
Mccurtain,U.S. House,Joshua Harris-Till,DEM,450018,3,0,47,50,02
Mccurtain,State House,Johnny Tadlock,DEM,450018,1,3,96,100,1
Mccurtain,State House,Kent Hendon,DEM,450018,3,4,122,129,1
Mccurtain,Governor,Dax Ewbank,REP,450018,0,0,4,4,
Mccurtain,Governor,Chad Moody,REP,450018,0,1,13,14,
Mccurtain,Governor,Mary Fallin,REP,450018,1,1,26,28,
Mccurtain,Superintendent of Public Instruction,Brian Kelly,REP,450018,0,0,16,16,
Mccurtain,Superintendent of Public Instruction,Janet Costello Barresi,REP,450018,0,0,5,5,
Mccurtain,Superintendent of Public Instruction,Joy Hofmeister,REP,450018,0,2,20,22,
Mccurtain,Insurance Commissioner,Bill Viner,REP,450018,0,1,11,12,
Mccurtain,Insurance Commissioner,John Doak,REP,450018,0,1,25,26,
Mccurtain,Corporation Commissioner,Todd Hiett,REP,450018,0,1,17,18,
Mccurtain,Corporation Commissioner,Cliff Branan,REP,450018,0,1,19,20,
Mccurtain,U.S. Senate,Evelyn Rogers,REP,450018,0,0,4,4,
Mccurtain,U.S. Senate,Rob Moye,REP,450018,0,0,1,1,
Mccurtain,U.S. Senate,D. Jean Mcbride-Samuels,REP,450018,0,0,0,0,
Mccurtain,U.S. Senate,Jim Inhofe,REP,450018,1,2,38,41,
Mccurtain,U.S. Senate,Erick Paul Wyatt,REP,450018,0,0,1,1,
Mccurtain,U.S. Senate,Andy Craig,REP,450018,0,0,0,0,
Mccurtain,U.S. Senate,T. Shannon,REP,450018,0,0,23,23,
Mccurtain,U.S. Senate,Randy Brogdon,REP,450018,0,0,3,3,
Mccurtain,U.S. Senate,Eric Mccray,REP,450018,0,0,1,1,
Mccurtain,U.S. Senate,Kevin Crow,REP,450018,0,0,0,0,
Mccurtain,U.S. Senate,James Lankford,REP,450018,0,1,16,17,
Mccurtain,U.S. Senate,Jason Weger,REP,450018,0,1,2,3,
Mccurtain,U.S. House,Darrel Robertson,REP,450018,0,0,7,7,02
Mccurtain,U.S. House,Markwayne Mullin,REP,450018,0,2,38,40,02
Mccurtain,State Senate,Joseph Silk,REP,450018,0,1,35,36,5
Mccurtain,State Senate,Brent Shain,REP,450018,1,1,8,10,5
Mccurtain,Superintendent of Public Instruction,John Cox,DEM,450019,1,2,82,85,
Mccurtain,Superintendent of Public Instruction,Jack Jr.,DEM,450019,1,1,21,23,
Mccurtain,Superintendent of Public Instruction,Ivan Holmes,DEM,450019,0,0,15,15,
Mccurtain,Superintendent of Public Instruction,Freda Deskin,DEM,450019,0,0,26,26,
Mccurtain,U.S. Senate,Patrick Michael Hayes,DEM,450019,2,1,33,36,
Mccurtain,U.S. Senate,Jim Rogers,DEM,450019,0,1,55,56,
Mccurtain,U.S. Senate,Connie Johnson,DEM,450019,1,1,33,35,
Mccurtain,U.S. House,Earl Everett,DEM,450019,1,3,79,83,02
Mccurtain,U.S. House,Joshua Harris-Till,DEM,450019,0,0,40,40,02
Mccurtain,State House,Johnny Tadlock,DEM,450019,1,2,66,69,1
Mccurtain,State House,Kent Hendon,DEM,450019,3,1,89,93,1
Mccurtain,Governor,Dax Ewbank,REP,450019,0,0,8,8,
Mccurtain,Governor,Chad Moody,REP,450019,0,0,10,10,
Mccurtain,Governor,Mary Fallin,REP,450019,0,1,42,43,
Mccurtain,Superintendent of Public Instruction,Brian Kelly,REP,450019,0,0,19,19,
Mccurtain,Superintendent of Public Instruction,Janet Costello Barresi,REP,450019,0,0,10,10,
Mccurtain,Superintendent of Public Instruction,Joy Hofmeister,REP,450019,0,1,27,28,
Mccurtain,Insurance Commissioner,Bill Viner,REP,450019,0,0,12,12,
Mccurtain,Insurance Commissioner,John Doak,REP,450019,0,1,40,41,
Mccurtain,Corporation Commissioner,Todd Hiett,REP,450019,0,1,25,26,
Mccurtain,Corporation Commissioner,Cliff Branan,REP,450019,0,0,28,28,
Mccurtain,U.S. Senate,Evelyn Rogers,REP,450019,0,1,5,6,
Mccurtain,U.S. Senate,Rob Moye,REP,450019,0,0,0,0,
Mccurtain,U.S. Senate,D. Jean Mcbride-Samuels,REP,450019,0,0,2,2,
Mccurtain,U.S. Senate,Jim Inhofe,REP,450019,0,0,53,53,
Mccurtain,U.S. Senate,Erick Paul Wyatt,REP,450019,0,0,1,1,
Mccurtain,U.S. Senate,Andy Craig,REP,450019,0,0,2,2,
Mccurtain,U.S. Senate,T. Shannon,REP,450019,0,0,20,20,
Mccurtain,U.S. Senate,Randy Brogdon,REP,450019,0,0,2,2,
Mccurtain,U.S. Senate,Eric Mccray,REP,450019,0,0,0,0,
Mccurtain,U.S. Senate,Kevin Crow,REP,450019,0,0,1,1,
Mccurtain,U.S. Senate,James Lankford,REP,450019,0,0,29,29,
Mccurtain,U.S. Senate,Jason Weger,REP,450019,0,0,5,5,
Mccurtain,U.S. House,Darrel Robertson,REP,450019,0,1,9,10,02
Mccurtain,U.S. House,Markwayne Mullin,REP,450019,0,0,49,49,02
Mccurtain,State Senate,Joseph Silk,REP,450019,0,1,50,51,5
Mccurtain,State Senate,Brent Shain,REP,450019,0,0,10,10,5
Mccurtain,Superintendent of Public Instruction,John Cox,DEM,450020,1,2,43,46,
Mccurtain,Superintendent of Public Instruction,Jack Jr.,DEM,450020,0,1,26,27,
Mccurtain,Superintendent of Public Instruction,Ivan Holmes,DEM,450020,0,0,10,10,
Mccurtain,Superintendent of Public Instruction,Freda Deskin,DEM,450020,0,1,20,21,
Mccurtain,U.S. Senate,Patrick Michael Hayes,DEM,450020,1,0,26,27,
Mccurtain,U.S. Senate,Jim Rogers,DEM,450020,1,2,29,32,
Mccurtain,U.S. Senate,Connie Johnson,DEM,450020,0,3,41,44,
Mccurtain,U.S. House,Earl Everett,DEM,450020,1,2,63,66,02
Mccurtain,U.S. House,Joshua Harris-Till,DEM,450020,1,2,33,36,02
Mccurtain,State House,Johnny Tadlock,DEM,450020,1,1,54,56,1
Mccurtain,State House,Kent Hendon,DEM,450020,1,4,58,63,1
Mccurtain,Governor,Dax Ewbank,REP,450020,0,0,4,4,
Mccurtain,Governor,Chad Moody,REP,450020,0,0,1,1,
Mccurtain,Governor,Mary Fallin,REP,450020,0,5,34,39,
Mccurtain,Superintendent of Public Instruction,Brian Kelly,REP,450020,0,2,6,8,
Mccurtain,Superintendent of Public Instruction,Janet Costello Barresi,REP,450020,0,1,8,9,
Mccurtain,Superintendent of Public Instruction,Joy Hofmeister,REP,450020,0,2,19,21,
Mccurtain,Insurance Commissioner,Bill Viner,REP,450020,0,0,7,7,
Mccurtain,Insurance Commissioner,John Doak,REP,450020,0,5,23,28,
Mccurtain,Corporation Commissioner,Todd Hiett,REP,450020,0,3,20,23,
Mccurtain,Corporation Commissioner,Cliff Branan,REP,450020,0,2,9,11,
Mccurtain,U.S. Senate,Evelyn Rogers,REP,450020,0,0,0,0,
Mccurtain,U.S. Senate,Rob Moye,REP,450020,0,0,0,0,
Mccurtain,U.S. Senate,D. Jean Mcbride-Samuels,REP,450020,0,0,1,1,
Mccurtain,U.S. Senate,Jim Inhofe,REP,450020,0,5,37,42,
Mccurtain,U.S. Senate,Erick Paul Wyatt,REP,450020,0,0,1,1,
Mccurtain,U.S. Senate,Andy Craig,REP,450020,0,0,0,0,
Mccurtain,U.S. Senate,T. Shannon,REP,450020,0,4,16,20,
Mccurtain,U.S. Senate,Randy Brogdon,REP,450020,0,0,4,4,
Mccurtain,U.S. Senate,Eric Mccray,REP,450020,0,0,0,0,
Mccurtain,U.S. Senate,Kevin Crow,REP,450020,0,1,1,2,
Mccurtain,U.S. Senate,James Lankford,REP,450020,0,0,16,16,
Mccurtain,U.S. Senate,Jason Weger,REP,450020,0,0,0,0,
Mccurtain,U.S. House,Darrel Robertson,REP,450020,0,1,7,8,02
Mccurtain,U.S. House,Markwayne Mullin,REP,450020,0,4,32,36,02
Mccurtain,State Senate,Joseph Silk,REP,450020,0,5,33,38,5
Mccurtain,State Senate,Brent Shain,REP,450020,0,0,7,7,5
Mccurtain,Superintendent of Public Instruction,John Cox,DEM,450022,0,1,50,51,
Mccurtain,Superintendent of Public Instruction,Jack Jr.,DEM,450022,2,1,6,9,
Mccurtain,Superintendent of Public Instruction,Ivan Holmes,DEM,450022,2,0,15,17,
Mccurtain,Superintendent of Public Instruction,Freda Deskin,DEM,450022,2,0,11,13,
Mccurtain,U.S. Senate,Patrick Michael Hayes,DEM,450022,0,2,22,24,
Mccurtain,U.S. Senate,Jim Rogers,DEM,450022,5,0,40,45,
Mccurtain,U.S. Senate,Connie Johnson,DEM,450022,0,0,19,19,
Mccurtain,U.S. House,Earl Everett,DEM,450022,3,1,46,50,02
Mccurtain,U.S. House,Joshua Harris-Till,DEM,450022,1,1,29,31,02
Mccurtain,State House,Johnny Tadlock,DEM,450022,2,1,38,41,1
Mccurtain,State House,Kent Hendon,DEM,450022,4,1,60,65,1
Mccurtain,Governor,Dax Ewbank,REP,450022,0,0,0,0,
Mccurtain,Governor,Chad Moody,REP,450022,0,0,7,7,
Mccurtain,Governor,Mary Fallin,REP,450022,2,0,26,28,
Mccurtain,Superintendent of Public Instruction,Brian Kelly,REP,450022,0,0,15,15,
Mccurtain,Superintendent of Public Instruction,Janet Costello Barresi,REP,450022,1,0,5,6,
Mccurtain,Superintendent of Public Instruction,Joy Hofmeister,REP,450022,1,0,13,14,
Mccurtain,Insurance Commissioner,Bill Viner,REP,450022,0,0,10,10,
Mccurtain,Insurance Commissioner,John Doak,REP,450022,1,0,16,17,
Mccurtain,Corporation Commissioner,Todd Hiett,REP,450022,1,0,13,14,
Mccurtain,Corporation Commissioner,Cliff Branan,REP,450022,0,0,14,14,
Mccurtain,U.S. Senate,Evelyn Rogers,REP,450022,0,0,1,1,
Mccurtain,U.S. Senate,Rob Moye,REP,450022,0,0,0,0,
Mccurtain,U.S. Senate,D. Jean Mcbride-Samuels,REP,450022,0,0,2,2,
Mccurtain,U.S. Senate,Jim Inhofe,REP,450022,2,0,30,32,
Mccurtain,U.S. Senate,Erick Paul Wyatt,REP,450022,0,0,1,1,
Mccurtain,U.S. Senate,Andy Craig,REP,450022,0,0,1,1,
Mccurtain,U.S. Senate,T. Shannon,REP,450022,1,0,14,15,
Mccurtain,U.S. Senate,Randy Brogdon,REP,450022,0,0,1,1,
Mccurtain,U.S. Senate,Eric Mccray,REP,450022,0,0,0,0,
Mccurtain,U.S. Senate,Kevin Crow,REP,450022,0,0,3,3,
Mccurtain,U.S. Senate,James Lankford,REP,450022,1,0,14,15,
Mccurtain,U.S. Senate,Jason Weger,REP,450022,0,0,1,1,
Mccurtain,U.S. House,Darrel Robertson,REP,450022,0,0,3,3,02
Mccurtain,U.S. House,Markwayne Mullin,REP,450022,2,0,31,33,02
Mccurtain,State Senate,Joseph Silk,REP,450022,2,0,30,32,5
Mccurtain,State Senate,Brent Shain,REP,450022,0,0,5,5,5
Mccurtain,Superintendent of Public Instruction,John Cox,DEM,450023,0,2,56,58,
Mccurtain,Superintendent of Public Instruction,Jack Jr.,DEM,450023,2,0,15,17,
Mccurtain,Superintendent of Public Instruction,Ivan Holmes,DEM,450023,0,0,7,7,
Mccurtain,Superintendent of Public Instruction,Freda Deskin,DEM,450023,0,0,15,15,
Mccurtain,U.S. Senate,Patrick Michael Hayes,DEM,450023,2,0,21,23,
Mccurtain,U.S. Senate,Jim Rogers,DEM,450023,0,0,45,45,
Mccurtain,U.S. Senate,Connie Johnson,DEM,450023,0,2,20,22,
Mccurtain,U.S. House,Earl Everett,DEM,450023,2,1,51,54,02
Mccurtain,U.S. House,Joshua Harris-Till,DEM,450023,0,0,31,31,02
Mccurtain,State House,Johnny Tadlock,DEM,450023,0,2,16,18,1
Mccurtain,State House,Kent Hendon,DEM,450023,2,1,96,99,1
Mccurtain,Governor,Dax Ewbank,REP,450023,0,0,0,0,
Mccurtain,Governor,Chad Moody,REP,450023,0,0,4,4,
Mccurtain,Governor,Mary Fallin,REP,450023,0,0,4,4,
Mccurtain,Superintendent of Public Instruction,Brian Kelly,REP,450023,0,0,3,3,
Mccurtain,Superintendent of Public Instruction,Janet Costello Barresi,REP,450023,0,0,1,1,
Mccurtain,Superintendent of Public Instruction,Joy Hofmeister,REP,450023,0,0,4,4,
Mccurtain,Insurance Commissioner,Bill Viner,REP,450023,0,0,4,4,
Mccurtain,Insurance Commissioner,John Doak,REP,450023,0,0,4,4,
Mccurtain,Corporation Commissioner,Todd Hiett,REP,450023,0,0,2,2,
Mccurtain,Corporation Commissioner,Cliff Branan,REP,450023,0,0,5,5,
Mccurtain,U.S. Senate,Evelyn Rogers,REP,450023,0,0,0,0,
Mccurtain,U.S. Senate,Rob Moye,REP,450023,0,0,0,0,
Mccurtain,U.S. Senate,D. Jean Mcbride-Samuels,REP,450023,0,0,0,0,
Mccurtain,U.S. Senate,Jim Inhofe,REP,450023,0,0,8,8,
Mccurtain,U.S. Senate,Erick Paul Wyatt,REP,450023,0,0,0,0,
Mccurtain,U.S. Senate,Andy Craig,REP,450023,0,0,0,0,
Mccurtain,U.S. Senate,T. Shannon,REP,450023,0,0,2,2,
Mccurtain,U.S. Senate,Randy Brogdon,REP,450023,0,0,0,0,
Mccurtain,U.S. Senate,Eric Mccray,REP,450023,0,0,0,0,
Mccurtain,U.S. Senate,Kevin Crow,REP,450023,0,0,3,3,
Mccurtain,U.S. Senate,James Lankford,REP,450023,0,0,2,2,
Mccurtain,U.S. Senate,Jason Weger,REP,450023,0,0,1,1,
Mccurtain,U.S. House,Darrel Robertson,REP,450023,0,0,3,3,02
Mccurtain,U.S. House,Markwayne Mullin,REP,450023,0,0,5,5,02
Mccurtain,State Senate,Joseph Silk,REP,450023,0,0,5,5,5
Mccurtain,State Senate,Brent Shain,REP,450023,0,0,3,3,5
Mccurtain,Superintendent of Public Instruction,John Cox,DEM,450024,0,0,33,33,
Mccurtain,Superintendent of Public Instruction,Jack Jr.,DEM,450024,5,0,8,13,
Mccurtain,Superintendent of Public Instruction,Ivan Holmes,DEM,450024,0,0,6,6,
Mccurtain,Superintendent of Public Instruction,Freda Deskin,DEM,450024,0,0,2,2,
Mccurtain,U.S. Senate,Patrick Michael Hayes,DEM,450024,0,0,8,8,
Mccurtain,U.S. Senate,Jim Rogers,DEM,450024,2,0,23,25,
Mccurtain,U.S. Senate,Connie Johnson,DEM,450024,0,0,13,13,
Mccurtain,U.S. House,Earl Everett,DEM,450024,1,0,35,36,02
Mccurtain,U.S. House,Joshua Harris-Till,DEM,450024,0,0,11,11,02
Mccurtain,State House,Johnny Tadlock,DEM,450024,4,0,37,41,1
Mccurtain,State House,Kent Hendon,DEM,450024,1,0,19,20,1
Mccurtain,Governor,Dax Ewbank,REP,450024,0,0,2,2,
Mccurtain,Governor,Chad Moody,REP,450024,0,0,0,0,
Mccurtain,Governor,Mary Fallin,REP,450024,0,0,2,2,
Mccurtain,Superintendent of Public Instruction,Brian Kelly,REP,450024,0,0,2,2,
Mccurtain,Superintendent of Public Instruction,Janet Costello Barresi,REP,450024,0,0,2,2,
Mccurtain,Superintendent of Public Instruction,Joy Hofmeister,REP,450024,0,0,0,0,
Mccurtain,Insurance Commissioner,Bill Viner,REP,450024,0,0,3,3,
Mccurtain,Insurance Commissioner,John Doak,REP,450024,0,0,1,1,
Mccurtain,Corporation Commissioner,Todd Hiett,REP,450024,0,0,2,2,
Mccurtain,Corporation Commissioner,Cliff Branan,REP,450024,0,0,2,2,
Mccurtain,U.S. Senate,Evelyn Rogers,REP,450024,0,0,0,0,
Mccurtain,U.S. Senate,Rob Moye,REP,450024,0,0,0,0,
Mccurtain,U.S. Senate,D. Jean Mcbride-Samuels,REP,450024,0,0,0,0,
Mccurtain,U.S. Senate,Jim Inhofe,REP,450024,0,0,3,3,
Mccurtain,U.S. Senate,Erick Paul Wyatt,REP,450024,0,0,1,1,
Mccurtain,U.S. Senate,Andy Craig,REP,450024,0,0,0,0,
Mccurtain,U.S. Senate,T. Shannon,REP,450024,0,0,2,2,
Mccurtain,U.S. Senate,Randy Brogdon,REP,450024,0,0,0,0,
Mccurtain,U.S. Senate,Eric Mccray,REP,450024,0,0,1,1,
Mccurtain,U.S. Senate,Kevin Crow,REP,450024,0,0,0,0,
Mccurtain,U.S. Senate,James Lankford,REP,450024,0,0,0,0,
Mccurtain,U.S. Senate,Jason Weger,REP,450024,0,0,1,1,
Mccurtain,U.S. House,Darrel Robertson,REP,450024,0,0,2,2,02
Mccurtain,U.S. House,Markwayne Mullin,REP,450024,0,0,2,2,02
Mccurtain,State Senate,Joseph Silk,REP,450024,0,0,3,3,5
Mccurtain,State Senate,Brent Shain,REP,450024,0,0,1,1,5
Mccurtain,Superintendent of Public Instruction,John Cox,DEM,450025,0,1,27,28,
Mccurtain,Superintendent of Public Instruction,Jack Jr.,DEM,450025,0,0,13,13,
Mccurtain,Superintendent of Public Instruction,Ivan Holmes,DEM,450025,0,0,6,6,
Mccurtain,Superintendent of Public Instruction,Freda Deskin,DEM,450025,0,0,12,12,
Mccurtain,U.S. Senate,Patrick Michael Hayes,DEM,450025,0,1,17,18,
Mccurtain,U.S. Senate,Jim Rogers,DEM,450025,0,0,20,20,
Mccurtain,U.S. Senate,Connie Johnson,DEM,450025,0,0,16,16,
Mccurtain,U.S. House,Earl Everett,DEM,450025,0,1,29,30,02
Mccurtain,U.S. House,Joshua Harris-Till,DEM,450025,0,0,20,20,02
Mccurtain,State House,Johnny Tadlock,DEM,450025,0,0,23,23,1
Mccurtain,State House,Kent Hendon,DEM,450025,0,1,35,36,1
Mccurtain,Governor,Dax Ewbank,REP,450025,0,0,0,0,
Mccurtain,Governor,Chad Moody,REP,450025,0,0,1,1,
Mccurtain,Governor,Mary Fallin,REP,450025,0,0,25,25,
Mccurtain,Superintendent of Public Instruction,Brian Kelly,REP,450025,0,0,7,7,
Mccurtain,Superintendent of Public Instruction,Janet Costello Barresi,REP,450025,0,0,7,7,
Mccurtain,Superintendent of Public Instruction,Joy Hofmeister,REP,450025,0,0,9,9,
Mccurtain,Insurance Commissioner,Bill Viner,REP,450025,0,0,8,8,
Mccurtain,Insurance Commissioner,John Doak,REP,450025,0,0,15,15,
Mccurtain,Corporation Commissioner,Todd Hiett,REP,450025,0,0,13,13,
Mccurtain,Corporation Commissioner,Cliff Branan,REP,450025,0,0,9,9,
Mccurtain,U.S. Senate,Evelyn Rogers,REP,450025,0,0,0,0,
Mccurtain,U.S. Senate,Rob Moye,REP,450025,0,0,1,1,
Mccurtain,U.S. Senate,D. Jean Mcbride-Samuels,REP,450025,0,0,0,0,
Mccurtain,U.S. Senate,Jim Inhofe,REP,450025,0,0,26,26,
Mccurtain,U.S. Senate,Erick Paul Wyatt,REP,450025,0,0,0,0,
Mccurtain,U.S. Senate,Andy Craig,REP,450025,0,0,1,1,
Mccurtain,U.S. Senate,T. Shannon,REP,450025,0,0,12,12,
Mccurtain,U.S. Senate,Randy Brogdon,REP,450025,0,0,2,2,
Mccurtain,U.S. Senate,Eric Mccray,REP,450025,0,0,0,0,
Mccurtain,U.S. Senate,Kevin Crow,REP,450025,0,0,0,0,
Mccurtain,U.S. Senate,James Lankford,REP,450025,0,0,10,10,
Mccurtain,U.S. Senate,Jason Weger,REP,450025,0,0,1,1,
Mccurtain,U.S. House,Darrel Robertson,REP,450025,0,0,5,5,02
Mccurtain,U.S. House,Markwayne Mullin,REP,450025,0,0,23,23,02
Mccurtain,State Senate,Joseph Silk,REP,450025,0,0,23,23,5
Mccurtain,State Senate,Brent Shain,REP,450025,0,0,4,4,5
Mccurtain,Superintendent of Public Instruction,John Cox,DEM,450026,1,0,9,10,
Mccurtain,Superintendent of Public Instruction,Jack Jr.,DEM,450026,0,0,6,6,
Mccurtain,Superintendent of Public Instruction,Ivan Holmes,DEM,450026,0,0,5,5,
Mccurtain,Superintendent of Public Instruction,Freda Deskin,DEM,450026,0,0,5,5,
Mccurtain,U.S. Senate,Patrick Michael Hayes,DEM,450026,1,0,5,6,
Mccurtain,U.S. Senate,Jim Rogers,DEM,450026,0,0,12,12,
Mccurtain,U.S. Senate,Connie Johnson,DEM,450026,0,0,5,5,
Mccurtain,U.S. House,Earl Everett,DEM,450026,1,0,17,18,02
Mccurtain,U.S. House,Joshua Harris-Till,DEM,450026,0,0,6,6,02
Mccurtain,State House,Johnny Tadlock,DEM,450026,1,0,9,10,1
Mccurtain,State House,Kent Hendon,DEM,450026,0,0,25,25,1
Mccurtain,Governor,Dax Ewbank,REP,450026,0,0,0,0,
Mccurtain,Governor,Chad Moody,REP,450026,0,0,1,1,
Mccurtain,Governor,Mary Fallin,REP,450026,1,0,14,15,
Mccurtain,Superintendent of Public Instruction,Brian Kelly,REP,450026,1,0,6,7,
Mccurtain,Superintendent of Public Instruction,Janet Costello Barresi,REP,450026,0,0,4,4,
Mccurtain,Superintendent of Public Instruction,Joy Hofmeister,REP,450026,0,0,5,5,
Mccurtain,Insurance Commissioner,Bill Viner,REP,450026,0,0,4,4,
Mccurtain,Insurance Commissioner,John Doak,REP,450026,0,0,9,9,
Mccurtain,Corporation Commissioner,Todd Hiett,REP,450026,1,0,7,8,
Mccurtain,Corporation Commissioner,Cliff Branan,REP,450026,0,0,8,8,
Mccurtain,U.S. Senate,Evelyn Rogers,REP,450026,0,0,1,1,
Mccurtain,U.S. Senate,Rob Moye,REP,450026,0,0,0,0,
Mccurtain,U.S. Senate,D. Jean Mcbride-Samuels,REP,450026,0,0,0,0,
Mccurtain,U.S. Senate,Jim Inhofe,REP,450026,0,0,13,13,
Mccurtain,U.S. Senate,Erick Paul Wyatt,REP,450026,1,0,0,1,
Mccurtain,U.S. Senate,Andy Craig,REP,450026,0,0,0,0,
Mccurtain,U.S. Senate,T. Shannon,REP,450026,0,0,9,9,
Mccurtain,U.S. Senate,Randy Brogdon,REP,450026,1,0,2,3,
Mccurtain,U.S. Senate,Eric Mccray,REP,450026,0,0,2,2,
Mccurtain,U.S. Senate,Kevin Crow,REP,450026,0,0,0,0,
Mccurtain,U.S. Senate,James Lankford,REP,450026,0,0,3,3,
Mccurtain,U.S. Senate,Jason Weger,REP,450026,0,0,0,0,
Mccurtain,U.S. House,Darrel Robertson,REP,450026,0,0,5,5,02
Mccurtain,U.S. House,Markwayne Mullin,REP,450026,1,0,10,11,02
Mccurtain,State Senate,Joseph Silk,REP,450026,1,0,16,17,5
Mccurtain,State Senate,Brent Shain,REP,450026,0,0,0,0,5
Mccurtain,Superintendent of Public Instruction,John Cox,DEM,450027,0,0,36,36,
Mccurtain,Superintendent of Public Instruction,Jack Jr.,DEM,450027,0,0,7,7,
Mccurtain,Superintendent of Public Instruction,Ivan Holmes,DEM,450027,0,0,3,3,
Mccurtain,Superintendent of Public Instruction,Freda Deskin,DEM,450027,0,0,6,6,
Mccurtain,U.S. Senate,Patrick Michael Hayes,DEM,450027,0,0,11,11,
Mccurtain,U.S. Senate,Jim Rogers,DEM,450027,0,0,32,32,
Mccurtain,U.S. Senate,Connie Johnson,DEM,450027,0,0,6,6,
Mccurtain,U.S. House,Earl Everett,DEM,450027,0,0,35,35,02
Mccurtain,U.S. House,Joshua Harris-Till,DEM,450027,0,0,12,12,02
Mccurtain,State House,Johnny Tadlock,DEM,450027,0,0,29,29,1
Mccurtain,State House,Kent Hendon,DEM,450027,0,0,25,25,1
Mccurtain,Governor,Dax Ewbank,REP,450027,0,0,1,1,
Mccurtain,Governor,Chad Moody,REP,450027,0,0,2,2,
Mccurtain,Governor,Mary Fallin,REP,450027,0,0,3,3,
Mccurtain,Superintendent of Public Instruction,Brian Kelly,REP,450027,0,0,3,3,
Mccurtain,Superintendent of Public Instruction,Janet Costello Barresi,REP,450027,0,0,0,0,
Mccurtain,Superintendent of Public Instruction,Joy Hofmeister,REP,450027,0,0,3,3,
Mccurtain,Insurance Commissioner,Bill Viner,REP,450027,0,0,1,1,
Mccurtain,Insurance Commissioner,John Doak,REP,450027,0,0,5,5,
Mccurtain,Corporation Commissioner,Todd Hiett,REP,450027,0,0,4,4,
Mccurtain,Corporation Commissioner,Cliff Branan,REP,450027,0,0,2,2,
Mccurtain,U.S. Senate,Evelyn Rogers,REP,450027,0,0,0,0,
Mccurtain,U.S. Senate,Rob Moye,REP,450027,0,0,0,0,
Mccurtain,U.S. Senate,D. Jean Mcbride-Samuels,REP,450027,0,0,0,0,
Mccurtain,U.S. Senate,Jim Inhofe,REP,450027,0,0,5,5,
Mccurtain,U.S. Senate,Erick Paul Wyatt,REP,450027,0,0,1,1,
Mccurtain,U.S. Senate,Andy Craig,REP,450027,0,0,0,0,
Mccurtain,U.S. Senate,T. Shannon,REP,450027,0,0,2,2,
Mccurtain,U.S. Senate,Randy Brogdon,REP,450027,0,0,0,0,
Mccurtain,U.S. Senate,Eric Mccray,REP,450027,0,0,0,0,
Mccurtain,U.S. Senate,Kevin Crow,REP,450027,0,0,0,0,
Mccurtain,U.S. Senate,James Lankford,REP,450027,0,0,2,2,
Mccurtain,U.S. Senate,Jason Weger,REP,450027,0,0,1,1,
Mccurtain,U.S. House,Darrel Robertson,REP,450027,0,0,1,1,02
Mccurtain,U.S. House,Markwayne Mullin,REP,450027,0,0,5,5,02
Mccurtain,State Senate,Joseph Silk,REP,450027,0,0,5,5,5
Mccurtain,State Senate,Brent Shain,REP,450027,0,0,1,1,5
Mccurtain,Superintendent of Public Instruction,John Cox,DEM,450028,0,0,10,10,
Mccurtain,Superintendent of Public Instruction,Jack Jr.,DEM,450028,0,0,4,4,
Mccurtain,Superintendent of Public Instruction,Ivan Holmes,DEM,450028,0,0,11,11,
Mccurtain,Superintendent of Public Instruction,Freda Deskin,DEM,450028,0,0,3,3,
Mccurtain,U.S. Senate,Patrick Michael Hayes,DEM,450028,0,0,7,7,
Mccurtain,U.S. Senate,Jim Rogers,DEM,450028,0,0,16,16,
Mccurtain,U.S. Senate,Connie Johnson,DEM,450028,0,0,3,3,
Mccurtain,U.S. House,Earl Everett,DEM,450028,0,0,17,17,02
Mccurtain,U.S. House,Joshua Harris-Till,DEM,450028,0,0,7,7,02
Mccurtain,State House,Johnny Tadlock,DEM,450028,0,0,23,23,1
Mccurtain,State House,Kent Hendon,DEM,450028,0,0,9,9,1
Mccurtain,Governor,Dax Ewbank,REP,450028,0,0,1,1,
Mccurtain,Governor,Chad Moody,REP,450028,0,0,3,3,
Mccurtain,Governor,Mary Fallin,REP,450028,0,0,7,7,
Mccurtain,Superintendent of Public Instruction,Brian Kelly,REP,450028,0,0,2,2,
Mccurtain,Superintendent of Public Instruction,Janet Costello Barresi,REP,450028,0,0,0,0,
Mccurtain,Superintendent of Public Instruction,Joy Hofmeister,REP,450028,0,0,9,9,
Mccurtain,Insurance Commissioner,Bill Viner,REP,450028,0,0,3,3,
Mccurtain,Insurance Commissioner,John Doak,REP,450028,0,0,6,6,
Mccurtain,Corporation Commissioner,Todd Hiett,REP,450028,0,0,5,5,
Mccurtain,Corporation Commissioner,Cliff Branan,REP,450028,0,0,4,4,
Mccurtain,U.S. Senate,Evelyn Rogers,REP,450028,0,0,0,0,
Mccurtain,U.S. Senate,Rob Moye,REP,450028,0,0,1,1,
Mccurtain,U.S. Senate,D. Jean Mcbride-Samuels,REP,450028,0,0,0,0,
Mccurtain,U.S. Senate,Jim Inhofe,REP,450028,0,0,10,10,
Mccurtain,U.S. Senate,Erick Paul Wyatt,REP,450028,0,0,0,0,
Mccurtain,U.S. Senate,Andy Craig,REP,450028,0,0,0,0,
Mccurtain,U.S. Senate,T. Shannon,REP,450028,0,0,3,3,
Mccurtain,U.S. Senate,Randy Brogdon,REP,450028,0,0,0,0,
Mccurtain,U.S. Senate,Eric Mccray,REP,450028,0,0,0,0,
Mccurtain,U.S. Senate,Kevin Crow,REP,450028,0,0,0,0,
Mccurtain,U.S. Senate,James Lankford,REP,450028,0,0,7,7,
Mccurtain,U.S. Senate,Jason Weger,REP,450028,0,0,1,1,
Mccurtain,U.S. House,Darrel Robertson,REP,450028,0,0,2,2,02
Mccurtain,U.S. House,Markwayne Mullin,REP,450028,0,0,9,9,02
Mccurtain,State Senate,Joseph Silk,REP,450028,0,0,7,7,5
Mccurtain,State Senate,Brent Shain,REP,450028,0,0,3,3,5
Mccurtain,Superintendent of Public Instruction,John Cox,DEM,450029,1,1,56,58,
Mccurtain,Superintendent of Public Instruction,Jack Jr.,DEM,450029,0,1,22,23,
Mccurtain,Superintendent of Public Instruction,Ivan Holmes,DEM,450029,0,0,15,15,
Mccurtain,Superintendent of Public Instruction,Freda Deskin,DEM,450029,1,0,8,9,
Mccurtain,U.S. Senate,Patrick Michael Hayes,DEM,450029,0,1,24,25,
Mccurtain,U.S. Senate,Jim Rogers,DEM,450029,1,1,49,51,
Mccurtain,U.S. Senate,Connie Johnson,DEM,450029,1,0,21,22,
Mccurtain,U.S. House,Earl Everett,DEM,450029,2,2,66,70,02
Mccurtain,U.S. House,Joshua Harris-Till,DEM,450029,0,0,21,21,02
Mccurtain,State House,Johnny Tadlock,DEM,450029,1,1,56,58,1
Mccurtain,State House,Kent Hendon,DEM,450029,1,2,60,63,1
Mccurtain,Governor,Dax Ewbank,REP,450029,0,0,3,3,
Mccurtain,Governor,Chad Moody,REP,450029,0,0,3,3,
Mccurtain,Governor,Mary Fallin,REP,450029,0,0,16,16,
Mccurtain,Superintendent of Public Instruction,Brian Kelly,REP,450029,0,0,11,11,
Mccurtain,Superintendent of Public Instruction,Janet Costello Barresi,REP,450029,0,0,2,2,
Mccurtain,Superintendent of Public Instruction,Joy Hofmeister,REP,450029,0,0,4,4,
Mccurtain,Insurance Commissioner,Bill Viner,REP,450029,0,0,8,8,
Mccurtain,Insurance Commissioner,John Doak,REP,450029,0,0,8,8,
Mccurtain,Corporation Commissioner,Todd Hiett,REP,450029,0,0,6,6,
Mccurtain,Corporation Commissioner,Cliff Branan,REP,450029,0,0,9,9,
Mccurtain,U.S. Senate,Evelyn Rogers,REP,450029,0,0,2,2,
Mccurtain,U.S. Senate,Rob Moye,REP,450029,0,0,5,5,
Mccurtain,U.S. Senate,D. Jean Mcbride-Samuels,REP,450029,0,0,0,0,
Mccurtain,U.S. Senate,Jim Inhofe,REP,450029,1,0,12,13,
Mccurtain,U.S. Senate,Erick Paul Wyatt,REP,450029,0,0,1,1,
Mccurtain,U.S. Senate,Andy Craig,REP,450029,0,0,2,2,
Mccurtain,U.S. Senate,T. Shannon,REP,450029,1,0,8,9,
Mccurtain,U.S. Senate,Randy Brogdon,REP,450029,0,0,2,2,
Mccurtain,U.S. Senate,Eric Mccray,REP,450029,0,0,0,0,
Mccurtain,U.S. Senate,Kevin Crow,REP,450029,0,0,2,2,
Mccurtain,U.S. Senate,James Lankford,REP,450029,0,0,7,7,
Mccurtain,U.S. Senate,Jason Weger,REP,450029,0,0,0,0,
Mccurtain,U.S. House,Darrel Robertson,REP,450029,0,0,7,7,02
Mccurtain,U.S. House,Markwayne Mullin,REP,450029,1,0,14,15,02
Mccurtain,State Senate,Joseph Silk,REP,450029,1,0,8,9,5
Mccurtain,State Senate,Brent Shain,REP,450029,0,0,10,10,5
Mccurtain,Superintendent of Public Instruction,John Cox,DEM,450031,1,4,109,114,
Mccurtain,Superintendent of Public Instruction,Jack Jr.,DEM,450031,0,0,41,41,
Mccurtain,Superintendent of Public Instruction,Ivan Holmes,DEM,450031,1,0,20,21,
Mccurtain,Superintendent of Public Instruction,Freda Deskin,DEM,450031,0,2,23,25,
Mccurtain,U.S. Senate,Patrick Michael Hayes,DEM,450031,1,2,42,45,
Mccurtain,U.S. Senate,Jim Rogers,DEM,450031,0,2,86,88,
Mccurtain,U.S. Senate,Connie Johnson,DEM,450031,1,2,48,51,
Mccurtain,U.S. House,Earl Everett,DEM,450031,2,3,125,130,02
Mccurtain,U.S. House,Joshua Harris-Till,DEM,450031,0,3,43,46,02
Mccurtain,State House,Johnny Tadlock,DEM,450031,1,5,89,95,1
Mccurtain,State House,Kent Hendon,DEM,450031,2,3,131,136,1
Mccurtain,Governor,Dax Ewbank,REP,450031,0,0,1,1,
Mccurtain,Governor,Chad Moody,REP,450031,0,1,8,9,
Mccurtain,Governor,Mary Fallin,REP,450031,0,1,19,20,
Mccurtain,Superintendent of Public Instruction,Brian Kelly,REP,450031,0,1,9,10,
Mccurtain,Superintendent of Public Instruction,Janet Costello Barresi,REP,450031,0,0,2,2,
Mccurtain,Superintendent of Public Instruction,Joy Hofmeister,REP,450031,0,1,15,16,
Mccurtain,Insurance Commissioner,Bill Viner,REP,450031,0,1,4,5,
Mccurtain,Insurance Commissioner,John Doak,REP,450031,0,1,20,21,
Mccurtain,Corporation Commissioner,Todd Hiett,REP,450031,0,2,11,13,
Mccurtain,Corporation Commissioner,Cliff Branan,REP,450031,0,0,12,12,
Mccurtain,U.S. Senate,Evelyn Rogers,REP,450031,0,0,0,0,
Mccurtain,U.S. Senate,Rob Moye,REP,450031,0,0,0,0,
Mccurtain,U.S. Senate,D. Jean Mcbride-Samuels,REP,450031,0,0,0,0,
Mccurtain,U.S. Senate,Jim Inhofe,REP,450031,0,2,23,25,
Mccurtain,U.S. Senate,Erick Paul Wyatt,REP,450031,0,0,5,5,
Mccurtain,U.S. Senate,Andy Craig,REP,450031,0,0,1,1,
Mccurtain,U.S. Senate,T. Shannon,REP,450031,0,1,10,11,
Mccurtain,U.S. Senate,Randy Brogdon,REP,450031,0,0,0,0,
Mccurtain,U.S. Senate,Eric Mccray,REP,450031,0,0,0,0,
Mccurtain,U.S. Senate,Kevin Crow,REP,450031,0,0,1,1,
Mccurtain,U.S. Senate,James Lankford,REP,450031,0,1,12,13,
Mccurtain,U.S. Senate,Jason Weger,REP,450031,0,0,3,3,
Mccurtain,U.S. House,Darrel Robertson,REP,450031,0,0,4,4,02
Mccurtain,U.S. House,Markwayne Mullin,REP,450031,0,2,23,25,02
Mccurtain,State Senate,Joseph Silk,REP,450031,0,2,21,23,5
Mccurtain,State Senate,Brent Shain,REP,450031,0,0,5,5,5
Mccurtain,Superintendent of Public Instruction,John Cox,DEM,450033,1,3,81,85,
Mccurtain,Superintendent of Public Instruction,Jack Jr.,DEM,450033,0,0,20,20,
Mccurtain,Superintendent of Public Instruction,Ivan Holmes,DEM,450033,0,0,5,5,
Mccurtain,Superintendent of Public Instruction,Freda Deskin,DEM,450033,0,2,18,20,
Mccurtain,U.S. Senate,Patrick Michael Hayes,DEM,450033,1,0,39,40,
Mccurtain,U.S. Senate,Jim Rogers,DEM,450033,0,1,53,54,
Mccurtain,U.S. Senate,Connie Johnson,DEM,450033,0,3,24,27,
Mccurtain,U.S. House,Earl Everett,DEM,450033,1,1,76,78,02
Mccurtain,U.S. House,Joshua Harris-Till,DEM,450033,0,3,35,38,02
Mccurtain,State House,Johnny Tadlock,DEM,450033,1,6,88,95,1
Mccurtain,State House,Kent Hendon,DEM,450033,0,1,54,55,1
Mccurtain,Governor,Dax Ewbank,REP,450033,0,0,2,2,
Mccurtain,Governor,Chad Moody,REP,450033,0,1,6,7,
Mccurtain,Governor,Mary Fallin,REP,450033,0,2,12,14,
Mccurtain,Superintendent of Public Instruction,Brian Kelly,REP,450033,0,1,6,7,
Mccurtain,Superintendent of Public Instruction,Janet Costello Barresi,REP,450033,0,0,0,0,
Mccurtain,Superintendent of Public Instruction,Joy Hofmeister,REP,450033,0,2,13,15,
Mccurtain,Insurance Commissioner,Bill Viner,REP,450033,0,2,4,6,
Mccurtain,Insurance Commissioner,John Doak,REP,450033,0,1,11,12,
Mccurtain,Corporation Commissioner,Todd Hiett,REP,450033,0,2,8,10,
Mccurtain,Corporation Commissioner,Cliff Branan,REP,450033,0,1,7,8,
Mccurtain,U.S. Senate,Evelyn Rogers,REP,450033,0,0,2,2,
Mccurtain,U.S. Senate,Rob Moye,REP,450033,0,0,1,1,
Mccurtain,U.S. Senate,D. Jean Mcbride-Samuels,REP,450033,0,0,0,0,
Mccurtain,U.S. Senate,Jim Inhofe,REP,450033,0,3,16,19,
Mccurtain,U.S. Senate,Erick Paul Wyatt,REP,450033,0,0,1,1,
Mccurtain,U.S. Senate,Andy Craig,REP,450033,0,1,0,1,
Mccurtain,U.S. Senate,T. Shannon,REP,450033,0,0,4,4,
Mccurtain,U.S. Senate,Randy Brogdon,REP,450033,0,0,1,1,
Mccurtain,U.S. Senate,Eric Mccray,REP,450033,0,0,2,2,
Mccurtain,U.S. Senate,Kevin Crow,REP,450033,0,0,2,2,
Mccurtain,U.S. Senate,James Lankford,REP,450033,0,2,9,11,
Mccurtain,U.S. Senate,Jason Weger,REP,450033,0,0,2,2,
Mccurtain,U.S. House,Darrel Robertson,REP,450033,0,0,2,2,02
Mccurtain,U.S. House,Markwayne Mullin,REP,450033,0,3,13,16,02
Mccurtain,State Senate,Joseph Silk,REP,450033,0,3,12,15,5
Mccurtain,State Senate,Brent Shain,REP,450033,0,0,7,7,5
Mccurtain,Superintendent of Public Instruction,John Cox,DEM,450034,0,7,51,58,
Mccurtain,Superintendent of Public Instruction,Jack Jr.,DEM,450034,0,2,35,37,
Mccurtain,Superintendent of Public Instruction,Ivan Holmes,DEM,450034,0,0,18,18,
Mccurtain,Superintendent of Public Instruction,Freda Deskin,DEM,450034,0,1,23,24,
Mccurtain,U.S. Senate,Patrick Michael Hayes,DEM,450034,0,3,28,31,
Mccurtain,U.S. Senate,Jim Rogers,DEM,450034,0,1,57,58,
Mccurtain,U.S. Senate,Connie Johnson,DEM,450034,0,3,36,39,
Mccurtain,U.S. House,Earl Everett,DEM,450034,0,5,82,87,02
Mccurtain,U.S. House,Joshua Harris-Till,DEM,450034,0,1,33,34,02
Mccurtain,State House,Johnny Tadlock,DEM,450034,0,7,89,96,1
Mccurtain,State House,Kent Hendon,DEM,450034,0,3,44,47,1
Mccurtain,Governor,Dax Ewbank,REP,450034,0,0,1,1,
Mccurtain,Governor,Chad Moody,REP,450034,0,0,3,3,
Mccurtain,Governor,Mary Fallin,REP,450034,0,0,9,9,
Mccurtain,Superintendent of Public Instruction,Brian Kelly,REP,450034,0,0,6,6,
Mccurtain,Superintendent of Public Instruction,Janet Costello Barresi,REP,450034,0,0,3,3,
Mccurtain,Superintendent of Public Instruction,Joy Hofmeister,REP,450034,0,0,4,4,
Mccurtain,Insurance Commissioner,Bill Viner,REP,450034,0,0,1,1,
Mccurtain,Insurance Commissioner,John Doak,REP,450034,0,0,12,12,
Mccurtain,Corporation Commissioner,Todd Hiett,REP,450034,0,0,2,2,
Mccurtain,Corporation Commissioner,Cliff Branan,REP,450034,0,0,7,7,
Mccurtain,U.S. Senate,Evelyn Rogers,REP,450034,0,0,0,0,
Mccurtain,U.S. Senate,Rob Moye,REP,450034,0,0,1,1,
Mccurtain,U.S. Senate,D. Jean Mcbride-Samuels,REP,450034,0,0,0,0,
Mccurtain,U.S. Senate,Jim Inhofe,REP,450034,0,0,12,12,
Mccurtain,U.S. Senate,Erick Paul Wyatt,REP,450034,0,0,0,0,
Mccurtain,U.S. Senate,Andy Craig,REP,450034,0,0,0,0,
Mccurtain,U.S. Senate,T. Shannon,REP,450034,0,0,3,3,
Mccurtain,U.S. Senate,Randy Brogdon,REP,450034,0,0,1,1,
Mccurtain,U.S. Senate,Eric Mccray,REP,450034,0,0,1,1,
Mccurtain,U.S. Senate,Kevin Crow,REP,450034,0,0,2,2,
Mccurtain,U.S. Senate,James Lankford,REP,450034,0,0,6,6,
Mccurtain,U.S. Senate,Jason Weger,REP,450034,0,0,0,0,
Mccurtain,U.S. House,Darrel Robertson,REP,450034,0,0,4,4,02
Mccurtain,U.S. House,Markwayne Mullin,REP,450034,0,0,8,8,02
Mccurtain,State Senate,Joseph Silk,REP,450034,0,0,10,10,5
Mccurtain,State Senate,Brent Shain,REP,450034,0,0,3,3,5
Mccurtain,Superintendent of Public Instruction,John Cox,DEM,450035,2,5,98,105,
Mccurtain,Superintendent of Public Instruction,Jack Jr.,DEM,450035,1,1,39,41,
Mccurtain,Superintendent of Public Instruction,Ivan Holmes,DEM,450035,0,0,11,11,
Mccurtain,Superintendent of Public Instruction,Freda Deskin,DEM,450035,0,1,22,23,
Mccurtain,U.S. Senate,Patrick Michael Hayes,DEM,450035,2,4,37,43,
Mccurtain,U.S. Senate,Jim Rogers,DEM,450035,1,2,78,81,
Mccurtain,U.S. Senate,Connie Johnson,DEM,450035,0,1,38,39,
Mccurtain,U.S. House,Earl Everett,DEM,450035,3,4,106,113,02
Mccurtain,U.S. House,Joshua Harris-Till,DEM,450035,0,2,42,44,02
Mccurtain,State House,Johnny Tadlock,DEM,450035,3,7,107,117,1
Mccurtain,State House,Kent Hendon,DEM,450035,0,1,77,78,1
Mccurtain,Governor,Dax Ewbank,REP,450035,0,0,2,2,
Mccurtain,Governor,Chad Moody,REP,450035,1,0,9,10,
Mccurtain,Governor,Mary Fallin,REP,450035,0,0,22,22,
Mccurtain,Superintendent of Public Instruction,Brian Kelly,REP,450035,0,0,11,11,
Mccurtain,Superintendent of Public Instruction,Janet Costello Barresi,REP,450035,1,0,5,6,
Mccurtain,Superintendent of Public Instruction,Joy Hofmeister,REP,450035,0,0,18,18,
Mccurtain,Insurance Commissioner,Bill Viner,REP,450035,0,0,10,10,
Mccurtain,Insurance Commissioner,John Doak,REP,450035,1,0,21,22,
Mccurtain,Corporation Commissioner,Todd Hiett,REP,450035,0,0,20,20,
Mccurtain,Corporation Commissioner,Cliff Branan,REP,450035,1,0,10,11,
Mccurtain,U.S. Senate,Evelyn Rogers,REP,450035,0,0,2,2,
Mccurtain,U.S. Senate,Rob Moye,REP,450035,0,0,2,2,
Mccurtain,U.S. Senate,D. Jean Mcbride-Samuels,REP,450035,0,0,1,1,
Mccurtain,U.S. Senate,Jim Inhofe,REP,450035,1,0,26,27,
Mccurtain,U.S. Senate,Erick Paul Wyatt,REP,450035,0,0,1,1,
Mccurtain,U.S. Senate,Andy Craig,REP,450035,0,0,2,2,
Mccurtain,U.S. Senate,T. Shannon,REP,450035,0,0,16,16,
Mccurtain,U.S. Senate,Randy Brogdon,REP,450035,0,0,3,3,
Mccurtain,U.S. Senate,Eric Mccray,REP,450035,0,0,1,1,
Mccurtain,U.S. Senate,Kevin Crow,REP,450035,1,0,1,2,
Mccurtain,U.S. Senate,James Lankford,REP,450035,0,0,8,8,
Mccurtain,U.S. Senate,Jason Weger,REP,450035,0,0,1,1,
Mccurtain,U.S. House,Darrel Robertson,REP,450035,1,0,11,12,02
Mccurtain,U.S. House,Markwayne Mullin,REP,450035,0,0,21,21,02
Mccurtain,State Senate,Joseph Silk,REP,450035,0,0,22,22,5
Mccurtain,State Senate,Brent Shain,REP,450035,1,0,9,10,5
Mccurtain,Superintendent of Public Instruction,John Cox,DEM,450036,1,0,73,74,
Mccurtain,Superintendent of Public Instruction,Jack Jr.,DEM,450036,0,2,21,23,
Mccurtain,Superintendent of Public Instruction,Ivan Holmes,DEM,450036,0,0,4,4,
Mccurtain,Superintendent of Public Instruction,Freda Deskin,DEM,450036,0,0,25,25,
Mccurtain,U.S. Senate,Patrick Michael Hayes,DEM,450036,1,0,26,27,
Mccurtain,U.S. Senate,Jim Rogers,DEM,450036,0,2,48,50,
Mccurtain,U.S. Senate,Connie Johnson,DEM,450036,0,0,39,39,
Mccurtain,U.S. House,Earl Everett,DEM,450036,1,1,64,66,02
Mccurtain,U.S. House,Joshua Harris-Till,DEM,450036,0,1,39,40,02
Mccurtain,State House,Johnny Tadlock,DEM,450036,1,1,85,87,1
Mccurtain,State House,Kent Hendon,DEM,450036,0,1,45,46,1
Mccurtain,Governor,Dax Ewbank,REP,450036,0,0,3,3,
Mccurtain,Governor,Chad Moody,REP,450036,0,0,12,12,
Mccurtain,Governor,Mary Fallin,REP,450036,0,2,11,13,
Mccurtain,Superintendent of Public Instruction,Brian Kelly,REP,450036,0,1,10,11,
Mccurtain,Superintendent of Public Instruction,Janet Costello Barresi,REP,450036,0,0,3,3,
Mccurtain,Superintendent of Public Instruction,Joy Hofmeister,REP,450036,0,1,14,15,
Mccurtain,Insurance Commissioner,Bill Viner,REP,450036,0,1,8,9,
Mccurtain,Insurance Commissioner,John Doak,REP,450036,0,1,15,16,
Mccurtain,Corporation Commissioner,Todd Hiett,REP,450036,0,1,13,14,
Mccurtain,Corporation Commissioner,Cliff Branan,REP,450036,0,1,10,11,
Mccurtain,U.S. Senate,Evelyn Rogers,REP,450036,0,1,1,2,
Mccurtain,U.S. Senate,Rob Moye,REP,450036,0,1,3,4,
Mccurtain,U.S. Senate,D. Jean Mcbride-Samuels,REP,450036,0,0,0,0,
Mccurtain,U.S. Senate,Jim Inhofe,REP,450036,0,0,21,21,
Mccurtain,U.S. Senate,Erick Paul Wyatt,REP,450036,0,0,2,2,
Mccurtain,U.S. Senate,Andy Craig,REP,450036,0,0,1,1,
Mccurtain,U.S. Senate,T. Shannon,REP,450036,0,0,10,10,
Mccurtain,U.S. Senate,Randy Brogdon,REP,450036,0,0,1,1,
Mccurtain,U.S. Senate,Eric Mccray,REP,450036,0,0,1,1,
Mccurtain,U.S. Senate,Kevin Crow,REP,450036,0,0,0,0,
Mccurtain,U.S. Senate,James Lankford,REP,450036,0,0,13,13,
Mccurtain,U.S. Senate,Jason Weger,REP,450036,0,2,1,3,
Mccurtain,U.S. House,Darrel Robertson,REP,450036,0,2,8,10,02
Mccurtain,U.S. House,Markwayne Mullin,REP,450036,0,0,17,17,02
Mccurtain,State Senate,Joseph Silk,REP,450036,0,1,14,15,5
Mccurtain,State Senate,Brent Shain,REP,450036,0,1,11,12,5
Mccurtain,Superintendent of Public Instruction,John Cox,DEM,450037,0,0,13,13,
Mccurtain,Superintendent of Public Instruction,Jack Jr.,DEM,450037,1,0,13,14,
Mccurtain,Superintendent of Public Instruction,Ivan Holmes,DEM,450037,0,0,6,6,
Mccurtain,Superintendent of Public Instruction,Freda Deskin,DEM,450037,0,0,9,9,
Mccurtain,U.S. Senate,Patrick Michael Hayes,DEM,450037,1,0,8,9,
Mccurtain,U.S. Senate,Jim Rogers,DEM,450037,0,0,21,21,
Mccurtain,U.S. Senate,Connie Johnson,DEM,450037,0,0,12,12,
Mccurtain,U.S. House,Earl Everett,DEM,450037,0,0,22,22,02
Mccurtain,U.S. House,Joshua Harris-Till,DEM,450037,1,0,18,19,02
Mccurtain,State House,Johnny Tadlock,DEM,450037,1,0,20,21,1
Mccurtain,State House,Kent Hendon,DEM,450037,1,2,30,33,1
Mccurtain,Governor,Dax Ewbank,REP,450037,0,0,0,0,
Mccurtain,Governor,Chad Moody,REP,450037,0,0,4,4,
Mccurtain,Governor,Mary Fallin,REP,450037,1,0,4,5,
Mccurtain,Superintendent of Public Instruction,Brian Kelly,REP,450037,0,0,4,4,
Mccurtain,Superintendent of Public Instruction,Janet Costello Barresi,REP,450037,0,0,1,1,
Mccurtain,Superintendent of Public Instruction,Joy Hofmeister,REP,450037,0,0,1,1,
Mccurtain,Insurance Commissioner,Bill Viner,REP,450037,0,0,4,4,
Mccurtain,Insurance Commissioner,John Doak,REP,450037,0,0,2,2,
Mccurtain,Corporation Commissioner,Todd Hiett,REP,450037,0,0,0,0,
Mccurtain,Corporation Commissioner,Cliff Branan,REP,450037,0,0,6,6,
Mccurtain,U.S. Senate,Evelyn Rogers,REP,450037,0,0,0,0,
Mccurtain,U.S. Senate,Rob Moye,REP,450037,0,0,0,0,
Mccurtain,U.S. Senate,D. Jean Mcbride-Samuels,REP,450037,0,0,0,0,
Mccurtain,U.S. Senate,Jim Inhofe,REP,450037,1,0,4,5,
Mccurtain,U.S. Senate,Erick Paul Wyatt,REP,450037,0,0,2,2,
Mccurtain,U.S. Senate,Andy Craig,REP,450037,0,0,0,0,
Mccurtain,U.S. Senate,T. Shannon,REP,450037,0,0,1,1,
Mccurtain,U.S. Senate,Randy Brogdon,REP,450037,0,0,0,0,
Mccurtain,U.S. Senate,Eric Mccray,REP,450037,0,0,0,0,
Mccurtain,U.S. Senate,Kevin Crow,REP,450037,0,0,2,2,
Mccurtain,U.S. Senate,James Lankford,REP,450037,1,0,5,6,
Mccurtain,U.S. Senate,Jason Weger,REP,450037,0,0,0,0,
Mccurtain,U.S. House,Darrel Robertson,REP,450037,0,0,3,3,02
Mccurtain,U.S. House,Markwayne Mullin,REP,450037,1,0,5,6,02
Mccurtain,State Senate,Joseph Silk,REP,450037,0,0,5,5,5
Mccurtain,State Senate,Brent Shain,REP,450037,0,0,1,1,5
Mccurtain,Superintendent of Public Instruction,John Cox,DEM,450038,2,4,125,131,
Mccurtain,Superintendent of Public Instruction,Jack Jr.,DEM,450038,0,3,34,37,
Mccurtain,Superintendent of Public Instruction,Ivan Holmes,DEM,450038,0,0,9,9,
Mccurtain,Superintendent of Public Instruction,Freda Deskin,DEM,450038,0,0,45,45,
Mccurtain,U.S. Senate,Patrick Michael Hayes,DEM,450038,1,3,52,56,
Mccurtain,U.S. Senate,Jim Rogers,DEM,450038,1,3,102,106,
Mccurtain,U.S. Senate,Connie Johnson,DEM,450038,1,0,46,47,
Mccurtain,U.S. House,Earl Everett,DEM,450038,1,3,138,142,02
Mccurtain,U.S. House,Joshua Harris-Till,DEM,450038,2,2,49,53,02
Mccurtain,State House,Johnny Tadlock,DEM,450038,3,7,127,137,1
Mccurtain,State House,Kent Hendon,DEM,450038,0,2,109,111,1
Mccurtain,Governor,Dax Ewbank,REP,450038,0,0,4,4,
Mccurtain,Governor,Chad Moody,REP,450038,0,0,6,6,
Mccurtain,Governor,Mary Fallin,REP,450038,0,1,11,12,
Mccurtain,Superintendent of Public Instruction,Brian Kelly,REP,450038,0,0,7,7,
Mccurtain,Superintendent of Public Instruction,Janet Costello Barresi,REP,450038,0,0,5,5,
Mccurtain,Superintendent of Public Instruction,Joy Hofmeister,REP,450038,0,1,9,10,
Mccurtain,Insurance Commissioner,Bill Viner,REP,450038,0,0,11,11,
Mccurtain,Insurance Commissioner,John Doak,REP,450038,0,1,9,10,
Mccurtain,Corporation Commissioner,Todd Hiett,REP,450038,0,1,8,9,
Mccurtain,Corporation Commissioner,Cliff Branan,REP,450038,0,0,13,13,
Mccurtain,U.S. Senate,Evelyn Rogers,REP,450038,0,0,0,0,
Mccurtain,U.S. Senate,Rob Moye,REP,450038,0,0,0,0,
Mccurtain,U.S. Senate,D. Jean Mcbride-Samuels,REP,450038,0,0,2,2,
Mccurtain,U.S. Senate,Jim Inhofe,REP,450038,0,1,18,19,
Mccurtain,U.S. Senate,Erick Paul Wyatt,REP,450038,0,0,1,1,
Mccurtain,U.S. Senate,Andy Craig,REP,450038,0,0,2,2,
Mccurtain,U.S. Senate,T. Shannon,REP,450038,0,1,4,5,
Mccurtain,U.S. Senate,Randy Brogdon,REP,450038,0,0,1,1,
Mccurtain,U.S. Senate,Eric Mccray,REP,450038,0,0,0,0,
Mccurtain,U.S. Senate,Kevin Crow,REP,450038,0,0,0,0,
Mccurtain,U.S. Senate,James Lankford,REP,450038,0,0,11,11,
Mccurtain,U.S. Senate,Jason Weger,REP,450038,0,0,2,2,
Mccurtain,U.S. House,Darrel Robertson,REP,450038,0,0,10,10,02
Mccurtain,U.S. House,Markwayne Mullin,REP,450038,0,1,11,12,02
Mccurtain,State Senate,Joseph Silk,REP,450038,0,1,13,14,5
Mccurtain,State Senate,Brent Shain,REP,450038,0,0,8,8,5
Mcintosh,Superintendent of Public Instruction,John Cox,DEM,460102,3,1,174,178,
Mcintosh,Superintendent of Public Instruction,Jack Jr.,DEM,460102,0,0,32,32,
Mcintosh,Superintendent of Public Instruction,Ivan Holmes,DEM,460102,2,0,25,27,
Mcintosh,Superintendent of Public Instruction,Freda Deskin,DEM,460102,2,0,94,96,
Mcintosh,U.S. Senate,Patrick Michael Hayes,DEM,460102,0,0,79,79,
Mcintosh,U.S. Senate,Jim Rogers,DEM,460102,1,1,139,141,
Mcintosh,U.S. Senate,Connie Johnson,DEM,460102,6,0,89,95,
Mcintosh,U.S. House,Earl Everett,DEM,460102,4,1,199,204,02
Mcintosh,U.S. House,Joshua Harris-Till,DEM,460102,3,0,98,101,02
Mcintosh,State Senate,Chad Bonds,DEM,460102,0,0,90,90,8
Mcintosh,State Senate,Gary Clason,DEM,460102,0,0,85,85,8
Mcintosh,State Senate,Selina Jayne-Dornan,DEM,460102,7,1,137,145,8
Mcintosh,Governor,Dax Ewbank,REP,460102,0,0,7,7,
Mcintosh,Governor,Chad Moody,REP,460102,0,1,8,9,
Mcintosh,Governor,Mary Fallin,REP,460102,0,0,35,35,
Mcintosh,Superintendent of Public Instruction,Brian Kelly,REP,460102,0,0,14,14,
Mcintosh,Superintendent of Public Instruction,Janet Costello Barresi,REP,460102,0,0,10,10,
Mcintosh,Superintendent of Public Instruction,Joy Hofmeister,REP,460102,0,1,26,27,
Mcintosh,Insurance Commissioner,Bill Viner,REP,460102,0,0,13,13,
Mcintosh,Insurance Commissioner,John Doak,REP,460102,0,1,36,37,
Mcintosh,Corporation Commissioner,Todd Hiett,REP,460102,0,0,13,13,
Mcintosh,Corporation Commissioner,Cliff Branan,REP,460102,0,1,35,36,
Mcintosh,U.S. Senate,Evelyn Rogers,REP,460102,0,1,3,4,
Mcintosh,U.S. Senate,Rob Moye,REP,460102,0,0,1,1,
Mcintosh,U.S. Senate,D. Jean Mcbride-Samuels,REP,460102,0,0,2,2,
Mcintosh,U.S. Senate,Jim Inhofe,REP,460102,0,0,40,40,
Mcintosh,U.S. Senate,Erick Paul Wyatt,REP,460102,0,0,3,3,
Mcintosh,U.S. Senate,Andy Craig,REP,460102,0,0,0,0,
Mcintosh,U.S. Senate,T. Shannon,REP,460102,0,0,26,26,
Mcintosh,U.S. Senate,Randy Brogdon,REP,460102,0,1,3,4,
Mcintosh,U.S. Senate,Eric Mccray,REP,460102,0,0,0,0,
Mcintosh,U.S. Senate,Kevin Crow,REP,460102,0,0,1,1,
Mcintosh,U.S. Senate,James Lankford,REP,460102,0,0,18,18,
Mcintosh,U.S. Senate,Jason Weger,REP,460102,0,0,2,2,
Mcintosh,U.S. House,Darrel Robertson,REP,460102,0,1,7,8,02
Mcintosh,U.S. House,Markwayne Mullin,REP,460102,0,0,43,43,02
Mcintosh,State Senate,J. Hill,REP,460102,0,0,13,13,8
Mcintosh,State Senate,Roger Thompson,REP,460102,0,1,30,31,8
Mcintosh,State Senate,Malcolm Branch,REP,460102,0,0,4,4,8
Mcintosh,Superintendent of Public Instruction,John Cox,DEM,460103,3,12,202,217,
Mcintosh,Superintendent of Public Instruction,Jack Jr.,DEM,460103,0,1,45,46,
Mcintosh,Superintendent of Public Instruction,Ivan Holmes,DEM,460103,1,0,27,28,
Mcintosh,Superintendent of Public Instruction,Freda Deskin,DEM,460103,0,3,123,126,
Mcintosh,U.S. Senate,Patrick Michael Hayes,DEM,460103,0,6,89,95,
Mcintosh,U.S. Senate,Jim Rogers,DEM,460103,3,6,167,176,
Mcintosh,U.S. Senate,Connie Johnson,DEM,460103,1,4,120,125,
Mcintosh,U.S. House,Earl Everett,DEM,460103,3,10,247,260,02
Mcintosh,U.S. House,Joshua Harris-Till,DEM,460103,1,6,122,129,02
Mcintosh,State Senate,Chad Bonds,DEM,460103,1,6,116,123,8
Mcintosh,State Senate,Gary Clason,DEM,460103,0,4,71,75,8
Mcintosh,State Senate,Selina Jayne-Dornan,DEM,460103,3,6,198,207,8
Mcintosh,Governor,Dax Ewbank,REP,460103,0,0,7,7,
Mcintosh,Governor,Chad Moody,REP,460103,0,0,16,16,
Mcintosh,Governor,Mary Fallin,REP,460103,0,2,76,78,
Mcintosh,Superintendent of Public Instruction,Brian Kelly,REP,460103,0,0,23,23,
Mcintosh,Superintendent of Public Instruction,Janet Costello Barresi,REP,460103,0,0,16,16,
Mcintosh,Superintendent of Public Instruction,Joy Hofmeister,REP,460103,0,2,62,64,
Mcintosh,Insurance Commissioner,Bill Viner,REP,460103,0,0,30,30,
Mcintosh,Insurance Commissioner,John Doak,REP,460103,0,2,67,69,
Mcintosh,Corporation Commissioner,Todd Hiett,REP,460103,0,1,48,49,
Mcintosh,Corporation Commissioner,Cliff Branan,REP,460103,0,0,47,47,
Mcintosh,U.S. Senate,Evelyn Rogers,REP,460103,0,0,6,6,
Mcintosh,U.S. Senate,Rob Moye,REP,460103,0,0,1,1,
Mcintosh,U.S. Senate,D. Jean Mcbride-Samuels,REP,460103,0,0,0,0,
Mcintosh,U.S. Senate,Jim Inhofe,REP,460103,0,2,90,92,
Mcintosh,U.S. Senate,Erick Paul Wyatt,REP,460103,0,0,2,2,
Mcintosh,U.S. Senate,Andy Craig,REP,460103,0,0,1,1,
Mcintosh,U.S. Senate,T. Shannon,REP,460103,0,2,51,53,
Mcintosh,U.S. Senate,Randy Brogdon,REP,460103,0,0,11,11,
Mcintosh,U.S. Senate,Eric Mccray,REP,460103,0,0,0,0,
Mcintosh,U.S. Senate,Kevin Crow,REP,460103,0,0,0,0,
Mcintosh,U.S. Senate,James Lankford,REP,460103,0,0,36,36,
Mcintosh,U.S. Senate,Jason Weger,REP,460103,0,0,2,2,
Mcintosh,U.S. House,Darrel Robertson,REP,460103,0,0,15,15,02
Mcintosh,U.S. House,Markwayne Mullin,REP,460103,0,2,86,88,02
Mcintosh,State Senate,J. Hill,REP,460103,0,2,38,40,8
Mcintosh,State Senate,Roger Thompson,REP,460103,0,0,53,53,8
Mcintosh,State Senate,Malcolm Branch,REP,460103,0,0,6,6,8
Mcintosh,Superintendent of Public Instruction,John Cox,DEM,460104,2,6,113,121,
Mcintosh,Superintendent of Public Instruction,Jack Jr.,DEM,460104,0,1,42,43,
Mcintosh,Superintendent of Public Instruction,Ivan Holmes,DEM,460104,1,0,12,13,
Mcintosh,Superintendent of Public Instruction,Freda Deskin,DEM,460104,0,5,88,93,
Mcintosh,U.S. Senate,Patrick Michael Hayes,DEM,460104,0,2,47,49,
Mcintosh,U.S. Senate,Jim Rogers,DEM,460104,3,6,143,152,
Mcintosh,U.S. Senate,Connie Johnson,DEM,460104,0,3,55,58,
Mcintosh,U.S. House,Earl Everett,DEM,460104,0,9,168,177,02
Mcintosh,U.S. House,Joshua Harris-Till,DEM,460104,3,3,71,77,02
Mcintosh,State Senate,Chad Bonds,DEM,460104,3,6,56,65,8
Mcintosh,State Senate,Gary Clason,DEM,460104,0,0,69,69,8
Mcintosh,State Senate,Selina Jayne-Dornan,DEM,460104,0,6,129,135,8
Mcintosh,Governor,Dax Ewbank,REP,460104,0,0,5,5,
Mcintosh,Governor,Chad Moody,REP,460104,0,1,7,8,
Mcintosh,Governor,Mary Fallin,REP,460104,0,3,33,36,
Mcintosh,Superintendent of Public Instruction,Brian Kelly,REP,460104,0,2,7,9,
Mcintosh,Superintendent of Public Instruction,Janet Costello Barresi,REP,460104,0,1,14,15,
Mcintosh,Superintendent of Public Instruction,Joy Hofmeister,REP,460104,0,1,21,22,
Mcintosh,Insurance Commissioner,Bill Viner,REP,460104,0,0,14,14,
Mcintosh,Insurance Commissioner,John Doak,REP,460104,0,4,27,31,
Mcintosh,Corporation Commissioner,Todd Hiett,REP,460104,0,4,20,24,
Mcintosh,Corporation Commissioner,Cliff Branan,REP,460104,0,0,21,21,
Mcintosh,U.S. Senate,Evelyn Rogers,REP,460104,0,0,0,0,
Mcintosh,U.S. Senate,Rob Moye,REP,460104,0,1,4,5,
Mcintosh,U.S. Senate,D. Jean Mcbride-Samuels,REP,460104,0,0,0,0,
Mcintosh,U.S. Senate,Jim Inhofe,REP,460104,0,3,36,39,
Mcintosh,U.S. Senate,Erick Paul Wyatt,REP,460104,0,0,5,5,
Mcintosh,U.S. Senate,Andy Craig,REP,460104,0,0,2,2,
Mcintosh,U.S. Senate,T. Shannon,REP,460104,0,2,16,18,
Mcintosh,U.S. Senate,Randy Brogdon,REP,460104,0,0,0,0,
Mcintosh,U.S. Senate,Eric Mccray,REP,460104,0,0,1,1,
Mcintosh,U.S. Senate,Kevin Crow,REP,460104,0,0,0,0,
Mcintosh,U.S. Senate,James Lankford,REP,460104,0,2,22,24,
Mcintosh,U.S. Senate,Jason Weger,REP,460104,0,0,2,2,
Mcintosh,U.S. House,Darrel Robertson,REP,460104,0,0,6,6,02
Mcintosh,U.S. House,Markwayne Mullin,REP,460104,0,4,38,42,02
Mcintosh,State Senate,J. Hill,REP,460104,0,0,13,13,8
Mcintosh,State Senate,Roger Thompson,REP,460104,0,2,26,28,8
Mcintosh,State Senate,Malcolm Branch,REP,460104,0,2,4,6,8
Mcintosh,Superintendent of Public Instruction,John Cox,DEM,460201,1,4,157,162,
Mcintosh,Superintendent of Public Instruction,Jack Jr.,DEM,460201,0,2,55,57,
Mcintosh,Superintendent of Public Instruction,Ivan Holmes,DEM,460201,1,0,29,30,
Mcintosh,Superintendent of Public Instruction,Freda Deskin,DEM,460201,2,14,117,133,
Mcintosh,U.S. Senate,Patrick Michael Hayes,DEM,460201,1,9,100,110,
Mcintosh,U.S. Senate,Jim Rogers,DEM,460201,2,4,139,145,
Mcintosh,U.S. Senate,Connie Johnson,DEM,460201,2,6,114,122,
Mcintosh,U.S. House,Earl Everett,DEM,460201,1,10,224,235,02
Mcintosh,U.S. House,Joshua Harris-Till,DEM,460201,3,9,119,131,02
Mcintosh,State Senate,Chad Bonds,DEM,460201,1,5,105,111,8
Mcintosh,State Senate,Gary Clason,DEM,460201,1,8,74,83,8
Mcintosh,State Senate,Selina Jayne-Dornan,DEM,460201,3,8,186,197,8
Mcintosh,Governor,Dax Ewbank,REP,460201,0,0,8,8,
Mcintosh,Governor,Chad Moody,REP,460201,0,2,20,22,
Mcintosh,Governor,Mary Fallin,REP,460201,4,17,64,85,
Mcintosh,Superintendent of Public Instruction,Brian Kelly,REP,460201,0,6,29,35,
Mcintosh,Superintendent of Public Instruction,Janet Costello Barresi,REP,460201,1,2,15,18,
Mcintosh,Superintendent of Public Instruction,Joy Hofmeister,REP,460201,3,9,46,58,
Mcintosh,Insurance Commissioner,Bill Viner,REP,460201,0,7,30,37,
Mcintosh,Insurance Commissioner,John Doak,REP,460201,3,11,54,68,
Mcintosh,Corporation Commissioner,Todd Hiett,REP,460201,2,10,40,52,
Mcintosh,Corporation Commissioner,Cliff Branan,REP,460201,2,7,43,52,
Mcintosh,U.S. Senate,Evelyn Rogers,REP,460201,0,0,8,8,
Mcintosh,U.S. Senate,Rob Moye,REP,460201,0,0,2,2,
Mcintosh,U.S. Senate,D. Jean Mcbride-Samuels,REP,460201,0,1,4,5,
Mcintosh,U.S. Senate,Jim Inhofe,REP,460201,4,17,67,88,
Mcintosh,U.S. Senate,Erick Paul Wyatt,REP,460201,0,1,10,11,
Mcintosh,U.S. Senate,Andy Craig,REP,460201,0,1,4,5,
Mcintosh,U.S. Senate,T. Shannon,REP,460201,4,12,38,54,
Mcintosh,U.S. Senate,Randy Brogdon,REP,460201,0,0,2,2,
Mcintosh,U.S. Senate,Eric Mccray,REP,460201,0,1,2,3,
Mcintosh,U.S. Senate,Kevin Crow,REP,460201,0,0,3,3,
Mcintosh,U.S. Senate,James Lankford,REP,460201,0,4,40,44,
Mcintosh,U.S. Senate,Jason Weger,REP,460201,0,0,3,3,
Mcintosh,U.S. House,Darrel Robertson,REP,460201,0,2,21,23,02
Mcintosh,U.S. House,Markwayne Mullin,REP,460201,4,17,71,92,02
Mcintosh,State Senate,J. Hill,REP,460201,1,3,24,28,8
Mcintosh,State Senate,Roger Thompson,REP,460201,3,12,54,69,8
Mcintosh,State Senate,Malcolm Branch,REP,460201,0,3,7,10,8
Mcintosh,Superintendent of Public Instruction,John Cox,DEM,460203,2,1,51,54,
Mcintosh,Superintendent of Public Instruction,Jack Jr.,DEM,460203,0,3,20,23,
Mcintosh,Superintendent of Public Instruction,Ivan Holmes,DEM,460203,2,1,12,15,
Mcintosh,Superintendent of Public Instruction,Freda Deskin,DEM,460203,0,1,49,50,
Mcintosh,U.S. Senate,Patrick Michael Hayes,DEM,460203,3,2,27,32,
Mcintosh,U.S. Senate,Jim Rogers,DEM,460203,1,4,57,62,
Mcintosh,U.S. Senate,Connie Johnson,DEM,460203,0,0,42,42,
Mcintosh,U.S. House,Earl Everett,DEM,460203,4,1,72,77,02
Mcintosh,U.S. House,Joshua Harris-Till,DEM,460203,0,5,49,54,02
Mcintosh,State Senate,Chad Bonds,DEM,460203,0,2,27,29,8
Mcintosh,State Senate,Gary Clason,DEM,460203,2,1,42,45,8
Mcintosh,State Senate,Selina Jayne-Dornan,DEM,460203,4,3,66,73,8
Mcintosh,Governor,Dax Ewbank,REP,460203,0,1,3,4,
Mcintosh,Governor,Chad Moody,REP,460203,0,0,8,8,
Mcintosh,Governor,Mary Fallin,REP,460203,1,3,44,48,
Mcintosh,Superintendent of Public Instruction,Brian Kelly,REP,460203,0,1,14,15,
Mcintosh,Superintendent of Public Instruction,Janet Costello Barresi,REP,460203,0,3,15,18,
Mcintosh,Superintendent of Public Instruction,Joy Hofmeister,REP,460203,1,0,23,24,
Mcintosh,Insurance Commissioner,Bill Viner,REP,460203,1,1,21,23,
Mcintosh,Insurance Commissioner,John Doak,REP,460203,0,1,32,33,
Mcintosh,Corporation Commissioner,Todd Hiett,REP,460203,1,2,24,27,
Mcintosh,Corporation Commissioner,Cliff Branan,REP,460203,0,1,28,29,
Mcintosh,U.S. Senate,Evelyn Rogers,REP,460203,0,0,7,7,
Mcintosh,U.S. Senate,Rob Moye,REP,460203,0,1,3,4,
Mcintosh,U.S. Senate,D. Jean Mcbride-Samuels,REP,460203,0,0,2,2,
Mcintosh,U.S. Senate,Jim Inhofe,REP,460203,1,3,40,44,
Mcintosh,U.S. Senate,Erick Paul Wyatt,REP,460203,0,0,3,3,
Mcintosh,U.S. Senate,Andy Craig,REP,460203,0,0,1,1,
Mcintosh,U.S. Senate,T. Shannon,REP,460203,0,3,26,29,
Mcintosh,U.S. Senate,Randy Brogdon,REP,460203,0,1,3,4,
Mcintosh,U.S. Senate,Eric Mccray,REP,460203,0,0,2,2,
Mcintosh,U.S. Senate,Kevin Crow,REP,460203,0,0,1,1,
Mcintosh,U.S. Senate,James Lankford,REP,460203,1,0,20,21,
Mcintosh,U.S. Senate,Jason Weger,REP,460203,0,0,2,2,
Mcintosh,U.S. House,Darrel Robertson,REP,460203,0,0,10,10,02
Mcintosh,U.S. House,Markwayne Mullin,REP,460203,1,4,44,49,02
Mcintosh,State Senate,J. Hill,REP,460203,0,1,15,16,8
Mcintosh,State Senate,Roger Thompson,REP,460203,1,0,35,36,8
Mcintosh,State Senate,Malcolm Branch,REP,460203,0,1,4,5,8
Mcintosh,Superintendent of Public Instruction,John Cox,DEM,460205,1,2,61,64,
Mcintosh,Superintendent of Public Instruction,Jack Jr.,DEM,460205,1,2,21,24,
Mcintosh,Superintendent of Public Instruction,Ivan Holmes,DEM,460205,0,2,18,20,
Mcintosh,Superintendent of Public Instruction,Freda Deskin,DEM,460205,2,4,52,58,
Mcintosh,U.S. Senate,Patrick Michael Hayes,DEM,460205,2,1,30,33,
Mcintosh,U.S. Senate,Jim Rogers,DEM,460205,0,7,73,80,
Mcintosh,U.S. Senate,Connie Johnson,DEM,460205,2,2,46,50,
Mcintosh,U.S. House,Earl Everett,DEM,460205,1,7,100,108,02
Mcintosh,U.S. House,Joshua Harris-Till,DEM,460205,3,3,46,52,02
Mcintosh,State Senate,Chad Bonds,DEM,460205,0,3,36,39,8
Mcintosh,State Senate,Gary Clason,DEM,460205,2,3,41,46,8
Mcintosh,State Senate,Selina Jayne-Dornan,DEM,460205,2,4,75,81,8
Mcintosh,Governor,Dax Ewbank,REP,460205,0,0,3,3,
Mcintosh,Governor,Chad Moody,REP,460205,0,0,16,16,
Mcintosh,Governor,Mary Fallin,REP,460205,1,8,144,153,
Mcintosh,Superintendent of Public Instruction,Brian Kelly,REP,460205,0,2,38,40,
Mcintosh,Superintendent of Public Instruction,Janet Costello Barresi,REP,460205,0,1,53,54,
Mcintosh,Superintendent of Public Instruction,Joy Hofmeister,REP,460205,1,5,71,77,
Mcintosh,Insurance Commissioner,Bill Viner,REP,460205,0,2,32,34,
Mcintosh,Insurance Commissioner,John Doak,REP,460205,1,5,121,127,
Mcintosh,Corporation Commissioner,Todd Hiett,REP,460205,0,1,85,86,
Mcintosh,Corporation Commissioner,Cliff Branan,REP,460205,1,7,71,79,
Mcintosh,U.S. Senate,Evelyn Rogers,REP,460205,0,0,11,11,
Mcintosh,U.S. Senate,Rob Moye,REP,460205,0,0,0,0,
Mcintosh,U.S. Senate,D. Jean Mcbride-Samuels,REP,460205,0,0,1,1,
Mcintosh,U.S. Senate,Jim Inhofe,REP,460205,1,7,144,152,
Mcintosh,U.S. Senate,Erick Paul Wyatt,REP,460205,0,1,7,8,
Mcintosh,U.S. Senate,Andy Craig,REP,460205,0,0,2,2,
Mcintosh,U.S. Senate,T. Shannon,REP,460205,1,3,72,76,
Mcintosh,U.S. Senate,Randy Brogdon,REP,460205,0,0,4,4,
Mcintosh,U.S. Senate,Eric Mccray,REP,460205,0,0,5,5,
Mcintosh,U.S. Senate,Kevin Crow,REP,460205,0,0,1,1,
Mcintosh,U.S. Senate,James Lankford,REP,460205,0,5,79,84,
Mcintosh,U.S. Senate,Jason Weger,REP,460205,0,0,1,1,
Mcintosh,U.S. House,Darrel Robertson,REP,460205,1,0,34,35,02
Mcintosh,U.S. House,Markwayne Mullin,REP,460205,0,8,128,136,02
Mcintosh,State Senate,J. Hill,REP,460205,0,0,33,33,8
Mcintosh,State Senate,Roger Thompson,REP,460205,1,7,102,110,8
Mcintosh,State Senate,Malcolm Branch,REP,460205,0,0,17,17,8
Mcintosh,Superintendent of Public Instruction,John Cox,DEM,460307,6,9,104,119,
Mcintosh,Superintendent of Public Instruction,Jack Jr.,DEM,460307,2,2,52,56,
Mcintosh,Superintendent of Public Instruction,Ivan Holmes,DEM,460307,1,0,18,19,
Mcintosh,Superintendent of Public Instruction,Freda Deskin,DEM,460307,1,2,65,68,
Mcintosh,U.S. Senate,Patrick Michael Hayes,DEM,460307,3,3,69,75,
Mcintosh,U.S. Senate,Jim Rogers,DEM,460307,4,5,107,116,
Mcintosh,U.S. Senate,Connie Johnson,DEM,460307,3,5,53,61,
Mcintosh,U.S. House,Earl Everett,DEM,460307,7,5,144,156,02
Mcintosh,U.S. House,Joshua Harris-Till,DEM,460307,3,8,75,86,02
Mcintosh,State Senate,Chad Bonds,DEM,460307,5,7,62,74,8
Mcintosh,State Senate,Gary Clason,DEM,460307,1,4,68,73,8
Mcintosh,State Senate,Selina Jayne-Dornan,DEM,460307,4,5,116,125,8
Mcintosh,Governor,Dax Ewbank,REP,460307,0,0,6,6,
Mcintosh,Governor,Chad Moody,REP,460307,0,0,6,6,
Mcintosh,Governor,Mary Fallin,REP,460307,0,1,27,28,
Mcintosh,Superintendent of Public Instruction,Brian Kelly,REP,460307,0,1,6,7,
Mcintosh,Superintendent of Public Instruction,Janet Costello Barresi,REP,460307,0,0,10,10,
Mcintosh,Superintendent of Public Instruction,Joy Hofmeister,REP,460307,0,0,23,23,
Mcintosh,Insurance Commissioner,Bill Viner,REP,460307,0,1,10,11,
Mcintosh,Insurance Commissioner,John Doak,REP,460307,0,0,27,27,
Mcintosh,Corporation Commissioner,Todd Hiett,REP,460307,0,0,17,17,
Mcintosh,Corporation Commissioner,Cliff Branan,REP,460307,0,1,19,20,
Mcintosh,U.S. Senate,Evelyn Rogers,REP,460307,0,1,0,1,
Mcintosh,U.S. Senate,Rob Moye,REP,460307,0,0,0,0,
Mcintosh,U.S. Senate,D. Jean Mcbride-Samuels,REP,460307,0,0,1,1,
Mcintosh,U.S. Senate,Jim Inhofe,REP,460307,0,0,33,33,
Mcintosh,U.S. Senate,Erick Paul Wyatt,REP,460307,0,0,5,5,
Mcintosh,U.S. Senate,Andy Craig,REP,460307,0,0,0,0,
Mcintosh,U.S. Senate,T. Shannon,REP,460307,0,0,22,22,
Mcintosh,U.S. Senate,Randy Brogdon,REP,460307,0,0,0,0,
Mcintosh,U.S. Senate,Eric Mccray,REP,460307,0,0,3,3,
Mcintosh,U.S. Senate,Kevin Crow,REP,460307,0,0,0,0,
Mcintosh,U.S. Senate,James Lankford,REP,460307,0,1,13,14,
Mcintosh,U.S. Senate,Jason Weger,REP,460307,0,0,1,1,
Mcintosh,U.S. House,Darrel Robertson,REP,460307,0,1,4,5,02
Mcintosh,U.S. House,Markwayne Mullin,REP,460307,0,0,35,35,02
Mcintosh,State Senate,J. Hill,REP,460307,0,0,7,7,8
Mcintosh,State Senate,Roger Thompson,REP,460307,0,1,27,28,8
Mcintosh,State Senate,Malcolm Branch,REP,460307,0,0,2,2,8
Mcintosh,Superintendent of Public Instruction,John Cox,DEM,460310,3,3,74,80,
Mcintosh,Superintendent of Public Instruction,Jack Jr.,DEM,460310,0,0,11,11,
Mcintosh,Superintendent of Public Instruction,Ivan Holmes,DEM,460310,1,0,8,9,
Mcintosh,Superintendent of Public Instruction,Freda Deskin,DEM,460310,1,2,43,46,
Mcintosh,U.S. Senate,Patrick Michael Hayes,DEM,460310,1,1,31,33,
Mcintosh,U.S. Senate,Jim Rogers,DEM,460310,3,2,52,57,
Mcintosh,U.S. Senate,Connie Johnson,DEM,460310,1,1,46,48,
Mcintosh,U.S. House,Earl Everett,DEM,460310,4,2,63,69,02
Mcintosh,U.S. House,Joshua Harris-Till,DEM,460310,1,0,60,61,02
Mcintosh,State Senate,Chad Bonds,DEM,460310,1,0,19,20,8
Mcintosh,State Senate,Gary Clason,DEM,460310,1,3,52,56,8
Mcintosh,State Senate,Selina Jayne-Dornan,DEM,460310,3,2,70,75,8
Mcintosh,Governor,Dax Ewbank,REP,460310,0,0,1,1,
Mcintosh,Governor,Chad Moody,REP,460310,0,0,1,1,
Mcintosh,Governor,Mary Fallin,REP,460310,0,0,7,7,
Mcintosh,Superintendent of Public Instruction,Brian Kelly,REP,460310,0,0,2,2,
Mcintosh,Superintendent of Public Instruction,Janet Costello Barresi,REP,460310,0,0,5,5,
Mcintosh,Superintendent of Public Instruction,Joy Hofmeister,REP,460310,0,0,2,2,
Mcintosh,Insurance Commissioner,Bill Viner,REP,460310,0,0,2,2,
Mcintosh,Insurance Commissioner,John Doak,REP,460310,0,0,6,6,
Mcintosh,Corporation Commissioner,Todd Hiett,REP,460310,0,0,6,6,
Mcintosh,Corporation Commissioner,Cliff Branan,REP,460310,0,0,3,3,
Mcintosh,U.S. Senate,Evelyn Rogers,REP,460310,0,0,0,0,
Mcintosh,U.S. Senate,Rob Moye,REP,460310,0,0,0,0,
Mcintosh,U.S. Senate,D. Jean Mcbride-Samuels,REP,460310,0,0,0,0,
Mcintosh,U.S. Senate,Jim Inhofe,REP,460310,0,0,7,7,
Mcintosh,U.S. Senate,Erick Paul Wyatt,REP,460310,0,0,2,2,
Mcintosh,U.S. Senate,Andy Craig,REP,460310,0,0,0,0,
Mcintosh,U.S. Senate,T. Shannon,REP,460310,0,0,4,4,
Mcintosh,U.S. Senate,Randy Brogdon,REP,460310,0,0,1,1,
Mcintosh,U.S. Senate,Eric Mccray,REP,460310,0,0,0,0,
Mcintosh,U.S. Senate,Kevin Crow,REP,460310,0,0,0,0,
Mcintosh,U.S. Senate,James Lankford,REP,460310,0,0,4,4,
Mcintosh,U.S. Senate,Jason Weger,REP,460310,0,0,0,0,
Mcintosh,U.S. House,Darrel Robertson,REP,460310,0,0,1,1,02
Mcintosh,U.S. House,Markwayne Mullin,REP,460310,0,0,7,7,02
Mcintosh,State Senate,J. Hill,REP,460310,0,0,0,0,8
Mcintosh,State Senate,Roger Thompson,REP,460310,0,0,7,7,8
Mcintosh,State Senate,Malcolm Branch,REP,460310,0,0,2,2,8
Mcintosh,Superintendent of Public Instruction,John Cox,DEM,460311,2,5,74,81,
Mcintosh,Superintendent of Public Instruction,Jack Jr.,DEM,460311,1,0,20,21,
Mcintosh,Superintendent of Public Instruction,Ivan Holmes,DEM,460311,0,0,8,8,
Mcintosh,Superintendent of Public Instruction,Freda Deskin,DEM,460311,3,2,52,57,
Mcintosh,U.S. Senate,Patrick Michael Hayes,DEM,460311,0,1,44,45,
Mcintosh,U.S. Senate,Jim Rogers,DEM,460311,3,3,70,76,
Mcintosh,U.S. Senate,Connie Johnson,DEM,460311,3,3,42,48,
Mcintosh,U.S. House,Earl Everett,DEM,460311,4,5,89,98,02
Mcintosh,U.S. House,Joshua Harris-Till,DEM,460311,2,2,66,70,02
Mcintosh,State Senate,Chad Bonds,DEM,460311,4,4,45,53,8
Mcintosh,State Senate,Gary Clason,DEM,460311,1,3,43,47,8
Mcintosh,State Senate,Selina Jayne-Dornan,DEM,460311,2,1,69,72,8
Mcintosh,Governor,Dax Ewbank,REP,460311,0,0,0,0,
Mcintosh,Governor,Chad Moody,REP,460311,0,0,2,2,
Mcintosh,Governor,Mary Fallin,REP,460311,2,4,12,18,
Mcintosh,Superintendent of Public Instruction,Brian Kelly,REP,460311,0,0,4,4,
Mcintosh,Superintendent of Public Instruction,Janet Costello Barresi,REP,460311,2,2,3,7,
Mcintosh,Superintendent of Public Instruction,Joy Hofmeister,REP,460311,0,2,7,9,
Mcintosh,Insurance Commissioner,Bill Viner,REP,460311,0,0,4,4,
Mcintosh,Insurance Commissioner,John Doak,REP,460311,1,4,9,14,
Mcintosh,Corporation Commissioner,Todd Hiett,REP,460311,0,4,9,13,
Mcintosh,Corporation Commissioner,Cliff Branan,REP,460311,2,0,5,7,
Mcintosh,U.S. Senate,Evelyn Rogers,REP,460311,0,0,2,2,
Mcintosh,U.S. Senate,Rob Moye,REP,460311,0,0,0,0,
Mcintosh,U.S. Senate,D. Jean Mcbride-Samuels,REP,460311,0,0,0,0,
Mcintosh,U.S. Senate,Jim Inhofe,REP,460311,2,4,12,18,
Mcintosh,U.S. Senate,Erick Paul Wyatt,REP,460311,0,0,0,0,
Mcintosh,U.S. Senate,Andy Craig,REP,460311,0,0,0,0,
Mcintosh,U.S. Senate,T. Shannon,REP,460311,2,3,8,13,
Mcintosh,U.S. Senate,Randy Brogdon,REP,460311,0,0,1,1,
Mcintosh,U.S. Senate,Eric Mccray,REP,460311,0,0,0,0,
Mcintosh,U.S. Senate,Kevin Crow,REP,460311,0,0,0,0,
Mcintosh,U.S. Senate,James Lankford,REP,460311,0,1,5,6,
Mcintosh,U.S. Senate,Jason Weger,REP,460311,0,0,0,0,
Mcintosh,U.S. House,Darrel Robertson,REP,460311,0,0,2,2,02
Mcintosh,U.S. House,Markwayne Mullin,REP,460311,2,4,11,17,02
Mcintosh,State Senate,J. Hill,REP,460311,0,0,3,3,8
Mcintosh,State Senate,Roger Thompson,REP,460311,2,4,10,16,8
Mcintosh,State Senate,Malcolm Branch,REP,460311,0,0,1,1,8
Mcintosh,Superintendent of Public Instruction,John Cox,DEM,460312,0,0,10,10,
Mcintosh,Superintendent of Public Instruction,Jack Jr.,DEM,460312,0,0,5,5,
Mcintosh,Superintendent of Public Instruction,Ivan Holmes,DEM,460312,0,0,2,2,
Mcintosh,Superintendent of Public Instruction,Freda Deskin,DEM,460312,0,0,8,8,
Mcintosh,U.S. Senate,Patrick Michael Hayes,DEM,460312,0,0,14,14,
Mcintosh,U.S. Senate,Jim Rogers,DEM,460312,0,0,7,7,
Mcintosh,U.S. Senate,Connie Johnson,DEM,460312,0,0,4,4,
Mcintosh,U.S. House,Earl Everett,DEM,460312,0,0,14,14,02
Mcintosh,U.S. House,Joshua Harris-Till,DEM,460312,0,0,10,10,02
Mcintosh,State Senate,Chad Bonds,DEM,460312,0,0,2,2,8
Mcintosh,State Senate,Gary Clason,DEM,460312,0,0,11,11,8
Mcintosh,State Senate,Selina Jayne-Dornan,DEM,460312,0,0,12,12,8
Mcintosh,Governor,Dax Ewbank,REP,460312,0,0,0,0,
Mcintosh,Governor,Chad Moody,REP,460312,0,0,1,1,
Mcintosh,Governor,Mary Fallin,REP,460312,2,0,9,11,
Mcintosh,Superintendent of Public Instruction,Brian Kelly,REP,460312,0,0,3,3,
Mcintosh,Superintendent of Public Instruction,Janet Costello Barresi,REP,460312,0,0,2,2,
Mcintosh,Superintendent of Public Instruction,Joy Hofmeister,REP,460312,2,0,5,7,
Mcintosh,Insurance Commissioner,Bill Viner,REP,460312,0,0,1,1,
Mcintosh,Insurance Commissioner,John Doak,REP,460312,0,0,9,9,
Mcintosh,Corporation Commissioner,Todd Hiett,REP,460312,1,0,4,5,
Mcintosh,Corporation Commissioner,Cliff Branan,REP,460312,0,0,6,6,
Mcintosh,U.S. Senate,Evelyn Rogers,REP,460312,0,0,0,0,
Mcintosh,U.S. Senate,Rob Moye,REP,460312,0,0,0,0,
Mcintosh,U.S. Senate,D. Jean Mcbride-Samuels,REP,460312,0,0,0,0,
Mcintosh,U.S. Senate,Jim Inhofe,REP,460312,2,0,9,11,
Mcintosh,U.S. Senate,Erick Paul Wyatt,REP,460312,0,0,1,1,
Mcintosh,U.S. Senate,Andy Craig,REP,460312,0,0,0,0,
Mcintosh,U.S. Senate,T. Shannon,REP,460312,0,0,5,5,
Mcintosh,U.S. Senate,Randy Brogdon,REP,460312,2,0,0,2,
Mcintosh,U.S. Senate,Eric Mccray,REP,460312,0,0,0,0,
Mcintosh,U.S. Senate,Kevin Crow,REP,460312,0,0,0,0,
Mcintosh,U.S. Senate,James Lankford,REP,460312,0,0,5,5,
Mcintosh,U.S. Senate,Jason Weger,REP,460312,0,0,0,0,
Mcintosh,U.S. House,Darrel Robertson,REP,460312,0,0,1,1,02
Mcintosh,U.S. House,Markwayne Mullin,REP,460312,2,0,9,11,02
Mcintosh,State Senate,J. Hill,REP,460312,0,0,4,4,8
Mcintosh,State Senate,Roger Thompson,REP,460312,2,0,6,8,8
Mcintosh,State Senate,Malcolm Branch,REP,460312,0,0,0,0,8
Mcintosh,Superintendent of Public Instruction,John Cox,DEM,460313,1,0,17,18,
Mcintosh,Superintendent of Public Instruction,Jack Jr.,DEM,460313,0,0,0,0,
Mcintosh,Superintendent of Public Instruction,Ivan Holmes,DEM,460313,0,0,1,1,
Mcintosh,Superintendent of Public Instruction,Freda Deskin,DEM,460313,0,0,10,10,
Mcintosh,U.S. Senate,Patrick Michael Hayes,DEM,460313,0,0,4,4,
Mcintosh,U.S. Senate,Jim Rogers,DEM,460313,0,0,11,11,
Mcintosh,U.S. Senate,Connie Johnson,DEM,460313,1,0,13,14,
Mcintosh,U.S. House,Earl Everett,DEM,460313,1,0,11,12,02
Mcintosh,U.S. House,Joshua Harris-Till,DEM,460313,0,0,17,17,02
Mcintosh,State Senate,Chad Bonds,DEM,460313,0,0,3,3,8
Mcintosh,State Senate,Gary Clason,DEM,460313,0,0,17,17,8
Mcintosh,State Senate,Selina Jayne-Dornan,DEM,460313,1,0,8,9,8
Mcintosh,Governor,Dax Ewbank,REP,460313,0,0,1,1,
Mcintosh,Governor,Chad Moody,REP,460313,0,0,2,2,
Mcintosh,Governor,Mary Fallin,REP,460313,0,0,11,11,
Mcintosh,Superintendent of Public Instruction,Brian Kelly,REP,460313,0,0,4,4,
Mcintosh,Superintendent of Public Instruction,Janet Costello Barresi,REP,460313,0,0,1,1,
Mcintosh,Superintendent of Public Instruction,Joy Hofmeister,REP,460313,0,0,9,9,
Mcintosh,Insurance Commissioner,Bill Viner,REP,460313,0,0,4,4,
Mcintosh,Insurance Commissioner,John Doak,REP,460313,0,0,10,10,
Mcintosh,Corporation Commissioner,Todd Hiett,REP,460313,0,0,3,3,
Mcintosh,Corporation Commissioner,Cliff Branan,REP,460313,0,0,10,10,
Mcintosh,U.S. Senate,Evelyn Rogers,REP,460313,0,0,0,0,
Mcintosh,U.S. Senate,Rob Moye,REP,460313,0,0,0,0,
Mcintosh,U.S. Senate,D. Jean Mcbride-Samuels,REP,460313,0,0,0,0,
Mcintosh,U.S. Senate,Jim Inhofe,REP,460313,0,0,13,13,
Mcintosh,U.S. Senate,Erick Paul Wyatt,REP,460313,0,0,1,1,
Mcintosh,U.S. Senate,Andy Craig,REP,460313,0,0,0,0,
Mcintosh,U.S. Senate,T. Shannon,REP,460313,0,0,12,12,
Mcintosh,U.S. Senate,Randy Brogdon,REP,460313,0,0,0,0,
Mcintosh,U.S. Senate,Eric Mccray,REP,460313,0,0,0,0,
Mcintosh,U.S. Senate,Kevin Crow,REP,460313,0,0,0,0,
Mcintosh,U.S. Senate,James Lankford,REP,460313,0,0,2,2,
Mcintosh,U.S. Senate,Jason Weger,REP,460313,0,0,0,0,
Mcintosh,U.S. House,Darrel Robertson,REP,460313,0,0,1,1,02
Mcintosh,U.S. House,Markwayne Mullin,REP,460313,0,0,13,13,02
Mcintosh,State Senate,J. Hill,REP,460313,0,0,3,3,8
Mcintosh,State Senate,Roger Thompson,REP,460313,0,0,9,9,8
Mcintosh,State Senate,Malcolm Branch,REP,460313,0,0,2,2,8
Mcintosh,Superintendent of Public Instruction,John Cox,DEM,460314,0,4,67,71,
Mcintosh,Superintendent of Public Instruction,Jack Jr.,DEM,460314,0,0,23,23,
Mcintosh,Superintendent of Public Instruction,Ivan Holmes,DEM,460314,0,1,12,13,
Mcintosh,Superintendent of Public Instruction,Freda Deskin,DEM,460314,0,5,63,68,
Mcintosh,U.S. Senate,Patrick Michael Hayes,DEM,460314,0,3,27,30,
Mcintosh,U.S. Senate,Jim Rogers,DEM,460314,0,3,67,70,
Mcintosh,U.S. Senate,Connie Johnson,DEM,460314,0,3,60,63,
Mcintosh,U.S. House,Earl Everett,DEM,460314,0,6,101,107,02
Mcintosh,U.S. House,Joshua Harris-Till,DEM,460314,0,2,49,51,02
Mcintosh,State Senate,Chad Bonds,DEM,460314,0,2,34,36,8
Mcintosh,State Senate,Gary Clason,DEM,460314,0,2,44,46,8
Mcintosh,State Senate,Selina Jayne-Dornan,DEM,460314,0,6,74,80,8
Mcintosh,Governor,Dax Ewbank,REP,460314,0,1,1,2,
Mcintosh,Governor,Chad Moody,REP,460314,0,0,16,16,
Mcintosh,Governor,Mary Fallin,REP,460314,0,1,61,62,
Mcintosh,Superintendent of Public Instruction,Brian Kelly,REP,460314,0,1,24,25,
Mcintosh,Superintendent of Public Instruction,Janet Costello Barresi,REP,460314,0,0,22,22,
Mcintosh,Superintendent of Public Instruction,Joy Hofmeister,REP,460314,0,1,31,32,
Mcintosh,Insurance Commissioner,Bill Viner,REP,460314,0,1,18,19,
Mcintosh,Insurance Commissioner,John Doak,REP,460314,0,1,57,58,
Mcintosh,Corporation Commissioner,Todd Hiett,REP,460314,0,1,33,34,
Mcintosh,Corporation Commissioner,Cliff Branan,REP,460314,0,1,41,42,
Mcintosh,U.S. Senate,Evelyn Rogers,REP,460314,0,0,6,6,
Mcintosh,U.S. Senate,Rob Moye,REP,460314,0,0,0,0,
Mcintosh,U.S. Senate,D. Jean Mcbride-Samuels,REP,460314,0,0,2,2,
Mcintosh,U.S. Senate,Jim Inhofe,REP,460314,0,2,65,67,
Mcintosh,U.S. Senate,Erick Paul Wyatt,REP,460314,0,0,4,4,
Mcintosh,U.S. Senate,Andy Craig,REP,460314,0,0,0,0,
Mcintosh,U.S. Senate,T. Shannon,REP,460314,0,1,41,42,
Mcintosh,U.S. Senate,Randy Brogdon,REP,460314,0,0,1,1,
Mcintosh,U.S. Senate,Eric Mccray,REP,460314,0,0,2,2,
Mcintosh,U.S. Senate,Kevin Crow,REP,460314,0,1,1,2,
Mcintosh,U.S. Senate,James Lankford,REP,460314,0,0,31,31,
Mcintosh,U.S. Senate,Jason Weger,REP,460314,0,0,2,2,
Mcintosh,U.S. House,Darrel Robertson,REP,460314,0,1,16,17,02
Mcintosh,U.S. House,Markwayne Mullin,REP,460314,0,1,61,62,02
Mcintosh,State Senate,J. Hill,REP,460314,0,1,31,32,8
Mcintosh,State Senate,Roger Thompson,REP,460314,0,1,41,42,8
Mcintosh,State Senate,Malcolm Branch,REP,460314,0,0,3,3,8
Mcintosh,Superintendent of Public Instruction,John Cox,DEM,460315,0,1,43,44,
Mcintosh,Superintendent of Public Instruction,Jack Jr.,DEM,460315,0,0,11,11,
Mcintosh,Superintendent of Public Instruction,Ivan Holmes,DEM,460315,0,0,9,9,
Mcintosh,Superintendent of Public Instruction,Freda Deskin,DEM,460315,2,0,26,28,
Mcintosh,U.S. Senate,Patrick Michael Hayes,DEM,460315,2,1,28,31,
Mcintosh,U.S. Senate,Jim Rogers,DEM,460315,0,0,25,25,
Mcintosh,U.S. Senate,Connie Johnson,DEM,460315,0,0,32,32,
Mcintosh,U.S. House,Earl Everett,DEM,460315,2,0,51,53,02
Mcintosh,U.S. House,Joshua Harris-Till,DEM,460315,0,1,29,30,02
Mcintosh,State Senate,Chad Bonds,DEM,460315,0,0,24,24,8
Mcintosh,State Senate,Gary Clason,DEM,460315,2,0,30,32,8
Mcintosh,State Senate,Selina Jayne-Dornan,DEM,460315,0,1,33,34,8
Mcintosh,Governor,Dax Ewbank,REP,460315,0,0,0,0,
Mcintosh,Governor,Chad Moody,REP,460315,0,0,2,2,
Mcintosh,Governor,Mary Fallin,REP,460315,0,2,14,16,
Mcintosh,Superintendent of Public Instruction,Brian Kelly,REP,460315,0,0,5,5,
Mcintosh,Superintendent of Public Instruction,Janet Costello Barresi,REP,460315,0,0,3,3,
Mcintosh,Superintendent of Public Instruction,Joy Hofmeister,REP,460315,0,2,7,9,
Mcintosh,Insurance Commissioner,Bill Viner,REP,460315,0,1,6,7,
Mcintosh,Insurance Commissioner,John Doak,REP,460315,0,1,9,10,
Mcintosh,Corporation Commissioner,Todd Hiett,REP,460315,0,2,5,7,
Mcintosh,Corporation Commissioner,Cliff Branan,REP,460315,0,0,10,10,
Mcintosh,U.S. Senate,Evelyn Rogers,REP,460315,0,0,0,0,
Mcintosh,U.S. Senate,Rob Moye,REP,460315,0,0,0,0,
Mcintosh,U.S. Senate,D. Jean Mcbride-Samuels,REP,460315,0,0,0,0,
Mcintosh,U.S. Senate,Jim Inhofe,REP,460315,0,2,16,18,
Mcintosh,U.S. Senate,Erick Paul Wyatt,REP,460315,0,0,0,0,
Mcintosh,U.S. Senate,Andy Craig,REP,460315,0,0,0,0,
Mcintosh,U.S. Senate,T. Shannon,REP,460315,0,0,7,7,
Mcintosh,U.S. Senate,Randy Brogdon,REP,460315,0,0,1,1,
Mcintosh,U.S. Senate,Eric Mccray,REP,460315,0,0,0,0,
Mcintosh,U.S. Senate,Kevin Crow,REP,460315,0,0,0,0,
Mcintosh,U.S. Senate,James Lankford,REP,460315,0,2,7,9,
Mcintosh,U.S. Senate,Jason Weger,REP,460315,0,0,0,0,
Mcintosh,U.S. House,Darrel Robertson,REP,460315,0,0,2,2,02
Mcintosh,U.S. House,Markwayne Mullin,REP,460315,0,2,14,16,02
Mcintosh,State Senate,J. Hill,REP,460315,0,0,3,3,8
Mcintosh,State Senate,Roger Thompson,REP,460315,0,2,10,12,8
Mcintosh,State Senate,Malcolm Branch,REP,460315,0,0,3,3,8
Mcintosh,Superintendent of Public Instruction,John Cox,DEM,460316,0,0,42,42,
Mcintosh,Superintendent of Public Instruction,Jack Jr.,DEM,460316,0,1,10,11,
Mcintosh,Superintendent of Public Instruction,Ivan Holmes,DEM,460316,0,0,6,6,
Mcintosh,Superintendent of Public Instruction,Freda Deskin,DEM,460316,0,0,36,36,
Mcintosh,U.S. Senate,Patrick Michael Hayes,DEM,460316,0,0,16,16,
Mcintosh,U.S. Senate,Jim Rogers,DEM,460316,0,1,43,44,
Mcintosh,U.S. Senate,Connie Johnson,DEM,460316,0,0,31,31,
Mcintosh,U.S. House,Earl Everett,DEM,460316,0,0,53,53,02
Mcintosh,U.S. House,Joshua Harris-Till,DEM,460316,0,1,31,32,02
Mcintosh,State Senate,Chad Bonds,DEM,460316,0,0,23,23,8
Mcintosh,State Senate,Gary Clason,DEM,460316,0,0,24,24,8
Mcintosh,State Senate,Selina Jayne-Dornan,DEM,460316,0,1,43,44,8
Mcintosh,Governor,Dax Ewbank,REP,460316,0,0,1,1,
Mcintosh,Governor,Chad Moody,REP,460316,0,1,7,8,
Mcintosh,Governor,Mary Fallin,REP,460316,2,0,39,41,
Mcintosh,Superintendent of Public Instruction,Brian Kelly,REP,460316,0,0,12,12,
Mcintosh,Superintendent of Public Instruction,Janet Costello Barresi,REP,460316,0,0,14,14,
Mcintosh,Superintendent of Public Instruction,Joy Hofmeister,REP,460316,2,1,20,23,
Mcintosh,Insurance Commissioner,Bill Viner,REP,460316,0,1,13,14,
Mcintosh,Insurance Commissioner,John Doak,REP,460316,2,0,32,34,
Mcintosh,Corporation Commissioner,Todd Hiett,REP,460316,2,0,27,29,
Mcintosh,Corporation Commissioner,Cliff Branan,REP,460316,0,1,21,22,
Mcintosh,U.S. Senate,Evelyn Rogers,REP,460316,0,0,1,1,
Mcintosh,U.S. Senate,Rob Moye,REP,460316,0,0,0,0,
Mcintosh,U.S. Senate,D. Jean Mcbride-Samuels,REP,460316,0,0,0,0,
Mcintosh,U.S. Senate,Jim Inhofe,REP,460316,2,1,45,48,
Mcintosh,U.S. Senate,Erick Paul Wyatt,REP,460316,0,0,2,2,
Mcintosh,U.S. Senate,Andy Craig,REP,460316,0,0,0,0,
Mcintosh,U.S. Senate,T. Shannon,REP,460316,2,0,23,25,
Mcintosh,U.S. Senate,Randy Brogdon,REP,460316,0,0,4,4,
Mcintosh,U.S. Senate,Eric Mccray,REP,460316,0,1,1,2,
Mcintosh,U.S. Senate,Kevin Crow,REP,460316,0,0,0,0,
Mcintosh,U.S. Senate,James Lankford,REP,460316,0,0,19,19,
Mcintosh,U.S. Senate,Jason Weger,REP,460316,0,0,1,1,
Mcintosh,U.S. House,Darrel Robertson,REP,460316,0,1,3,4,02
Mcintosh,U.S. House,Markwayne Mullin,REP,460316,2,0,44,46,02
Mcintosh,State Senate,J. Hill,REP,460316,2,0,16,18,8
Mcintosh,State Senate,Roger Thompson,REP,460316,0,1,24,25,8
Mcintosh,State Senate,Malcolm Branch,REP,460316,0,0,5,5,8
Major,Superintendent of Public Instruction,John Cox,DEM,470002,0,2,19,21,
Major,Superintendent of Public Instruction,Jack Jr.,DEM,470002,0,0,4,4,
Major,Superintendent of Public Instruction,Ivan Holmes,DEM,470002,1,0,1,2,
Major,Superintendent of Public Instruction,Freda Deskin,DEM,470002,1,3,15,19,
Major,U.S. Senate,Patrick Michael Hayes,DEM,470002,1,0,7,8,
Major,U.S. Senate,Jim Rogers,DEM,470002,1,0,13,14,
Major,U.S. Senate,Connie Johnson,DEM,470002,0,5,18,23,
Major,Governor,Dax Ewbank,REP,470002,3,2,113,118,
Major,Governor,Chad Moody,REP,470002,0,5,47,52,
Major,Governor,Mary Fallin,REP,470002,9,21,210,240,
Major,Superintendent of Public Instruction,Brian Kelly,REP,470002,2,8,76,86,
Major,Superintendent of Public Instruction,Janet Costello Barresi,REP,470002,3,2,73,78,
Major,Superintendent of Public Instruction,Joy Hofmeister,REP,470002,7,18,219,244,
Major,Insurance Commissioner,Bill Viner,REP,470002,2,6,80,88,
Major,Insurance Commissioner,John Doak,REP,470002,10,21,281,312,
Major,Corporation Commissioner,Todd Hiett,REP,470002,8,18,205,231,
Major,Corporation Commissioner,Cliff Branan,REP,470002,4,9,156,169,
Major,U.S. Senate,Evelyn Rogers,REP,470002,0,1,17,18,
Major,U.S. Senate,Rob Moye,REP,470002,0,0,4,4,
Major,U.S. Senate,D. Jean Mcbride-Samuels,REP,470002,0,0,4,4,
Major,U.S. Senate,Jim Inhofe,REP,470002,12,26,316,354,
Major,U.S. Senate,Erick Paul Wyatt,REP,470002,0,1,31,32,
Major,U.S. Senate,Andy Craig,REP,470002,0,0,7,7,
Major,U.S. Senate,T. Shannon,REP,470002,2,8,128,138,
Major,U.S. Senate,Randy Brogdon,REP,470002,0,0,13,13,
Major,U.S. Senate,Eric Mccray,REP,470002,0,0,3,3,
Major,U.S. Senate,Kevin Crow,REP,470002,0,1,24,25,
Major,U.S. Senate,James Lankford,REP,470002,10,17,199,226,
Major,U.S. Senate,Jason Weger,REP,470002,0,1,0,1,
Major,U.S. House,Timothy Ray Murray,REP,470002,1,2,14,17,03
Major,U.S. House,Robert Hubbard,REP,470002,0,3,65,68,03
Major,U.S. House,Frank Lucas,REP,470002,11,23,294,328,03
Major,Superintendent of Public Instruction,John Cox,DEM,470004,0,0,8,8,
Major,Superintendent of Public Instruction,Jack Jr.,DEM,470004,0,0,6,6,
Major,Superintendent of Public Instruction,Ivan Holmes,DEM,470004,0,0,3,3,
Major,Superintendent of Public Instruction,Freda Deskin,DEM,470004,0,0,11,11,
Major,U.S. Senate,Patrick Michael Hayes,DEM,470004,0,0,11,11,
Major,U.S. Senate,Jim Rogers,DEM,470004,0,0,10,10,
Major,U.S. Senate,Connie Johnson,DEM,470004,0,0,6,6,
Major,Governor,Dax Ewbank,REP,470004,0,0,26,26,
Major,Governor,Chad Moody,REP,470004,0,0,2,2,
Major,Governor,Mary Fallin,REP,470004,0,1,35,36,
Major,Superintendent of Public Instruction,Brian Kelly,REP,470004,0,0,14,14,
Major,Superintendent of Public Instruction,Janet Costello Barresi,REP,470004,0,0,6,6,
Major,Superintendent of Public Instruction,Joy Hofmeister,REP,470004,0,1,42,43,
Major,Insurance Commissioner,Bill Viner,REP,470004,0,0,12,12,
Major,Insurance Commissioner,John Doak,REP,470004,0,1,48,49,
Major,Corporation Commissioner,Todd Hiett,REP,470004,0,1,34,35,
Major,Corporation Commissioner,Cliff Branan,REP,470004,0,0,25,25,
Major,U.S. Senate,Evelyn Rogers,REP,470004,0,0,4,4,
Major,U.S. Senate,Rob Moye,REP,470004,0,0,2,2,
Major,U.S. Senate,D. Jean Mcbride-Samuels,REP,470004,0,0,0,0,
Major,U.S. Senate,Jim Inhofe,REP,470004,0,1,45,46,
Major,U.S. Senate,Erick Paul Wyatt,REP,470004,0,0,9,9,
Major,U.S. Senate,Andy Craig,REP,470004,0,0,0,0,
Major,U.S. Senate,T. Shannon,REP,470004,0,0,16,16,
Major,U.S. Senate,Randy Brogdon,REP,470004,0,0,2,2,
Major,U.S. Senate,Eric Mccray,REP,470004,0,0,0,0,
Major,U.S. Senate,Kevin Crow,REP,470004,0,0,1,1,
Major,U.S. Senate,James Lankford,REP,470004,0,1,44,45,
Major,U.S. Senate,Jason Weger,REP,470004,0,0,0,0,
Major,U.S. House,Timothy Ray Murray,REP,470004,0,0,4,4,03
Major,U.S. House,Robert Hubbard,REP,470004,0,0,13,13,03
Major,U.S. House,Frank Lucas,REP,470004,0,1,45,46,03
Major,Superintendent of Public Instruction,John Cox,DEM,470009,0,0,2,2,
Major,Superintendent of Public Instruction,Jack Jr.,DEM,470009,0,0,1,1,
Major,Superintendent of Public Instruction,Ivan Holmes,DEM,470009,0,0,0,0,
Major,Superintendent of Public Instruction,Freda Deskin,DEM,470009,0,1,3,4,
Major,U.S. Senate,Patrick Michael Hayes,DEM,470009,0,0,2,2,
Major,U.S. Senate,Jim Rogers,DEM,470009,0,1,2,3,
Major,U.S. Senate,Connie Johnson,DEM,470009,0,0,2,2,
Major,Governor,Dax Ewbank,REP,470009,0,1,4,5,
Major,Governor,Chad Moody,REP,470009,0,0,2,2,
Major,Governor,Mary Fallin,REP,470009,1,2,17,20,
Major,Superintendent of Public Instruction,Brian Kelly,REP,470009,0,0,11,11,
Major,Superintendent of Public Instruction,Janet Costello Barresi,REP,470009,0,1,4,5,
Major,Superintendent of Public Instruction,Joy Hofmeister,REP,470009,1,2,8,11,
Major,Insurance Commissioner,Bill Viner,REP,470009,0,0,4,4,
Major,Insurance Commissioner,John Doak,REP,470009,1,3,18,22,
Major,Corporation Commissioner,Todd Hiett,REP,470009,0,1,7,8,
Major,Corporation Commissioner,Cliff Branan,REP,470009,0,2,14,16,
Major,U.S. Senate,Evelyn Rogers,REP,470009,0,0,0,0,
Major,U.S. Senate,Rob Moye,REP,470009,0,0,0,0,
Major,U.S. Senate,D. Jean Mcbride-Samuels,REP,470009,0,0,0,0,
Major,U.S. Senate,Jim Inhofe,REP,470009,1,3,22,26,
Major,U.S. Senate,Erick Paul Wyatt,REP,470009,0,0,1,1,
Major,U.S. Senate,Andy Craig,REP,470009,0,0,0,0,
Major,U.S. Senate,T. Shannon,REP,470009,0,0,11,11,
Major,U.S. Senate,Randy Brogdon,REP,470009,0,0,0,0,
Major,U.S. Senate,Eric Mccray,REP,470009,0,1,0,1,
Major,U.S. Senate,Kevin Crow,REP,470009,0,0,0,0,
Major,U.S. Senate,James Lankford,REP,470009,1,2,12,15,
Major,U.S. Senate,Jason Weger,REP,470009,0,0,0,0,
Major,U.S. House,Timothy Ray Murray,REP,470009,0,0,1,1,03
Major,U.S. House,Robert Hubbard,REP,470009,0,0,3,3,03
Major,U.S. House,Frank Lucas,REP,470009,1,3,19,23,03
Major,Superintendent of Public Instruction,John Cox,DEM,470010,2,0,7,9,
Major,Superintendent of Public Instruction,Jack Jr.,DEM,470010,0,0,2,2,
Major,Superintendent of Public Instruction,Ivan Holmes,DEM,470010,0,0,5,5,
Major,Superintendent of Public Instruction,Freda Deskin,DEM,470010,0,0,2,2,
Major,U.S. Senate,Patrick Michael Hayes,DEM,470010,2,0,6,8,
Major,U.S. Senate,Jim Rogers,DEM,470010,0,0,8,8,
Major,U.S. Senate,Connie Johnson,DEM,470010,0,0,2,2,
Major,Governor,Dax Ewbank,REP,470010,0,2,26,28,
Major,Governor,Chad Moody,REP,470010,1,0,5,6,
Major,Governor,Mary Fallin,REP,470010,6,2,45,53,
Major,Superintendent of Public Instruction,Brian Kelly,REP,470010,4,1,23,28,
Major,Superintendent of Public Instruction,Janet Costello Barresi,REP,470010,1,0,4,5,
Major,Superintendent of Public Instruction,Joy Hofmeister,REP,470010,1,3,48,52,
Major,Insurance Commissioner,Bill Viner,REP,470010,2,1,13,16,
Major,Insurance Commissioner,John Doak,REP,470010,4,3,62,69,
Major,Corporation Commissioner,Todd Hiett,REP,470010,4,1,39,44,
Major,Corporation Commissioner,Cliff Branan,REP,470010,2,3,33,38,
Major,U.S. Senate,Evelyn Rogers,REP,470010,0,0,2,2,
Major,U.S. Senate,Rob Moye,REP,470010,1,0,1,2,
Major,U.S. Senate,D. Jean Mcbride-Samuels,REP,470010,1,0,0,1,
Major,U.S. Senate,Jim Inhofe,REP,470010,5,4,64,73,
Major,U.S. Senate,Erick Paul Wyatt,REP,470010,0,0,8,8,
Major,U.S. Senate,Andy Craig,REP,470010,0,0,0,0,
Major,U.S. Senate,T. Shannon,REP,470010,3,0,32,35,
Major,U.S. Senate,Randy Brogdon,REP,470010,0,0,4,4,
Major,U.S. Senate,Eric Mccray,REP,470010,0,1,0,1,
Major,U.S. Senate,Kevin Crow,REP,470010,0,0,0,0,
Major,U.S. Senate,James Lankford,REP,470010,3,3,40,46,
Major,U.S. Senate,Jason Weger,REP,470010,0,0,0,0,
Major,U.S. House,Timothy Ray Murray,REP,470010,1,0,3,4,03
Major,U.S. House,Robert Hubbard,REP,470010,1,0,11,12,03
Major,U.S. House,Frank Lucas,REP,470010,5,4,62,71,03
Major,Superintendent of Public Instruction,John Cox,DEM,470015,0,0,7,7,
Major,Superintendent of Public Instruction,Jack Jr.,DEM,470015,0,0,1,1,
Major,Superintendent of Public Instruction,Ivan Holmes,DEM,470015,0,0,1,1,
Major,Superintendent of Public Instruction,Freda Deskin,DEM,470015,0,0,8,8,
Major,U.S. Senate,Patrick Michael Hayes,DEM,470015,0,0,4,4,
Major,U.S. Senate,Jim Rogers,DEM,470015,0,0,8,8,
Major,U.S. Senate,Connie Johnson,DEM,470015,0,0,5,5,
Major,Governor,Dax Ewbank,REP,470015,0,0,19,19,
Major,Governor,Chad Moody,REP,470015,0,1,14,15,
Major,Governor,Mary Fallin,REP,470015,0,3,78,81,
Major,Superintendent of Public Instruction,Brian Kelly,REP,470015,0,0,21,21,
Major,Superintendent of Public Instruction,Janet Costello Barresi,REP,470015,0,0,5,5,
Major,Superintendent of Public Instruction,Joy Hofmeister,REP,470015,0,4,86,90,
Major,Insurance Commissioner,Bill Viner,REP,470015,0,0,19,19,
Major,Insurance Commissioner,John Doak,REP,470015,0,4,84,88,
Major,Corporation Commissioner,Todd Hiett,REP,470015,0,2,54,56,
Major,Corporation Commissioner,Cliff Branan,REP,470015,0,2,51,53,
Major,U.S. Senate,Evelyn Rogers,REP,470015,0,0,9,9,
Major,U.S. Senate,Rob Moye,REP,470015,0,0,2,2,
Major,U.S. Senate,D. Jean Mcbride-Samuels,REP,470015,0,0,0,0,
Major,U.S. Senate,Jim Inhofe,REP,470015,0,4,93,97,
Major,U.S. Senate,Erick Paul Wyatt,REP,470015,0,0,8,8,
Major,U.S. Senate,Andy Craig,REP,470015,0,0,4,4,
Major,U.S. Senate,T. Shannon,REP,470015,0,2,43,45,
Major,U.S. Senate,Randy Brogdon,REP,470015,0,0,0,0,
Major,U.S. Senate,Eric Mccray,REP,470015,0,0,4,4,
Major,U.S. Senate,Kevin Crow,REP,470015,0,0,2,2,
Major,U.S. Senate,James Lankford,REP,470015,0,2,57,59,
Major,U.S. Senate,Jason Weger,REP,470015,0,0,0,0,
Major,U.S. House,Timothy Ray Murray,REP,470015,0,0,7,7,03
Major,U.S. House,Robert Hubbard,REP,470015,0,0,7,7,03
Major,U.S. House,Frank Lucas,REP,470015,0,4,97,101,03
Major,Superintendent of Public Instruction,John Cox,DEM,470016,0,0,4,4,
Major,Superintendent of Public Instruction,Jack Jr.,DEM,470016,0,0,0,0,
Major,Superintendent of Public Instruction,Ivan Holmes,DEM,470016,0,0,0,0,
Major,Superintendent of Public Instruction,Freda Deskin,DEM,470016,0,0,1,1,
Major,U.S. Senate,Patrick Michael Hayes,DEM,470016,0,0,2,2,
Major,U.S. Senate,Jim Rogers,DEM,470016,0,0,2,2,
Major,U.S. Senate,Connie Johnson,DEM,470016,0,0,1,1,
Major,Governor,Dax Ewbank,REP,470016,0,0,9,9,
Major,Governor,Chad Moody,REP,470016,0,0,5,5,
Major,Governor,Mary Fallin,REP,470016,0,1,37,38,
Major,Superintendent of Public Instruction,Brian Kelly,REP,470016,0,0,10,10,
Major,Superintendent of Public Instruction,Janet Costello Barresi,REP,470016,0,1,7,8,
Major,Superintendent of Public Instruction,Joy Hofmeister,REP,470016,0,0,33,33,
Major,Insurance Commissioner,Bill Viner,REP,470016,0,0,8,8,
Major,Insurance Commissioner,John Doak,REP,470016,0,1,41,42,
Major,Corporation Commissioner,Todd Hiett,REP,470016,0,1,25,26,
Major,Corporation Commissioner,Cliff Branan,REP,470016,0,0,25,25,
Major,U.S. Senate,Evelyn Rogers,REP,470016,0,0,3,3,
Major,U.S. Senate,Rob Moye,REP,470016,0,0,1,1,
Major,U.S. Senate,D. Jean Mcbride-Samuels,REP,470016,0,0,0,0,
Major,U.S. Senate,Jim Inhofe,REP,470016,0,1,44,45,
Major,U.S. Senate,Erick Paul Wyatt,REP,470016,0,0,3,3,
Major,U.S. Senate,Andy Craig,REP,470016,0,0,2,2,
Major,U.S. Senate,T. Shannon,REP,470016,0,1,17,18,
Major,U.S. Senate,Randy Brogdon,REP,470016,0,0,0,0,
Major,U.S. Senate,Eric Mccray,REP,470016,0,0,2,2,
Major,U.S. Senate,Kevin Crow,REP,470016,0,0,0,0,
Major,U.S. Senate,James Lankford,REP,470016,0,0,29,29,
Major,U.S. Senate,Jason Weger,REP,470016,0,0,0,0,
Major,U.S. House,Timothy Ray Murray,REP,470016,0,0,3,3,03
Major,U.S. House,Robert Hubbard,REP,470016,0,0,3,3,03
Major,U.S. House,Frank Lucas,REP,470016,0,1,45,46,03
Major,Superintendent of Public Instruction,John Cox,DEM,470020,2,2,25,29,
Major,Superintendent of Public Instruction,Jack Jr.,DEM,470020,3,1,8,12,
Major,Superintendent of Public Instruction,Ivan Holmes,DEM,470020,1,2,8,11,
Major,Superintendent of Public Instruction,Freda Deskin,DEM,470020,1,3,29,33,
Major,U.S. Senate,Patrick Michael Hayes,DEM,470020,3,1,21,25,
Major,U.S. Senate,Jim Rogers,DEM,470020,0,6,28,34,
Major,U.S. Senate,Connie Johnson,DEM,470020,4,1,17,22,
Major,Governor,Dax Ewbank,REP,470020,6,24,159,189,
Major,Governor,Chad Moody,REP,470020,0,4,44,48,
Major,Governor,Mary Fallin,REP,470020,14,40,230,284,
Major,Superintendent of Public Instruction,Brian Kelly,REP,470020,7,13,81,101,
Major,Superintendent of Public Instruction,Janet Costello Barresi,REP,470020,0,7,50,57,
Major,Superintendent of Public Instruction,Joy Hofmeister,REP,470020,12,50,301,363,
Major,Insurance Commissioner,Bill Viner,REP,470020,9,14,79,102,
Major,Insurance Commissioner,John Doak,REP,470020,11,51,326,388,
Major,Corporation Commissioner,Todd Hiett,REP,470020,12,42,250,304,
Major,Corporation Commissioner,Cliff Branan,REP,470020,8,24,171,203,
Major,U.S. Senate,Evelyn Rogers,REP,470020,1,6,14,21,
Major,U.S. Senate,Rob Moye,REP,470020,0,0,4,4,
Major,U.S. Senate,D. Jean Mcbride-Samuels,REP,470020,0,2,5,7,
Major,U.S. Senate,Jim Inhofe,REP,470020,16,59,376,451,
Major,U.S. Senate,Erick Paul Wyatt,REP,470020,2,3,35,40,
Major,U.S. Senate,Andy Craig,REP,470020,1,3,4,8,
Major,U.S. Senate,T. Shannon,REP,470020,7,25,143,175,
Major,U.S. Senate,Randy Brogdon,REP,470020,0,4,13,17,
Major,U.S. Senate,Eric Mccray,REP,470020,1,1,6,8,
Major,U.S. Senate,Kevin Crow,REP,470020,0,3,4,7,
Major,U.S. Senate,James Lankford,REP,470020,10,35,258,303,
Major,U.S. Senate,Jason Weger,REP,470020,1,0,3,4,
Major,U.S. House,Timothy Ray Murray,REP,470020,1,3,15,19,03
Major,U.S. House,Robert Hubbard,REP,470020,0,5,43,48,03
Major,U.S. House,Frank Lucas,REP,470020,19,61,375,455,03
Major,Superintendent of Public Instruction,John Cox,DEM,470022,0,8,21,29,
Major,Superintendent of Public Instruction,Jack Jr.,DEM,470022,1,3,5,9,
Major,Superintendent of Public Instruction,Ivan Holmes,DEM,470022,0,3,4,7,
Major,Superintendent of Public Instruction,Freda Deskin,DEM,470022,1,4,33,38,
Major,U.S. Senate,Patrick Michael Hayes,DEM,470022,1,6,16,23,
Major,U.S. Senate,Jim Rogers,DEM,470022,0,4,28,32,
Major,U.S. Senate,Connie Johnson,DEM,470022,1,8,16,25,
Major,Governor,Dax Ewbank,REP,470022,7,24,146,177,
Major,Governor,Chad Moody,REP,470022,1,8,33,42,
Major,Governor,Mary Fallin,REP,470022,5,29,133,167,
Major,Superintendent of Public Instruction,Brian Kelly,REP,470022,3,16,98,117,
Major,Superintendent of Public Instruction,Janet Costello Barresi,REP,470022,0,10,29,39,
Major,Superintendent of Public Instruction,Joy Hofmeister,REP,470022,8,34,181,223,
Major,Insurance Commissioner,Bill Viner,REP,470022,5,12,60,77,
Major,Insurance Commissioner,John Doak,REP,470022,7,46,233,286,
Major,Corporation Commissioner,Todd Hiett,REP,470022,6,33,182,221,
Major,Corporation Commissioner,Cliff Branan,REP,470022,6,27,118,151,
Major,U.S. Senate,Evelyn Rogers,REP,470022,1,2,16,19,
Major,U.S. Senate,Rob Moye,REP,470022,2,0,7,9,
Major,U.S. Senate,D. Jean Mcbride-Samuels,REP,470022,1,2,3,6,
Major,U.S. Senate,Jim Inhofe,REP,470022,7,46,256,309,
Major,U.S. Senate,Erick Paul Wyatt,REP,470022,1,10,21,32,
Major,U.S. Senate,Andy Craig,REP,470022,0,1,5,6,
Major,U.S. Senate,T. Shannon,REP,470022,6,16,111,133,
Major,U.S. Senate,Randy Brogdon,REP,470022,1,4,14,19,
Major,U.S. Senate,Eric Mccray,REP,470022,1,2,10,13,
Major,U.S. Senate,Kevin Crow,REP,470022,0,3,5,8,
Major,U.S. Senate,James Lankford,REP,470022,4,35,159,198,
Major,U.S. Senate,Jason Weger,REP,470022,0,0,2,2,
Major,U.S. House,Timothy Ray Murray,REP,470022,2,2,18,22,03
Major,U.S. House,Robert Hubbard,REP,470022,1,8,33,42,03
Major,U.S. House,Frank Lucas,REP,470022,9,49,255,313,03
Marshall,Superintendent of Public Instruction,John Cox,DEM,480101,2,12,80,94,
Marshall,Superintendent of Public Instruction,Jack Jr.,DEM,480101,1,0,18,19,
Marshall,Superintendent of Public Instruction,Ivan Holmes,DEM,480101,0,1,6,7,
Marshall,Superintendent of Public Instruction,Freda Deskin,DEM,480101,0,1,37,38,
Marshall,U.S. Senate,Patrick Michael Hayes,DEM,480101,1,3,35,39,
Marshall,U.S. Senate,Jim Rogers,DEM,480101,0,5,66,71,
Marshall,U.S. Senate,Connie Johnson,DEM,480101,2,5,28,35,
Marshall,U.S. House,Earl Everett,DEM,480101,0,8,86,94,02
Marshall,U.S. House,Joshua Harris-Till,DEM,480101,3,5,38,46,02
Marshall,Governor,Dax Ewbank,REP,480101,0,1,7,8,
Marshall,Governor,Chad Moody,REP,480101,0,0,11,11,
Marshall,Governor,Mary Fallin,REP,480101,0,2,55,57,
Marshall,Superintendent of Public Instruction,Brian Kelly,REP,480101,0,0,18,18,
Marshall,Superintendent of Public Instruction,Janet Costello Barresi,REP,480101,0,2,11,13,
Marshall,Superintendent of Public Instruction,Joy Hofmeister,REP,480101,0,1,44,45,
Marshall,Insurance Commissioner,Bill Viner,REP,480101,0,0,21,21,
Marshall,Insurance Commissioner,John Doak,REP,480101,0,1,48,49,
Marshall,Corporation Commissioner,Todd Hiett,REP,480101,0,2,46,48,
Marshall,Corporation Commissioner,Cliff Branan,REP,480101,0,0,20,20,
Marshall,U.S. Senate,Evelyn Rogers,REP,480101,0,0,1,1,
Marshall,U.S. Senate,Rob Moye,REP,480101,0,0,2,2,
Marshall,U.S. Senate,D. Jean Mcbride-Samuels,REP,480101,0,0,0,0,
Marshall,U.S. Senate,Jim Inhofe,REP,480101,0,3,66,69,
Marshall,U.S. Senate,Erick Paul Wyatt,REP,480101,0,0,3,3,
Marshall,U.S. Senate,Andy Craig,REP,480101,0,0,2,2,
Marshall,U.S. Senate,T. Shannon,REP,480101,0,1,25,26,
Marshall,U.S. Senate,Randy Brogdon,REP,480101,0,0,2,2,
Marshall,U.S. Senate,Eric Mccray,REP,480101,0,0,0,0,
Marshall,U.S. Senate,Kevin Crow,REP,480101,0,0,1,1,
Marshall,U.S. Senate,James Lankford,REP,480101,0,2,43,45,
Marshall,U.S. Senate,Jason Weger,REP,480101,0,0,1,1,
Marshall,U.S. House,Darrel Robertson,REP,480101,0,0,10,10,02
Marshall,U.S. House,Markwayne Mullin,REP,480101,0,3,64,67,02
Marshall,State House,Tommy Hardin,REP,480101,0,3,69,72,49
Marshall,State House,Kyle Reid Chatham,REP,480101,0,0,6,6,49
Marshall,Superintendent of Public Instruction,John Cox,DEM,480102,0,6,39,45,
Marshall,Superintendent of Public Instruction,Jack Jr.,DEM,480102,1,0,8,9,
Marshall,Superintendent of Public Instruction,Ivan Holmes,DEM,480102,0,0,2,2,
Marshall,Superintendent of Public Instruction,Freda Deskin,DEM,480102,0,1,26,27,
Marshall,U.S. Senate,Patrick Michael Hayes,DEM,480102,1,3,17,21,
Marshall,U.S. Senate,Jim Rogers,DEM,480102,0,3,28,31,
Marshall,U.S. Senate,Connie Johnson,DEM,480102,0,1,24,25,
Marshall,U.S. House,Earl Everett,DEM,480102,1,7,44,52,02
Marshall,U.S. House,Joshua Harris-Till,DEM,480102,0,0,24,24,02
Marshall,Governor,Dax Ewbank,REP,480102,0,1,4,5,
Marshall,Governor,Chad Moody,REP,480102,0,0,8,8,
Marshall,Governor,Mary Fallin,REP,480102,0,2,23,25,
Marshall,Superintendent of Public Instruction,Brian Kelly,REP,480102,0,1,7,8,
Marshall,Superintendent of Public Instruction,Janet Costello Barresi,REP,480102,0,1,6,7,
Marshall,Superintendent of Public Instruction,Joy Hofmeister,REP,480102,0,1,19,20,
Marshall,Insurance Commissioner,Bill Viner,REP,480102,0,1,3,4,
Marshall,Insurance Commissioner,John Doak,REP,480102,0,1,27,28,
Marshall,Corporation Commissioner,Todd Hiett,REP,480102,0,2,20,22,
Marshall,Corporation Commissioner,Cliff Branan,REP,480102,0,0,9,9,
Marshall,U.S. Senate,Evelyn Rogers,REP,480102,0,0,1,1,
Marshall,U.S. Senate,Rob Moye,REP,480102,0,0,1,1,
Marshall,U.S. Senate,D. Jean Mcbride-Samuels,REP,480102,0,0,0,0,
Marshall,U.S. Senate,Jim Inhofe,REP,480102,0,2,34,36,
Marshall,U.S. Senate,Erick Paul Wyatt,REP,480102,0,1,0,1,
Marshall,U.S. Senate,Andy Craig,REP,480102,0,0,0,0,
Marshall,U.S. Senate,T. Shannon,REP,480102,0,0,14,14,
Marshall,U.S. Senate,Randy Brogdon,REP,480102,0,0,0,0,
Marshall,U.S. Senate,Eric Mccray,REP,480102,0,0,0,0,
Marshall,U.S. Senate,Kevin Crow,REP,480102,0,1,1,2,
Marshall,U.S. Senate,James Lankford,REP,480102,0,2,16,18,
Marshall,U.S. Senate,Jason Weger,REP,480102,0,0,1,1,
Marshall,U.S. House,Darrel Robertson,REP,480102,0,0,5,5,02
Marshall,U.S. House,Markwayne Mullin,REP,480102,0,3,30,33,02
Marshall,State House,Tommy Hardin,REP,480102,0,2,33,35,49
Marshall,State House,Kyle Reid Chatham,REP,480102,0,1,3,4,49
Marshall,Superintendent of Public Instruction,John Cox,DEM,480105,0,1,43,44,
Marshall,Superintendent of Public Instruction,Jack Jr.,DEM,480105,0,0,6,6,
Marshall,Superintendent of Public Instruction,Ivan Holmes,DEM,480105,0,0,5,5,
Marshall,Superintendent of Public Instruction,Freda Deskin,DEM,480105,5,4,42,51,
Marshall,U.S. Senate,Patrick Michael Hayes,DEM,480105,0,0,16,16,
Marshall,U.S. Senate,Jim Rogers,DEM,480105,0,2,34,36,
Marshall,U.S. Senate,Connie Johnson,DEM,480105,5,3,37,45,
Marshall,U.S. House,Earl Everett,DEM,480105,5,4,46,55,02
Marshall,U.S. House,Joshua Harris-Till,DEM,480105,0,1,36,37,02
Marshall,Governor,Dax Ewbank,REP,480105,0,0,7,7,
Marshall,Governor,Chad Moody,REP,480105,0,0,7,7,
Marshall,Governor,Mary Fallin,REP,480105,7,0,25,32,
Marshall,Superintendent of Public Instruction,Brian Kelly,REP,480105,4,0,9,13,
Marshall,Superintendent of Public Instruction,Janet Costello Barresi,REP,480105,0,0,10,10,
Marshall,Superintendent of Public Instruction,Joy Hofmeister,REP,480105,3,0,16,19,
Marshall,Insurance Commissioner,Bill Viner,REP,480105,3,0,12,15,
Marshall,Insurance Commissioner,John Doak,REP,480105,4,0,17,21,
Marshall,Corporation Commissioner,Todd Hiett,REP,480105,4,0,15,19,
Marshall,Corporation Commissioner,Cliff Branan,REP,480105,3,0,11,14,
Marshall,U.S. Senate,Evelyn Rogers,REP,480105,0,0,1,1,
Marshall,U.S. Senate,Rob Moye,REP,480105,0,0,2,2,
Marshall,U.S. Senate,D. Jean Mcbride-Samuels,REP,480105,0,0,0,0,
Marshall,U.S. Senate,Jim Inhofe,REP,480105,7,0,21,28,
Marshall,U.S. Senate,Erick Paul Wyatt,REP,480105,0,0,11,11,
Marshall,U.S. Senate,Andy Craig,REP,480105,0,0,1,1,
Marshall,U.S. Senate,T. Shannon,REP,480105,2,0,14,16,
Marshall,U.S. Senate,Randy Brogdon,REP,480105,1,0,5,6,
Marshall,U.S. Senate,Eric Mccray,REP,480105,0,0,4,4,
Marshall,U.S. Senate,Kevin Crow,REP,480105,0,0,1,1,
Marshall,U.S. Senate,James Lankford,REP,480105,4,0,9,13,
Marshall,U.S. Senate,Jason Weger,REP,480105,0,0,1,1,
Marshall,U.S. House,Darrel Robertson,REP,480105,1,0,13,14,02
Marshall,U.S. House,Markwayne Mullin,REP,480105,6,0,22,28,02
Marshall,State House,Tommy Hardin,REP,480105,6,0,25,31,49
Marshall,State House,Kyle Reid Chatham,REP,480105,1,0,12,13,49
Marshall,Superintendent of Public Instruction,John Cox,DEM,480106,0,0,28,28,
Marshall,Superintendent of Public Instruction,Jack Jr.,DEM,480106,0,0,5,5,
Marshall,Superintendent of Public Instruction,Ivan Holmes,DEM,480106,0,0,3,3,
Marshall,Superintendent of Public Instruction,Freda Deskin,DEM,480106,0,1,18,19,
Marshall,U.S. Senate,Patrick Michael Hayes,DEM,480106,0,0,13,13,
Marshall,U.S. Senate,Jim Rogers,DEM,480106,0,1,17,18,
Marshall,U.S. Senate,Connie Johnson,DEM,480106,0,0,20,20,
Marshall,U.S. House,Earl Everett,DEM,480106,0,1,26,27,02
Marshall,U.S. House,Joshua Harris-Till,DEM,480106,0,0,20,20,02
Marshall,Governor,Dax Ewbank,REP,480106,0,0,2,2,
Marshall,Governor,Chad Moody,REP,480106,0,0,5,5,
Marshall,Governor,Mary Fallin,REP,480106,1,0,15,16,
Marshall,Superintendent of Public Instruction,Brian Kelly,REP,480106,0,0,9,9,
Marshall,Superintendent of Public Instruction,Janet Costello Barresi,REP,480106,0,0,8,8,
Marshall,Superintendent of Public Instruction,Joy Hofmeister,REP,480106,0,0,8,8,
Marshall,Insurance Commissioner,Bill Viner,REP,480106,0,0,10,10,
Marshall,Insurance Commissioner,John Doak,REP,480106,0,0,12,12,
Marshall,Corporation Commissioner,Todd Hiett,REP,480106,0,0,11,11,
Marshall,Corporation Commissioner,Cliff Branan,REP,480106,0,0,10,10,
Marshall,U.S. Senate,Evelyn Rogers,REP,480106,0,0,0,0,
Marshall,U.S. Senate,Rob Moye,REP,480106,0,0,0,0,
Marshall,U.S. Senate,D. Jean Mcbride-Samuels,REP,480106,0,0,1,1,
Marshall,U.S. Senate,Jim Inhofe,REP,480106,0,0,17,17,
Marshall,U.S. Senate,Erick Paul Wyatt,REP,480106,1,0,7,8,
Marshall,U.S. Senate,Andy Craig,REP,480106,0,0,1,1,
Marshall,U.S. Senate,T. Shannon,REP,480106,0,0,10,10,
Marshall,U.S. Senate,Randy Brogdon,REP,480106,0,0,2,2,
Marshall,U.S. Senate,Eric Mccray,REP,480106,0,0,2,2,
Marshall,U.S. Senate,Kevin Crow,REP,480106,0,0,2,2,
Marshall,U.S. Senate,James Lankford,REP,480106,1,0,7,8,
Marshall,U.S. Senate,Jason Weger,REP,480106,0,0,1,1,
Marshall,U.S. House,Darrel Robertson,REP,480106,0,0,9,9,02
Marshall,U.S. House,Markwayne Mullin,REP,480106,1,0,15,16,02
Marshall,State House,Tommy Hardin,REP,480106,0,0,23,23,49
Marshall,State House,Kyle Reid Chatham,REP,480106,0,0,2,2,49
Marshall,Superintendent of Public Instruction,John Cox,DEM,480201,0,1,33,34,
Marshall,Superintendent of Public Instruction,Jack Jr.,DEM,480201,0,0,7,7,
Marshall,Superintendent of Public Instruction,Ivan Holmes,DEM,480201,0,0,7,7,
Marshall,Superintendent of Public Instruction,Freda Deskin,DEM,480201,0,0,17,17,
Marshall,U.S. Senate,Patrick Michael Hayes,DEM,480201,0,0,10,10,
Marshall,U.S. Senate,Jim Rogers,DEM,480201,0,1,31,32,
Marshall,U.S. Senate,Connie Johnson,DEM,480201,0,0,20,20,
Marshall,U.S. House,Earl Everett,DEM,480201,0,1,40,41,02
Marshall,U.S. House,Joshua Harris-Till,DEM,480201,0,0,20,20,02
Marshall,Governor,Dax Ewbank,REP,480201,0,0,3,3,
Marshall,Governor,Chad Moody,REP,480201,0,0,4,4,
Marshall,Governor,Mary Fallin,REP,480201,1,3,31,35,
Marshall,Superintendent of Public Instruction,Brian Kelly,REP,480201,0,0,13,13,
Marshall,Superintendent of Public Instruction,Janet Costello Barresi,REP,480201,1,2,4,7,
Marshall,Superintendent of Public Instruction,Joy Hofmeister,REP,480201,0,1,19,20,
Marshall,Insurance Commissioner,Bill Viner,REP,480201,0,2,5,7,
Marshall,Insurance Commissioner,John Doak,REP,480201,1,1,32,34,
Marshall,Corporation Commissioner,Todd Hiett,REP,480201,0,3,26,29,
Marshall,Corporation Commissioner,Cliff Branan,REP,480201,0,0,11,11,
Marshall,U.S. Senate,Evelyn Rogers,REP,480201,0,0,0,0,
Marshall,U.S. Senate,Rob Moye,REP,480201,0,0,0,0,
Marshall,U.S. Senate,D. Jean Mcbride-Samuels,REP,480201,0,0,1,1,
Marshall,U.S. Senate,Jim Inhofe,REP,480201,2,4,37,43,
Marshall,U.S. Senate,Erick Paul Wyatt,REP,480201,0,0,0,0,
Marshall,U.S. Senate,Andy Craig,REP,480201,0,0,1,1,
Marshall,U.S. Senate,T. Shannon,REP,480201,0,0,12,12,
Marshall,U.S. Senate,Randy Brogdon,REP,480201,0,0,0,0,
Marshall,U.S. Senate,Eric Mccray,REP,480201,0,0,0,0,
Marshall,U.S. Senate,Kevin Crow,REP,480201,0,0,0,0,
Marshall,U.S. Senate,James Lankford,REP,480201,2,4,24,30,
Marshall,U.S. Senate,Jason Weger,REP,480201,0,0,0,0,
Marshall,U.S. House,Darrel Robertson,REP,480201,0,1,8,9,02
Marshall,U.S. House,Markwayne Mullin,REP,480201,2,3,30,35,02
Marshall,State House,Tommy Hardin,REP,480201,2,3,36,41,49
Marshall,State House,Kyle Reid Chatham,REP,480201,0,1,2,3,49
Marshall,Superintendent of Public Instruction,John Cox,DEM,480202,1,2,38,41,
Marshall,Superintendent of Public Instruction,Jack Jr.,DEM,480202,0,1,3,4,
Marshall,Superintendent of Public Instruction,Ivan Holmes,DEM,480202,0,1,6,7,
Marshall,Superintendent of Public Instruction,Freda Deskin,DEM,480202,0,2,28,30,
Marshall,U.S. Senate,Patrick Michael Hayes,DEM,480202,0,0,15,15,
Marshall,U.S. Senate,Jim Rogers,DEM,480202,0,2,24,26,
Marshall,U.S. Senate,Connie Johnson,DEM,480202,1,4,21,26,
Marshall,U.S. House,Earl Everett,DEM,480202,1,1,35,37,02
Marshall,U.S. House,Joshua Harris-Till,DEM,480202,0,5,23,28,02
Marshall,Governor,Dax Ewbank,REP,480202,0,0,4,4,
Marshall,Governor,Chad Moody,REP,480202,0,0,5,5,
Marshall,Governor,Mary Fallin,REP,480202,1,0,27,28,
Marshall,Superintendent of Public Instruction,Brian Kelly,REP,480202,0,0,9,9,
Marshall,Superintendent of Public Instruction,Janet Costello Barresi,REP,480202,0,0,5,5,
Marshall,Superintendent of Public Instruction,Joy Hofmeister,REP,480202,1,1,20,22,
Marshall,Insurance Commissioner,Bill Viner,REP,480202,1,0,5,6,
Marshall,Insurance Commissioner,John Doak,REP,480202,0,0,26,26,
Marshall,Corporation Commissioner,Todd Hiett,REP,480202,1,0,20,21,
Marshall,Corporation Commissioner,Cliff Branan,REP,480202,0,0,12,12,
Marshall,U.S. Senate,Evelyn Rogers,REP,480202,0,0,1,1,
Marshall,U.S. Senate,Rob Moye,REP,480202,0,0,1,1,
Marshall,U.S. Senate,D. Jean Mcbride-Samuels,REP,480202,0,0,1,1,
Marshall,U.S. Senate,Jim Inhofe,REP,480202,1,0,30,31,
Marshall,U.S. Senate,Erick Paul Wyatt,REP,480202,0,0,1,1,
Marshall,U.S. Senate,Andy Craig,REP,480202,0,0,3,3,
Marshall,U.S. Senate,T. Shannon,REP,480202,0,0,11,11,
Marshall,U.S. Senate,Randy Brogdon,REP,480202,0,0,0,0,
Marshall,U.S. Senate,Eric Mccray,REP,480202,0,0,0,0,
Marshall,U.S. Senate,Kevin Crow,REP,480202,0,0,0,0,
Marshall,U.S. Senate,James Lankford,REP,480202,0,0,19,19,
Marshall,U.S. Senate,Jason Weger,REP,480202,1,0,0,1,
Marshall,U.S. House,Darrel Robertson,REP,480202,0,0,5,5,02
Marshall,U.S. House,Markwayne Mullin,REP,480202,1,1,29,31,02
Marshall,State House,Tommy Hardin,REP,480202,1,1,34,36,49
Marshall,State House,Kyle Reid Chatham,REP,480202,0,0,2,2,49
Marshall,Superintendent of Public Instruction,John Cox,DEM,480204,5,0,57,62,
Marshall,Superintendent of Public Instruction,Jack Jr.,DEM,480204,0,1,11,12,
Marshall,Superintendent of Public Instruction,Ivan Holmes,DEM,480204,0,1,7,8,
Marshall,Superintendent of Public Instruction,Freda Deskin,DEM,480204,0,0,25,25,
Marshall,U.S. Senate,Patrick Michael Hayes,DEM,480204,3,1,26,30,
Marshall,U.S. Senate,Jim Rogers,DEM,480204,1,1,37,39,
Marshall,U.S. Senate,Connie Johnson,DEM,480204,0,0,27,27,
Marshall,U.S. House,Earl Everett,DEM,480204,3,0,49,52,02
Marshall,U.S. House,Joshua Harris-Till,DEM,480204,1,2,36,39,02
Marshall,Governor,Dax Ewbank,REP,480204,1,0,7,8,
Marshall,Governor,Chad Moody,REP,480204,0,4,20,24,
Marshall,Governor,Mary Fallin,REP,480204,0,5,44,49,
Marshall,Superintendent of Public Instruction,Brian Kelly,REP,480204,1,4,22,27,
Marshall,Superintendent of Public Instruction,Janet Costello Barresi,REP,480204,0,0,7,7,
Marshall,Superintendent of Public Instruction,Joy Hofmeister,REP,480204,0,5,38,43,
Marshall,Insurance Commissioner,Bill Viner,REP,480204,1,3,13,17,
Marshall,Insurance Commissioner,John Doak,REP,480204,0,6,51,57,
Marshall,Corporation Commissioner,Todd Hiett,REP,480204,1,4,49,54,
Marshall,Corporation Commissioner,Cliff Branan,REP,480204,0,2,15,17,
Marshall,U.S. Senate,Evelyn Rogers,REP,480204,0,1,3,4,
Marshall,U.S. Senate,Rob Moye,REP,480204,0,0,1,1,
Marshall,U.S. Senate,D. Jean Mcbride-Samuels,REP,480204,0,0,1,1,
Marshall,U.S. Senate,Jim Inhofe,REP,480204,1,3,62,66,
Marshall,U.S. Senate,Erick Paul Wyatt,REP,480204,0,4,5,9,
Marshall,U.S. Senate,Andy Craig,REP,480204,1,1,2,4,
Marshall,U.S. Senate,T. Shannon,REP,480204,0,3,28,31,
Marshall,U.S. Senate,Randy Brogdon,REP,480204,0,1,4,5,
Marshall,U.S. Senate,Eric Mccray,REP,480204,0,0,0,0,
Marshall,U.S. Senate,Kevin Crow,REP,480204,0,0,0,0,
Marshall,U.S. Senate,James Lankford,REP,480204,0,3,34,37,
Marshall,U.S. Senate,Jason Weger,REP,480204,0,1,2,3,
Marshall,U.S. House,Darrel Robertson,REP,480204,0,2,13,15,02
Marshall,U.S. House,Markwayne Mullin,REP,480204,1,7,57,65,02
Marshall,State House,Tommy Hardin,REP,480204,1,8,67,76,49
Marshall,State House,Kyle Reid Chatham,REP,480204,0,1,4,5,49
Marshall,Superintendent of Public Instruction,John Cox,DEM,480206,0,1,22,23,
Marshall,Superintendent of Public Instruction,Jack Jr.,DEM,480206,0,1,9,10,
Marshall,Superintendent of Public Instruction,Ivan Holmes,DEM,480206,0,0,6,6,
Marshall,Superintendent of Public Instruction,Freda Deskin,DEM,480206,1,1,27,29,
Marshall,U.S. Senate,Patrick Michael Hayes,DEM,480206,0,0,21,21,
Marshall,U.S. Senate,Jim Rogers,DEM,480206,1,1,24,26,
Marshall,U.S. Senate,Connie Johnson,DEM,480206,0,2,17,19,
Marshall,U.S. House,Earl Everett,DEM,480206,1,2,37,40,02
Marshall,U.S. House,Joshua Harris-Till,DEM,480206,0,0,25,25,02
Marshall,Governor,Dax Ewbank,REP,480206,0,1,4,5,
Marshall,Governor,Chad Moody,REP,480206,0,0,9,9,
Marshall,Governor,Mary Fallin,REP,480206,4,0,24,28,
Marshall,Superintendent of Public Instruction,Brian Kelly,REP,480206,3,1,15,19,
Marshall,Superintendent of Public Instruction,Janet Costello Barresi,REP,480206,0,0,1,1,
Marshall,Superintendent of Public Instruction,Joy Hofmeister,REP,480206,1,0,19,20,
Marshall,Insurance Commissioner,Bill Viner,REP,480206,2,0,12,14,
Marshall,Insurance Commissioner,John Doak,REP,480206,2,1,21,24,
Marshall,Corporation Commissioner,Todd Hiett,REP,480206,0,1,15,16,
Marshall,Corporation Commissioner,Cliff Branan,REP,480206,4,0,19,23,
Marshall,U.S. Senate,Evelyn Rogers,REP,480206,0,0,1,1,
Marshall,U.S. Senate,Rob Moye,REP,480206,0,0,2,2,
Marshall,U.S. Senate,D. Jean Mcbride-Samuels,REP,480206,0,0,0,0,
Marshall,U.S. Senate,Jim Inhofe,REP,480206,5,1,32,38,
Marshall,U.S. Senate,Erick Paul Wyatt,REP,480206,0,0,3,3,
Marshall,U.S. Senate,Andy Craig,REP,480206,2,0,5,7,
Marshall,U.S. Senate,T. Shannon,REP,480206,2,0,13,15,
Marshall,U.S. Senate,Randy Brogdon,REP,480206,0,1,1,2,
Marshall,U.S. Senate,Eric Mccray,REP,480206,0,0,1,1,
Marshall,U.S. Senate,Kevin Crow,REP,480206,0,0,1,1,
Marshall,U.S. Senate,James Lankford,REP,480206,1,0,15,16,
Marshall,U.S. Senate,Jason Weger,REP,480206,0,0,0,0,
Marshall,U.S. House,Darrel Robertson,REP,480206,0,0,11,11,02
Marshall,U.S. House,Markwayne Mullin,REP,480206,5,1,27,33,02
Marshall,State House,Tommy Hardin,REP,480206,4,0,35,39,49
Marshall,State House,Kyle Reid Chatham,REP,480206,0,1,3,4,49
Marshall,Superintendent of Public Instruction,John Cox,DEM,480302,4,1,42,47,
Marshall,Superintendent of Public Instruction,Jack Jr.,DEM,480302,0,1,7,8,
Marshall,Superintendent of Public Instruction,Ivan Holmes,DEM,480302,0,0,5,5,
Marshall,Superintendent of Public Instruction,Freda Deskin,DEM,480302,1,1,23,25,
Marshall,U.S. Senate,Patrick Michael Hayes,DEM,480302,2,1,22,25,
Marshall,U.S. Senate,Jim Rogers,DEM,480302,0,0,22,22,
Marshall,U.S. Senate,Connie Johnson,DEM,480302,3,1,23,27,
Marshall,U.S. House,Earl Everett,DEM,480302,2,2,45,49,02
Marshall,U.S. House,Joshua Harris-Till,DEM,480302,3,0,19,22,02
Marshall,Governor,Dax Ewbank,REP,480302,0,0,6,6,
Marshall,Governor,Chad Moody,REP,480302,1,0,15,16,
Marshall,Governor,Mary Fallin,REP,480302,1,2,38,41,
Marshall,Superintendent of Public Instruction,Brian Kelly,REP,480302,1,0,14,15,
Marshall,Superintendent of Public Instruction,Janet Costello Barresi,REP,480302,1,2,13,16,
Marshall,Superintendent of Public Instruction,Joy Hofmeister,REP,480302,0,0,30,30,
Marshall,Insurance Commissioner,Bill Viner,REP,480302,0,0,16,16,
Marshall,Insurance Commissioner,John Doak,REP,480302,2,2,38,42,
Marshall,Corporation Commissioner,Todd Hiett,REP,480302,0,1,36,37,
Marshall,Corporation Commissioner,Cliff Branan,REP,480302,1,1,17,19,
Marshall,U.S. Senate,Evelyn Rogers,REP,480302,1,0,4,5,
Marshall,U.S. Senate,Rob Moye,REP,480302,0,0,2,2,
Marshall,U.S. Senate,D. Jean Mcbride-Samuels,REP,480302,0,0,2,2,
Marshall,U.S. Senate,Jim Inhofe,REP,480302,1,2,43,46,
Marshall,U.S. Senate,Erick Paul Wyatt,REP,480302,0,0,9,9,
Marshall,U.S. Senate,Andy Craig,REP,480302,1,0,1,2,
Marshall,U.S. Senate,T. Shannon,REP,480302,0,0,15,15,
Marshall,U.S. Senate,Randy Brogdon,REP,480302,0,0,2,2,
Marshall,U.S. Senate,Eric Mccray,REP,480302,0,0,1,1,
Marshall,U.S. Senate,Kevin Crow,REP,480302,0,0,0,0,
Marshall,U.S. Senate,James Lankford,REP,480302,1,2,37,40,
Marshall,U.S. Senate,Jason Weger,REP,480302,0,0,0,0,
Marshall,U.S. House,Darrel Robertson,REP,480302,1,0,17,18,02
Marshall,U.S. House,Markwayne Mullin,REP,480302,0,2,43,45,02
Marshall,State House,Tommy Hardin,REP,480302,0,2,47,49,49
Marshall,State House,Kyle Reid Chatham,REP,480302,1,0,13,14,49
Marshall,Superintendent of Public Instruction,John Cox,DEM,480303,0,2,61,63,
Marshall,Superintendent of Public Instruction,Jack Jr.,DEM,480303,0,0,15,15,
Marshall,Superintendent of Public Instruction,Ivan Holmes,DEM,480303,0,1,5,6,
Marshall,Superintendent of Public Instruction,Freda Deskin,DEM,480303,0,2,48,50,
Marshall,U.S. Senate,Patrick Michael Hayes,DEM,480303,0,0,29,29,
Marshall,U.S. Senate,Jim Rogers,DEM,480303,0,3,54,57,
Marshall,U.S. Senate,Connie Johnson,DEM,480303,0,2,40,42,
Marshall,U.S. House,Earl Everett,DEM,480303,0,4,62,66,02
Marshall,U.S. House,Joshua Harris-Till,DEM,480303,0,1,55,56,02
Marshall,Governor,Dax Ewbank,REP,480303,0,1,14,15,
Marshall,Governor,Chad Moody,REP,480303,0,0,25,25,
Marshall,Governor,Mary Fallin,REP,480303,2,7,71,80,
Marshall,Superintendent of Public Instruction,Brian Kelly,REP,480303,0,3,38,41,
Marshall,Superintendent of Public Instruction,Janet Costello Barresi,REP,480303,1,3,28,32,
Marshall,Superintendent of Public Instruction,Joy Hofmeister,REP,480303,0,2,43,45,
Marshall,Insurance Commissioner,Bill Viner,REP,480303,0,5,38,43,
Marshall,Insurance Commissioner,John Doak,REP,480303,0,3,70,73,
Marshall,Corporation Commissioner,Todd Hiett,REP,480303,0,6,56,62,
Marshall,Corporation Commissioner,Cliff Branan,REP,480303,0,2,46,48,
Marshall,U.S. Senate,Evelyn Rogers,REP,480303,0,0,12,12,
Marshall,U.S. Senate,Rob Moye,REP,480303,0,0,3,3,
Marshall,U.S. Senate,D. Jean Mcbride-Samuels,REP,480303,0,0,3,3,
Marshall,U.S. Senate,Jim Inhofe,REP,480303,2,7,82,91,
Marshall,U.S. Senate,Erick Paul Wyatt,REP,480303,0,1,11,12,
Marshall,U.S. Senate,Andy Craig,REP,480303,0,0,5,5,
Marshall,U.S. Senate,T. Shannon,REP,480303,2,4,39,45,
Marshall,U.S. Senate,Randy Brogdon,REP,480303,0,0,6,6,
Marshall,U.S. Senate,Eric Mccray,REP,480303,0,0,3,3,
Marshall,U.S. Senate,Kevin Crow,REP,480303,0,0,3,3,
Marshall,U.S. Senate,James Lankford,REP,480303,0,4,51,55,
Marshall,U.S. Senate,Jason Weger,REP,480303,0,0,4,4,
Marshall,U.S. House,Darrel Robertson,REP,480303,0,4,39,43,02
Marshall,U.S. House,Markwayne Mullin,REP,480303,2,4,74,80,02
Marshall,State House,Tommy Hardin,REP,480303,0,8,83,91,49
Marshall,State House,Kyle Reid Chatham,REP,480303,2,0,27,29,49
Marshall,Superintendent of Public Instruction,John Cox,DEM,480304,1,5,71,77,
Marshall,Superintendent of Public Instruction,Jack Jr.,DEM,480304,0,1,43,44,
Marshall,Superintendent of Public Instruction,Ivan Holmes,DEM,480304,0,0,9,9,
Marshall,Superintendent of Public Instruction,Freda Deskin,DEM,480304,0,0,89,89,
Marshall,U.S. Senate,Patrick Michael Hayes,DEM,480304,0,1,37,38,
Marshall,U.S. Senate,Jim Rogers,DEM,480304,0,2,79,81,
Marshall,U.S. Senate,Connie Johnson,DEM,480304,1,2,91,94,
Marshall,U.S. House,Earl Everett,DEM,480304,0,3,125,128,02
Marshall,U.S. House,Joshua Harris-Till,DEM,480304,1,1,69,71,02
Marshall,Governor,Dax Ewbank,REP,480304,0,1,6,7,
Marshall,Governor,Chad Moody,REP,480304,1,2,25,28,
Marshall,Governor,Mary Fallin,REP,480304,2,7,102,111,
Marshall,Superintendent of Public Instruction,Brian Kelly,REP,480304,1,4,50,55,
Marshall,Superintendent of Public Instruction,Janet Costello Barresi,REP,480304,2,1,41,44,
Marshall,Superintendent of Public Instruction,Joy Hofmeister,REP,480304,0,5,36,41,
Marshall,Insurance Commissioner,Bill Viner,REP,480304,1,6,44,51,
Marshall,Insurance Commissioner,John Doak,REP,480304,1,4,78,83,
Marshall,Corporation Commissioner,Todd Hiett,REP,480304,1,7,72,80,
Marshall,Corporation Commissioner,Cliff Branan,REP,480304,1,3,45,49,
Marshall,U.S. Senate,Evelyn Rogers,REP,480304,1,1,10,12,
Marshall,U.S. Senate,Rob Moye,REP,480304,0,0,3,3,
Marshall,U.S. Senate,D. Jean Mcbride-Samuels,REP,480304,0,0,3,3,
Marshall,U.S. Senate,Jim Inhofe,REP,480304,2,9,109,120,
Marshall,U.S. Senate,Erick Paul Wyatt,REP,480304,0,0,7,7,
Marshall,U.S. Senate,Andy Craig,REP,480304,0,1,2,3,
Marshall,U.S. Senate,T. Shannon,REP,480304,1,4,41,46,
Marshall,U.S. Senate,Randy Brogdon,REP,480304,0,0,3,3,
Marshall,U.S. Senate,Eric Mccray,REP,480304,0,1,8,9,
Marshall,U.S. Senate,Kevin Crow,REP,480304,0,0,12,12,
Marshall,U.S. Senate,James Lankford,REP,480304,2,4,60,66,
Marshall,U.S. Senate,Jason Weger,REP,480304,0,0,1,1,
Marshall,U.S. House,Darrel Robertson,REP,480304,1,3,28,32,02
Marshall,U.S. House,Markwayne Mullin,REP,480304,2,7,101,110,02
Marshall,State House,Tommy Hardin,REP,480304,2,8,108,118,49
Marshall,State House,Kyle Reid Chatham,REP,480304,1,2,25,28,49
Mayes,Superintendent of Public Instruction,John Cox,DEM,490011,0,1,46,47,
Mayes,Superintendent of Public Instruction,Jack Jr.,DEM,490011,0,0,11,11,
Mayes,Superintendent of Public Instruction,Ivan Holmes,DEM,490011,0,0,4,4,
Mayes,Superintendent of Public Instruction,Freda Deskin,DEM,490011,0,0,24,24,
Mayes,U.S. Senate,Patrick Michael Hayes,DEM,490011,0,1,27,28,
Mayes,U.S. Senate,Jim Rogers,DEM,490011,0,0,30,30,
Mayes,U.S. Senate,Connie Johnson,DEM,490011,0,0,27,27,
Mayes,U.S. House,Earl Everett,DEM,490011,0,1,46,47,02
Mayes,U.S. House,Joshua Harris-Till,DEM,490011,0,0,34,34,02
Mayes,Governor,Dax Ewbank,REP,490011,0,0,9,9,
Mayes,Governor,Chad Moody,REP,490011,0,0,10,10,
Mayes,Governor,Mary Fallin,REP,490011,2,2,92,96,
Mayes,Superintendent of Public Instruction,Brian Kelly,REP,490011,2,0,24,26,
Mayes,Superintendent of Public Instruction,Janet Costello Barresi,REP,490011,1,0,24,25,
Mayes,Superintendent of Public Instruction,Joy Hofmeister,REP,490011,0,2,64,66,
Mayes,Insurance Commissioner,Bill Viner,REP,490011,1,1,24,26,
Mayes,Insurance Commissioner,John Doak,REP,490011,0,1,84,85,
Mayes,Corporation Commissioner,Todd Hiett,REP,490011,1,1,56,58,
Mayes,Corporation Commissioner,Cliff Branan,REP,490011,1,1,53,55,
Mayes,U.S. Senate,Evelyn Rogers,REP,490011,0,0,6,6,
Mayes,U.S. Senate,Rob Moye,REP,490011,0,0,1,1,
Mayes,U.S. Senate,D. Jean Mcbride-Samuels,REP,490011,0,0,0,0,
Mayes,U.S. Senate,Jim Inhofe,REP,490011,3,2,98,103,
Mayes,U.S. Senate,Erick Paul Wyatt,REP,490011,0,0,6,6,
Mayes,U.S. Senate,Andy Craig,REP,490011,0,0,1,1,
Mayes,U.S. Senate,T. Shannon,REP,490011,1,1,55,57,
Mayes,U.S. Senate,Randy Brogdon,REP,490011,2,0,8,10,
Mayes,U.S. Senate,Eric Mccray,REP,490011,0,0,1,1,
Mayes,U.S. Senate,Kevin Crow,REP,490011,0,0,1,1,
Mayes,U.S. Senate,James Lankford,REP,490011,0,1,44,45,
Mayes,U.S. Senate,Jason Weger,REP,490011,0,0,2,2,
Mayes,U.S. House,Darrel Robertson,REP,490011,0,0,11,11,02
Mayes,U.S. House,Markwayne Mullin,REP,490011,2,2,100,104,02
Mayes,Superintendent of Public Instruction,John Cox,DEM,490012,0,9,76,85,
Mayes,Superintendent of Public Instruction,Jack Jr.,DEM,490012,0,1,7,8,
Mayes,Superintendent of Public Instruction,Ivan Holmes,DEM,490012,0,0,4,4,
Mayes,Superintendent of Public Instruction,Freda Deskin,DEM,490012,2,0,18,20,
Mayes,U.S. Senate,Patrick Michael Hayes,DEM,490012,0,2,33,35,
Mayes,U.S. Senate,Jim Rogers,DEM,490012,0,6,52,58,
Mayes,U.S. Senate,Connie Johnson,DEM,490012,2,0,16,18,
Mayes,U.S. House,Earl Everett,DEM,490012,1,5,57,63,02
Mayes,U.S. House,Joshua Harris-Till,DEM,490012,1,3,39,43,02
Mayes,Governor,Dax Ewbank,REP,490012,1,0,4,5,
Mayes,Governor,Chad Moody,REP,490012,0,0,23,23,
Mayes,Governor,Mary Fallin,REP,490012,3,6,63,72,
Mayes,Superintendent of Public Instruction,Brian Kelly,REP,490012,0,0,22,22,
Mayes,Superintendent of Public Instruction,Janet Costello Barresi,REP,490012,2,2,8,12,
Mayes,Superintendent of Public Instruction,Joy Hofmeister,REP,490012,2,4,56,62,
Mayes,Insurance Commissioner,Bill Viner,REP,490012,0,0,28,28,
Mayes,Insurance Commissioner,John Doak,REP,490012,4,6,53,63,
Mayes,Corporation Commissioner,Todd Hiett,REP,490012,2,5,46,53,
Mayes,Corporation Commissioner,Cliff Branan,REP,490012,2,1,40,43,
Mayes,U.S. Senate,Evelyn Rogers,REP,490012,1,0,2,3,
Mayes,U.S. Senate,Rob Moye,REP,490012,0,0,2,2,
Mayes,U.S. Senate,D. Jean Mcbride-Samuels,REP,490012,0,0,2,2,
Mayes,U.S. Senate,Jim Inhofe,REP,490012,3,6,74,83,
Mayes,U.S. Senate,Erick Paul Wyatt,REP,490012,0,0,9,9,
Mayes,U.S. Senate,Andy Craig,REP,490012,1,0,4,5,
Mayes,U.S. Senate,T. Shannon,REP,490012,1,1,43,45,
Mayes,U.S. Senate,Randy Brogdon,REP,490012,1,0,3,4,
Mayes,U.S. Senate,Eric Mccray,REP,490012,0,0,1,1,
Mayes,U.S. Senate,Kevin Crow,REP,490012,0,0,1,1,
Mayes,U.S. Senate,James Lankford,REP,490012,1,5,36,42,
Mayes,U.S. Senate,Jason Weger,REP,490012,0,0,1,1,
Mayes,U.S. House,Darrel Robertson,REP,490012,1,0,9,10,02
Mayes,U.S. House,Markwayne Mullin,REP,490012,3,6,79,88,02
Mayes,Superintendent of Public Instruction,John Cox,DEM,490014,0,0,17,17,
Mayes,Superintendent of Public Instruction,Jack Jr.,DEM,490014,0,0,3,3,
Mayes,Superintendent of Public Instruction,Ivan Holmes,DEM,490014,0,0,1,1,
Mayes,Superintendent of Public Instruction,Freda Deskin,DEM,490014,0,1,9,10,
Mayes,U.S. Senate,Patrick Michael Hayes,DEM,490014,0,0,8,8,
Mayes,U.S. Senate,Jim Rogers,DEM,490014,0,0,10,10,
Mayes,U.S. Senate,Connie Johnson,DEM,490014,0,1,12,13,
Mayes,U.S. House,Earl Everett,DEM,490014,0,1,14,15,02
Mayes,U.S. House,Joshua Harris-Till,DEM,490014,0,0,15,15,02
Mayes,Governor,Dax Ewbank,REP,490014,0,0,3,3,
Mayes,Governor,Chad Moody,REP,490014,0,0,3,3,
Mayes,Governor,Mary Fallin,REP,490014,0,0,18,18,
Mayes,Superintendent of Public Instruction,Brian Kelly,REP,490014,0,0,6,6,
Mayes,Superintendent of Public Instruction,Janet Costello Barresi,REP,490014,0,0,1,1,
Mayes,Superintendent of Public Instruction,Joy Hofmeister,REP,490014,0,0,18,18,
Mayes,Insurance Commissioner,Bill Viner,REP,490014,0,0,3,3,
Mayes,Insurance Commissioner,John Doak,REP,490014,0,0,19,19,
Mayes,Corporation Commissioner,Todd Hiett,REP,490014,0,0,10,10,
Mayes,Corporation Commissioner,Cliff Branan,REP,490014,0,0,13,13,
Mayes,U.S. Senate,Evelyn Rogers,REP,490014,0,0,1,1,
Mayes,U.S. Senate,Rob Moye,REP,490014,0,0,0,0,
Mayes,U.S. Senate,D. Jean Mcbride-Samuels,REP,490014,0,0,1,1,
Mayes,U.S. Senate,Jim Inhofe,REP,490014,0,0,20,20,
Mayes,U.S. Senate,Erick Paul Wyatt,REP,490014,0,0,3,3,
Mayes,U.S. Senate,Andy Craig,REP,490014,0,0,0,0,
Mayes,U.S. Senate,T. Shannon,REP,490014,0,0,9,9,
Mayes,U.S. Senate,Randy Brogdon,REP,490014,0,0,0,0,
Mayes,U.S. Senate,Eric Mccray,REP,490014,0,0,0,0,
Mayes,U.S. Senate,Kevin Crow,REP,490014,0,0,0,0,
Mayes,U.S. Senate,James Lankford,REP,490014,0,0,16,16,
Mayes,U.S. Senate,Jason Weger,REP,490014,0,0,0,0,
Mayes,U.S. House,Darrel Robertson,REP,490014,0,0,4,4,02
Mayes,U.S. House,Markwayne Mullin,REP,490014,0,0,20,20,02
Mayes,Superintendent of Public Instruction,John Cox,DEM,490015,2,7,45,54,
Mayes,Superintendent of Public Instruction,Jack Jr.,DEM,490015,0,0,1,1,
Mayes,Superintendent of Public Instruction,Ivan Holmes,DEM,490015,0,0,3,3,
Mayes,Superintendent of Public Instruction,Freda Deskin,DEM,490015,0,0,23,23,
Mayes,U.S. Senate,Patrick Michael Hayes,DEM,490015,0,1,17,18,
Mayes,U.S. Senate,Jim Rogers,DEM,490015,1,2,24,27,
Mayes,U.S. Senate,Connie Johnson,DEM,490015,1,2,30,33,
Mayes,U.S. House,Earl Everett,DEM,490015,1,3,35,39,02
Mayes,U.S. House,Joshua Harris-Till,DEM,490015,1,2,33,36,02
Mayes,Governor,Dax Ewbank,REP,490015,2,0,3,5,
Mayes,Governor,Chad Moody,REP,490015,0,4,12,16,
Mayes,Governor,Mary Fallin,REP,490015,1,12,45,58,
Mayes,Superintendent of Public Instruction,Brian Kelly,REP,490015,2,1,13,16,
Mayes,Superintendent of Public Instruction,Janet Costello Barresi,REP,490015,0,4,9,13,
Mayes,Superintendent of Public Instruction,Joy Hofmeister,REP,490015,1,11,38,50,
Mayes,Insurance Commissioner,Bill Viner,REP,490015,0,6,19,25,
Mayes,Insurance Commissioner,John Doak,REP,490015,3,10,37,50,
Mayes,Corporation Commissioner,Todd Hiett,REP,490015,3,7,29,39,
Mayes,Corporation Commissioner,Cliff Branan,REP,490015,0,9,26,35,
Mayes,U.S. Senate,Evelyn Rogers,REP,490015,0,0,5,5,
Mayes,U.S. Senate,Rob Moye,REP,490015,0,0,2,2,
Mayes,U.S. Senate,D. Jean Mcbride-Samuels,REP,490015,0,0,2,2,
Mayes,U.S. Senate,Jim Inhofe,REP,490015,3,16,44,63,
Mayes,U.S. Senate,Erick Paul Wyatt,REP,490015,0,0,8,8,
Mayes,U.S. Senate,Andy Craig,REP,490015,0,0,2,2,
Mayes,U.S. Senate,T. Shannon,REP,490015,3,6,26,35,
Mayes,U.S. Senate,Randy Brogdon,REP,490015,0,0,7,7,
Mayes,U.S. Senate,Eric Mccray,REP,490015,0,0,0,0,
Mayes,U.S. Senate,Kevin Crow,REP,490015,0,0,1,1,
Mayes,U.S. Senate,James Lankford,REP,490015,0,10,25,35,
Mayes,U.S. Senate,Jason Weger,REP,490015,0,0,0,0,
Mayes,U.S. House,Darrel Robertson,REP,490015,0,4,12,16,02
Mayes,U.S. House,Markwayne Mullin,REP,490015,3,12,49,64,02
Mayes,Superintendent of Public Instruction,John Cox,DEM,490016,3,12,53,68,
Mayes,Superintendent of Public Instruction,Jack Jr.,DEM,490016,0,1,1,2,
Mayes,Superintendent of Public Instruction,Ivan Holmes,DEM,490016,0,0,7,7,
Mayes,Superintendent of Public Instruction,Freda Deskin,DEM,490016,1,0,4,5,
Mayes,U.S. Senate,Patrick Michael Hayes,DEM,490016,1,3,15,19,
Mayes,U.S. Senate,Jim Rogers,DEM,490016,2,4,23,29,
Mayes,U.S. Senate,Connie Johnson,DEM,490016,1,5,22,28,
Mayes,U.S. House,Earl Everett,DEM,490016,1,6,25,32,02
Mayes,U.S. House,Joshua Harris-Till,DEM,490016,3,7,32,42,02
Mayes,Governor,Dax Ewbank,REP,490016,0,3,7,10,
Mayes,Governor,Chad Moody,REP,490016,1,2,9,12,
Mayes,Governor,Mary Fallin,REP,490016,2,9,27,38,
Mayes,Superintendent of Public Instruction,Brian Kelly,REP,490016,1,5,8,14,
Mayes,Superintendent of Public Instruction,Janet Costello Barresi,REP,490016,1,1,1,3,
Mayes,Superintendent of Public Instruction,Joy Hofmeister,REP,490016,0,8,33,41,
Mayes,Insurance Commissioner,Bill Viner,REP,490016,0,2,10,12,
Mayes,Insurance Commissioner,John Doak,REP,490016,3,10,27,40,
Mayes,Corporation Commissioner,Todd Hiett,REP,490016,2,6,21,29,
Mayes,Corporation Commissioner,Cliff Branan,REP,490016,0,6,18,24,
Mayes,U.S. Senate,Evelyn Rogers,REP,490016,0,0,2,2,
Mayes,U.S. Senate,Rob Moye,REP,490016,0,0,0,0,
Mayes,U.S. Senate,D. Jean Mcbride-Samuels,REP,490016,0,0,0,0,
Mayes,U.S. Senate,Jim Inhofe,REP,490016,3,14,39,56,
Mayes,U.S. Senate,Erick Paul Wyatt,REP,490016,0,0,0,0,
Mayes,U.S. Senate,Andy Craig,REP,490016,0,0,1,1,
Mayes,U.S. Senate,T. Shannon,REP,490016,2,5,22,29,
Mayes,U.S. Senate,Randy Brogdon,REP,490016,0,2,2,4,
Mayes,U.S. Senate,Eric Mccray,REP,490016,0,0,1,1,
Mayes,U.S. Senate,Kevin Crow,REP,490016,0,0,0,0,
Mayes,U.S. Senate,James Lankford,REP,490016,1,7,16,24,
Mayes,U.S. Senate,Jason Weger,REP,490016,0,0,0,0,
Mayes,U.S. House,Darrel Robertson,REP,490016,0,4,4,8,02
Mayes,U.S. House,Markwayne Mullin,REP,490016,3,10,38,51,02
Mayes,Superintendent of Public Instruction,John Cox,DEM,490020,3,9,115,127,
Mayes,Superintendent of Public Instruction,Jack Jr.,DEM,490020,1,0,14,15,
Mayes,Superintendent of Public Instruction,Ivan Holmes,DEM,490020,0,1,3,4,
Mayes,Superintendent of Public Instruction,Freda Deskin,DEM,490020,0,3,37,40,
Mayes,U.S. Senate,Patrick Michael Hayes,DEM,490020,2,5,32,39,
Mayes,U.S. Senate,Jim Rogers,DEM,490020,1,5,77,83,
Mayes,U.S. Senate,Connie Johnson,DEM,490020,1,2,55,58,
Mayes,U.S. House,Earl Everett,DEM,490020,1,7,96,104,02
Mayes,U.S. House,Joshua Harris-Till,DEM,490020,2,5,64,71,02
Mayes,Governor,Dax Ewbank,REP,490020,0,1,14,15,
Mayes,Governor,Chad Moody,REP,490020,0,1,20,21,
Mayes,Governor,Mary Fallin,REP,490020,0,16,124,140,
Mayes,Superintendent of Public Instruction,Brian Kelly,REP,490020,0,5,26,31,
Mayes,Superintendent of Public Instruction,Janet Costello Barresi,REP,490020,0,3,25,28,
Mayes,Superintendent of Public Instruction,Joy Hofmeister,REP,490020,2,11,97,110,
Mayes,Insurance Commissioner,Bill Viner,REP,490020,0,6,33,39,
Mayes,Insurance Commissioner,John Doak,REP,490020,0,12,109,121,
Mayes,Corporation Commissioner,Todd Hiett,REP,490020,0,11,85,96,
Mayes,Corporation Commissioner,Cliff Branan,REP,490020,0,7,57,64,
Mayes,U.S. Senate,Evelyn Rogers,REP,490020,0,0,6,6,
Mayes,U.S. Senate,Rob Moye,REP,490020,0,1,2,3,
Mayes,U.S. Senate,D. Jean Mcbride-Samuels,REP,490020,0,0,2,2,
Mayes,U.S. Senate,Jim Inhofe,REP,490020,2,15,139,156,
Mayes,U.S. Senate,Erick Paul Wyatt,REP,490020,0,3,6,9,
Mayes,U.S. Senate,Andy Craig,REP,490020,0,0,0,0,
Mayes,U.S. Senate,T. Shannon,REP,490020,0,9,85,94,
Mayes,U.S. Senate,Randy Brogdon,REP,490020,0,0,12,12,
Mayes,U.S. Senate,Eric Mccray,REP,490020,0,1,1,2,
Mayes,U.S. Senate,Kevin Crow,REP,490020,0,0,1,1,
Mayes,U.S. Senate,James Lankford,REP,490020,0,9,57,66,
Mayes,U.S. Senate,Jason Weger,REP,490020,0,0,1,1,
Mayes,U.S. House,Darrel Robertson,REP,490020,0,1,27,28,02
Mayes,U.S. House,Markwayne Mullin,REP,490020,2,18,131,151,02
Mayes,Superintendent of Public Instruction,John Cox,DEM,490021,2,3,38,43,
Mayes,Superintendent of Public Instruction,Jack Jr.,DEM,490021,0,0,2,2,
Mayes,Superintendent of Public Instruction,Ivan Holmes,DEM,490021,0,0,1,1,
Mayes,Superintendent of Public Instruction,Freda Deskin,DEM,490021,0,0,13,13,
Mayes,U.S. Senate,Patrick Michael Hayes,DEM,490021,0,0,20,20,
Mayes,U.S. Senate,Jim Rogers,DEM,490021,0,2,22,24,
Mayes,U.S. Senate,Connie Johnson,DEM,490021,2,1,12,15,
Mayes,U.S. House,Earl Everett,DEM,490021,0,2,31,33,02
Mayes,U.S. House,Joshua Harris-Till,DEM,490021,2,1,21,24,02
Mayes,Governor,Dax Ewbank,REP,490021,0,2,4,6,
Mayes,Governor,Chad Moody,REP,490021,0,1,7,8,
Mayes,Governor,Mary Fallin,REP,490021,1,5,51,57,
Mayes,Superintendent of Public Instruction,Brian Kelly,REP,490021,0,1,11,12,
Mayes,Superintendent of Public Instruction,Janet Costello Barresi,REP,490021,1,1,9,11,
Mayes,Superintendent of Public Instruction,Joy Hofmeister,REP,490021,0,6,42,48,
Mayes,Insurance Commissioner,Bill Viner,REP,490021,0,1,8,9,
Mayes,Insurance Commissioner,John Doak,REP,490021,1,5,51,57,
Mayes,Corporation Commissioner,Todd Hiett,REP,490021,1,5,27,33,
Mayes,Corporation Commissioner,Cliff Branan,REP,490021,0,3,31,34,
Mayes,U.S. Senate,Evelyn Rogers,REP,490021,0,1,4,5,
Mayes,U.S. Senate,Rob Moye,REP,490021,0,0,0,0,
Mayes,U.S. Senate,D. Jean Mcbride-Samuels,REP,490021,0,0,0,0,
Mayes,U.S. Senate,Jim Inhofe,REP,490021,1,7,57,65,
Mayes,U.S. Senate,Erick Paul Wyatt,REP,490021,0,0,1,1,
Mayes,U.S. Senate,Andy Craig,REP,490021,0,1,1,2,
Mayes,U.S. Senate,T. Shannon,REP,490021,1,4,31,36,
Mayes,U.S. Senate,Randy Brogdon,REP,490021,0,0,1,1,
Mayes,U.S. Senate,Eric Mccray,REP,490021,0,0,0,0,
Mayes,U.S. Senate,Kevin Crow,REP,490021,0,0,0,0,
Mayes,U.S. Senate,James Lankford,REP,490021,0,3,28,31,
Mayes,U.S. Senate,Jason Weger,REP,490021,0,0,1,1,
Mayes,U.S. House,Darrel Robertson,REP,490021,0,0,3,3,02
Mayes,U.S. House,Markwayne Mullin,REP,490021,1,8,59,68,02
Mayes,Superintendent of Public Instruction,John Cox,DEM,490022,2,2,81,85,
Mayes,Superintendent of Public Instruction,Jack Jr.,DEM,490022,0,1,4,5,
Mayes,Superintendent of Public Instruction,Ivan Holmes,DEM,490022,0,0,11,11,
Mayes,Superintendent of Public Instruction,Freda Deskin,DEM,490022,0,0,34,34,
Mayes,U.S. Senate,Patrick Michael Hayes,DEM,490022,0,0,35,35,
Mayes,U.S. Senate,Jim Rogers,DEM,490022,0,2,46,48,
Mayes,U.S. Senate,Connie Johnson,DEM,490022,2,1,39,42,
Mayes,U.S. House,Earl Everett,DEM,490022,2,3,73,78,02
Mayes,U.S. House,Joshua Harris-Till,DEM,490022,0,0,41,41,02
Mayes,Governor,Dax Ewbank,REP,490022,1,0,4,5,
Mayes,Governor,Chad Moody,REP,490022,0,1,21,22,
Mayes,Governor,Mary Fallin,REP,490022,0,3,69,72,
Mayes,Superintendent of Public Instruction,Brian Kelly,REP,490022,1,2,18,21,
Mayes,Superintendent of Public Instruction,Janet Costello Barresi,REP,490022,0,0,7,7,
Mayes,Superintendent of Public Instruction,Joy Hofmeister,REP,490022,0,2,70,72,
Mayes,Insurance Commissioner,Bill Viner,REP,490022,0,0,22,22,
Mayes,Insurance Commissioner,John Doak,REP,490022,1,4,72,77,
Mayes,Corporation Commissioner,Todd Hiett,REP,490022,1,2,54,57,
Mayes,Corporation Commissioner,Cliff Branan,REP,490022,0,2,37,39,
Mayes,U.S. Senate,Evelyn Rogers,REP,490022,0,0,4,4,
Mayes,U.S. Senate,Rob Moye,REP,490022,0,0,2,2,
Mayes,U.S. Senate,D. Jean Mcbride-Samuels,REP,490022,0,0,2,2,
Mayes,U.S. Senate,Jim Inhofe,REP,490022,1,4,81,86,
Mayes,U.S. Senate,Erick Paul Wyatt,REP,490022,0,0,5,5,
Mayes,U.S. Senate,Andy Craig,REP,490022,0,0,1,1,
Mayes,U.S. Senate,T. Shannon,REP,490022,1,3,51,55,
Mayes,U.S. Senate,Randy Brogdon,REP,490022,0,0,3,3,
Mayes,U.S. Senate,Eric Mccray,REP,490022,0,0,1,1,
Mayes,U.S. Senate,Kevin Crow,REP,490022,0,0,4,4,
Mayes,U.S. Senate,James Lankford,REP,490022,0,1,34,35,
Mayes,U.S. Senate,Jason Weger,REP,490022,0,0,0,0,
Mayes,U.S. House,Darrel Robertson,REP,490022,0,0,15,15,02
Mayes,U.S. House,Markwayne Mullin,REP,490022,1,4,80,85,02
Mayes,Superintendent of Public Instruction,John Cox,DEM,490023,0,6,83,89,
Mayes,Superintendent of Public Instruction,Jack Jr.,DEM,490023,0,1,15,16,
Mayes,Superintendent of Public Instruction,Ivan Holmes,DEM,490023,0,0,5,5,
Mayes,Superintendent of Public Instruction,Freda Deskin,DEM,490023,0,2,29,31,
Mayes,U.S. Senate,Patrick Michael Hayes,DEM,490023,0,3,28,31,
Mayes,U.S. Senate,Jim Rogers,DEM,490023,0,4,58,62,
Mayes,U.S. Senate,Connie Johnson,DEM,490023,0,1,36,37,
Mayes,U.S. House,Earl Everett,DEM,490023,0,5,72,77,02
Mayes,U.S. House,Joshua Harris-Till,DEM,490023,0,3,42,45,02
Mayes,Governor,Dax Ewbank,REP,490023,0,2,7,9,
Mayes,Governor,Chad Moody,REP,490023,0,1,21,22,
Mayes,Governor,Mary Fallin,REP,490023,0,5,109,114,
Mayes,Superintendent of Public Instruction,Brian Kelly,REP,490023,0,3,30,33,
Mayes,Superintendent of Public Instruction,Janet Costello Barresi,REP,490023,0,0,21,21,
Mayes,Superintendent of Public Instruction,Joy Hofmeister,REP,490023,0,5,77,82,
Mayes,Insurance Commissioner,Bill Viner,REP,490023,0,2,35,37,
Mayes,Insurance Commissioner,John Doak,REP,490023,0,6,87,93,
Mayes,Corporation Commissioner,Todd Hiett,REP,490023,0,2,65,67,
Mayes,Corporation Commissioner,Cliff Branan,REP,490023,0,6,62,68,
Mayes,U.S. Senate,Evelyn Rogers,REP,490023,0,1,5,6,
Mayes,U.S. Senate,Rob Moye,REP,490023,0,0,3,3,
Mayes,U.S. Senate,D. Jean Mcbride-Samuels,REP,490023,0,0,2,2,
Mayes,U.S. Senate,Jim Inhofe,REP,490023,0,6,109,115,
Mayes,U.S. Senate,Erick Paul Wyatt,REP,490023,0,1,17,18,
Mayes,U.S. Senate,Andy Craig,REP,490023,0,0,3,3,
Mayes,U.S. Senate,T. Shannon,REP,490023,0,5,53,58,
Mayes,U.S. Senate,Randy Brogdon,REP,490023,0,2,3,5,
Mayes,U.S. Senate,Eric Mccray,REP,490023,0,0,1,1,
Mayes,U.S. Senate,Kevin Crow,REP,490023,0,0,1,1,
Mayes,U.S. Senate,James Lankford,REP,490023,0,1,76,77,
Mayes,U.S. Senate,Jason Weger,REP,490023,0,0,0,0,
Mayes,U.S. House,Darrel Robertson,REP,490023,0,2,15,17,02
Mayes,U.S. House,Markwayne Mullin,REP,490023,0,6,120,126,02
Mayes,Superintendent of Public Instruction,John Cox,DEM,490024,0,0,23,23,
Mayes,Superintendent of Public Instruction,Jack Jr.,DEM,490024,0,0,3,3,
Mayes,Superintendent of Public Instruction,Ivan Holmes,DEM,490024,0,0,2,2,
Mayes,Superintendent of Public Instruction,Freda Deskin,DEM,490024,2,0,11,13,
Mayes,U.S. Senate,Patrick Michael Hayes,DEM,490024,0,0,9,9,
Mayes,U.S. Senate,Jim Rogers,DEM,490024,2,0,15,17,
Mayes,U.S. Senate,Connie Johnson,DEM,490024,0,0,11,11,
Mayes,U.S. House,Earl Everett,DEM,490024,0,0,21,21,02
Mayes,U.S. House,Joshua Harris-Till,DEM,490024,2,0,12,14,02
Mayes,Governor,Dax Ewbank,REP,490024,0,0,5,5,
Mayes,Governor,Chad Moody,REP,490024,0,2,13,15,
Mayes,Governor,Mary Fallin,REP,490024,1,2,64,67,
Mayes,Superintendent of Public Instruction,Brian Kelly,REP,490024,0,2,23,25,
Mayes,Superintendent of Public Instruction,Janet Costello Barresi,REP,490024,1,1,9,11,
Mayes,Superintendent of Public Instruction,Joy Hofmeister,REP,490024,0,1,49,50,
Mayes,Insurance Commissioner,Bill Viner,REP,490024,0,0,18,18,
Mayes,Insurance Commissioner,John Doak,REP,490024,1,3,59,63,
Mayes,Corporation Commissioner,Todd Hiett,REP,490024,1,2,41,44,
Mayes,Corporation Commissioner,Cliff Branan,REP,490024,0,1,36,37,
Mayes,U.S. Senate,Evelyn Rogers,REP,490024,0,0,2,2,
Mayes,U.S. Senate,Rob Moye,REP,490024,0,0,0,0,
Mayes,U.S. Senate,D. Jean Mcbride-Samuels,REP,490024,0,0,3,3,
Mayes,U.S. Senate,Jim Inhofe,REP,490024,0,2,71,73,
Mayes,U.S. Senate,Erick Paul Wyatt,REP,490024,1,1,5,7,
Mayes,U.S. Senate,Andy Craig,REP,490024,0,0,0,0,
Mayes,U.S. Senate,T. Shannon,REP,490024,1,1,49,51,
Mayes,U.S. Senate,Randy Brogdon,REP,490024,0,0,9,9,
Mayes,U.S. Senate,Eric Mccray,REP,490024,0,0,1,1,
Mayes,U.S. Senate,Kevin Crow,REP,490024,0,0,1,1,
Mayes,U.S. Senate,James Lankford,REP,490024,0,2,20,22,
Mayes,U.S. Senate,Jason Weger,REP,490024,0,0,2,2,
Mayes,U.S. House,Darrel Robertson,REP,490024,0,0,10,10,02
Mayes,U.S. House,Markwayne Mullin,REP,490024,1,4,71,76,02
Mayes,Superintendent of Public Instruction,John Cox,DEM,490025,1,1,37,39,
Mayes,Superintendent of Public Instruction,Jack Jr.,DEM,490025,0,0,4,4,
Mayes,Superintendent of Public Instruction,Ivan Holmes,DEM,490025,0,0,1,1,
Mayes,Superintendent of Public Instruction,Freda Deskin,DEM,490025,0,2,8,10,
Mayes,U.S. Senate,Patrick Michael Hayes,DEM,490025,0,1,13,14,
Mayes,U.S. Senate,Jim Rogers,DEM,490025,1,2,18,21,
Mayes,U.S. Senate,Connie Johnson,DEM,490025,0,0,15,15,
Mayes,U.S. House,Earl Everett,DEM,490025,0,1,22,23,02
Mayes,U.S. House,Joshua Harris-Till,DEM,490025,1,2,20,23,02
Mayes,Governor,Dax Ewbank,REP,490025,0,0,4,4,
Mayes,Governor,Chad Moody,REP,490025,0,0,5,5,
Mayes,Governor,Mary Fallin,REP,490025,0,0,48,48,
Mayes,Superintendent of Public Instruction,Brian Kelly,REP,490025,0,0,12,12,
Mayes,Superintendent of Public Instruction,Janet Costello Barresi,REP,490025,0,0,6,6,
Mayes,Superintendent of Public Instruction,Joy Hofmeister,REP,490025,0,0,38,38,
Mayes,Insurance Commissioner,Bill Viner,REP,490025,0,0,16,16,
Mayes,Insurance Commissioner,John Doak,REP,490025,0,0,40,40,
Mayes,Corporation Commissioner,Todd Hiett,REP,490025,0,0,26,26,
Mayes,Corporation Commissioner,Cliff Branan,REP,490025,0,0,30,30,
Mayes,U.S. Senate,Evelyn Rogers,REP,490025,0,0,1,1,
Mayes,U.S. Senate,Rob Moye,REP,490025,0,0,1,1,
Mayes,U.S. Senate,D. Jean Mcbride-Samuels,REP,490025,0,0,1,1,
Mayes,U.S. Senate,Jim Inhofe,REP,490025,0,0,49,49,
Mayes,U.S. Senate,Erick Paul Wyatt,REP,490025,0,0,4,4,
Mayes,U.S. Senate,Andy Craig,REP,490025,0,0,1,1,
Mayes,U.S. Senate,T. Shannon,REP,490025,0,0,31,31,
Mayes,U.S. Senate,Randy Brogdon,REP,490025,0,0,3,3,
Mayes,U.S. Senate,Eric Mccray,REP,490025,0,0,0,0,
Mayes,U.S. Senate,Kevin Crow,REP,490025,0,0,1,1,
Mayes,U.S. Senate,James Lankford,REP,490025,0,0,22,22,
Mayes,U.S. Senate,Jason Weger,REP,490025,0,0,0,0,
Mayes,U.S. House,Darrel Robertson,REP,490025,0,0,9,9,02
Mayes,U.S. House,Markwayne Mullin,REP,490025,0,0,49,49,02
Mayes,Superintendent of Public Instruction,John Cox,DEM,490026,0,0,5,5,
Mayes,Superintendent of Public Instruction,Jack Jr.,DEM,490026,1,0,0,1,
Mayes,Superintendent of Public Instruction,Ivan Holmes,DEM,490026,0,0,0,0,
Mayes,Superintendent of Public Instruction,Freda Deskin,DEM,490026,0,0,0,0,
Mayes,U.S. Senate,Patrick Michael Hayes,DEM,490026,0,0,1,1,
Mayes,U.S. Senate,Jim Rogers,DEM,490026,1,0,0,1,
Mayes,U.S. Senate,Connie Johnson,DEM,490026,0,0,3,3,
Mayes,U.S. House,Earl Everett,DEM,490026,1,0,1,2,02
Mayes,U.S. House,Joshua Harris-Till,DEM,490026,0,0,3,3,02
Mayes,Governor,Dax Ewbank,REP,490026,0,0,0,0,
Mayes,Governor,Chad Moody,REP,490026,0,0,1,1,
Mayes,Governor,Mary Fallin,REP,490026,0,0,4,4,
Mayes,Superintendent of Public Instruction,Brian Kelly,REP,490026,0,0,1,1,
Mayes,Superintendent of Public Instruction,Janet Costello Barresi,REP,490026,0,0,2,2,
Mayes,Superintendent of Public Instruction,Joy Hofmeister,REP,490026,0,0,2,2,
Mayes,Insurance Commissioner,Bill Viner,REP,490026,0,0,1,1,
Mayes,Insurance Commissioner,John Doak,REP,490026,0,0,3,3,
Mayes,Corporation Commissioner,Todd Hiett,REP,490026,0,0,1,1,
Mayes,Corporation Commissioner,Cliff Branan,REP,490026,0,0,4,4,
Mayes,U.S. Senate,Evelyn Rogers,REP,490026,0,0,0,0,
Mayes,U.S. Senate,Rob Moye,REP,490026,0,0,0,0,
Mayes,U.S. Senate,D. Jean Mcbride-Samuels,REP,490026,0,0,0,0,
Mayes,U.S. Senate,Jim Inhofe,REP,490026,0,0,4,4,
Mayes,U.S. Senate,Erick Paul Wyatt,REP,490026,0,0,1,1,
Mayes,U.S. Senate,Andy Craig,REP,490026,0,0,0,0,
Mayes,U.S. Senate,T. Shannon,REP,490026,0,0,0,0,
Mayes,U.S. Senate,Randy Brogdon,REP,490026,0,0,1,1,
Mayes,U.S. Senate,Eric Mccray,REP,490026,0,0,0,0,
Mayes,U.S. Senate,Kevin Crow,REP,490026,0,0,0,0,
Mayes,U.S. Senate,James Lankford,REP,490026,0,0,4,4,
Mayes,U.S. Senate,Jason Weger,REP,490026,0,0,0,0,
Mayes,U.S. House,Darrel Robertson,REP,490026,0,0,0,0,02
Mayes,U.S. House,Markwayne Mullin,REP,490026,0,0,5,5,02
Mayes,Superintendent of Public Instruction,John Cox,DEM,490027,0,0,1,1,
Mayes,Superintendent of Public Instruction,Jack Jr.,DEM,490027,0,0,0,0,
Mayes,Superintendent of Public Instruction,Ivan Holmes,DEM,490027,0,0,0,0,
Mayes,Superintendent of Public Instruction,Freda Deskin,DEM,490027,0,0,5,5,
Mayes,U.S. Senate,Patrick Michael Hayes,DEM,490027,0,0,1,1,
Mayes,U.S. Senate,Jim Rogers,DEM,490027,0,0,3,3,
Mayes,U.S. Senate,Connie Johnson,DEM,490027,0,0,2,2,
Mayes,U.S. House,Earl Everett,DEM,490027,0,0,2,2,02
Mayes,U.S. House,Joshua Harris-Till,DEM,490027,0,0,4,4,02
Mayes,Governor,Dax Ewbank,REP,490027,0,0,1,1,
Mayes,Governor,Chad Moody,REP,490027,0,0,3,3,
Mayes,Governor,Mary Fallin,REP,490027,0,0,7,7,
Mayes,Superintendent of Public Instruction,Brian Kelly,REP,490027,0,0,4,4,
Mayes,Superintendent of Public Instruction,Janet Costello Barresi,REP,490027,0,0,1,1,
Mayes,Superintendent of Public Instruction,Joy Hofmeister,REP,490027,0,0,7,7,
Mayes,Insurance Commissioner,Bill Viner,REP,490027,0,0,2,2,
Mayes,Insurance Commissioner,John Doak,REP,490027,0,0,9,9,
Mayes,Corporation Commissioner,Todd Hiett,REP,490027,0,0,3,3,
Mayes,Corporation Commissioner,Cliff Branan,REP,490027,0,0,9,9,
Mayes,U.S. Senate,Evelyn Rogers,REP,490027,0,0,1,1,
Mayes,U.S. Senate,Rob Moye,REP,490027,0,0,0,0,
Mayes,U.S. Senate,D. Jean Mcbride-Samuels,REP,490027,0,0,0,0,
Mayes,U.S. Senate,Jim Inhofe,REP,490027,0,0,9,9,
Mayes,U.S. Senate,Erick Paul Wyatt,REP,490027,0,0,2,2,
Mayes,U.S. Senate,Andy Craig,REP,490027,0,0,0,0,
Mayes,U.S. Senate,T. Shannon,REP,490027,0,0,6,6,
Mayes,U.S. Senate,Randy Brogdon,REP,490027,0,0,0,0,
Mayes,U.S. Senate,Eric Mccray,REP,490027,0,0,0,0,
Mayes,U.S. Senate,Kevin Crow,REP,490027,0,0,1,1,
Mayes,U.S. Senate,James Lankford,REP,490027,0,0,3,3,
Mayes,U.S. Senate,Jason Weger,REP,490027,0,0,2,2,
Mayes,U.S. House,Darrel Robertson,REP,490027,0,0,1,1,02
Mayes,U.S. House,Markwayne Mullin,REP,490027,0,0,11,11,02
Mayes,Superintendent of Public Instruction,John Cox,DEM,490031,0,1,71,72,
Mayes,Superintendent of Public Instruction,Jack Jr.,DEM,490031,0,0,10,10,
Mayes,Superintendent of Public Instruction,Ivan Holmes,DEM,490031,0,0,4,4,
Mayes,Superintendent of Public Instruction,Freda Deskin,DEM,490031,0,0,31,31,
Mayes,U.S. Senate,Patrick Michael Hayes,DEM,490031,0,0,29,29,
Mayes,U.S. Senate,Jim Rogers,DEM,490031,0,1,37,38,
Mayes,U.S. Senate,Connie Johnson,DEM,490031,0,0,43,43,
Mayes,U.S. House,Earl Everett,DEM,490031,0,1,59,60,02
Mayes,U.S. House,Joshua Harris-Till,DEM,490031,0,0,46,46,02
Mayes,Governor,Dax Ewbank,REP,490031,0,0,12,12,
Mayes,Governor,Chad Moody,REP,490031,0,0,12,12,
Mayes,Governor,Mary Fallin,REP,490031,2,0,89,91,
Mayes,Superintendent of Public Instruction,Brian Kelly,REP,490031,0,0,23,23,
Mayes,Superintendent of Public Instruction,Janet Costello Barresi,REP,490031,1,0,16,17,
Mayes,Superintendent of Public Instruction,Joy Hofmeister,REP,490031,1,0,71,72,
Mayes,Insurance Commissioner,Bill Viner,REP,490031,0,0,29,29,
Mayes,Insurance Commissioner,John Doak,REP,490031,2,0,66,68,
Mayes,Corporation Commissioner,Todd Hiett,REP,490031,2,0,46,48,
Mayes,Corporation Commissioner,Cliff Branan,REP,490031,0,0,47,47,
Mayes,U.S. Senate,Evelyn Rogers,REP,490031,0,0,1,1,
Mayes,U.S. Senate,Rob Moye,REP,490031,0,0,4,4,
Mayes,U.S. Senate,D. Jean Mcbride-Samuels,REP,490031,1,0,2,3,
Mayes,U.S. Senate,Jim Inhofe,REP,490031,1,0,100,101,
Mayes,U.S. Senate,Erick Paul Wyatt,REP,490031,0,0,7,7,
Mayes,U.S. Senate,Andy Craig,REP,490031,0,0,4,4,
Mayes,U.S. Senate,T. Shannon,REP,490031,1,0,34,35,
Mayes,U.S. Senate,Randy Brogdon,REP,490031,0,0,7,7,
Mayes,U.S. Senate,Eric Mccray,REP,490031,0,0,0,0,
Mayes,U.S. Senate,Kevin Crow,REP,490031,0,0,2,2,
Mayes,U.S. Senate,James Lankford,REP,490031,1,0,64,65,
Mayes,U.S. Senate,Jason Weger,REP,490031,0,0,1,1,
Mayes,U.S. House,Darrel Robertson,REP,490031,1,0,26,27,02
Mayes,U.S. House,Markwayne Mullin,REP,490031,1,0,85,86,02
Mayes,Superintendent of Public Instruction,John Cox,DEM,490034,4,4,52,60,
Mayes,Superintendent of Public Instruction,Jack Jr.,DEM,490034,3,0,1,4,
Mayes,Superintendent of Public Instruction,Ivan Holmes,DEM,490034,0,0,1,1,
Mayes,Superintendent of Public Instruction,Freda Deskin,DEM,490034,1,1,15,17,
Mayes,U.S. Senate,Patrick Michael Hayes,DEM,490034,3,3,16,22,
Mayes,U.S. Senate,Jim Rogers,DEM,490034,1,0,29,30,
Mayes,U.S. Senate,Connie Johnson,DEM,490034,2,2,23,27,
Mayes,U.S. House,Earl Everett,DEM,490034,4,4,44,52,02
Mayes,U.S. House,Joshua Harris-Till,DEM,490034,2,1,22,25,02
Mayes,Governor,Dax Ewbank,REP,490034,0,0,5,5,
Mayes,Governor,Chad Moody,REP,490034,0,1,14,15,
Mayes,Governor,Mary Fallin,REP,490034,2,1,32,35,
Mayes,Superintendent of Public Instruction,Brian Kelly,REP,490034,1,0,14,15,
Mayes,Superintendent of Public Instruction,Janet Costello Barresi,REP,490034,1,0,9,10,
Mayes,Superintendent of Public Instruction,Joy Hofmeister,REP,490034,0,2,28,30,
Mayes,Insurance Commissioner,Bill Viner,REP,490034,1,1,16,18,
Mayes,Insurance Commissioner,John Doak,REP,490034,1,1,31,33,
Mayes,Corporation Commissioner,Todd Hiett,REP,490034,2,2,21,25,
Mayes,Corporation Commissioner,Cliff Branan,REP,490034,0,0,28,28,
Mayes,U.S. Senate,Evelyn Rogers,REP,490034,0,0,7,7,
Mayes,U.S. Senate,Rob Moye,REP,490034,0,0,0,0,
Mayes,U.S. Senate,D. Jean Mcbride-Samuels,REP,490034,0,0,3,3,
Mayes,U.S. Senate,Jim Inhofe,REP,490034,2,2,33,37,
Mayes,U.S. Senate,Erick Paul Wyatt,REP,490034,0,0,8,8,
Mayes,U.S. Senate,Andy Craig,REP,490034,1,0,0,1,
Mayes,U.S. Senate,T. Shannon,REP,490034,1,0,21,22,
Mayes,U.S. Senate,Randy Brogdon,REP,490034,0,1,5,6,
Mayes,U.S. Senate,Eric Mccray,REP,490034,0,0,2,2,
Mayes,U.S. Senate,Kevin Crow,REP,490034,0,0,2,2,
Mayes,U.S. Senate,James Lankford,REP,490034,0,1,21,22,
Mayes,U.S. Senate,Jason Weger,REP,490034,0,0,0,0,
Mayes,U.S. House,Darrel Robertson,REP,490034,1,1,14,16,02
Mayes,U.S. House,Markwayne Mullin,REP,490034,1,1,37,39,02
Mayes,Superintendent of Public Instruction,John Cox,DEM,490036,1,14,213,228,
Mayes,Superintendent of Public Instruction,Jack Jr.,DEM,490036,1,0,8,9,
Mayes,Superintendent of Public Instruction,Ivan Holmes,DEM,490036,1,2,12,15,
Mayes,Superintendent of Public Instruction,Freda Deskin,DEM,490036,1,0,36,37,
Mayes,U.S. Senate,Patrick Michael Hayes,DEM,490036,3,5,77,85,
Mayes,U.S. Senate,Jim Rogers,DEM,490036,0,6,112,118,
Mayes,U.S. Senate,Connie Johnson,DEM,490036,1,2,63,66,
Mayes,U.S. House,Earl Everett,DEM,490036,2,7,165,174,02
Mayes,U.S. House,Joshua Harris-Till,DEM,490036,2,6,83,91,02
Mayes,Governor,Dax Ewbank,REP,490036,0,2,11,13,
Mayes,Governor,Chad Moody,REP,490036,0,1,66,67,
Mayes,Governor,Mary Fallin,REP,490036,1,1,145,147,
Mayes,Superintendent of Public Instruction,Brian Kelly,REP,490036,0,1,43,44,
Mayes,Superintendent of Public Instruction,Janet Costello Barresi,REP,490036,0,0,40,40,
Mayes,Superintendent of Public Instruction,Joy Hofmeister,REP,490036,2,3,139,144,
Mayes,Insurance Commissioner,Bill Viner,REP,490036,0,1,49,50,
Mayes,Insurance Commissioner,John Doak,REP,490036,1,3,159,163,
Mayes,Corporation Commissioner,Todd Hiett,REP,490036,1,2,110,113,
Mayes,Corporation Commissioner,Cliff Branan,REP,490036,0,2,106,108,
Mayes,U.S. Senate,Evelyn Rogers,REP,490036,0,0,10,10,
Mayes,U.S. Senate,Rob Moye,REP,490036,0,0,7,7,
Mayes,U.S. Senate,D. Jean Mcbride-Samuels,REP,490036,0,2,6,8,
Mayes,U.S. Senate,Jim Inhofe,REP,490036,2,1,195,198,
Mayes,U.S. Senate,Erick Paul Wyatt,REP,490036,0,1,5,6,
Mayes,U.S. Senate,Andy Craig,REP,490036,0,0,1,1,
Mayes,U.S. Senate,T. Shannon,REP,490036,1,0,117,118,
Mayes,U.S. Senate,Randy Brogdon,REP,490036,0,1,10,11,
Mayes,U.S. Senate,Eric Mccray,REP,490036,0,1,6,7,
Mayes,U.S. Senate,Kevin Crow,REP,490036,0,1,3,4,
Mayes,U.S. Senate,James Lankford,REP,490036,1,1,83,85,
Mayes,U.S. Senate,Jason Weger,REP,490036,0,0,2,2,
Mayes,U.S. House,Darrel Robertson,REP,490036,0,1,25,26,02
Mayes,U.S. House,Markwayne Mullin,REP,490036,2,3,199,204,02
Mayes,Superintendent of Public Instruction,John Cox,DEM,490037,1,3,110,114,
Mayes,Superintendent of Public Instruction,Jack Jr.,DEM,490037,0,0,3,3,
Mayes,Superintendent of Public Instruction,Ivan Holmes,DEM,490037,0,0,6,6,
Mayes,Superintendent of Public Instruction,Freda Deskin,DEM,490037,0,0,36,36,
Mayes,U.S. Senate,Patrick Michael Hayes,DEM,490037,0,2,43,45,
Mayes,U.S. Senate,Jim Rogers,DEM,490037,0,1,74,75,
Mayes,U.S. Senate,Connie Johnson,DEM,490037,0,0,33,33,
Mayes,U.S. House,Earl Everett,DEM,490037,0,2,84,86,02
Mayes,U.S. House,Joshua Harris-Till,DEM,490037,0,1,54,55,02
Mayes,Governor,Dax Ewbank,REP,490037,0,1,13,14,
Mayes,Governor,Chad Moody,REP,490037,1,2,20,23,
Mayes,Governor,Mary Fallin,REP,490037,1,3,82,86,
Mayes,Superintendent of Public Instruction,Brian Kelly,REP,490037,1,2,34,37,
Mayes,Superintendent of Public Instruction,Janet Costello Barresi,REP,490037,0,1,6,7,
Mayes,Superintendent of Public Instruction,Joy Hofmeister,REP,490037,1,3,72,76,
Mayes,Insurance Commissioner,Bill Viner,REP,490037,0,2,27,29,
Mayes,Insurance Commissioner,John Doak,REP,490037,1,4,84,89,
Mayes,Corporation Commissioner,Todd Hiett,REP,490037,0,1,50,51,
Mayes,Corporation Commissioner,Cliff Branan,REP,490037,2,5,58,65,
Mayes,U.S. Senate,Evelyn Rogers,REP,490037,0,0,6,6,
Mayes,U.S. Senate,Rob Moye,REP,490037,0,0,1,1,
Mayes,U.S. Senate,D. Jean Mcbride-Samuels,REP,490037,0,0,2,2,
Mayes,U.S. Senate,Jim Inhofe,REP,490037,2,4,101,107,
Mayes,U.S. Senate,Erick Paul Wyatt,REP,490037,0,2,7,9,
Mayes,U.S. Senate,Andy Craig,REP,490037,0,0,2,2,
Mayes,U.S. Senate,T. Shannon,REP,490037,0,3,57,60,
Mayes,U.S. Senate,Randy Brogdon,REP,490037,0,0,6,6,
Mayes,U.S. Senate,Eric Mccray,REP,490037,0,0,0,0,
Mayes,U.S. Senate,Kevin Crow,REP,490037,0,0,2,2,
Mayes,U.S. Senate,James Lankford,REP,490037,2,3,48,53,
Mayes,U.S. Senate,Jason Weger,REP,490037,0,0,0,0,
Mayes,U.S. House,Darrel Robertson,REP,490037,1,1,22,24,02
Mayes,U.S. House,Markwayne Mullin,REP,490037,1,4,92,97,02
Mayes,Superintendent of Public Instruction,John Cox,DEM,490038,0,0,36,36,
Mayes,Superintendent of Public Instruction,Jack Jr.,DEM,490038,0,0,2,2,
Mayes,Superintendent of Public Instruction,Ivan Holmes,DEM,490038,0,0,0,0,
Mayes,Superintendent of Public Instruction,Freda Deskin,DEM,490038,0,0,12,12,
Mayes,U.S. Senate,Patrick Michael Hayes,DEM,490038,0,0,11,11,
Mayes,U.S. Senate,Jim Rogers,DEM,490038,0,0,19,19,
Mayes,U.S. Senate,Connie Johnson,DEM,490038,0,0,17,17,
Mayes,U.S. House,Earl Everett,DEM,490038,0,0,33,33,02
Mayes,U.S. House,Joshua Harris-Till,DEM,490038,0,0,11,11,02
Mayes,Governor,Dax Ewbank,REP,490038,0,0,8,8,
Mayes,Governor,Chad Moody,REP,490038,2,1,5,8,
Mayes,Governor,Mary Fallin,REP,490038,1,3,34,38,
Mayes,Superintendent of Public Instruction,Brian Kelly,REP,490038,1,1,11,13,
Mayes,Superintendent of Public Instruction,Janet Costello Barresi,REP,490038,0,0,2,2,
Mayes,Superintendent of Public Instruction,Joy Hofmeister,REP,490038,2,3,35,40,
Mayes,Insurance Commissioner,Bill Viner,REP,490038,1,2,13,16,
Mayes,Insurance Commissioner,John Doak,REP,490038,2,2,30,34,
Mayes,Corporation Commissioner,Todd Hiett,REP,490038,3,3,26,32,
Mayes,Corporation Commissioner,Cliff Branan,REP,490038,0,1,19,20,
Mayes,U.S. Senate,Evelyn Rogers,REP,490038,0,0,2,2,
Mayes,U.S. Senate,Rob Moye,REP,490038,0,0,0,0,
Mayes,U.S. Senate,D. Jean Mcbride-Samuels,REP,490038,0,1,0,1,
Mayes,U.S. Senate,Jim Inhofe,REP,490038,3,3,43,49,
Mayes,U.S. Senate,Erick Paul Wyatt,REP,490038,0,0,2,2,
Mayes,U.S. Senate,Andy Craig,REP,490038,0,0,0,0,
Mayes,U.S. Senate,T. Shannon,REP,490038,1,2,23,26,
Mayes,U.S. Senate,Randy Brogdon,REP,490038,0,1,0,1,
Mayes,U.S. Senate,Eric Mccray,REP,490038,0,0,0,0,
Mayes,U.S. Senate,Kevin Crow,REP,490038,0,0,0,0,
Mayes,U.S. Senate,James Lankford,REP,490038,2,1,24,27,
Mayes,U.S. Senate,Jason Weger,REP,490038,0,0,0,0,
Mayes,U.S. House,Darrel Robertson,REP,490038,0,1,8,9,02
Mayes,U.S. House,Markwayne Mullin,REP,490038,3,3,39,45,02
Mayes,Superintendent of Public Instruction,John Cox,DEM,490039,0,2,168,170,
Mayes,Superintendent of Public Instruction,Jack Jr.,DEM,490039,0,0,15,15,
Mayes,Superintendent of Public Instruction,Ivan Holmes,DEM,490039,1,0,8,9,
Mayes,Superintendent of Public Instruction,Freda Deskin,DEM,490039,0,0,22,22,
Mayes,U.S. Senate,Patrick Michael Hayes,DEM,490039,1,1,42,44,
Mayes,U.S. Senate,Jim Rogers,DEM,490039,0,1,104,105,
Mayes,U.S. Senate,Connie Johnson,DEM,490039,0,0,54,54,
Mayes,U.S. House,Earl Everett,DEM,490039,1,1,115,117,02
Mayes,U.S. House,Joshua Harris-Till,DEM,490039,0,1,77,78,02
Mayes,Governor,Dax Ewbank,REP,490039,0,0,6,6,
Mayes,Governor,Chad Moody,REP,490039,0,4,21,25,
Mayes,Governor,Mary Fallin,REP,490039,0,2,60,62,
Mayes,Superintendent of Public Instruction,Brian Kelly,REP,490039,0,1,22,23,
Mayes,Superintendent of Public Instruction,Janet Costello Barresi,REP,490039,0,1,12,13,
Mayes,Superintendent of Public Instruction,Joy Hofmeister,REP,490039,0,4,54,58,
Mayes,Insurance Commissioner,Bill Viner,REP,490039,0,4,25,29,
Mayes,Insurance Commissioner,John Doak,REP,490039,0,2,57,59,
Mayes,Corporation Commissioner,Todd Hiett,REP,490039,0,3,42,45,
Mayes,Corporation Commissioner,Cliff Branan,REP,490039,0,3,41,44,
Mayes,U.S. Senate,Evelyn Rogers,REP,490039,0,0,3,3,
Mayes,U.S. Senate,Rob Moye,REP,490039,0,0,4,4,
Mayes,U.S. Senate,D. Jean Mcbride-Samuels,REP,490039,0,0,3,3,
Mayes,U.S. Senate,Jim Inhofe,REP,490039,0,6,74,80,
Mayes,U.S. Senate,Erick Paul Wyatt,REP,490039,0,0,5,5,
Mayes,U.S. Senate,Andy Craig,REP,490039,0,0,0,0,
Mayes,U.S. Senate,T. Shannon,REP,490039,0,5,50,55,
Mayes,U.S. Senate,Randy Brogdon,REP,490039,0,0,3,3,
Mayes,U.S. Senate,Eric Mccray,REP,490039,0,0,0,0,
Mayes,U.S. Senate,Kevin Crow,REP,490039,0,0,4,4,
Mayes,U.S. Senate,James Lankford,REP,490039,0,0,30,30,
Mayes,U.S. Senate,Jason Weger,REP,490039,0,1,1,2,
Mayes,U.S. House,Darrel Robertson,REP,490039,0,0,16,16,02
Mayes,U.S. House,Markwayne Mullin,REP,490039,0,6,72,78,02
Mayes,Superintendent of Public Instruction,John Cox,DEM,490101,0,3,59,62,
Mayes,Superintendent of Public Instruction,Jack Jr.,DEM,490101,0,0,7,7,
Mayes,Superintendent of Public Instruction,Ivan Holmes,DEM,490101,1,0,3,4,
Mayes,Superintendent of Public Instruction,Freda Deskin,DEM,490101,2,0,26,28,
Mayes,U.S. Senate,Patrick Michael Hayes,DEM,490101,0,3,23,26,
Mayes,U.S. Senate,Jim Rogers,DEM,490101,2,0,34,36,
Mayes,U.S. Senate,Connie Johnson,DEM,490101,1,0,32,33,
Mayes,U.S. House,Earl Everett,DEM,490101,0,2,45,47,02
Mayes,U.S. House,Joshua Harris-Till,DEM,490101,2,0,46,48,02
Mayes,Governor,Dax Ewbank,REP,490101,0,0,6,6,
Mayes,Governor,Chad Moody,REP,490101,0,0,17,17,
Mayes,Governor,Mary Fallin,REP,490101,0,3,37,40,
Mayes,Superintendent of Public Instruction,Brian Kelly,REP,490101,0,0,22,22,
Mayes,Superintendent of Public Instruction,Janet Costello Barresi,REP,490101,0,0,10,10,
Mayes,Superintendent of Public Instruction,Joy Hofmeister,REP,490101,0,3,28,31,
Mayes,Insurance Commissioner,Bill Viner,REP,490101,0,0,19,19,
Mayes,Insurance Commissioner,John Doak,REP,490101,0,3,38,41,
Mayes,Corporation Commissioner,Todd Hiett,REP,490101,0,2,32,34,
Mayes,Corporation Commissioner,Cliff Branan,REP,490101,0,1,26,27,
Mayes,U.S. Senate,Evelyn Rogers,REP,490101,0,0,5,5,
Mayes,U.S. Senate,Rob Moye,REP,490101,0,0,1,1,
Mayes,U.S. Senate,D. Jean Mcbride-Samuels,REP,490101,0,0,0,0,
Mayes,U.S. Senate,Jim Inhofe,REP,490101,0,3,48,51,
Mayes,U.S. Senate,Erick Paul Wyatt,REP,490101,0,0,7,7,
Mayes,U.S. Senate,Andy Craig,REP,490101,0,0,2,2,
Mayes,U.S. Senate,T. Shannon,REP,490101,0,3,29,32,
Mayes,U.S. Senate,Randy Brogdon,REP,490101,0,0,2,2,
Mayes,U.S. Senate,Eric Mccray,REP,490101,0,0,0,0,
Mayes,U.S. Senate,Kevin Crow,REP,490101,0,0,0,0,
Mayes,U.S. Senate,James Lankford,REP,490101,0,0,28,28,
Mayes,U.S. Senate,Jason Weger,REP,490101,0,0,0,0,
Mayes,U.S. House,Darrel Robertson,REP,490101,0,2,13,15,02
Mayes,U.S. House,Markwayne Mullin,REP,490101,0,1,48,49,02
Mayes,Superintendent of Public Instruction,John Cox,DEM,490121,1,14,113,128,
Mayes,Superintendent of Public Instruction,Jack Jr.,DEM,490121,0,5,12,17,
Mayes,Superintendent of Public Instruction,Ivan Holmes,DEM,490121,0,1,5,6,
Mayes,Superintendent of Public Instruction,Freda Deskin,DEM,490121,1,1,22,24,
Mayes,U.S. Senate,Patrick Michael Hayes,DEM,490121,0,6,43,49,
Mayes,U.S. Senate,Jim Rogers,DEM,490121,1,9,57,67,
Mayes,U.S. Senate,Connie Johnson,DEM,490121,0,4,39,43,
Mayes,U.S. House,Earl Everett,DEM,490121,1,15,79,95,02
Mayes,U.S. House,Joshua Harris-Till,DEM,490121,0,4,56,60,02
Mayes,Governor,Dax Ewbank,REP,490121,0,2,14,16,
Mayes,Governor,Chad Moody,REP,490121,2,1,15,18,
Mayes,Governor,Mary Fallin,REP,490121,1,11,68,80,
Mayes,Superintendent of Public Instruction,Brian Kelly,REP,490121,2,3,24,29,
Mayes,Superintendent of Public Instruction,Janet Costello Barresi,REP,490121,0,3,9,12,
Mayes,Superintendent of Public Instruction,Joy Hofmeister,REP,490121,1,8,65,74,
Mayes,Insurance Commissioner,Bill Viner,REP,490121,0,3,26,29,
Mayes,Insurance Commissioner,John Doak,REP,490121,3,10,63,76,
Mayes,Corporation Commissioner,Todd Hiett,REP,490121,2,6,42,50,
Mayes,Corporation Commissioner,Cliff Branan,REP,490121,1,7,48,56,
Mayes,U.S. Senate,Evelyn Rogers,REP,490121,0,0,5,5,
Mayes,U.S. Senate,Rob Moye,REP,490121,0,1,2,3,
Mayes,U.S. Senate,D. Jean Mcbride-Samuels,REP,490121,0,0,3,3,
Mayes,U.S. Senate,Jim Inhofe,REP,490121,3,12,76,91,
Mayes,U.S. Senate,Erick Paul Wyatt,REP,490121,0,1,9,10,
Mayes,U.S. Senate,Andy Craig,REP,490121,0,0,1,1,
Mayes,U.S. Senate,T. Shannon,REP,490121,1,4,41,46,
Mayes,U.S. Senate,Randy Brogdon,REP,490121,0,0,6,6,
Mayes,U.S. Senate,Eric Mccray,REP,490121,0,0,0,0,
Mayes,U.S. Senate,Kevin Crow,REP,490121,0,1,1,2,
Mayes,U.S. Senate,James Lankford,REP,490121,2,9,47,58,
Mayes,U.S. Senate,Jason Weger,REP,490121,0,0,1,1,
Mayes,U.S. House,Darrel Robertson,REP,490121,0,4,23,27,02
Mayes,U.S. House,Markwayne Mullin,REP,490121,3,10,71,84,02
Mayes,Superintendent of Public Instruction,John Cox,DEM,490122,0,1,11,12,
Mayes,Superintendent of Public Instruction,Jack Jr.,DEM,490122,0,0,1,1,
Mayes,Superintendent of Public Instruction,Ivan Holmes,DEM,490122,0,0,0,0,
Mayes,Superintendent of Public Instruction,Freda Deskin,DEM,490122,0,0,3,3,
Mayes,U.S. Senate,Patrick Michael Hayes,DEM,490122,0,0,3,3,
Mayes,U.S. Senate,Jim Rogers,DEM,490122,0,1,8,9,
Mayes,U.S. Senate,Connie Johnson,DEM,490122,0,0,4,4,
Mayes,U.S. House,Earl Everett,DEM,490122,0,1,8,9,02
Mayes,U.S. House,Joshua Harris-Till,DEM,490122,0,0,7,7,02
Mayes,Governor,Dax Ewbank,REP,490122,0,0,2,2,
Mayes,Governor,Chad Moody,REP,490122,0,0,0,0,
Mayes,Governor,Mary Fallin,REP,490122,0,0,17,17,
Mayes,Superintendent of Public Instruction,Brian Kelly,REP,490122,0,0,1,1,
Mayes,Superintendent of Public Instruction,Janet Costello Barresi,REP,490122,0,0,5,5,
Mayes,Superintendent of Public Instruction,Joy Hofmeister,REP,490122,0,0,13,13,
Mayes,Insurance Commissioner,Bill Viner,REP,490122,0,0,2,2,
Mayes,Insurance Commissioner,John Doak,REP,490122,0,0,16,16,
Mayes,Corporation Commissioner,Todd Hiett,REP,490122,0,0,11,11,
Mayes,Corporation Commissioner,Cliff Branan,REP,490122,0,0,8,8,
Mayes,U.S. Senate,Evelyn Rogers,REP,490122,0,0,0,0,
Mayes,U.S. Senate,Rob Moye,REP,490122,0,0,0,0,
Mayes,U.S. Senate,D. Jean Mcbride-Samuels,REP,490122,0,0,0,0,
Mayes,U.S. Senate,Jim Inhofe,REP,490122,0,0,19,19,
Mayes,U.S. Senate,Erick Paul Wyatt,REP,490122,0,0,0,0,
Mayes,U.S. Senate,Andy Craig,REP,490122,0,0,0,0,
Mayes,U.S. Senate,T. Shannon,REP,490122,0,0,8,8,
Mayes,U.S. Senate,Randy Brogdon,REP,490122,0,0,1,1,
Mayes,U.S. Senate,Eric Mccray,REP,490122,0,0,0,0,
Mayes,U.S. Senate,Kevin Crow,REP,490122,0,0,0,0,
Mayes,U.S. Senate,James Lankford,REP,490122,0,0,10,10,
Mayes,U.S. Senate,Jason Weger,REP,490122,0,0,0,0,
Mayes,U.S. House,Darrel Robertson,REP,490122,0,0,0,0,02
Mayes,U.S. House,Markwayne Mullin,REP,490122,0,0,19,19,02
Mayes,Superintendent of Public Instruction,John Cox,DEM,490130,3,9,64,76,
Mayes,Superintendent of Public Instruction,Jack Jr.,DEM,490130,0,2,1,3,
Mayes,Superintendent of Public Instruction,Ivan Holmes,DEM,490130,0,0,4,4,
Mayes,Superintendent of Public Instruction,Freda Deskin,DEM,490130,0,1,25,26,
Mayes,U.S. Senate,Patrick Michael Hayes,DEM,490130,0,2,27,29,
Mayes,U.S. Senate,Jim Rogers,DEM,490130,1,6,31,38,
Mayes,U.S. Senate,Connie Johnson,DEM,490130,0,2,30,32,
Mayes,U.S. House,Earl Everett,DEM,490130,1,6,44,51,02
Mayes,U.S. House,Joshua Harris-Till,DEM,490130,0,4,43,47,02
Mayes,Governor,Dax Ewbank,REP,490130,0,1,5,6,
Mayes,Governor,Chad Moody,REP,490130,1,1,18,20,
Mayes,Governor,Mary Fallin,REP,490130,0,2,73,75,
Mayes,Superintendent of Public Instruction,Brian Kelly,REP,490130,0,0,18,18,
Mayes,Superintendent of Public Instruction,Janet Costello Barresi,REP,490130,0,2,14,16,
Mayes,Superintendent of Public Instruction,Joy Hofmeister,REP,490130,1,2,63,66,
Mayes,Insurance Commissioner,Bill Viner,REP,490130,1,1,25,27,
Mayes,Insurance Commissioner,John Doak,REP,490130,0,3,64,67,
Mayes,Corporation Commissioner,Todd Hiett,REP,490130,0,0,44,44,
Mayes,Corporation Commissioner,Cliff Branan,REP,490130,1,4,48,53,
Mayes,U.S. Senate,Evelyn Rogers,REP,490130,0,1,3,4,
Mayes,U.S. Senate,Rob Moye,REP,490130,0,0,3,3,
Mayes,U.S. Senate,D. Jean Mcbride-Samuels,REP,490130,1,0,2,3,
Mayes,U.S. Senate,Jim Inhofe,REP,490130,0,3,83,86,
Mayes,U.S. Senate,Erick Paul Wyatt,REP,490130,0,0,6,6,
Mayes,U.S. Senate,Andy Craig,REP,490130,0,0,3,3,
Mayes,U.S. Senate,T. Shannon,REP,490130,0,3,37,40,
Mayes,U.S. Senate,Randy Brogdon,REP,490130,1,0,4,5,
Mayes,U.S. Senate,Eric Mccray,REP,490130,0,0,0,0,
Mayes,U.S. Senate,Kevin Crow,REP,490130,0,0,0,0,
Mayes,U.S. Senate,James Lankford,REP,490130,0,1,52,53,
Mayes,U.S. Senate,Jason Weger,REP,490130,0,0,1,1,
Mayes,U.S. House,Darrel Robertson,REP,490130,1,1,22,24,02
Mayes,U.S. House,Markwayne Mullin,REP,490130,0,3,74,77,02
Mayes,Superintendent of Public Instruction,John Cox,DEM,490132,3,20,96,119,
Mayes,Superintendent of Public Instruction,Jack Jr.,DEM,490132,0,1,14,15,
Mayes,Superintendent of Public Instruction,Ivan Holmes,DEM,490132,0,1,9,10,
Mayes,Superintendent of Public Instruction,Freda Deskin,DEM,490132,0,2,27,29,
Mayes,U.S. Senate,Patrick Michael Hayes,DEM,490132,0,10,38,48,
Mayes,U.S. Senate,Jim Rogers,DEM,490132,0,6,48,54,
Mayes,U.S. Senate,Connie Johnson,DEM,490132,3,7,52,62,
Mayes,U.S. House,Earl Everett,DEM,490132,1,13,80,94,02
Mayes,U.S. House,Joshua Harris-Till,DEM,490132,2,10,53,65,02
Mayes,Governor,Dax Ewbank,REP,490132,1,2,10,13,
Mayes,Governor,Chad Moody,REP,490132,2,1,14,17,
Mayes,Governor,Mary Fallin,REP,490132,2,7,48,57,
Mayes,Superintendent of Public Instruction,Brian Kelly,REP,490132,1,4,19,24,
Mayes,Superintendent of Public Instruction,Janet Costello Barresi,REP,490132,0,0,9,9,
Mayes,Superintendent of Public Instruction,Joy Hofmeister,REP,490132,4,6,45,55,
Mayes,Insurance Commissioner,Bill Viner,REP,490132,0,0,19,19,
Mayes,Insurance Commissioner,John Doak,REP,490132,5,10,52,67,
Mayes,Corporation Commissioner,Todd Hiett,REP,490132,4,3,42,49,
Mayes,Corporation Commissioner,Cliff Branan,REP,490132,1,4,30,35,
Mayes,U.S. Senate,Evelyn Rogers,REP,490132,1,1,4,6,
Mayes,U.S. Senate,Rob Moye,REP,490132,0,0,2,2,
Mayes,U.S. Senate,D. Jean Mcbride-Samuels,REP,490132,0,0,2,2,
Mayes,U.S. Senate,Jim Inhofe,REP,490132,4,8,63,75,
Mayes,U.S. Senate,Erick Paul Wyatt,REP,490132,0,1,2,3,
Mayes,U.S. Senate,Andy Craig,REP,490132,0,0,2,2,
Mayes,U.S. Senate,T. Shannon,REP,490132,3,3,32,38,
Mayes,U.S. Senate,Randy Brogdon,REP,490132,0,0,6,6,
Mayes,U.S. Senate,Eric Mccray,REP,490132,0,0,0,0,
Mayes,U.S. Senate,Kevin Crow,REP,490132,0,1,1,2,
Mayes,U.S. Senate,James Lankford,REP,490132,2,5,30,37,
Mayes,U.S. Senate,Jason Weger,REP,490132,0,0,3,3,
Mayes,U.S. House,Darrel Robertson,REP,490132,0,0,11,11,02
Mayes,U.S. House,Markwayne Mullin,REP,490132,5,10,62,77,02
Mayes,Superintendent of Public Instruction,John Cox,DEM,490241,4,40,194,238,
Mayes,Superintendent of Public Instruction,Jack Jr.,DEM,490241,0,1,10,11,
Mayes,Superintendent of Public Instruction,Ivan Holmes,DEM,490241,1,1,10,12,
Mayes,Superintendent of Public Instruction,Freda Deskin,DEM,490241,1,5,47,53,
Mayes,U.S. Senate,Patrick Michael Hayes,DEM,490241,2,14,58,74,
Mayes,U.S. Senate,Jim Rogers,DEM,490241,3,20,97,120,
Mayes,U.S. Senate,Connie Johnson,DEM,490241,1,10,81,92,
Mayes,U.S. House,Earl Everett,DEM,490241,3,25,132,160,02
Mayes,U.S. House,Joshua Harris-Till,DEM,490241,3,17,91,111,02
Mayes,Governor,Dax Ewbank,REP,490241,0,0,15,15,
Mayes,Governor,Chad Moody,REP,490241,0,6,47,53,
Mayes,Governor,Mary Fallin,REP,490241,0,25,153,178,
Mayes,Superintendent of Public Instruction,Brian Kelly,REP,490241,0,4,37,41,
Mayes,Superintendent of Public Instruction,Janet Costello Barresi,REP,490241,0,2,34,36,
Mayes,Superintendent of Public Instruction,Joy Hofmeister,REP,490241,0,25,142,167,
Mayes,Insurance Commissioner,Bill Viner,REP,490241,0,7,53,60,
Mayes,Insurance Commissioner,John Doak,REP,490241,0,21,141,162,
Mayes,Corporation Commissioner,Todd Hiett,REP,490241,0,18,106,124,
Mayes,Corporation Commissioner,Cliff Branan,REP,490241,0,12,90,102,
Mayes,U.S. Senate,Evelyn Rogers,REP,490241,0,2,5,7,
Mayes,U.S. Senate,Rob Moye,REP,490241,0,0,8,8,
Mayes,U.S. Senate,D. Jean Mcbride-Samuels,REP,490241,0,0,6,6,
Mayes,U.S. Senate,Jim Inhofe,REP,490241,0,27,180,207,
Mayes,U.S. Senate,Erick Paul Wyatt,REP,490241,0,2,15,17,
Mayes,U.S. Senate,Andy Craig,REP,490241,0,0,4,4,
Mayes,U.S. Senate,T. Shannon,REP,490241,0,14,86,100,
Mayes,U.S. Senate,Randy Brogdon,REP,490241,0,3,8,11,
Mayes,U.S. Senate,Eric Mccray,REP,490241,0,0,0,0,
Mayes,U.S. Senate,Kevin Crow,REP,490241,0,0,4,4,
Mayes,U.S. Senate,James Lankford,REP,490241,0,14,117,131,
Mayes,U.S. Senate,Jason Weger,REP,490241,0,0,0,0,
Mayes,U.S. House,Darrel Robertson,REP,490241,0,5,32,37,02
Mayes,U.S. House,Markwayne Mullin,REP,490241,0,26,185,211,02
Mayes,Superintendent of Public Instruction,John Cox,DEM,490242,2,12,109,123,
Mayes,Superintendent of Public Instruction,Jack Jr.,DEM,490242,0,0,8,8,
Mayes,Superintendent of Public Instruction,Ivan Holmes,DEM,490242,0,1,4,5,
Mayes,Superintendent of Public Instruction,Freda Deskin,DEM,490242,1,1,19,21,
Mayes,U.S. Senate,Patrick Michael Hayes,DEM,490242,0,3,27,30,
Mayes,U.S. Senate,Jim Rogers,DEM,490242,0,7,57,64,
Mayes,U.S. Senate,Connie Johnson,DEM,490242,3,3,47,53,
Mayes,U.S. House,Earl Everett,DEM,490242,1,4,67,72,02
Mayes,U.S. House,Joshua Harris-Till,DEM,490242,2,9,58,69,02
Mayes,Governor,Dax Ewbank,REP,490242,0,0,10,10,
Mayes,Governor,Chad Moody,REP,490242,0,0,17,17,
Mayes,Governor,Mary Fallin,REP,490242,1,6,73,80,
Mayes,Superintendent of Public Instruction,Brian Kelly,REP,490242,0,2,25,27,
Mayes,Superintendent of Public Instruction,Janet Costello Barresi,REP,490242,0,0,12,12,
Mayes,Superintendent of Public Instruction,Joy Hofmeister,REP,490242,0,3,64,67,
Mayes,Insurance Commissioner,Bill Viner,REP,490242,0,0,19,19,
Mayes,Insurance Commissioner,John Doak,REP,490242,0,5,74,79,
Mayes,Corporation Commissioner,Todd Hiett,REP,490242,0,5,41,46,
Mayes,Corporation Commissioner,Cliff Branan,REP,490242,0,1,55,56,
Mayes,U.S. Senate,Evelyn Rogers,REP,490242,0,0,3,3,
Mayes,U.S. Senate,Rob Moye,REP,490242,0,0,4,4,
Mayes,U.S. Senate,D. Jean Mcbride-Samuels,REP,490242,0,0,1,1,
Mayes,U.S. Senate,Jim Inhofe,REP,490242,2,6,90,98,
Mayes,U.S. Senate,Erick Paul Wyatt,REP,490242,0,0,4,4,
Mayes,U.S. Senate,Andy Craig,REP,490242,0,0,5,5,
Mayes,U.S. Senate,T. Shannon,REP,490242,1,1,44,46,
Mayes,U.S. Senate,Randy Brogdon,REP,490242,0,0,6,6,
Mayes,U.S. Senate,Eric Mccray,REP,490242,0,0,0,0,
Mayes,U.S. Senate,Kevin Crow,REP,490242,0,0,2,2,
Mayes,U.S. Senate,James Lankford,REP,490242,1,4,44,49,
Mayes,U.S. Senate,Jason Weger,REP,490242,0,0,0,0,
Mayes,U.S. House,Darrel Robertson,REP,490242,1,0,19,20,02
Mayes,U.S. House,Markwayne Mullin,REP,490242,1,6,83,90,02
Mayes,Superintendent of Public Instruction,John Cox,DEM,490311,0,1,57,58,
Mayes,Superintendent of Public Instruction,Jack Jr.,DEM,490311,0,0,1,1,
Mayes,Superintendent of Public Instruction,Ivan Holmes,DEM,490311,0,0,1,1,
Mayes,Superintendent of Public Instruction,Freda Deskin,DEM,490311,0,0,10,10,
Mayes,U.S. Senate,Patrick Michael Hayes,DEM,490311,0,0,16,16,
Mayes,U.S. Senate,Jim Rogers,DEM,490311,0,0,32,32,
Mayes,U.S. Senate,Connie Johnson,DEM,490311,0,1,16,17,
Mayes,U.S. House,Earl Everett,DEM,490311,0,0,38,38,02
Mayes,U.S. House,Joshua Harris-Till,DEM,490311,0,1,23,24,02
Mayes,Governor,Dax Ewbank,REP,490311,0,0,4,4,
Mayes,Governor,Chad Moody,REP,490311,0,0,7,7,
Mayes,Governor,Mary Fallin,REP,490311,0,0,31,31,
Mayes,Superintendent of Public Instruction,Brian Kelly,REP,490311,0,0,9,9,
Mayes,Superintendent of Public Instruction,Janet Costello Barresi,REP,490311,0,0,8,8,
Mayes,Superintendent of Public Instruction,Joy Hofmeister,REP,490311,0,0,21,21,
Mayes,Insurance Commissioner,Bill Viner,REP,490311,0,0,11,11,
Mayes,Insurance Commissioner,John Doak,REP,490311,0,0,27,27,
Mayes,Corporation Commissioner,Todd Hiett,REP,490311,0,0,18,18,
Mayes,Corporation Commissioner,Cliff Branan,REP,490311,0,0,19,19,
Mayes,U.S. Senate,Evelyn Rogers,REP,490311,0,0,5,5,
Mayes,U.S. Senate,Rob Moye,REP,490311,0,0,0,0,
Mayes,U.S. Senate,D. Jean Mcbride-Samuels,REP,490311,0,0,0,0,
Mayes,U.S. Senate,Jim Inhofe,REP,490311,0,0,36,36,
Mayes,U.S. Senate,Erick Paul Wyatt,REP,490311,0,0,3,3,
Mayes,U.S. Senate,Andy Craig,REP,490311,0,0,1,1,
Mayes,U.S. Senate,T. Shannon,REP,490311,0,0,21,21,
Mayes,U.S. Senate,Randy Brogdon,REP,490311,0,0,7,7,
Mayes,U.S. Senate,Eric Mccray,REP,490311,0,0,0,0,
Mayes,U.S. Senate,Kevin Crow,REP,490311,0,0,0,0,
Mayes,U.S. Senate,James Lankford,REP,490311,0,0,13,13,
Mayes,U.S. Senate,Jason Weger,REP,490311,0,0,1,1,
Mayes,U.S. House,Darrel Robertson,REP,490311,0,0,7,7,02
Mayes,U.S. House,Markwayne Mullin,REP,490311,0,0,37,37,02
Murray,Superintendent of Public Instruction,John Cox,DEM,500004,0,12,62,74,
Murray,Superintendent of Public Instruction,Jack Jr.,DEM,500004,0,3,31,34,
Murray,Superintendent of Public Instruction,Ivan Holmes,DEM,500004,0,0,15,15,
Murray,Superintendent of Public Instruction,Freda Deskin,DEM,500004,2,13,100,115,
Murray,U.S. Senate,Patrick Michael Hayes,DEM,500004,0,7,46,53,
Murray,U.S. Senate,Jim Rogers,DEM,500004,2,6,81,89,
Murray,U.S. Senate,Connie Johnson,DEM,500004,0,15,71,86,
Murray,U.S. House,Bert Smith,DEM,500004,2,23,174,199,04
Murray,U.S. House,Tae Si,DEM,500004,1,5,26,32,04
Murray,Governor,Dax Ewbank,REP,500004,0,0,10,10,
Murray,Governor,Chad Moody,REP,500004,0,4,11,15,
Murray,Governor,Mary Fallin,REP,500004,0,7,65,72,
Murray,Superintendent of Public Instruction,Brian Kelly,REP,500004,0,3,21,24,
Murray,Superintendent of Public Instruction,Janet Costello Barresi,REP,500004,0,4,17,21,
Murray,Superintendent of Public Instruction,Joy Hofmeister,REP,500004,0,4,47,51,
Murray,Insurance Commissioner,Bill Viner,REP,500004,0,0,24,24,
Murray,Insurance Commissioner,John Doak,REP,500004,0,10,53,63,
Murray,Corporation Commissioner,Todd Hiett,REP,500004,0,4,32,36,
Murray,Corporation Commissioner,Cliff Branan,REP,500004,0,5,45,50,
Murray,U.S. Senate,Evelyn Rogers,REP,500004,0,0,9,9,
Murray,U.S. Senate,Rob Moye,REP,500004,0,0,0,0,
Murray,U.S. Senate,D. Jean Mcbride-Samuels,REP,500004,0,0,3,3,
Murray,U.S. Senate,Jim Inhofe,REP,500004,0,11,70,81,
Murray,U.S. Senate,Erick Paul Wyatt,REP,500004,0,0,3,3,
Murray,U.S. Senate,Andy Craig,REP,500004,0,0,2,2,
Murray,U.S. Senate,T. Shannon,REP,500004,0,3,28,31,
Murray,U.S. Senate,Randy Brogdon,REP,500004,0,0,1,1,
Murray,U.S. Senate,Eric Mccray,REP,500004,0,0,2,2,
Murray,U.S. Senate,Kevin Crow,REP,500004,0,0,0,0,
Murray,U.S. Senate,James Lankford,REP,500004,0,8,53,61,
Murray,U.S. Senate,Jason Weger,REP,500004,0,0,0,0,
Murray,U.S. House,Anna Flatt,REP,500004,0,2,14,16,04
Murray,U.S. House,Tom Cole,REP,500004,0,9,70,79,04
Murray,Superintendent of Public Instruction,John Cox,DEM,500005,1,6,113,120,
Murray,Superintendent of Public Instruction,Jack Jr.,DEM,500005,1,2,31,34,
Murray,Superintendent of Public Instruction,Ivan Holmes,DEM,500005,0,0,13,13,
Murray,Superintendent of Public Instruction,Freda Deskin,DEM,500005,0,9,148,157,
Murray,U.S. Senate,Patrick Michael Hayes,DEM,500005,0,4,69,73,
Murray,U.S. Senate,Jim Rogers,DEM,500005,2,8,112,122,
Murray,U.S. Senate,Connie Johnson,DEM,500005,0,6,116,122,
Murray,U.S. House,Bert Smith,DEM,500005,2,14,258,274,04
Murray,U.S. House,Tae Si,DEM,500005,0,4,33,37,04
Murray,Governor,Dax Ewbank,REP,500005,0,0,8,8,
Murray,Governor,Chad Moody,REP,500005,0,2,18,20,
Murray,Governor,Mary Fallin,REP,500005,5,3,69,77,
Murray,Superintendent of Public Instruction,Brian Kelly,REP,500005,0,1,17,18,
Murray,Superintendent of Public Instruction,Janet Costello Barresi,REP,500005,2,0,10,12,
Murray,Superintendent of Public Instruction,Joy Hofmeister,REP,500005,3,4,69,76,
Murray,Insurance Commissioner,Bill Viner,REP,500005,0,2,20,22,
Murray,Insurance Commissioner,John Doak,REP,500005,5,2,68,75,
Murray,Corporation Commissioner,Todd Hiett,REP,500005,1,0,50,51,
Murray,Corporation Commissioner,Cliff Branan,REP,500005,4,4,38,46,
Murray,U.S. Senate,Evelyn Rogers,REP,500005,0,1,6,7,
Murray,U.S. Senate,Rob Moye,REP,500005,0,0,2,2,
Murray,U.S. Senate,D. Jean Mcbride-Samuels,REP,500005,0,0,1,1,
Murray,U.S. Senate,Jim Inhofe,REP,500005,5,4,80,89,
Murray,U.S. Senate,Erick Paul Wyatt,REP,500005,0,0,5,5,
Murray,U.S. Senate,Andy Craig,REP,500005,0,0,0,0,
Murray,U.S. Senate,T. Shannon,REP,500005,1,3,39,43,
Murray,U.S. Senate,Randy Brogdon,REP,500005,0,0,3,3,
Murray,U.S. Senate,Eric Mccray,REP,500005,0,0,1,1,
Murray,U.S. Senate,Kevin Crow,REP,500005,0,0,0,0,
Murray,U.S. Senate,James Lankford,REP,500005,4,1,55,60,
Murray,U.S. Senate,Jason Weger,REP,500005,0,0,0,0,
Murray,U.S. House,Anna Flatt,REP,500005,0,1,12,13,04
Murray,U.S. House,Tom Cole,REP,500005,5,4,83,92,04
Murray,Superintendent of Public Instruction,John Cox,DEM,500007,0,0,37,37,
Murray,Superintendent of Public Instruction,Jack Jr.,DEM,500007,0,0,5,5,
Murray,Superintendent of Public Instruction,Ivan Holmes,DEM,500007,0,0,10,10,
Murray,Superintendent of Public Instruction,Freda Deskin,DEM,500007,0,3,21,24,
Murray,U.S. Senate,Patrick Michael Hayes,DEM,500007,0,0,23,23,
Murray,U.S. Senate,Jim Rogers,DEM,500007,0,1,28,29,
Murray,U.S. Senate,Connie Johnson,DEM,500007,0,1,19,20,
Murray,U.S. House,Bert Smith,DEM,500007,0,2,59,61,04
Murray,U.S. House,Tae Si,DEM,500007,0,1,9,10,04
Murray,Governor,Dax Ewbank,REP,500007,0,0,3,3,
Murray,Governor,Chad Moody,REP,500007,0,0,1,1,
Murray,Governor,Mary Fallin,REP,500007,0,2,30,32,
Murray,Superintendent of Public Instruction,Brian Kelly,REP,500007,0,0,11,11,
Murray,Superintendent of Public Instruction,Janet Costello Barresi,REP,500007,0,0,8,8,
Murray,Superintendent of Public Instruction,Joy Hofmeister,REP,500007,0,2,15,17,
Murray,Insurance Commissioner,Bill Viner,REP,500007,0,1,9,10,
Murray,Insurance Commissioner,John Doak,REP,500007,0,1,23,24,
Murray,Corporation Commissioner,Todd Hiett,REP,500007,0,1,21,22,
Murray,Corporation Commissioner,Cliff Branan,REP,500007,0,1,9,10,
Murray,U.S. Senate,Evelyn Rogers,REP,500007,0,0,1,1,
Murray,U.S. Senate,Rob Moye,REP,500007,0,0,1,1,
Murray,U.S. Senate,D. Jean Mcbride-Samuels,REP,500007,0,0,0,0,
Murray,U.S. Senate,Jim Inhofe,REP,500007,0,2,32,34,
Murray,U.S. Senate,Erick Paul Wyatt,REP,500007,0,0,0,0,
Murray,U.S. Senate,Andy Craig,REP,500007,0,0,0,0,
Murray,U.S. Senate,T. Shannon,REP,500007,0,0,14,14,
Murray,U.S. Senate,Randy Brogdon,REP,500007,0,0,0,0,
Murray,U.S. Senate,Eric Mccray,REP,500007,0,0,0,0,
Murray,U.S. Senate,Kevin Crow,REP,500007,0,0,0,0,
Murray,U.S. Senate,James Lankford,REP,500007,0,2,20,22,
Murray,U.S. Senate,Jason Weger,REP,500007,0,0,0,0,
Murray,U.S. House,Anna Flatt,REP,500007,0,0,3,3,04
Murray,U.S. House,Tom Cole,REP,500007,0,2,30,32,04
Murray,Superintendent of Public Instruction,John Cox,DEM,500009,3,4,50,57,
Murray,Superintendent of Public Instruction,Jack Jr.,DEM,500009,0,0,14,14,
Murray,Superintendent of Public Instruction,Ivan Holmes,DEM,500009,0,0,10,10,
Murray,Superintendent of Public Instruction,Freda Deskin,DEM,500009,0,11,48,59,
Murray,U.S. Senate,Patrick Michael Hayes,DEM,500009,1,6,20,27,
Murray,U.S. Senate,Jim Rogers,DEM,500009,0,7,61,68,
Murray,U.S. Senate,Connie Johnson,DEM,500009,2,1,31,34,
Murray,U.S. House,Bert Smith,DEM,500009,3,13,104,120,04
Murray,U.S. House,Tae Si,DEM,500009,0,1,15,16,04
Murray,Governor,Dax Ewbank,REP,500009,0,0,3,3,
Murray,Governor,Chad Moody,REP,500009,0,0,7,7,
Murray,Governor,Mary Fallin,REP,500009,0,5,23,28,
Murray,Superintendent of Public Instruction,Brian Kelly,REP,500009,0,0,9,9,
Murray,Superintendent of Public Instruction,Janet Costello Barresi,REP,500009,0,1,5,6,
Murray,Superintendent of Public Instruction,Joy Hofmeister,REP,500009,0,4,19,23,
Murray,Insurance Commissioner,Bill Viner,REP,500009,0,3,9,12,
Murray,Insurance Commissioner,John Doak,REP,500009,0,2,21,23,
Murray,Corporation Commissioner,Todd Hiett,REP,500009,0,3,13,16,
Murray,Corporation Commissioner,Cliff Branan,REP,500009,0,2,17,19,
Murray,U.S. Senate,Evelyn Rogers,REP,500009,0,0,1,1,
Murray,U.S. Senate,Rob Moye,REP,500009,0,0,1,1,
Murray,U.S. Senate,D. Jean Mcbride-Samuels,REP,500009,0,0,0,0,
Murray,U.S. Senate,Jim Inhofe,REP,500009,0,5,28,33,
Murray,U.S. Senate,Erick Paul Wyatt,REP,500009,0,0,3,3,
Murray,U.S. Senate,Andy Craig,REP,500009,0,0,0,0,
Murray,U.S. Senate,T. Shannon,REP,500009,0,3,9,12,
Murray,U.S. Senate,Randy Brogdon,REP,500009,0,0,1,1,
Murray,U.S. Senate,Eric Mccray,REP,500009,0,0,0,0,
Murray,U.S. Senate,Kevin Crow,REP,500009,0,0,0,0,
Murray,U.S. Senate,James Lankford,REP,500009,0,2,23,25,
Murray,U.S. Senate,Jason Weger,REP,500009,0,0,0,0,
Murray,U.S. House,Anna Flatt,REP,500009,0,2,4,6,04
Murray,U.S. House,Tom Cole,REP,500009,0,2,28,30,04
Murray,Superintendent of Public Instruction,John Cox,DEM,500012,2,1,32,35,
Murray,Superintendent of Public Instruction,Jack Jr.,DEM,500012,0,3,9,12,
Murray,Superintendent of Public Instruction,Ivan Holmes,DEM,500012,0,0,6,6,
Murray,Superintendent of Public Instruction,Freda Deskin,DEM,500012,0,0,25,25,
Murray,U.S. Senate,Patrick Michael Hayes,DEM,500012,1,1,15,17,
Murray,U.S. Senate,Jim Rogers,DEM,500012,0,3,34,37,
Murray,U.S. Senate,Connie Johnson,DEM,500012,0,0,20,20,
Murray,U.S. House,Bert Smith,DEM,500012,1,4,64,69,04
Murray,U.S. House,Tae Si,DEM,500012,0,0,4,4,04
Murray,Governor,Dax Ewbank,REP,500012,1,0,2,3,
Murray,Governor,Chad Moody,REP,500012,0,0,4,4,
Murray,Governor,Mary Fallin,REP,500012,1,0,31,32,
Murray,Superintendent of Public Instruction,Brian Kelly,REP,500012,0,0,14,14,
Murray,Superintendent of Public Instruction,Janet Costello Barresi,REP,500012,0,0,3,3,
Murray,Superintendent of Public Instruction,Joy Hofmeister,REP,500012,2,0,19,21,
Murray,Insurance Commissioner,Bill Viner,REP,500012,0,0,11,11,
Murray,Insurance Commissioner,John Doak,REP,500012,1,0,26,27,
Murray,Corporation Commissioner,Todd Hiett,REP,500012,1,0,16,17,
Murray,Corporation Commissioner,Cliff Branan,REP,500012,0,0,19,19,
Murray,U.S. Senate,Evelyn Rogers,REP,500012,0,0,2,2,
Murray,U.S. Senate,Rob Moye,REP,500012,0,0,0,0,
Murray,U.S. Senate,D. Jean Mcbride-Samuels,REP,500012,0,0,1,1,
Murray,U.S. Senate,Jim Inhofe,REP,500012,2,0,31,33,
Murray,U.S. Senate,Erick Paul Wyatt,REP,500012,0,0,3,3,
Murray,U.S. Senate,Andy Craig,REP,500012,0,0,0,0,
Murray,U.S. Senate,T. Shannon,REP,500012,0,0,18,18,
Murray,U.S. Senate,Randy Brogdon,REP,500012,0,0,1,1,
Murray,U.S. Senate,Eric Mccray,REP,500012,0,0,0,0,
Murray,U.S. Senate,Kevin Crow,REP,500012,0,0,0,0,
Murray,U.S. Senate,James Lankford,REP,500012,2,0,18,20,
Murray,U.S. Senate,Jason Weger,REP,500012,0,0,0,0,
Murray,U.S. House,Anna Flatt,REP,500012,0,0,3,3,04
Murray,U.S. House,Tom Cole,REP,500012,2,0,32,34,04
Murray,Superintendent of Public Instruction,John Cox,DEM,500014,0,3,23,26,
Murray,Superintendent of Public Instruction,Jack Jr.,DEM,500014,0,0,8,8,
Murray,Superintendent of Public Instruction,Ivan Holmes,DEM,500014,0,0,5,5,
Murray,Superintendent of Public Instruction,Freda Deskin,DEM,500014,0,3,37,40,
Murray,U.S. Senate,Patrick Michael Hayes,DEM,500014,0,0,19,19,
Murray,U.S. Senate,Jim Rogers,DEM,500014,0,1,33,34,
Murray,U.S. Senate,Connie Johnson,DEM,500014,0,5,19,24,
Murray,U.S. House,Bert Smith,DEM,500014,1,6,66,73,04
Murray,U.S. House,Tae Si,DEM,500014,0,0,6,6,04
Murray,Governor,Dax Ewbank,REP,500014,0,0,0,0,
Murray,Governor,Chad Moody,REP,500014,0,1,0,1,
Murray,Governor,Mary Fallin,REP,500014,0,0,10,10,
Murray,Superintendent of Public Instruction,Brian Kelly,REP,500014,0,0,3,3,
Murray,Superintendent of Public Instruction,Janet Costello Barresi,REP,500014,0,0,3,3,
Murray,Superintendent of Public Instruction,Joy Hofmeister,REP,500014,0,1,4,5,
Murray,Insurance Commissioner,Bill Viner,REP,500014,0,1,3,4,
Murray,Insurance Commissioner,John Doak,REP,500014,0,0,7,7,
Murray,Corporation Commissioner,Todd Hiett,REP,500014,0,0,5,5,
Murray,Corporation Commissioner,Cliff Branan,REP,500014,0,1,5,6,
Murray,U.S. Senate,Evelyn Rogers,REP,500014,0,0,0,0,
Murray,U.S. Senate,Rob Moye,REP,500014,0,0,0,0,
Murray,U.S. Senate,D. Jean Mcbride-Samuels,REP,500014,0,0,0,0,
Murray,U.S. Senate,Jim Inhofe,REP,500014,0,1,10,11,
Murray,U.S. Senate,Erick Paul Wyatt,REP,500014,0,0,0,0,
Murray,U.S. Senate,Andy Craig,REP,500014,0,0,0,0,
Murray,U.S. Senate,T. Shannon,REP,500014,0,0,2,2,
Murray,U.S. Senate,Randy Brogdon,REP,500014,0,0,0,0,
Murray,U.S. Senate,Eric Mccray,REP,500014,0,0,0,0,
Murray,U.S. Senate,Kevin Crow,REP,500014,0,0,0,0,
Murray,U.S. Senate,James Lankford,REP,500014,0,1,8,9,
Murray,U.S. Senate,Jason Weger,REP,500014,0,0,0,0,
Murray,U.S. House,Anna Flatt,REP,500014,0,0,1,1,04
Murray,U.S. House,Tom Cole,REP,500014,0,1,9,10,04
Murray,Superintendent of Public Instruction,John Cox,DEM,500015,0,25,118,143,
Murray,Superintendent of Public Instruction,Jack Jr.,DEM,500015,0,9,36,45,
Murray,Superintendent of Public Instruction,Ivan Holmes,DEM,500015,2,4,18,24,
Murray,Superintendent of Public Instruction,Freda Deskin,DEM,500015,2,35,123,160,
Murray,U.S. Senate,Patrick Michael Hayes,DEM,500015,0,15,75,90,
Murray,U.S. Senate,Jim Rogers,DEM,500015,0,28,109,137,
Murray,U.S. Senate,Connie Johnson,DEM,500015,4,28,97,129,
Murray,U.S. House,Bert Smith,DEM,500015,2,61,249,312,04
Murray,U.S. House,Tae Si,DEM,500015,1,10,33,44,04
Murray,Governor,Dax Ewbank,REP,500015,0,1,1,2,
Murray,Governor,Chad Moody,REP,500015,0,3,8,11,
Murray,Governor,Mary Fallin,REP,500015,7,5,63,75,
Murray,Superintendent of Public Instruction,Brian Kelly,REP,500015,2,5,18,25,
Murray,Superintendent of Public Instruction,Janet Costello Barresi,REP,500015,0,1,13,14,
Murray,Superintendent of Public Instruction,Joy Hofmeister,REP,500015,5,3,39,47,
Murray,Insurance Commissioner,Bill Viner,REP,500015,4,2,13,19,
Murray,Insurance Commissioner,John Doak,REP,500015,3,5,52,60,
Murray,Corporation Commissioner,Todd Hiett,REP,500015,4,3,29,36,
Murray,Corporation Commissioner,Cliff Branan,REP,500015,3,7,38,48,
Murray,U.S. Senate,Evelyn Rogers,REP,500015,0,1,4,5,
Murray,U.S. Senate,Rob Moye,REP,500015,0,1,0,1,
Murray,U.S. Senate,D. Jean Mcbride-Samuels,REP,500015,0,0,0,0,
Murray,U.S. Senate,Jim Inhofe,REP,500015,6,5,60,71,
Murray,U.S. Senate,Erick Paul Wyatt,REP,500015,1,2,8,11,
Murray,U.S. Senate,Andy Craig,REP,500015,0,0,1,1,
Murray,U.S. Senate,T. Shannon,REP,500015,3,6,28,37,
Murray,U.S. Senate,Randy Brogdon,REP,500015,0,0,2,2,
Murray,U.S. Senate,Eric Mccray,REP,500015,0,0,0,0,
Murray,U.S. Senate,Kevin Crow,REP,500015,0,0,1,1,
Murray,U.S. Senate,James Lankford,REP,500015,4,3,38,45,
Murray,U.S. Senate,Jason Weger,REP,500015,0,0,2,2,
Murray,U.S. House,Anna Flatt,REP,500015,1,4,12,17,04
Murray,U.S. House,Tom Cole,REP,500015,6,5,60,71,04
Murray,Superintendent of Public Instruction,John Cox,DEM,500017,0,1,17,18,
Murray,Superintendent of Public Instruction,Jack Jr.,DEM,500017,0,0,2,2,
Murray,Superintendent of Public Instruction,Ivan Holmes,DEM,500017,0,0,0,0,
Murray,Superintendent of Public Instruction,Freda Deskin,DEM,500017,0,0,15,15,
Murray,U.S. Senate,Patrick Michael Hayes,DEM,500017,0,0,5,5,
Murray,U.S. Senate,Jim Rogers,DEM,500017,0,1,15,16,
Murray,U.S. Senate,Connie Johnson,DEM,500017,0,0,12,12,
Murray,U.S. House,Bert Smith,DEM,500017,0,1,26,27,04
Murray,U.S. House,Tae Si,DEM,500017,0,0,6,6,04
Murray,Governor,Dax Ewbank,REP,500017,0,0,0,0,
Murray,Governor,Chad Moody,REP,500017,0,0,1,1,
Murray,Governor,Mary Fallin,REP,500017,0,3,7,10,
Murray,Superintendent of Public Instruction,Brian Kelly,REP,500017,0,0,2,2,
Murray,Superintendent of Public Instruction,Janet Costello Barresi,REP,500017,0,0,2,2,
Murray,Superintendent of Public Instruction,Joy Hofmeister,REP,500017,0,3,4,7,
Murray,Insurance Commissioner,Bill Viner,REP,500017,0,1,2,3,
Murray,Insurance Commissioner,John Doak,REP,500017,0,2,5,7,
Murray,Corporation Commissioner,Todd Hiett,REP,500017,0,2,4,6,
Murray,Corporation Commissioner,Cliff Branan,REP,500017,0,1,4,5,
Murray,U.S. Senate,Evelyn Rogers,REP,500017,0,0,0,0,
Murray,U.S. Senate,Rob Moye,REP,500017,0,0,0,0,
Murray,U.S. Senate,D. Jean Mcbride-Samuels,REP,500017,0,0,0,0,
Murray,U.S. Senate,Jim Inhofe,REP,500017,0,3,8,11,
Murray,U.S. Senate,Erick Paul Wyatt,REP,500017,0,0,0,0,
Murray,U.S. Senate,Andy Craig,REP,500017,0,0,0,0,
Murray,U.S. Senate,T. Shannon,REP,500017,0,1,4,5,
Murray,U.S. Senate,Randy Brogdon,REP,500017,0,0,0,0,
Murray,U.S. Senate,Eric Mccray,REP,500017,0,0,0,0,
Murray,U.S. Senate,Kevin Crow,REP,500017,0,0,0,0,
Murray,U.S. Senate,James Lankford,REP,500017,0,2,4,6,
Murray,U.S. Senate,Jason Weger,REP,500017,0,0,0,0,
Murray,U.S. House,Anna Flatt,REP,500017,0,1,0,1,04
Murray,U.S. House,Tom Cole,REP,500017,0,2,8,10,04
Murray,Superintendent of Public Instruction,John Cox,DEM,500018,0,8,53,61,
Murray,Superintendent of Public Instruction,Jack Jr.,DEM,500018,0,1,25,26,
Murray,Superintendent of Public Instruction,Ivan Holmes,DEM,500018,0,1,8,9,
Murray,Superintendent of Public Instruction,Freda Deskin,DEM,500018,2,8,56,66,
Murray,U.S. Senate,Patrick Michael Hayes,DEM,500018,0,3,35,38,
Murray,U.S. Senate,Jim Rogers,DEM,500018,1,8,56,65,
Murray,U.S. Senate,Connie Johnson,DEM,500018,0,5,40,45,
Murray,U.S. House,Bert Smith,DEM,500018,1,17,114,132,04
Murray,U.S. House,Tae Si,DEM,500018,0,0,18,18,04
Murray,Governor,Dax Ewbank,REP,500018,0,0,4,4,
Murray,Governor,Chad Moody,REP,500018,0,1,15,16,
Murray,Governor,Mary Fallin,REP,500018,0,3,33,36,
Murray,Superintendent of Public Instruction,Brian Kelly,REP,500018,0,2,12,14,
Murray,Superintendent of Public Instruction,Janet Costello Barresi,REP,500018,0,0,11,11,
Murray,Superintendent of Public Instruction,Joy Hofmeister,REP,500018,0,2,28,30,
Murray,Insurance Commissioner,Bill Viner,REP,500018,0,0,12,12,
Murray,Insurance Commissioner,John Doak,REP,500018,0,4,36,40,
Murray,Corporation Commissioner,Todd Hiett,REP,500018,0,1,18,19,
Murray,Corporation Commissioner,Cliff Branan,REP,500018,0,3,30,33,
Murray,U.S. Senate,Evelyn Rogers,REP,500018,0,0,4,4,
Murray,U.S. Senate,Rob Moye,REP,500018,0,0,1,1,
Murray,U.S. Senate,D. Jean Mcbride-Samuels,REP,500018,0,0,1,1,
Murray,U.S. Senate,Jim Inhofe,REP,500018,0,4,46,50,
Murray,U.S. Senate,Erick Paul Wyatt,REP,500018,0,0,0,0,
Murray,U.S. Senate,Andy Craig,REP,500018,0,0,1,1,
Murray,U.S. Senate,T. Shannon,REP,500018,0,2,24,26,
Murray,U.S. Senate,Randy Brogdon,REP,500018,0,0,2,2,
Murray,U.S. Senate,Eric Mccray,REP,500018,0,0,1,1,
Murray,U.S. Senate,Kevin Crow,REP,500018,0,0,0,0,
Murray,U.S. Senate,James Lankford,REP,500018,0,2,24,26,
Murray,U.S. Senate,Jason Weger,REP,500018,0,0,0,0,
Murray,U.S. House,Anna Flatt,REP,500018,0,0,10,10,04
Murray,U.S. House,Tom Cole,REP,500018,0,4,42,46,04
Murray,Superintendent of Public Instruction,John Cox,DEM,500020,6,17,81,104,
Murray,Superintendent of Public Instruction,Jack Jr.,DEM,500020,1,8,30,39,
Murray,Superintendent of Public Instruction,Ivan Holmes,DEM,500020,0,1,6,7,
Murray,Superintendent of Public Instruction,Freda Deskin,DEM,500020,2,16,90,108,
Murray,U.S. Senate,Patrick Michael Hayes,DEM,500020,2,9,52,63,
Murray,U.S. Senate,Jim Rogers,DEM,500020,5,17,80,102,
Murray,U.S. Senate,Connie Johnson,DEM,500020,4,13,67,84,
Murray,U.S. House,Bert Smith,DEM,500020,9,38,176,223,04
Murray,U.S. House,Tae Si,DEM,500020,2,0,20,22,04
Murray,Governor,Dax Ewbank,REP,500020,0,2,3,5,
Murray,Governor,Chad Moody,REP,500020,0,1,8,9,
Murray,Governor,Mary Fallin,REP,500020,0,6,57,63,
Murray,Superintendent of Public Instruction,Brian Kelly,REP,500020,0,1,10,11,
Murray,Superintendent of Public Instruction,Janet Costello Barresi,REP,500020,0,0,7,7,
Murray,Superintendent of Public Instruction,Joy Hofmeister,REP,500020,0,8,51,59,
Murray,Insurance Commissioner,Bill Viner,REP,500020,0,3,19,22,
Murray,Insurance Commissioner,John Doak,REP,500020,0,6,43,49,
Murray,Corporation Commissioner,Todd Hiett,REP,500020,0,3,41,44,
Murray,Corporation Commissioner,Cliff Branan,REP,500020,0,6,22,28,
Murray,U.S. Senate,Evelyn Rogers,REP,500020,0,0,1,1,
Murray,U.S. Senate,Rob Moye,REP,500020,0,0,0,0,
Murray,U.S. Senate,D. Jean Mcbride-Samuels,REP,500020,0,1,1,2,
Murray,U.S. Senate,Jim Inhofe,REP,500020,0,7,59,66,
Murray,U.S. Senate,Erick Paul Wyatt,REP,500020,0,1,5,6,
Murray,U.S. Senate,Andy Craig,REP,500020,0,0,0,0,
Murray,U.S. Senate,T. Shannon,REP,500020,0,6,28,34,
Murray,U.S. Senate,Randy Brogdon,REP,500020,0,0,1,1,
Murray,U.S. Senate,Eric Mccray,REP,500020,0,0,0,0,
Murray,U.S. Senate,Kevin Crow,REP,500020,0,0,2,2,
Murray,U.S. Senate,James Lankford,REP,500020,0,3,38,41,
Murray,U.S. Senate,Jason Weger,REP,500020,0,0,0,0,
Murray,U.S. House,Anna Flatt,REP,500020,0,1,8,9,04
Murray,U.S. House,Tom Cole,REP,500020,0,8,61,69,04
Muskogee,Superintendent of Public Instruction,John Cox,DEM,510005,0,6,107,113,
Muskogee,Superintendent of Public Instruction,Jack Jr.,DEM,510005,1,5,45,51,
Muskogee,Superintendent of Public Instruction,Ivan Holmes,DEM,510005,1,0,26,27,
Muskogee,Superintendent of Public Instruction,Freda Deskin,DEM,510005,3,6,107,116,
Muskogee,U.S. Senate,Patrick Michael Hayes,DEM,510005,0,3,63,66,
Muskogee,U.S. Senate,Jim Rogers,DEM,510005,1,9,129,139,
Muskogee,U.S. Senate,Connie Johnson,DEM,510005,4,6,95,105,
Muskogee,U.S. House,Earl Everett,DEM,510005,2,9,205,216,02
Muskogee,U.S. House,Joshua Harris-Till,DEM,510005,3,8,72,83,02
Muskogee,Governor,Dax Ewbank,REP,510005,0,0,8,8,
Muskogee,Governor,Chad Moody,REP,510005,0,1,39,40,
Muskogee,Governor,Mary Fallin,REP,510005,4,4,78,86,
Muskogee,Superintendent of Public Instruction,Brian Kelly,REP,510005,0,2,38,40,
Muskogee,Superintendent of Public Instruction,Janet Costello Barresi,REP,510005,1,0,19,20,
Muskogee,Superintendent of Public Instruction,Joy Hofmeister,REP,510005,3,3,66,72,
Muskogee,Insurance Commissioner,Bill Viner,REP,510005,1,1,18,20,
Muskogee,Insurance Commissioner,John Doak,REP,510005,3,3,100,106,
Muskogee,Corporation Commissioner,Todd Hiett,REP,510005,2,2,54,58,
Muskogee,Corporation Commissioner,Cliff Branan,REP,510005,1,3,60,64,
Muskogee,U.S. Senate,Evelyn Rogers,REP,510005,0,0,8,8,
Muskogee,U.S. Senate,Rob Moye,REP,510005,0,0,8,8,
Muskogee,U.S. Senate,D. Jean Mcbride-Samuels,REP,510005,0,0,2,2,
Muskogee,U.S. Senate,Jim Inhofe,REP,510005,4,5,99,108,
Muskogee,U.S. Senate,Erick Paul Wyatt,REP,510005,0,0,7,7,
Muskogee,U.S. Senate,Andy Craig,REP,510005,0,0,3,3,
Muskogee,U.S. Senate,T. Shannon,REP,510005,4,1,52,57,
Muskogee,U.S. Senate,Randy Brogdon,REP,510005,0,0,10,10,
Muskogee,U.S. Senate,Eric Mccray,REP,510005,0,0,4,4,
Muskogee,U.S. Senate,Kevin Crow,REP,510005,0,0,5,5,
Muskogee,U.S. Senate,James Lankford,REP,510005,0,4,52,56,
Muskogee,U.S. Senate,Jason Weger,REP,510005,0,0,0,0,
Muskogee,U.S. House,Darrel Robertson,REP,510005,0,2,32,34,02
Muskogee,U.S. House,Markwayne Mullin,REP,510005,4,3,92,99,02
Muskogee,Superintendent of Public Instruction,John Cox,DEM,510007,4,9,144,157,
Muskogee,Superintendent of Public Instruction,Jack Jr.,DEM,510007,0,6,59,65,
Muskogee,Superintendent of Public Instruction,Ivan Holmes,DEM,510007,0,5,26,31,
Muskogee,Superintendent of Public Instruction,Freda Deskin,DEM,510007,2,12,185,199,
Muskogee,U.S. Senate,Patrick Michael Hayes,DEM,510007,1,5,90,96,
Muskogee,U.S. Senate,Jim Rogers,DEM,510007,2,14,187,203,
Muskogee,U.S. Senate,Connie Johnson,DEM,510007,3,11,117,131,
Muskogee,U.S. House,Earl Everett,DEM,510007,5,20,256,281,02
Muskogee,U.S. House,Joshua Harris-Till,DEM,510007,1,7,120,128,02
Muskogee,Governor,Dax Ewbank,REP,510007,3,1,10,14,
Muskogee,Governor,Chad Moody,REP,510007,0,7,25,32,
Muskogee,Governor,Mary Fallin,REP,510007,2,13,158,173,
Muskogee,Superintendent of Public Instruction,Brian Kelly,REP,510007,1,4,42,47,
Muskogee,Superintendent of Public Instruction,Janet Costello Barresi,REP,510007,0,2,37,39,
Muskogee,Superintendent of Public Instruction,Joy Hofmeister,REP,510007,4,15,111,130,
Muskogee,Insurance Commissioner,Bill Viner,REP,510007,1,6,31,38,
Muskogee,Insurance Commissioner,John Doak,REP,510007,4,14,151,169,
Muskogee,Corporation Commissioner,Todd Hiett,REP,510007,3,11,94,108,
Muskogee,Corporation Commissioner,Cliff Branan,REP,510007,1,6,77,84,
Muskogee,U.S. Senate,Evelyn Rogers,REP,510007,1,1,7,9,
Muskogee,U.S. Senate,Rob Moye,REP,510007,0,2,3,5,
Muskogee,U.S. Senate,D. Jean Mcbride-Samuels,REP,510007,0,0,3,3,
Muskogee,U.S. Senate,Jim Inhofe,REP,510007,4,18,170,192,
Muskogee,U.S. Senate,Erick Paul Wyatt,REP,510007,0,1,10,11,
Muskogee,U.S. Senate,Andy Craig,REP,510007,0,0,0,0,
Muskogee,U.S. Senate,T. Shannon,REP,510007,3,14,66,83,
Muskogee,U.S. Senate,Randy Brogdon,REP,510007,0,1,4,5,
Muskogee,U.S. Senate,Eric Mccray,REP,510007,0,0,6,6,
Muskogee,U.S. Senate,Kevin Crow,REP,510007,0,2,2,4,
Muskogee,U.S. Senate,James Lankford,REP,510007,2,4,116,122,
Muskogee,U.S. Senate,Jason Weger,REP,510007,0,0,1,1,
Muskogee,U.S. House,Darrel Robertson,REP,510007,1,10,45,56,02
Muskogee,U.S. House,Markwayne Mullin,REP,510007,4,11,146,161,02
Muskogee,Superintendent of Public Instruction,John Cox,DEM,510009,1,12,140,153,
Muskogee,Superintendent of Public Instruction,Jack Jr.,DEM,510009,0,5,69,74,
Muskogee,Superintendent of Public Instruction,Ivan Holmes,DEM,510009,0,5,19,24,
Muskogee,Superintendent of Public Instruction,Freda Deskin,DEM,510009,1,14,145,160,
Muskogee,U.S. Senate,Patrick Michael Hayes,DEM,510009,0,6,91,97,
Muskogee,U.S. Senate,Jim Rogers,DEM,510009,1,13,164,178,
Muskogee,U.S. Senate,Connie Johnson,DEM,510009,1,17,104,122,
Muskogee,U.S. House,Earl Everett,DEM,510009,2,27,240,269,02
Muskogee,U.S. House,Joshua Harris-Till,DEM,510009,0,8,105,113,02
Muskogee,Governor,Dax Ewbank,REP,510009,0,1,18,19,
Muskogee,Governor,Chad Moody,REP,510009,0,6,49,55,
Muskogee,Governor,Mary Fallin,REP,510009,2,21,213,236,
Muskogee,Superintendent of Public Instruction,Brian Kelly,REP,510009,1,6,51,58,
Muskogee,Superintendent of Public Instruction,Janet Costello Barresi,REP,510009,1,5,45,51,
Muskogee,Superintendent of Public Instruction,Joy Hofmeister,REP,510009,0,17,178,195,
Muskogee,Insurance Commissioner,Bill Viner,REP,510009,0,4,31,35,
Muskogee,Insurance Commissioner,John Doak,REP,510009,2,24,234,260,
Muskogee,Corporation Commissioner,Todd Hiett,REP,510009,1,15,116,132,
Muskogee,Corporation Commissioner,Cliff Branan,REP,510009,1,13,141,155,
Muskogee,U.S. Senate,Evelyn Rogers,REP,510009,0,2,15,17,
Muskogee,U.S. Senate,Rob Moye,REP,510009,0,1,6,7,
Muskogee,U.S. Senate,D. Jean Mcbride-Samuels,REP,510009,0,0,1,1,
Muskogee,U.S. Senate,Jim Inhofe,REP,510009,1,25,235,261,
Muskogee,U.S. Senate,Erick Paul Wyatt,REP,510009,1,0,19,20,
Muskogee,U.S. Senate,Andy Craig,REP,510009,0,0,2,2,
Muskogee,U.S. Senate,T. Shannon,REP,510009,1,8,125,134,
Muskogee,U.S. Senate,Randy Brogdon,REP,510009,0,0,7,7,
Muskogee,U.S. Senate,Eric Mccray,REP,510009,0,0,3,3,
Muskogee,U.S. Senate,Kevin Crow,REP,510009,0,0,5,5,
Muskogee,U.S. Senate,James Lankford,REP,510009,1,20,133,154,
Muskogee,U.S. Senate,Jason Weger,REP,510009,0,0,2,2,
Muskogee,U.S. House,Darrel Robertson,REP,510009,1,6,72,79,02
Muskogee,U.S. House,Markwayne Mullin,REP,510009,1,22,207,230,02
Muskogee,Superintendent of Public Instruction,John Cox,DEM,510011,0,2,48,50,
Muskogee,Superintendent of Public Instruction,Jack Jr.,DEM,510011,0,0,25,25,
Muskogee,Superintendent of Public Instruction,Ivan Holmes,DEM,510011,0,0,15,15,
Muskogee,Superintendent of Public Instruction,Freda Deskin,DEM,510011,0,5,37,42,
Muskogee,U.S. Senate,Patrick Michael Hayes,DEM,510011,0,2,23,25,
Muskogee,U.S. Senate,Jim Rogers,DEM,510011,0,3,59,62,
Muskogee,U.S. Senate,Connie Johnson,DEM,510011,0,2,36,38,
Muskogee,U.S. House,Earl Everett,DEM,510011,0,3,84,87,02
Muskogee,U.S. House,Joshua Harris-Till,DEM,510011,0,4,31,35,02
Muskogee,Governor,Dax Ewbank,REP,510011,0,0,4,4,
Muskogee,Governor,Chad Moody,REP,510011,0,0,8,8,
Muskogee,Governor,Mary Fallin,REP,510011,0,2,39,41,
Muskogee,Superintendent of Public Instruction,Brian Kelly,REP,510011,0,0,15,15,
Muskogee,Superintendent of Public Instruction,Janet Costello Barresi,REP,510011,0,1,12,13,
Muskogee,Superintendent of Public Instruction,Joy Hofmeister,REP,510011,0,0,24,24,
Muskogee,Insurance Commissioner,Bill Viner,REP,510011,0,0,9,9,
Muskogee,Insurance Commissioner,John Doak,REP,510011,0,2,41,43,
Muskogee,Corporation Commissioner,Todd Hiett,REP,510011,0,1,33,34,
Muskogee,Corporation Commissioner,Cliff Branan,REP,510011,0,1,17,18,
Muskogee,U.S. Senate,Evelyn Rogers,REP,510011,0,0,4,4,
Muskogee,U.S. Senate,Rob Moye,REP,510011,0,0,1,1,
Muskogee,U.S. Senate,D. Jean Mcbride-Samuels,REP,510011,0,0,2,2,
Muskogee,U.S. Senate,Jim Inhofe,REP,510011,0,2,38,40,
Muskogee,U.S. Senate,Erick Paul Wyatt,REP,510011,0,0,5,5,
Muskogee,U.S. Senate,Andy Craig,REP,510011,0,0,0,0,
Muskogee,U.S. Senate,T. Shannon,REP,510011,0,2,31,33,
Muskogee,U.S. Senate,Randy Brogdon,REP,510011,0,0,1,1,
Muskogee,U.S. Senate,Eric Mccray,REP,510011,0,0,0,0,
Muskogee,U.S. Senate,Kevin Crow,REP,510011,0,0,1,1,
Muskogee,U.S. Senate,James Lankford,REP,510011,0,0,16,16,
Muskogee,U.S. Senate,Jason Weger,REP,510011,0,0,2,2,
Muskogee,U.S. House,Darrel Robertson,REP,510011,0,0,14,14,02
Muskogee,U.S. House,Markwayne Mullin,REP,510011,0,2,36,38,02
Muskogee,Superintendent of Public Instruction,John Cox,DEM,510013,1,7,79,87,
Muskogee,Superintendent of Public Instruction,Jack Jr.,DEM,510013,1,2,30,33,
Muskogee,Superintendent of Public Instruction,Ivan Holmes,DEM,510013,0,2,19,21,
Muskogee,Superintendent of Public Instruction,Freda Deskin,DEM,510013,0,7,61,68,
Muskogee,U.S. Senate,Patrick Michael Hayes,DEM,510013,0,1,49,50,
Muskogee,U.S. Senate,Jim Rogers,DEM,510013,2,10,90,102,
Muskogee,U.S. Senate,Connie Johnson,DEM,510013,0,7,44,51,
Muskogee,U.S. House,Earl Everett,DEM,510013,2,13,120,135,02
Muskogee,U.S. House,Joshua Harris-Till,DEM,510013,0,4,51,55,02
Muskogee,Governor,Dax Ewbank,REP,510013,0,1,7,8,
Muskogee,Governor,Chad Moody,REP,510013,0,1,21,22,
Muskogee,Governor,Mary Fallin,REP,510013,2,5,70,77,
Muskogee,Superintendent of Public Instruction,Brian Kelly,REP,510013,0,6,27,33,
Muskogee,Superintendent of Public Instruction,Janet Costello Barresi,REP,510013,0,1,16,17,
Muskogee,Superintendent of Public Instruction,Joy Hofmeister,REP,510013,2,0,53,55,
Muskogee,Insurance Commissioner,Bill Viner,REP,510013,0,1,14,15,
Muskogee,Insurance Commissioner,John Doak,REP,510013,2,6,79,87,
Muskogee,Corporation Commissioner,Todd Hiett,REP,510013,0,0,42,42,
Muskogee,Corporation Commissioner,Cliff Branan,REP,510013,1,6,49,56,
Muskogee,U.S. Senate,Evelyn Rogers,REP,510013,0,0,11,11,
Muskogee,U.S. Senate,Rob Moye,REP,510013,0,1,0,1,
Muskogee,U.S. Senate,D. Jean Mcbride-Samuels,REP,510013,0,0,1,1,
Muskogee,U.S. Senate,Jim Inhofe,REP,510013,2,6,82,90,
Muskogee,U.S. Senate,Erick Paul Wyatt,REP,510013,0,0,5,5,
Muskogee,U.S. Senate,Andy Craig,REP,510013,0,0,1,1,
Muskogee,U.S. Senate,T. Shannon,REP,510013,2,1,43,46,
Muskogee,U.S. Senate,Randy Brogdon,REP,510013,0,0,1,1,
Muskogee,U.S. Senate,Eric Mccray,REP,510013,0,0,3,3,
Muskogee,U.S. Senate,Kevin Crow,REP,510013,0,0,7,7,
Muskogee,U.S. Senate,James Lankford,REP,510013,0,6,45,51,
Muskogee,U.S. Senate,Jason Weger,REP,510013,0,0,0,0,
Muskogee,U.S. House,Darrel Robertson,REP,510013,0,1,27,28,02
Muskogee,U.S. House,Markwayne Mullin,REP,510013,2,6,71,79,02
Muskogee,Superintendent of Public Instruction,John Cox,DEM,510017,0,0,37,37,
Muskogee,Superintendent of Public Instruction,Jack Jr.,DEM,510017,0,3,24,27,
Muskogee,Superintendent of Public Instruction,Ivan Holmes,DEM,510017,0,0,14,14,
Muskogee,Superintendent of Public Instruction,Freda Deskin,DEM,510017,0,4,46,50,
Muskogee,U.S. Senate,Patrick Michael Hayes,DEM,510017,0,1,20,21,
Muskogee,U.S. Senate,Jim Rogers,DEM,510017,0,3,31,34,
Muskogee,U.S. Senate,Connie Johnson,DEM,510017,0,3,70,73,
Muskogee,U.S. House,Earl Everett,DEM,510017,0,6,53,59,02
Muskogee,U.S. House,Joshua Harris-Till,DEM,510017,0,1,61,62,02
Muskogee,Governor,Dax Ewbank,REP,510017,0,0,3,3,
Muskogee,Governor,Chad Moody,REP,510017,0,0,3,3,
Muskogee,Governor,Mary Fallin,REP,510017,2,1,10,13,
Muskogee,Superintendent of Public Instruction,Brian Kelly,REP,510017,0,0,3,3,
Muskogee,Superintendent of Public Instruction,Janet Costello Barresi,REP,510017,0,0,3,3,
Muskogee,Superintendent of Public Instruction,Joy Hofmeister,REP,510017,2,0,10,12,
Muskogee,Insurance Commissioner,Bill Viner,REP,510017,0,0,3,3,
Muskogee,Insurance Commissioner,John Doak,REP,510017,2,1,12,15,
Muskogee,Corporation Commissioner,Todd Hiett,REP,510017,2,1,7,10,
Muskogee,Corporation Commissioner,Cliff Branan,REP,510017,0,0,7,7,
Muskogee,U.S. Senate,Evelyn Rogers,REP,510017,0,0,1,1,
Muskogee,U.S. Senate,Rob Moye,REP,510017,0,0,1,1,
Muskogee,U.S. Senate,D. Jean Mcbride-Samuels,REP,510017,0,0,0,0,
Muskogee,U.S. Senate,Jim Inhofe,REP,510017,2,1,13,16,
Muskogee,U.S. Senate,Erick Paul Wyatt,REP,510017,0,0,1,1,
Muskogee,U.S. Senate,Andy Craig,REP,510017,0,0,1,1,
Muskogee,U.S. Senate,T. Shannon,REP,510017,0,1,8,9,
Muskogee,U.S. Senate,Randy Brogdon,REP,510017,0,0,2,2,
Muskogee,U.S. Senate,Eric Mccray,REP,510017,0,0,0,0,
Muskogee,U.S. Senate,Kevin Crow,REP,510017,0,0,0,0,
Muskogee,U.S. Senate,James Lankford,REP,510017,2,0,5,7,
Muskogee,U.S. Senate,Jason Weger,REP,510017,0,0,0,0,
Muskogee,U.S. House,Darrel Robertson,REP,510017,0,0,4,4,02
Muskogee,U.S. House,Markwayne Mullin,REP,510017,2,1,11,14,02
Muskogee,Superintendent of Public Instruction,John Cox,DEM,510021,0,5,63,68,
Muskogee,Superintendent of Public Instruction,Jack Jr.,DEM,510021,0,2,30,32,
Muskogee,Superintendent of Public Instruction,Ivan Holmes,DEM,510021,0,1,21,22,
Muskogee,Superintendent of Public Instruction,Freda Deskin,DEM,510021,0,5,73,78,
Muskogee,U.S. Senate,Patrick Michael Hayes,DEM,510021,0,4,47,51,
Muskogee,U.S. Senate,Jim Rogers,DEM,510021,0,6,51,57,
Muskogee,U.S. Senate,Connie Johnson,DEM,510021,0,3,88,91,
Muskogee,U.S. House,Earl Everett,DEM,510021,0,7,105,112,02
Muskogee,U.S. House,Joshua Harris-Till,DEM,510021,0,6,69,75,02
Muskogee,Governor,Dax Ewbank,REP,510021,0,0,6,6,
Muskogee,Governor,Chad Moody,REP,510021,0,0,9,9,
Muskogee,Governor,Mary Fallin,REP,510021,2,6,50,58,
Muskogee,Superintendent of Public Instruction,Brian Kelly,REP,510021,2,2,22,26,
Muskogee,Superintendent of Public Instruction,Janet Costello Barresi,REP,510021,0,0,14,14,
Muskogee,Superintendent of Public Instruction,Joy Hofmeister,REP,510021,0,4,32,36,
Muskogee,Insurance Commissioner,Bill Viner,REP,510021,0,1,9,10,
Muskogee,Insurance Commissioner,John Doak,REP,510021,2,5,56,63,
Muskogee,Corporation Commissioner,Todd Hiett,REP,510021,0,2,25,27,
Muskogee,Corporation Commissioner,Cliff Branan,REP,510021,2,4,36,42,
Muskogee,U.S. Senate,Evelyn Rogers,REP,510021,0,0,8,8,
Muskogee,U.S. Senate,Rob Moye,REP,510021,0,0,2,2,
Muskogee,U.S. Senate,D. Jean Mcbride-Samuels,REP,510021,0,0,0,0,
Muskogee,U.S. Senate,Jim Inhofe,REP,510021,2,6,55,63,
Muskogee,U.S. Senate,Erick Paul Wyatt,REP,510021,0,0,2,2,
Muskogee,U.S. Senate,Andy Craig,REP,510021,0,0,1,1,
Muskogee,U.S. Senate,T. Shannon,REP,510021,0,6,27,33,
Muskogee,U.S. Senate,Randy Brogdon,REP,510021,0,0,1,1,
Muskogee,U.S. Senate,Eric Mccray,REP,510021,0,0,1,1,
Muskogee,U.S. Senate,Kevin Crow,REP,510021,0,0,0,0,
Muskogee,U.S. Senate,James Lankford,REP,510021,2,2,34,38,
Muskogee,U.S. Senate,Jason Weger,REP,510021,0,0,1,1,
Muskogee,U.S. House,Darrel Robertson,REP,510021,0,0,22,22,02
Muskogee,U.S. House,Markwayne Mullin,REP,510021,2,8,41,51,02
Muskogee,Superintendent of Public Instruction,John Cox,DEM,510022,5,5,97,107,
Muskogee,Superintendent of Public Instruction,Jack Jr.,DEM,510022,3,4,43,50,
Muskogee,Superintendent of Public Instruction,Ivan Holmes,DEM,510022,0,2,8,10,
Muskogee,Superintendent of Public Instruction,Freda Deskin,DEM,510022,1,12,105,118,
Muskogee,U.S. Senate,Patrick Michael Hayes,DEM,510022,3,6,60,69,
Muskogee,U.S. Senate,Jim Rogers,DEM,510022,2,9,105,116,
Muskogee,U.S. Senate,Connie Johnson,DEM,510022,4,8,84,96,
Muskogee,U.S. House,Earl Everett,DEM,510022,5,15,156,176,02
Muskogee,U.S. House,Joshua Harris-Till,DEM,510022,2,6,87,95,02
Muskogee,Governor,Dax Ewbank,REP,510022,0,0,11,11,
Muskogee,Governor,Chad Moody,REP,510022,0,1,22,23,
Muskogee,Governor,Mary Fallin,REP,510022,3,10,132,145,
Muskogee,Superintendent of Public Instruction,Brian Kelly,REP,510022,0,0,30,30,
Muskogee,Superintendent of Public Instruction,Janet Costello Barresi,REP,510022,3,2,38,43,
Muskogee,Superintendent of Public Instruction,Joy Hofmeister,REP,510022,0,9,94,103,
Muskogee,Insurance Commissioner,Bill Viner,REP,510022,1,3,22,26,
Muskogee,Insurance Commissioner,John Doak,REP,510022,2,7,136,145,
Muskogee,Corporation Commissioner,Todd Hiett,REP,510022,2,6,72,80,
Muskogee,Corporation Commissioner,Cliff Branan,REP,510022,1,3,81,85,
Muskogee,U.S. Senate,Evelyn Rogers,REP,510022,0,0,3,3,
Muskogee,U.S. Senate,Rob Moye,REP,510022,0,0,2,2,
Muskogee,U.S. Senate,D. Jean Mcbride-Samuels,REP,510022,0,0,3,3,
Muskogee,U.S. Senate,Jim Inhofe,REP,510022,3,9,152,164,
Muskogee,U.S. Senate,Erick Paul Wyatt,REP,510022,0,1,7,8,
Muskogee,U.S. Senate,Andy Craig,REP,510022,0,0,0,0,
Muskogee,U.S. Senate,T. Shannon,REP,510022,0,3,68,71,
Muskogee,U.S. Senate,Randy Brogdon,REP,510022,0,0,2,2,
Muskogee,U.S. Senate,Eric Mccray,REP,510022,0,0,0,0,
Muskogee,U.S. Senate,Kevin Crow,REP,510022,0,0,2,2,
Muskogee,U.S. Senate,James Lankford,REP,510022,2,8,95,105,
Muskogee,U.S. Senate,Jason Weger,REP,510022,0,0,0,0,
Muskogee,U.S. House,Darrel Robertson,REP,510022,1,3,35,39,02
Muskogee,U.S. House,Markwayne Mullin,REP,510022,2,8,128,138,02
Muskogee,Superintendent of Public Instruction,John Cox,DEM,510023,0,6,77,83,
Muskogee,Superintendent of Public Instruction,Jack Jr.,DEM,510023,0,3,31,34,
Muskogee,Superintendent of Public Instruction,Ivan Holmes,DEM,510023,0,1,21,22,
Muskogee,Superintendent of Public Instruction,Freda Deskin,DEM,510023,0,10,100,110,
Muskogee,U.S. Senate,Patrick Michael Hayes,DEM,510023,0,4,48,52,
Muskogee,U.S. Senate,Jim Rogers,DEM,510023,0,3,67,70,
Muskogee,U.S. Senate,Connie Johnson,DEM,510023,0,12,119,131,
Muskogee,U.S. House,Earl Everett,DEM,510023,0,12,104,116,02
Muskogee,U.S. House,Joshua Harris-Till,DEM,510023,0,4,113,117,02
Muskogee,Governor,Dax Ewbank,REP,510023,0,0,3,3,
Muskogee,Governor,Chad Moody,REP,510023,0,0,5,5,
Muskogee,Governor,Mary Fallin,REP,510023,0,7,24,31,
Muskogee,Superintendent of Public Instruction,Brian Kelly,REP,510023,0,3,9,12,
Muskogee,Superintendent of Public Instruction,Janet Costello Barresi,REP,510023,0,3,10,13,
Muskogee,Superintendent of Public Instruction,Joy Hofmeister,REP,510023,0,1,14,15,
Muskogee,Insurance Commissioner,Bill Viner,REP,510023,0,2,6,8,
Muskogee,Insurance Commissioner,John Doak,REP,510023,0,5,26,31,
Muskogee,Corporation Commissioner,Todd Hiett,REP,510023,0,3,14,17,
Muskogee,Corporation Commissioner,Cliff Branan,REP,510023,0,4,14,18,
Muskogee,U.S. Senate,Evelyn Rogers,REP,510023,0,0,3,3,
Muskogee,U.S. Senate,Rob Moye,REP,510023,0,0,2,2,
Muskogee,U.S. Senate,D. Jean Mcbride-Samuels,REP,510023,0,0,1,1,
Muskogee,U.S. Senate,Jim Inhofe,REP,510023,0,6,23,29,
Muskogee,U.S. Senate,Erick Paul Wyatt,REP,510023,0,0,3,3,
Muskogee,U.S. Senate,Andy Craig,REP,510023,0,0,0,0,
Muskogee,U.S. Senate,T. Shannon,REP,510023,0,3,17,20,
Muskogee,U.S. Senate,Randy Brogdon,REP,510023,0,0,1,1,
Muskogee,U.S. Senate,Eric Mccray,REP,510023,0,1,3,4,
Muskogee,U.S. Senate,Kevin Crow,REP,510023,0,0,3,3,
Muskogee,U.S. Senate,James Lankford,REP,510023,0,3,7,10,
Muskogee,U.S. Senate,Jason Weger,REP,510023,0,0,2,2,
Muskogee,U.S. House,Darrel Robertson,REP,510023,0,2,10,12,02
Muskogee,U.S. House,Markwayne Mullin,REP,510023,0,5,22,27,02
Muskogee,Superintendent of Public Instruction,John Cox,DEM,510028,1,2,42,45,
Muskogee,Superintendent of Public Instruction,Jack Jr.,DEM,510028,0,0,19,19,
Muskogee,Superintendent of Public Instruction,Ivan Holmes,DEM,510028,0,2,9,11,
Muskogee,Superintendent of Public Instruction,Freda Deskin,DEM,510028,0,1,52,53,
Muskogee,U.S. Senate,Patrick Michael Hayes,DEM,510028,0,0,26,26,
Muskogee,U.S. Senate,Jim Rogers,DEM,510028,1,3,48,52,
Muskogee,U.S. Senate,Connie Johnson,DEM,510028,0,1,45,46,
Muskogee,U.S. House,Earl Everett,DEM,510028,1,4,75,80,02
Muskogee,U.S. House,Joshua Harris-Till,DEM,510028,0,0,42,42,02
Muskogee,Governor,Dax Ewbank,REP,510028,0,0,1,1,
Muskogee,Governor,Chad Moody,REP,510028,1,0,13,14,
Muskogee,Governor,Mary Fallin,REP,510028,0,3,33,36,
Muskogee,Superintendent of Public Instruction,Brian Kelly,REP,510028,0,0,8,8,
Muskogee,Superintendent of Public Instruction,Janet Costello Barresi,REP,510028,0,0,11,11,
Muskogee,Superintendent of Public Instruction,Joy Hofmeister,REP,510028,0,3,28,31,
Muskogee,Insurance Commissioner,Bill Viner,REP,510028,0,0,5,5,
Muskogee,Insurance Commissioner,John Doak,REP,510028,1,2,39,42,
Muskogee,Corporation Commissioner,Todd Hiett,REP,510028,0,2,21,23,
Muskogee,Corporation Commissioner,Cliff Branan,REP,510028,1,1,22,24,
Muskogee,U.S. Senate,Evelyn Rogers,REP,510028,0,0,2,2,
Muskogee,U.S. Senate,Rob Moye,REP,510028,0,0,0,0,
Muskogee,U.S. Senate,D. Jean Mcbride-Samuels,REP,510028,1,0,2,3,
Muskogee,U.S. Senate,Jim Inhofe,REP,510028,0,3,40,43,
Muskogee,U.S. Senate,Erick Paul Wyatt,REP,510028,0,0,3,3,
Muskogee,U.S. Senate,Andy Craig,REP,510028,0,0,1,1,
Muskogee,U.S. Senate,T. Shannon,REP,510028,1,2,24,27,
Muskogee,U.S. Senate,Randy Brogdon,REP,510028,0,0,1,1,
Muskogee,U.S. Senate,Eric Mccray,REP,510028,0,0,0,0,
Muskogee,U.S. Senate,Kevin Crow,REP,510028,0,0,1,1,
Muskogee,U.S. Senate,James Lankford,REP,510028,0,1,20,21,
Muskogee,U.S. Senate,Jason Weger,REP,510028,0,0,0,0,
Muskogee,U.S. House,Darrel Robertson,REP,510028,0,0,12,12,02
Muskogee,U.S. House,Markwayne Mullin,REP,510028,1,3,35,39,02
Muskogee,Superintendent of Public Instruction,John Cox,DEM,510033,2,3,119,124,
Muskogee,Superintendent of Public Instruction,Jack Jr.,DEM,510033,0,2,20,22,
Muskogee,Superintendent of Public Instruction,Ivan Holmes,DEM,510033,0,0,21,21,
Muskogee,Superintendent of Public Instruction,Freda Deskin,DEM,510033,0,5,71,76,
Muskogee,U.S. Senate,Patrick Michael Hayes,DEM,510033,1,0,58,59,
Muskogee,U.S. Senate,Jim Rogers,DEM,510033,1,6,111,118,
Muskogee,U.S. Senate,Connie Johnson,DEM,510033,0,3,63,66,
Muskogee,U.S. House,Earl Everett,DEM,510033,2,4,149,155,02
Muskogee,U.S. House,Joshua Harris-Till,DEM,510033,0,4,73,77,02
Muskogee,Governor,Dax Ewbank,REP,510033,0,0,13,13,
Muskogee,Governor,Chad Moody,REP,510033,0,0,30,30,
Muskogee,Governor,Mary Fallin,REP,510033,2,1,106,109,
Muskogee,Superintendent of Public Instruction,Brian Kelly,REP,510033,0,0,28,28,
Muskogee,Superintendent of Public Instruction,Janet Costello Barresi,REP,510033,0,0,21,21,
Muskogee,Superintendent of Public Instruction,Joy Hofmeister,REP,510033,2,1,99,102,
Muskogee,Insurance Commissioner,Bill Viner,REP,510033,0,0,25,25,
Muskogee,Insurance Commissioner,John Doak,REP,510033,2,0,119,121,
Muskogee,Corporation Commissioner,Todd Hiett,REP,510033,1,0,76,77,
Muskogee,Corporation Commissioner,Cliff Branan,REP,510033,0,1,68,69,
Muskogee,U.S. Senate,Evelyn Rogers,REP,510033,0,0,3,3,
Muskogee,U.S. Senate,Rob Moye,REP,510033,0,0,2,2,
Muskogee,U.S. Senate,D. Jean Mcbride-Samuels,REP,510033,0,0,5,5,
Muskogee,U.S. Senate,Jim Inhofe,REP,510033,2,1,130,133,
Muskogee,U.S. Senate,Erick Paul Wyatt,REP,510033,0,0,8,8,
Muskogee,U.S. Senate,Andy Craig,REP,510033,0,0,2,2,
Muskogee,U.S. Senate,T. Shannon,REP,510033,0,1,61,62,
Muskogee,U.S. Senate,Randy Brogdon,REP,510033,0,0,10,10,
Muskogee,U.S. Senate,Eric Mccray,REP,510033,0,0,4,4,
Muskogee,U.S. Senate,Kevin Crow,REP,510033,0,0,2,2,
Muskogee,U.S. Senate,James Lankford,REP,510033,2,0,67,69,
Muskogee,U.S. Senate,Jason Weger,REP,510033,0,0,3,3,
Muskogee,U.S. House,Darrel Robertson,REP,510033,0,0,23,23,02
Muskogee,U.S. House,Markwayne Mullin,REP,510033,2,1,126,129,02
Muskogee,Superintendent of Public Instruction,John Cox,DEM,510036,0,2,21,23,
Muskogee,Superintendent of Public Instruction,Jack Jr.,DEM,510036,2,0,12,14,
Muskogee,Superintendent of Public Instruction,Ivan Holmes,DEM,510036,0,0,9,9,
Muskogee,Superintendent of Public Instruction,Freda Deskin,DEM,510036,0,2,36,38,
Muskogee,U.S. Senate,Patrick Michael Hayes,DEM,510036,1,1,12,14,
Muskogee,U.S. Senate,Jim Rogers,DEM,510036,1,0,21,22,
Muskogee,U.S. Senate,Connie Johnson,DEM,510036,0,2,44,46,
Muskogee,U.S. House,Earl Everett,DEM,510036,2,2,41,45,02
Muskogee,U.S. House,Joshua Harris-Till,DEM,510036,0,1,32,33,02
Muskogee,Governor,Dax Ewbank,REP,510036,0,0,0,0,
Muskogee,Governor,Chad Moody,REP,510036,0,0,5,5,
Muskogee,Governor,Mary Fallin,REP,510036,2,0,9,11,
Muskogee,Superintendent of Public Instruction,Brian Kelly,REP,510036,0,0,5,5,
Muskogee,Superintendent of Public Instruction,Janet Costello Barresi,REP,510036,0,0,3,3,
Muskogee,Superintendent of Public Instruction,Joy Hofmeister,REP,510036,2,0,7,9,
Muskogee,Insurance Commissioner,Bill Viner,REP,510036,0,0,3,3,
Muskogee,Insurance Commissioner,John Doak,REP,510036,2,0,9,11,
Muskogee,Corporation Commissioner,Todd Hiett,REP,510036,2,0,7,9,
Muskogee,Corporation Commissioner,Cliff Branan,REP,510036,0,0,3,3,
Muskogee,U.S. Senate,Evelyn Rogers,REP,510036,0,0,0,0,
Muskogee,U.S. Senate,Rob Moye,REP,510036,0,0,0,0,
Muskogee,U.S. Senate,D. Jean Mcbride-Samuels,REP,510036,0,0,0,0,
Muskogee,U.S. Senate,Jim Inhofe,REP,510036,2,0,11,13,
Muskogee,U.S. Senate,Erick Paul Wyatt,REP,510036,0,0,4,4,
Muskogee,U.S. Senate,Andy Craig,REP,510036,0,0,0,0,
Muskogee,U.S. Senate,T. Shannon,REP,510036,1,0,8,9,
Muskogee,U.S. Senate,Randy Brogdon,REP,510036,0,0,1,1,
Muskogee,U.S. Senate,Eric Mccray,REP,510036,0,0,0,0,
Muskogee,U.S. Senate,Kevin Crow,REP,510036,0,0,0,0,
Muskogee,U.S. Senate,James Lankford,REP,510036,1,0,4,5,
Muskogee,U.S. Senate,Jason Weger,REP,510036,0,0,0,0,
Muskogee,U.S. House,Darrel Robertson,REP,510036,0,0,5,5,02
Muskogee,U.S. House,Markwayne Mullin,REP,510036,2,0,8,10,02
Muskogee,Superintendent of Public Instruction,John Cox,DEM,510037,0,4,86,90,
Muskogee,Superintendent of Public Instruction,Jack Jr.,DEM,510037,0,3,47,50,
Muskogee,Superintendent of Public Instruction,Ivan Holmes,DEM,510037,0,0,21,21,
Muskogee,Superintendent of Public Instruction,Freda Deskin,DEM,510037,0,5,81,86,
Muskogee,U.S. Senate,Patrick Michael Hayes,DEM,510037,0,3,47,50,
Muskogee,U.S. Senate,Jim Rogers,DEM,510037,0,2,112,114,
Muskogee,U.S. Senate,Connie Johnson,DEM,510037,0,8,63,71,
Muskogee,U.S. House,Earl Everett,DEM,510037,0,11,132,143,02
Muskogee,U.S. House,Joshua Harris-Till,DEM,510037,0,2,79,81,02
Muskogee,Governor,Dax Ewbank,REP,510037,0,1,14,15,
Muskogee,Governor,Chad Moody,REP,510037,0,0,10,10,
Muskogee,Governor,Mary Fallin,REP,510037,0,3,91,94,
Muskogee,Superintendent of Public Instruction,Brian Kelly,REP,510037,0,2,31,33,
Muskogee,Superintendent of Public Instruction,Janet Costello Barresi,REP,510037,0,1,15,16,
Muskogee,Superintendent of Public Instruction,Joy Hofmeister,REP,510037,0,0,66,66,
Muskogee,Insurance Commissioner,Bill Viner,REP,510037,0,1,19,20,
Muskogee,Insurance Commissioner,John Doak,REP,510037,0,3,89,92,
Muskogee,Corporation Commissioner,Todd Hiett,REP,510037,0,2,55,57,
Muskogee,Corporation Commissioner,Cliff Branan,REP,510037,0,2,51,53,
Muskogee,U.S. Senate,Evelyn Rogers,REP,510037,0,0,6,6,
Muskogee,U.S. Senate,Rob Moye,REP,510037,0,0,5,5,
Muskogee,U.S. Senate,D. Jean Mcbride-Samuels,REP,510037,0,0,0,0,
Muskogee,U.S. Senate,Jim Inhofe,REP,510037,0,3,99,102,
Muskogee,U.S. Senate,Erick Paul Wyatt,REP,510037,0,0,5,5,
Muskogee,U.S. Senate,Andy Craig,REP,510037,0,0,0,0,
Muskogee,U.S. Senate,T. Shannon,REP,510037,0,2,52,54,
Muskogee,U.S. Senate,Randy Brogdon,REP,510037,0,0,8,8,
Muskogee,U.S. Senate,Eric Mccray,REP,510037,0,0,0,0,
Muskogee,U.S. Senate,Kevin Crow,REP,510037,0,0,0,0,
Muskogee,U.S. Senate,James Lankford,REP,510037,0,2,56,58,
Muskogee,U.S. Senate,Jason Weger,REP,510037,0,0,1,1,
Muskogee,U.S. House,Darrel Robertson,REP,510037,0,0,18,18,02
Muskogee,U.S. House,Markwayne Mullin,REP,510037,0,4,97,101,02
Muskogee,Superintendent of Public Instruction,John Cox,DEM,510038,0,23,94,117,
Muskogee,Superintendent of Public Instruction,Jack Jr.,DEM,510038,2,1,42,45,
Muskogee,Superintendent of Public Instruction,Ivan Holmes,DEM,510038,0,2,21,23,
Muskogee,Superintendent of Public Instruction,Freda Deskin,DEM,510038,1,16,97,114,
Muskogee,U.S. Senate,Patrick Michael Hayes,DEM,510038,1,6,56,63,
Muskogee,U.S. Senate,Jim Rogers,DEM,510038,2,15,120,137,
Muskogee,U.S. Senate,Connie Johnson,DEM,510038,0,16,69,85,
Muskogee,U.S. House,Earl Everett,DEM,510038,1,22,160,183,02
Muskogee,U.S. House,Joshua Harris-Till,DEM,510038,2,13,69,84,02
Muskogee,Governor,Dax Ewbank,REP,510038,1,0,8,9,
Muskogee,Governor,Chad Moody,REP,510038,0,2,18,20,
Muskogee,Governor,Mary Fallin,REP,510038,3,17,165,185,
Muskogee,Superintendent of Public Instruction,Brian Kelly,REP,510038,0,2,42,44,
Muskogee,Superintendent of Public Instruction,Janet Costello Barresi,REP,510038,2,9,40,51,
Muskogee,Superintendent of Public Instruction,Joy Hofmeister,REP,510038,2,8,110,120,
Muskogee,Insurance Commissioner,Bill Viner,REP,510038,1,0,20,21,
Muskogee,Insurance Commissioner,John Doak,REP,510038,3,19,162,184,
Muskogee,Corporation Commissioner,Todd Hiett,REP,510038,4,10,82,96,
Muskogee,Corporation Commissioner,Cliff Branan,REP,510038,0,8,84,92,
Muskogee,U.S. Senate,Evelyn Rogers,REP,510038,0,2,4,6,
Muskogee,U.S. Senate,Rob Moye,REP,510038,0,0,3,3,
Muskogee,U.S. Senate,D. Jean Mcbride-Samuels,REP,510038,0,0,2,2,
Muskogee,U.S. Senate,Jim Inhofe,REP,510038,4,17,173,194,
Muskogee,U.S. Senate,Erick Paul Wyatt,REP,510038,0,0,9,9,
Muskogee,U.S. Senate,Andy Craig,REP,510038,0,0,1,1,
Muskogee,U.S. Senate,T. Shannon,REP,510038,2,6,57,65,
Muskogee,U.S. Senate,Randy Brogdon,REP,510038,0,0,3,3,
Muskogee,U.S. Senate,Eric Mccray,REP,510038,0,0,0,0,
Muskogee,U.S. Senate,Kevin Crow,REP,510038,0,0,3,3,
Muskogee,U.S. Senate,James Lankford,REP,510038,2,13,128,143,
Muskogee,U.S. Senate,Jason Weger,REP,510038,0,0,0,0,
Muskogee,U.S. House,Darrel Robertson,REP,510038,0,3,44,47,02
Muskogee,U.S. House,Markwayne Mullin,REP,510038,4,16,138,158,02
Muskogee,Superintendent of Public Instruction,John Cox,DEM,510040,0,2,32,34,
Muskogee,Superintendent of Public Instruction,Jack Jr.,DEM,510040,0,0,8,8,
Muskogee,Superintendent of Public Instruction,Ivan Holmes,DEM,510040,0,2,3,5,
Muskogee,Superintendent of Public Instruction,Freda Deskin,DEM,510040,0,2,25,27,
Muskogee,U.S. Senate,Patrick Michael Hayes,DEM,510040,0,1,15,16,
Muskogee,U.S. Senate,Jim Rogers,DEM,510040,0,3,31,34,
Muskogee,U.S. Senate,Connie Johnson,DEM,510040,0,2,18,20,
Muskogee,U.S. House,Earl Everett,DEM,510040,0,5,41,46,02
Muskogee,U.S. House,Joshua Harris-Till,DEM,510040,0,1,21,22,02
Muskogee,Governor,Dax Ewbank,REP,510040,0,0,6,6,
Muskogee,Governor,Chad Moody,REP,510040,0,0,14,14,
Muskogee,Governor,Mary Fallin,REP,510040,0,2,61,63,
Muskogee,Superintendent of Public Instruction,Brian Kelly,REP,510040,0,0,14,14,
Muskogee,Superintendent of Public Instruction,Janet Costello Barresi,REP,510040,0,1,12,13,
Muskogee,Superintendent of Public Instruction,Joy Hofmeister,REP,510040,0,1,56,57,
Muskogee,Insurance Commissioner,Bill Viner,REP,510040,0,0,10,10,
Muskogee,Insurance Commissioner,John Doak,REP,510040,0,1,66,67,
Muskogee,Corporation Commissioner,Todd Hiett,REP,510040,0,1,37,38,
Muskogee,Corporation Commissioner,Cliff Branan,REP,510040,0,1,38,39,
Muskogee,U.S. Senate,Evelyn Rogers,REP,510040,0,0,4,4,
Muskogee,U.S. Senate,Rob Moye,REP,510040,0,0,1,1,
Muskogee,U.S. Senate,D. Jean Mcbride-Samuels,REP,510040,0,0,0,0,
Muskogee,U.S. Senate,Jim Inhofe,REP,510040,0,2,70,72,
Muskogee,U.S. Senate,Erick Paul Wyatt,REP,510040,0,0,7,7,
Muskogee,U.S. Senate,Andy Craig,REP,510040,0,0,1,1,
Muskogee,U.S. Senate,T. Shannon,REP,510040,0,1,36,37,
Muskogee,U.S. Senate,Randy Brogdon,REP,510040,0,0,2,2,
Muskogee,U.S. Senate,Eric Mccray,REP,510040,0,0,0,0,
Muskogee,U.S. Senate,Kevin Crow,REP,510040,0,0,0,0,
Muskogee,U.S. Senate,James Lankford,REP,510040,0,1,42,43,
Muskogee,U.S. Senate,Jason Weger,REP,510040,0,0,1,1,
Muskogee,U.S. House,Darrel Robertson,REP,510040,0,0,11,11,02
Muskogee,U.S. House,Markwayne Mullin,REP,510040,0,2,69,71,02
Muskogee,Superintendent of Public Instruction,John Cox,DEM,510041,1,22,271,294,
Muskogee,Superintendent of Public Instruction,Jack Jr.,DEM,510041,0,6,63,69,
Muskogee,Superintendent of Public Instruction,Ivan Holmes,DEM,510041,0,2,33,35,
Muskogee,Superintendent of Public Instruction,Freda Deskin,DEM,510041,1,10,170,181,
Muskogee,U.S. Senate,Patrick Michael Hayes,DEM,510041,0,11,139,150,
Muskogee,U.S. Senate,Jim Rogers,DEM,510041,2,18,252,272,
Muskogee,U.S. Senate,Connie Johnson,DEM,510041,0,9,133,142,
Muskogee,U.S. House,Earl Everett,DEM,510041,2,27,357,386,02
Muskogee,U.S. House,Joshua Harris-Till,DEM,510041,0,9,155,164,02
Muskogee,Governor,Dax Ewbank,REP,510041,2,1,18,21,
Muskogee,Governor,Chad Moody,REP,510041,0,4,72,76,
Muskogee,Governor,Mary Fallin,REP,510041,3,19,247,269,
Muskogee,Superintendent of Public Instruction,Brian Kelly,REP,510041,2,0,63,65,
Muskogee,Superintendent of Public Instruction,Janet Costello Barresi,REP,510041,1,3,35,39,
Muskogee,Superintendent of Public Instruction,Joy Hofmeister,REP,510041,2,21,232,255,
Muskogee,Insurance Commissioner,Bill Viner,REP,510041,0,7,41,48,
Muskogee,Insurance Commissioner,John Doak,REP,510041,4,17,282,303,
Muskogee,Corporation Commissioner,Todd Hiett,REP,510041,0,13,162,175,
Muskogee,Corporation Commissioner,Cliff Branan,REP,510041,4,11,146,161,
Muskogee,U.S. Senate,Evelyn Rogers,REP,510041,0,2,18,20,
Muskogee,U.S. Senate,Rob Moye,REP,510041,0,1,11,12,
Muskogee,U.S. Senate,D. Jean Mcbride-Samuels,REP,510041,0,0,3,3,
Muskogee,U.S. Senate,Jim Inhofe,REP,510041,5,17,287,309,
Muskogee,U.S. Senate,Erick Paul Wyatt,REP,510041,0,4,13,17,
Muskogee,U.S. Senate,Andy Craig,REP,510041,0,0,5,5,
Muskogee,U.S. Senate,T. Shannon,REP,510041,0,6,151,157,
Muskogee,U.S. Senate,Randy Brogdon,REP,510041,0,2,11,13,
Muskogee,U.S. Senate,Eric Mccray,REP,510041,0,0,6,6,
Muskogee,U.S. Senate,Kevin Crow,REP,510041,0,0,8,8,
Muskogee,U.S. Senate,James Lankford,REP,510041,5,15,159,179,
Muskogee,U.S. Senate,Jason Weger,REP,510041,0,1,1,2,
Muskogee,U.S. House,Darrel Robertson,REP,510041,0,4,56,60,02
Muskogee,U.S. House,Markwayne Mullin,REP,510041,5,20,283,308,02
Muskogee,Superintendent of Public Instruction,John Cox,DEM,510044,0,1,78,79,
Muskogee,Superintendent of Public Instruction,Jack Jr.,DEM,510044,0,0,25,25,
Muskogee,Superintendent of Public Instruction,Ivan Holmes,DEM,510044,0,0,11,11,
Muskogee,Superintendent of Public Instruction,Freda Deskin,DEM,510044,0,0,48,48,
Muskogee,U.S. Senate,Patrick Michael Hayes,DEM,510044,0,0,31,31,
Muskogee,U.S. Senate,Jim Rogers,DEM,510044,0,0,85,85,
Muskogee,U.S. Senate,Connie Johnson,DEM,510044,0,0,40,40,
Muskogee,U.S. House,Earl Everett,DEM,510044,0,0,112,112,02
Muskogee,U.S. House,Joshua Harris-Till,DEM,510044,0,0,37,37,02
Muskogee,Governor,Dax Ewbank,REP,510044,0,0,0,0,
Muskogee,Governor,Chad Moody,REP,510044,0,0,12,12,
Muskogee,Governor,Mary Fallin,REP,510044,0,0,30,30,
Muskogee,Superintendent of Public Instruction,Brian Kelly,REP,510044,0,0,11,11,
Muskogee,Superintendent of Public Instruction,Janet Costello Barresi,REP,510044,0,0,2,2,
Muskogee,Superintendent of Public Instruction,Joy Hofmeister,REP,510044,0,0,27,27,
Muskogee,Insurance Commissioner,Bill Viner,REP,510044,0,0,7,7,
Muskogee,Insurance Commissioner,John Doak,REP,510044,0,0,33,33,
Muskogee,Corporation Commissioner,Todd Hiett,REP,510044,0,0,20,20,
Muskogee,Corporation Commissioner,Cliff Branan,REP,510044,0,0,18,18,
Muskogee,U.S. Senate,Evelyn Rogers,REP,510044,0,0,0,0,
Muskogee,U.S. Senate,Rob Moye,REP,510044,0,0,0,0,
Muskogee,U.S. Senate,D. Jean Mcbride-Samuels,REP,510044,0,0,0,0,
Muskogee,U.S. Senate,Jim Inhofe,REP,510044,0,0,37,37,
Muskogee,U.S. Senate,Erick Paul Wyatt,REP,510044,0,0,4,4,
Muskogee,U.S. Senate,Andy Craig,REP,510044,0,0,1,1,
Muskogee,U.S. Senate,T. Shannon,REP,510044,0,0,19,19,
Muskogee,U.S. Senate,Randy Brogdon,REP,510044,0,0,0,0,
Muskogee,U.S. Senate,Eric Mccray,REP,510044,0,0,0,0,
Muskogee,U.S. Senate,Kevin Crow,REP,510044,0,0,1,1,
Muskogee,U.S. Senate,James Lankford,REP,510044,0,0,17,17,
Muskogee,U.S. Senate,Jason Weger,REP,510044,0,0,2,2,
Muskogee,U.S. House,Darrel Robertson,REP,510044,0,0,10,10,02
Muskogee,U.S. House,Markwayne Mullin,REP,510044,0,0,32,32,02
Muskogee,Superintendent of Public Instruction,John Cox,DEM,510045,0,3,58,61,
Muskogee,Superintendent of Public Instruction,Jack Jr.,DEM,510045,2,1,19,22,
Muskogee,Superintendent of Public Instruction,Ivan Holmes,DEM,510045,0,1,16,17,
Muskogee,Superintendent of Public Instruction,Freda Deskin,DEM,510045,0,4,66,70,
Muskogee,U.S. Senate,Patrick Michael Hayes,DEM,510045,0,1,35,36,
Muskogee,U.S. Senate,Jim Rogers,DEM,510045,2,2,79,83,
Muskogee,U.S. Senate,Connie Johnson,DEM,510045,0,5,40,45,
Muskogee,U.S. House,Earl Everett,DEM,510045,2,6,107,115,02
Muskogee,U.S. House,Joshua Harris-Till,DEM,510045,0,2,44,46,02
Muskogee,Governor,Dax Ewbank,REP,510045,0,0,4,4,
Muskogee,Governor,Chad Moody,REP,510045,0,0,14,14,
Muskogee,Governor,Mary Fallin,REP,510045,0,6,58,64,
Muskogee,Superintendent of Public Instruction,Brian Kelly,REP,510045,0,2,13,15,
Muskogee,Superintendent of Public Instruction,Janet Costello Barresi,REP,510045,0,1,15,16,
Muskogee,Superintendent of Public Instruction,Joy Hofmeister,REP,510045,0,3,47,50,
Muskogee,Insurance Commissioner,Bill Viner,REP,510045,0,2,6,8,
Muskogee,Insurance Commissioner,John Doak,REP,510045,0,3,64,67,
Muskogee,Corporation Commissioner,Todd Hiett,REP,510045,0,5,36,41,
Muskogee,Corporation Commissioner,Cliff Branan,REP,510045,0,2,35,37,
Muskogee,U.S. Senate,Evelyn Rogers,REP,510045,0,0,4,4,
Muskogee,U.S. Senate,Rob Moye,REP,510045,0,0,2,2,
Muskogee,U.S. Senate,D. Jean Mcbride-Samuels,REP,510045,0,0,1,1,
Muskogee,U.S. Senate,Jim Inhofe,REP,510045,0,7,58,65,
Muskogee,U.S. Senate,Erick Paul Wyatt,REP,510045,0,0,7,7,
Muskogee,U.S. Senate,Andy Craig,REP,510045,0,0,3,3,
Muskogee,U.S. Senate,T. Shannon,REP,510045,0,1,18,19,
Muskogee,U.S. Senate,Randy Brogdon,REP,510045,0,0,6,6,
Muskogee,U.S. Senate,Eric Mccray,REP,510045,0,0,0,0,
Muskogee,U.S. Senate,Kevin Crow,REP,510045,0,0,1,1,
Muskogee,U.S. Senate,James Lankford,REP,510045,0,5,48,53,
Muskogee,U.S. Senate,Jason Weger,REP,510045,0,1,0,1,
Muskogee,U.S. House,Darrel Robertson,REP,510045,0,1,22,23,02
Muskogee,U.S. House,Markwayne Mullin,REP,510045,0,6,51,57,02
Muskogee,Superintendent of Public Instruction,John Cox,DEM,510046,1,3,123,127,
Muskogee,Superintendent of Public Instruction,Jack Jr.,DEM,510046,0,1,36,37,
Muskogee,Superintendent of Public Instruction,Ivan Holmes,DEM,510046,1,2,17,20,
Muskogee,Superintendent of Public Instruction,Freda Deskin,DEM,510046,0,4,78,82,
Muskogee,U.S. Senate,Patrick Michael Hayes,DEM,510046,0,1,74,75,
Muskogee,U.S. Senate,Jim Rogers,DEM,510046,1,5,121,127,
Muskogee,U.S. Senate,Connie Johnson,DEM,510046,1,4,53,58,
Muskogee,U.S. House,Earl Everett,DEM,510046,1,9,174,184,02
Muskogee,U.S. House,Joshua Harris-Till,DEM,510046,1,1,63,65,02
Muskogee,Governor,Dax Ewbank,REP,510046,0,1,3,4,
Muskogee,Governor,Chad Moody,REP,510046,1,2,29,32,
Muskogee,Governor,Mary Fallin,REP,510046,3,4,121,128,
Muskogee,Superintendent of Public Instruction,Brian Kelly,REP,510046,0,3,38,41,
Muskogee,Superintendent of Public Instruction,Janet Costello Barresi,REP,510046,1,1,29,31,
Muskogee,Superintendent of Public Instruction,Joy Hofmeister,REP,510046,3,4,85,92,
Muskogee,Insurance Commissioner,Bill Viner,REP,510046,0,2,30,32,
Muskogee,Insurance Commissioner,John Doak,REP,510046,4,6,120,130,
Muskogee,Corporation Commissioner,Todd Hiett,REP,510046,0,2,64,66,
Muskogee,Corporation Commissioner,Cliff Branan,REP,510046,4,5,76,85,
Muskogee,U.S. Senate,Evelyn Rogers,REP,510046,0,1,8,9,
Muskogee,U.S. Senate,Rob Moye,REP,510046,0,0,1,1,
Muskogee,U.S. Senate,D. Jean Mcbride-Samuels,REP,510046,0,0,4,4,
Muskogee,U.S. Senate,Jim Inhofe,REP,510046,4,7,133,144,
Muskogee,U.S. Senate,Erick Paul Wyatt,REP,510046,0,0,8,8,
Muskogee,U.S. Senate,Andy Craig,REP,510046,0,0,2,2,
Muskogee,U.S. Senate,T. Shannon,REP,510046,1,1,67,69,
Muskogee,U.S. Senate,Randy Brogdon,REP,510046,0,0,7,7,
Muskogee,U.S. Senate,Eric Mccray,REP,510046,0,0,4,4,
Muskogee,U.S. Senate,Kevin Crow,REP,510046,0,0,2,2,
Muskogee,U.S. Senate,James Lankford,REP,510046,3,7,68,78,
Muskogee,U.S. Senate,Jason Weger,REP,510046,0,0,2,2,
Muskogee,U.S. House,Darrel Robertson,REP,510046,1,1,42,44,02
Muskogee,U.S. House,Markwayne Mullin,REP,510046,3,7,108,118,02
Muskogee,Superintendent of Public Instruction,John Cox,DEM,510047,0,6,63,69,
Muskogee,Superintendent of Public Instruction,Jack Jr.,DEM,510047,0,1,32,33,
Muskogee,Superintendent of Public Instruction,Ivan Holmes,DEM,510047,0,1,17,18,
Muskogee,Superintendent of Public Instruction,Freda Deskin,DEM,510047,0,3,60,63,
Muskogee,U.S. Senate,Patrick Michael Hayes,DEM,510047,0,5,34,39,
Muskogee,U.S. Senate,Jim Rogers,DEM,510047,0,2,84,86,
Muskogee,U.S. Senate,Connie Johnson,DEM,510047,0,4,52,56,
Muskogee,U.S. House,Earl Everett,DEM,510047,0,5,111,116,02
Muskogee,U.S. House,Joshua Harris-Till,DEM,510047,0,5,53,58,02
Muskogee,Governor,Dax Ewbank,REP,510047,0,1,4,5,
Muskogee,Governor,Chad Moody,REP,510047,0,2,12,14,
Muskogee,Governor,Mary Fallin,REP,510047,0,1,58,59,
Muskogee,Superintendent of Public Instruction,Brian Kelly,REP,510047,0,1,13,14,
Muskogee,Superintendent of Public Instruction,Janet Costello Barresi,REP,510047,0,0,11,11,
Muskogee,Superintendent of Public Instruction,Joy Hofmeister,REP,510047,0,3,48,51,
Muskogee,Insurance Commissioner,Bill Viner,REP,510047,0,1,11,12,
Muskogee,Insurance Commissioner,John Doak,REP,510047,0,3,61,64,
Muskogee,Corporation Commissioner,Todd Hiett,REP,510047,0,0,33,33,
Muskogee,Corporation Commissioner,Cliff Branan,REP,510047,0,2,36,38,
Muskogee,U.S. Senate,Evelyn Rogers,REP,510047,0,2,3,5,
Muskogee,U.S. Senate,Rob Moye,REP,510047,0,1,1,2,
Muskogee,U.S. Senate,D. Jean Mcbride-Samuels,REP,510047,0,0,3,3,
Muskogee,U.S. Senate,Jim Inhofe,REP,510047,0,1,65,66,
Muskogee,U.S. Senate,Erick Paul Wyatt,REP,510047,0,0,3,3,
Muskogee,U.S. Senate,Andy Craig,REP,510047,0,0,1,1,
Muskogee,U.S. Senate,T. Shannon,REP,510047,0,2,27,29,
Muskogee,U.S. Senate,Randy Brogdon,REP,510047,0,1,9,10,
Muskogee,U.S. Senate,Eric Mccray,REP,510047,0,1,0,1,
Muskogee,U.S. Senate,Kevin Crow,REP,510047,0,0,0,0,
Muskogee,U.S. Senate,James Lankford,REP,510047,0,0,38,38,
Muskogee,U.S. Senate,Jason Weger,REP,510047,0,0,0,0,
Muskogee,U.S. House,Darrel Robertson,REP,510047,0,2,18,20,02
Muskogee,U.S. House,Markwayne Mullin,REP,510047,0,2,55,57,02
Muskogee,Superintendent of Public Instruction,John Cox,DEM,510049,0,5,33,38,
Muskogee,Superintendent of Public Instruction,Jack Jr.,DEM,510049,0,0,14,14,
Muskogee,Superintendent of Public Instruction,Ivan Holmes,DEM,510049,0,1,7,8,
Muskogee,Superintendent of Public Instruction,Freda Deskin,DEM,510049,0,6,36,42,
Muskogee,U.S. Senate,Patrick Michael Hayes,DEM,510049,0,2,26,28,
Muskogee,U.S. Senate,Jim Rogers,DEM,510049,0,7,48,55,
Muskogee,U.S. Senate,Connie Johnson,DEM,510049,0,3,17,20,
Muskogee,U.S. House,Earl Everett,DEM,510049,0,8,48,56,02
Muskogee,U.S. House,Joshua Harris-Till,DEM,510049,0,4,38,42,02
Muskogee,Governor,Dax Ewbank,REP,510049,0,0,1,1,
Muskogee,Governor,Chad Moody,REP,510049,0,0,9,9,
Muskogee,Governor,Mary Fallin,REP,510049,0,0,20,20,
Muskogee,Superintendent of Public Instruction,Brian Kelly,REP,510049,0,0,7,7,
Muskogee,Superintendent of Public Instruction,Janet Costello Barresi,REP,510049,0,0,5,5,
Muskogee,Superintendent of Public Instruction,Joy Hofmeister,REP,510049,0,0,18,18,
Muskogee,Insurance Commissioner,Bill Viner,REP,510049,0,0,5,5,
Muskogee,Insurance Commissioner,John Doak,REP,510049,0,0,24,24,
Muskogee,Corporation Commissioner,Todd Hiett,REP,510049,0,0,12,12,
Muskogee,Corporation Commissioner,Cliff Branan,REP,510049,0,0,16,16,
Muskogee,U.S. Senate,Evelyn Rogers,REP,510049,0,0,1,1,
Muskogee,U.S. Senate,Rob Moye,REP,510049,0,0,0,0,
Muskogee,U.S. Senate,D. Jean Mcbride-Samuels,REP,510049,0,0,0,0,
Muskogee,U.S. Senate,Jim Inhofe,REP,510049,0,0,25,25,
Muskogee,U.S. Senate,Erick Paul Wyatt,REP,510049,0,0,4,4,
Muskogee,U.S. Senate,Andy Craig,REP,510049,0,0,1,1,
Muskogee,U.S. Senate,T. Shannon,REP,510049,0,0,11,11,
Muskogee,U.S. Senate,Randy Brogdon,REP,510049,0,0,0,0,
Muskogee,U.S. Senate,Eric Mccray,REP,510049,0,0,0,0,
Muskogee,U.S. Senate,Kevin Crow,REP,510049,0,0,0,0,
Muskogee,U.S. Senate,James Lankford,REP,510049,0,0,18,18,
Muskogee,U.S. Senate,Jason Weger,REP,510049,0,0,0,0,
Muskogee,U.S. House,Darrel Robertson,REP,510049,0,0,10,10,02
Muskogee,U.S. House,Markwayne Mullin,REP,510049,0,0,21,21,02
Muskogee,Superintendent of Public Instruction,John Cox,DEM,510050,0,0,38,38,
Muskogee,Superintendent of Public Instruction,Jack Jr.,DEM,510050,1,0,8,9,
Muskogee,Superintendent of Public Instruction,Ivan Holmes,DEM,510050,0,0,11,11,
Muskogee,Superintendent of Public Instruction,Freda Deskin,DEM,510050,0,0,21,21,
Muskogee,U.S. Senate,Patrick Michael Hayes,DEM,510050,0,0,15,15,
Muskogee,U.S. Senate,Jim Rogers,DEM,510050,0,0,26,26,
Muskogee,U.S. Senate,Connie Johnson,DEM,510050,1,0,33,34,
Muskogee,U.S. House,Earl Everett,DEM,510050,0,0,51,51,02
Muskogee,U.S. House,Joshua Harris-Till,DEM,510050,1,0,23,24,02
Muskogee,Governor,Dax Ewbank,REP,510050,0,0,3,3,
Muskogee,Governor,Chad Moody,REP,510050,1,1,4,6,
Muskogee,Governor,Mary Fallin,REP,510050,1,4,15,20,
Muskogee,Superintendent of Public Instruction,Brian Kelly,REP,510050,0,1,2,3,
Muskogee,Superintendent of Public Instruction,Janet Costello Barresi,REP,510050,0,2,7,9,
Muskogee,Superintendent of Public Instruction,Joy Hofmeister,REP,510050,1,2,13,16,
Muskogee,Insurance Commissioner,Bill Viner,REP,510050,0,3,4,7,
Muskogee,Insurance Commissioner,John Doak,REP,510050,1,2,16,19,
Muskogee,Corporation Commissioner,Todd Hiett,REP,510050,1,3,15,19,
Muskogee,Corporation Commissioner,Cliff Branan,REP,510050,0,2,7,9,
Muskogee,U.S. Senate,Evelyn Rogers,REP,510050,0,0,1,1,
Muskogee,U.S. Senate,Rob Moye,REP,510050,0,0,0,0,
Muskogee,U.S. Senate,D. Jean Mcbride-Samuels,REP,510050,0,0,0,0,
Muskogee,U.S. Senate,Jim Inhofe,REP,510050,1,5,16,22,
Muskogee,U.S. Senate,Erick Paul Wyatt,REP,510050,1,0,5,6,
Muskogee,U.S. Senate,Andy Craig,REP,510050,0,0,1,1,
Muskogee,U.S. Senate,T. Shannon,REP,510050,0,1,9,10,
Muskogee,U.S. Senate,Randy Brogdon,REP,510050,1,2,2,5,
Muskogee,U.S. Senate,Eric Mccray,REP,510050,0,0,0,0,
Muskogee,U.S. Senate,Kevin Crow,REP,510050,1,0,0,1,
Muskogee,U.S. Senate,James Lankford,REP,510050,0,2,9,11,
Muskogee,U.S. Senate,Jason Weger,REP,510050,0,0,1,1,
Muskogee,U.S. House,Darrel Robertson,REP,510050,0,0,1,1,02
Muskogee,U.S. House,Markwayne Mullin,REP,510050,2,5,21,28,02
Muskogee,Superintendent of Public Instruction,John Cox,DEM,510051,0,0,8,8,
Muskogee,Superintendent of Public Instruction,Jack Jr.,DEM,510051,0,0,9,9,
Muskogee,Superintendent of Public Instruction,Ivan Holmes,DEM,510051,0,0,0,0,
Muskogee,Superintendent of Public Instruction,Freda Deskin,DEM,510051,0,0,18,18,
Muskogee,U.S. Senate,Patrick Michael Hayes,DEM,510051,0,0,11,11,
Muskogee,U.S. Senate,Jim Rogers,DEM,510051,0,0,18,18,
Muskogee,U.S. Senate,Connie Johnson,DEM,510051,0,0,4,4,
Muskogee,U.S. House,Earl Everett,DEM,510051,0,0,19,19,02
Muskogee,U.S. House,Joshua Harris-Till,DEM,510051,0,0,12,12,02
Muskogee,Governor,Dax Ewbank,REP,510051,0,0,7,7,
Muskogee,Governor,Chad Moody,REP,510051,0,0,3,3,
Muskogee,Governor,Mary Fallin,REP,510051,0,0,8,8,
Muskogee,Superintendent of Public Instruction,Brian Kelly,REP,510051,0,0,2,2,
Muskogee,Superintendent of Public Instruction,Janet Costello Barresi,REP,510051,0,0,4,4,
Muskogee,Superintendent of Public Instruction,Joy Hofmeister,REP,510051,0,0,13,13,
Muskogee,Insurance Commissioner,Bill Viner,REP,510051,0,0,6,6,
Muskogee,Insurance Commissioner,John Doak,REP,510051,0,0,11,11,
Muskogee,Corporation Commissioner,Todd Hiett,REP,510051,0,0,9,9,
Muskogee,Corporation Commissioner,Cliff Branan,REP,510051,0,0,9,9,
Muskogee,U.S. Senate,Evelyn Rogers,REP,510051,0,0,0,0,
Muskogee,U.S. Senate,Rob Moye,REP,510051,0,0,1,1,
Muskogee,U.S. Senate,D. Jean Mcbride-Samuels,REP,510051,0,0,0,0,
Muskogee,U.S. Senate,Jim Inhofe,REP,510051,0,0,17,17,
Muskogee,U.S. Senate,Erick Paul Wyatt,REP,510051,0,0,1,1,
Muskogee,U.S. Senate,Andy Craig,REP,510051,0,0,0,0,
Muskogee,U.S. Senate,T. Shannon,REP,510051,0,0,4,4,
Muskogee,U.S. Senate,Randy Brogdon,REP,510051,0,0,2,2,
Muskogee,U.S. Senate,Eric Mccray,REP,510051,0,0,0,0,
Muskogee,U.S. Senate,Kevin Crow,REP,510051,0,0,0,0,
Muskogee,U.S. Senate,James Lankford,REP,510051,0,0,11,11,
Muskogee,U.S. Senate,Jason Weger,REP,510051,0,0,2,2,
Muskogee,U.S. House,Darrel Robertson,REP,510051,0,0,2,2,02
Muskogee,U.S. House,Markwayne Mullin,REP,510051,0,0,17,17,02
Muskogee,Superintendent of Public Instruction,John Cox,DEM,510052,2,4,59,65,
Muskogee,Superintendent of Public Instruction,Jack Jr.,DEM,510052,0,0,6,6,
Muskogee,Superintendent of Public Instruction,Ivan Holmes,DEM,510052,0,0,3,3,
Muskogee,Superintendent of Public Instruction,Freda Deskin,DEM,510052,0,0,16,16,
Muskogee,U.S. Senate,Patrick Michael Hayes,DEM,510052,0,1,25,26,
Muskogee,U.S. Senate,Jim Rogers,DEM,510052,2,3,38,43,
Muskogee,U.S. Senate,Connie Johnson,DEM,510052,0,0,15,15,
Muskogee,U.S. House,Earl Everett,DEM,510052,2,3,57,62,02
Muskogee,U.S. House,Joshua Harris-Till,DEM,510052,0,0,21,21,02
Muskogee,Governor,Dax Ewbank,REP,510052,0,0,5,5,
Muskogee,Governor,Chad Moody,REP,510052,0,0,6,6,
Muskogee,Governor,Mary Fallin,REP,510052,0,4,19,23,
Muskogee,Superintendent of Public Instruction,Brian Kelly,REP,510052,0,0,10,10,
Muskogee,Superintendent of Public Instruction,Janet Costello Barresi,REP,510052,0,1,4,5,
Muskogee,Superintendent of Public Instruction,Joy Hofmeister,REP,510052,0,3,16,19,
Muskogee,Insurance Commissioner,Bill Viner,REP,510052,0,0,7,7,
Muskogee,Insurance Commissioner,John Doak,REP,510052,0,3,20,23,
Muskogee,Corporation Commissioner,Todd Hiett,REP,510052,0,0,9,9,
Muskogee,Corporation Commissioner,Cliff Branan,REP,510052,0,4,17,21,
Muskogee,U.S. Senate,Evelyn Rogers,REP,510052,0,0,6,6,
Muskogee,U.S. Senate,Rob Moye,REP,510052,0,0,0,0,
Muskogee,U.S. Senate,D. Jean Mcbride-Samuels,REP,510052,0,0,1,1,
Muskogee,U.S. Senate,Jim Inhofe,REP,510052,0,4,20,24,
Muskogee,U.S. Senate,Erick Paul Wyatt,REP,510052,0,0,3,3,
Muskogee,U.S. Senate,Andy Craig,REP,510052,0,0,1,1,
Muskogee,U.S. Senate,T. Shannon,REP,510052,0,3,12,15,
Muskogee,U.S. Senate,Randy Brogdon,REP,510052,0,0,3,3,
Muskogee,U.S. Senate,Eric Mccray,REP,510052,0,0,2,2,
Muskogee,U.S. Senate,Kevin Crow,REP,510052,0,0,0,0,
Muskogee,U.S. Senate,James Lankford,REP,510052,0,1,12,13,
Muskogee,U.S. Senate,Jason Weger,REP,510052,0,0,0,0,
Muskogee,U.S. House,Darrel Robertson,REP,510052,0,0,0,0,02
Muskogee,U.S. House,Markwayne Mullin,REP,510052,0,4,29,33,02
Muskogee,Superintendent of Public Instruction,John Cox,DEM,510053,0,2,84,86,
Muskogee,Superintendent of Public Instruction,Jack Jr.,DEM,510053,0,0,25,25,
Muskogee,Superintendent of Public Instruction,Ivan Holmes,DEM,510053,0,0,12,12,
Muskogee,Superintendent of Public Instruction,Freda Deskin,DEM,510053,0,2,48,50,
Muskogee,U.S. Senate,Patrick Michael Hayes,DEM,510053,0,0,33,33,
Muskogee,U.S. Senate,Jim Rogers,DEM,510053,0,1,86,87,
Muskogee,U.S. Senate,Connie Johnson,DEM,510053,0,2,44,46,
Muskogee,U.S. House,Earl Everett,DEM,510053,0,4,112,116,02
Muskogee,U.S. House,Joshua Harris-Till,DEM,510053,0,0,50,50,02
Muskogee,Governor,Dax Ewbank,REP,510053,0,0,9,9,
Muskogee,Governor,Chad Moody,REP,510053,0,1,20,21,
Muskogee,Governor,Mary Fallin,REP,510053,1,0,50,51,
Muskogee,Superintendent of Public Instruction,Brian Kelly,REP,510053,0,0,17,17,
Muskogee,Superintendent of Public Instruction,Janet Costello Barresi,REP,510053,0,0,11,11,
Muskogee,Superintendent of Public Instruction,Joy Hofmeister,REP,510053,1,1,49,51,
Muskogee,Insurance Commissioner,Bill Viner,REP,510053,1,0,17,18,
Muskogee,Insurance Commissioner,John Doak,REP,510053,0,1,58,59,
Muskogee,Corporation Commissioner,Todd Hiett,REP,510053,0,0,34,34,
Muskogee,Corporation Commissioner,Cliff Branan,REP,510053,1,1,41,43,
Muskogee,U.S. Senate,Evelyn Rogers,REP,510053,0,0,2,2,
Muskogee,U.S. Senate,Rob Moye,REP,510053,0,0,4,4,
Muskogee,U.S. Senate,D. Jean Mcbride-Samuels,REP,510053,0,0,0,0,
Muskogee,U.S. Senate,Jim Inhofe,REP,510053,1,1,64,66,
Muskogee,U.S. Senate,Erick Paul Wyatt,REP,510053,0,0,8,8,
Muskogee,U.S. Senate,Andy Craig,REP,510053,0,0,1,1,
Muskogee,U.S. Senate,T. Shannon,REP,510053,0,1,38,39,
Muskogee,U.S. Senate,Randy Brogdon,REP,510053,0,0,1,1,
Muskogee,U.S. Senate,Eric Mccray,REP,510053,1,0,1,2,
Muskogee,U.S. Senate,Kevin Crow,REP,510053,0,0,1,1,
Muskogee,U.S. Senate,James Lankford,REP,510053,0,0,34,34,
Muskogee,U.S. Senate,Jason Weger,REP,510053,0,0,1,1,
Muskogee,U.S. House,Darrel Robertson,REP,510053,0,1,14,15,02
Muskogee,U.S. House,Markwayne Mullin,REP,510053,1,0,64,65,02
Muskogee,Superintendent of Public Instruction,John Cox,DEM,510055,0,12,193,205,
Muskogee,Superintendent of Public Instruction,Jack Jr.,DEM,510055,0,5,51,56,
Muskogee,Superintendent of Public Instruction,Ivan Holmes,DEM,510055,0,0,22,22,
Muskogee,Superintendent of Public Instruction,Freda Deskin,DEM,510055,1,6,146,153,
Muskogee,U.S. Senate,Patrick Michael Hayes,DEM,510055,0,4,82,86,
Muskogee,U.S. Senate,Jim Rogers,DEM,510055,0,8,200,208,
Muskogee,U.S. Senate,Connie Johnson,DEM,510055,1,9,131,141,
Muskogee,U.S. House,Earl Everett,DEM,510055,1,14,277,292,02
Muskogee,U.S. House,Joshua Harris-Till,DEM,510055,0,8,120,128,02
Muskogee,Governor,Dax Ewbank,REP,510055,0,0,6,6,
Muskogee,Governor,Chad Moody,REP,510055,0,2,53,55,
Muskogee,Governor,Mary Fallin,REP,510055,2,11,173,186,
Muskogee,Superintendent of Public Instruction,Brian Kelly,REP,510055,0,1,59,60,
Muskogee,Superintendent of Public Instruction,Janet Costello Barresi,REP,510055,0,7,38,45,
Muskogee,Superintendent of Public Instruction,Joy Hofmeister,REP,510055,2,5,133,140,
Muskogee,Insurance Commissioner,Bill Viner,REP,510055,0,6,41,47,
Muskogee,Insurance Commissioner,John Doak,REP,510055,1,7,181,189,
Muskogee,Corporation Commissioner,Todd Hiett,REP,510055,1,7,105,113,
Muskogee,Corporation Commissioner,Cliff Branan,REP,510055,0,6,119,125,
Muskogee,U.S. Senate,Evelyn Rogers,REP,510055,0,1,5,6,
Muskogee,U.S. Senate,Rob Moye,REP,510055,0,1,5,6,
Muskogee,U.S. Senate,D. Jean Mcbride-Samuels,REP,510055,0,0,1,1,
Muskogee,U.S. Senate,Jim Inhofe,REP,510055,2,9,205,216,
Muskogee,U.S. Senate,Erick Paul Wyatt,REP,510055,0,2,15,17,
Muskogee,U.S. Senate,Andy Craig,REP,510055,0,0,4,4,
Muskogee,U.S. Senate,T. Shannon,REP,510055,2,9,89,100,
Muskogee,U.S. Senate,Randy Brogdon,REP,510055,0,1,9,10,
Muskogee,U.S. Senate,Eric Mccray,REP,510055,0,0,8,8,
Muskogee,U.S. Senate,Kevin Crow,REP,510055,0,0,1,1,
Muskogee,U.S. Senate,James Lankford,REP,510055,0,3,117,120,
Muskogee,U.S. Senate,Jason Weger,REP,510055,0,0,3,3,
Muskogee,U.S. House,Darrel Robertson,REP,510055,0,7,43,50,02
Muskogee,U.S. House,Markwayne Mullin,REP,510055,2,6,189,197,02
Muskogee,Superintendent of Public Instruction,John Cox,DEM,510056,0,1,10,11,
Muskogee,Superintendent of Public Instruction,Jack Jr.,DEM,510056,0,1,4,5,
Muskogee,Superintendent of Public Instruction,Ivan Holmes,DEM,510056,0,0,4,4,
Muskogee,Superintendent of Public Instruction,Freda Deskin,DEM,510056,0,1,17,18,
Muskogee,U.S. Senate,Patrick Michael Hayes,DEM,510056,0,1,9,10,
Muskogee,U.S. Senate,Jim Rogers,DEM,510056,0,2,16,18,
Muskogee,U.S. Senate,Connie Johnson,DEM,510056,0,0,9,9,
Muskogee,U.S. House,Earl Everett,DEM,510056,0,3,21,24,02
Muskogee,U.S. House,Joshua Harris-Till,DEM,510056,0,0,13,13,02
Muskogee,Governor,Dax Ewbank,REP,510056,0,0,0,0,
Muskogee,Governor,Chad Moody,REP,510056,0,0,1,1,
Muskogee,Governor,Mary Fallin,REP,510056,0,1,19,20,
Muskogee,Superintendent of Public Instruction,Brian Kelly,REP,510056,0,0,2,2,
Muskogee,Superintendent of Public Instruction,Janet Costello Barresi,REP,510056,0,1,9,10,
Muskogee,Superintendent of Public Instruction,Joy Hofmeister,REP,510056,0,0,9,9,
Muskogee,Insurance Commissioner,Bill Viner,REP,510056,0,0,1,1,
Muskogee,Insurance Commissioner,John Doak,REP,510056,0,1,19,20,
Muskogee,Corporation Commissioner,Todd Hiett,REP,510056,0,0,16,16,
Muskogee,Corporation Commissioner,Cliff Branan,REP,510056,0,0,4,4,
Muskogee,U.S. Senate,Evelyn Rogers,REP,510056,0,0,0,0,
Muskogee,U.S. Senate,Rob Moye,REP,510056,0,0,0,0,
Muskogee,U.S. Senate,D. Jean Mcbride-Samuels,REP,510056,0,0,0,0,
Muskogee,U.S. Senate,Jim Inhofe,REP,510056,0,1,19,20,
Muskogee,U.S. Senate,Erick Paul Wyatt,REP,510056,0,0,1,1,
Muskogee,U.S. Senate,Andy Craig,REP,510056,0,0,0,0,
Muskogee,U.S. Senate,T. Shannon,REP,510056,0,1,11,12,
Muskogee,U.S. Senate,Randy Brogdon,REP,510056,0,0,2,2,
Muskogee,U.S. Senate,Eric Mccray,REP,510056,0,0,0,0,
Muskogee,U.S. Senate,Kevin Crow,REP,510056,0,0,0,0,
Muskogee,U.S. Senate,James Lankford,REP,510056,0,0,7,7,
Muskogee,U.S. Senate,Jason Weger,REP,510056,0,0,0,0,
Muskogee,U.S. House,Darrel Robertson,REP,510056,0,0,2,2,02
Muskogee,U.S. House,Markwayne Mullin,REP,510056,0,1,17,18,02
Muskogee,Superintendent of Public Instruction,John Cox,DEM,510057,0,0,1,1,
Muskogee,Superintendent of Public Instruction,Jack Jr.,DEM,510057,0,0,2,2,
Muskogee,Superintendent of Public Instruction,Ivan Holmes,DEM,510057,0,0,0,0,
Muskogee,Superintendent of Public Instruction,Freda Deskin,DEM,510057,0,0,2,2,
Muskogee,U.S. Senate,Patrick Michael Hayes,DEM,510057,0,0,2,2,
Muskogee,U.S. Senate,Jim Rogers,DEM,510057,0,0,2,2,
Muskogee,U.S. Senate,Connie Johnson,DEM,510057,0,0,1,1,
Muskogee,U.S. House,Earl Everett,DEM,510057,0,0,3,3,02
Muskogee,U.S. House,Joshua Harris-Till,DEM,510057,0,0,2,2,02
Muskogee,Governor,Dax Ewbank,REP,510057,0,0,0,0,
Muskogee,Governor,Chad Moody,REP,510057,0,0,0,0,
Muskogee,Governor,Mary Fallin,REP,510057,0,0,3,3,
Muskogee,Superintendent of Public Instruction,Brian Kelly,REP,510057,0,0,0,0,
Muskogee,Superintendent of Public Instruction,Janet Costello Barresi,REP,510057,0,0,0,0,
Muskogee,Superintendent of Public Instruction,Joy Hofmeister,REP,510057,0,0,3,3,
Muskogee,Insurance Commissioner,Bill Viner,REP,510057,0,0,0,0,
Muskogee,Insurance Commissioner,John Doak,REP,510057,0,0,3,3,
Muskogee,Corporation Commissioner,Todd Hiett,REP,510057,0,0,3,3,
Muskogee,Corporation Commissioner,Cliff Branan,REP,510057,0,0,0,0,
Muskogee,U.S. Senate,Evelyn Rogers,REP,510057,0,0,0,0,
Muskogee,U.S. Senate,Rob Moye,REP,510057,0,0,0,0,
Muskogee,U.S. Senate,D. Jean Mcbride-Samuels,REP,510057,0,0,0,0,
Muskogee,U.S. Senate,Jim Inhofe,REP,510057,0,0,3,3,
Muskogee,U.S. Senate,Erick Paul Wyatt,REP,510057,0,0,0,0,
Muskogee,U.S. Senate,Andy Craig,REP,510057,0,0,0,0,
Muskogee,U.S. Senate,T. Shannon,REP,510057,0,1,1,2,
Muskogee,U.S. Senate,Randy Brogdon,REP,510057,0,0,0,0,
Muskogee,U.S. Senate,Eric Mccray,REP,510057,0,0,0,0,
Muskogee,U.S. Senate,Kevin Crow,REP,510057,0,0,0,0,
Muskogee,U.S. Senate,James Lankford,REP,510057,0,0,2,2,
Muskogee,U.S. Senate,Jason Weger,REP,510057,0,0,0,0,
Muskogee,U.S. House,Darrel Robertson,REP,510057,0,0,2,2,02
Muskogee,U.S. House,Markwayne Mullin,REP,510057,0,0,1,1,02
Muskogee,Superintendent of Public Instruction,John Cox,DEM,510058,0,3,64,67,
Muskogee,Superintendent of Public Instruction,Jack Jr.,DEM,510058,0,0,11,11,
Muskogee,Superintendent of Public Instruction,Ivan Holmes,DEM,510058,0,1,7,8,
Muskogee,Superintendent of Public Instruction,Freda Deskin,DEM,510058,0,1,32,33,
Muskogee,U.S. Senate,Patrick Michael Hayes,DEM,510058,0,0,18,18,
Muskogee,U.S. Senate,Jim Rogers,DEM,510058,0,3,57,60,
Muskogee,U.S. Senate,Connie Johnson,DEM,510058,0,2,35,37,
Muskogee,U.S. House,Earl Everett,DEM,510058,0,4,67,71,02
Muskogee,U.S. House,Joshua Harris-Till,DEM,510058,0,1,39,40,02
Muskogee,State Senate,Chad Bonds,DEM,510058,0,3,30,33,8
Muskogee,State Senate,Gary Clason,DEM,510058,0,1,27,28,8
Muskogee,State Senate,Selina Jayne-Dornan,DEM,510058,0,1,51,52,8
Muskogee,Governor,Dax Ewbank,REP,510058,0,1,2,3,
Muskogee,Governor,Chad Moody,REP,510058,0,2,7,9,
Muskogee,Governor,Mary Fallin,REP,510058,4,1,42,47,
Muskogee,Superintendent of Public Instruction,Brian Kelly,REP,510058,0,0,11,11,
Muskogee,Superintendent of Public Instruction,Janet Costello Barresi,REP,510058,3,1,12,16,
Muskogee,Superintendent of Public Instruction,Joy Hofmeister,REP,510058,1,3,26,30,
Muskogee,Insurance Commissioner,Bill Viner,REP,510058,0,0,16,16,
Muskogee,Insurance Commissioner,John Doak,REP,510058,4,4,32,40,
Muskogee,Corporation Commissioner,Todd Hiett,REP,510058,2,0,30,32,
Muskogee,Corporation Commissioner,Cliff Branan,REP,510058,2,4,19,25,
Muskogee,U.S. Senate,Evelyn Rogers,REP,510058,0,0,5,5,
Muskogee,U.S. Senate,Rob Moye,REP,510058,0,0,2,2,
Muskogee,U.S. Senate,D. Jean Mcbride-Samuels,REP,510058,0,0,0,0,
Muskogee,U.S. Senate,Jim Inhofe,REP,510058,2,4,41,47,
Muskogee,U.S. Senate,Erick Paul Wyatt,REP,510058,2,0,2,4,
Muskogee,U.S. Senate,Andy Craig,REP,510058,0,1,0,1,
Muskogee,U.S. Senate,T. Shannon,REP,510058,3,0,24,27,
Muskogee,U.S. Senate,Randy Brogdon,REP,510058,0,0,2,2,
Muskogee,U.S. Senate,Eric Mccray,REP,510058,0,1,0,1,
Muskogee,U.S. Senate,Kevin Crow,REP,510058,0,0,0,0,
Muskogee,U.S. Senate,James Lankford,REP,510058,1,2,25,28,
Muskogee,U.S. Senate,Jason Weger,REP,510058,0,0,0,0,
Muskogee,U.S. House,Darrel Robertson,REP,510058,2,2,12,16,02
Muskogee,U.S. House,Markwayne Mullin,REP,510058,2,2,39,43,02
Muskogee,State Senate,J. Hill,REP,510058,2,1,14,17,8
Muskogee,State Senate,Roger Thompson,REP,510058,0,1,27,28,8
Muskogee,State Senate,Malcolm Branch,REP,510058,2,2,7,11,8
Muskogee,Superintendent of Public Instruction,John Cox,DEM,510059,1,3,115,119,
Muskogee,Superintendent of Public Instruction,Jack Jr.,DEM,510059,0,0,14,14,
Muskogee,Superintendent of Public Instruction,Ivan Holmes,DEM,510059,0,1,13,14,
Muskogee,Superintendent of Public Instruction,Freda Deskin,DEM,510059,0,4,56,60,
Muskogee,U.S. Senate,Patrick Michael Hayes,DEM,510059,0,0,46,46,
Muskogee,U.S. Senate,Jim Rogers,DEM,510059,0,3,89,92,
Muskogee,U.S. Senate,Connie Johnson,DEM,510059,1,5,55,61,
Muskogee,U.S. House,Earl Everett,DEM,510059,1,5,123,129,02
Muskogee,U.S. House,Joshua Harris-Till,DEM,510059,0,3,61,64,02
Muskogee,State Senate,Chad Bonds,DEM,510059,0,1,53,54,8
Muskogee,State Senate,Gary Clason,DEM,510059,1,0,55,56,8
Muskogee,State Senate,Selina Jayne-Dornan,DEM,510059,0,7,79,86,8
Muskogee,Governor,Dax Ewbank,REP,510059,1,0,0,1,
Muskogee,Governor,Chad Moody,REP,510059,0,1,14,15,
Muskogee,Governor,Mary Fallin,REP,510059,0,0,35,35,
Muskogee,Superintendent of Public Instruction,Brian Kelly,REP,510059,1,0,9,10,
Muskogee,Superintendent of Public Instruction,Janet Costello Barresi,REP,510059,0,1,6,7,
Muskogee,Superintendent of Public Instruction,Joy Hofmeister,REP,510059,0,0,33,33,
Muskogee,Insurance Commissioner,Bill Viner,REP,510059,0,0,9,9,
Muskogee,Insurance Commissioner,John Doak,REP,510059,0,1,39,40,
Muskogee,Corporation Commissioner,Todd Hiett,REP,510059,1,0,28,29,
Muskogee,Corporation Commissioner,Cliff Branan,REP,510059,0,1,21,22,
Muskogee,U.S. Senate,Evelyn Rogers,REP,510059,0,0,4,4,
Muskogee,U.S. Senate,Rob Moye,REP,510059,0,1,1,2,
Muskogee,U.S. Senate,D. Jean Mcbride-Samuels,REP,510059,0,0,0,0,
Muskogee,U.S. Senate,Jim Inhofe,REP,510059,0,0,41,41,
Muskogee,U.S. Senate,Erick Paul Wyatt,REP,510059,0,0,3,3,
Muskogee,U.S. Senate,Andy Craig,REP,510059,0,0,0,0,
Muskogee,U.S. Senate,T. Shannon,REP,510059,0,1,25,26,
Muskogee,U.S. Senate,Randy Brogdon,REP,510059,0,0,1,1,
Muskogee,U.S. Senate,Eric Mccray,REP,510059,0,0,1,1,
Muskogee,U.S. Senate,Kevin Crow,REP,510059,0,0,1,1,
Muskogee,U.S. Senate,James Lankford,REP,510059,0,0,20,20,
Muskogee,U.S. Senate,Jason Weger,REP,510059,1,0,1,2,
Muskogee,U.S. House,Darrel Robertson,REP,510059,0,1,8,9,02
Muskogee,U.S. House,Markwayne Mullin,REP,510059,0,0,41,41,02
Muskogee,State Senate,J. Hill,REP,510059,0,0,16,16,8
Muskogee,State Senate,Roger Thompson,REP,510059,0,1,28,29,8
Muskogee,State Senate,Malcolm Branch,REP,510059,0,0,5,5,8
Muskogee,Superintendent of Public Instruction,John Cox,DEM,510060,3,3,32,38,
Muskogee,Superintendent of Public Instruction,Jack Jr.,DEM,510060,0,0,1,1,
Muskogee,Superintendent of Public Instruction,Ivan Holmes,DEM,510060,0,0,4,4,
Muskogee,Superintendent of Public Instruction,Freda Deskin,DEM,510060,0,0,18,18,
Muskogee,U.S. Senate,Patrick Michael Hayes,DEM,510060,1,1,14,16,
Muskogee,U.S. Senate,Jim Rogers,DEM,510060,2,1,22,25,
Muskogee,U.S. Senate,Connie Johnson,DEM,510060,0,0,13,13,
Muskogee,U.S. House,Earl Everett,DEM,510060,3,1,28,32,02
Muskogee,U.S. House,Joshua Harris-Till,DEM,510060,0,1,20,21,02
Muskogee,State Senate,Chad Bonds,DEM,510060,0,0,11,11,8
Muskogee,State Senate,Gary Clason,DEM,510060,3,1,14,18,8
Muskogee,State Senate,Selina Jayne-Dornan,DEM,510060,0,1,24,25,8
Muskogee,Governor,Dax Ewbank,REP,510060,0,0,1,1,
Muskogee,Governor,Chad Moody,REP,510060,0,0,1,1,
Muskogee,Governor,Mary Fallin,REP,510060,0,0,8,8,
Muskogee,Superintendent of Public Instruction,Brian Kelly,REP,510060,0,0,3,3,
Muskogee,Superintendent of Public Instruction,Janet Costello Barresi,REP,510060,0,0,1,1,
Muskogee,Superintendent of Public Instruction,Joy Hofmeister,REP,510060,0,0,5,5,
Muskogee,Insurance Commissioner,Bill Viner,REP,510060,0,0,1,1,
Muskogee,Insurance Commissioner,John Doak,REP,510060,0,0,8,8,
Muskogee,Corporation Commissioner,Todd Hiett,REP,510060,0,0,5,5,
Muskogee,Corporation Commissioner,Cliff Branan,REP,510060,0,0,4,4,
Muskogee,U.S. Senate,Evelyn Rogers,REP,510060,0,0,0,0,
Muskogee,U.S. Senate,Rob Moye,REP,510060,0,0,0,0,
Muskogee,U.S. Senate,D. Jean Mcbride-Samuels,REP,510060,0,0,0,0,
Muskogee,U.S. Senate,Jim Inhofe,REP,510060,0,0,10,10,
Muskogee,U.S. Senate,Erick Paul Wyatt,REP,510060,0,0,0,0,
Muskogee,U.S. Senate,Andy Craig,REP,510060,0,0,0,0,
Muskogee,U.S. Senate,T. Shannon,REP,510060,0,0,6,6,
Muskogee,U.S. Senate,Randy Brogdon,REP,510060,0,0,0,0,
Muskogee,U.S. Senate,Eric Mccray,REP,510060,0,0,0,0,
Muskogee,U.S. Senate,Kevin Crow,REP,510060,0,0,0,0,
Muskogee,U.S. Senate,James Lankford,REP,510060,0,0,3,3,
Muskogee,U.S. Senate,Jason Weger,REP,510060,0,0,0,0,
Muskogee,U.S. House,Darrel Robertson,REP,510060,0,0,0,0,02
Muskogee,U.S. House,Markwayne Mullin,REP,510060,0,0,9,9,02
Muskogee,State Senate,J. Hill,REP,510060,0,0,2,2,8
Muskogee,State Senate,Roger Thompson,REP,510060,0,0,6,6,8
Muskogee,State Senate,Malcolm Branch,REP,510060,0,0,1,1,8
Muskogee,Superintendent of Public Instruction,John Cox,DEM,510061,0,4,50,54,
Muskogee,Superintendent of Public Instruction,Jack Jr.,DEM,510061,0,0,15,15,
Muskogee,Superintendent of Public Instruction,Ivan Holmes,DEM,510061,0,1,11,12,
Muskogee,Superintendent of Public Instruction,Freda Deskin,DEM,510061,0,2,41,43,
Muskogee,U.S. Senate,Patrick Michael Hayes,DEM,510061,0,4,26,30,
Muskogee,U.S. Senate,Jim Rogers,DEM,510061,0,1,48,49,
Muskogee,U.S. Senate,Connie Johnson,DEM,510061,0,2,40,42,
Muskogee,U.S. House,Earl Everett,DEM,510061,0,4,75,79,02
Muskogee,U.S. House,Joshua Harris-Till,DEM,510061,0,2,34,36,02
Muskogee,Governor,Dax Ewbank,REP,510061,0,0,3,3,
Muskogee,Governor,Chad Moody,REP,510061,0,0,4,4,
Muskogee,Governor,Mary Fallin,REP,510061,1,1,33,35,
Muskogee,Superintendent of Public Instruction,Brian Kelly,REP,510061,0,0,8,8,
Muskogee,Superintendent of Public Instruction,Janet Costello Barresi,REP,510061,1,1,6,8,
Muskogee,Superintendent of Public Instruction,Joy Hofmeister,REP,510061,0,0,24,24,
Muskogee,Insurance Commissioner,Bill Viner,REP,510061,0,0,8,8,
Muskogee,Insurance Commissioner,John Doak,REP,510061,1,1,31,33,
Muskogee,Corporation Commissioner,Todd Hiett,REP,510061,0,0,16,16,
Muskogee,Corporation Commissioner,Cliff Branan,REP,510061,1,1,22,24,
Muskogee,U.S. Senate,Evelyn Rogers,REP,510061,0,0,3,3,
Muskogee,U.S. Senate,Rob Moye,REP,510061,1,1,0,2,
Muskogee,U.S. Senate,D. Jean Mcbride-Samuels,REP,510061,0,0,1,1,
Muskogee,U.S. Senate,Jim Inhofe,REP,510061,0,0,34,34,
Muskogee,U.S. Senate,Erick Paul Wyatt,REP,510061,0,0,1,1,
Muskogee,U.S. Senate,Andy Craig,REP,510061,0,0,1,1,
Muskogee,U.S. Senate,T. Shannon,REP,510061,0,0,8,8,
Muskogee,U.S. Senate,Randy Brogdon,REP,510061,0,0,3,3,
Muskogee,U.S. Senate,Eric Mccray,REP,510061,0,0,0,0,
Muskogee,U.S. Senate,Kevin Crow,REP,510061,1,1,0,2,
Muskogee,U.S. Senate,James Lankford,REP,510061,0,0,27,27,
Muskogee,U.S. Senate,Jason Weger,REP,510061,0,0,0,0,
Muskogee,U.S. House,Darrel Robertson,REP,510061,0,0,8,8,02
Muskogee,U.S. House,Markwayne Mullin,REP,510061,1,1,31,33,02
Muskogee,Superintendent of Public Instruction,John Cox,DEM,510064,0,4,130,134,
Muskogee,Superintendent of Public Instruction,Jack Jr.,DEM,510064,0,1,16,17,
Muskogee,Superintendent of Public Instruction,Ivan Holmes,DEM,510064,0,0,10,10,
Muskogee,Superintendent of Public Instruction,Freda Deskin,DEM,510064,0,1,32,33,
Muskogee,U.S. Senate,Patrick Michael Hayes,DEM,510064,0,0,47,47,
Muskogee,U.S. Senate,Jim Rogers,DEM,510064,0,4,92,96,
Muskogee,U.S. Senate,Connie Johnson,DEM,510064,0,2,35,37,
Muskogee,U.S. House,Earl Everett,DEM,510064,0,5,116,121,02
Muskogee,U.S. House,Joshua Harris-Till,DEM,510064,0,1,50,51,02
Muskogee,State Senate,Chad Bonds,DEM,510064,0,4,66,70,8
Muskogee,State Senate,Gary Clason,DEM,510064,0,0,46,46,8
Muskogee,State Senate,Selina Jayne-Dornan,DEM,510064,0,2,60,62,8
Muskogee,Governor,Dax Ewbank,REP,510064,0,0,4,4,
Muskogee,Governor,Chad Moody,REP,510064,1,0,2,3,
Muskogee,Governor,Mary Fallin,REP,510064,0,0,39,39,
Muskogee,Superintendent of Public Instruction,Brian Kelly,REP,510064,0,0,8,8,
Muskogee,Superintendent of Public Instruction,Janet Costello Barresi,REP,510064,0,0,12,12,
Muskogee,Superintendent of Public Instruction,Joy Hofmeister,REP,510064,1,0,23,24,
Muskogee,Insurance Commissioner,Bill Viner,REP,510064,1,0,9,10,
Muskogee,Insurance Commissioner,John Doak,REP,510064,0,0,32,32,
Muskogee,Corporation Commissioner,Todd Hiett,REP,510064,1,0,17,18,
Muskogee,Corporation Commissioner,Cliff Branan,REP,510064,0,0,25,25,
Muskogee,U.S. Senate,Evelyn Rogers,REP,510064,1,0,2,3,
Muskogee,U.S. Senate,Rob Moye,REP,510064,0,0,0,0,
Muskogee,U.S. Senate,D. Jean Mcbride-Samuels,REP,510064,0,0,0,0,
Muskogee,U.S. Senate,Jim Inhofe,REP,510064,0,0,38,38,
Muskogee,U.S. Senate,Erick Paul Wyatt,REP,510064,0,0,4,4,
Muskogee,U.S. Senate,Andy Craig,REP,510064,1,0,1,2,
Muskogee,U.S. Senate,T. Shannon,REP,510064,0,0,28,28,
Muskogee,U.S. Senate,Randy Brogdon,REP,510064,0,0,0,0,
Muskogee,U.S. Senate,Eric Mccray,REP,510064,0,0,0,0,
Muskogee,U.S. Senate,Kevin Crow,REP,510064,0,0,0,0,
Muskogee,U.S. Senate,James Lankford,REP,510064,0,0,15,15,
Muskogee,U.S. Senate,Jason Weger,REP,510064,0,0,1,1,
Muskogee,U.S. House,Darrel Robertson,REP,510064,1,0,3,4,02
Muskogee,U.S. House,Markwayne Mullin,REP,510064,0,0,42,42,02
Muskogee,State Senate,J. Hill,REP,510064,0,0,7,7,8
Muskogee,State Senate,Roger Thompson,REP,510064,1,0,28,29,8
Muskogee,State Senate,Malcolm Branch,REP,510064,0,0,6,6,8
Noble,Superintendent of Public Instruction,John Cox,DEM,520101,0,4,19,23,
Noble,Superintendent of Public Instruction,Jack Jr.,DEM,520101,0,1,9,10,
Noble,Superintendent of Public Instruction,Ivan Holmes,DEM,520101,0,0,5,5,
Noble,Superintendent of Public Instruction,Freda Deskin,DEM,520101,0,2,26,28,
Noble,U.S. Senate,Patrick Michael Hayes,DEM,520101,0,3,15,18,
Noble,U.S. Senate,Jim Rogers,DEM,520101,0,2,23,25,
Noble,U.S. Senate,Connie Johnson,DEM,520101,1,2,19,22,
Noble,Governor,Dax Ewbank,REP,520101,0,2,11,13,
Noble,Governor,Chad Moody,REP,520101,0,12,25,37,
Noble,Governor,Mary Fallin,REP,520101,5,31,147,183,
Noble,Superintendent of Public Instruction,Brian Kelly,REP,520101,1,8,44,53,
Noble,Superintendent of Public Instruction,Janet Costello Barresi,REP,520101,1,7,22,30,
Noble,Superintendent of Public Instruction,Joy Hofmeister,REP,520101,3,31,116,150,
Noble,Insurance Commissioner,Bill Viner,REP,520101,0,7,31,38,
Noble,Insurance Commissioner,John Doak,REP,520101,5,38,147,190,
Noble,Corporation Commissioner,Todd Hiett,REP,520101,5,17,77,99,
Noble,Corporation Commissioner,Cliff Branan,REP,520101,0,28,96,124,
Noble,U.S. Senate,Evelyn Rogers,REP,520101,0,2,9,11,
Noble,U.S. Senate,Rob Moye,REP,520101,0,0,0,0,
Noble,U.S. Senate,D. Jean Mcbride-Samuels,REP,520101,0,1,1,2,
Noble,U.S. Senate,Jim Inhofe,REP,520101,5,38,167,210,
Noble,U.S. Senate,Erick Paul Wyatt,REP,520101,0,4,5,9,
Noble,U.S. Senate,Andy Craig,REP,520101,0,0,1,1,
Noble,U.S. Senate,T. Shannon,REP,520101,2,20,61,83,
Noble,U.S. Senate,Randy Brogdon,REP,520101,0,1,1,2,
Noble,U.S. Senate,Eric Mccray,REP,520101,0,0,2,2,
Noble,U.S. Senate,Kevin Crow,REP,520101,0,2,6,8,
Noble,U.S. Senate,James Lankford,REP,520101,3,23,112,138,
Noble,U.S. Senate,Jason Weger,REP,520101,0,0,0,0,
Noble,U.S. House,Timothy Ray Murray,REP,520101,0,1,4,5,03
Noble,U.S. House,Robert Hubbard,REP,520101,0,5,10,15,03
Noble,U.S. House,Frank Lucas,REP,520101,5,40,168,213,03
Noble,State Senate,Dan Ladd,REP,520101,0,7,26,33,20
Noble,State Senate,A Griffin,REP,520101,5,39,158,202,20
Noble,Superintendent of Public Instruction,John Cox,DEM,520102,0,2,8,10,
Noble,Superintendent of Public Instruction,Jack Jr.,DEM,520102,0,1,4,5,
Noble,Superintendent of Public Instruction,Ivan Holmes,DEM,520102,0,0,2,2,
Noble,Superintendent of Public Instruction,Freda Deskin,DEM,520102,0,1,8,9,
Noble,U.S. Senate,Patrick Michael Hayes,DEM,520102,0,1,4,5,
Noble,U.S. Senate,Jim Rogers,DEM,520102,0,3,6,9,
Noble,U.S. Senate,Connie Johnson,DEM,520102,0,0,13,13,
Noble,Governor,Dax Ewbank,REP,520102,0,0,2,2,
Noble,Governor,Chad Moody,REP,520102,0,1,11,12,
Noble,Governor,Mary Fallin,REP,520102,2,10,40,52,
Noble,Superintendent of Public Instruction,Brian Kelly,REP,520102,1,3,15,19,
Noble,Superintendent of Public Instruction,Janet Costello Barresi,REP,520102,0,0,7,7,
Noble,Superintendent of Public Instruction,Joy Hofmeister,REP,520102,1,7,32,40,
Noble,Insurance Commissioner,Bill Viner,REP,520102,2,0,9,11,
Noble,Insurance Commissioner,John Doak,REP,520102,0,11,45,56,
Noble,Corporation Commissioner,Todd Hiett,REP,520102,2,4,31,37,
Noble,Corporation Commissioner,Cliff Branan,REP,520102,0,6,22,28,
Noble,U.S. Senate,Evelyn Rogers,REP,520102,0,0,1,1,
Noble,U.S. Senate,Rob Moye,REP,520102,0,0,2,2,
Noble,U.S. Senate,D. Jean Mcbride-Samuels,REP,520102,0,0,1,1,
Noble,U.S. Senate,Jim Inhofe,REP,520102,2,11,49,62,
Noble,U.S. Senate,Erick Paul Wyatt,REP,520102,0,0,1,1,
Noble,U.S. Senate,Andy Craig,REP,520102,0,0,0,0,
Noble,U.S. Senate,T. Shannon,REP,520102,0,1,22,23,
Noble,U.S. Senate,Randy Brogdon,REP,520102,0,0,0,0,
Noble,U.S. Senate,Eric Mccray,REP,520102,0,0,0,0,
Noble,U.S. Senate,Kevin Crow,REP,520102,0,0,0,0,
Noble,U.S. Senate,James Lankford,REP,520102,2,9,32,43,
Noble,U.S. Senate,Jason Weger,REP,520102,0,0,0,0,
Noble,U.S. House,Timothy Ray Murray,REP,520102,0,0,0,0,03
Noble,U.S. House,Robert Hubbard,REP,520102,0,0,5,5,03
Noble,U.S. House,Frank Lucas,REP,520102,2,11,49,62,03
Noble,State Senate,Dan Ladd,REP,520102,0,2,17,19,20
Noble,State Senate,A Griffin,REP,520102,2,9,37,48,20
Noble,State House,Roy Chaney,REP,520102,0,2,6,8,38
Noble,State House,Niki Schrader,REP,520102,0,1,3,4,38
Noble,State House,Jason Warren,REP,520102,0,0,3,3,38
Noble,State House,Ralph Meade,REP,520102,0,0,5,5,38
Noble,State House,John Pfeiffer,REP,520102,2,6,33,41,38
Noble,State House,Harold Levalley,REP,520102,0,1,4,5,38
Noble,Superintendent of Public Instruction,John Cox,DEM,520103,3,0,15,18,
Noble,Superintendent of Public Instruction,Jack Jr.,DEM,520103,0,0,4,4,
Noble,Superintendent of Public Instruction,Ivan Holmes,DEM,520103,1,0,5,6,
Noble,Superintendent of Public Instruction,Freda Deskin,DEM,520103,0,0,12,12,
Noble,U.S. Senate,Patrick Michael Hayes,DEM,520103,0,0,8,8,
Noble,U.S. Senate,Jim Rogers,DEM,520103,1,0,14,15,
Noble,U.S. Senate,Connie Johnson,DEM,520103,3,0,14,17,
Noble,Governor,Dax Ewbank,REP,520103,0,0,8,8,
Noble,Governor,Chad Moody,REP,520103,2,0,13,15,
Noble,Governor,Mary Fallin,REP,520103,7,1,43,51,
Noble,Superintendent of Public Instruction,Brian Kelly,REP,520103,5,0,23,28,
Noble,Superintendent of Public Instruction,Janet Costello Barresi,REP,520103,1,0,4,5,
Noble,Superintendent of Public Instruction,Joy Hofmeister,REP,520103,3,1,36,40,
Noble,Insurance Commissioner,Bill Viner,REP,520103,6,0,19,25,
Noble,Insurance Commissioner,John Doak,REP,520103,3,1,41,45,
Noble,Corporation Commissioner,Todd Hiett,REP,520103,5,0,30,35,
Noble,Corporation Commissioner,Cliff Branan,REP,520103,4,1,31,36,
Noble,U.S. Senate,Evelyn Rogers,REP,520103,0,0,5,5,
Noble,U.S. Senate,Rob Moye,REP,520103,1,0,2,3,
Noble,U.S. Senate,D. Jean Mcbride-Samuels,REP,520103,0,0,1,1,
Noble,U.S. Senate,Jim Inhofe,REP,520103,6,1,50,57,
Noble,U.S. Senate,Erick Paul Wyatt,REP,520103,2,0,5,7,
Noble,U.S. Senate,Andy Craig,REP,520103,1,0,3,4,
Noble,U.S. Senate,T. Shannon,REP,520103,3,0,26,29,
Noble,U.S. Senate,Randy Brogdon,REP,520103,1,0,0,1,
Noble,U.S. Senate,Eric Mccray,REP,520103,0,0,0,0,
Noble,U.S. Senate,Kevin Crow,REP,520103,1,0,2,3,
Noble,U.S. Senate,James Lankford,REP,520103,2,1,30,33,
Noble,U.S. Senate,Jason Weger,REP,520103,1,0,2,3,
Noble,U.S. House,Timothy Ray Murray,REP,520103,1,0,9,10,03
Noble,U.S. House,Robert Hubbard,REP,520103,3,0,5,8,03
Noble,U.S. House,Frank Lucas,REP,520103,5,1,49,55,03
Noble,State Senate,Dan Ladd,REP,520103,2,0,15,17,20
Noble,State Senate,A Griffin,REP,520103,7,1,48,56,20
Noble,State House,Roy Chaney,REP,520103,2,0,14,16,38
Noble,State House,Niki Schrader,REP,520103,0,0,8,8,38
Noble,State House,Jason Warren,REP,520103,1,0,7,8,38
Noble,State House,Ralph Meade,REP,520103,1,0,7,8,38
Noble,State House,John Pfeiffer,REP,520103,3,1,16,20,38
Noble,State House,Harold Levalley,REP,520103,2,0,11,13,38
Noble,Superintendent of Public Instruction,John Cox,DEM,520104,0,2,14,16,
Noble,Superintendent of Public Instruction,Jack Jr.,DEM,520104,0,0,3,3,
Noble,Superintendent of Public Instruction,Ivan Holmes,DEM,520104,1,0,6,7,
Noble,Superintendent of Public Instruction,Freda Deskin,DEM,520104,0,0,7,7,
Noble,U.S. Senate,Patrick Michael Hayes,DEM,520104,0,1,4,5,
Noble,U.S. Senate,Jim Rogers,DEM,520104,1,0,18,19,
Noble,U.S. Senate,Connie Johnson,DEM,520104,0,1,8,9,
Noble,Governor,Dax Ewbank,REP,520104,0,0,7,7,
Noble,Governor,Chad Moody,REP,520104,0,0,10,10,
Noble,Governor,Mary Fallin,REP,520104,1,5,58,64,
Noble,Superintendent of Public Instruction,Brian Kelly,REP,520104,0,3,22,25,
Noble,Superintendent of Public Instruction,Janet Costello Barresi,REP,520104,0,0,11,11,
Noble,Superintendent of Public Instruction,Joy Hofmeister,REP,520104,1,2,42,45,
Noble,Insurance Commissioner,Bill Viner,REP,520104,0,1,20,21,
Noble,Insurance Commissioner,John Doak,REP,520104,1,4,51,56,
Noble,Corporation Commissioner,Todd Hiett,REP,520104,1,3,41,45,
Noble,Corporation Commissioner,Cliff Branan,REP,520104,0,2,30,32,
Noble,U.S. Senate,Evelyn Rogers,REP,520104,0,0,2,2,
Noble,U.S. Senate,Rob Moye,REP,520104,0,0,0,0,
Noble,U.S. Senate,D. Jean Mcbride-Samuels,REP,520104,0,0,0,0,
Noble,U.S. Senate,Jim Inhofe,REP,520104,1,5,69,75,
Noble,U.S. Senate,Erick Paul Wyatt,REP,520104,0,0,5,5,
Noble,U.S. Senate,Andy Craig,REP,520104,0,0,0,0,
Noble,U.S. Senate,T. Shannon,REP,520104,0,3,35,38,
Noble,U.S. Senate,Randy Brogdon,REP,520104,0,0,2,2,
Noble,U.S. Senate,Eric Mccray,REP,520104,0,0,1,1,
Noble,U.S. Senate,Kevin Crow,REP,520104,0,0,1,1,
Noble,U.S. Senate,James Lankford,REP,520104,1,2,37,40,
Noble,U.S. Senate,Jason Weger,REP,520104,0,0,0,0,
Noble,U.S. House,Timothy Ray Murray,REP,520104,0,0,6,6,03
Noble,U.S. House,Robert Hubbard,REP,520104,0,0,8,8,03
Noble,U.S. House,Frank Lucas,REP,520104,1,5,62,68,03
Noble,State Senate,Dan Ladd,REP,520104,1,1,30,32,20
Noble,State Senate,A Griffin,REP,520104,0,4,42,46,20
Noble,State House,Roy Chaney,REP,520104,0,1,13,14,38
Noble,State House,Niki Schrader,REP,520104,0,0,6,6,38
Noble,State House,Jason Warren,REP,520104,0,0,5,5,38
Noble,State House,Ralph Meade,REP,520104,0,0,13,13,38
Noble,State House,John Pfeiffer,REP,520104,1,4,31,36,38
Noble,State House,Harold Levalley,REP,520104,0,0,6,6,38
Noble,Superintendent of Public Instruction,John Cox,DEM,520105,0,0,8,8,
Noble,Superintendent of Public Instruction,Jack Jr.,DEM,520105,0,0,2,2,
Noble,Superintendent of Public Instruction,Ivan Holmes,DEM,520105,0,0,1,1,
Noble,Superintendent of Public Instruction,Freda Deskin,DEM,520105,0,1,7,8,
Noble,U.S. Senate,Patrick Michael Hayes,DEM,520105,0,1,7,8,
Noble,U.S. Senate,Jim Rogers,DEM,520105,0,0,5,5,
Noble,U.S. Senate,Connie Johnson,DEM,520105,0,0,6,6,
Noble,Governor,Dax Ewbank,REP,520105,0,0,4,4,
Noble,Governor,Chad Moody,REP,520105,0,2,4,6,
Noble,Governor,Mary Fallin,REP,520105,0,10,34,44,
Noble,Superintendent of Public Instruction,Brian Kelly,REP,520105,0,6,3,9,
Noble,Superintendent of Public Instruction,Janet Costello Barresi,REP,520105,0,0,6,6,
Noble,Superintendent of Public Instruction,Joy Hofmeister,REP,520105,0,6,33,39,
Noble,Insurance Commissioner,Bill Viner,REP,520105,0,2,2,4,
Noble,Insurance Commissioner,John Doak,REP,520105,0,10,37,47,
Noble,Corporation Commissioner,Todd Hiett,REP,520105,0,6,16,22,
Noble,Corporation Commissioner,Cliff Branan,REP,520105,0,5,23,28,
Noble,U.S. Senate,Evelyn Rogers,REP,520105,0,1,2,3,
Noble,U.S. Senate,Rob Moye,REP,520105,0,0,0,0,
Noble,U.S. Senate,D. Jean Mcbride-Samuels,REP,520105,0,0,0,0,
Noble,U.S. Senate,Jim Inhofe,REP,520105,0,11,38,49,
Noble,U.S. Senate,Erick Paul Wyatt,REP,520105,0,0,2,2,
Noble,U.S. Senate,Andy Craig,REP,520105,0,0,0,0,
Noble,U.S. Senate,T. Shannon,REP,520105,0,3,11,14,
Noble,U.S. Senate,Randy Brogdon,REP,520105,0,0,1,1,
Noble,U.S. Senate,Eric Mccray,REP,520105,0,0,0,0,
Noble,U.S. Senate,Kevin Crow,REP,520105,0,0,2,2,
Noble,U.S. Senate,James Lankford,REP,520105,0,8,27,35,
Noble,U.S. Senate,Jason Weger,REP,520105,0,1,1,2,
Noble,U.S. House,Timothy Ray Murray,REP,520105,0,1,4,5,03
Noble,U.S. House,Robert Hubbard,REP,520105,0,0,1,1,03
Noble,U.S. House,Frank Lucas,REP,520105,0,11,37,48,03
Noble,State Senate,Dan Ladd,REP,520105,0,3,9,12,20
Noble,State Senate,A Griffin,REP,520105,0,9,33,42,20
Noble,State House,Roy Chaney,REP,520105,0,1,5,6,38
Noble,State House,Niki Schrader,REP,520105,0,0,4,4,38
Noble,State House,Jason Warren,REP,520105,0,1,1,2,38
Noble,State House,Ralph Meade,REP,520105,0,1,3,4,38
Noble,State House,John Pfeiffer,REP,520105,0,8,23,31,38
Noble,State House,Harold Levalley,REP,520105,0,1,6,7,38
Noble,Superintendent of Public Instruction,John Cox,DEM,520106,0,0,6,6,
Noble,Superintendent of Public Instruction,Jack Jr.,DEM,520106,0,0,1,1,
Noble,Superintendent of Public Instruction,Ivan Holmes,DEM,520106,0,0,2,2,
Noble,Superintendent of Public Instruction,Freda Deskin,DEM,520106,0,0,3,3,
Noble,U.S. Senate,Patrick Michael Hayes,DEM,520106,0,0,0,0,
Noble,U.S. Senate,Jim Rogers,DEM,520106,0,0,9,9,
Noble,U.S. Senate,Connie Johnson,DEM,520106,0,0,2,2,
Noble,Governor,Dax Ewbank,REP,520106,0,0,1,1,
Noble,Governor,Chad Moody,REP,520106,0,0,1,1,
Noble,Governor,Mary Fallin,REP,520106,0,2,31,33,
Noble,Superintendent of Public Instruction,Brian Kelly,REP,520106,0,1,13,14,
Noble,Superintendent of Public Instruction,Janet Costello Barresi,REP,520106,0,0,3,3,
Noble,Superintendent of Public Instruction,Joy Hofmeister,REP,520106,0,1,17,18,
Noble,Insurance Commissioner,Bill Viner,REP,520106,0,1,6,7,
Noble,Insurance Commissioner,John Doak,REP,520106,0,1,27,28,
Noble,Corporation Commissioner,Todd Hiett,REP,520106,0,1,20,21,
Noble,Corporation Commissioner,Cliff Branan,REP,520106,0,1,12,13,
Noble,U.S. Senate,Evelyn Rogers,REP,520106,0,0,0,0,
Noble,U.S. Senate,Rob Moye,REP,520106,0,0,0,0,
Noble,U.S. Senate,D. Jean Mcbride-Samuels,REP,520106,0,0,0,0,
Noble,U.S. Senate,Jim Inhofe,REP,520106,0,2,31,33,
Noble,U.S. Senate,Erick Paul Wyatt,REP,520106,0,0,2,2,
Noble,U.S. Senate,Andy Craig,REP,520106,0,0,1,1,
Noble,U.S. Senate,T. Shannon,REP,520106,0,1,14,15,
Noble,U.S. Senate,Randy Brogdon,REP,520106,0,0,0,0,
Noble,U.S. Senate,Eric Mccray,REP,520106,0,0,0,0,
Noble,U.S. Senate,Kevin Crow,REP,520106,0,0,0,0,
Noble,U.S. Senate,James Lankford,REP,520106,0,1,18,19,
Noble,U.S. Senate,Jason Weger,REP,520106,0,0,0,0,
Noble,U.S. House,Timothy Ray Murray,REP,520106,0,0,1,1,03
Noble,U.S. House,Robert Hubbard,REP,520106,0,0,4,4,03
Noble,U.S. House,Frank Lucas,REP,520106,0,2,28,30,03
Noble,State Senate,Dan Ladd,REP,520106,0,1,7,8,20
Noble,State Senate,A Griffin,REP,520106,0,1,26,27,20
Noble,State House,Roy Chaney,REP,520106,0,0,3,3,38
Noble,State House,Niki Schrader,REP,520106,0,0,5,5,38
Noble,State House,Jason Warren,REP,520106,0,1,1,2,38
Noble,State House,Ralph Meade,REP,520106,0,0,5,5,38
Noble,State House,John Pfeiffer,REP,520106,0,1,16,17,38
Noble,State House,Harold Levalley,REP,520106,0,0,3,3,38
Noble,Superintendent of Public Instruction,John Cox,DEM,520201,0,4,23,27,
Noble,Superintendent of Public Instruction,Jack Jr.,DEM,520201,0,8,5,13,
Noble,Superintendent of Public Instruction,Ivan Holmes,DEM,520201,0,3,3,6,
Noble,Superintendent of Public Instruction,Freda Deskin,DEM,520201,0,5,23,28,
Noble,U.S. Senate,Patrick Michael Hayes,DEM,520201,0,8,13,21,
Noble,U.S. Senate,Jim Rogers,DEM,520201,0,6,19,25,
Noble,U.S. Senate,Connie Johnson,DEM,520201,0,6,21,27,
Noble,Governor,Dax Ewbank,REP,520201,0,2,11,13,
Noble,Governor,Chad Moody,REP,520201,0,4,13,17,
Noble,Governor,Mary Fallin,REP,520201,2,27,94,123,
Noble,Superintendent of Public Instruction,Brian Kelly,REP,520201,2,8,38,48,
Noble,Superintendent of Public Instruction,Janet Costello Barresi,REP,520201,0,6,15,21,
Noble,Superintendent of Public Instruction,Joy Hofmeister,REP,520201,0,18,62,80,
Noble,Insurance Commissioner,Bill Viner,REP,520201,0,8,19,27,
Noble,Insurance Commissioner,John Doak,REP,520201,2,23,97,122,
Noble,Corporation Commissioner,Todd Hiett,REP,520201,0,16,58,74,
Noble,Corporation Commissioner,Cliff Branan,REP,520201,2,16,54,72,
Noble,U.S. Senate,Evelyn Rogers,REP,520201,0,3,5,8,
Noble,U.S. Senate,Rob Moye,REP,520201,2,0,1,3,
Noble,U.S. Senate,D. Jean Mcbride-Samuels,REP,520201,0,0,0,0,
Noble,U.S. Senate,Jim Inhofe,REP,520201,0,26,106,132,
Noble,U.S. Senate,Erick Paul Wyatt,REP,520201,0,3,6,9,
Noble,U.S. Senate,Andy Craig,REP,520201,0,0,0,0,
Noble,U.S. Senate,T. Shannon,REP,520201,2,11,50,63,
Noble,U.S. Senate,Randy Brogdon,REP,520201,0,0,1,1,
Noble,U.S. Senate,Eric Mccray,REP,520201,0,0,0,0,
Noble,U.S. Senate,Kevin Crow,REP,520201,0,0,0,0,
Noble,U.S. Senate,James Lankford,REP,520201,0,20,67,87,
Noble,U.S. Senate,Jason Weger,REP,520201,0,2,0,2,
Noble,U.S. House,Timothy Ray Murray,REP,520201,0,2,4,6,03
Noble,U.S. House,Robert Hubbard,REP,520201,2,2,7,11,03
Noble,U.S. House,Frank Lucas,REP,520201,0,29,105,134,03
Noble,State Senate,Dan Ladd,REP,520201,0,4,17,21,20
Noble,State Senate,A Griffin,REP,520201,2,29,97,128,20
Noble,Superintendent of Public Instruction,John Cox,DEM,520202,1,1,14,16,
Noble,Superintendent of Public Instruction,Jack Jr.,DEM,520202,0,0,3,3,
Noble,Superintendent of Public Instruction,Ivan Holmes,DEM,520202,0,0,7,7,
Noble,Superintendent of Public Instruction,Freda Deskin,DEM,520202,0,3,11,14,
Noble,U.S. Senate,Patrick Michael Hayes,DEM,520202,0,2,7,9,
Noble,U.S. Senate,Jim Rogers,DEM,520202,1,0,18,19,
Noble,U.S. Senate,Connie Johnson,DEM,520202,1,2,11,14,
Noble,Governor,Dax Ewbank,REP,520202,0,2,6,8,
Noble,Governor,Chad Moody,REP,520202,0,2,11,13,
Noble,Governor,Mary Fallin,REP,520202,3,12,68,83,
Noble,Superintendent of Public Instruction,Brian Kelly,REP,520202,1,6,19,26,
Noble,Superintendent of Public Instruction,Janet Costello Barresi,REP,520202,0,2,12,14,
Noble,Superintendent of Public Instruction,Joy Hofmeister,REP,520202,2,8,53,63,
Noble,Insurance Commissioner,Bill Viner,REP,520202,0,4,20,24,
Noble,Insurance Commissioner,John Doak,REP,520202,2,12,60,74,
Noble,Corporation Commissioner,Todd Hiett,REP,520202,0,7,41,48,
Noble,Corporation Commissioner,Cliff Branan,REP,520202,2,8,43,53,
Noble,U.S. Senate,Evelyn Rogers,REP,520202,0,0,3,3,
Noble,U.S. Senate,Rob Moye,REP,520202,0,0,0,0,
Noble,U.S. Senate,D. Jean Mcbride-Samuels,REP,520202,0,0,2,2,
Noble,U.S. Senate,Jim Inhofe,REP,520202,3,16,76,95,
Noble,U.S. Senate,Erick Paul Wyatt,REP,520202,0,0,4,4,
Noble,U.S. Senate,Andy Craig,REP,520202,0,0,0,0,
Noble,U.S. Senate,T. Shannon,REP,520202,3,5,44,52,
Noble,U.S. Senate,Randy Brogdon,REP,520202,0,2,1,3,
Noble,U.S. Senate,Eric Mccray,REP,520202,0,0,0,0,
Noble,U.S. Senate,Kevin Crow,REP,520202,0,0,0,0,
Noble,U.S. Senate,James Lankford,REP,520202,0,9,40,49,
Noble,U.S. Senate,Jason Weger,REP,520202,0,0,0,0,
Noble,U.S. House,Timothy Ray Murray,REP,520202,0,0,3,3,03
Noble,U.S. House,Robert Hubbard,REP,520202,0,3,6,9,03
Noble,U.S. House,Frank Lucas,REP,520202,3,13,76,92,03
Noble,State Senate,Dan Ladd,REP,520202,3,2,21,26,20
Noble,State Senate,A Griffin,REP,520202,0,14,62,76,20
Noble,State House,Roy Chaney,REP,520202,1,2,10,13,38
Noble,State House,Niki Schrader,REP,520202,0,1,1,2,38
Noble,State House,Jason Warren,REP,520202,1,1,2,4,38
Noble,State House,Ralph Meade,REP,520202,0,2,10,12,38
Noble,State House,John Pfeiffer,REP,520202,0,8,53,61,38
Noble,State House,Harold Levalley,REP,520202,1,2,7,10,38
Noble,Superintendent of Public Instruction,John Cox,DEM,520203,0,2,10,12,
Noble,Superintendent of Public Instruction,Jack Jr.,DEM,520203,0,0,3,3,
Noble,Superintendent of Public Instruction,Ivan Holmes,DEM,520203,0,0,1,1,
Noble,Superintendent of Public Instruction,Freda Deskin,DEM,520203,1,1,14,16,
Noble,U.S. Senate,Patrick Michael Hayes,DEM,520203,0,1,5,6,
Noble,U.S. Senate,Jim Rogers,DEM,520203,0,1,14,15,
Noble,U.S. Senate,Connie Johnson,DEM,520203,1,1,9,11,
Noble,Governor,Dax Ewbank,REP,520203,0,0,3,3,
Noble,Governor,Chad Moody,REP,520203,0,3,10,13,
Noble,Governor,Mary Fallin,REP,520203,2,13,41,56,
Noble,Superintendent of Public Instruction,Brian Kelly,REP,520203,0,2,18,20,
Noble,Superintendent of Public Instruction,Janet Costello Barresi,REP,520203,2,2,3,7,
Noble,Superintendent of Public Instruction,Joy Hofmeister,REP,520203,0,12,33,45,
Noble,Insurance Commissioner,Bill Viner,REP,520203,0,0,11,11,
Noble,Insurance Commissioner,John Doak,REP,520203,2,16,37,55,
Noble,Corporation Commissioner,Todd Hiett,REP,520203,2,9,29,40,
Noble,Corporation Commissioner,Cliff Branan,REP,520203,0,7,22,29,
Noble,U.S. Senate,Evelyn Rogers,REP,520203,0,0,0,0,
Noble,U.S. Senate,Rob Moye,REP,520203,0,0,1,1,
Noble,U.S. Senate,D. Jean Mcbride-Samuels,REP,520203,0,0,2,2,
Noble,U.S. Senate,Jim Inhofe,REP,520203,1,16,46,63,
Noble,U.S. Senate,Erick Paul Wyatt,REP,520203,0,0,5,5,
Noble,U.S. Senate,Andy Craig,REP,520203,0,0,1,1,
Noble,U.S. Senate,T. Shannon,REP,520203,0,10,26,36,
Noble,U.S. Senate,Randy Brogdon,REP,520203,0,0,0,0,
Noble,U.S. Senate,Eric Mccray,REP,520203,0,0,1,1,
Noble,U.S. Senate,Kevin Crow,REP,520203,0,0,0,0,
Noble,U.S. Senate,James Lankford,REP,520203,2,6,26,34,
Noble,U.S. Senate,Jason Weger,REP,520203,0,0,0,0,
Noble,U.S. House,Timothy Ray Murray,REP,520203,0,1,4,5,03
Noble,U.S. House,Robert Hubbard,REP,520203,1,0,7,8,03
Noble,U.S. House,Frank Lucas,REP,520203,1,15,43,59,03
Noble,State Senate,Dan Ladd,REP,520203,0,1,17,18,20
Noble,State Senate,A Griffin,REP,520203,2,15,37,54,20
Noble,Superintendent of Public Instruction,John Cox,DEM,520301,0,1,23,24,
Noble,Superintendent of Public Instruction,Jack Jr.,DEM,520301,0,1,7,8,
Noble,Superintendent of Public Instruction,Ivan Holmes,DEM,520301,0,0,2,2,
Noble,Superintendent of Public Instruction,Freda Deskin,DEM,520301,0,7,14,21,
Noble,U.S. Senate,Patrick Michael Hayes,DEM,520301,0,3,9,12,
Noble,U.S. Senate,Jim Rogers,DEM,520301,0,4,22,26,
Noble,U.S. Senate,Connie Johnson,DEM,520301,0,3,12,15,
Noble,Governor,Dax Ewbank,REP,520301,0,2,9,11,
Noble,Governor,Chad Moody,REP,520301,0,4,13,17,
Noble,Governor,Mary Fallin,REP,520301,3,22,70,95,
Noble,Superintendent of Public Instruction,Brian Kelly,REP,520301,1,6,18,25,
Noble,Superintendent of Public Instruction,Janet Costello Barresi,REP,520301,0,5,11,16,
Noble,Superintendent of Public Instruction,Joy Hofmeister,REP,520301,2,17,62,81,
Noble,Insurance Commissioner,Bill Viner,REP,520301,0,8,17,25,
Noble,Insurance Commissioner,John Doak,REP,520301,3,20,74,97,
Noble,Corporation Commissioner,Todd Hiett,REP,520301,2,14,44,60,
Noble,Corporation Commissioner,Cliff Branan,REP,520301,1,13,45,59,
Noble,U.S. Senate,Evelyn Rogers,REP,520301,0,2,1,3,
Noble,U.S. Senate,Rob Moye,REP,520301,0,1,3,4,
Noble,U.S. Senate,D. Jean Mcbride-Samuels,REP,520301,0,1,1,2,
Noble,U.S. Senate,Jim Inhofe,REP,520301,3,23,82,108,
Noble,U.S. Senate,Erick Paul Wyatt,REP,520301,0,1,5,6,
Noble,U.S. Senate,Andy Craig,REP,520301,0,0,1,1,
Noble,U.S. Senate,T. Shannon,REP,520301,1,7,32,40,
Noble,U.S. Senate,Randy Brogdon,REP,520301,0,0,2,2,
Noble,U.S. Senate,Eric Mccray,REP,520301,0,0,1,1,
Noble,U.S. Senate,Kevin Crow,REP,520301,0,0,0,0,
Noble,U.S. Senate,James Lankford,REP,520301,2,21,53,76,
Noble,U.S. Senate,Jason Weger,REP,520301,0,0,3,3,
Noble,U.S. House,Timothy Ray Murray,REP,520301,0,3,4,7,03
Noble,U.S. House,Robert Hubbard,REP,520301,0,1,4,5,03
Noble,U.S. House,Frank Lucas,REP,520301,3,24,84,111,03
Noble,State Senate,Dan Ladd,REP,520301,1,6,13,20,20
Noble,State Senate,A Griffin,REP,520301,2,22,79,103,20
Noble,State House,Roy Chaney,REP,520301,0,0,10,10,38
Noble,State House,Niki Schrader,REP,520301,0,2,3,5,38
Noble,State House,Jason Warren,REP,520301,0,1,3,4,38
Noble,State House,Ralph Meade,REP,520301,0,5,0,5,38
Noble,State House,John Pfeiffer,REP,520301,3,19,71,93,38
Noble,State House,Harold Levalley,REP,520301,0,1,4,5,38
Noble,Superintendent of Public Instruction,John Cox,DEM,520305,2,0,28,30,
Noble,Superintendent of Public Instruction,Jack Jr.,DEM,520305,1,1,7,9,
Noble,Superintendent of Public Instruction,Ivan Holmes,DEM,520305,0,1,4,5,
Noble,Superintendent of Public Instruction,Freda Deskin,DEM,520305,0,0,32,32,
Noble,U.S. Senate,Patrick Michael Hayes,DEM,520305,1,0,13,14,
Noble,U.S. Senate,Jim Rogers,DEM,520305,0,2,26,28,
Noble,U.S. Senate,Connie Johnson,DEM,520305,2,0,31,33,
Noble,Governor,Dax Ewbank,REP,520305,1,0,19,20,
Noble,Governor,Chad Moody,REP,520305,1,2,32,35,
Noble,Governor,Mary Fallin,REP,520305,0,3,115,118,
Noble,Superintendent of Public Instruction,Brian Kelly,REP,520305,0,3,27,30,
Noble,Superintendent of Public Instruction,Janet Costello Barresi,REP,520305,0,0,16,16,
Noble,Superintendent of Public Instruction,Joy Hofmeister,REP,520305,2,2,123,127,
Noble,Insurance Commissioner,Bill Viner,REP,520305,1,0,27,28,
Noble,Insurance Commissioner,John Doak,REP,520305,1,5,135,141,
Noble,Corporation Commissioner,Todd Hiett,REP,520305,1,0,87,88,
Noble,Corporation Commissioner,Cliff Branan,REP,520305,1,5,74,80,
Noble,U.S. Senate,Evelyn Rogers,REP,520305,0,0,12,12,
Noble,U.S. Senate,Rob Moye,REP,520305,0,0,3,3,
Noble,U.S. Senate,D. Jean Mcbride-Samuels,REP,520305,0,0,4,4,
Noble,U.S. Senate,Jim Inhofe,REP,520305,2,5,136,143,
Noble,U.S. Senate,Erick Paul Wyatt,REP,520305,0,0,9,9,
Noble,U.S. Senate,Andy Craig,REP,520305,0,0,5,5,
Noble,U.S. Senate,T. Shannon,REP,520305,2,3,87,92,
Noble,U.S. Senate,Randy Brogdon,REP,520305,0,0,1,1,
Noble,U.S. Senate,Eric Mccray,REP,520305,0,0,4,4,
Noble,U.S. Senate,Kevin Crow,REP,520305,0,0,2,2,
Noble,U.S. Senate,James Lankford,REP,520305,0,2,66,68,
Noble,U.S. Senate,Jason Weger,REP,520305,0,0,1,1,
Noble,U.S. House,Timothy Ray Murray,REP,520305,0,0,7,7,03
Noble,U.S. House,Robert Hubbard,REP,520305,0,0,17,17,03
Noble,U.S. House,Frank Lucas,REP,520305,2,5,143,150,03
Noble,State Senate,Dan Ladd,REP,520305,0,1,59,60,20
Noble,State Senate,A Griffin,REP,520305,2,4,103,109,20
Noble,Superintendent of Public Instruction,John Cox,DEM,520307,0,3,20,23,
Noble,Superintendent of Public Instruction,Jack Jr.,DEM,520307,1,2,1,4,
Noble,Superintendent of Public Instruction,Ivan Holmes,DEM,520307,0,0,2,2,
Noble,Superintendent of Public Instruction,Freda Deskin,DEM,520307,0,5,15,20,
Noble,U.S. Senate,Patrick Michael Hayes,DEM,520307,0,2,11,13,
Noble,U.S. Senate,Jim Rogers,DEM,520307,0,6,12,18,
Noble,U.S. Senate,Connie Johnson,DEM,520307,1,2,15,18,
Noble,Governor,Dax Ewbank,REP,520307,0,2,8,10,
Noble,Governor,Chad Moody,REP,520307,0,6,19,25,
Noble,Governor,Mary Fallin,REP,520307,3,40,88,131,
Noble,Superintendent of Public Instruction,Brian Kelly,REP,520307,0,12,26,38,
Noble,Superintendent of Public Instruction,Janet Costello Barresi,REP,520307,1,8,15,24,
Noble,Superintendent of Public Instruction,Joy Hofmeister,REP,520307,2,25,74,101,
Noble,Insurance Commissioner,Bill Viner,REP,520307,0,7,29,36,
Noble,Insurance Commissioner,John Doak,REP,520307,3,39,80,122,
Noble,Corporation Commissioner,Todd Hiett,REP,520307,3,22,51,76,
Noble,Corporation Commissioner,Cliff Branan,REP,520307,0,24,62,86,
Noble,U.S. Senate,Evelyn Rogers,REP,520307,0,3,6,9,
Noble,U.S. Senate,Rob Moye,REP,520307,0,0,2,2,
Noble,U.S. Senate,D. Jean Mcbride-Samuels,REP,520307,0,0,0,0,
Noble,U.S. Senate,Jim Inhofe,REP,520307,3,42,103,148,
Noble,U.S. Senate,Erick Paul Wyatt,REP,520307,0,2,4,6,
Noble,U.S. Senate,Andy Craig,REP,520307,0,2,1,3,
Noble,U.S. Senate,T. Shannon,REP,520307,0,20,53,73,
Noble,U.S. Senate,Randy Brogdon,REP,520307,0,0,5,5,
Noble,U.S. Senate,Eric Mccray,REP,520307,0,0,1,1,
Noble,U.S. Senate,Kevin Crow,REP,520307,0,0,3,3,
Noble,U.S. Senate,James Lankford,REP,520307,3,25,52,80,
Noble,U.S. Senate,Jason Weger,REP,520307,0,0,0,0,
Noble,U.S. House,Timothy Ray Murray,REP,520307,0,3,6,9,03
Noble,U.S. House,Robert Hubbard,REP,520307,0,3,19,22,03
Noble,U.S. House,Frank Lucas,REP,520307,3,42,90,135,03
Noble,State Senate,Dan Ladd,REP,520307,0,10,40,50,20
Noble,State Senate,A Griffin,REP,520307,3,38,74,115,20
Nowata,Superintendent of Public Instruction,John Cox,DEM,530101,0,6,49,55,
Nowata,Superintendent of Public Instruction,Jack Jr.,DEM,530101,1,0,8,9,
Nowata,Superintendent of Public Instruction,Ivan Holmes,DEM,530101,0,1,4,5,
Nowata,Superintendent of Public Instruction,Freda Deskin,DEM,530101,1,0,25,26,
Nowata,U.S. Senate,Patrick Michael Hayes,DEM,530101,0,2,27,29,
Nowata,U.S. Senate,Jim Rogers,DEM,530101,0,1,28,29,
Nowata,U.S. Senate,Connie Johnson,DEM,530101,2,2,32,36,
Nowata,U.S. House,Earl Everett,DEM,530101,1,1,55,57,02
Nowata,U.S. House,Joshua Harris-Till,DEM,530101,1,4,31,36,02
Nowata,Governor,Dax Ewbank,REP,530101,0,0,10,10,
Nowata,Governor,Chad Moody,REP,530101,0,2,7,9,
Nowata,Governor,Mary Fallin,REP,530101,4,3,70,77,
Nowata,Superintendent of Public Instruction,Brian Kelly,REP,530101,2,4,17,23,
Nowata,Superintendent of Public Instruction,Janet Costello Barresi,REP,530101,1,0,22,23,
Nowata,Superintendent of Public Instruction,Joy Hofmeister,REP,530101,1,3,49,53,
Nowata,Insurance Commissioner,Bill Viner,REP,530101,0,2,15,17,
Nowata,Insurance Commissioner,John Doak,REP,530101,3,4,66,73,
Nowata,Corporation Commissioner,Todd Hiett,REP,530101,3,2,45,50,
Nowata,Corporation Commissioner,Cliff Branan,REP,530101,1,4,37,42,
Nowata,U.S. Senate,Evelyn Rogers,REP,530101,0,0,4,4,
Nowata,U.S. Senate,Rob Moye,REP,530101,0,0,1,1,
Nowata,U.S. Senate,D. Jean Mcbride-Samuels,REP,530101,0,1,0,1,
Nowata,U.S. Senate,Jim Inhofe,REP,530101,4,6,72,82,
Nowata,U.S. Senate,Erick Paul Wyatt,REP,530101,0,0,11,11,
Nowata,U.S. Senate,Andy Craig,REP,530101,0,0,0,0,
Nowata,U.S. Senate,T. Shannon,REP,530101,3,5,37,45,
Nowata,U.S. Senate,Randy Brogdon,REP,530101,0,1,6,7,
Nowata,U.S. Senate,Eric Mccray,REP,530101,0,0,1,1,
Nowata,U.S. Senate,Kevin Crow,REP,530101,0,0,1,1,
Nowata,U.S. Senate,James Lankford,REP,530101,1,1,41,43,
Nowata,U.S. Senate,Jason Weger,REP,530101,0,0,0,0,
Nowata,U.S. House,Darrel Robertson,REP,530101,1,1,7,9,02
Nowata,U.S. House,Markwayne Mullin,REP,530101,3,6,83,92,02
Nowata,State House,Randy Barnett,REP,530101,0,3,42,45,10
Nowata,State House,Travis Dunlap,REP,530101,3,3,46,52,10
Nowata,Superintendent of Public Instruction,John Cox,DEM,530102,2,3,86,91,
Nowata,Superintendent of Public Instruction,Jack Jr.,DEM,530102,0,0,8,8,
Nowata,Superintendent of Public Instruction,Ivan Holmes,DEM,530102,1,0,5,6,
Nowata,Superintendent of Public Instruction,Freda Deskin,DEM,530102,0,1,34,35,
Nowata,U.S. Senate,Patrick Michael Hayes,DEM,530102,1,1,33,35,
Nowata,U.S. Senate,Jim Rogers,DEM,530102,0,2,51,53,
Nowata,U.S. Senate,Connie Johnson,DEM,530102,2,1,45,48,
Nowata,U.S. House,Earl Everett,DEM,530102,1,1,79,81,02
Nowata,U.S. House,Joshua Harris-Till,DEM,530102,2,3,46,51,02
Nowata,Governor,Dax Ewbank,REP,530102,0,0,14,14,
Nowata,Governor,Chad Moody,REP,530102,1,3,16,20,
Nowata,Governor,Mary Fallin,REP,530102,3,10,76,89,
Nowata,Superintendent of Public Instruction,Brian Kelly,REP,530102,1,5,27,33,
Nowata,Superintendent of Public Instruction,Janet Costello Barresi,REP,530102,1,3,11,15,
Nowata,Superintendent of Public Instruction,Joy Hofmeister,REP,530102,2,5,67,74,
Nowata,Insurance Commissioner,Bill Viner,REP,530102,1,2,22,25,
Nowata,Insurance Commissioner,John Doak,REP,530102,3,10,78,91,
Nowata,Corporation Commissioner,Todd Hiett,REP,530102,1,8,44,53,
Nowata,Corporation Commissioner,Cliff Branan,REP,530102,3,4,58,65,
Nowata,U.S. Senate,Evelyn Rogers,REP,530102,0,0,7,7,
Nowata,U.S. Senate,Rob Moye,REP,530102,0,1,0,1,
Nowata,U.S. Senate,D. Jean Mcbride-Samuels,REP,530102,0,0,0,0,
Nowata,U.S. Senate,Jim Inhofe,REP,530102,3,12,88,103,
Nowata,U.S. Senate,Erick Paul Wyatt,REP,530102,1,0,9,10,
Nowata,U.S. Senate,Andy Craig,REP,530102,0,0,0,0,
Nowata,U.S. Senate,T. Shannon,REP,530102,3,4,39,46,
Nowata,U.S. Senate,Randy Brogdon,REP,530102,0,1,10,11,
Nowata,U.S. Senate,Eric Mccray,REP,530102,0,0,0,0,
Nowata,U.S. Senate,Kevin Crow,REP,530102,1,0,0,1,
Nowata,U.S. Senate,James Lankford,REP,530102,0,8,56,64,
Nowata,U.S. Senate,Jason Weger,REP,530102,0,0,1,1,
Nowata,U.S. House,Darrel Robertson,REP,530102,1,0,14,15,02
Nowata,U.S. House,Markwayne Mullin,REP,530102,3,13,91,107,02
Nowata,State House,Randy Barnett,REP,530102,2,5,46,53,10
Nowata,State House,Travis Dunlap,REP,530102,2,8,57,67,10
Nowata,Superintendent of Public Instruction,John Cox,DEM,530103,0,6,35,41,
Nowata,Superintendent of Public Instruction,Jack Jr.,DEM,530103,0,0,10,10,
Nowata,Superintendent of Public Instruction,Ivan Holmes,DEM,530103,0,0,8,8,
Nowata,Superintendent of Public Instruction,Freda Deskin,DEM,530103,0,3,30,33,
Nowata,U.S. Senate,Patrick Michael Hayes,DEM,530103,0,2,20,22,
Nowata,U.S. Senate,Jim Rogers,DEM,530103,0,3,33,36,
Nowata,U.S. Senate,Connie Johnson,DEM,530103,0,2,29,31,
Nowata,U.S. House,Earl Everett,DEM,530103,0,4,45,49,02
Nowata,U.S. House,Joshua Harris-Till,DEM,530103,0,3,37,40,02
Nowata,Governor,Dax Ewbank,REP,530103,0,0,8,8,
Nowata,Governor,Chad Moody,REP,530103,0,0,6,6,
Nowata,Governor,Mary Fallin,REP,530103,0,0,39,39,
Nowata,Superintendent of Public Instruction,Brian Kelly,REP,530103,0,0,14,14,
Nowata,Superintendent of Public Instruction,Janet Costello Barresi,REP,530103,0,0,5,5,
Nowata,Superintendent of Public Instruction,Joy Hofmeister,REP,530103,0,0,34,34,
Nowata,Insurance Commissioner,Bill Viner,REP,530103,0,0,3,3,
Nowata,Insurance Commissioner,John Doak,REP,530103,0,0,48,48,
Nowata,Corporation Commissioner,Todd Hiett,REP,530103,0,0,20,20,
Nowata,Corporation Commissioner,Cliff Branan,REP,530103,0,0,33,33,
Nowata,U.S. Senate,Evelyn Rogers,REP,530103,0,0,1,1,
Nowata,U.S. Senate,Rob Moye,REP,530103,0,0,2,2,
Nowata,U.S. Senate,D. Jean Mcbride-Samuels,REP,530103,0,0,0,0,
Nowata,U.S. Senate,Jim Inhofe,REP,530103,0,0,44,44,
Nowata,U.S. Senate,Erick Paul Wyatt,REP,530103,0,0,6,6,
Nowata,U.S. Senate,Andy Craig,REP,530103,0,0,1,1,
Nowata,U.S. Senate,T. Shannon,REP,530103,0,0,29,29,
Nowata,U.S. Senate,Randy Brogdon,REP,530103,0,0,1,1,
Nowata,U.S. Senate,Eric Mccray,REP,530103,0,0,0,0,
Nowata,U.S. Senate,Kevin Crow,REP,530103,0,0,1,1,
Nowata,U.S. Senate,James Lankford,REP,530103,0,0,21,21,
Nowata,U.S. Senate,Jason Weger,REP,530103,0,0,0,0,
Nowata,U.S. House,Darrel Robertson,REP,530103,0,0,10,10,02
Nowata,U.S. House,Markwayne Mullin,REP,530103,0,0,43,43,02
Nowata,State House,Randy Barnett,REP,530103,0,0,19,19,10
Nowata,State House,Travis Dunlap,REP,530103,0,0,34,34,10
Nowata,Superintendent of Public Instruction,John Cox,DEM,530201,0,0,20,20,
Nowata,Superintendent of Public Instruction,Jack Jr.,DEM,530201,0,0,5,5,
Nowata,Superintendent of Public Instruction,Ivan Holmes,DEM,530201,0,0,1,1,
Nowata,Superintendent of Public Instruction,Freda Deskin,DEM,530201,0,0,11,11,
Nowata,U.S. Senate,Patrick Michael Hayes,DEM,530201,0,0,14,14,
Nowata,U.S. Senate,Jim Rogers,DEM,530201,0,0,14,14,
Nowata,U.S. Senate,Connie Johnson,DEM,530201,0,0,9,9,
Nowata,U.S. House,Earl Everett,DEM,530201,0,0,22,22,02
Nowata,U.S. House,Joshua Harris-Till,DEM,530201,0,0,14,14,02
Nowata,Governor,Dax Ewbank,REP,530201,2,0,2,4,
Nowata,Governor,Chad Moody,REP,530201,0,0,1,1,
Nowata,Governor,Mary Fallin,REP,530201,2,0,46,48,
Nowata,Superintendent of Public Instruction,Brian Kelly,REP,530201,0,0,18,18,
Nowata,Superintendent of Public Instruction,Janet Costello Barresi,REP,530201,4,0,9,13,
Nowata,Superintendent of Public Instruction,Joy Hofmeister,REP,530201,0,0,21,21,
Nowata,Insurance Commissioner,Bill Viner,REP,530201,0,0,12,12,
Nowata,Insurance Commissioner,John Doak,REP,530201,4,0,34,38,
Nowata,Corporation Commissioner,Todd Hiett,REP,530201,2,0,28,30,
Nowata,Corporation Commissioner,Cliff Branan,REP,530201,0,0,20,20,
Nowata,U.S. Senate,Evelyn Rogers,REP,530201,0,0,0,0,
Nowata,U.S. Senate,Rob Moye,REP,530201,0,0,2,2,
Nowata,U.S. Senate,D. Jean Mcbride-Samuels,REP,530201,0,0,0,0,
Nowata,U.S. Senate,Jim Inhofe,REP,530201,4,0,41,45,
Nowata,U.S. Senate,Erick Paul Wyatt,REP,530201,0,0,7,7,
Nowata,U.S. Senate,Andy Craig,REP,530201,0,0,2,2,
Nowata,U.S. Senate,T. Shannon,REP,530201,3,0,26,29,
Nowata,U.S. Senate,Randy Brogdon,REP,530201,0,0,0,0,
Nowata,U.S. Senate,Eric Mccray,REP,530201,0,0,0,0,
Nowata,U.S. Senate,Kevin Crow,REP,530201,0,0,0,0,
Nowata,U.S. Senate,James Lankford,REP,530201,1,0,20,21,
Nowata,U.S. Senate,Jason Weger,REP,530201,0,0,2,2,
Nowata,U.S. House,Darrel Robertson,REP,530201,0,0,6,6,02
Nowata,U.S. House,Markwayne Mullin,REP,530201,4,0,43,47,02
Nowata,State House,Randy Barnett,REP,530201,2,0,22,24,10
Nowata,State House,Travis Dunlap,REP,530201,0,0,27,27,10
Nowata,Superintendent of Public Instruction,John Cox,DEM,530202,0,2,34,36,
Nowata,Superintendent of Public Instruction,Jack Jr.,DEM,530202,0,0,0,0,
Nowata,Superintendent of Public Instruction,Ivan Holmes,DEM,530202,0,0,0,0,
Nowata,Superintendent of Public Instruction,Freda Deskin,DEM,530202,0,0,8,8,
Nowata,U.S. Senate,Patrick Michael Hayes,DEM,530202,0,0,9,9,
Nowata,U.S. Senate,Jim Rogers,DEM,530202,0,2,22,24,
Nowata,U.S. Senate,Connie Johnson,DEM,530202,0,0,9,9,
Nowata,U.S. House,Earl Everett,DEM,530202,0,1,27,28,02
Nowata,U.S. House,Joshua Harris-Till,DEM,530202,0,1,11,12,02
Nowata,Governor,Dax Ewbank,REP,530202,1,0,4,5,
Nowata,Governor,Chad Moody,REP,530202,0,1,6,7,
Nowata,Governor,Mary Fallin,REP,530202,1,8,35,44,
Nowata,Superintendent of Public Instruction,Brian Kelly,REP,530202,2,4,13,19,
Nowata,Superintendent of Public Instruction,Janet Costello Barresi,REP,530202,0,1,7,8,
Nowata,Superintendent of Public Instruction,Joy Hofmeister,REP,530202,0,4,24,28,
Nowata,Insurance Commissioner,Bill Viner,REP,530202,2,5,11,18,
Nowata,Insurance Commissioner,John Doak,REP,530202,0,4,31,35,
Nowata,Corporation Commissioner,Todd Hiett,REP,530202,0,3,19,22,
Nowata,Corporation Commissioner,Cliff Branan,REP,530202,2,6,25,33,
Nowata,U.S. Senate,Evelyn Rogers,REP,530202,1,0,1,2,
Nowata,U.S. Senate,Rob Moye,REP,530202,0,0,0,0,
Nowata,U.S. Senate,D. Jean Mcbride-Samuels,REP,530202,0,0,1,1,
Nowata,U.S. Senate,Jim Inhofe,REP,530202,1,7,39,47,
Nowata,U.S. Senate,Erick Paul Wyatt,REP,530202,0,2,4,6,
Nowata,U.S. Senate,Andy Craig,REP,530202,2,0,0,2,
Nowata,U.S. Senate,T. Shannon,REP,530202,0,6,24,30,
Nowata,U.S. Senate,Randy Brogdon,REP,530202,0,0,1,1,
Nowata,U.S. Senate,Eric Mccray,REP,530202,0,0,0,0,
Nowata,U.S. Senate,Kevin Crow,REP,530202,0,0,0,0,
Nowata,U.S. Senate,James Lankford,REP,530202,0,3,19,22,
Nowata,U.S. Senate,Jason Weger,REP,530202,0,0,2,2,
Nowata,U.S. House,Darrel Robertson,REP,530202,2,1,3,6,02
Nowata,U.S. House,Markwayne Mullin,REP,530202,0,8,42,50,02
Nowata,State House,Randy Barnett,REP,530202,2,2,10,14,10
Nowata,State House,Travis Dunlap,REP,530202,0,7,35,42,10
Nowata,Superintendent of Public Instruction,John Cox,DEM,530203,1,6,43,50,
Nowata,Superintendent of Public Instruction,Jack Jr.,DEM,530203,0,1,3,4,
Nowata,Superintendent of Public Instruction,Ivan Holmes,DEM,530203,0,0,8,8,
Nowata,Superintendent of Public Instruction,Freda Deskin,DEM,530203,2,3,24,29,
Nowata,U.S. Senate,Patrick Michael Hayes,DEM,530203,2,3,22,27,
Nowata,U.S. Senate,Jim Rogers,DEM,530203,1,4,22,27,
Nowata,U.S. Senate,Connie Johnson,DEM,530203,0,3,32,35,
Nowata,U.S. House,Earl Everett,DEM,530203,2,4,46,52,02
Nowata,U.S. House,Joshua Harris-Till,DEM,530203,0,6,29,35,02
Nowata,Governor,Dax Ewbank,REP,530203,0,2,9,11,
Nowata,Governor,Chad Moody,REP,530203,0,0,18,18,
Nowata,Governor,Mary Fallin,REP,530203,4,7,95,106,
Nowata,Superintendent of Public Instruction,Brian Kelly,REP,530203,3,2,24,29,
Nowata,Superintendent of Public Instruction,Janet Costello Barresi,REP,530203,0,4,12,16,
Nowata,Superintendent of Public Instruction,Joy Hofmeister,REP,530203,1,3,86,90,
Nowata,Insurance Commissioner,Bill Viner,REP,530203,0,2,23,25,
Nowata,Insurance Commissioner,John Doak,REP,530203,4,5,89,98,
Nowata,Corporation Commissioner,Todd Hiett,REP,530203,3,5,64,72,
Nowata,Corporation Commissioner,Cliff Branan,REP,530203,1,4,49,54,
Nowata,U.S. Senate,Evelyn Rogers,REP,530203,0,0,4,4,
Nowata,U.S. Senate,Rob Moye,REP,530203,0,0,0,0,
Nowata,U.S. Senate,D. Jean Mcbride-Samuels,REP,530203,0,0,4,4,
Nowata,U.S. Senate,Jim Inhofe,REP,530203,3,7,103,113,
Nowata,U.S. Senate,Erick Paul Wyatt,REP,530203,1,2,12,15,
Nowata,U.S. Senate,Andy Craig,REP,530203,0,0,1,1,
Nowata,U.S. Senate,T. Shannon,REP,530203,2,3,61,66,
Nowata,U.S. Senate,Randy Brogdon,REP,530203,0,0,5,5,
Nowata,U.S. Senate,Eric Mccray,REP,530203,0,0,0,0,
Nowata,U.S. Senate,Kevin Crow,REP,530203,0,0,1,1,
Nowata,U.S. Senate,James Lankford,REP,530203,2,6,53,61,
Nowata,U.S. Senate,Jason Weger,REP,530203,0,0,2,2,
Nowata,U.S. House,Darrel Robertson,REP,530203,1,1,23,25,02
Nowata,U.S. House,Markwayne Mullin,REP,530203,3,8,101,112,02
Nowata,State House,Randy Barnett,REP,530203,2,3,31,36,10
Nowata,State House,Travis Dunlap,REP,530203,2,6,89,97,10
Nowata,Superintendent of Public Instruction,John Cox,DEM,530204,0,0,21,21,
Nowata,Superintendent of Public Instruction,Jack Jr.,DEM,530204,2,0,5,7,
Nowata,Superintendent of Public Instruction,Ivan Holmes,DEM,530204,0,0,0,0,
Nowata,Superintendent of Public Instruction,Freda Deskin,DEM,530204,0,0,7,7,
Nowata,U.S. Senate,Patrick Michael Hayes,DEM,530204,2,0,5,7,
Nowata,U.S. Senate,Jim Rogers,DEM,530204,0,0,16,16,
Nowata,U.S. Senate,Connie Johnson,DEM,530204,0,0,12,12,
Nowata,U.S. House,Earl Everett,DEM,530204,2,0,20,22,02
Nowata,U.S. House,Joshua Harris-Till,DEM,530204,0,0,12,12,02
Nowata,Governor,Dax Ewbank,REP,530204,0,1,3,4,
Nowata,Governor,Chad Moody,REP,530204,0,0,8,8,
Nowata,Governor,Mary Fallin,REP,530204,0,0,37,37,
Nowata,Superintendent of Public Instruction,Brian Kelly,REP,530204,0,0,10,10,
Nowata,Superintendent of Public Instruction,Janet Costello Barresi,REP,530204,0,0,6,6,
Nowata,Superintendent of Public Instruction,Joy Hofmeister,REP,530204,0,1,30,31,
Nowata,Insurance Commissioner,Bill Viner,REP,530204,0,0,8,8,
Nowata,Insurance Commissioner,John Doak,REP,530204,0,1,34,35,
Nowata,Corporation Commissioner,Todd Hiett,REP,530204,0,0,20,20,
Nowata,Corporation Commissioner,Cliff Branan,REP,530204,0,1,24,25,
Nowata,U.S. Senate,Evelyn Rogers,REP,530204,0,0,6,6,
Nowata,U.S. Senate,Rob Moye,REP,530204,0,0,0,0,
Nowata,U.S. Senate,D. Jean Mcbride-Samuels,REP,530204,0,0,1,1,
Nowata,U.S. Senate,Jim Inhofe,REP,530204,0,0,39,39,
Nowata,U.S. Senate,Erick Paul Wyatt,REP,530204,0,1,1,2,
Nowata,U.S. Senate,Andy Craig,REP,530204,0,0,0,0,
Nowata,U.S. Senate,T. Shannon,REP,530204,0,1,28,29,
Nowata,U.S. Senate,Randy Brogdon,REP,530204,0,0,0,0,
Nowata,U.S. Senate,Eric Mccray,REP,530204,0,0,1,1,
Nowata,U.S. Senate,Kevin Crow,REP,530204,0,0,0,0,
Nowata,U.S. Senate,James Lankford,REP,530204,0,0,19,19,
Nowata,U.S. Senate,Jason Weger,REP,530204,0,0,0,0,
Nowata,U.S. House,Darrel Robertson,REP,530204,0,1,5,6,02
Nowata,U.S. House,Markwayne Mullin,REP,530204,0,0,43,43,02
Nowata,State House,Randy Barnett,REP,530204,0,1,19,20,10
Nowata,State House,Travis Dunlap,REP,530204,0,0,23,23,10
Nowata,Superintendent of Public Instruction,John Cox,DEM,530301,4,2,58,64,
Nowata,Superintendent of Public Instruction,Jack Jr.,DEM,530301,0,0,10,10,
Nowata,Superintendent of Public Instruction,Ivan Holmes,DEM,530301,0,0,3,3,
Nowata,Superintendent of Public Instruction,Freda Deskin,DEM,530301,0,1,42,43,
Nowata,U.S. Senate,Patrick Michael Hayes,DEM,530301,0,1,26,27,
Nowata,U.S. Senate,Jim Rogers,DEM,530301,4,0,56,60,
Nowata,U.S. Senate,Connie Johnson,DEM,530301,0,2,26,28,
Nowata,U.S. House,Earl Everett,DEM,530301,4,0,61,65,02
Nowata,U.S. House,Joshua Harris-Till,DEM,530301,0,3,39,42,02
Nowata,Governor,Dax Ewbank,REP,530301,2,0,9,11,
Nowata,Governor,Chad Moody,REP,530301,0,0,13,13,
Nowata,Governor,Mary Fallin,REP,530301,0,1,60,61,
Nowata,Superintendent of Public Instruction,Brian Kelly,REP,530301,1,0,20,21,
Nowata,Superintendent of Public Instruction,Janet Costello Barresi,REP,530301,0,0,14,14,
Nowata,Superintendent of Public Instruction,Joy Hofmeister,REP,530301,1,1,47,49,
Nowata,Insurance Commissioner,Bill Viner,REP,530301,0,1,14,15,
Nowata,Insurance Commissioner,John Doak,REP,530301,2,0,62,64,
Nowata,Corporation Commissioner,Todd Hiett,REP,530301,2,1,39,42,
Nowata,Corporation Commissioner,Cliff Branan,REP,530301,0,0,39,39,
Nowata,U.S. Senate,Evelyn Rogers,REP,530301,0,0,2,2,
Nowata,U.S. Senate,Rob Moye,REP,530301,1,0,0,1,
Nowata,U.S. Senate,D. Jean Mcbride-Samuels,REP,530301,0,0,1,1,
Nowata,U.S. Senate,Jim Inhofe,REP,530301,1,1,73,75,
Nowata,U.S. Senate,Erick Paul Wyatt,REP,530301,0,0,6,6,
Nowata,U.S. Senate,Andy Craig,REP,530301,0,0,1,1,
Nowata,U.S. Senate,T. Shannon,REP,530301,0,1,39,40,
Nowata,U.S. Senate,Randy Brogdon,REP,530301,2,0,5,7,
Nowata,U.S. Senate,Eric Mccray,REP,530301,0,0,1,1,
Nowata,U.S. Senate,Kevin Crow,REP,530301,0,0,1,1,
Nowata,U.S. Senate,James Lankford,REP,530301,0,0,35,35,
Nowata,U.S. Senate,Jason Weger,REP,530301,0,0,2,2,
Nowata,U.S. House,Darrel Robertson,REP,530301,1,0,14,15,02
Nowata,U.S. House,Markwayne Mullin,REP,530301,1,1,70,72,02
Nowata,State House,Randy Barnett,REP,530301,1,0,31,32,10
Nowata,State House,Travis Dunlap,REP,530301,1,1,47,49,10
Nowata,Superintendent of Public Instruction,John Cox,DEM,530302,0,3,45,48,
Nowata,Superintendent of Public Instruction,Jack Jr.,DEM,530302,1,1,3,5,
Nowata,Superintendent of Public Instruction,Ivan Holmes,DEM,530302,0,0,5,5,
Nowata,Superintendent of Public Instruction,Freda Deskin,DEM,530302,0,0,16,16,
Nowata,U.S. Senate,Patrick Michael Hayes,DEM,530302,0,2,22,24,
Nowata,U.S. Senate,Jim Rogers,DEM,530302,2,2,25,29,
Nowata,U.S. Senate,Connie Johnson,DEM,530302,0,1,20,21,
Nowata,U.S. House,Earl Everett,DEM,530302,1,2,40,43,02
Nowata,U.S. House,Joshua Harris-Till,DEM,530302,1,1,24,26,02
Nowata,Governor,Dax Ewbank,REP,530302,1,1,3,5,
Nowata,Governor,Chad Moody,REP,530302,0,0,7,7,
Nowata,Governor,Mary Fallin,REP,530302,0,6,31,37,
Nowata,Superintendent of Public Instruction,Brian Kelly,REP,530302,1,0,9,10,
Nowata,Superintendent of Public Instruction,Janet Costello Barresi,REP,530302,0,2,3,5,
Nowata,Superintendent of Public Instruction,Joy Hofmeister,REP,530302,0,6,30,36,
Nowata,Insurance Commissioner,Bill Viner,REP,530302,0,4,9,13,
Nowata,Insurance Commissioner,John Doak,REP,530302,1,4,31,36,
Nowata,Corporation Commissioner,Todd Hiett,REP,530302,1,2,19,22,
Nowata,Corporation Commissioner,Cliff Branan,REP,530302,0,6,21,27,
Nowata,U.S. Senate,Evelyn Rogers,REP,530302,0,0,2,2,
Nowata,U.S. Senate,Rob Moye,REP,530302,0,0,1,1,
Nowata,U.S. Senate,D. Jean Mcbride-Samuels,REP,530302,0,0,1,1,
Nowata,U.S. Senate,Jim Inhofe,REP,530302,1,8,33,42,
Nowata,U.S. Senate,Erick Paul Wyatt,REP,530302,0,0,5,5,
Nowata,U.S. Senate,Andy Craig,REP,530302,0,0,2,2,
Nowata,U.S. Senate,T. Shannon,REP,530302,1,6,19,26,
Nowata,U.S. Senate,Randy Brogdon,REP,530302,0,0,3,3,
Nowata,U.S. Senate,Eric Mccray,REP,530302,0,0,1,1,
Nowata,U.S. Senate,Kevin Crow,REP,530302,0,0,2,2,
Nowata,U.S. Senate,James Lankford,REP,530302,0,2,14,16,
Nowata,U.S. Senate,Jason Weger,REP,530302,0,0,1,1,
Nowata,U.S. House,Darrel Robertson,REP,530302,1,0,10,11,02
Nowata,U.S. House,Markwayne Mullin,REP,530302,0,8,32,40,02
Nowata,State House,Randy Barnett,REP,530302,0,4,15,19,10
Nowata,State House,Travis Dunlap,REP,530302,1,4,25,30,10
Nowata,Superintendent of Public Instruction,John Cox,DEM,530303,0,5,40,45,
Nowata,Superintendent of Public Instruction,Jack Jr.,DEM,530303,0,1,3,4,
Nowata,Superintendent of Public Instruction,Ivan Holmes,DEM,530303,0,0,2,2,
Nowata,Superintendent of Public Instruction,Freda Deskin,DEM,530303,1,0,15,16,
Nowata,U.S. Senate,Patrick Michael Hayes,DEM,530303,1,1,18,20,
Nowata,U.S. Senate,Jim Rogers,DEM,530303,0,1,28,29,
Nowata,U.S. Senate,Connie Johnson,DEM,530303,0,4,13,17,
Nowata,U.S. House,Earl Everett,DEM,530303,0,1,33,34,02
Nowata,U.S. House,Joshua Harris-Till,DEM,530303,1,4,27,32,02
Nowata,Governor,Dax Ewbank,REP,530303,0,0,3,3,
Nowata,Governor,Chad Moody,REP,530303,0,1,8,9,
Nowata,Governor,Mary Fallin,REP,530303,0,1,33,34,
Nowata,Superintendent of Public Instruction,Brian Kelly,REP,530303,0,2,15,17,
Nowata,Superintendent of Public Instruction,Janet Costello Barresi,REP,530303,0,0,4,4,
Nowata,Superintendent of Public Instruction,Joy Hofmeister,REP,530303,0,0,23,23,
Nowata,Insurance Commissioner,Bill Viner,REP,530303,0,0,13,13,
Nowata,Insurance Commissioner,John Doak,REP,530303,0,2,27,29,
Nowata,Corporation Commissioner,Todd Hiett,REP,530303,0,1,22,23,
Nowata,Corporation Commissioner,Cliff Branan,REP,530303,0,1,17,18,
Nowata,U.S. Senate,Evelyn Rogers,REP,530303,0,1,0,1,
Nowata,U.S. Senate,Rob Moye,REP,530303,0,0,2,2,
Nowata,U.S. Senate,D. Jean Mcbride-Samuels,REP,530303,0,0,0,0,
Nowata,U.S. Senate,Jim Inhofe,REP,530303,0,1,38,39,
Nowata,U.S. Senate,Erick Paul Wyatt,REP,530303,0,0,4,4,
Nowata,U.S. Senate,Andy Craig,REP,530303,0,0,1,1,
Nowata,U.S. Senate,T. Shannon,REP,530303,0,2,26,28,
Nowata,U.S. Senate,Randy Brogdon,REP,530303,0,0,3,3,
Nowata,U.S. Senate,Eric Mccray,REP,530303,0,0,0,0,
Nowata,U.S. Senate,Kevin Crow,REP,530303,0,0,1,1,
Nowata,U.S. Senate,James Lankford,REP,530303,0,0,12,12,
Nowata,U.S. Senate,Jason Weger,REP,530303,0,0,0,0,
Nowata,U.S. House,Darrel Robertson,REP,530303,0,0,4,4,02
Nowata,U.S. House,Markwayne Mullin,REP,530303,0,2,38,40,02
Nowata,State House,Randy Barnett,REP,530303,0,1,23,24,10
Nowata,State House,Travis Dunlap,REP,530303,0,1,17,18,10
Nowata,Superintendent of Public Instruction,John Cox,DEM,530304,3,1,26,30,
Nowata,Superintendent of Public Instruction,Jack Jr.,DEM,530304,0,0,2,2,
Nowata,Superintendent of Public Instruction,Ivan Holmes,DEM,530304,0,0,2,2,
Nowata,Superintendent of Public Instruction,Freda Deskin,DEM,530304,0,1,3,4,
Nowata,U.S. Senate,Patrick Michael Hayes,DEM,530304,0,0,9,9,
Nowata,U.S. Senate,Jim Rogers,DEM,530304,0,1,13,14,
Nowata,U.S. Senate,Connie Johnson,DEM,530304,3,1,7,11,
Nowata,U.S. House,Earl Everett,DEM,530304,1,1,13,15,02
Nowata,U.S. House,Joshua Harris-Till,DEM,530304,2,0,13,15,02
Nowata,Governor,Dax Ewbank,REP,530304,0,0,1,1,
Nowata,Governor,Chad Moody,REP,530304,0,0,1,1,
Nowata,Governor,Mary Fallin,REP,530304,0,0,17,17,
Nowata,Superintendent of Public Instruction,Brian Kelly,REP,530304,0,0,1,1,
Nowata,Superintendent of Public Instruction,Janet Costello Barresi,REP,530304,0,0,1,1,
Nowata,Superintendent of Public Instruction,Joy Hofmeister,REP,530304,0,0,17,17,
Nowata,Insurance Commissioner,Bill Viner,REP,530304,0,0,5,5,
Nowata,Insurance Commissioner,John Doak,REP,530304,0,0,14,14,
Nowata,Corporation Commissioner,Todd Hiett,REP,530304,0,0,13,13,
Nowata,Corporation Commissioner,Cliff Branan,REP,530304,0,0,6,6,
Nowata,U.S. Senate,Evelyn Rogers,REP,530304,0,0,0,0,
Nowata,U.S. Senate,Rob Moye,REP,530304,0,0,0,0,
Nowata,U.S. Senate,D. Jean Mcbride-Samuels,REP,530304,0,0,0,0,
Nowata,U.S. Senate,Jim Inhofe,REP,530304,0,0,17,17,
Nowata,U.S. Senate,Erick Paul Wyatt,REP,530304,0,0,2,2,
Nowata,U.S. Senate,Andy Craig,REP,530304,0,0,0,0,
Nowata,U.S. Senate,T. Shannon,REP,530304,0,0,15,15,
Nowata,U.S. Senate,Randy Brogdon,REP,530304,0,0,0,0,
Nowata,U.S. Senate,Eric Mccray,REP,530304,0,0,0,0,
Nowata,U.S. Senate,Kevin Crow,REP,530304,0,0,0,0,
Nowata,U.S. Senate,James Lankford,REP,530304,0,0,4,4,
Nowata,U.S. Senate,Jason Weger,REP,530304,0,0,0,0,
Nowata,U.S. House,Darrel Robertson,REP,530304,0,0,0,0,02
Nowata,U.S. House,Markwayne Mullin,REP,530304,0,0,19,19,02
Nowata,State House,Randy Barnett,REP,530304,0,0,7,7,10
Nowata,State House,Travis Dunlap,REP,530304,0,0,12,12,10
Okfuskee,Superintendent of Public Instruction,John Cox,DEM,540101,0,0,78,78,
Okfuskee,Superintendent of Public Instruction,Jack Jr.,DEM,540101,0,0,19,19,
Okfuskee,Superintendent of Public Instruction,Ivan Holmes,DEM,540101,0,0,16,16,
Okfuskee,Superintendent of Public Instruction,Freda Deskin,DEM,540101,0,0,40,40,
Okfuskee,U.S. Senate,Patrick Michael Hayes,DEM,540101,0,0,23,23,
Okfuskee,U.S. Senate,Jim Rogers,DEM,540101,0,0,90,90,
Okfuskee,U.S. Senate,Connie Johnson,DEM,540101,0,0,33,33,
Okfuskee,U.S. House,Earl Everett,DEM,540101,0,0,96,96,02
Okfuskee,U.S. House,Joshua Harris-Till,DEM,540101,0,0,36,36,02
Okfuskee,State Senate,Chad Bonds,DEM,540101,0,0,45,45,8
Okfuskee,State Senate,Gary Clason,DEM,540101,0,0,55,55,8
Okfuskee,State Senate,Selina Jayne-Dornan,DEM,540101,0,0,36,36,8
Okfuskee,Governor,Dax Ewbank,REP,540101,0,0,15,15,
Okfuskee,Governor,Chad Moody,REP,540101,1,1,18,20,
Okfuskee,Governor,Mary Fallin,REP,540101,1,0,81,82,
Okfuskee,Superintendent of Public Instruction,Brian Kelly,REP,540101,0,1,33,34,
Okfuskee,Superintendent of Public Instruction,Janet Costello Barresi,REP,540101,0,0,12,12,
Okfuskee,Superintendent of Public Instruction,Joy Hofmeister,REP,540101,2,0,66,68,
Okfuskee,Insurance Commissioner,Bill Viner,REP,540101,0,0,20,20,
Okfuskee,Insurance Commissioner,John Doak,REP,540101,2,1,85,88,
Okfuskee,Corporation Commissioner,Todd Hiett,REP,540101,0,1,64,65,
Okfuskee,Corporation Commissioner,Cliff Branan,REP,540101,2,0,47,49,
Okfuskee,U.S. Senate,Evelyn Rogers,REP,540101,0,0,4,4,
Okfuskee,U.S. Senate,Rob Moye,REP,540101,0,0,3,3,
Okfuskee,U.S. Senate,D. Jean Mcbride-Samuels,REP,540101,0,0,2,2,
Okfuskee,U.S. Senate,Jim Inhofe,REP,540101,2,1,95,98,
Okfuskee,U.S. Senate,Erick Paul Wyatt,REP,540101,0,0,9,9,
Okfuskee,U.S. Senate,Andy Craig,REP,540101,0,0,0,0,
Okfuskee,U.S. Senate,T. Shannon,REP,540101,1,1,27,29,
Okfuskee,U.S. Senate,Randy Brogdon,REP,540101,0,0,6,6,
Okfuskee,U.S. Senate,Eric Mccray,REP,540101,0,0,0,0,
Okfuskee,U.S. Senate,Kevin Crow,REP,540101,0,0,1,1,
Okfuskee,U.S. Senate,James Lankford,REP,540101,1,0,80,81,
Okfuskee,U.S. Senate,Jason Weger,REP,540101,0,0,1,1,
Okfuskee,U.S. House,Darrel Robertson,REP,540101,0,0,34,34,02
Okfuskee,U.S. House,Markwayne Mullin,REP,540101,2,1,75,78,02
Okfuskee,State Senate,J. Hill,REP,540101,1,1,21,23,8
Okfuskee,State Senate,Roger Thompson,REP,540101,1,0,81,82,8
Okfuskee,State Senate,Malcolm Branch,REP,540101,0,0,5,5,8
Okfuskee,Superintendent of Public Instruction,John Cox,DEM,540102,3,1,17,21,
Okfuskee,Superintendent of Public Instruction,Jack Jr.,DEM,540102,0,0,10,10,
Okfuskee,Superintendent of Public Instruction,Ivan Holmes,DEM,540102,0,0,7,7,
Okfuskee,Superintendent of Public Instruction,Freda Deskin,DEM,540102,0,0,23,23,
Okfuskee,U.S. Senate,Patrick Michael Hayes,DEM,540102,0,0,12,12,
Okfuskee,U.S. Senate,Jim Rogers,DEM,540102,3,0,5,8,
Okfuskee,U.S. Senate,Connie Johnson,DEM,540102,0,1,40,41,
Okfuskee,U.S. House,Earl Everett,DEM,540102,2,1,32,35,02
Okfuskee,U.S. House,Joshua Harris-Till,DEM,540102,1,0,24,25,02
Okfuskee,State Senate,Chad Bonds,DEM,540102,2,1,8,11,8
Okfuskee,State Senate,Gary Clason,DEM,540102,1,0,15,16,8
Okfuskee,State Senate,Selina Jayne-Dornan,DEM,540102,0,0,33,33,8
Okfuskee,Governor,Dax Ewbank,REP,540102,3,0,0,3,
Okfuskee,Governor,Chad Moody,REP,540102,0,3,1,4,
Okfuskee,Governor,Mary Fallin,REP,540102,0,0,5,5,
Okfuskee,Superintendent of Public Instruction,Brian Kelly,REP,540102,0,1,1,2,
Okfuskee,Superintendent of Public Instruction,Janet Costello Barresi,REP,540102,0,0,1,1,
Okfuskee,Superintendent of Public Instruction,Joy Hofmeister,REP,540102,3,1,4,8,
Okfuskee,Insurance Commissioner,Bill Viner,REP,540102,3,2,0,5,
Okfuskee,Insurance Commissioner,John Doak,REP,540102,0,1,5,6,
Okfuskee,Corporation Commissioner,Todd Hiett,REP,540102,1,1,2,4,
Okfuskee,Corporation Commissioner,Cliff Branan,REP,540102,2,2,4,8,
Okfuskee,U.S. Senate,Evelyn Rogers,REP,540102,0,1,0,1,
Okfuskee,U.S. Senate,Rob Moye,REP,540102,0,0,0,0,
Okfuskee,U.S. Senate,D. Jean Mcbride-Samuels,REP,540102,0,1,0,1,
Okfuskee,U.S. Senate,Jim Inhofe,REP,540102,3,1,4,8,
Okfuskee,U.S. Senate,Erick Paul Wyatt,REP,540102,0,0,1,1,
Okfuskee,U.S. Senate,Andy Craig,REP,540102,0,0,0,0,
Okfuskee,U.S. Senate,T. Shannon,REP,540102,3,1,5,9,
Okfuskee,U.S. Senate,Randy Brogdon,REP,540102,0,0,0,0,
Okfuskee,U.S. Senate,Eric Mccray,REP,540102,0,0,0,0,
Okfuskee,U.S. Senate,Kevin Crow,REP,540102,0,0,1,1,
Okfuskee,U.S. Senate,James Lankford,REP,540102,0,2,1,3,
Okfuskee,U.S. Senate,Jason Weger,REP,540102,0,0,0,0,
Okfuskee,U.S. House,Darrel Robertson,REP,540102,2,1,1,4,02
Okfuskee,U.S. House,Markwayne Mullin,REP,540102,1,2,5,8,02
Okfuskee,State Senate,J. Hill,REP,540102,0,0,0,0,8
Okfuskee,State Senate,Roger Thompson,REP,540102,0,2,5,7,8
Okfuskee,State Senate,Malcolm Branch,REP,540102,3,1,1,5,8
Okfuskee,Superintendent of Public Instruction,John Cox,DEM,540103,1,0,21,22,
Okfuskee,Superintendent of Public Instruction,Jack Jr.,DEM,540103,0,0,7,7,
Okfuskee,Superintendent of Public Instruction,Ivan Holmes,DEM,540103,0,0,7,7,
Okfuskee,Superintendent of Public Instruction,Freda Deskin,DEM,540103,0,0,24,24,
Okfuskee,U.S. Senate,Patrick Michael Hayes,DEM,540103,0,0,22,22,
Okfuskee,U.S. Senate,Jim Rogers,DEM,540103,1,0,18,19,
Okfuskee,U.S. Senate,Connie Johnson,DEM,540103,0,0,19,19,
Okfuskee,U.S. House,Earl Everett,DEM,540103,1,0,36,37,02
Okfuskee,U.S. House,Joshua Harris-Till,DEM,540103,0,0,22,22,02
Okfuskee,State Senate,Chad Bonds,DEM,540103,1,0,31,32,8
Okfuskee,State Senate,Gary Clason,DEM,540103,0,0,16,16,8
Okfuskee,State Senate,Selina Jayne-Dornan,DEM,540103,0,0,12,12,8
Okfuskee,Governor,Dax Ewbank,REP,540103,0,0,2,2,
Okfuskee,Governor,Chad Moody,REP,540103,0,0,3,3,
Okfuskee,Governor,Mary Fallin,REP,540103,0,0,13,13,
Okfuskee,Superintendent of Public Instruction,Brian Kelly,REP,540103,0,0,1,1,
Okfuskee,Superintendent of Public Instruction,Janet Costello Barresi,REP,540103,0,0,4,4,
Okfuskee,Superintendent of Public Instruction,Joy Hofmeister,REP,540103,0,0,10,10,
Okfuskee,Insurance Commissioner,Bill Viner,REP,540103,0,0,3,3,
Okfuskee,Insurance Commissioner,John Doak,REP,540103,0,0,12,12,
Okfuskee,Corporation Commissioner,Todd Hiett,REP,540103,0,0,12,12,
Okfuskee,Corporation Commissioner,Cliff Branan,REP,540103,0,0,5,5,
Okfuskee,U.S. Senate,Evelyn Rogers,REP,540103,0,0,1,1,
Okfuskee,U.S. Senate,Rob Moye,REP,540103,0,0,0,0,
Okfuskee,U.S. Senate,D. Jean Mcbride-Samuels,REP,540103,0,0,0,0,
Okfuskee,U.S. Senate,Jim Inhofe,REP,540103,0,0,16,16,
Okfuskee,U.S. Senate,Erick Paul Wyatt,REP,540103,0,0,0,0,
Okfuskee,U.S. Senate,Andy Craig,REP,540103,0,0,0,0,
Okfuskee,U.S. Senate,T. Shannon,REP,540103,0,0,9,9,
Okfuskee,U.S. Senate,Randy Brogdon,REP,540103,0,0,1,1,
Okfuskee,U.S. Senate,Eric Mccray,REP,540103,0,0,0,0,
Okfuskee,U.S. Senate,Kevin Crow,REP,540103,0,0,0,0,
Okfuskee,U.S. Senate,James Lankford,REP,540103,0,0,8,8,
Okfuskee,U.S. Senate,Jason Weger,REP,540103,0,0,0,0,
Okfuskee,U.S. House,Darrel Robertson,REP,540103,0,0,2,2,02
Okfuskee,U.S. House,Markwayne Mullin,REP,540103,0,0,14,14,02
Okfuskee,State Senate,J. Hill,REP,540103,0,0,1,1,8
Okfuskee,State Senate,Roger Thompson,REP,540103,0,0,10,10,8
Okfuskee,State Senate,Malcolm Branch,REP,540103,0,0,2,2,8
Okfuskee,Superintendent of Public Instruction,John Cox,DEM,540105,0,3,22,25,
Okfuskee,Superintendent of Public Instruction,Jack Jr.,DEM,540105,0,0,4,4,
Okfuskee,Superintendent of Public Instruction,Ivan Holmes,DEM,540105,0,0,5,5,
Okfuskee,Superintendent of Public Instruction,Freda Deskin,DEM,540105,0,2,18,20,
Okfuskee,U.S. Senate,Patrick Michael Hayes,DEM,540105,0,1,12,13,
Okfuskee,U.S. Senate,Jim Rogers,DEM,540105,0,2,22,24,
Okfuskee,U.S. Senate,Connie Johnson,DEM,540105,0,2,13,15,
Okfuskee,U.S. House,Earl Everett,DEM,540105,0,1,30,31,02
Okfuskee,U.S. House,Joshua Harris-Till,DEM,540105,0,4,17,21,02
Okfuskee,State Senate,Chad Bonds,DEM,540105,0,1,12,13,8
Okfuskee,State Senate,Gary Clason,DEM,540105,0,3,12,15,8
Okfuskee,State Senate,Selina Jayne-Dornan,DEM,540105,0,1,23,24,8
Okfuskee,Governor,Dax Ewbank,REP,540105,0,1,3,4,
Okfuskee,Governor,Chad Moody,REP,540105,0,0,3,3,
Okfuskee,Governor,Mary Fallin,REP,540105,0,2,14,16,
Okfuskee,Superintendent of Public Instruction,Brian Kelly,REP,540105,0,0,3,3,
Okfuskee,Superintendent of Public Instruction,Janet Costello Barresi,REP,540105,0,0,2,2,
Okfuskee,Superintendent of Public Instruction,Joy Hofmeister,REP,540105,0,3,14,17,
Okfuskee,Insurance Commissioner,Bill Viner,REP,540105,0,0,5,5,
Okfuskee,Insurance Commissioner,John Doak,REP,540105,0,3,13,16,
Okfuskee,Corporation Commissioner,Todd Hiett,REP,540105,0,3,6,9,
Okfuskee,Corporation Commissioner,Cliff Branan,REP,540105,0,0,11,11,
Okfuskee,U.S. Senate,Evelyn Rogers,REP,540105,0,0,2,2,
Okfuskee,U.S. Senate,Rob Moye,REP,540105,0,0,1,1,
Okfuskee,U.S. Senate,D. Jean Mcbride-Samuels,REP,540105,0,0,0,0,
Okfuskee,U.S. Senate,Jim Inhofe,REP,540105,0,3,14,17,
Okfuskee,U.S. Senate,Erick Paul Wyatt,REP,540105,0,0,2,2,
Okfuskee,U.S. Senate,Andy Craig,REP,540105,0,0,1,1,
Okfuskee,U.S. Senate,T. Shannon,REP,540105,0,1,9,10,
Okfuskee,U.S. Senate,Randy Brogdon,REP,540105,0,1,2,3,
Okfuskee,U.S. Senate,Eric Mccray,REP,540105,0,1,0,1,
Okfuskee,U.S. Senate,Kevin Crow,REP,540105,0,0,0,0,
Okfuskee,U.S. Senate,James Lankford,REP,540105,0,0,6,6,
Okfuskee,U.S. Senate,Jason Weger,REP,540105,0,0,1,1,
Okfuskee,U.S. House,Darrel Robertson,REP,540105,0,1,4,5,02
Okfuskee,U.S. House,Markwayne Mullin,REP,540105,0,2,16,18,02
Okfuskee,State Senate,J. Hill,REP,540105,0,1,4,5,8
Okfuskee,State Senate,Roger Thompson,REP,540105,0,1,14,15,8
Okfuskee,State Senate,Malcolm Branch,REP,540105,0,1,2,3,8
Okfuskee,Superintendent of Public Instruction,John Cox,DEM,540206,1,4,39,44,
Okfuskee,Superintendent of Public Instruction,Jack Jr.,DEM,540206,0,0,1,1,
Okfuskee,Superintendent of Public Instruction,Ivan Holmes,DEM,540206,0,1,1,2,
Okfuskee,Superintendent of Public Instruction,Freda Deskin,DEM,540206,0,1,27,28,
Okfuskee,U.S. Senate,Patrick Michael Hayes,DEM,540206,0,3,11,14,
Okfuskee,U.S. Senate,Jim Rogers,DEM,540206,0,1,28,29,
Okfuskee,U.S. Senate,Connie Johnson,DEM,540206,1,2,27,30,
Okfuskee,U.S. House,Earl Everett,DEM,540206,0,3,36,39,02
Okfuskee,U.S. House,Joshua Harris-Till,DEM,540206,1,2,29,32,02
Okfuskee,State Senate,Chad Bonds,DEM,540206,0,2,30,32,8
Okfuskee,State Senate,Gary Clason,DEM,540206,0,1,8,9,8
Okfuskee,State Senate,Selina Jayne-Dornan,DEM,540206,1,2,29,32,8
Okfuskee,Governor,Dax Ewbank,REP,540206,0,0,8,8,
Okfuskee,Governor,Chad Moody,REP,540206,1,1,5,7,
Okfuskee,Governor,Mary Fallin,REP,540206,2,4,26,32,
Okfuskee,Superintendent of Public Instruction,Brian Kelly,REP,540206,1,2,11,14,
Okfuskee,Superintendent of Public Instruction,Janet Costello Barresi,REP,540206,1,0,8,9,
Okfuskee,Superintendent of Public Instruction,Joy Hofmeister,REP,540206,1,3,21,25,
Okfuskee,Insurance Commissioner,Bill Viner,REP,540206,1,1,5,7,
Okfuskee,Insurance Commissioner,John Doak,REP,540206,2,4,32,38,
Okfuskee,Corporation Commissioner,Todd Hiett,REP,540206,1,2,22,25,
Okfuskee,Corporation Commissioner,Cliff Branan,REP,540206,2,3,15,20,
Okfuskee,U.S. Senate,Evelyn Rogers,REP,540206,0,0,1,1,
Okfuskee,U.S. Senate,Rob Moye,REP,540206,0,0,0,0,
Okfuskee,U.S. Senate,D. Jean Mcbride-Samuels,REP,540206,0,0,0,0,
Okfuskee,U.S. Senate,Jim Inhofe,REP,540206,1,4,32,37,
Okfuskee,U.S. Senate,Erick Paul Wyatt,REP,540206,1,0,6,7,
Okfuskee,U.S. Senate,Andy Craig,REP,540206,0,0,1,1,
Okfuskee,U.S. Senate,T. Shannon,REP,540206,1,4,14,19,
Okfuskee,U.S. Senate,Randy Brogdon,REP,540206,1,1,4,6,
Okfuskee,U.S. Senate,Eric Mccray,REP,540206,1,0,0,1,
Okfuskee,U.S. Senate,Kevin Crow,REP,540206,0,0,2,2,
Okfuskee,U.S. Senate,James Lankford,REP,540206,0,0,17,17,
Okfuskee,U.S. Senate,Jason Weger,REP,540206,0,0,0,0,
Okfuskee,U.S. House,Darrel Robertson,REP,540206,1,0,8,9,02
Okfuskee,U.S. House,Markwayne Mullin,REP,540206,2,5,31,38,02
Okfuskee,State Senate,J. Hill,REP,540206,2,2,9,13,8
Okfuskee,State Senate,Roger Thompson,REP,540206,1,2,25,28,8
Okfuskee,State Senate,Malcolm Branch,REP,540206,0,1,5,6,8
Okfuskee,Superintendent of Public Instruction,John Cox,DEM,540207,1,0,8,9,
Okfuskee,Superintendent of Public Instruction,Jack Jr.,DEM,540207,0,0,0,0,
Okfuskee,Superintendent of Public Instruction,Ivan Holmes,DEM,540207,0,0,0,0,
Okfuskee,Superintendent of Public Instruction,Freda Deskin,DEM,540207,0,0,13,13,
Okfuskee,U.S. Senate,Patrick Michael Hayes,DEM,540207,1,0,3,4,
Okfuskee,U.S. Senate,Jim Rogers,DEM,540207,0,0,7,7,
Okfuskee,U.S. Senate,Connie Johnson,DEM,540207,0,0,11,11,
Okfuskee,U.S. House,Earl Everett,DEM,540207,1,0,15,16,02
Okfuskee,U.S. House,Joshua Harris-Till,DEM,540207,0,0,6,6,02
Okfuskee,State Senate,Chad Bonds,DEM,540207,1,0,8,9,8
Okfuskee,State Senate,Gary Clason,DEM,540207,0,0,6,6,8
Okfuskee,State Senate,Selina Jayne-Dornan,DEM,540207,0,0,7,7,8
Okfuskee,Governor,Dax Ewbank,REP,540207,0,0,0,0,
Okfuskee,Governor,Chad Moody,REP,540207,0,1,2,3,
Okfuskee,Governor,Mary Fallin,REP,540207,0,1,20,21,
Okfuskee,Superintendent of Public Instruction,Brian Kelly,REP,540207,0,0,2,2,
Okfuskee,Superintendent of Public Instruction,Janet Costello Barresi,REP,540207,0,0,6,6,
Okfuskee,Superintendent of Public Instruction,Joy Hofmeister,REP,540207,0,2,14,16,
Okfuskee,Insurance Commissioner,Bill Viner,REP,540207,0,0,2,2,
Okfuskee,Insurance Commissioner,John Doak,REP,540207,0,2,19,21,
Okfuskee,Corporation Commissioner,Todd Hiett,REP,540207,0,1,11,12,
Okfuskee,Corporation Commissioner,Cliff Branan,REP,540207,0,1,8,9,
Okfuskee,U.S. Senate,Evelyn Rogers,REP,540207,0,0,1,1,
Okfuskee,U.S. Senate,Rob Moye,REP,540207,0,0,1,1,
Okfuskee,U.S. Senate,D. Jean Mcbride-Samuels,REP,540207,0,0,0,0,
Okfuskee,U.S. Senate,Jim Inhofe,REP,540207,0,2,19,21,
Okfuskee,U.S. Senate,Erick Paul Wyatt,REP,540207,0,0,0,0,
Okfuskee,U.S. Senate,Andy Craig,REP,540207,0,0,0,0,
Okfuskee,U.S. Senate,T. Shannon,REP,540207,0,1,8,9,
Okfuskee,U.S. Senate,Randy Brogdon,REP,540207,0,0,1,1,
Okfuskee,U.S. Senate,Eric Mccray,REP,540207,0,0,0,0,
Okfuskee,U.S. Senate,Kevin Crow,REP,540207,0,0,0,0,
Okfuskee,U.S. Senate,James Lankford,REP,540207,0,1,12,13,
Okfuskee,U.S. Senate,Jason Weger,REP,540207,0,0,0,0,
Okfuskee,U.S. House,Darrel Robertson,REP,540207,0,0,3,3,02
Okfuskee,U.S. House,Markwayne Mullin,REP,540207,0,2,19,21,02
Okfuskee,State Senate,J. Hill,REP,540207,0,1,2,3,8
Okfuskee,State Senate,Roger Thompson,REP,540207,0,1,15,16,8
Okfuskee,State Senate,Malcolm Branch,REP,540207,0,0,4,4,8
Okfuskee,Superintendent of Public Instruction,John Cox,DEM,540208,0,4,33,37,
Okfuskee,Superintendent of Public Instruction,Jack Jr.,DEM,540208,0,1,6,7,
Okfuskee,Superintendent of Public Instruction,Ivan Holmes,DEM,540208,0,0,2,2,
Okfuskee,Superintendent of Public Instruction,Freda Deskin,DEM,540208,0,6,22,28,
Okfuskee,U.S. Senate,Patrick Michael Hayes,DEM,540208,0,3,18,21,
Okfuskee,U.S. Senate,Jim Rogers,DEM,540208,0,2,23,25,
Okfuskee,U.S. Senate,Connie Johnson,DEM,540208,0,6,22,28,
Okfuskee,U.S. House,Earl Everett,DEM,540208,0,5,40,45,02
Okfuskee,U.S. House,Joshua Harris-Till,DEM,540208,0,5,20,25,02
Okfuskee,State Senate,Chad Bonds,DEM,540208,0,3,15,18,8
Okfuskee,State Senate,Gary Clason,DEM,540208,0,4,15,19,8
Okfuskee,State Senate,Selina Jayne-Dornan,DEM,540208,0,4,32,36,8
Okfuskee,Governor,Dax Ewbank,REP,540208,1,0,4,5,
Okfuskee,Governor,Chad Moody,REP,540208,1,0,7,8,
Okfuskee,Governor,Mary Fallin,REP,540208,2,5,15,22,
Okfuskee,Superintendent of Public Instruction,Brian Kelly,REP,540208,1,1,10,12,
Okfuskee,Superintendent of Public Instruction,Janet Costello Barresi,REP,540208,0,0,3,3,
Okfuskee,Superintendent of Public Instruction,Joy Hofmeister,REP,540208,3,3,14,20,
Okfuskee,Insurance Commissioner,Bill Viner,REP,540208,0,1,8,9,
Okfuskee,Insurance Commissioner,John Doak,REP,540208,4,4,18,26,
Okfuskee,Corporation Commissioner,Todd Hiett,REP,540208,3,1,12,16,
Okfuskee,Corporation Commissioner,Cliff Branan,REP,540208,1,4,14,19,
Okfuskee,U.S. Senate,Evelyn Rogers,REP,540208,0,0,0,0,
Okfuskee,U.S. Senate,Rob Moye,REP,540208,0,0,3,3,
Okfuskee,U.S. Senate,D. Jean Mcbride-Samuels,REP,540208,0,0,0,0,
Okfuskee,U.S. Senate,Jim Inhofe,REP,540208,3,4,22,29,
Okfuskee,U.S. Senate,Erick Paul Wyatt,REP,540208,1,1,1,3,
Okfuskee,U.S. Senate,Andy Craig,REP,540208,0,0,0,0,
Okfuskee,U.S. Senate,T. Shannon,REP,540208,2,1,12,15,
Okfuskee,U.S. Senate,Randy Brogdon,REP,540208,1,0,0,1,
Okfuskee,U.S. Senate,Eric Mccray,REP,540208,0,0,1,1,
Okfuskee,U.S. Senate,Kevin Crow,REP,540208,0,0,1,1,
Okfuskee,U.S. Senate,James Lankford,REP,540208,1,4,13,18,
Okfuskee,U.S. Senate,Jason Weger,REP,540208,0,0,0,0,
Okfuskee,U.S. House,Darrel Robertson,REP,540208,1,0,6,7,02
Okfuskee,U.S. House,Markwayne Mullin,REP,540208,3,5,21,29,02
Okfuskee,State Senate,J. Hill,REP,540208,0,2,11,13,8
Okfuskee,State Senate,Roger Thompson,REP,540208,3,3,14,20,8
Okfuskee,State Senate,Malcolm Branch,REP,540208,1,0,2,3,8
Okfuskee,Superintendent of Public Instruction,John Cox,DEM,540209,2,5,79,86,
Okfuskee,Superintendent of Public Instruction,Jack Jr.,DEM,540209,1,2,15,18,
Okfuskee,Superintendent of Public Instruction,Ivan Holmes,DEM,540209,0,2,12,14,
Okfuskee,Superintendent of Public Instruction,Freda Deskin,DEM,540209,1,3,42,46,
Okfuskee,U.S. Senate,Patrick Michael Hayes,DEM,540209,2,4,25,31,
Okfuskee,U.S. Senate,Jim Rogers,DEM,540209,1,6,65,72,
Okfuskee,U.S. Senate,Connie Johnson,DEM,540209,1,2,46,49,
Okfuskee,U.S. House,Earl Everett,DEM,540209,2,10,85,97,02
Okfuskee,U.S. House,Joshua Harris-Till,DEM,540209,2,2,45,49,02
Okfuskee,State Senate,Chad Bonds,DEM,540209,1,3,35,39,8
Okfuskee,State Senate,Gary Clason,DEM,540209,0,2,38,40,8
Okfuskee,State Senate,Selina Jayne-Dornan,DEM,540209,3,7,70,80,8
Okfuskee,Governor,Dax Ewbank,REP,540209,0,3,10,13,
Okfuskee,Governor,Chad Moody,REP,540209,0,1,11,12,
Okfuskee,Governor,Mary Fallin,REP,540209,4,3,31,38,
Okfuskee,Superintendent of Public Instruction,Brian Kelly,REP,540209,1,1,4,6,
Okfuskee,Superintendent of Public Instruction,Janet Costello Barresi,REP,540209,2,1,11,14,
Okfuskee,Superintendent of Public Instruction,Joy Hofmeister,REP,540209,0,5,36,41,
Okfuskee,Insurance Commissioner,Bill Viner,REP,540209,0,1,14,15,
Okfuskee,Insurance Commissioner,John Doak,REP,540209,3,6,35,44,
Okfuskee,Corporation Commissioner,Todd Hiett,REP,540209,1,7,29,37,
Okfuskee,Corporation Commissioner,Cliff Branan,REP,540209,2,0,19,21,
Okfuskee,U.S. Senate,Evelyn Rogers,REP,540209,0,0,5,5,
Okfuskee,U.S. Senate,Rob Moye,REP,540209,0,0,2,2,
Okfuskee,U.S. Senate,D. Jean Mcbride-Samuels,REP,540209,0,0,2,2,
Okfuskee,U.S. Senate,Jim Inhofe,REP,540209,3,6,40,49,
Okfuskee,U.S. Senate,Erick Paul Wyatt,REP,540209,0,1,2,3,
Okfuskee,U.S. Senate,Andy Craig,REP,540209,0,0,3,3,
Okfuskee,U.S. Senate,T. Shannon,REP,540209,1,3,14,18,
Okfuskee,U.S. Senate,Randy Brogdon,REP,540209,0,1,1,2,
Okfuskee,U.S. Senate,Eric Mccray,REP,540209,0,0,0,0,
Okfuskee,U.S. Senate,Kevin Crow,REP,540209,0,0,1,1,
Okfuskee,U.S. Senate,James Lankford,REP,540209,3,3,29,35,
Okfuskee,U.S. Senate,Jason Weger,REP,540209,0,0,3,3,
Okfuskee,U.S. House,Darrel Robertson,REP,540209,0,1,8,9,02
Okfuskee,U.S. House,Markwayne Mullin,REP,540209,3,6,44,53,02
Okfuskee,State Senate,J. Hill,REP,540209,0,2,20,22,8
Okfuskee,State Senate,Roger Thompson,REP,540209,4,5,29,38,8
Okfuskee,State Senate,Malcolm Branch,REP,540209,0,0,3,3,8
Okfuskee,Superintendent of Public Instruction,John Cox,DEM,540210,0,1,21,22,
Okfuskee,Superintendent of Public Instruction,Jack Jr.,DEM,540210,1,0,7,8,
Okfuskee,Superintendent of Public Instruction,Ivan Holmes,DEM,540210,1,0,4,5,
Okfuskee,Superintendent of Public Instruction,Freda Deskin,DEM,540210,1,2,12,15,
Okfuskee,U.S. Senate,Patrick Michael Hayes,DEM,540210,0,1,8,9,
Okfuskee,U.S. Senate,Jim Rogers,DEM,540210,1,1,19,21,
Okfuskee,U.S. Senate,Connie Johnson,DEM,540210,2,1,15,18,
Okfuskee,U.S. House,Earl Everett,DEM,540210,3,1,24,28,02
Okfuskee,U.S. House,Joshua Harris-Till,DEM,540210,0,2,16,18,02
Okfuskee,Governor,Dax Ewbank,REP,540210,0,0,3,3,
Okfuskee,Governor,Chad Moody,REP,540210,0,2,5,7,
Okfuskee,Governor,Mary Fallin,REP,540210,0,2,14,16,
Okfuskee,Superintendent of Public Instruction,Brian Kelly,REP,540210,0,0,5,5,
Okfuskee,Superintendent of Public Instruction,Janet Costello Barresi,REP,540210,0,1,2,3,
Okfuskee,Superintendent of Public Instruction,Joy Hofmeister,REP,540210,0,3,15,18,
Okfuskee,Insurance Commissioner,Bill Viner,REP,540210,0,1,4,5,
Okfuskee,Insurance Commissioner,John Doak,REP,540210,0,3,17,20,
Okfuskee,Corporation Commissioner,Todd Hiett,REP,540210,0,3,14,17,
Okfuskee,Corporation Commissioner,Cliff Branan,REP,540210,0,1,8,9,
Okfuskee,U.S. Senate,Evelyn Rogers,REP,540210,0,0,1,1,
Okfuskee,U.S. Senate,Rob Moye,REP,540210,0,0,0,0,
Okfuskee,U.S. Senate,D. Jean Mcbride-Samuels,REP,540210,0,0,0,0,
Okfuskee,U.S. Senate,Jim Inhofe,REP,540210,0,2,21,23,
Okfuskee,U.S. Senate,Erick Paul Wyatt,REP,540210,0,2,0,2,
Okfuskee,U.S. Senate,Andy Craig,REP,540210,0,0,0,0,
Okfuskee,U.S. Senate,T. Shannon,REP,540210,0,3,4,7,
Okfuskee,U.S. Senate,Randy Brogdon,REP,540210,0,0,2,2,
Okfuskee,U.S. Senate,Eric Mccray,REP,540210,0,0,0,0,
Okfuskee,U.S. Senate,Kevin Crow,REP,540210,0,0,0,0,
Okfuskee,U.S. Senate,James Lankford,REP,540210,0,1,16,17,
Okfuskee,U.S. Senate,Jason Weger,REP,540210,0,0,0,0,
Okfuskee,U.S. House,Darrel Robertson,REP,540210,0,1,5,6,02
Okfuskee,U.S. House,Markwayne Mullin,REP,540210,0,3,17,20,02
Okfuskee,Superintendent of Public Instruction,John Cox,DEM,540311,1,3,48,52,
Okfuskee,Superintendent of Public Instruction,Jack Jr.,DEM,540311,1,0,10,11,
Okfuskee,Superintendent of Public Instruction,Ivan Holmes,DEM,540311,1,1,8,10,
Okfuskee,Superintendent of Public Instruction,Freda Deskin,DEM,540311,1,2,32,35,
Okfuskee,U.S. Senate,Patrick Michael Hayes,DEM,540311,0,2,23,25,
Okfuskee,U.S. Senate,Jim Rogers,DEM,540311,2,4,42,48,
Okfuskee,U.S. Senate,Connie Johnson,DEM,540311,2,0,31,33,
Okfuskee,U.S. House,Earl Everett,DEM,540311,3,6,52,61,02
Okfuskee,U.S. House,Joshua Harris-Till,DEM,540311,1,0,42,43,02
Okfuskee,State Senate,Chad Bonds,DEM,540311,1,2,27,30,8
Okfuskee,State Senate,Gary Clason,DEM,540311,2,3,37,42,8
Okfuskee,State Senate,Selina Jayne-Dornan,DEM,540311,1,2,32,35,8
Okfuskee,Governor,Dax Ewbank,REP,540311,0,0,1,1,
Okfuskee,Governor,Chad Moody,REP,540311,0,0,7,7,
Okfuskee,Governor,Mary Fallin,REP,540311,3,3,23,29,
Okfuskee,Superintendent of Public Instruction,Brian Kelly,REP,540311,0,1,5,6,
Okfuskee,Superintendent of Public Instruction,Janet Costello Barresi,REP,540311,2,1,5,8,
Okfuskee,Superintendent of Public Instruction,Joy Hofmeister,REP,540311,1,1,21,23,
Okfuskee,Insurance Commissioner,Bill Viner,REP,540311,1,0,8,9,
Okfuskee,Insurance Commissioner,John Doak,REP,540311,2,3,23,28,
Okfuskee,Corporation Commissioner,Todd Hiett,REP,540311,3,1,17,21,
Okfuskee,Corporation Commissioner,Cliff Branan,REP,540311,0,2,12,14,
Okfuskee,U.S. Senate,Evelyn Rogers,REP,540311,0,0,1,1,
Okfuskee,U.S. Senate,Rob Moye,REP,540311,0,0,1,1,
Okfuskee,U.S. Senate,D. Jean Mcbride-Samuels,REP,540311,0,0,0,0,
Okfuskee,U.S. Senate,Jim Inhofe,REP,540311,3,3,28,34,
Okfuskee,U.S. Senate,Erick Paul Wyatt,REP,540311,0,0,1,1,
Okfuskee,U.S. Senate,Andy Craig,REP,540311,0,0,1,1,
Okfuskee,U.S. Senate,T. Shannon,REP,540311,0,1,12,13,
Okfuskee,U.S. Senate,Randy Brogdon,REP,540311,0,0,1,1,
Okfuskee,U.S. Senate,Eric Mccray,REP,540311,0,0,1,1,
Okfuskee,U.S. Senate,Kevin Crow,REP,540311,0,0,0,0,
Okfuskee,U.S. Senate,James Lankford,REP,540311,3,2,15,20,
Okfuskee,U.S. Senate,Jason Weger,REP,540311,0,0,1,1,
Okfuskee,U.S. House,Darrel Robertson,REP,540311,0,1,4,5,02
Okfuskee,U.S. House,Markwayne Mullin,REP,540311,3,2,27,32,02
Okfuskee,State Senate,J. Hill,REP,540311,2,2,6,10,8
Okfuskee,State Senate,Roger Thompson,REP,540311,1,0,19,20,8
Okfuskee,State Senate,Malcolm Branch,REP,540311,0,1,5,6,8
Okfuskee,Superintendent of Public Instruction,John Cox,DEM,540312,5,6,69,80,
Okfuskee,Superintendent of Public Instruction,Jack Jr.,DEM,540312,1,3,13,17,
Okfuskee,Superintendent of Public Instruction,Ivan Holmes,DEM,540312,4,1,12,17,
Okfuskee,Superintendent of Public Instruction,Freda Deskin,DEM,540312,4,0,50,54,
Okfuskee,U.S. Senate,Patrick Michael Hayes,DEM,540312,5,3,31,39,
Okfuskee,U.S. Senate,Jim Rogers,DEM,540312,3,7,70,80,
Okfuskee,U.S. Senate,Connie Johnson,DEM,540312,5,0,39,44,
Okfuskee,U.S. House,Earl Everett,DEM,540312,6,7,84,97,02
Okfuskee,U.S. House,Joshua Harris-Till,DEM,540312,8,2,50,60,02
Okfuskee,Governor,Dax Ewbank,REP,540312,0,0,3,3,
Okfuskee,Governor,Chad Moody,REP,540312,0,1,12,13,
Okfuskee,Governor,Mary Fallin,REP,540312,1,3,28,32,
Okfuskee,Superintendent of Public Instruction,Brian Kelly,REP,540312,0,0,3,3,
Okfuskee,Superintendent of Public Instruction,Janet Costello Barresi,REP,540312,0,1,5,6,
Okfuskee,Superintendent of Public Instruction,Joy Hofmeister,REP,540312,1,2,33,36,
Okfuskee,Insurance Commissioner,Bill Viner,REP,540312,0,1,8,9,
Okfuskee,Insurance Commissioner,John Doak,REP,540312,1,2,31,34,
Okfuskee,Corporation Commissioner,Todd Hiett,REP,540312,1,1,20,22,
Okfuskee,Corporation Commissioner,Cliff Branan,REP,540312,0,3,14,17,
Okfuskee,U.S. Senate,Evelyn Rogers,REP,540312,0,1,2,3,
Okfuskee,U.S. Senate,Rob Moye,REP,540312,0,0,1,1,
Okfuskee,U.S. Senate,D. Jean Mcbride-Samuels,REP,540312,0,0,2,2,
Okfuskee,U.S. Senate,Jim Inhofe,REP,540312,1,3,33,37,
Okfuskee,U.S. Senate,Erick Paul Wyatt,REP,540312,0,0,3,3,
Okfuskee,U.S. Senate,Andy Craig,REP,540312,0,1,0,1,
Okfuskee,U.S. Senate,T. Shannon,REP,540312,0,2,18,20,
Okfuskee,U.S. Senate,Randy Brogdon,REP,540312,0,0,0,0,
Okfuskee,U.S. Senate,Eric Mccray,REP,540312,0,0,0,0,
Okfuskee,U.S. Senate,Kevin Crow,REP,540312,0,0,0,0,
Okfuskee,U.S. Senate,James Lankford,REP,540312,1,1,23,25,
Okfuskee,U.S. Senate,Jason Weger,REP,540312,0,0,1,1,
Okfuskee,U.S. House,Darrel Robertson,REP,540312,0,1,10,11,02
Okfuskee,U.S. House,Markwayne Mullin,REP,540312,1,2,31,34,02
Okfuskee,Superintendent of Public Instruction,John Cox,DEM,540313,0,1,23,24,
Okfuskee,Superintendent of Public Instruction,Jack Jr.,DEM,540313,0,0,3,3,
Okfuskee,Superintendent of Public Instruction,Ivan Holmes,DEM,540313,0,0,2,2,
Okfuskee,Superintendent of Public Instruction,Freda Deskin,DEM,540313,0,0,19,19,
Okfuskee,U.S. Senate,Patrick Michael Hayes,DEM,540313,0,0,9,9,
Okfuskee,U.S. Senate,Jim Rogers,DEM,540313,0,1,24,25,
Okfuskee,U.S. Senate,Connie Johnson,DEM,540313,0,0,17,17,
Okfuskee,U.S. House,Earl Everett,DEM,540313,0,0,31,31,02
Okfuskee,U.S. House,Joshua Harris-Till,DEM,540313,0,1,14,15,02
Okfuskee,State Senate,Chad Bonds,DEM,540313,0,1,12,13,8
Okfuskee,State Senate,Gary Clason,DEM,540313,0,0,22,22,8
Okfuskee,State Senate,Selina Jayne-Dornan,DEM,540313,0,0,15,15,8
Okfuskee,Governor,Dax Ewbank,REP,540313,0,0,0,0,
Okfuskee,Governor,Chad Moody,REP,540313,0,0,1,1,
Okfuskee,Governor,Mary Fallin,REP,540313,0,0,2,2,
Okfuskee,Superintendent of Public Instruction,Brian Kelly,REP,540313,0,0,0,0,
Okfuskee,Superintendent of Public Instruction,Janet Costello Barresi,REP,540313,0,0,1,1,
Okfuskee,Superintendent of Public Instruction,Joy Hofmeister,REP,540313,0,0,1,1,
Okfuskee,Insurance Commissioner,Bill Viner,REP,540313,0,0,0,0,
Okfuskee,Insurance Commissioner,John Doak,REP,540313,0,0,3,3,
Okfuskee,Corporation Commissioner,Todd Hiett,REP,540313,0,0,1,1,
Okfuskee,Corporation Commissioner,Cliff Branan,REP,540313,0,0,1,1,
Okfuskee,U.S. Senate,Evelyn Rogers,REP,540313,0,0,0,0,
Okfuskee,U.S. Senate,Rob Moye,REP,540313,0,0,0,0,
Okfuskee,U.S. Senate,D. Jean Mcbride-Samuels,REP,540313,0,0,0,0,
Okfuskee,U.S. Senate,Jim Inhofe,REP,540313,0,0,3,3,
Okfuskee,U.S. Senate,Erick Paul Wyatt,REP,540313,0,0,0,0,
Okfuskee,U.S. Senate,Andy Craig,REP,540313,0,0,0,0,
Okfuskee,U.S. Senate,T. Shannon,REP,540313,0,0,1,1,
Okfuskee,U.S. Senate,Randy Brogdon,REP,540313,0,0,0,0,
Okfuskee,U.S. Senate,Eric Mccray,REP,540313,0,0,0,0,
Okfuskee,U.S. Senate,Kevin Crow,REP,540313,0,0,0,0,
Okfuskee,U.S. Senate,James Lankford,REP,540313,0,0,2,2,
Okfuskee,U.S. Senate,Jason Weger,REP,540313,0,0,0,0,
Okfuskee,U.S. House,Darrel Robertson,REP,540313,0,0,0,0,02
Okfuskee,U.S. House,Markwayne Mullin,REP,540313,0,0,3,3,02
Okfuskee,State Senate,J. Hill,REP,540313,0,0,1,1,8
Okfuskee,State Senate,Roger Thompson,REP,540313,0,0,2,2,8
Okfuskee,State Senate,Malcolm Branch,REP,540313,0,0,0,0,8
Okfuskee,Superintendent of Public Instruction,John Cox,DEM,540314,3,5,46,54,
Okfuskee,Superintendent of Public Instruction,Jack Jr.,DEM,540314,0,0,8,8,
Okfuskee,Superintendent of Public Instruction,Ivan Holmes,DEM,540314,0,0,7,7,
Okfuskee,Superintendent of Public Instruction,Freda Deskin,DEM,540314,1,2,20,23,
Okfuskee,U.S. Senate,Patrick Michael Hayes,DEM,540314,0,2,20,22,
Okfuskee,U.S. Senate,Jim Rogers,DEM,540314,2,1,26,29,
Okfuskee,U.S. Senate,Connie Johnson,DEM,540314,2,4,34,40,
Okfuskee,U.S. House,Earl Everett,DEM,540314,3,2,42,47,02
Okfuskee,U.S. House,Joshua Harris-Till,DEM,540314,1,4,34,39,02
Okfuskee,State Senate,Chad Bonds,DEM,540314,0,1,21,22,8
Okfuskee,State Senate,Gary Clason,DEM,540314,1,3,22,26,8
Okfuskee,State Senate,Selina Jayne-Dornan,DEM,540314,3,3,35,41,8
Okfuskee,Governor,Dax Ewbank,REP,540314,0,1,1,2,
Okfuskee,Governor,Chad Moody,REP,540314,0,1,7,8,
Okfuskee,Governor,Mary Fallin,REP,540314,0,1,18,19,
Okfuskee,Superintendent of Public Instruction,Brian Kelly,REP,540314,0,0,5,5,
Okfuskee,Superintendent of Public Instruction,Janet Costello Barresi,REP,540314,0,1,1,2,
Okfuskee,Superintendent of Public Instruction,Joy Hofmeister,REP,540314,0,2,20,22,
Okfuskee,Insurance Commissioner,Bill Viner,REP,540314,0,0,7,7,
Okfuskee,Insurance Commissioner,John Doak,REP,540314,0,3,17,20,
Okfuskee,Corporation Commissioner,Todd Hiett,REP,540314,0,3,13,16,
Okfuskee,Corporation Commissioner,Cliff Branan,REP,540314,0,0,11,11,
Okfuskee,U.S. Senate,Evelyn Rogers,REP,540314,0,1,0,1,
Okfuskee,U.S. Senate,Rob Moye,REP,540314,0,0,2,2,
Okfuskee,U.S. Senate,D. Jean Mcbride-Samuels,REP,540314,0,0,0,0,
Okfuskee,U.S. Senate,Jim Inhofe,REP,540314,0,2,22,24,
Okfuskee,U.S. Senate,Erick Paul Wyatt,REP,540314,0,0,1,1,
Okfuskee,U.S. Senate,Andy Craig,REP,540314,0,0,0,0,
Okfuskee,U.S. Senate,T. Shannon,REP,540314,0,2,8,10,
Okfuskee,U.S. Senate,Randy Brogdon,REP,540314,0,0,0,0,
Okfuskee,U.S. Senate,Eric Mccray,REP,540314,0,0,2,2,
Okfuskee,U.S. Senate,Kevin Crow,REP,540314,0,0,0,0,
Okfuskee,U.S. Senate,James Lankford,REP,540314,0,1,16,17,
Okfuskee,U.S. Senate,Jason Weger,REP,540314,0,0,0,0,
Okfuskee,U.S. House,Darrel Robertson,REP,540314,0,0,4,4,02
Okfuskee,U.S. House,Markwayne Mullin,REP,540314,0,3,22,25,02
Okfuskee,State Senate,J. Hill,REP,540314,0,2,8,10,8
Okfuskee,State Senate,Roger Thompson,REP,540314,0,1,17,18,8
Okfuskee,State Senate,Malcolm Branch,REP,540314,0,0,1,1,8
Oklahoma,Superintendent of Public Instruction,John Cox,DEM,550001,0,0,9,9,
Oklahoma,Superintendent of Public Instruction,Jack Jr.,DEM,550001,0,0,9,9,
Oklahoma,Superintendent of Public Instruction,Ivan Holmes,DEM,550001,0,0,4,4,
Oklahoma,Superintendent of Public Instruction,Freda Deskin,DEM,550001,0,0,28,28,
Oklahoma,U.S. Senate,Patrick Michael Hayes,DEM,550001,0,0,8,8,
Oklahoma,U.S. Senate,Jim Rogers,DEM,550001,0,0,16,16,
Oklahoma,U.S. Senate,Connie Johnson,DEM,550001,0,0,26,26,
Oklahoma,U.S. House,Tom Guild,DEM,550001,0,0,18,18,05
Oklahoma,U.S. House,Al Mcaffrey,DEM,550001,0,0,17,17,05
Oklahoma,U.S. House,Leona Leonard,DEM,550001,0,0,14,14,05
Oklahoma,Governor,Dax Ewbank,REP,550001,0,0,15,15,
Oklahoma,Governor,Chad Moody,REP,550001,0,0,10,10,
Oklahoma,Governor,Mary Fallin,REP,550001,0,0,128,128,
Oklahoma,Superintendent of Public Instruction,Brian Kelly,REP,550001,0,0,43,43,
Oklahoma,Superintendent of Public Instruction,Janet Costello Barresi,REP,550001,0,0,38,38,
Oklahoma,Superintendent of Public Instruction,Joy Hofmeister,REP,550001,0,0,72,72,
Oklahoma,Insurance Commissioner,Bill Viner,REP,550001,0,0,29,29,
Oklahoma,Insurance Commissioner,John Doak,REP,550001,0,0,116,116,
Oklahoma,Corporation Commissioner,Todd Hiett,REP,550001,0,0,68,68,
Oklahoma,Corporation Commissioner,Cliff Branan,REP,550001,0,0,77,77,
Oklahoma,U.S. Senate,Evelyn Rogers,REP,550001,0,0,5,5,
Oklahoma,U.S. Senate,Rob Moye,REP,550001,0,0,3,3,
Oklahoma,U.S. Senate,D. Jean Mcbride-Samuels,REP,550001,0,0,3,3,
Oklahoma,U.S. Senate,Jim Inhofe,REP,550001,0,0,141,141,
Oklahoma,U.S. Senate,Erick Paul Wyatt,REP,550001,0,0,1,1,
Oklahoma,U.S. Senate,Andy Craig,REP,550001,0,0,1,1,
Oklahoma,U.S. Senate,T. Shannon,REP,550001,0,0,36,36,
Oklahoma,U.S. Senate,Randy Brogdon,REP,550001,0,0,4,4,
Oklahoma,U.S. Senate,Eric Mccray,REP,550001,0,0,0,0,
Oklahoma,U.S. Senate,Kevin Crow,REP,550001,0,0,1,1,
Oklahoma,U.S. Senate,James Lankford,REP,550001,0,0,112,112,
Oklahoma,U.S. Senate,Jason Weger,REP,550001,0,0,0,0,
Oklahoma,U.S. House,Shane David Jett,REP,550001,0,0,18,18,05
Oklahoma,U.S. House,Patrice Douglas,REP,550001,0,0,26,26,05
Oklahoma,U.S. House,Mike Turner,REP,550001,0,0,39,39,05
Oklahoma,U.S. House,Steve Russell,REP,550001,0,0,47,47,05
Oklahoma,U.S. House,Harvey Sparks,REP,550001,0,0,10,10,05
Oklahoma,U.S. House,Clark Jolley,REP,550001,0,0,13,13,05
Oklahoma,Superintendent of Public Instruction,John Cox,DEM,550002,0,0,10,10,
Oklahoma,Superintendent of Public Instruction,Jack Jr.,DEM,550002,0,0,7,7,
Oklahoma,Superintendent of Public Instruction,Ivan Holmes,DEM,550002,0,0,1,1,
Oklahoma,Superintendent of Public Instruction,Freda Deskin,DEM,550002,0,0,18,18,
Oklahoma,U.S. Senate,Patrick Michael Hayes,DEM,550002,0,0,6,6,
Oklahoma,U.S. Senate,Jim Rogers,DEM,550002,0,0,6,6,
Oklahoma,U.S. Senate,Connie Johnson,DEM,550002,0,0,24,24,
Oklahoma,U.S. House,Tom Guild,DEM,550002,0,0,16,16,05
Oklahoma,U.S. House,Al Mcaffrey,DEM,550002,0,0,11,11,05
Oklahoma,U.S. House,Leona Leonard,DEM,550002,0,0,9,9,05
Oklahoma,Governor,Dax Ewbank,REP,550002,0,0,8,8,
Oklahoma,Governor,Chad Moody,REP,550002,0,0,19,19,
Oklahoma,Governor,Mary Fallin,REP,550002,0,0,158,158,
Oklahoma,Superintendent of Public Instruction,Brian Kelly,REP,550002,0,0,39,39,
Oklahoma,Superintendent of Public Instruction,Janet Costello Barresi,REP,550002,0,0,71,71,
Oklahoma,Superintendent of Public Instruction,Joy Hofmeister,REP,550002,0,0,67,67,
Oklahoma,Insurance Commissioner,Bill Viner,REP,550002,0,0,36,36,
Oklahoma,Insurance Commissioner,John Doak,REP,550002,0,0,134,134,
Oklahoma,Corporation Commissioner,Todd Hiett,REP,550002,0,0,84,84,
Oklahoma,Corporation Commissioner,Cliff Branan,REP,550002,0,0,85,85,
Oklahoma,U.S. Senate,Evelyn Rogers,REP,550002,0,0,5,5,
Oklahoma,U.S. Senate,Rob Moye,REP,550002,0,0,4,4,
Oklahoma,U.S. Senate,D. Jean Mcbride-Samuels,REP,550002,0,0,4,4,
Oklahoma,U.S. Senate,Jim Inhofe,REP,550002,0,0,168,168,
Oklahoma,U.S. Senate,Erick Paul Wyatt,REP,550002,0,0,5,5,
Oklahoma,U.S. Senate,Andy Craig,REP,550002,0,0,0,0,
Oklahoma,U.S. Senate,T. Shannon,REP,550002,0,0,41,41,
Oklahoma,U.S. Senate,Randy Brogdon,REP,550002,0,0,4,4,
Oklahoma,U.S. Senate,Eric Mccray,REP,550002,0,0,1,1,
Oklahoma,U.S. Senate,Kevin Crow,REP,550002,0,0,0,0,
Oklahoma,U.S. Senate,James Lankford,REP,550002,0,0,141,141,
Oklahoma,U.S. Senate,Jason Weger,REP,550002,0,0,0,0,
Oklahoma,U.S. House,Shane David Jett,REP,550002,0,0,15,15,05
Oklahoma,U.S. House,Patrice Douglas,REP,550002,0,0,43,43,05
Oklahoma,U.S. House,Mike Turner,REP,550002,0,0,33,33,05
Oklahoma,U.S. House,Steve Russell,REP,550002,0,0,59,59,05
Oklahoma,U.S. House,Harvey Sparks,REP,550002,0,0,11,11,05
Oklahoma,U.S. House,Clark Jolley,REP,550002,0,0,17,17,05
Oklahoma,Superintendent of Public Instruction,John Cox,DEM,550003,0,0,30,30,
Oklahoma,Superintendent of Public Instruction,Jack Jr.,DEM,550003,0,0,8,8,
Oklahoma,Superintendent of Public Instruction,Ivan Holmes,DEM,550003,0,0,7,7,
Oklahoma,Superintendent of Public Instruction,Freda Deskin,DEM,550003,0,0,39,39,
Oklahoma,U.S. Senate,Patrick Michael Hayes,DEM,550003,0,0,14,14,
Oklahoma,U.S. Senate,Jim Rogers,DEM,550003,0,0,19,19,
Oklahoma,U.S. Senate,Connie Johnson,DEM,550003,0,0,48,48,
Oklahoma,U.S. House,Tom Guild,DEM,550003,0,0,40,40,05
Oklahoma,U.S. House,Al Mcaffrey,DEM,550003,0,0,25,25,05
Oklahoma,U.S. House,Leona Leonard,DEM,550003,0,0,17,17,05
Oklahoma,Governor,Dax Ewbank,REP,550003,0,0,23,23,
Oklahoma,Governor,Chad Moody,REP,550003,0,0,43,43,
Oklahoma,Governor,Mary Fallin,REP,550003,0,0,224,224,
Oklahoma,Superintendent of Public Instruction,Brian Kelly,REP,550003,0,0,61,61,
Oklahoma,Superintendent of Public Instruction,Janet Costello Barresi,REP,550003,0,0,87,87,
Oklahoma,Superintendent of Public Instruction,Joy Hofmeister,REP,550003,0,0,139,139,
Oklahoma,Insurance Commissioner,Bill Viner,REP,550003,0,0,69,69,
Oklahoma,Insurance Commissioner,John Doak,REP,550003,0,0,202,202,
Oklahoma,Corporation Commissioner,Todd Hiett,REP,550003,0,0,125,125,
Oklahoma,Corporation Commissioner,Cliff Branan,REP,550003,0,0,146,146,
Oklahoma,U.S. Senate,Evelyn Rogers,REP,550003,0,0,14,14,
Oklahoma,U.S. Senate,Rob Moye,REP,550003,0,0,6,6,
Oklahoma,U.S. Senate,D. Jean Mcbride-Samuels,REP,550003,0,0,7,7,
Oklahoma,U.S. Senate,Jim Inhofe,REP,550003,0,0,248,248,
Oklahoma,U.S. Senate,Erick Paul Wyatt,REP,550003,0,0,13,13,
Oklahoma,U.S. Senate,Andy Craig,REP,550003,0,0,0,0,
Oklahoma,U.S. Senate,T. Shannon,REP,550003,0,0,45,45,
Oklahoma,U.S. Senate,Randy Brogdon,REP,550003,0,0,16,16,
Oklahoma,U.S. Senate,Eric Mccray,REP,550003,0,0,1,1,
Oklahoma,U.S. Senate,Kevin Crow,REP,550003,0,0,4,4,
Oklahoma,U.S. Senate,James Lankford,REP,550003,0,0,223,223,
Oklahoma,U.S. Senate,Jason Weger,REP,550003,0,0,1,1,
Oklahoma,U.S. House,Shane David Jett,REP,550003,0,0,33,33,05
Oklahoma,U.S. House,Patrice Douglas,REP,550003,0,0,62,62,05
Oklahoma,U.S. House,Mike Turner,REP,550003,0,0,57,57,05
Oklahoma,U.S. House,Steve Russell,REP,550003,0,0,85,85,05
Oklahoma,U.S. House,Harvey Sparks,REP,550003,0,0,25,25,05
Oklahoma,U.S. House,Clark Jolley,REP,550003,0,0,18,18,05
Oklahoma,Superintendent of Public Instruction,John Cox,DEM,550004,0,0,18,18,
Oklahoma,Superintendent of Public Instruction,Jack Jr.,DEM,550004,0,0,7,7,
Oklahoma,Superintendent of Public Instruction,Ivan Holmes,DEM,550004,0,0,5,5,
Oklahoma,Superintendent of Public Instruction,Freda Deskin,DEM,550004,0,0,49,49,
Oklahoma,U.S. Senate,Patrick Michael Hayes,DEM,550004,0,0,17,17,
Oklahoma,U.S. Senate,Jim Rogers,DEM,550004,0,0,23,23,
Oklahoma,U.S. Senate,Connie Johnson,DEM,550004,0,0,39,39,
Oklahoma,U.S. House,Tom Guild,DEM,550004,0,0,40,40,05
Oklahoma,U.S. House,Al Mcaffrey,DEM,550004,0,0,20,20,05
Oklahoma,U.S. House,Leona Leonard,DEM,550004,0,0,17,17,05
Oklahoma,Governor,Dax Ewbank,REP,550004,0,0,10,10,
Oklahoma,Governor,Chad Moody,REP,550004,0,0,36,36,
Oklahoma,Governor,Mary Fallin,REP,550004,0,0,255,255,
Oklahoma,Superintendent of Public Instruction,Brian Kelly,REP,550004,0,0,62,62,
Oklahoma,Superintendent of Public Instruction,Janet Costello Barresi,REP,550004,0,0,91,91,
Oklahoma,Superintendent of Public Instruction,Joy Hofmeister,REP,550004,0,0,143,143,
Oklahoma,Insurance Commissioner,Bill Viner,REP,550004,0,0,51,51,
Oklahoma,Insurance Commissioner,John Doak,REP,550004,0,0,227,227,
Oklahoma,Corporation Commissioner,Todd Hiett,REP,550004,0,0,111,111,
Oklahoma,Corporation Commissioner,Cliff Branan,REP,550004,0,0,154,154,
Oklahoma,U.S. Senate,Evelyn Rogers,REP,550004,0,0,9,9,
Oklahoma,U.S. Senate,Rob Moye,REP,550004,0,0,4,4,
Oklahoma,U.S. Senate,D. Jean Mcbride-Samuels,REP,550004,0,0,2,2,
Oklahoma,U.S. Senate,Jim Inhofe,REP,550004,0,0,281,281,
Oklahoma,U.S. Senate,Erick Paul Wyatt,REP,550004,0,0,6,6,
Oklahoma,U.S. Senate,Andy Craig,REP,550004,0,0,0,0,
Oklahoma,U.S. Senate,T. Shannon,REP,550004,0,0,49,49,
Oklahoma,U.S. Senate,Randy Brogdon,REP,550004,0,0,4,4,
Oklahoma,U.S. Senate,Eric Mccray,REP,550004,0,0,3,3,
Oklahoma,U.S. Senate,Kevin Crow,REP,550004,0,0,1,1,
Oklahoma,U.S. Senate,James Lankford,REP,550004,0,0,251,251,
Oklahoma,U.S. Senate,Jason Weger,REP,550004,0,0,0,0,
Oklahoma,U.S. House,Shane David Jett,REP,550004,0,0,23,23,05
Oklahoma,U.S. House,Patrice Douglas,REP,550004,0,0,63,63,05
Oklahoma,U.S. House,Mike Turner,REP,550004,0,0,55,55,05
Oklahoma,U.S. House,Steve Russell,REP,550004,0,0,87,87,05
Oklahoma,U.S. House,Harvey Sparks,REP,550004,0,0,38,38,05
Oklahoma,U.S. House,Clark Jolley,REP,550004,0,0,29,29,05
Oklahoma,Superintendent of Public Instruction,John Cox,DEM,550005,0,0,18,18,
Oklahoma,Superintendent of Public Instruction,Jack Jr.,DEM,550005,0,0,4,4,
Oklahoma,Superintendent of Public Instruction,Ivan Holmes,DEM,550005,0,0,5,5,
Oklahoma,Superintendent of Public Instruction,Freda Deskin,DEM,550005,0,0,38,38,
Oklahoma,U.S. Senate,Patrick Michael Hayes,DEM,550005,0,0,11,11,
Oklahoma,U.S. Senate,Jim Rogers,DEM,550005,0,0,17,17,
Oklahoma,U.S. Senate,Connie Johnson,DEM,550005,0,0,37,37,
Oklahoma,U.S. House,Tom Guild,DEM,550005,0,0,30,30,05
Oklahoma,U.S. House,Al Mcaffrey,DEM,550005,0,0,15,15,05
Oklahoma,U.S. House,Leona Leonard,DEM,550005,0,0,20,20,05
Oklahoma,Governor,Dax Ewbank,REP,550005,0,0,20,20,
Oklahoma,Governor,Chad Moody,REP,550005,0,0,28,28,
Oklahoma,Governor,Mary Fallin,REP,550005,0,0,204,204,
Oklahoma,Superintendent of Public Instruction,Brian Kelly,REP,550005,0,0,64,64,
Oklahoma,Superintendent of Public Instruction,Janet Costello Barresi,REP,550005,0,0,54,54,
Oklahoma,Superintendent of Public Instruction,Joy Hofmeister,REP,550005,0,0,131,131,
Oklahoma,Insurance Commissioner,Bill Viner,REP,550005,0,0,49,49,
Oklahoma,Insurance Commissioner,John Doak,REP,550005,0,0,184,184,
Oklahoma,Corporation Commissioner,Todd Hiett,REP,550005,0,0,116,116,
Oklahoma,Corporation Commissioner,Cliff Branan,REP,550005,0,0,117,117,
Oklahoma,U.S. Senate,Evelyn Rogers,REP,550005,0,0,7,7,
Oklahoma,U.S. Senate,Rob Moye,REP,550005,0,0,4,4,
Oklahoma,U.S. Senate,D. Jean Mcbride-Samuels,REP,550005,0,0,2,2,
Oklahoma,U.S. Senate,Jim Inhofe,REP,550005,0,0,225,225,
Oklahoma,U.S. Senate,Erick Paul Wyatt,REP,550005,0,0,10,10,
Oklahoma,U.S. Senate,Andy Craig,REP,550005,0,0,0,0,
Oklahoma,U.S. Senate,T. Shannon,REP,550005,0,0,56,56,
Oklahoma,U.S. Senate,Randy Brogdon,REP,550005,0,0,10,10,
Oklahoma,U.S. Senate,Eric Mccray,REP,550005,0,0,2,2,
Oklahoma,U.S. Senate,Kevin Crow,REP,550005,0,0,2,2,
Oklahoma,U.S. Senate,James Lankford,REP,550005,0,0,182,182,
Oklahoma,U.S. Senate,Jason Weger,REP,550005,0,0,0,0,
Oklahoma,U.S. House,Shane David Jett,REP,550005,0,0,26,26,05
Oklahoma,U.S. House,Patrice Douglas,REP,550005,0,0,43,43,05
Oklahoma,U.S. House,Mike Turner,REP,550005,0,0,48,48,05
Oklahoma,U.S. House,Steve Russell,REP,550005,0,0,75,75,05
Oklahoma,U.S. House,Harvey Sparks,REP,550005,0,0,29,29,05
Oklahoma,U.S. House,Clark Jolley,REP,550005,0,0,22,22,05
Oklahoma,State Senate,Ervin Yen,REP,550005,0,0,64,64,40
Oklahoma,State Senate,Joe Howell,REP,550005,0,0,9,9,40
Oklahoma,State Senate,Michael Taylor,REP,550005,0,0,28,28,40
Oklahoma,State Senate,Brian Winslow,REP,550005,0,0,43,43,40
Oklahoma,State Senate,Steve Kern,REP,550005,0,0,83,83,40
Oklahoma,State Senate,David Hooten,REP,550005,0,0,20,20,40
Oklahoma,Superintendent of Public Instruction,John Cox,DEM,550006,0,0,15,15,
Oklahoma,Superintendent of Public Instruction,Jack Jr.,DEM,550006,0,0,4,4,
Oklahoma,Superintendent of Public Instruction,Ivan Holmes,DEM,550006,0,0,5,5,
Oklahoma,Superintendent of Public Instruction,Freda Deskin,DEM,550006,0,0,27,27,
Oklahoma,U.S. Senate,Patrick Michael Hayes,DEM,550006,0,0,10,10,
Oklahoma,U.S. Senate,Jim Rogers,DEM,550006,0,0,15,15,
Oklahoma,U.S. Senate,Connie Johnson,DEM,550006,0,0,27,27,
Oklahoma,U.S. House,Tom Guild,DEM,550006,0,0,24,24,05
Oklahoma,U.S. House,Al Mcaffrey,DEM,550006,0,0,8,8,05
Oklahoma,U.S. House,Leona Leonard,DEM,550006,0,0,19,19,05
Oklahoma,Governor,Dax Ewbank,REP,550006,0,0,13,13,
Oklahoma,Governor,Chad Moody,REP,550006,0,0,19,19,
Oklahoma,Governor,Mary Fallin,REP,550006,0,0,141,141,
Oklahoma,Superintendent of Public Instruction,Brian Kelly,REP,550006,0,0,52,52,
Oklahoma,Superintendent of Public Instruction,Janet Costello Barresi,REP,550006,0,0,44,44,
Oklahoma,Superintendent of Public Instruction,Joy Hofmeister,REP,550006,0,0,74,74,
Oklahoma,Insurance Commissioner,Bill Viner,REP,550006,0,0,40,40,
Oklahoma,Insurance Commissioner,John Doak,REP,550006,0,0,122,122,
Oklahoma,Corporation Commissioner,Todd Hiett,REP,550006,0,0,77,77,
Oklahoma,Corporation Commissioner,Cliff Branan,REP,550006,0,0,84,84,
Oklahoma,U.S. Senate,Evelyn Rogers,REP,550006,0,0,8,8,
Oklahoma,U.S. Senate,Rob Moye,REP,550006,0,0,4,4,
Oklahoma,U.S. Senate,D. Jean Mcbride-Samuels,REP,550006,0,0,5,5,
Oklahoma,U.S. Senate,Jim Inhofe,REP,550006,0,0,151,151,
Oklahoma,U.S. Senate,Erick Paul Wyatt,REP,550006,0,0,5,5,
Oklahoma,U.S. Senate,Andy Craig,REP,550006,0,0,0,0,
Oklahoma,U.S. Senate,T. Shannon,REP,550006,0,0,37,37,
Oklahoma,U.S. Senate,Randy Brogdon,REP,550006,0,0,5,5,
Oklahoma,U.S. Senate,Eric Mccray,REP,550006,0,0,3,3,
Oklahoma,U.S. Senate,Kevin Crow,REP,550006,0,0,1,1,
Oklahoma,U.S. Senate,James Lankford,REP,550006,0,0,129,129,
Oklahoma,U.S. Senate,Jason Weger,REP,550006,0,0,1,1,
Oklahoma,U.S. House,Shane David Jett,REP,550006,0,0,18,18,05
Oklahoma,U.S. House,Patrice Douglas,REP,550006,0,0,34,34,05
Oklahoma,U.S. House,Mike Turner,REP,550006,0,0,33,33,05
Oklahoma,U.S. House,Steve Russell,REP,550006,0,0,56,56,05
Oklahoma,U.S. House,Harvey Sparks,REP,550006,0,0,13,13,05
Oklahoma,U.S. House,Clark Jolley,REP,550006,0,0,17,17,05
Oklahoma,Superintendent of Public Instruction,John Cox,DEM,550007,0,0,22,22,
Oklahoma,Superintendent of Public Instruction,Jack Jr.,DEM,550007,0,0,13,13,
Oklahoma,Superintendent of Public Instruction,Ivan Holmes,DEM,550007,0,0,3,3,
Oklahoma,Superintendent of Public Instruction,Freda Deskin,DEM,550007,0,0,33,33,
Oklahoma,U.S. Senate,Patrick Michael Hayes,DEM,550007,0,0,10,10,
Oklahoma,U.S. Senate,Jim Rogers,DEM,550007,0,0,19,19,
Oklahoma,U.S. Senate,Connie Johnson,DEM,550007,0,0,39,39,
Oklahoma,U.S. House,Tom Guild,DEM,550007,0,0,40,40,05
Oklahoma,U.S. House,Al Mcaffrey,DEM,550007,0,0,19,19,05
Oklahoma,U.S. House,Leona Leonard,DEM,550007,0,0,11,11,05
Oklahoma,Governor,Dax Ewbank,REP,550007,0,0,24,24,
Oklahoma,Governor,Chad Moody,REP,550007,0,0,24,24,
Oklahoma,Governor,Mary Fallin,REP,550007,0,0,252,252,
Oklahoma,Superintendent of Public Instruction,Brian Kelly,REP,550007,0,0,61,61,
Oklahoma,Superintendent of Public Instruction,Janet Costello Barresi,REP,550007,0,0,86,86,
Oklahoma,Superintendent of Public Instruction,Joy Hofmeister,REP,550007,0,0,149,149,
Oklahoma,Insurance Commissioner,Bill Viner,REP,550007,0,0,68,68,
Oklahoma,Insurance Commissioner,John Doak,REP,550007,0,0,210,210,
Oklahoma,Corporation Commissioner,Todd Hiett,REP,550007,0,0,126,126,
Oklahoma,Corporation Commissioner,Cliff Branan,REP,550007,0,0,142,142,
Oklahoma,U.S. Senate,Evelyn Rogers,REP,550007,0,0,12,12,
Oklahoma,U.S. Senate,Rob Moye,REP,550007,0,0,2,2,
Oklahoma,U.S. Senate,D. Jean Mcbride-Samuels,REP,550007,0,0,2,2,
Oklahoma,U.S. Senate,Jim Inhofe,REP,550007,0,0,278,278,
Oklahoma,U.S. Senate,Erick Paul Wyatt,REP,550007,0,0,7,7,
Oklahoma,U.S. Senate,Andy Craig,REP,550007,0,0,2,2,
Oklahoma,U.S. Senate,T. Shannon,REP,550007,0,0,60,60,
Oklahoma,U.S. Senate,Randy Brogdon,REP,550007,0,0,12,12,
Oklahoma,U.S. Senate,Eric Mccray,REP,550007,0,0,1,1,
Oklahoma,U.S. Senate,Kevin Crow,REP,550007,0,0,0,0,
Oklahoma,U.S. Senate,James Lankford,REP,550007,0,0,228,228,
Oklahoma,U.S. Senate,Jason Weger,REP,550007,0,0,1,1,
Oklahoma,U.S. House,Shane David Jett,REP,550007,0,0,34,34,05
Oklahoma,U.S. House,Patrice Douglas,REP,550007,0,0,72,72,05
Oklahoma,U.S. House,Mike Turner,REP,550007,0,0,38,38,05
Oklahoma,U.S. House,Steve Russell,REP,550007,0,0,88,88,05
Oklahoma,U.S. House,Harvey Sparks,REP,550007,0,0,25,25,05
Oklahoma,U.S. House,Clark Jolley,REP,550007,0,0,34,34,05
Oklahoma,Superintendent of Public Instruction,John Cox,DEM,550008,0,0,12,12,
Oklahoma,Superintendent of Public Instruction,Jack Jr.,DEM,550008,0,0,4,4,
Oklahoma,Superintendent of Public Instruction,Ivan Holmes,DEM,550008,0,0,0,0,
Oklahoma,Superintendent of Public Instruction,Freda Deskin,DEM,550008,0,0,15,15,
Oklahoma,U.S. Senate,Patrick Michael Hayes,DEM,550008,0,0,6,6,
Oklahoma,U.S. Senate,Jim Rogers,DEM,550008,0,0,8,8,
Oklahoma,U.S. Senate,Connie Johnson,DEM,550008,0,0,16,16,
Oklahoma,U.S. House,Tom Guild,DEM,550008,0,0,11,11,05
Oklahoma,U.S. House,Al Mcaffrey,DEM,550008,0,0,9,9,05
Oklahoma,U.S. House,Leona Leonard,DEM,550008,0,0,8,8,05
Oklahoma,Governor,Dax Ewbank,REP,550008,0,0,9,9,
Oklahoma,Governor,Chad Moody,REP,550008,0,0,12,12,
Oklahoma,Governor,Mary Fallin,REP,550008,0,0,165,165,
Oklahoma,Superintendent of Public Instruction,Brian Kelly,REP,550008,0,0,48,48,
Oklahoma,Superintendent of Public Instruction,Janet Costello Barresi,REP,550008,0,0,45,45,
Oklahoma,Superintendent of Public Instruction,Joy Hofmeister,REP,550008,0,0,88,88,
Oklahoma,Insurance Commissioner,Bill Viner,REP,550008,0,0,29,29,
Oklahoma,Insurance Commissioner,John Doak,REP,550008,0,0,133,133,
Oklahoma,Corporation Commissioner,Todd Hiett,REP,550008,0,0,75,75,
Oklahoma,Corporation Commissioner,Cliff Branan,REP,550008,0,0,86,86,
Oklahoma,U.S. Senate,Evelyn Rogers,REP,550008,0,0,3,3,
Oklahoma,U.S. Senate,Rob Moye,REP,550008,0,0,2,2,
Oklahoma,U.S. Senate,D. Jean Mcbride-Samuels,REP,550008,0,0,1,1,
Oklahoma,U.S. Senate,Jim Inhofe,REP,550008,0,0,170,170,
Oklahoma,U.S. Senate,Erick Paul Wyatt,REP,550008,0,0,6,6,
Oklahoma,U.S. Senate,Andy Craig,REP,550008,0,0,0,0,
Oklahoma,U.S. Senate,T. Shannon,REP,550008,0,0,31,31,
Oklahoma,U.S. Senate,Randy Brogdon,REP,550008,0,0,5,5,
Oklahoma,U.S. Senate,Eric Mccray,REP,550008,0,0,2,2,
Oklahoma,U.S. Senate,Kevin Crow,REP,550008,0,0,0,0,
Oklahoma,U.S. Senate,James Lankford,REP,550008,0,0,147,147,
Oklahoma,U.S. Senate,Jason Weger,REP,550008,0,0,2,2,
Oklahoma,U.S. House,Shane David Jett,REP,550008,0,0,15,15,05
Oklahoma,U.S. House,Patrice Douglas,REP,550008,0,0,34,34,05
Oklahoma,U.S. House,Mike Turner,REP,550008,0,0,28,28,05
Oklahoma,U.S. House,Steve Russell,REP,550008,0,0,45,45,05
Oklahoma,U.S. House,Harvey Sparks,REP,550008,0,0,43,43,05
Oklahoma,U.S. House,Clark Jolley,REP,550008,0,0,16,16,05
Oklahoma,Superintendent of Public Instruction,John Cox,DEM,550009,0,0,6,6,
Oklahoma,Superintendent of Public Instruction,Jack Jr.,DEM,550009,0,0,4,4,
Oklahoma,Superintendent of Public Instruction,Ivan Holmes,DEM,550009,0,0,0,0,
Oklahoma,Superintendent of Public Instruction,Freda Deskin,DEM,550009,0,0,10,10,
Oklahoma,U.S. Senate,Patrick Michael Hayes,DEM,550009,0,0,1,1,
Oklahoma,U.S. Senate,Jim Rogers,DEM,550009,0,0,6,6,
Oklahoma,U.S. Senate,Connie Johnson,DEM,550009,0,0,12,12,
Oklahoma,U.S. House,Tom Guild,DEM,550009,0,0,13,13,05
Oklahoma,U.S. House,Al Mcaffrey,DEM,550009,0,0,2,2,05
Oklahoma,U.S. House,Leona Leonard,DEM,550009,0,0,4,4,05
Oklahoma,Governor,Dax Ewbank,REP,550009,0,0,16,16,
Oklahoma,Governor,Chad Moody,REP,550009,0,0,27,27,
Oklahoma,Governor,Mary Fallin,REP,550009,0,0,142,142,
Oklahoma,Superintendent of Public Instruction,Brian Kelly,REP,550009,0,0,36,36,
Oklahoma,Superintendent of Public Instruction,Janet Costello Barresi,REP,550009,0,0,30,30,
Oklahoma,Superintendent of Public Instruction,Joy Hofmeister,REP,550009,0,0,114,114,
Oklahoma,Insurance Commissioner,Bill Viner,REP,550009,0,0,37,37,
Oklahoma,Insurance Commissioner,John Doak,REP,550009,0,0,125,125,
Oklahoma,Corporation Commissioner,Todd Hiett,REP,550009,0,0,70,70,
Oklahoma,Corporation Commissioner,Cliff Branan,REP,550009,0,0,93,93,
Oklahoma,U.S. Senate,Evelyn Rogers,REP,550009,0,0,10,10,
Oklahoma,U.S. Senate,Rob Moye,REP,550009,0,0,2,2,
Oklahoma,U.S. Senate,D. Jean Mcbride-Samuels,REP,550009,0,0,2,2,
Oklahoma,U.S. Senate,Jim Inhofe,REP,550009,0,0,161,161,
Oklahoma,U.S. Senate,Erick Paul Wyatt,REP,550009,0,0,9,9,
Oklahoma,U.S. Senate,Andy Craig,REP,550009,0,0,1,1,
Oklahoma,U.S. Senate,T. Shannon,REP,550009,0,0,42,42,
Oklahoma,U.S. Senate,Randy Brogdon,REP,550009,0,0,2,2,
Oklahoma,U.S. Senate,Eric Mccray,REP,550009,0,0,1,1,
Oklahoma,U.S. Senate,Kevin Crow,REP,550009,0,0,5,5,
Oklahoma,U.S. Senate,James Lankford,REP,550009,0,0,135,135,
Oklahoma,U.S. Senate,Jason Weger,REP,550009,0,0,0,0,
Oklahoma,U.S. House,Shane David Jett,REP,550009,0,0,17,17,05
Oklahoma,U.S. House,Patrice Douglas,REP,550009,0,0,27,27,05
Oklahoma,U.S. House,Mike Turner,REP,550009,0,0,42,42,05
Oklahoma,U.S. House,Steve Russell,REP,550009,0,0,57,57,05
Oklahoma,U.S. House,Harvey Sparks,REP,550009,0,0,19,19,05
Oklahoma,U.S. House,Clark Jolley,REP,550009,0,0,16,16,05
Oklahoma,Superintendent of Public Instruction,John Cox,DEM,550010,0,0,13,13,
Oklahoma,Superintendent of Public Instruction,Jack Jr.,DEM,550010,0,0,1,1,
Oklahoma,Superintendent of Public Instruction,Ivan Holmes,DEM,550010,0,0,1,1,
Oklahoma,Superintendent of Public Instruction,Freda Deskin,DEM,550010,0,0,9,9,
Oklahoma,U.S. Senate,Patrick Michael Hayes,DEM,550010,0,0,5,5,
Oklahoma,U.S. Senate,Jim Rogers,DEM,550010,0,0,11,11,
Oklahoma,U.S. Senate,Connie Johnson,DEM,550010,0,0,10,10,
Oklahoma,U.S. House,Tom Guild,DEM,550010,0,0,8,8,05
Oklahoma,U.S. House,Al Mcaffrey,DEM,550010,0,0,13,13,05
Oklahoma,U.S. House,Leona Leonard,DEM,550010,0,0,4,4,05
Oklahoma,Governor,Dax Ewbank,REP,550010,0,0,8,8,
Oklahoma,Governor,Chad Moody,REP,550010,0,0,27,27,
Oklahoma,Governor,Mary Fallin,REP,550010,0,0,108,108,
Oklahoma,Superintendent of Public Instruction,Brian Kelly,REP,550010,0,0,28,28,
Oklahoma,Superintendent of Public Instruction,Janet Costello Barresi,REP,550010,0,0,35,35,
Oklahoma,Superintendent of Public Instruction,Joy Hofmeister,REP,550010,0,0,81,81,
Oklahoma,Insurance Commissioner,Bill Viner,REP,550010,0,0,25,25,
Oklahoma,Insurance Commissioner,John Doak,REP,550010,0,0,111,111,
Oklahoma,Corporation Commissioner,Todd Hiett,REP,550010,0,0,43,43,
Oklahoma,Corporation Commissioner,Cliff Branan,REP,550010,0,0,91,91,
Oklahoma,U.S. Senate,Evelyn Rogers,REP,550010,0,0,3,3,
Oklahoma,U.S. Senate,Rob Moye,REP,550010,0,0,1,1,
Oklahoma,U.S. Senate,D. Jean Mcbride-Samuels,REP,550010,0,0,0,0,
Oklahoma,U.S. Senate,Jim Inhofe,REP,550010,0,0,132,132,
Oklahoma,U.S. Senate,Erick Paul Wyatt,REP,550010,0,0,6,6,
Oklahoma,U.S. Senate,Andy Craig,REP,550010,0,0,0,0,
Oklahoma,U.S. Senate,T. Shannon,REP,550010,0,0,33,33,
Oklahoma,U.S. Senate,Randy Brogdon,REP,550010,0,0,9,9,
Oklahoma,U.S. Senate,Eric Mccray,REP,550010,0,0,1,1,
Oklahoma,U.S. Senate,Kevin Crow,REP,550010,0,0,2,2,
Oklahoma,U.S. Senate,James Lankford,REP,550010,0,0,98,98,
Oklahoma,U.S. Senate,Jason Weger,REP,550010,0,0,1,1,
Oklahoma,U.S. House,Shane David Jett,REP,550010,0,0,10,10,05
Oklahoma,U.S. House,Patrice Douglas,REP,550010,0,0,37,37,05
Oklahoma,U.S. House,Mike Turner,REP,550010,0,0,20,20,05
Oklahoma,U.S. House,Steve Russell,REP,550010,0,0,45,45,05
Oklahoma,U.S. House,Harvey Sparks,REP,550010,0,0,10,10,05
Oklahoma,U.S. House,Clark Jolley,REP,550010,0,0,15,15,05
Oklahoma,Superintendent of Public Instruction,John Cox,DEM,550011,0,0,22,22,
Oklahoma,Superintendent of Public Instruction,Jack Jr.,DEM,550011,0,0,8,8,
Oklahoma,Superintendent of Public Instruction,Ivan Holmes,DEM,550011,0,0,6,6,
Oklahoma,Superintendent of Public Instruction,Freda Deskin,DEM,550011,0,0,22,22,
Oklahoma,U.S. Senate,Patrick Michael Hayes,DEM,550011,0,0,12,12,
Oklahoma,U.S. Senate,Jim Rogers,DEM,550011,0,0,14,14,
Oklahoma,U.S. Senate,Connie Johnson,DEM,550011,0,0,30,30,
Oklahoma,U.S. House,Tom Guild,DEM,550011,0,0,28,28,05
Oklahoma,U.S. House,Al Mcaffrey,DEM,550011,0,0,17,17,05
Oklahoma,U.S. House,Leona Leonard,DEM,550011,0,0,11,11,05
Oklahoma,Governor,Dax Ewbank,REP,550011,0,0,16,16,
Oklahoma,Governor,Chad Moody,REP,550011,0,0,29,29,
Oklahoma,Governor,Mary Fallin,REP,550011,0,0,136,136,
Oklahoma,Superintendent of Public Instruction,Brian Kelly,REP,550011,0,0,55,55,
Oklahoma,Superintendent of Public Instruction,Janet Costello Barresi,REP,550011,0,0,53,53,
Oklahoma,Superintendent of Public Instruction,Joy Hofmeister,REP,550011,0,0,71,71,
Oklahoma,Insurance Commissioner,Bill Viner,REP,550011,0,0,40,40,
Oklahoma,Insurance Commissioner,John Doak,REP,550011,0,0,129,129,
Oklahoma,Corporation Commissioner,Todd Hiett,REP,550011,0,0,67,67,
Oklahoma,Corporation Commissioner,Cliff Branan,REP,550011,0,0,100,100,
Oklahoma,U.S. Senate,Evelyn Rogers,REP,550011,0,0,5,5,
Oklahoma,U.S. Senate,Rob Moye,REP,550011,0,0,4,4,
Oklahoma,U.S. Senate,D. Jean Mcbride-Samuels,REP,550011,0,0,5,5,
Oklahoma,U.S. Senate,Jim Inhofe,REP,550011,0,0,153,153,
Oklahoma,U.S. Senate,Erick Paul Wyatt,REP,550011,0,0,10,10,
Oklahoma,U.S. Senate,Andy Craig,REP,550011,0,0,1,1,
Oklahoma,U.S. Senate,T. Shannon,REP,550011,0,0,43,43,
Oklahoma,U.S. Senate,Randy Brogdon,REP,550011,0,0,15,15,
Oklahoma,U.S. Senate,Eric Mccray,REP,550011,0,0,3,3,
Oklahoma,U.S. Senate,Kevin Crow,REP,550011,0,0,1,1,
Oklahoma,U.S. Senate,James Lankford,REP,550011,0,0,118,118,
Oklahoma,U.S. Senate,Jason Weger,REP,550011,0,0,1,1,
Oklahoma,U.S. House,Shane David Jett,REP,550011,0,0,12,12,05
Oklahoma,U.S. House,Patrice Douglas,REP,550011,0,0,32,32,05
Oklahoma,U.S. House,Mike Turner,REP,550011,0,0,29,29,05
Oklahoma,U.S. House,Steve Russell,REP,550011,0,0,57,57,05
Oklahoma,U.S. House,Harvey Sparks,REP,550011,0,0,21,21,05
Oklahoma,U.S. House,Clark Jolley,REP,550011,0,0,20,20,05
Oklahoma,State Senate,Ervin Yen,REP,550011,0,0,39,39,40
Oklahoma,State Senate,Joe Howell,REP,550011,0,0,6,6,40
Oklahoma,State Senate,Michael Taylor,REP,550011,0,0,11,11,40
Oklahoma,State Senate,Brian Winslow,REP,550011,0,0,37,37,40
Oklahoma,State Senate,Steve Kern,REP,550011,0,0,71,71,40
Oklahoma,State Senate,David Hooten,REP,550011,0,0,13,13,40
Oklahoma,Superintendent of Public Instruction,John Cox,DEM,550012,0,0,30,30,
Oklahoma,Superintendent of Public Instruction,Jack Jr.,DEM,550012,0,0,18,18,
Oklahoma,Superintendent of Public Instruction,Ivan Holmes,DEM,550012,0,0,5,5,
Oklahoma,Superintendent of Public Instruction,Freda Deskin,DEM,550012,0,0,52,52,
Oklahoma,U.S. Senate,Patrick Michael Hayes,DEM,550012,0,0,18,18,
Oklahoma,U.S. Senate,Jim Rogers,DEM,550012,0,0,17,17,
Oklahoma,U.S. Senate,Connie Johnson,DEM,550012,0,0,69,69,
Oklahoma,U.S. House,Tom Guild,DEM,550012,0,0,47,47,05
Oklahoma,U.S. House,Al Mcaffrey,DEM,550012,0,0,41,41,05
Oklahoma,U.S. House,Leona Leonard,DEM,550012,0,0,15,15,05
Oklahoma,Governor,Dax Ewbank,REP,550012,0,0,30,30,
Oklahoma,Governor,Chad Moody,REP,550012,0,0,51,51,
Oklahoma,Governor,Mary Fallin,REP,550012,0,0,255,255,
Oklahoma,Superintendent of Public Instruction,Brian Kelly,REP,550012,0,0,77,77,
Oklahoma,Superintendent of Public Instruction,Janet Costello Barresi,REP,550012,0,0,109,109,
Oklahoma,Superintendent of Public Instruction,Joy Hofmeister,REP,550012,0,0,146,146,
Oklahoma,Insurance Commissioner,Bill Viner,REP,550012,0,0,70,70,
Oklahoma,Insurance Commissioner,John Doak,REP,550012,0,0,236,236,
Oklahoma,Corporation Commissioner,Todd Hiett,REP,550012,0,0,130,130,
Oklahoma,Corporation Commissioner,Cliff Branan,REP,550012,0,0,174,174,
Oklahoma,U.S. Senate,Evelyn Rogers,REP,550012,0,0,15,15,
Oklahoma,U.S. Senate,Rob Moye,REP,550012,0,0,6,6,
Oklahoma,U.S. Senate,D. Jean Mcbride-Samuels,REP,550012,0,0,4,4,
Oklahoma,U.S. Senate,Jim Inhofe,REP,550012,0,0,301,301,
Oklahoma,U.S. Senate,Erick Paul Wyatt,REP,550012,0,0,10,10,
Oklahoma,U.S. Senate,Andy Craig,REP,550012,0,0,2,2,
Oklahoma,U.S. Senate,T. Shannon,REP,550012,0,0,58,58,
Oklahoma,U.S. Senate,Randy Brogdon,REP,550012,0,0,10,10,
Oklahoma,U.S. Senate,Eric Mccray,REP,550012,0,0,1,1,
Oklahoma,U.S. Senate,Kevin Crow,REP,550012,0,0,4,4,
Oklahoma,U.S. Senate,James Lankford,REP,550012,0,0,266,266,
Oklahoma,U.S. Senate,Jason Weger,REP,550012,0,0,0,0,
Oklahoma,U.S. House,Shane David Jett,REP,550012,0,0,40,40,05
Oklahoma,U.S. House,Patrice Douglas,REP,550012,0,0,73,73,05
Oklahoma,U.S. House,Mike Turner,REP,550012,0,0,61,61,05
Oklahoma,U.S. House,Steve Russell,REP,550012,0,0,80,80,05
Oklahoma,U.S. House,Harvey Sparks,REP,550012,0,0,25,25,05
Oklahoma,U.S. House,Clark Jolley,REP,550012,0,0,45,45,05
Oklahoma,State Senate,Ervin Yen,REP,550012,0,0,87,87,40
Oklahoma,State Senate,Joe Howell,REP,550012,0,0,25,25,40
Oklahoma,State Senate,Michael Taylor,REP,550012,0,0,30,30,40
Oklahoma,State Senate,Brian Winslow,REP,550012,0,0,52,52,40
Oklahoma,State Senate,Steve Kern,REP,550012,0,0,96,96,40
Oklahoma,State Senate,David Hooten,REP,550012,0,0,34,34,40
Oklahoma,Superintendent of Public Instruction,John Cox,DEM,550013,0,0,15,15,
Oklahoma,Superintendent of Public Instruction,Jack Jr.,DEM,550013,0,0,5,5,
Oklahoma,Superintendent of Public Instruction,Ivan Holmes,DEM,550013,0,0,3,3,
Oklahoma,Superintendent of Public Instruction,Freda Deskin,DEM,550013,0,0,24,24,
Oklahoma,U.S. Senate,Patrick Michael Hayes,DEM,550013,0,0,6,6,
Oklahoma,U.S. Senate,Jim Rogers,DEM,550013,0,0,14,14,
Oklahoma,U.S. Senate,Connie Johnson,DEM,550013,0,0,26,26,
Oklahoma,U.S. House,Tom Guild,DEM,550013,0,0,23,23,05
Oklahoma,U.S. House,Al Mcaffrey,DEM,550013,0,0,9,9,05
Oklahoma,U.S. House,Leona Leonard,DEM,550013,0,0,14,14,05
Oklahoma,Governor,Dax Ewbank,REP,550013,0,0,21,21,
Oklahoma,Governor,Chad Moody,REP,550013,0,0,35,35,
Oklahoma,Governor,Mary Fallin,REP,550013,0,0,153,153,
Oklahoma,Superintendent of Public Instruction,Brian Kelly,REP,550013,0,0,47,47,
Oklahoma,Superintendent of Public Instruction,Janet Costello Barresi,REP,550013,0,0,45,45,
Oklahoma,Superintendent of Public Instruction,Joy Hofmeister,REP,550013,0,0,116,116,
Oklahoma,Insurance Commissioner,Bill Viner,REP,550013,0,0,48,48,
Oklahoma,Insurance Commissioner,John Doak,REP,550013,0,0,149,149,
Oklahoma,Corporation Commissioner,Todd Hiett,REP,550013,0,0,87,87,
Oklahoma,Corporation Commissioner,Cliff Branan,REP,550013,0,0,110,110,
Oklahoma,U.S. Senate,Evelyn Rogers,REP,550013,0,0,7,7,
Oklahoma,U.S. Senate,Rob Moye,REP,550013,0,0,5,5,
Oklahoma,U.S. Senate,D. Jean Mcbride-Samuels,REP,550013,0,0,7,7,
Oklahoma,U.S. Senate,Jim Inhofe,REP,550013,0,0,181,181,
Oklahoma,U.S. Senate,Erick Paul Wyatt,REP,550013,0,0,8,8,
Oklahoma,U.S. Senate,Andy Craig,REP,550013,0,0,2,2,
Oklahoma,U.S. Senate,T. Shannon,REP,550013,0,0,50,50,
Oklahoma,U.S. Senate,Randy Brogdon,REP,550013,0,0,9,9,
Oklahoma,U.S. Senate,Eric Mccray,REP,550013,0,0,3,3,
Oklahoma,U.S. Senate,Kevin Crow,REP,550013,0,0,2,2,
Oklahoma,U.S. Senate,James Lankford,REP,550013,0,0,148,148,
Oklahoma,U.S. Senate,Jason Weger,REP,550013,0,0,2,2,
Oklahoma,U.S. House,Shane David Jett,REP,550013,0,0,25,25,05
Oklahoma,U.S. House,Patrice Douglas,REP,550013,0,0,52,52,05
Oklahoma,U.S. House,Mike Turner,REP,550013,0,0,24,24,05
Oklahoma,U.S. House,Steve Russell,REP,550013,0,0,62,62,05
Oklahoma,U.S. House,Harvey Sparks,REP,550013,0,0,18,18,05
Oklahoma,U.S. House,Clark Jolley,REP,550013,0,0,28,28,05
Oklahoma,Superintendent of Public Instruction,John Cox,DEM,550014,0,0,17,17,
Oklahoma,Superintendent of Public Instruction,Jack Jr.,DEM,550014,0,0,9,9,
Oklahoma,Superintendent of Public Instruction,Ivan Holmes,DEM,550014,0,0,10,10,
Oklahoma,Superintendent of Public Instruction,Freda Deskin,DEM,550014,0,0,34,34,
Oklahoma,U.S. Senate,Patrick Michael Hayes,DEM,550014,0,0,12,12,
Oklahoma,U.S. Senate,Jim Rogers,DEM,550014,0,0,17,17,
Oklahoma,U.S. Senate,Connie Johnson,DEM,550014,0,0,41,41,
Oklahoma,U.S. House,Tom Guild,DEM,550014,0,0,32,32,05
Oklahoma,U.S. House,Al Mcaffrey,DEM,550014,0,0,20,20,05
Oklahoma,U.S. House,Leona Leonard,DEM,550014,0,0,16,16,05
Oklahoma,Governor,Dax Ewbank,REP,550014,0,0,13,13,
Oklahoma,Governor,Chad Moody,REP,550014,0,0,23,23,
Oklahoma,Governor,Mary Fallin,REP,550014,0,0,167,167,
Oklahoma,Superintendent of Public Instruction,Brian Kelly,REP,550014,0,0,49,49,
Oklahoma,Superintendent of Public Instruction,Janet Costello Barresi,REP,550014,0,0,72,72,
Oklahoma,Superintendent of Public Instruction,Joy Hofmeister,REP,550014,0,0,78,78,
Oklahoma,Insurance Commissioner,Bill Viner,REP,550014,0,0,31,31,
Oklahoma,Insurance Commissioner,John Doak,REP,550014,0,0,159,159,
Oklahoma,Corporation Commissioner,Todd Hiett,REP,550014,0,0,94,94,
Oklahoma,Corporation Commissioner,Cliff Branan,REP,550014,0,0,91,91,
Oklahoma,U.S. Senate,Evelyn Rogers,REP,550014,0,0,8,8,
Oklahoma,U.S. Senate,Rob Moye,REP,550014,0,0,2,2,
Oklahoma,U.S. Senate,D. Jean Mcbride-Samuels,REP,550014,0,0,1,1,
Oklahoma,U.S. Senate,Jim Inhofe,REP,550014,0,0,178,178,
Oklahoma,U.S. Senate,Erick Paul Wyatt,REP,550014,0,0,13,13,
Oklahoma,U.S. Senate,Andy Craig,REP,550014,0,0,2,2,
Oklahoma,U.S. Senate,T. Shannon,REP,550014,0,0,38,38,
Oklahoma,U.S. Senate,Randy Brogdon,REP,550014,0,0,6,6,
Oklahoma,U.S. Senate,Eric Mccray,REP,550014,0,0,2,2,
Oklahoma,U.S. Senate,Kevin Crow,REP,550014,0,0,3,3,
Oklahoma,U.S. Senate,James Lankford,REP,550014,0,0,154,154,
Oklahoma,U.S. Senate,Jason Weger,REP,550014,0,0,0,0,
Oklahoma,U.S. House,Shane David Jett,REP,550014,0,0,19,19,05
Oklahoma,U.S. House,Patrice Douglas,REP,550014,0,0,52,52,05
Oklahoma,U.S. House,Mike Turner,REP,550014,0,0,30,30,05
Oklahoma,U.S. House,Steve Russell,REP,550014,0,0,48,48,05
Oklahoma,U.S. House,Harvey Sparks,REP,550014,0,0,19,19,05
Oklahoma,U.S. House,Clark Jolley,REP,550014,0,0,25,25,05
Oklahoma,Superintendent of Public Instruction,John Cox,DEM,550015,0,0,26,26,
Oklahoma,Superintendent of Public Instruction,Jack Jr.,DEM,550015,0,0,11,11,
Oklahoma,Superintendent of Public Instruction,Ivan Holmes,DEM,550015,0,0,8,8,
Oklahoma,Superintendent of Public Instruction,Freda Deskin,DEM,550015,0,0,47,47,
Oklahoma,U.S. Senate,Patrick Michael Hayes,DEM,550015,0,0,28,28,
Oklahoma,U.S. Senate,Jim Rogers,DEM,550015,0,0,16,16,
Oklahoma,U.S. Senate,Connie Johnson,DEM,550015,0,0,45,45,
Oklahoma,U.S. House,Tom Guild,DEM,550015,0,0,33,33,05
Oklahoma,U.S. House,Al Mcaffrey,DEM,550015,0,0,29,29,05
Oklahoma,U.S. House,Leona Leonard,DEM,550015,0,0,29,29,05
Oklahoma,Governor,Dax Ewbank,REP,550015,0,0,14,14,
Oklahoma,Governor,Chad Moody,REP,550015,0,0,38,38,
Oklahoma,Governor,Mary Fallin,REP,550015,0,0,205,205,
Oklahoma,Superintendent of Public Instruction,Brian Kelly,REP,550015,0,0,67,67,
Oklahoma,Superintendent of Public Instruction,Janet Costello Barresi,REP,550015,0,0,81,81,
Oklahoma,Superintendent of Public Instruction,Joy Hofmeister,REP,550015,0,0,100,100,
Oklahoma,Insurance Commissioner,Bill Viner,REP,550015,0,0,59,59,
Oklahoma,Insurance Commissioner,John Doak,REP,550015,0,0,180,180,
Oklahoma,Corporation Commissioner,Todd Hiett,REP,550015,0,0,114,114,
Oklahoma,Corporation Commissioner,Cliff Branan,REP,550015,0,0,116,116,
Oklahoma,U.S. Senate,Evelyn Rogers,REP,550015,0,0,13,13,
Oklahoma,U.S. Senate,Rob Moye,REP,550015,0,0,3,3,
Oklahoma,U.S. Senate,D. Jean Mcbride-Samuels,REP,550015,0,0,9,9,
Oklahoma,U.S. Senate,Jim Inhofe,REP,550015,0,0,224,224,
Oklahoma,U.S. Senate,Erick Paul Wyatt,REP,550015,0,0,5,5,
Oklahoma,U.S. Senate,Andy Craig,REP,550015,0,0,5,5,
Oklahoma,U.S. Senate,T. Shannon,REP,550015,0,0,51,51,
Oklahoma,U.S. Senate,Randy Brogdon,REP,550015,0,0,4,4,
Oklahoma,U.S. Senate,Eric Mccray,REP,550015,0,0,2,2,
Oklahoma,U.S. Senate,Kevin Crow,REP,550015,0,0,1,1,
Oklahoma,U.S. Senate,James Lankford,REP,550015,0,0,197,197,
Oklahoma,U.S. Senate,Jason Weger,REP,550015,0,0,1,1,
Oklahoma,U.S. House,Shane David Jett,REP,550015,0,0,33,33,05
Oklahoma,U.S. House,Patrice Douglas,REP,550015,0,0,50,50,05
Oklahoma,U.S. House,Mike Turner,REP,550015,0,0,41,41,05
Oklahoma,U.S. House,Steve Russell,REP,550015,0,0,71,71,05
Oklahoma,U.S. House,Harvey Sparks,REP,550015,0,0,21,21,05
Oklahoma,U.S. House,Clark Jolley,REP,550015,0,0,25,25,05
Oklahoma,State Senate,Ervin Yen,REP,550015,0,0,68,68,40
Oklahoma,State Senate,Joe Howell,REP,550015,0,0,14,14,40
Oklahoma,State Senate,Michael Taylor,REP,550015,0,0,37,37,40
Oklahoma,State Senate,Brian Winslow,REP,550015,0,0,48,48,40
Oklahoma,State Senate,Steve Kern,REP,550015,0,0,55,55,40
Oklahoma,State Senate,David Hooten,REP,550015,0,0,24,24,40
Oklahoma,Superintendent of Public Instruction,John Cox,DEM,550016,0,0,10,10,
Oklahoma,Superintendent of Public Instruction,Jack Jr.,DEM,550016,0,0,0,0,
Oklahoma,Superintendent of Public Instruction,Ivan Holmes,DEM,550016,0,0,1,1,
Oklahoma,Superintendent of Public Instruction,Freda Deskin,DEM,550016,0,0,6,6,
Oklahoma,U.S. Senate,Patrick Michael Hayes,DEM,550016,0,0,4,4,
Oklahoma,U.S. Senate,Jim Rogers,DEM,550016,0,0,1,1,
Oklahoma,U.S. Senate,Connie Johnson,DEM,550016,0,0,12,12,
Oklahoma,U.S. House,Tom Guild,DEM,550016,0,0,8,8,05
Oklahoma,U.S. House,Al Mcaffrey,DEM,550016,0,0,6,6,05
Oklahoma,U.S. House,Leona Leonard,DEM,550016,0,0,2,2,05
Oklahoma,Governor,Dax Ewbank,REP,550016,0,0,3,3,
Oklahoma,Governor,Chad Moody,REP,550016,0,0,15,15,
Oklahoma,Governor,Mary Fallin,REP,550016,0,0,62,62,
Oklahoma,Superintendent of Public Instruction,Brian Kelly,REP,550016,0,0,16,16,
Oklahoma,Superintendent of Public Instruction,Janet Costello Barresi,REP,550016,0,0,24,24,
Oklahoma,Superintendent of Public Instruction,Joy Hofmeister,REP,550016,0,0,42,42,
Oklahoma,Insurance Commissioner,Bill Viner,REP,550016,0,0,15,15,
Oklahoma,Insurance Commissioner,John Doak,REP,550016,0,0,65,65,
Oklahoma,Corporation Commissioner,Todd Hiett,REP,550016,0,0,35,35,
Oklahoma,Corporation Commissioner,Cliff Branan,REP,550016,0,0,40,40,
Oklahoma,U.S. Senate,Evelyn Rogers,REP,550016,0,0,5,5,
Oklahoma,U.S. Senate,Rob Moye,REP,550016,0,0,1,1,
Oklahoma,U.S. Senate,D. Jean Mcbride-Samuels,REP,550016,0,0,2,2,
Oklahoma,U.S. Senate,Jim Inhofe,REP,550016,0,0,73,73,
Oklahoma,U.S. Senate,Erick Paul Wyatt,REP,550016,0,0,2,2,
Oklahoma,U.S. Senate,Andy Craig,REP,550016,0,0,0,0,
Oklahoma,U.S. Senate,T. Shannon,REP,550016,0,0,12,12,
Oklahoma,U.S. Senate,Randy Brogdon,REP,550016,0,0,2,2,
Oklahoma,U.S. Senate,Eric Mccray,REP,550016,0,0,0,0,
Oklahoma,U.S. Senate,Kevin Crow,REP,550016,0,0,0,0,
Oklahoma,U.S. Senate,James Lankford,REP,550016,0,0,68,68,
Oklahoma,U.S. Senate,Jason Weger,REP,550016,0,0,2,2,
Oklahoma,U.S. House,Shane David Jett,REP,550016,0,0,7,7,05
Oklahoma,U.S. House,Patrice Douglas,REP,550016,0,0,25,25,05
Oklahoma,U.S. House,Mike Turner,REP,550016,0,0,10,10,05
Oklahoma,U.S. House,Steve Russell,REP,550016,0,0,22,22,05
Oklahoma,U.S. House,Harvey Sparks,REP,550016,0,0,7,7,05
Oklahoma,U.S. House,Clark Jolley,REP,550016,0,0,9,9,05
Oklahoma,State Senate,Ervin Yen,REP,550016,0,0,47,47,40
Oklahoma,State Senate,Joe Howell,REP,550016,0,0,4,4,40
Oklahoma,State Senate,Michael Taylor,REP,550016,0,0,5,5,40
Oklahoma,State Senate,Brian Winslow,REP,550016,0,0,7,7,40
Oklahoma,State Senate,Steve Kern,REP,550016,0,0,13,13,40
Oklahoma,State Senate,David Hooten,REP,550016,0,0,8,8,40
Oklahoma,Superintendent of Public Instruction,John Cox,DEM,550017,0,0,0,0,
Oklahoma,Superintendent of Public Instruction,Jack Jr.,DEM,550017,0,0,0,0,
Oklahoma,Superintendent of Public Instruction,Ivan Holmes,DEM,550017,0,0,0,0,
Oklahoma,Superintendent of Public Instruction,Freda Deskin,DEM,550017,0,0,0,0,
Oklahoma,U.S. Senate,Patrick Michael Hayes,DEM,550017,0,0,0,0,
Oklahoma,U.S. Senate,Jim Rogers,DEM,550017,0,0,0,0,
Oklahoma,U.S. Senate,Connie Johnson,DEM,550017,0,0,0,0,
Oklahoma,U.S. House,Tom Guild,DEM,550017,0,0,0,0,05
Oklahoma,U.S. House,Al Mcaffrey,DEM,550017,0,0,0,0,05
Oklahoma,U.S. House,Leona Leonard,DEM,550017,0,0,0,0,05
Oklahoma,Governor,Dax Ewbank,REP,550017,0,0,0,0,
Oklahoma,Governor,Chad Moody,REP,550017,0,0,0,0,
Oklahoma,Governor,Mary Fallin,REP,550017,0,0,0,0,
Oklahoma,Superintendent of Public Instruction,Brian Kelly,REP,550017,0,0,0,0,
Oklahoma,Superintendent of Public Instruction,Janet Costello Barresi,REP,550017,0,0,0,0,
Oklahoma,Superintendent of Public Instruction,Joy Hofmeister,REP,550017,0,0,0,0,
Oklahoma,Insurance Commissioner,Bill Viner,REP,550017,0,0,0,0,
Oklahoma,Insurance Commissioner,John Doak,REP,550017,0,0,0,0,
Oklahoma,Corporation Commissioner,Todd Hiett,REP,550017,0,0,0,0,
Oklahoma,Corporation Commissioner,Cliff Branan,REP,550017,0,0,0,0,
Oklahoma,U.S. Senate,Evelyn Rogers,REP,550017,0,0,0,0,
Oklahoma,U.S. Senate,Rob Moye,REP,550017,0,0,0,0,
Oklahoma,U.S. Senate,D. Jean Mcbride-Samuels,REP,550017,0,0,0,0,
Oklahoma,U.S. Senate,Jim Inhofe,REP,550017,0,0,0,0,
Oklahoma,U.S. Senate,Erick Paul Wyatt,REP,550017,0,0,0,0,
Oklahoma,U.S. Senate,Andy Craig,REP,550017,0,0,0,0,
Oklahoma,U.S. Senate,T. Shannon,REP,550017,0,0,0,0,
Oklahoma,U.S. Senate,Randy Brogdon,REP,550017,0,0,0,0,
Oklahoma,U.S. Senate,Eric Mccray,REP,550017,0,0,0,0,
Oklahoma,U.S. Senate,Kevin Crow,REP,550017,0,0,0,0,
Oklahoma,U.S. Senate,James Lankford,REP,550017,0,0,0,0,
Oklahoma,U.S. Senate,Jason Weger,REP,550017,0,0,0,0,
Oklahoma,U.S. House,Shane David Jett,REP,550017,0,0,0,0,05
Oklahoma,U.S. House,Patrice Douglas,REP,550017,0,0,0,0,05
Oklahoma,U.S. House,Mike Turner,REP,550017,0,0,0,0,05
Oklahoma,U.S. House,Steve Russell,REP,550017,0,0,0,0,05
Oklahoma,U.S. House,Harvey Sparks,REP,550017,0,0,0,0,05
Oklahoma,U.S. House,Clark Jolley,REP,550017,0,0,0,0,05
Oklahoma,Superintendent of Public Instruction,John Cox,DEM,550018,0,0,16,16,
Oklahoma,Superintendent of Public Instruction,Jack Jr.,DEM,550018,0,0,4,4,
Oklahoma,Superintendent of Public Instruction,Ivan Holmes,DEM,550018,0,0,1,1,
Oklahoma,Superintendent of Public Instruction,Freda Deskin,DEM,550018,0,0,15,15,
Oklahoma,U.S. Senate,Patrick Michael Hayes,DEM,550018,0,0,12,12,
Oklahoma,U.S. Senate,Jim Rogers,DEM,550018,0,0,8,8,
Oklahoma,U.S. Senate,Connie Johnson,DEM,550018,0,0,16,16,
Oklahoma,U.S. House,Tom Guild,DEM,550018,0,0,22,22,05
Oklahoma,U.S. House,Al Mcaffrey,DEM,550018,0,0,7,7,05
Oklahoma,U.S. House,Leona Leonard,DEM,550018,0,0,6,6,05
Oklahoma,Governor,Dax Ewbank,REP,550018,0,0,9,9,
Oklahoma,Governor,Chad Moody,REP,550018,0,0,11,11,
Oklahoma,Governor,Mary Fallin,REP,550018,0,0,50,50,
Oklahoma,Superintendent of Public Instruction,Brian Kelly,REP,550018,0,0,15,15,
Oklahoma,Superintendent of Public Instruction,Janet Costello Barresi,REP,550018,0,0,14,14,
Oklahoma,Superintendent of Public Instruction,Joy Hofmeister,REP,550018,0,0,38,38,
Oklahoma,Insurance Commissioner,Bill Viner,REP,550018,0,0,12,12,
Oklahoma,Insurance Commissioner,John Doak,REP,550018,0,0,54,54,
Oklahoma,Corporation Commissioner,Todd Hiett,REP,550018,0,0,35,35,
Oklahoma,Corporation Commissioner,Cliff Branan,REP,550018,0,0,30,30,
Oklahoma,U.S. Senate,Evelyn Rogers,REP,550018,0,0,3,3,
Oklahoma,U.S. Senate,Rob Moye,REP,550018,0,0,1,1,
Oklahoma,U.S. Senate,D. Jean Mcbride-Samuels,REP,550018,0,0,1,1,
Oklahoma,U.S. Senate,Jim Inhofe,REP,550018,0,0,60,60,
Oklahoma,U.S. Senate,Erick Paul Wyatt,REP,550018,0,0,5,5,
Oklahoma,U.S. Senate,Andy Craig,REP,550018,0,0,0,0,
Oklahoma,U.S. Senate,T. Shannon,REP,550018,0,0,15,15,
Oklahoma,U.S. Senate,Randy Brogdon,REP,550018,0,0,2,2,
Oklahoma,U.S. Senate,Eric Mccray,REP,550018,0,0,1,1,
Oklahoma,U.S. Senate,Kevin Crow,REP,550018,0,0,1,1,
Oklahoma,U.S. Senate,James Lankford,REP,550018,0,0,51,51,
Oklahoma,U.S. Senate,Jason Weger,REP,550018,0,0,0,0,
Oklahoma,U.S. House,Shane David Jett,REP,550018,0,0,10,10,05
Oklahoma,U.S. House,Patrice Douglas,REP,550018,0,0,10,10,05
Oklahoma,U.S. House,Mike Turner,REP,550018,0,0,9,9,05
Oklahoma,U.S. House,Steve Russell,REP,550018,0,0,20,20,05
Oklahoma,U.S. House,Harvey Sparks,REP,550018,0,0,4,4,05
Oklahoma,U.S. House,Clark Jolley,REP,550018,0,0,16,16,05
Oklahoma,Superintendent of Public Instruction,John Cox,DEM,550019,0,0,22,22,
Oklahoma,Superintendent of Public Instruction,Jack Jr.,DEM,550019,0,0,11,11,
Oklahoma,Superintendent of Public Instruction,Ivan Holmes,DEM,550019,0,0,5,5,
Oklahoma,Superintendent of Public Instruction,Freda Deskin,DEM,550019,0,0,38,38,
Oklahoma,U.S. Senate,Patrick Michael Hayes,DEM,550019,0,0,10,10,
Oklahoma,U.S. Senate,Jim Rogers,DEM,550019,0,0,31,31,
Oklahoma,U.S. Senate,Connie Johnson,DEM,550019,0,0,37,37,
Oklahoma,U.S. House,Tom Guild,DEM,550019,0,0,47,47,05
Oklahoma,U.S. House,Al Mcaffrey,DEM,550019,0,0,11,11,05
Oklahoma,U.S. House,Leona Leonard,DEM,550019,0,0,20,20,05
Oklahoma,Governor,Dax Ewbank,REP,550019,0,0,20,20,
Oklahoma,Governor,Chad Moody,REP,550019,0,0,67,67,
Oklahoma,Governor,Mary Fallin,REP,550019,0,0,166,166,
Oklahoma,Superintendent of Public Instruction,Brian Kelly,REP,550019,0,0,64,64,
Oklahoma,Superintendent of Public Instruction,Janet Costello Barresi,REP,550019,0,0,44,44,
Oklahoma,Superintendent of Public Instruction,Joy Hofmeister,REP,550019,0,0,143,143,
Oklahoma,Insurance Commissioner,Bill Viner,REP,550019,0,0,54,54,
Oklahoma,Insurance Commissioner,John Doak,REP,550019,0,0,174,174,
Oklahoma,Corporation Commissioner,Todd Hiett,REP,550019,0,0,111,111,
Oklahoma,Corporation Commissioner,Cliff Branan,REP,550019,0,0,116,116,
Oklahoma,U.S. Senate,Evelyn Rogers,REP,550019,0,0,11,11,
Oklahoma,U.S. Senate,Rob Moye,REP,550019,0,0,8,8,
Oklahoma,U.S. Senate,D. Jean Mcbride-Samuels,REP,550019,0,0,3,3,
Oklahoma,U.S. Senate,Jim Inhofe,REP,550019,0,0,221,221,
Oklahoma,U.S. Senate,Erick Paul Wyatt,REP,550019,0,0,7,7,
Oklahoma,U.S. Senate,Andy Craig,REP,550019,0,0,3,3,
Oklahoma,U.S. Senate,T. Shannon,REP,550019,0,0,71,71,
Oklahoma,U.S. Senate,Randy Brogdon,REP,550019,0,0,9,9,
Oklahoma,U.S. Senate,Eric Mccray,REP,550019,0,0,4,4,
Oklahoma,U.S. Senate,Kevin Crow,REP,550019,0,0,1,1,
Oklahoma,U.S. Senate,James Lankford,REP,550019,0,0,164,164,
Oklahoma,U.S. Senate,Jason Weger,REP,550019,0,0,0,0,
Oklahoma,U.S. House,Shane David Jett,REP,550019,0,0,40,40,05
Oklahoma,U.S. House,Patrice Douglas,REP,550019,0,0,43,43,05
Oklahoma,U.S. House,Mike Turner,REP,550019,0,0,48,48,05
Oklahoma,U.S. House,Steve Russell,REP,550019,0,0,75,75,05
Oklahoma,U.S. House,Harvey Sparks,REP,550019,0,0,11,11,05
Oklahoma,U.S. House,Clark Jolley,REP,550019,0,0,24,24,05
Oklahoma,Superintendent of Public Instruction,John Cox,DEM,550020,0,0,31,31,
Oklahoma,Superintendent of Public Instruction,Jack Jr.,DEM,550020,0,0,4,4,
Oklahoma,Superintendent of Public Instruction,Ivan Holmes,DEM,550020,0,0,3,3,
Oklahoma,Superintendent of Public Instruction,Freda Deskin,DEM,550020,0,0,37,37,
Oklahoma,U.S. Senate,Patrick Michael Hayes,DEM,550020,0,0,18,18,
Oklahoma,U.S. Senate,Jim Rogers,DEM,550020,0,0,24,24,
Oklahoma,U.S. Senate,Connie Johnson,DEM,550020,0,0,32,32,
Oklahoma,U.S. House,Tom Guild,DEM,550020,0,0,34,34,05
Oklahoma,U.S. House,Al Mcaffrey,DEM,550020,0,0,22,22,05
Oklahoma,U.S. House,Leona Leonard,DEM,550020,0,0,17,17,05
Oklahoma,Governor,Dax Ewbank,REP,550020,0,0,33,33,
Oklahoma,Governor,Chad Moody,REP,550020,0,0,57,57,
Oklahoma,Governor,Mary Fallin,REP,550020,0,0,259,259,
Oklahoma,Superintendent of Public Instruction,Brian Kelly,REP,550020,0,0,69,69,
Oklahoma,Superintendent of Public Instruction,Janet Costello Barresi,REP,550020,0,0,78,78,
Oklahoma,Superintendent of Public Instruction,Joy Hofmeister,REP,550020,0,0,193,193,
Oklahoma,Insurance Commissioner,Bill Viner,REP,550020,0,0,83,83,
Oklahoma,Insurance Commissioner,John Doak,REP,550020,0,0,240,240,
Oklahoma,Corporation Commissioner,Todd Hiett,REP,550020,0,0,138,138,
Oklahoma,Corporation Commissioner,Cliff Branan,REP,550020,0,0,177,177,
Oklahoma,U.S. Senate,Evelyn Rogers,REP,550020,0,0,15,15,
Oklahoma,U.S. Senate,Rob Moye,REP,550020,0,0,10,10,
Oklahoma,U.S. Senate,D. Jean Mcbride-Samuels,REP,550020,0,0,2,2,
Oklahoma,U.S. Senate,Jim Inhofe,REP,550020,0,0,302,302,
Oklahoma,U.S. Senate,Erick Paul Wyatt,REP,550020,0,0,10,10,
Oklahoma,U.S. Senate,Andy Craig,REP,550020,0,0,3,3,
Oklahoma,U.S. Senate,T. Shannon,REP,550020,0,0,74,74,
Oklahoma,U.S. Senate,Randy Brogdon,REP,550020,0,0,18,18,
Oklahoma,U.S. Senate,Eric Mccray,REP,550020,0,0,0,0,
Oklahoma,U.S. Senate,Kevin Crow,REP,550020,0,0,2,2,
Oklahoma,U.S. Senate,James Lankford,REP,550020,0,0,255,255,
Oklahoma,U.S. Senate,Jason Weger,REP,550020,0,0,0,0,
Oklahoma,U.S. House,Shane David Jett,REP,550020,0,0,42,42,05
Oklahoma,U.S. House,Patrice Douglas,REP,550020,0,0,74,74,05
Oklahoma,U.S. House,Mike Turner,REP,550020,0,0,40,40,05
Oklahoma,U.S. House,Steve Russell,REP,550020,0,0,118,118,05
Oklahoma,U.S. House,Harvey Sparks,REP,550020,0,0,17,17,05
Oklahoma,U.S. House,Clark Jolley,REP,550020,0,0,45,45,05
Oklahoma,Superintendent of Public Instruction,John Cox,DEM,550021,0,0,31,31,
Oklahoma,Superintendent of Public Instruction,Jack Jr.,DEM,550021,0,0,13,13,
Oklahoma,Superintendent of Public Instruction,Ivan Holmes,DEM,550021,0,0,9,9,
Oklahoma,Superintendent of Public Instruction,Freda Deskin,DEM,550021,0,0,58,58,
Oklahoma,U.S. Senate,Patrick Michael Hayes,DEM,550021,0,0,33,33,
Oklahoma,U.S. Senate,Jim Rogers,DEM,550021,0,0,28,28,
Oklahoma,U.S. Senate,Connie Johnson,DEM,550021,0,0,51,51,
Oklahoma,U.S. House,Tom Guild,DEM,550021,0,0,47,47,05
Oklahoma,U.S. House,Al Mcaffrey,DEM,550021,0,0,30,30,05
Oklahoma,U.S. House,Leona Leonard,DEM,550021,0,0,32,32,05
Oklahoma,Governor,Dax Ewbank,REP,550021,0,0,28,28,
Oklahoma,Governor,Chad Moody,REP,550021,0,0,60,60,
Oklahoma,Governor,Mary Fallin,REP,550021,0,0,312,312,
Oklahoma,Superintendent of Public Instruction,Brian Kelly,REP,550021,0,0,103,103,
Oklahoma,Superintendent of Public Instruction,Janet Costello Barresi,REP,550021,0,0,85,85,
Oklahoma,Superintendent of Public Instruction,Joy Hofmeister,REP,550021,0,0,201,201,
Oklahoma,Insurance Commissioner,Bill Viner,REP,550021,0,0,91,91,
Oklahoma,Insurance Commissioner,John Doak,REP,550021,0,0,274,274,
Oklahoma,Corporation Commissioner,Todd Hiett,REP,550021,0,0,156,156,
Oklahoma,Corporation Commissioner,Cliff Branan,REP,550021,0,0,204,204,
Oklahoma,U.S. Senate,Evelyn Rogers,REP,550021,0,0,24,24,
Oklahoma,U.S. Senate,Rob Moye,REP,550021,0,0,14,14,
Oklahoma,U.S. Senate,D. Jean Mcbride-Samuels,REP,550021,0,0,4,4,
Oklahoma,U.S. Senate,Jim Inhofe,REP,550021,0,0,335,335,
Oklahoma,U.S. Senate,Erick Paul Wyatt,REP,550021,0,0,16,16,
Oklahoma,U.S. Senate,Andy Craig,REP,550021,0,0,0,0,
Oklahoma,U.S. Senate,T. Shannon,REP,550021,0,0,98,98,
Oklahoma,U.S. Senate,Randy Brogdon,REP,550021,0,0,15,15,
Oklahoma,U.S. Senate,Eric Mccray,REP,550021,0,0,4,4,
Oklahoma,U.S. Senate,Kevin Crow,REP,550021,0,0,9,9,
Oklahoma,U.S. Senate,James Lankford,REP,550021,0,0,278,278,
Oklahoma,U.S. Senate,Jason Weger,REP,550021,0,0,1,1,
Oklahoma,U.S. House,Shane David Jett,REP,550021,0,0,47,47,05
Oklahoma,U.S. House,Patrice Douglas,REP,550021,0,0,80,80,05
Oklahoma,U.S. House,Mike Turner,REP,550021,0,0,56,56,05
Oklahoma,U.S. House,Steve Russell,REP,550021,0,0,128,128,05
Oklahoma,U.S. House,Harvey Sparks,REP,550021,0,0,15,15,05
Oklahoma,U.S. House,Clark Jolley,REP,550021,0,0,58,58,05
Oklahoma,State House,A. Bailey,REP,550021,0,0,79,79,10
Oklahoma,State House,Gary Banz,REP,550021,0,0,294,294,10
Oklahoma,Superintendent of Public Instruction,John Cox,DEM,550022,0,0,21,21,
Oklahoma,Superintendent of Public Instruction,Jack Jr.,DEM,550022,0,0,4,4,
Oklahoma,Superintendent of Public Instruction,Ivan Holmes,DEM,550022,0,0,3,3,
Oklahoma,Superintendent of Public Instruction,Freda Deskin,DEM,550022,0,0,20,20,
Oklahoma,U.S. Senate,Patrick Michael Hayes,DEM,550022,0,0,10,10,
Oklahoma,U.S. Senate,Jim Rogers,DEM,550022,0,0,12,12,
Oklahoma,U.S. Senate,Connie Johnson,DEM,550022,0,0,24,24,
Oklahoma,U.S. House,Bert Smith,DEM,550022,0,0,40,40,04
Oklahoma,U.S. House,Tae Si,DEM,550022,0,0,5,5,04
Oklahoma,Governor,Dax Ewbank,REP,550022,0,0,21,21,
Oklahoma,Governor,Chad Moody,REP,550022,0,0,24,24,
Oklahoma,Governor,Mary Fallin,REP,550022,0,0,148,148,
Oklahoma,Superintendent of Public Instruction,Brian Kelly,REP,550022,0,0,39,39,
Oklahoma,Superintendent of Public Instruction,Janet Costello Barresi,REP,550022,0,0,37,37,
Oklahoma,Superintendent of Public Instruction,Joy Hofmeister,REP,550022,0,0,104,104,
Oklahoma,Insurance Commissioner,Bill Viner,REP,550022,0,0,42,42,
Oklahoma,Insurance Commissioner,John Doak,REP,550022,0,0,136,136,
Oklahoma,Corporation Commissioner,Todd Hiett,REP,550022,0,0,77,77,
Oklahoma,Corporation Commissioner,Cliff Branan,REP,550022,0,0,92,92,
Oklahoma,U.S. Senate,Evelyn Rogers,REP,550022,0,0,7,7,
Oklahoma,U.S. Senate,Rob Moye,REP,550022,0,0,1,1,
Oklahoma,U.S. Senate,D. Jean Mcbride-Samuels,REP,550022,0,0,3,3,
Oklahoma,U.S. Senate,Jim Inhofe,REP,550022,0,0,170,170,
Oklahoma,U.S. Senate,Erick Paul Wyatt,REP,550022,0,0,8,8,
Oklahoma,U.S. Senate,Andy Craig,REP,550022,0,0,0,0,
Oklahoma,U.S. Senate,T. Shannon,REP,550022,0,0,58,58,
Oklahoma,U.S. Senate,Randy Brogdon,REP,550022,0,0,14,14,
Oklahoma,U.S. Senate,Eric Mccray,REP,550022,0,0,0,0,
Oklahoma,U.S. Senate,Kevin Crow,REP,550022,0,0,2,2,
Oklahoma,U.S. Senate,James Lankford,REP,550022,0,0,116,116,
Oklahoma,U.S. Senate,Jason Weger,REP,550022,0,0,2,2,
Oklahoma,U.S. House,Anna Flatt,REP,550022,0,0,37,37,04
Oklahoma,U.S. House,Tom Cole,REP,550022,0,0,154,154,04
Oklahoma,State Senate,Greg Childers,REP,550022,0,0,82,82,42
Oklahoma,State Senate,Jack Fry,REP,550022,0,0,102,102,42
Oklahoma,State House,A. Bailey,REP,550022,0,0,20,20,10
Oklahoma,State House,Gary Banz,REP,550022,0,0,163,163,10
Oklahoma,Superintendent of Public Instruction,John Cox,DEM,550023,0,0,36,36,
Oklahoma,Superintendent of Public Instruction,Jack Jr.,DEM,550023,0,0,15,15,
Oklahoma,Superintendent of Public Instruction,Ivan Holmes,DEM,550023,0,0,8,8,
Oklahoma,Superintendent of Public Instruction,Freda Deskin,DEM,550023,0,0,30,30,
Oklahoma,U.S. Senate,Patrick Michael Hayes,DEM,550023,0,0,21,21,
Oklahoma,U.S. Senate,Jim Rogers,DEM,550023,0,0,34,34,
Oklahoma,U.S. Senate,Connie Johnson,DEM,550023,0,0,32,32,
Oklahoma,U.S. House,Bert Smith,DEM,550023,0,0,67,67,04
Oklahoma,U.S. House,Tae Si,DEM,550023,0,0,17,17,04
Oklahoma,Governor,Dax Ewbank,REP,550023,0,0,32,32,
Oklahoma,Governor,Chad Moody,REP,550023,0,0,51,51,
Oklahoma,Governor,Mary Fallin,REP,550023,0,0,174,174,
Oklahoma,Superintendent of Public Instruction,Brian Kelly,REP,550023,0,0,46,46,
Oklahoma,Superintendent of Public Instruction,Janet Costello Barresi,REP,550023,0,0,47,47,
Oklahoma,Superintendent of Public Instruction,Joy Hofmeister,REP,550023,0,0,160,160,
Oklahoma,Insurance Commissioner,Bill Viner,REP,550023,0,0,66,66,
Oklahoma,Insurance Commissioner,John Doak,REP,550023,0,0,176,176,
Oklahoma,Corporation Commissioner,Todd Hiett,REP,550023,0,0,114,114,
Oklahoma,Corporation Commissioner,Cliff Branan,REP,550023,0,0,131,131,
Oklahoma,U.S. Senate,Evelyn Rogers,REP,550023,0,0,15,15,
Oklahoma,U.S. Senate,Rob Moye,REP,550023,0,0,0,0,
Oklahoma,U.S. Senate,D. Jean Mcbride-Samuels,REP,550023,0,0,5,5,
Oklahoma,U.S. Senate,Jim Inhofe,REP,550023,0,0,228,228,
Oklahoma,U.S. Senate,Erick Paul Wyatt,REP,550023,0,0,10,10,
Oklahoma,U.S. Senate,Andy Craig,REP,550023,0,0,0,0,
Oklahoma,U.S. Senate,T. Shannon,REP,550023,0,0,75,75,
Oklahoma,U.S. Senate,Randy Brogdon,REP,550023,0,0,7,7,
Oklahoma,U.S. Senate,Eric Mccray,REP,550023,0,0,2,2,
Oklahoma,U.S. Senate,Kevin Crow,REP,550023,0,0,4,4,
Oklahoma,U.S. Senate,James Lankford,REP,550023,0,0,170,170,
Oklahoma,U.S. Senate,Jason Weger,REP,550023,0,0,0,0,
Oklahoma,U.S. House,Anna Flatt,REP,550023,0,0,35,35,04
Oklahoma,U.S. House,Tom Cole,REP,550023,0,0,220,220,04
Oklahoma,State House,A. Bailey,REP,550023,0,0,41,41,10
Oklahoma,State House,Gary Banz,REP,550023,0,0,207,207,10
Oklahoma,Superintendent of Public Instruction,John Cox,DEM,550024,0,0,5,5,
Oklahoma,Superintendent of Public Instruction,Jack Jr.,DEM,550024,0,0,0,0,
Oklahoma,Superintendent of Public Instruction,Ivan Holmes,DEM,550024,0,0,0,0,
Oklahoma,Superintendent of Public Instruction,Freda Deskin,DEM,550024,0,0,7,7,
Oklahoma,U.S. Senate,Patrick Michael Hayes,DEM,550024,0,0,1,1,
Oklahoma,U.S. Senate,Jim Rogers,DEM,550024,0,0,5,5,
Oklahoma,U.S. Senate,Connie Johnson,DEM,550024,0,0,7,7,
Oklahoma,U.S. House,Tom Guild,DEM,550024,0,0,6,6,05
Oklahoma,U.S. House,Al Mcaffrey,DEM,550024,0,0,5,5,05
Oklahoma,U.S. House,Leona Leonard,DEM,550024,0,0,2,2,05
Oklahoma,State Senate,Christine Byrd,DEM,550024,0,0,8,8,48
Oklahoma,State Senate,Anastasia Pittman,DEM,550024,0,0,5,5,48
Oklahoma,Governor,Dax Ewbank,REP,550024,0,0,8,8,
Oklahoma,Governor,Chad Moody,REP,550024,0,0,3,3,
Oklahoma,Governor,Mary Fallin,REP,550024,0,0,12,12,
Oklahoma,Superintendent of Public Instruction,Brian Kelly,REP,550024,0,0,5,5,
Oklahoma,Superintendent of Public Instruction,Janet Costello Barresi,REP,550024,0,0,5,5,
Oklahoma,Superintendent of Public Instruction,Joy Hofmeister,REP,550024,0,0,12,12,
Oklahoma,Insurance Commissioner,Bill Viner,REP,550024,0,0,5,5,
Oklahoma,Insurance Commissioner,John Doak,REP,550024,0,0,17,17,
Oklahoma,Corporation Commissioner,Todd Hiett,REP,550024,0,0,14,14,
Oklahoma,Corporation Commissioner,Cliff Branan,REP,550024,0,0,9,9,
Oklahoma,U.S. Senate,Evelyn Rogers,REP,550024,0,0,0,0,
Oklahoma,U.S. Senate,Rob Moye,REP,550024,0,0,1,1,
Oklahoma,U.S. Senate,D. Jean Mcbride-Samuels,REP,550024,0,0,0,0,
Oklahoma,U.S. Senate,Jim Inhofe,REP,550024,0,0,21,21,
Oklahoma,U.S. Senate,Erick Paul Wyatt,REP,550024,0,0,1,1,
Oklahoma,U.S. Senate,Andy Craig,REP,550024,0,0,0,0,
Oklahoma,U.S. Senate,T. Shannon,REP,550024,0,0,3,3,
Oklahoma,U.S. Senate,Randy Brogdon,REP,550024,0,0,7,7,
Oklahoma,U.S. Senate,Eric Mccray,REP,550024,0,0,0,0,
Oklahoma,U.S. Senate,Kevin Crow,REP,550024,0,0,1,1,
Oklahoma,U.S. Senate,James Lankford,REP,550024,0,0,12,12,
Oklahoma,U.S. Senate,Jason Weger,REP,550024,0,0,0,0,
Oklahoma,U.S. House,Shane David Jett,REP,550024,0,0,3,3,05
Oklahoma,U.S. House,Patrice Douglas,REP,550024,0,0,4,4,05
Oklahoma,U.S. House,Mike Turner,REP,550024,0,0,2,2,05
Oklahoma,U.S. House,Steve Russell,REP,550024,0,0,11,11,05
Oklahoma,U.S. House,Harvey Sparks,REP,550024,0,0,2,2,05
Oklahoma,U.S. House,Clark Jolley,REP,550024,0,0,1,1,05
Oklahoma,Superintendent of Public Instruction,John Cox,DEM,550025,0,0,14,14,
Oklahoma,Superintendent of Public Instruction,Jack Jr.,DEM,550025,0,0,6,6,
Oklahoma,Superintendent of Public Instruction,Ivan Holmes,DEM,550025,0,0,4,4,
Oklahoma,Superintendent of Public Instruction,Freda Deskin,DEM,550025,0,0,22,22,
Oklahoma,U.S. Senate,Patrick Michael Hayes,DEM,550025,0,0,6,6,
Oklahoma,U.S. Senate,Jim Rogers,DEM,550025,0,0,8,8,
Oklahoma,U.S. Senate,Connie Johnson,DEM,550025,0,0,39,39,
Oklahoma,U.S. House,Tom Guild,DEM,550025,0,0,15,15,05
Oklahoma,U.S. House,Al Mcaffrey,DEM,550025,0,0,13,13,05
Oklahoma,U.S. House,Leona Leonard,DEM,550025,0,0,18,18,05
Oklahoma,State Senate,Christine Byrd,DEM,550025,0,0,11,11,48
Oklahoma,State Senate,Anastasia Pittman,DEM,550025,0,0,41,41,48
Oklahoma,State House,Mike Shelton,DEM,550025,0,0,41,41,97
Oklahoma,State House,Bruce Fisher,DEM,550025,0,0,10,10,97
Oklahoma,Governor,Dax Ewbank,REP,550025,0,0,3,3,
Oklahoma,Governor,Chad Moody,REP,550025,0,0,4,4,
Oklahoma,Governor,Mary Fallin,REP,550025,0,0,31,31,
Oklahoma,Superintendent of Public Instruction,Brian Kelly,REP,550025,0,0,12,12,
Oklahoma,Superintendent of Public Instruction,Janet Costello Barresi,REP,550025,0,0,10,10,
Oklahoma,Superintendent of Public Instruction,Joy Hofmeister,REP,550025,0,0,20,20,
Oklahoma,Insurance Commissioner,Bill Viner,REP,550025,0,0,6,6,
Oklahoma,Insurance Commissioner,John Doak,REP,550025,0,0,33,33,
Oklahoma,Corporation Commissioner,Todd Hiett,REP,550025,0,0,19,19,
Oklahoma,Corporation Commissioner,Cliff Branan,REP,550025,0,0,17,17,
Oklahoma,U.S. Senate,Evelyn Rogers,REP,550025,0,0,1,1,
Oklahoma,U.S. Senate,Rob Moye,REP,550025,0,0,0,0,
Oklahoma,U.S. Senate,D. Jean Mcbride-Samuels,REP,550025,0,0,2,2,
Oklahoma,U.S. Senate,Jim Inhofe,REP,550025,0,0,36,36,
Oklahoma,U.S. Senate,Erick Paul Wyatt,REP,550025,0,0,1,1,
Oklahoma,U.S. Senate,Andy Craig,REP,550025,0,0,0,0,
Oklahoma,U.S. Senate,T. Shannon,REP,550025,0,0,11,11,
Oklahoma,U.S. Senate,Randy Brogdon,REP,550025,0,0,1,1,
Oklahoma,U.S. Senate,Eric Mccray,REP,550025,0,0,1,1,
Oklahoma,U.S. Senate,Kevin Crow,REP,550025,0,0,1,1,
Oklahoma,U.S. Senate,James Lankford,REP,550025,0,0,28,28,
Oklahoma,U.S. Senate,Jason Weger,REP,550025,0,0,0,0,
Oklahoma,U.S. House,Shane David Jett,REP,550025,0,0,3,3,05
Oklahoma,U.S. House,Patrice Douglas,REP,550025,0,0,7,7,05
Oklahoma,U.S. House,Mike Turner,REP,550025,0,0,5,5,05
Oklahoma,U.S. House,Steve Russell,REP,550025,0,0,14,14,05
Oklahoma,U.S. House,Harvey Sparks,REP,550025,0,0,3,3,05
Oklahoma,U.S. House,Clark Jolley,REP,550025,0,0,6,6,05
Oklahoma,Superintendent of Public Instruction,John Cox,DEM,550026,0,0,19,19,
Oklahoma,Superintendent of Public Instruction,Jack Jr.,DEM,550026,0,0,9,9,
Oklahoma,Superintendent of Public Instruction,Ivan Holmes,DEM,550026,0,0,3,3,
Oklahoma,Superintendent of Public Instruction,Freda Deskin,DEM,550026,0,0,28,28,
Oklahoma,U.S. Senate,Patrick Michael Hayes,DEM,550026,0,0,13,13,
Oklahoma,U.S. Senate,Jim Rogers,DEM,550026,0,0,18,18,
Oklahoma,U.S. Senate,Connie Johnson,DEM,550026,0,0,28,28,
Oklahoma,U.S. House,Bert Smith,DEM,550026,0,0,51,51,04
Oklahoma,U.S. House,Tae Si,DEM,550026,0,0,8,8,04
Oklahoma,Governor,Dax Ewbank,REP,550026,0,0,14,14,
Oklahoma,Governor,Chad Moody,REP,550026,0,0,35,35,
Oklahoma,Governor,Mary Fallin,REP,550026,0,0,115,115,
Oklahoma,Superintendent of Public Instruction,Brian Kelly,REP,550026,0,0,51,51,
Oklahoma,Superintendent of Public Instruction,Janet Costello Barresi,REP,550026,0,0,26,26,
Oklahoma,Superintendent of Public Instruction,Joy Hofmeister,REP,550026,0,0,88,88,
Oklahoma,Insurance Commissioner,Bill Viner,REP,550026,0,0,37,37,
Oklahoma,Insurance Commissioner,John Doak,REP,550026,0,0,109,109,
Oklahoma,Corporation Commissioner,Todd Hiett,REP,550026,0,0,69,69,
Oklahoma,Corporation Commissioner,Cliff Branan,REP,550026,0,0,84,84,
Oklahoma,U.S. Senate,Evelyn Rogers,REP,550026,0,0,6,6,
Oklahoma,U.S. Senate,Rob Moye,REP,550026,0,0,1,1,
Oklahoma,U.S. Senate,D. Jean Mcbride-Samuels,REP,550026,0,0,0,0,
Oklahoma,U.S. Senate,Jim Inhofe,REP,550026,0,0,150,150,
Oklahoma,U.S. Senate,Erick Paul Wyatt,REP,550026,0,0,8,8,
Oklahoma,U.S. Senate,Andy Craig,REP,550026,0,0,0,0,
Oklahoma,U.S. Senate,T. Shannon,REP,550026,0,0,37,37,
Oklahoma,U.S. Senate,Randy Brogdon,REP,550026,0,0,8,8,
Oklahoma,U.S. Senate,Eric Mccray,REP,550026,0,0,0,0,
Oklahoma,U.S. Senate,Kevin Crow,REP,550026,0,0,2,2,
Oklahoma,U.S. Senate,James Lankford,REP,550026,0,0,119,119,
Oklahoma,U.S. Senate,Jason Weger,REP,550026,0,0,0,0,
Oklahoma,U.S. House,Anna Flatt,REP,550026,0,0,25,25,04
Oklahoma,U.S. House,Tom Cole,REP,550026,0,0,139,139,04
Oklahoma,State House,A. Bailey,REP,550026,0,0,32,32,10
Oklahoma,State House,Gary Banz,REP,550026,0,0,125,125,10
Oklahoma,Superintendent of Public Instruction,John Cox,DEM,550027,0,0,2,2,
Oklahoma,Superintendent of Public Instruction,Jack Jr.,DEM,550027,0,0,0,0,
Oklahoma,Superintendent of Public Instruction,Ivan Holmes,DEM,550027,0,0,3,3,
Oklahoma,Superintendent of Public Instruction,Freda Deskin,DEM,550027,0,0,1,1,
Oklahoma,U.S. Senate,Patrick Michael Hayes,DEM,550027,0,0,1,1,
Oklahoma,U.S. Senate,Jim Rogers,DEM,550027,0,0,2,2,
Oklahoma,U.S. Senate,Connie Johnson,DEM,550027,0,0,3,3,
Oklahoma,U.S. House,Bert Smith,DEM,550027,0,0,3,3,04
Oklahoma,U.S. House,Tae Si,DEM,550027,0,0,2,2,04
Oklahoma,State Senate,Christine Byrd,DEM,550027,0,0,3,3,48
Oklahoma,State Senate,Anastasia Pittman,DEM,550027,0,0,3,3,48
Oklahoma,Governor,Dax Ewbank,REP,550027,0,0,3,3,
Oklahoma,Governor,Chad Moody,REP,550027,0,0,7,7,
Oklahoma,Governor,Mary Fallin,REP,550027,0,0,22,22,
Oklahoma,Superintendent of Public Instruction,Brian Kelly,REP,550027,0,0,7,7,
Oklahoma,Superintendent of Public Instruction,Janet Costello Barresi,REP,550027,0,0,12,12,
Oklahoma,Superintendent of Public Instruction,Joy Hofmeister,REP,550027,0,0,14,14,
Oklahoma,Insurance Commissioner,Bill Viner,REP,550027,0,0,6,6,
Oklahoma,Insurance Commissioner,John Doak,REP,550027,0,0,27,27,
Oklahoma,Corporation Commissioner,Todd Hiett,REP,550027,0,0,18,18,
Oklahoma,Corporation Commissioner,Cliff Branan,REP,550027,0,0,15,15,
Oklahoma,U.S. Senate,Evelyn Rogers,REP,550027,0,0,1,1,
Oklahoma,U.S. Senate,Rob Moye,REP,550027,0,0,0,0,
Oklahoma,U.S. Senate,D. Jean Mcbride-Samuels,REP,550027,0,0,1,1,
Oklahoma,U.S. Senate,Jim Inhofe,REP,550027,0,0,29,29,
Oklahoma,U.S. Senate,Erick Paul Wyatt,REP,550027,0,0,2,2,
Oklahoma,U.S. Senate,Andy Craig,REP,550027,0,0,0,0,
Oklahoma,U.S. Senate,T. Shannon,REP,550027,0,0,11,11,
Oklahoma,U.S. Senate,Randy Brogdon,REP,550027,0,0,0,0,
Oklahoma,U.S. Senate,Eric Mccray,REP,550027,0,0,0,0,
Oklahoma,U.S. Senate,Kevin Crow,REP,550027,0,0,0,0,
Oklahoma,U.S. Senate,James Lankford,REP,550027,0,0,22,22,
Oklahoma,U.S. Senate,Jason Weger,REP,550027,0,0,0,0,
Oklahoma,U.S. House,Anna Flatt,REP,550027,0,0,4,4,04
Oklahoma,U.S. House,Tom Cole,REP,550027,0,0,29,29,04
Oklahoma,State House,A. Bailey,REP,550027,0,0,7,7,10
Oklahoma,State House,Gary Banz,REP,550027,0,0,26,26,10
Oklahoma,Superintendent of Public Instruction,John Cox,DEM,550028,0,0,31,31,
Oklahoma,Superintendent of Public Instruction,Jack Jr.,DEM,550028,0,0,13,13,
Oklahoma,Superintendent of Public Instruction,Ivan Holmes,DEM,550028,0,0,12,12,
Oklahoma,Superintendent of Public Instruction,Freda Deskin,DEM,550028,0,0,45,45,
Oklahoma,U.S. Senate,Patrick Michael Hayes,DEM,550028,0,0,16,16,
Oklahoma,U.S. Senate,Jim Rogers,DEM,550028,0,0,29,29,
Oklahoma,U.S. Senate,Connie Johnson,DEM,550028,0,0,57,57,
Oklahoma,U.S. House,Tom Guild,DEM,550028,0,0,38,38,05
Oklahoma,U.S. House,Al Mcaffrey,DEM,550028,0,0,31,31,05
Oklahoma,U.S. House,Leona Leonard,DEM,550028,0,0,31,31,05
Oklahoma,Governor,Dax Ewbank,REP,550028,0,0,6,6,
Oklahoma,Governor,Chad Moody,REP,550028,0,0,17,17,
Oklahoma,Governor,Mary Fallin,REP,550028,0,0,104,104,
Oklahoma,Superintendent of Public Instruction,Brian Kelly,REP,550028,0,0,27,27,
Oklahoma,Superintendent of Public Instruction,Janet Costello Barresi,REP,550028,0,0,45,45,
Oklahoma,Superintendent of Public Instruction,Joy Hofmeister,REP,550028,0,0,52,52,
Oklahoma,Insurance Commissioner,Bill Viner,REP,550028,0,0,32,32,
Oklahoma,Insurance Commissioner,John Doak,REP,550028,0,0,84,84,
Oklahoma,Corporation Commissioner,Todd Hiett,REP,550028,0,0,49,49,
Oklahoma,Corporation Commissioner,Cliff Branan,REP,550028,0,0,61,61,
Oklahoma,U.S. Senate,Evelyn Rogers,REP,550028,0,0,8,8,
Oklahoma,U.S. Senate,Rob Moye,REP,550028,0,0,3,3,
Oklahoma,U.S. Senate,D. Jean Mcbride-Samuels,REP,550028,0,0,1,1,
Oklahoma,U.S. Senate,Jim Inhofe,REP,550028,0,0,108,108,
Oklahoma,U.S. Senate,Erick Paul Wyatt,REP,550028,0,0,5,5,
Oklahoma,U.S. Senate,Andy Craig,REP,550028,0,0,1,1,
Oklahoma,U.S. Senate,T. Shannon,REP,550028,0,0,33,33,
Oklahoma,U.S. Senate,Randy Brogdon,REP,550028,0,0,0,0,
Oklahoma,U.S. Senate,Eric Mccray,REP,550028,0,0,2,2,
Oklahoma,U.S. Senate,Kevin Crow,REP,550028,0,0,1,1,
Oklahoma,U.S. Senate,James Lankford,REP,550028,0,0,89,89,
Oklahoma,U.S. Senate,Jason Weger,REP,550028,0,0,1,1,
Oklahoma,U.S. House,Shane David Jett,REP,550028,0,0,13,13,05
Oklahoma,U.S. House,Patrice Douglas,REP,550028,0,0,17,17,05
Oklahoma,U.S. House,Mike Turner,REP,550028,0,0,21,21,05
Oklahoma,U.S. House,Steve Russell,REP,550028,0,0,64,64,05
Oklahoma,U.S. House,Harvey Sparks,REP,550028,0,0,2,2,05
Oklahoma,U.S. House,Clark Jolley,REP,550028,0,0,5,5,05
Oklahoma,State Senate,Greg Childers,REP,550028,0,0,81,81,42
Oklahoma,State Senate,Jack Fry,REP,550028,0,0,37,37,42
Oklahoma,Superintendent of Public Instruction,John Cox,DEM,550029,0,0,31,31,
Oklahoma,Superintendent of Public Instruction,Jack Jr.,DEM,550029,0,0,10,10,
Oklahoma,Superintendent of Public Instruction,Ivan Holmes,DEM,550029,0,0,4,4,
Oklahoma,Superintendent of Public Instruction,Freda Deskin,DEM,550029,0,0,61,61,
Oklahoma,U.S. Senate,Patrick Michael Hayes,DEM,550029,0,0,11,11,
Oklahoma,U.S. Senate,Jim Rogers,DEM,550029,0,0,27,27,
Oklahoma,U.S. Senate,Connie Johnson,DEM,550029,0,0,67,67,
Oklahoma,U.S. House,Tom Guild,DEM,550029,0,0,49,49,05
Oklahoma,U.S. House,Al Mcaffrey,DEM,550029,0,0,25,25,05
Oklahoma,U.S. House,Leona Leonard,DEM,550029,0,0,33,33,05
Oklahoma,Governor,Dax Ewbank,REP,550029,0,0,15,15,
Oklahoma,Governor,Chad Moody,REP,550029,0,0,37,37,
Oklahoma,Governor,Mary Fallin,REP,550029,0,0,165,165,
Oklahoma,Superintendent of Public Instruction,Brian Kelly,REP,550029,0,0,54,54,
Oklahoma,Superintendent of Public Instruction,Janet Costello Barresi,REP,550029,0,0,67,67,
Oklahoma,Superintendent of Public Instruction,Joy Hofmeister,REP,550029,0,0,93,93,
Oklahoma,Insurance Commissioner,Bill Viner,REP,550029,0,0,47,47,
Oklahoma,Insurance Commissioner,John Doak,REP,550029,0,0,160,160,
Oklahoma,Corporation Commissioner,Todd Hiett,REP,550029,0,0,88,88,
Oklahoma,Corporation Commissioner,Cliff Branan,REP,550029,0,0,119,119,
Oklahoma,U.S. Senate,Evelyn Rogers,REP,550029,0,0,15,15,
Oklahoma,U.S. Senate,Rob Moye,REP,550029,0,0,6,6,
Oklahoma,U.S. Senate,D. Jean Mcbride-Samuels,REP,550029,0,0,3,3,
Oklahoma,U.S. Senate,Jim Inhofe,REP,550029,0,0,186,186,
Oklahoma,U.S. Senate,Erick Paul Wyatt,REP,550029,0,0,8,8,
Oklahoma,U.S. Senate,Andy Craig,REP,550029,0,0,3,3,
Oklahoma,U.S. Senate,T. Shannon,REP,550029,0,0,56,56,
Oklahoma,U.S. Senate,Randy Brogdon,REP,550029,0,0,5,5,
Oklahoma,U.S. Senate,Eric Mccray,REP,550029,0,0,3,3,
Oklahoma,U.S. Senate,Kevin Crow,REP,550029,0,0,1,1,
Oklahoma,U.S. Senate,James Lankford,REP,550029,0,0,150,150,
Oklahoma,U.S. Senate,Jason Weger,REP,550029,0,0,1,1,
Oklahoma,U.S. House,Shane David Jett,REP,550029,0,0,21,21,05
Oklahoma,U.S. House,Patrice Douglas,REP,550029,0,0,24,24,05
Oklahoma,U.S. House,Mike Turner,REP,550029,0,0,22,22,05
Oklahoma,U.S. House,Steve Russell,REP,550029,0,0,112,112,05
Oklahoma,U.S. House,Harvey Sparks,REP,550029,0,0,6,6,05
Oklahoma,U.S. House,Clark Jolley,REP,550029,0,0,30,30,05
Oklahoma,State Senate,Greg Childers,REP,550029,0,0,148,148,42
Oklahoma,State Senate,Jack Fry,REP,550029,0,0,69,69,42
Oklahoma,Superintendent of Public Instruction,John Cox,DEM,550030,0,0,30,30,
Oklahoma,Superintendent of Public Instruction,Jack Jr.,DEM,550030,0,0,14,14,
Oklahoma,Superintendent of Public Instruction,Ivan Holmes,DEM,550030,0,0,16,16,
Oklahoma,Superintendent of Public Instruction,Freda Deskin,DEM,550030,0,0,45,45,
Oklahoma,U.S. Senate,Patrick Michael Hayes,DEM,550030,0,0,18,18,
Oklahoma,U.S. Senate,Jim Rogers,DEM,550030,0,0,24,24,
Oklahoma,U.S. Senate,Connie Johnson,DEM,550030,0,0,62,62,
Oklahoma,U.S. House,Tom Guild,DEM,550030,0,0,38,38,05
Oklahoma,U.S. House,Al Mcaffrey,DEM,550030,0,0,26,26,05
Oklahoma,U.S. House,Leona Leonard,DEM,550030,0,0,38,38,05
Oklahoma,Governor,Dax Ewbank,REP,550030,0,0,11,11,
Oklahoma,Governor,Chad Moody,REP,550030,0,0,20,20,
Oklahoma,Governor,Mary Fallin,REP,550030,0,0,111,111,
Oklahoma,Superintendent of Public Instruction,Brian Kelly,REP,550030,0,0,39,39,
Oklahoma,Superintendent of Public Instruction,Janet Costello Barresi,REP,550030,0,0,47,47,
Oklahoma,Superintendent of Public Instruction,Joy Hofmeister,REP,550030,0,0,53,53,
Oklahoma,Insurance Commissioner,Bill Viner,REP,550030,0,0,28,28,
Oklahoma,Insurance Commissioner,John Doak,REP,550030,0,0,103,103,
Oklahoma,Corporation Commissioner,Todd Hiett,REP,550030,0,0,63,63,
Oklahoma,Corporation Commissioner,Cliff Branan,REP,550030,0,0,72,72,
Oklahoma,U.S. Senate,Evelyn Rogers,REP,550030,0,0,4,4,
Oklahoma,U.S. Senate,Rob Moye,REP,550030,0,0,4,4,
Oklahoma,U.S. Senate,D. Jean Mcbride-Samuels,REP,550030,0,0,3,3,
Oklahoma,U.S. Senate,Jim Inhofe,REP,550030,0,0,125,125,
Oklahoma,U.S. Senate,Erick Paul Wyatt,REP,550030,0,0,3,3,
Oklahoma,U.S. Senate,Andy Craig,REP,550030,0,0,0,0,
Oklahoma,U.S. Senate,T. Shannon,REP,550030,0,0,28,28,
Oklahoma,U.S. Senate,Randy Brogdon,REP,550030,0,0,5,5,
Oklahoma,U.S. Senate,Eric Mccray,REP,550030,0,0,2,2,
Oklahoma,U.S. Senate,Kevin Crow,REP,550030,0,0,0,0,
Oklahoma,U.S. Senate,James Lankford,REP,550030,0,0,106,106,
Oklahoma,U.S. Senate,Jason Weger,REP,550030,0,0,0,0,
Oklahoma,U.S. House,Shane David Jett,REP,550030,0,0,21,21,05
Oklahoma,U.S. House,Patrice Douglas,REP,550030,0,0,16,16,05
Oklahoma,U.S. House,Mike Turner,REP,550030,0,0,18,18,05
Oklahoma,U.S. House,Steve Russell,REP,550030,0,0,57,57,05
Oklahoma,U.S. House,Harvey Sparks,REP,550030,0,0,3,3,05
Oklahoma,U.S. House,Clark Jolley,REP,550030,0,0,20,20,05
Oklahoma,State Senate,Greg Childers,REP,550030,0,0,85,85,42
Oklahoma,State Senate,Jack Fry,REP,550030,0,0,50,50,42
Oklahoma,Superintendent of Public Instruction,John Cox,DEM,550031,0,0,55,55,
Oklahoma,Superintendent of Public Instruction,Jack Jr.,DEM,550031,0,0,9,9,
Oklahoma,Superintendent of Public Instruction,Ivan Holmes,DEM,550031,0,0,7,7,
Oklahoma,Superintendent of Public Instruction,Freda Deskin,DEM,550031,0,0,46,46,
Oklahoma,U.S. Senate,Patrick Michael Hayes,DEM,550031,0,0,24,24,
Oklahoma,U.S. Senate,Jim Rogers,DEM,550031,0,0,35,35,
Oklahoma,U.S. Senate,Connie Johnson,DEM,550031,0,0,55,55,
Oklahoma,U.S. House,Tom Guild,DEM,550031,0,0,64,64,05
Oklahoma,U.S. House,Al Mcaffrey,DEM,550031,0,0,25,25,05
Oklahoma,U.S. House,Leona Leonard,DEM,550031,0,0,27,27,05
Oklahoma,Governor,Dax Ewbank,REP,550031,0,0,24,24,
Oklahoma,Governor,Chad Moody,REP,550031,0,0,39,39,
Oklahoma,Governor,Mary Fallin,REP,550031,0,0,175,175,
Oklahoma,Superintendent of Public Instruction,Brian Kelly,REP,550031,0,0,57,57,
Oklahoma,Superintendent of Public Instruction,Janet Costello Barresi,REP,550031,0,0,70,70,
Oklahoma,Superintendent of Public Instruction,Joy Hofmeister,REP,550031,0,0,103,103,
Oklahoma,Insurance Commissioner,Bill Viner,REP,550031,0,0,54,54,
Oklahoma,Insurance Commissioner,John Doak,REP,550031,0,0,165,165,
Oklahoma,Corporation Commissioner,Todd Hiett,REP,550031,0,0,120,120,
Oklahoma,Corporation Commissioner,Cliff Branan,REP,550031,0,0,100,100,
Oklahoma,U.S. Senate,Evelyn Rogers,REP,550031,0,0,7,7,
Oklahoma,U.S. Senate,Rob Moye,REP,550031,0,0,5,5,
Oklahoma,U.S. Senate,D. Jean Mcbride-Samuels,REP,550031,0,0,4,4,
Oklahoma,U.S. Senate,Jim Inhofe,REP,550031,0,0,209,209,
Oklahoma,U.S. Senate,Erick Paul Wyatt,REP,550031,0,0,6,6,
Oklahoma,U.S. Senate,Andy Craig,REP,550031,0,0,0,0,
Oklahoma,U.S. Senate,T. Shannon,REP,550031,0,0,36,36,
Oklahoma,U.S. Senate,Randy Brogdon,REP,550031,0,0,9,9,
Oklahoma,U.S. Senate,Eric Mccray,REP,550031,0,0,1,1,
Oklahoma,U.S. Senate,Kevin Crow,REP,550031,0,0,4,4,
Oklahoma,U.S. Senate,James Lankford,REP,550031,0,0,185,185,
Oklahoma,U.S. Senate,Jason Weger,REP,550031,0,0,1,1,
Oklahoma,U.S. House,Shane David Jett,REP,550031,0,0,22,22,05
Oklahoma,U.S. House,Patrice Douglas,REP,550031,0,0,25,25,05
Oklahoma,U.S. House,Mike Turner,REP,550031,0,0,21,21,05
Oklahoma,U.S. House,Steve Russell,REP,550031,0,0,127,127,05
Oklahoma,U.S. House,Harvey Sparks,REP,550031,0,0,5,5,05
Oklahoma,U.S. House,Clark Jolley,REP,550031,0,0,29,29,05
Oklahoma,State Senate,Greg Childers,REP,550031,0,0,128,128,42
Oklahoma,State Senate,Jack Fry,REP,550031,0,0,95,95,42
Oklahoma,Superintendent of Public Instruction,John Cox,DEM,550032,0,0,33,33,
Oklahoma,Superintendent of Public Instruction,Jack Jr.,DEM,550032,0,0,12,12,
Oklahoma,Superintendent of Public Instruction,Ivan Holmes,DEM,550032,0,0,6,6,
Oklahoma,Superintendent of Public Instruction,Freda Deskin,DEM,550032,0,0,31,31,
Oklahoma,U.S. Senate,Patrick Michael Hayes,DEM,550032,0,0,18,18,
Oklahoma,U.S. Senate,Jim Rogers,DEM,550032,0,0,33,33,
Oklahoma,U.S. Senate,Connie Johnson,DEM,550032,0,0,28,28,
Oklahoma,U.S. House,Tom Guild,DEM,550032,0,0,49,49,05
Oklahoma,U.S. House,Al Mcaffrey,DEM,550032,0,0,16,16,05
Oklahoma,U.S. House,Leona Leonard,DEM,550032,0,0,18,18,05
Oklahoma,Governor,Dax Ewbank,REP,550032,0,0,25,25,
Oklahoma,Governor,Chad Moody,REP,550032,0,0,29,29,
Oklahoma,Governor,Mary Fallin,REP,550032,0,0,120,120,
Oklahoma,Superintendent of Public Instruction,Brian Kelly,REP,550032,0,0,56,56,
Oklahoma,Superintendent of Public Instruction,Janet Costello Barresi,REP,550032,0,0,43,43,
Oklahoma,Superintendent of Public Instruction,Joy Hofmeister,REP,550032,0,0,65,65,
Oklahoma,Insurance Commissioner,Bill Viner,REP,550032,0,0,38,38,
Oklahoma,Insurance Commissioner,John Doak,REP,550032,0,0,121,121,
Oklahoma,Corporation Commissioner,Todd Hiett,REP,550032,0,0,77,77,
Oklahoma,Corporation Commissioner,Cliff Branan,REP,550032,0,0,80,80,
Oklahoma,U.S. Senate,Evelyn Rogers,REP,550032,0,0,6,6,
Oklahoma,U.S. Senate,Rob Moye,REP,550032,0,0,4,4,
Oklahoma,U.S. Senate,D. Jean Mcbride-Samuels,REP,550032,0,0,3,3,
Oklahoma,U.S. Senate,Jim Inhofe,REP,550032,0,0,147,147,
Oklahoma,U.S. Senate,Erick Paul Wyatt,REP,550032,0,0,10,10,
Oklahoma,U.S. Senate,Andy Craig,REP,550032,0,0,1,1,
Oklahoma,U.S. Senate,T. Shannon,REP,550032,0,0,46,46,
Oklahoma,U.S. Senate,Randy Brogdon,REP,550032,0,0,7,7,
Oklahoma,U.S. Senate,Eric Mccray,REP,550032,0,0,2,2,
Oklahoma,U.S. Senate,Kevin Crow,REP,550032,0,0,1,1,
Oklahoma,U.S. Senate,James Lankford,REP,550032,0,0,117,117,
Oklahoma,U.S. Senate,Jason Weger,REP,550032,0,0,0,0,
Oklahoma,U.S. House,Shane David Jett,REP,550032,0,0,15,15,05
Oklahoma,U.S. House,Patrice Douglas,REP,550032,0,0,17,17,05
Oklahoma,U.S. House,Mike Turner,REP,550032,0,0,33,33,05
Oklahoma,U.S. House,Steve Russell,REP,550032,0,0,81,81,05
Oklahoma,U.S. House,Harvey Sparks,REP,550032,0,0,4,4,05
Oklahoma,U.S. House,Clark Jolley,REP,550032,0,0,18,18,05
Oklahoma,State Senate,Greg Childers,REP,550032,0,0,90,90,42
Oklahoma,State Senate,Jack Fry,REP,550032,0,0,70,70,42
Oklahoma,Superintendent of Public Instruction,John Cox,DEM,550033,0,0,48,48,
Oklahoma,Superintendent of Public Instruction,Jack Jr.,DEM,550033,0,0,18,18,
Oklahoma,Superintendent of Public Instruction,Ivan Holmes,DEM,550033,0,0,17,17,
Oklahoma,Superintendent of Public Instruction,Freda Deskin,DEM,550033,0,0,75,75,
Oklahoma,U.S. Senate,Patrick Michael Hayes,DEM,550033,0,0,22,22,
Oklahoma,U.S. Senate,Jim Rogers,DEM,550033,0,0,48,48,
Oklahoma,U.S. Senate,Connie Johnson,DEM,550033,0,0,83,83,
Oklahoma,U.S. House,Tom Guild,DEM,550033,0,0,77,77,05
Oklahoma,U.S. House,Al Mcaffrey,DEM,550033,0,0,45,45,05
Oklahoma,U.S. House,Leona Leonard,DEM,550033,0,0,30,30,05
Oklahoma,Governor,Dax Ewbank,REP,550033,0,0,27,27,
Oklahoma,Governor,Chad Moody,REP,550033,0,0,47,47,
Oklahoma,Governor,Mary Fallin,REP,550033,0,0,285,285,
Oklahoma,Superintendent of Public Instruction,Brian Kelly,REP,550033,0,0,80,80,
Oklahoma,Superintendent of Public Instruction,Janet Costello Barresi,REP,550033,0,0,96,96,
Oklahoma,Superintendent of Public Instruction,Joy Hofmeister,REP,550033,0,0,174,174,
Oklahoma,Insurance Commissioner,Bill Viner,REP,550033,0,0,73,73,
Oklahoma,Insurance Commissioner,John Doak,REP,550033,0,0,257,257,
Oklahoma,Corporation Commissioner,Todd Hiett,REP,550033,0,0,171,171,
Oklahoma,Corporation Commissioner,Cliff Branan,REP,550033,0,0,155,155,
Oklahoma,U.S. Senate,Evelyn Rogers,REP,550033,0,0,16,16,
Oklahoma,U.S. Senate,Rob Moye,REP,550033,0,0,5,5,
Oklahoma,U.S. Senate,D. Jean Mcbride-Samuels,REP,550033,0,0,2,2,
Oklahoma,U.S. Senate,Jim Inhofe,REP,550033,0,0,325,325,
Oklahoma,U.S. Senate,Erick Paul Wyatt,REP,550033,0,0,13,13,
Oklahoma,U.S. Senate,Andy Craig,REP,550033,0,0,1,1,
Oklahoma,U.S. Senate,T. Shannon,REP,550033,0,0,77,77,
Oklahoma,U.S. Senate,Randy Brogdon,REP,550033,0,0,13,13,
Oklahoma,U.S. Senate,Eric Mccray,REP,550033,0,0,0,0,
Oklahoma,U.S. Senate,Kevin Crow,REP,550033,0,0,2,2,
Oklahoma,U.S. Senate,James Lankford,REP,550033,0,0,270,270,
Oklahoma,U.S. Senate,Jason Weger,REP,550033,0,0,2,2,
Oklahoma,U.S. House,Shane David Jett,REP,550033,0,0,20,20,05
Oklahoma,U.S. House,Patrice Douglas,REP,550033,0,0,36,36,05
Oklahoma,U.S. House,Mike Turner,REP,550033,0,0,40,40,05
Oklahoma,U.S. House,Steve Russell,REP,550033,0,0,228,228,05
Oklahoma,U.S. House,Harvey Sparks,REP,550033,0,0,8,8,05
Oklahoma,U.S. House,Clark Jolley,REP,550033,0,0,25,25,05
Oklahoma,State Senate,Greg Childers,REP,550033,0,0,234,234,42
Oklahoma,State Senate,Jack Fry,REP,550033,0,0,115,115,42
Oklahoma,Superintendent of Public Instruction,John Cox,DEM,550034,0,0,5,5,
Oklahoma,Superintendent of Public Instruction,Jack Jr.,DEM,550034,0,0,0,0,
Oklahoma,Superintendent of Public Instruction,Ivan Holmes,DEM,550034,0,0,3,3,
Oklahoma,Superintendent of Public Instruction,Freda Deskin,DEM,550034,0,0,9,9,
Oklahoma,U.S. Senate,Patrick Michael Hayes,DEM,550034,0,0,3,3,
Oklahoma,U.S. Senate,Jim Rogers,DEM,550034,0,0,6,6,
Oklahoma,U.S. Senate,Connie Johnson,DEM,550034,0,0,9,9,
Oklahoma,U.S. House,Tom Guild,DEM,550034,0,0,7,7,05
Oklahoma,U.S. House,Al Mcaffrey,DEM,550034,0,0,7,7,05
Oklahoma,U.S. House,Leona Leonard,DEM,550034,0,0,4,4,05
Oklahoma,Governor,Dax Ewbank,REP,550034,0,0,29,29,
Oklahoma,Governor,Chad Moody,REP,550034,0,0,38,38,
Oklahoma,Governor,Mary Fallin,REP,550034,0,0,201,201,
Oklahoma,Superintendent of Public Instruction,Brian Kelly,REP,550034,0,0,54,54,
Oklahoma,Superintendent of Public Instruction,Janet Costello Barresi,REP,550034,0,0,54,54,
Oklahoma,Superintendent of Public Instruction,Joy Hofmeister,REP,550034,0,0,152,152,
Oklahoma,Insurance Commissioner,Bill Viner,REP,550034,0,0,57,57,
Oklahoma,Insurance Commissioner,John Doak,REP,550034,0,0,187,187,
Oklahoma,Corporation Commissioner,Todd Hiett,REP,550034,0,0,111,111,
Oklahoma,Corporation Commissioner,Cliff Branan,REP,550034,0,0,124,124,
Oklahoma,U.S. Senate,Evelyn Rogers,REP,550034,0,0,9,9,
Oklahoma,U.S. Senate,Rob Moye,REP,550034,0,0,8,8,
Oklahoma,U.S. Senate,D. Jean Mcbride-Samuels,REP,550034,0,0,2,2,
Oklahoma,U.S. Senate,Jim Inhofe,REP,550034,0,0,238,238,
Oklahoma,U.S. Senate,Erick Paul Wyatt,REP,550034,0,0,11,11,
Oklahoma,U.S. Senate,Andy Craig,REP,550034,0,0,0,0,
Oklahoma,U.S. Senate,T. Shannon,REP,550034,0,0,54,54,
Oklahoma,U.S. Senate,Randy Brogdon,REP,550034,0,0,13,13,
Oklahoma,U.S. Senate,Eric Mccray,REP,550034,0,0,0,0,
Oklahoma,U.S. Senate,Kevin Crow,REP,550034,0,0,1,1,
Oklahoma,U.S. Senate,James Lankford,REP,550034,0,0,203,203,
Oklahoma,U.S. Senate,Jason Weger,REP,550034,0,0,0,0,
Oklahoma,U.S. House,Shane David Jett,REP,550034,0,0,22,22,05
Oklahoma,U.S. House,Patrice Douglas,REP,550034,0,0,72,72,05
Oklahoma,U.S. House,Mike Turner,REP,550034,0,0,41,41,05
Oklahoma,U.S. House,Steve Russell,REP,550034,0,0,76,76,05
Oklahoma,U.S. House,Harvey Sparks,REP,550034,0,0,10,10,05
Oklahoma,U.S. House,Clark Jolley,REP,550034,0,0,40,40,05
Oklahoma,State Senate,Mark Thomas,REP,550034,0,0,75,75,22
Oklahoma,State Senate,Leif Francel,REP,550034,0,0,84,84,22
Oklahoma,State Senate,Stephanie Bice,REP,550034,0,0,87,87,22
Oklahoma,State House,Jason Murphey,REP,550034,0,0,200,200,31
Oklahoma,State House,Andrew Muchmore,REP,550034,0,0,32,32,31
Oklahoma,Superintendent of Public Instruction,John Cox,DEM,550035,0,0,22,22,
Oklahoma,Superintendent of Public Instruction,Jack Jr.,DEM,550035,0,0,6,6,
Oklahoma,Superintendent of Public Instruction,Ivan Holmes,DEM,550035,0,0,3,3,
Oklahoma,Superintendent of Public Instruction,Freda Deskin,DEM,550035,0,0,37,37,
Oklahoma,U.S. Senate,Patrick Michael Hayes,DEM,550035,0,0,8,8,
Oklahoma,U.S. Senate,Jim Rogers,DEM,550035,0,0,13,13,
Oklahoma,U.S. Senate,Connie Johnson,DEM,550035,0,0,46,46,
Oklahoma,U.S. House,Tom Guild,DEM,550035,0,0,25,25,05
Oklahoma,U.S. House,Al Mcaffrey,DEM,550035,0,0,27,27,05
Oklahoma,U.S. House,Leona Leonard,DEM,550035,0,0,16,16,05
Oklahoma,Governor,Dax Ewbank,REP,550035,0,0,57,57,
Oklahoma,Governor,Chad Moody,REP,550035,0,0,73,73,
Oklahoma,Governor,Mary Fallin,REP,550035,0,0,312,312,
Oklahoma,Superintendent of Public Instruction,Brian Kelly,REP,550035,0,0,85,85,
Oklahoma,Superintendent of Public Instruction,Janet Costello Barresi,REP,550035,0,0,96,96,
Oklahoma,Superintendent of Public Instruction,Joy Hofmeister,REP,550035,0,0,241,241,
Oklahoma,Insurance Commissioner,Bill Viner,REP,550035,0,0,88,88,
Oklahoma,Insurance Commissioner,John Doak,REP,550035,0,0,308,308,
Oklahoma,Corporation Commissioner,Todd Hiett,REP,550035,0,0,203,203,
Oklahoma,Corporation Commissioner,Cliff Branan,REP,550035,0,0,195,195,
Oklahoma,U.S. Senate,Evelyn Rogers,REP,550035,0,0,17,17,
Oklahoma,U.S. Senate,Rob Moye,REP,550035,0,0,8,8,
Oklahoma,U.S. Senate,D. Jean Mcbride-Samuels,REP,550035,0,0,9,9,
Oklahoma,U.S. Senate,Jim Inhofe,REP,550035,0,0,377,377,
Oklahoma,U.S. Senate,Erick Paul Wyatt,REP,550035,0,0,21,21,
Oklahoma,U.S. Senate,Andy Craig,REP,550035,0,0,4,4,
Oklahoma,U.S. Senate,T. Shannon,REP,550035,0,0,101,101,
Oklahoma,U.S. Senate,Randy Brogdon,REP,550035,0,0,7,7,
Oklahoma,U.S. Senate,Eric Mccray,REP,550035,0,0,3,3,
Oklahoma,U.S. Senate,Kevin Crow,REP,550035,0,0,2,2,
Oklahoma,U.S. Senate,James Lankford,REP,550035,0,0,315,315,
Oklahoma,U.S. Senate,Jason Weger,REP,550035,0,0,8,8,
Oklahoma,U.S. House,Shane David Jett,REP,550035,0,0,39,39,05
Oklahoma,U.S. House,Patrice Douglas,REP,550035,0,0,114,114,05
Oklahoma,U.S. House,Mike Turner,REP,550035,0,0,76,76,05
Oklahoma,U.S. House,Steve Russell,REP,550035,0,0,101,101,05
Oklahoma,U.S. House,Harvey Sparks,REP,550035,0,0,13,13,05
Oklahoma,U.S. House,Clark Jolley,REP,550035,0,0,77,77,05
Oklahoma,State Senate,Mark Thomas,REP,550035,0,0,130,130,22
Oklahoma,State Senate,Leif Francel,REP,550035,0,0,97,97,22
Oklahoma,State Senate,Stephanie Bice,REP,550035,0,0,173,173,22
Oklahoma,State House,Gregory Duke Brown,REP,550035,0,0,16,16,82
Oklahoma,State House,Dustin Hopson,REP,550035,0,0,47,47,82
Oklahoma,State House,Adam Pugh,REP,550035,0,0,149,149,82
Oklahoma,State House,Kevin Calvey,REP,550035,0,0,187,187,82
Oklahoma,State House,Paul Ruckel,REP,550035,0,0,13,13,82
Oklahoma,Superintendent of Public Instruction,John Cox,DEM,550036,0,0,18,18,
Oklahoma,Superintendent of Public Instruction,Jack Jr.,DEM,550036,0,0,5,5,
Oklahoma,Superintendent of Public Instruction,Ivan Holmes,DEM,550036,0,0,9,9,
Oklahoma,Superintendent of Public Instruction,Freda Deskin,DEM,550036,0,0,30,30,
Oklahoma,U.S. Senate,Patrick Michael Hayes,DEM,550036,0,0,6,6,
Oklahoma,U.S. Senate,Jim Rogers,DEM,550036,0,0,6,6,
Oklahoma,U.S. Senate,Connie Johnson,DEM,550036,0,0,47,47,
Oklahoma,U.S. House,Tom Guild,DEM,550036,0,0,33,33,05
Oklahoma,U.S. House,Al Mcaffrey,DEM,550036,0,0,21,21,05
Oklahoma,U.S. House,Leona Leonard,DEM,550036,0,0,9,9,05
Oklahoma,Governor,Dax Ewbank,REP,550036,0,0,18,18,
Oklahoma,Governor,Chad Moody,REP,550036,0,0,25,25,
Oklahoma,Governor,Mary Fallin,REP,550036,0,0,243,243,
Oklahoma,Superintendent of Public Instruction,Brian Kelly,REP,550036,0,0,58,58,
Oklahoma,Superintendent of Public Instruction,Janet Costello Barresi,REP,550036,0,0,80,80,
Oklahoma,Superintendent of Public Instruction,Joy Hofmeister,REP,550036,0,0,146,146,
Oklahoma,Insurance Commissioner,Bill Viner,REP,550036,0,0,52,52,
Oklahoma,Insurance Commissioner,John Doak,REP,550036,0,0,200,200,
Oklahoma,Corporation Commissioner,Todd Hiett,REP,550036,0,0,120,120,
Oklahoma,Corporation Commissioner,Cliff Branan,REP,550036,0,0,135,135,
Oklahoma,U.S. Senate,Evelyn Rogers,REP,550036,0,0,11,11,
Oklahoma,U.S. Senate,Rob Moye,REP,550036,0,0,5,5,
Oklahoma,U.S. Senate,D. Jean Mcbride-Samuels,REP,550036,0,0,2,2,
Oklahoma,U.S. Senate,Jim Inhofe,REP,550036,0,0,261,261,
Oklahoma,U.S. Senate,Erick Paul Wyatt,REP,550036,0,0,3,3,
Oklahoma,U.S. Senate,Andy Craig,REP,550036,0,0,1,1,
Oklahoma,U.S. Senate,T. Shannon,REP,550036,0,0,62,62,
Oklahoma,U.S. Senate,Randy Brogdon,REP,550036,0,0,8,8,
Oklahoma,U.S. Senate,Eric Mccray,REP,550036,0,0,0,0,
Oklahoma,U.S. Senate,Kevin Crow,REP,550036,0,0,0,0,
Oklahoma,U.S. Senate,James Lankford,REP,550036,0,0,220,220,
Oklahoma,U.S. Senate,Jason Weger,REP,550036,0,0,0,0,
Oklahoma,U.S. House,Shane David Jett,REP,550036,0,0,18,18,05
Oklahoma,U.S. House,Patrice Douglas,REP,550036,0,0,93,93,05
Oklahoma,U.S. House,Mike Turner,REP,550036,0,0,36,36,05
Oklahoma,U.S. House,Steve Russell,REP,550036,0,0,68,68,05
Oklahoma,U.S. House,Harvey Sparks,REP,550036,0,0,9,9,05
Oklahoma,U.S. House,Clark Jolley,REP,550036,0,0,60,60,05
Oklahoma,State Senate,Mark Thomas,REP,550036,0,0,82,82,22
Oklahoma,State Senate,Leif Francel,REP,550036,0,0,44,44,22
Oklahoma,State Senate,Stephanie Bice,REP,550036,0,0,134,134,22
Oklahoma,Superintendent of Public Instruction,John Cox,DEM,550037,0,0,20,20,
Oklahoma,Superintendent of Public Instruction,Jack Jr.,DEM,550037,0,0,10,10,
Oklahoma,Superintendent of Public Instruction,Ivan Holmes,DEM,550037,0,0,9,9,
Oklahoma,Superintendent of Public Instruction,Freda Deskin,DEM,550037,0,0,40,40,
Oklahoma,U.S. Senate,Patrick Michael Hayes,DEM,550037,0,0,12,12,
Oklahoma,U.S. Senate,Jim Rogers,DEM,550037,0,0,16,16,
Oklahoma,U.S. Senate,Connie Johnson,DEM,550037,0,0,52,52,
Oklahoma,U.S. House,Tom Guild,DEM,550037,0,0,39,39,05
Oklahoma,U.S. House,Al Mcaffrey,DEM,550037,0,0,25,25,05
Oklahoma,U.S. House,Leona Leonard,DEM,550037,0,0,15,15,05
Oklahoma,Governor,Dax Ewbank,REP,550037,0,0,44,44,
Oklahoma,Governor,Chad Moody,REP,550037,0,0,46,46,
Oklahoma,Governor,Mary Fallin,REP,550037,0,0,279,279,
Oklahoma,Superintendent of Public Instruction,Brian Kelly,REP,550037,0,0,75,75,
Oklahoma,Superintendent of Public Instruction,Janet Costello Barresi,REP,550037,0,0,94,94,
Oklahoma,Superintendent of Public Instruction,Joy Hofmeister,REP,550037,0,0,194,194,
Oklahoma,Insurance Commissioner,Bill Viner,REP,550037,0,0,75,75,
Oklahoma,Insurance Commissioner,John Doak,REP,550037,0,0,260,260,
Oklahoma,Corporation Commissioner,Todd Hiett,REP,550037,0,0,169,169,
Oklahoma,Corporation Commissioner,Cliff Branan,REP,550037,0,0,167,167,
Oklahoma,U.S. Senate,Evelyn Rogers,REP,550037,0,0,14,14,
Oklahoma,U.S. Senate,Rob Moye,REP,550037,0,0,8,8,
Oklahoma,U.S. Senate,D. Jean Mcbride-Samuels,REP,550037,0,0,5,5,
Oklahoma,U.S. Senate,Jim Inhofe,REP,550037,0,0,328,328,
Oklahoma,U.S. Senate,Erick Paul Wyatt,REP,550037,0,0,14,14,
Oklahoma,U.S. Senate,Andy Craig,REP,550037,0,0,2,2,
Oklahoma,U.S. Senate,T. Shannon,REP,550037,0,0,101,101,
Oklahoma,U.S. Senate,Randy Brogdon,REP,550037,0,0,15,15,
Oklahoma,U.S. Senate,Eric Mccray,REP,550037,0,0,2,2,
Oklahoma,U.S. Senate,Kevin Crow,REP,550037,0,0,2,2,
Oklahoma,U.S. Senate,James Lankford,REP,550037,0,0,253,253,
Oklahoma,U.S. Senate,Jason Weger,REP,550037,0,0,0,0,
Oklahoma,U.S. House,Shane David Jett,REP,550037,0,0,12,12,05
Oklahoma,U.S. House,Patrice Douglas,REP,550037,0,0,116,116,05
Oklahoma,U.S. House,Mike Turner,REP,550037,0,0,34,34,05
Oklahoma,U.S. House,Steve Russell,REP,550037,0,0,76,76,05
Oklahoma,U.S. House,Harvey Sparks,REP,550037,0,0,12,12,05
Oklahoma,U.S. House,Clark Jolley,REP,550037,0,0,110,110,05
Oklahoma,State Senate,Mark Thomas,REP,550037,0,0,103,103,22
Oklahoma,State Senate,Leif Francel,REP,550037,0,0,111,111,22
Oklahoma,State Senate,Stephanie Bice,REP,550037,0,0,129,129,22
Oklahoma,Superintendent of Public Instruction,John Cox,DEM,550038,0,0,25,25,
Oklahoma,Superintendent of Public Instruction,Jack Jr.,DEM,550038,0,0,10,10,
Oklahoma,Superintendent of Public Instruction,Ivan Holmes,DEM,550038,0,0,5,5,
Oklahoma,Superintendent of Public Instruction,Freda Deskin,DEM,550038,0,0,35,35,
Oklahoma,U.S. Senate,Patrick Michael Hayes,DEM,550038,0,0,17,17,
Oklahoma,U.S. Senate,Jim Rogers,DEM,550038,0,0,16,16,
Oklahoma,U.S. Senate,Connie Johnson,DEM,550038,0,0,39,39,
Oklahoma,U.S. House,Tom Guild,DEM,550038,0,0,39,39,05
Oklahoma,U.S. House,Al Mcaffrey,DEM,550038,0,0,24,24,05
Oklahoma,U.S. House,Leona Leonard,DEM,550038,0,0,12,12,05
Oklahoma,Governor,Dax Ewbank,REP,550038,0,0,21,21,
Oklahoma,Governor,Chad Moody,REP,550038,0,0,36,36,
Oklahoma,Governor,Mary Fallin,REP,550038,0,0,223,223,
Oklahoma,Superintendent of Public Instruction,Brian Kelly,REP,550038,0,0,55,55,
Oklahoma,Superintendent of Public Instruction,Janet Costello Barresi,REP,550038,0,0,77,77,
Oklahoma,Superintendent of Public Instruction,Joy Hofmeister,REP,550038,0,0,142,142,
Oklahoma,Insurance Commissioner,Bill Viner,REP,550038,0,0,55,55,
Oklahoma,Insurance Commissioner,John Doak,REP,550038,0,0,196,196,
Oklahoma,Corporation Commissioner,Todd Hiett,REP,550038,0,0,125,125,
Oklahoma,Corporation Commissioner,Cliff Branan,REP,550038,0,0,130,130,
Oklahoma,U.S. Senate,Evelyn Rogers,REP,550038,0,0,8,8,
Oklahoma,U.S. Senate,Rob Moye,REP,550038,0,0,8,8,
Oklahoma,U.S. Senate,D. Jean Mcbride-Samuels,REP,550038,0,0,1,1,
Oklahoma,U.S. Senate,Jim Inhofe,REP,550038,0,0,246,246,
Oklahoma,U.S. Senate,Erick Paul Wyatt,REP,550038,0,0,13,13,
Oklahoma,U.S. Senate,Andy Craig,REP,550038,0,0,0,0,
Oklahoma,U.S. Senate,T. Shannon,REP,550038,0,0,56,56,
Oklahoma,U.S. Senate,Randy Brogdon,REP,550038,0,0,15,15,
Oklahoma,U.S. Senate,Eric Mccray,REP,550038,0,0,0,0,
Oklahoma,U.S. Senate,Kevin Crow,REP,550038,0,0,2,2,
Oklahoma,U.S. Senate,James Lankford,REP,550038,0,0,206,206,
Oklahoma,U.S. Senate,Jason Weger,REP,550038,0,0,2,2,
Oklahoma,U.S. House,Shane David Jett,REP,550038,0,0,16,16,05
Oklahoma,U.S. House,Patrice Douglas,REP,550038,0,0,81,81,05
Oklahoma,U.S. House,Mike Turner,REP,550038,0,0,33,33,05
Oklahoma,U.S. House,Steve Russell,REP,550038,0,0,57,57,05
Oklahoma,U.S. House,Harvey Sparks,REP,550038,0,0,15,15,05
Oklahoma,U.S. House,Clark Jolley,REP,550038,0,0,72,72,05
Oklahoma,State Senate,Mark Thomas,REP,550038,0,0,76,76,22
Oklahoma,State Senate,Leif Francel,REP,550038,0,0,36,36,22
Oklahoma,State Senate,Stephanie Bice,REP,550038,0,0,151,151,22
Oklahoma,Superintendent of Public Instruction,John Cox,DEM,550039,0,0,24,24,
Oklahoma,Superintendent of Public Instruction,Jack Jr.,DEM,550039,0,0,5,5,
Oklahoma,Superintendent of Public Instruction,Ivan Holmes,DEM,550039,0,0,6,6,
Oklahoma,Superintendent of Public Instruction,Freda Deskin,DEM,550039,0,0,39,39,
Oklahoma,U.S. Senate,Patrick Michael Hayes,DEM,550039,0,0,11,11,
Oklahoma,U.S. Senate,Jim Rogers,DEM,550039,0,0,14,14,
Oklahoma,U.S. Senate,Connie Johnson,DEM,550039,0,0,51,51,
Oklahoma,U.S. House,Tom Guild,DEM,550039,0,0,42,42,05
Oklahoma,U.S. House,Al Mcaffrey,DEM,550039,0,0,9,9,05
Oklahoma,U.S. House,Leona Leonard,DEM,550039,0,0,23,23,05
Oklahoma,Governor,Dax Ewbank,REP,550039,0,0,24,24,
Oklahoma,Governor,Chad Moody,REP,550039,0,0,47,47,
Oklahoma,Governor,Mary Fallin,REP,550039,0,0,219,219,
Oklahoma,Superintendent of Public Instruction,Brian Kelly,REP,550039,0,0,65,65,
Oklahoma,Superintendent of Public Instruction,Janet Costello Barresi,REP,550039,0,0,67,67,
Oklahoma,Superintendent of Public Instruction,Joy Hofmeister,REP,550039,0,0,156,156,
Oklahoma,Insurance Commissioner,Bill Viner,REP,550039,0,0,43,43,
Oklahoma,Insurance Commissioner,John Doak,REP,550039,0,0,218,218,
Oklahoma,Corporation Commissioner,Todd Hiett,REP,550039,0,0,138,138,
Oklahoma,Corporation Commissioner,Cliff Branan,REP,550039,0,0,126,126,
Oklahoma,U.S. Senate,Evelyn Rogers,REP,550039,0,0,9,9,
Oklahoma,U.S. Senate,Rob Moye,REP,550039,0,0,6,6,
Oklahoma,U.S. Senate,D. Jean Mcbride-Samuels,REP,550039,0,0,2,2,
Oklahoma,U.S. Senate,Jim Inhofe,REP,550039,0,0,267,267,
Oklahoma,U.S. Senate,Erick Paul Wyatt,REP,550039,0,0,6,6,
Oklahoma,U.S. Senate,Andy Craig,REP,550039,0,0,0,0,
Oklahoma,U.S. Senate,T. Shannon,REP,550039,0,0,63,63,
Oklahoma,U.S. Senate,Randy Brogdon,REP,550039,0,0,7,7,
Oklahoma,U.S. Senate,Eric Mccray,REP,550039,0,0,1,1,
Oklahoma,U.S. Senate,Kevin Crow,REP,550039,0,0,0,0,
Oklahoma,U.S. Senate,James Lankford,REP,550039,0,0,223,223,
Oklahoma,U.S. Senate,Jason Weger,REP,550039,0,0,2,2,
Oklahoma,U.S. House,Shane David Jett,REP,550039,0,0,29,29,05
Oklahoma,U.S. House,Patrice Douglas,REP,550039,0,0,96,96,05
Oklahoma,U.S. House,Mike Turner,REP,550039,0,0,21,21,05
Oklahoma,U.S. House,Steve Russell,REP,550039,0,0,68,68,05
Oklahoma,U.S. House,Harvey Sparks,REP,550039,0,0,7,7,05
Oklahoma,U.S. House,Clark Jolley,REP,550039,0,0,63,63,05
Oklahoma,Superintendent of Public Instruction,John Cox,DEM,550040,0,0,25,25,
Oklahoma,Superintendent of Public Instruction,Jack Jr.,DEM,550040,0,0,7,7,
Oklahoma,Superintendent of Public Instruction,Ivan Holmes,DEM,550040,0,0,4,4,
Oklahoma,Superintendent of Public Instruction,Freda Deskin,DEM,550040,0,0,60,60,
Oklahoma,U.S. Senate,Patrick Michael Hayes,DEM,550040,0,0,13,13,
Oklahoma,U.S. Senate,Jim Rogers,DEM,550040,0,0,23,23,
Oklahoma,U.S. Senate,Connie Johnson,DEM,550040,0,0,55,55,
Oklahoma,U.S. House,Tom Guild,DEM,550040,0,0,42,42,05
Oklahoma,U.S. House,Al Mcaffrey,DEM,550040,0,0,22,22,05
Oklahoma,U.S. House,Leona Leonard,DEM,550040,0,0,31,31,05
Oklahoma,Governor,Dax Ewbank,REP,550040,0,0,39,39,
Oklahoma,Governor,Chad Moody,REP,550040,0,0,76,76,
Oklahoma,Governor,Mary Fallin,REP,550040,0,0,319,319,
Oklahoma,Superintendent of Public Instruction,Brian Kelly,REP,550040,0,0,103,103,
Oklahoma,Superintendent of Public Instruction,Janet Costello Barresi,REP,550040,0,0,103,103,
Oklahoma,Superintendent of Public Instruction,Joy Hofmeister,REP,550040,0,0,220,220,
Oklahoma,Insurance Commissioner,Bill Viner,REP,550040,0,0,76,76,
Oklahoma,Insurance Commissioner,John Doak,REP,550040,0,0,315,315,
Oklahoma,Corporation Commissioner,Todd Hiett,REP,550040,0,0,205,205,
Oklahoma,Corporation Commissioner,Cliff Branan,REP,550040,0,0,194,194,
Oklahoma,U.S. Senate,Evelyn Rogers,REP,550040,0,0,26,26,
Oklahoma,U.S. Senate,Rob Moye,REP,550040,0,0,3,3,
Oklahoma,U.S. Senate,D. Jean Mcbride-Samuels,REP,550040,0,0,2,2,
Oklahoma,U.S. Senate,Jim Inhofe,REP,550040,0,0,377,377,
Oklahoma,U.S. Senate,Erick Paul Wyatt,REP,550040,0,0,18,18,
Oklahoma,U.S. Senate,Andy Craig,REP,550040,0,0,4,4,
Oklahoma,U.S. Senate,T. Shannon,REP,550040,0,0,104,104,
Oklahoma,U.S. Senate,Randy Brogdon,REP,550040,0,0,7,7,
Oklahoma,U.S. Senate,Eric Mccray,REP,550040,0,0,3,3,
Oklahoma,U.S. Senate,Kevin Crow,REP,550040,0,0,3,3,
Oklahoma,U.S. Senate,James Lankford,REP,550040,0,0,311,311,
Oklahoma,U.S. Senate,Jason Weger,REP,550040,0,0,5,5,
Oklahoma,U.S. House,Shane David Jett,REP,550040,0,0,31,31,05
Oklahoma,U.S. House,Patrice Douglas,REP,550040,0,0,116,116,05
Oklahoma,U.S. House,Mike Turner,REP,550040,0,0,57,57,05
Oklahoma,U.S. House,Steve Russell,REP,550040,0,0,79,79,05
Oklahoma,U.S. House,Harvey Sparks,REP,550040,0,0,12,12,05
Oklahoma,U.S. House,Clark Jolley,REP,550040,0,0,125,125,05
Oklahoma,State Senate,Mark Thomas,REP,550040,0,0,137,137,22
Oklahoma,State Senate,Leif Francel,REP,550040,0,0,60,60,22
Oklahoma,State Senate,Stephanie Bice,REP,550040,0,0,198,198,22
Oklahoma,Superintendent of Public Instruction,John Cox,DEM,550041,0,0,7,7,
Oklahoma,Superintendent of Public Instruction,Jack Jr.,DEM,550041,0,0,12,12,
Oklahoma,Superintendent of Public Instruction,Ivan Holmes,DEM,550041,0,0,4,4,
Oklahoma,Superintendent of Public Instruction,Freda Deskin,DEM,550041,0,0,47,47,
Oklahoma,U.S. Senate,Patrick Michael Hayes,DEM,550041,0,0,5,5,
Oklahoma,U.S. Senate,Jim Rogers,DEM,550041,0,0,11,11,
Oklahoma,U.S. Senate,Connie Johnson,DEM,550041,0,0,54,54,
Oklahoma,U.S. House,Tom Guild,DEM,550041,0,0,29,29,05
Oklahoma,U.S. House,Al Mcaffrey,DEM,550041,0,0,19,19,05
Oklahoma,U.S. House,Leona Leonard,DEM,550041,0,0,25,25,05
Oklahoma,Governor,Dax Ewbank,REP,550041,0,0,29,29,
Oklahoma,Governor,Chad Moody,REP,550041,0,0,37,37,
Oklahoma,Governor,Mary Fallin,REP,550041,0,0,210,210,
Oklahoma,Superintendent of Public Instruction,Brian Kelly,REP,550041,0,0,63,63,
Oklahoma,Superintendent of Public Instruction,Janet Costello Barresi,REP,550041,0,0,69,69,
Oklahoma,Superintendent of Public Instruction,Joy Hofmeister,REP,550041,0,0,138,138,
Oklahoma,Insurance Commissioner,Bill Viner,REP,550041,0,0,54,54,
Oklahoma,Insurance Commissioner,John Doak,REP,550041,0,0,196,196,
Oklahoma,Corporation Commissioner,Todd Hiett,REP,550041,0,0,119,119,
Oklahoma,Corporation Commissioner,Cliff Branan,REP,550041,0,0,137,137,
Oklahoma,U.S. Senate,Evelyn Rogers,REP,550041,0,0,13,13,
Oklahoma,U.S. Senate,Rob Moye,REP,550041,0,0,10,10,
Oklahoma,U.S. Senate,D. Jean Mcbride-Samuels,REP,550041,0,0,3,3,
Oklahoma,U.S. Senate,Jim Inhofe,REP,550041,0,0,235,235,
Oklahoma,U.S. Senate,Erick Paul Wyatt,REP,550041,0,0,7,7,
Oklahoma,U.S. Senate,Andy Craig,REP,550041,0,0,3,3,
Oklahoma,U.S. Senate,T. Shannon,REP,550041,0,0,62,62,
Oklahoma,U.S. Senate,Randy Brogdon,REP,550041,0,0,8,8,
Oklahoma,U.S. Senate,Eric Mccray,REP,550041,0,0,2,2,
Oklahoma,U.S. Senate,Kevin Crow,REP,550041,0,0,1,1,
Oklahoma,U.S. Senate,James Lankford,REP,550041,0,0,201,201,
Oklahoma,U.S. Senate,Jason Weger,REP,550041,0,0,0,0,
Oklahoma,U.S. House,Shane David Jett,REP,550041,0,0,16,16,05
Oklahoma,U.S. House,Patrice Douglas,REP,550041,0,0,79,79,05
Oklahoma,U.S. House,Mike Turner,REP,550041,0,0,37,37,05
Oklahoma,U.S. House,Steve Russell,REP,550041,0,0,53,53,05
Oklahoma,U.S. House,Harvey Sparks,REP,550041,0,0,8,8,05
Oklahoma,U.S. House,Clark Jolley,REP,550041,0,0,72,72,05
Oklahoma,State Senate,Mark Thomas,REP,550041,0,0,105,105,22
Oklahoma,State Senate,Leif Francel,REP,550041,0,0,32,32,22
Oklahoma,State Senate,Stephanie Bice,REP,550041,0,0,109,109,22
Oklahoma,Superintendent of Public Instruction,John Cox,DEM,550042,0,0,17,17,
Oklahoma,Superintendent of Public Instruction,Jack Jr.,DEM,550042,0,0,7,7,
Oklahoma,Superintendent of Public Instruction,Ivan Holmes,DEM,550042,0,0,4,4,
Oklahoma,Superintendent of Public Instruction,Freda Deskin,DEM,550042,0,0,30,30,
Oklahoma,U.S. Senate,Patrick Michael Hayes,DEM,550042,0,0,11,11,
Oklahoma,U.S. Senate,Jim Rogers,DEM,550042,0,0,9,9,
Oklahoma,U.S. Senate,Connie Johnson,DEM,550042,0,0,38,38,
Oklahoma,U.S. House,Tom Guild,DEM,550042,0,0,28,28,05
Oklahoma,U.S. House,Al Mcaffrey,DEM,550042,0,0,11,11,05
Oklahoma,U.S. House,Leona Leonard,DEM,550042,0,0,19,19,05
Oklahoma,Governor,Dax Ewbank,REP,550042,0,0,29,29,
Oklahoma,Governor,Chad Moody,REP,550042,0,0,47,47,
Oklahoma,Governor,Mary Fallin,REP,550042,0,0,313,313,
Oklahoma,Superintendent of Public Instruction,Brian Kelly,REP,550042,0,0,71,71,
Oklahoma,Superintendent of Public Instruction,Janet Costello Barresi,REP,550042,0,0,116,116,
Oklahoma,Superintendent of Public Instruction,Joy Hofmeister,REP,550042,0,0,199,199,
Oklahoma,Insurance Commissioner,Bill Viner,REP,550042,0,0,68,68,
Oklahoma,Insurance Commissioner,John Doak,REP,550042,0,0,286,286,
Oklahoma,Corporation Commissioner,Todd Hiett,REP,550042,0,0,179,179,
Oklahoma,Corporation Commissioner,Cliff Branan,REP,550042,0,0,174,174,
Oklahoma,U.S. Senate,Evelyn Rogers,REP,550042,0,0,24,24,
Oklahoma,U.S. Senate,Rob Moye,REP,550042,0,0,4,4,
Oklahoma,U.S. Senate,D. Jean Mcbride-Samuels,REP,550042,0,0,1,1,
Oklahoma,U.S. Senate,Jim Inhofe,REP,550042,0,0,345,345,
Oklahoma,U.S. Senate,Erick Paul Wyatt,REP,550042,0,0,13,13,
Oklahoma,U.S. Senate,Andy Craig,REP,550042,0,0,3,3,
Oklahoma,U.S. Senate,T. Shannon,REP,550042,0,0,97,97,
Oklahoma,U.S. Senate,Randy Brogdon,REP,550042,0,0,10,10,
Oklahoma,U.S. Senate,Eric Mccray,REP,550042,0,0,0,0,
Oklahoma,U.S. Senate,Kevin Crow,REP,550042,0,0,1,1,
Oklahoma,U.S. Senate,James Lankford,REP,550042,0,0,279,279,
Oklahoma,U.S. Senate,Jason Weger,REP,550042,0,0,1,1,
Oklahoma,U.S. House,Shane David Jett,REP,550042,0,0,28,28,05
Oklahoma,U.S. House,Patrice Douglas,REP,550042,0,0,119,119,05
Oklahoma,U.S. House,Mike Turner,REP,550042,0,0,27,27,05
Oklahoma,U.S. House,Steve Russell,REP,550042,0,0,78,78,05
Oklahoma,U.S. House,Harvey Sparks,REP,550042,0,0,13,13,05
Oklahoma,U.S. House,Clark Jolley,REP,550042,0,0,119,119,05
Oklahoma,Superintendent of Public Instruction,John Cox,DEM,550043,0,0,6,6,
Oklahoma,Superintendent of Public Instruction,Jack Jr.,DEM,550043,0,0,6,6,
Oklahoma,Superintendent of Public Instruction,Ivan Holmes,DEM,550043,0,0,7,7,
Oklahoma,Superintendent of Public Instruction,Freda Deskin,DEM,550043,0,0,36,36,
Oklahoma,U.S. Senate,Patrick Michael Hayes,DEM,550043,0,0,10,10,
Oklahoma,U.S. Senate,Jim Rogers,DEM,550043,0,0,13,13,
Oklahoma,U.S. Senate,Connie Johnson,DEM,550043,0,0,29,29,
Oklahoma,U.S. House,Tom Guild,DEM,550043,0,0,22,22,05
Oklahoma,U.S. House,Al Mcaffrey,DEM,550043,0,0,16,16,05
Oklahoma,U.S. House,Leona Leonard,DEM,550043,0,0,17,17,05
Oklahoma,Governor,Dax Ewbank,REP,550043,0,0,35,35,
Oklahoma,Governor,Chad Moody,REP,550043,0,0,44,44,
Oklahoma,Governor,Mary Fallin,REP,550043,0,0,531,531,
Oklahoma,Superintendent of Public Instruction,Brian Kelly,REP,550043,0,0,119,119,
Oklahoma,Superintendent of Public Instruction,Janet Costello Barresi,REP,550043,0,0,241,241,
Oklahoma,Superintendent of Public Instruction,Joy Hofmeister,REP,550043,0,0,235,235,
Oklahoma,Insurance Commissioner,Bill Viner,REP,550043,0,0,79,79,
Oklahoma,Insurance Commissioner,John Doak,REP,550043,0,0,462,462,
Oklahoma,Corporation Commissioner,Todd Hiett,REP,550043,0,0,242,242,
Oklahoma,Corporation Commissioner,Cliff Branan,REP,550043,0,0,314,314,
Oklahoma,U.S. Senate,Evelyn Rogers,REP,550043,0,0,15,15,
Oklahoma,U.S. Senate,Rob Moye,REP,550043,0,0,7,7,
Oklahoma,U.S. Senate,D. Jean Mcbride-Samuels,REP,550043,0,0,4,4,
Oklahoma,U.S. Senate,Jim Inhofe,REP,550043,0,0,562,562,
Oklahoma,U.S. Senate,Erick Paul Wyatt,REP,550043,0,0,14,14,
Oklahoma,U.S. Senate,Andy Craig,REP,550043,0,0,2,2,
Oklahoma,U.S. Senate,T. Shannon,REP,550043,0,0,139,139,
Oklahoma,U.S. Senate,Randy Brogdon,REP,550043,0,0,8,8,
Oklahoma,U.S. Senate,Eric Mccray,REP,550043,0,0,0,0,
Oklahoma,U.S. Senate,Kevin Crow,REP,550043,0,0,0,0,
Oklahoma,U.S. Senate,James Lankford,REP,550043,0,0,460,460,
Oklahoma,U.S. Senate,Jason Weger,REP,550043,0,0,4,4,
Oklahoma,U.S. House,Shane David Jett,REP,550043,0,0,21,21,05
Oklahoma,U.S. House,Patrice Douglas,REP,550043,0,0,219,219,05
Oklahoma,U.S. House,Mike Turner,REP,550043,0,0,66,66,05
Oklahoma,U.S. House,Steve Russell,REP,550043,0,0,158,158,05
Oklahoma,U.S. House,Harvey Sparks,REP,550043,0,0,9,9,05
Oklahoma,U.S. House,Clark Jolley,REP,550043,0,0,130,130,05
Oklahoma,Superintendent of Public Instruction,John Cox,DEM,550044,0,0,30,30,
Oklahoma,Superintendent of Public Instruction,Jack Jr.,DEM,550044,0,0,12,12,
Oklahoma,Superintendent of Public Instruction,Ivan Holmes,DEM,550044,0,0,2,2,
Oklahoma,Superintendent of Public Instruction,Freda Deskin,DEM,550044,0,0,39,39,
Oklahoma,U.S. Senate,Patrick Michael Hayes,DEM,550044,0,0,15,15,
Oklahoma,U.S. Senate,Jim Rogers,DEM,550044,0,0,10,10,
Oklahoma,U.S. Senate,Connie Johnson,DEM,550044,0,0,57,57,
Oklahoma,U.S. House,Tom Guild,DEM,550044,0,0,38,38,05
Oklahoma,U.S. House,Al Mcaffrey,DEM,550044,0,0,27,27,05
Oklahoma,U.S. House,Leona Leonard,DEM,550044,0,0,17,17,05
Oklahoma,Governor,Dax Ewbank,REP,550044,0,0,26,26,
Oklahoma,Governor,Chad Moody,REP,550044,0,0,73,73,
Oklahoma,Governor,Mary Fallin,REP,550044,0,0,417,417,
Oklahoma,Superintendent of Public Instruction,Brian Kelly,REP,550044,0,0,107,107,
Oklahoma,Superintendent of Public Instruction,Janet Costello Barresi,REP,550044,0,0,157,157,
Oklahoma,Superintendent of Public Instruction,Joy Hofmeister,REP,550044,0,0,251,251,
Oklahoma,Insurance Commissioner,Bill Viner,REP,550044,0,0,79,79,
Oklahoma,Insurance Commissioner,John Doak,REP,550044,0,0,386,386,
Oklahoma,Corporation Commissioner,Todd Hiett,REP,550044,0,0,212,212,
Oklahoma,Corporation Commissioner,Cliff Branan,REP,550044,0,0,251,251,
Oklahoma,U.S. Senate,Evelyn Rogers,REP,550044,0,0,39,39,
Oklahoma,U.S. Senate,Rob Moye,REP,550044,0,0,9,9,
Oklahoma,U.S. Senate,D. Jean Mcbride-Samuels,REP,550044,0,0,7,7,
Oklahoma,U.S. Senate,Jim Inhofe,REP,550044,0,0,443,443,
Oklahoma,U.S. Senate,Erick Paul Wyatt,REP,550044,0,0,9,9,
Oklahoma,U.S. Senate,Andy Craig,REP,550044,0,0,3,3,
Oklahoma,U.S. Senate,T. Shannon,REP,550044,0,0,114,114,
Oklahoma,U.S. Senate,Randy Brogdon,REP,550044,0,0,10,10,
Oklahoma,U.S. Senate,Eric Mccray,REP,550044,0,0,4,4,
Oklahoma,U.S. Senate,Kevin Crow,REP,550044,0,0,1,1,
Oklahoma,U.S. Senate,James Lankford,REP,550044,0,0,395,395,
Oklahoma,U.S. Senate,Jason Weger,REP,550044,0,0,3,3,
Oklahoma,U.S. House,Shane David Jett,REP,550044,0,0,35,35,05
Oklahoma,U.S. House,Patrice Douglas,REP,550044,0,0,128,128,05
Oklahoma,U.S. House,Mike Turner,REP,550044,0,0,37,37,05
Oklahoma,U.S. House,Steve Russell,REP,550044,0,0,118,118,05
Oklahoma,U.S. House,Harvey Sparks,REP,550044,0,0,18,18,05
Oklahoma,U.S. House,Clark Jolley,REP,550044,0,0,177,177,05
Oklahoma,Superintendent of Public Instruction,John Cox,DEM,550045,0,0,19,19,
Oklahoma,Superintendent of Public Instruction,Jack Jr.,DEM,550045,0,0,14,14,
Oklahoma,Superintendent of Public Instruction,Ivan Holmes,DEM,550045,0,0,2,2,
Oklahoma,Superintendent of Public Instruction,Freda Deskin,DEM,550045,0,0,53,53,
Oklahoma,U.S. Senate,Patrick Michael Hayes,DEM,550045,0,0,12,12,
Oklahoma,U.S. Senate,Jim Rogers,DEM,550045,0,0,21,21,
Oklahoma,U.S. Senate,Connie Johnson,DEM,550045,0,0,50,50,
Oklahoma,U.S. House,Tom Guild,DEM,550045,0,0,44,44,05
Oklahoma,U.S. House,Al Mcaffrey,DEM,550045,0,0,24,24,05
Oklahoma,U.S. House,Leona Leonard,DEM,550045,0,0,18,18,05
Oklahoma,Governor,Dax Ewbank,REP,550045,0,0,43,43,
Oklahoma,Governor,Chad Moody,REP,550045,0,0,71,71,
Oklahoma,Governor,Mary Fallin,REP,550045,0,0,533,533,
Oklahoma,Superintendent of Public Instruction,Brian Kelly,REP,550045,0,0,117,117,
Oklahoma,Superintendent of Public Instruction,Janet Costello Barresi,REP,550045,0,0,212,212,
Oklahoma,Superintendent of Public Instruction,Joy Hofmeister,REP,550045,0,0,292,292,
Oklahoma,Insurance Commissioner,Bill Viner,REP,550045,0,0,96,96,
Oklahoma,Insurance Commissioner,John Doak,REP,550045,0,0,485,485,
Oklahoma,Corporation Commissioner,Todd Hiett,REP,550045,0,0,262,262,
Oklahoma,Corporation Commissioner,Cliff Branan,REP,550045,0,0,319,319,
Oklahoma,U.S. Senate,Evelyn Rogers,REP,550045,0,0,33,33,
Oklahoma,U.S. Senate,Rob Moye,REP,550045,0,0,7,7,
Oklahoma,U.S. Senate,D. Jean Mcbride-Samuels,REP,550045,0,0,4,4,
Oklahoma,U.S. Senate,Jim Inhofe,REP,550045,0,0,575,575,
Oklahoma,U.S. Senate,Erick Paul Wyatt,REP,550045,0,0,17,17,
Oklahoma,U.S. Senate,Andy Craig,REP,550045,0,0,3,3,
Oklahoma,U.S. Senate,T. Shannon,REP,550045,0,0,147,147,
Oklahoma,U.S. Senate,Randy Brogdon,REP,550045,0,0,12,12,
Oklahoma,U.S. Senate,Eric Mccray,REP,550045,0,0,2,2,
Oklahoma,U.S. Senate,Kevin Crow,REP,550045,0,0,2,2,
Oklahoma,U.S. Senate,James Lankford,REP,550045,0,0,485,485,
Oklahoma,U.S. Senate,Jason Weger,REP,550045,0,0,2,2,
Oklahoma,U.S. House,Shane David Jett,REP,550045,0,0,23,23,05
Oklahoma,U.S. House,Patrice Douglas,REP,550045,0,0,217,217,05
Oklahoma,U.S. House,Mike Turner,REP,550045,0,0,44,44,05
Oklahoma,U.S. House,Steve Russell,REP,550045,0,0,129,129,05
Oklahoma,U.S. House,Harvey Sparks,REP,550045,0,0,17,17,05
Oklahoma,U.S. House,Clark Jolley,REP,550045,0,0,213,213,05
Oklahoma,Superintendent of Public Instruction,John Cox,DEM,550046,0,0,18,18,
Oklahoma,Superintendent of Public Instruction,Jack Jr.,DEM,550046,0,0,6,6,
Oklahoma,Superintendent of Public Instruction,Ivan Holmes,DEM,550046,0,0,3,3,
Oklahoma,Superintendent of Public Instruction,Freda Deskin,DEM,550046,0,0,19,19,
Oklahoma,U.S. Senate,Patrick Michael Hayes,DEM,550046,0,0,9,9,
Oklahoma,U.S. Senate,Jim Rogers,DEM,550046,0,0,6,6,
Oklahoma,U.S. Senate,Connie Johnson,DEM,550046,0,0,29,29,
Oklahoma,U.S. House,Tom Guild,DEM,550046,0,0,24,24,05
Oklahoma,U.S. House,Al Mcaffrey,DEM,550046,0,0,14,14,05
Oklahoma,U.S. House,Leona Leonard,DEM,550046,0,0,8,8,05
Oklahoma,Governor,Dax Ewbank,REP,550046,0,0,6,6,
Oklahoma,Governor,Chad Moody,REP,550046,0,0,23,23,
Oklahoma,Governor,Mary Fallin,REP,550046,0,0,118,118,
Oklahoma,Superintendent of Public Instruction,Brian Kelly,REP,550046,0,0,24,24,
Oklahoma,Superintendent of Public Instruction,Janet Costello Barresi,REP,550046,0,0,39,39,
Oklahoma,Superintendent of Public Instruction,Joy Hofmeister,REP,550046,0,0,79,79,
Oklahoma,Insurance Commissioner,Bill Viner,REP,550046,0,0,31,31,
Oklahoma,Insurance Commissioner,John Doak,REP,550046,0,0,99,99,
Oklahoma,Corporation Commissioner,Todd Hiett,REP,550046,0,0,79,79,
Oklahoma,Corporation Commissioner,Cliff Branan,REP,550046,0,0,49,49,
Oklahoma,U.S. Senate,Evelyn Rogers,REP,550046,0,0,8,8,
Oklahoma,U.S. Senate,Rob Moye,REP,550046,0,0,3,3,
Oklahoma,U.S. Senate,D. Jean Mcbride-Samuels,REP,550046,0,0,1,1,
Oklahoma,U.S. Senate,Jim Inhofe,REP,550046,0,0,128,128,
Oklahoma,U.S. Senate,Erick Paul Wyatt,REP,550046,0,0,5,5,
Oklahoma,U.S. Senate,Andy Craig,REP,550046,0,0,1,1,
Oklahoma,U.S. Senate,T. Shannon,REP,550046,0,0,38,38,
Oklahoma,U.S. Senate,Randy Brogdon,REP,550046,0,0,3,3,
Oklahoma,U.S. Senate,Eric Mccray,REP,550046,0,0,3,3,
Oklahoma,U.S. Senate,Kevin Crow,REP,550046,0,0,0,0,
Oklahoma,U.S. Senate,James Lankford,REP,550046,0,0,102,102,
Oklahoma,U.S. Senate,Jason Weger,REP,550046,0,0,0,0,
Oklahoma,U.S. House,Shane David Jett,REP,550046,0,0,6,6,05
Oklahoma,U.S. House,Patrice Douglas,REP,550046,0,0,43,43,05
Oklahoma,U.S. House,Mike Turner,REP,550046,0,0,11,11,05
Oklahoma,U.S. House,Steve Russell,REP,550046,0,0,29,29,05
Oklahoma,U.S. House,Harvey Sparks,REP,550046,0,0,5,5,05
Oklahoma,U.S. House,Clark Jolley,REP,550046,0,0,48,48,05
Oklahoma,Superintendent of Public Instruction,John Cox,DEM,550047,0,0,16,16,
Oklahoma,Superintendent of Public Instruction,Jack Jr.,DEM,550047,0,0,8,8,
Oklahoma,Superintendent of Public Instruction,Ivan Holmes,DEM,550047,0,0,5,5,
Oklahoma,Superintendent of Public Instruction,Freda Deskin,DEM,550047,0,0,21,21,
Oklahoma,U.S. Senate,Patrick Michael Hayes,DEM,550047,0,0,8,8,
Oklahoma,U.S. Senate,Jim Rogers,DEM,550047,0,0,15,15,
Oklahoma,U.S. Senate,Connie Johnson,DEM,550047,0,0,26,26,
Oklahoma,U.S. House,Tom Guild,DEM,550047,0,0,31,31,05
Oklahoma,U.S. House,Al Mcaffrey,DEM,550047,0,0,8,8,05
Oklahoma,U.S. House,Leona Leonard,DEM,550047,0,0,12,12,05
Oklahoma,Governor,Dax Ewbank,REP,550047,0,0,12,12,
Oklahoma,Governor,Chad Moody,REP,550047,0,0,23,23,
Oklahoma,Governor,Mary Fallin,REP,550047,0,0,85,85,
Oklahoma,Superintendent of Public Instruction,Brian Kelly,REP,550047,0,0,33,33,
Oklahoma,Superintendent of Public Instruction,Janet Costello Barresi,REP,550047,0,0,32,32,
Oklahoma,Superintendent of Public Instruction,Joy Hofmeister,REP,550047,0,0,55,55,
Oklahoma,Insurance Commissioner,Bill Viner,REP,550047,0,0,25,25,
Oklahoma,Insurance Commissioner,John Doak,REP,550047,0,0,92,92,
Oklahoma,Corporation Commissioner,Todd Hiett,REP,550047,0,0,56,56,
Oklahoma,Corporation Commissioner,Cliff Branan,REP,550047,0,0,62,62,
Oklahoma,U.S. Senate,Evelyn Rogers,REP,550047,0,0,7,7,
Oklahoma,U.S. Senate,Rob Moye,REP,550047,0,0,2,2,
Oklahoma,U.S. Senate,D. Jean Mcbride-Samuels,REP,550047,0,0,5,5,
Oklahoma,U.S. Senate,Jim Inhofe,REP,550047,0,0,99,99,
Oklahoma,U.S. Senate,Erick Paul Wyatt,REP,550047,0,0,6,6,
Oklahoma,U.S. Senate,Andy Craig,REP,550047,0,0,0,0,
Oklahoma,U.S. Senate,T. Shannon,REP,550047,0,0,34,34,
Oklahoma,U.S. Senate,Randy Brogdon,REP,550047,0,0,5,5,
Oklahoma,U.S. Senate,Eric Mccray,REP,550047,0,0,1,1,
Oklahoma,U.S. Senate,Kevin Crow,REP,550047,0,0,1,1,
Oklahoma,U.S. Senate,James Lankford,REP,550047,0,0,81,81,
Oklahoma,U.S. Senate,Jason Weger,REP,550047,0,0,2,2,
Oklahoma,U.S. House,Shane David Jett,REP,550047,0,0,5,5,05
Oklahoma,U.S. House,Patrice Douglas,REP,550047,0,0,40,40,05
Oklahoma,U.S. House,Mike Turner,REP,550047,0,0,13,13,05
Oklahoma,U.S. House,Steve Russell,REP,550047,0,0,23,23,05
Oklahoma,U.S. House,Harvey Sparks,REP,550047,0,0,4,4,05
Oklahoma,U.S. House,Clark Jolley,REP,550047,0,0,38,38,05
Oklahoma,Superintendent of Public Instruction,John Cox,DEM,550048,0,0,10,10,
Oklahoma,Superintendent of Public Instruction,Jack Jr.,DEM,550048,0,0,6,6,
Oklahoma,Superintendent of Public Instruction,Ivan Holmes,DEM,550048,0,0,7,7,
Oklahoma,Superintendent of Public Instruction,Freda Deskin,DEM,550048,0,0,34,34,
Oklahoma,U.S. Senate,Patrick Michael Hayes,DEM,550048,0,0,11,11,
Oklahoma,U.S. Senate,Jim Rogers,DEM,550048,0,0,14,14,
Oklahoma,U.S. Senate,Connie Johnson,DEM,550048,0,0,32,32,
Oklahoma,U.S. House,Tom Guild,DEM,550048,0,0,25,25,05
Oklahoma,U.S. House,Al Mcaffrey,DEM,550048,0,0,16,16,05
Oklahoma,U.S. House,Leona Leonard,DEM,550048,0,0,17,17,05
Oklahoma,Governor,Dax Ewbank,REP,550048,0,0,24,24,
Oklahoma,Governor,Chad Moody,REP,550048,0,0,52,52,
Oklahoma,Governor,Mary Fallin,REP,550048,0,0,120,120,
Oklahoma,Superintendent of Public Instruction,Brian Kelly,REP,550048,0,0,61,61,
Oklahoma,Superintendent of Public Instruction,Janet Costello Barresi,REP,550048,0,0,33,33,
Oklahoma,Superintendent of Public Instruction,Joy Hofmeister,REP,550048,0,0,97,97,
Oklahoma,Insurance Commissioner,Bill Viner,REP,550048,0,0,45,45,
Oklahoma,Insurance Commissioner,John Doak,REP,550048,0,0,142,142,
Oklahoma,Corporation Commissioner,Todd Hiett,REP,550048,0,0,78,78,
Oklahoma,Corporation Commissioner,Cliff Branan,REP,550048,0,0,107,107,
Oklahoma,U.S. Senate,Evelyn Rogers,REP,550048,0,0,11,11,
Oklahoma,U.S. Senate,Rob Moye,REP,550048,0,0,2,2,
Oklahoma,U.S. Senate,D. Jean Mcbride-Samuels,REP,550048,0,0,4,4,
Oklahoma,U.S. Senate,Jim Inhofe,REP,550048,0,0,171,171,
Oklahoma,U.S. Senate,Erick Paul Wyatt,REP,550048,0,0,8,8,
Oklahoma,U.S. Senate,Andy Craig,REP,550048,0,0,2,2,
Oklahoma,U.S. Senate,T. Shannon,REP,550048,0,0,61,61,
Oklahoma,U.S. Senate,Randy Brogdon,REP,550048,0,0,8,8,
Oklahoma,U.S. Senate,Eric Mccray,REP,550048,0,0,2,2,
Oklahoma,U.S. Senate,Kevin Crow,REP,550048,0,0,0,0,
Oklahoma,U.S. Senate,James Lankford,REP,550048,0,0,125,125,
Oklahoma,U.S. Senate,Jason Weger,REP,550048,0,0,0,0,
Oklahoma,U.S. House,Shane David Jett,REP,550048,0,0,14,14,05
Oklahoma,U.S. House,Patrice Douglas,REP,550048,0,0,45,45,05
Oklahoma,U.S. House,Mike Turner,REP,550048,0,0,31,31,05
Oklahoma,U.S. House,Steve Russell,REP,550048,0,0,39,39,05
Oklahoma,U.S. House,Harvey Sparks,REP,550048,0,0,4,4,05
Oklahoma,U.S. House,Clark Jolley,REP,550048,0,0,59,59,05
Oklahoma,Superintendent of Public Instruction,John Cox,DEM,550049,0,0,19,19,
Oklahoma,Superintendent of Public Instruction,Jack Jr.,DEM,550049,0,0,6,6,
Oklahoma,Superintendent of Public Instruction,Ivan Holmes,DEM,550049,0,0,7,7,
Oklahoma,Superintendent of Public Instruction,Freda Deskin,DEM,550049,0,0,34,34,
Oklahoma,U.S. Senate,Patrick Michael Hayes,DEM,550049,0,0,4,4,
Oklahoma,U.S. Senate,Jim Rogers,DEM,550049,0,0,17,17,
Oklahoma,U.S. Senate,Connie Johnson,DEM,550049,0,0,45,45,
Oklahoma,U.S. House,Tom Guild,DEM,550049,0,0,37,37,05
Oklahoma,U.S. House,Al Mcaffrey,DEM,550049,0,0,8,8,05
Oklahoma,U.S. House,Leona Leonard,DEM,550049,0,0,18,18,05
Oklahoma,Governor,Dax Ewbank,REP,550049,0,0,18,18,
Oklahoma,Governor,Chad Moody,REP,550049,0,0,21,21,
Oklahoma,Governor,Mary Fallin,REP,550049,0,0,81,81,
Oklahoma,Superintendent of Public Instruction,Brian Kelly,REP,550049,0,0,32,32,
Oklahoma,Superintendent of Public Instruction,Janet Costello Barresi,REP,550049,0,0,27,27,
Oklahoma,Superintendent of Public Instruction,Joy Hofmeister,REP,550049,0,0,63,63,
Oklahoma,Insurance Commissioner,Bill Viner,REP,550049,0,0,25,25,
Oklahoma,Insurance Commissioner,John Doak,REP,550049,0,0,92,92,
Oklahoma,Corporation Commissioner,Todd Hiett,REP,550049,0,0,57,57,
Oklahoma,Corporation Commissioner,Cliff Branan,REP,550049,0,0,55,55,
Oklahoma,U.S. Senate,Evelyn Rogers,REP,550049,0,0,3,3,
Oklahoma,U.S. Senate,Rob Moye,REP,550049,0,0,2,2,
Oklahoma,U.S. Senate,D. Jean Mcbride-Samuels,REP,550049,0,0,7,7,
Oklahoma,U.S. Senate,Jim Inhofe,REP,550049,0,0,99,99,
Oklahoma,U.S. Senate,Erick Paul Wyatt,REP,550049,0,0,8,8,
Oklahoma,U.S. Senate,Andy Craig,REP,550049,0,0,2,2,
Oklahoma,U.S. Senate,T. Shannon,REP,550049,0,0,20,20,
Oklahoma,U.S. Senate,Randy Brogdon,REP,550049,0,0,11,11,
Oklahoma,U.S. Senate,Eric Mccray,REP,550049,0,0,1,1,
Oklahoma,U.S. Senate,Kevin Crow,REP,550049,0,0,1,1,
Oklahoma,U.S. Senate,James Lankford,REP,550049,0,0,85,85,
Oklahoma,U.S. Senate,Jason Weger,REP,550049,0,0,2,2,
Oklahoma,U.S. House,Shane David Jett,REP,550049,0,0,8,8,05
Oklahoma,U.S. House,Patrice Douglas,REP,550049,0,0,38,38,05
Oklahoma,U.S. House,Mike Turner,REP,550049,0,0,18,18,05
Oklahoma,U.S. House,Steve Russell,REP,550049,0,0,21,21,05
Oklahoma,U.S. House,Harvey Sparks,REP,550049,0,0,3,3,05
Oklahoma,U.S. House,Clark Jolley,REP,550049,0,0,32,32,05
Oklahoma,Superintendent of Public Instruction,John Cox,DEM,550050,0,0,0,0,
Oklahoma,Superintendent of Public Instruction,Jack Jr.,DEM,550050,0,0,0,0,
Oklahoma,Superintendent of Public Instruction,Ivan Holmes,DEM,550050,0,0,0,0,
Oklahoma,Superintendent of Public Instruction,Freda Deskin,DEM,550050,0,0,1,1,
Oklahoma,U.S. Senate,Patrick Michael Hayes,DEM,550050,0,0,0,0,
Oklahoma,U.S. Senate,Jim Rogers,DEM,550050,0,0,0,0,
Oklahoma,U.S. Senate,Connie Johnson,DEM,550050,0,0,1,1,
Oklahoma,U.S. House,Tom Guild,DEM,550050,0,0,0,0,05
Oklahoma,U.S. House,Al Mcaffrey,DEM,550050,0,0,0,0,05
Oklahoma,U.S. House,Leona Leonard,DEM,550050,0,0,1,1,05
Oklahoma,Governor,Dax Ewbank,REP,550050,0,0,1,1,
Oklahoma,Governor,Chad Moody,REP,550050,0,0,1,1,
Oklahoma,Governor,Mary Fallin,REP,550050,0,0,3,3,
Oklahoma,Superintendent of Public Instruction,Brian Kelly,REP,550050,0,0,1,1,
Oklahoma,Superintendent of Public Instruction,Janet Costello Barresi,REP,550050,0,0,0,0,
Oklahoma,Superintendent of Public Instruction,Joy Hofmeister,REP,550050,0,0,4,4,
Oklahoma,Insurance Commissioner,Bill Viner,REP,550050,0,0,1,1,
Oklahoma,Insurance Commissioner,John Doak,REP,550050,0,0,4,4,
Oklahoma,Corporation Commissioner,Todd Hiett,REP,550050,0,0,1,1,
Oklahoma,Corporation Commissioner,Cliff Branan,REP,550050,0,0,4,4,
Oklahoma,U.S. Senate,Evelyn Rogers,REP,550050,0,0,1,1,
Oklahoma,U.S. Senate,Rob Moye,REP,550050,0,0,0,0,
Oklahoma,U.S. Senate,D. Jean Mcbride-Samuels,REP,550050,0,0,0,0,
Oklahoma,U.S. Senate,Jim Inhofe,REP,550050,0,0,4,4,
Oklahoma,U.S. Senate,Erick Paul Wyatt,REP,550050,0,0,0,0,
Oklahoma,U.S. Senate,Andy Craig,REP,550050,0,0,0,0,
Oklahoma,U.S. Senate,T. Shannon,REP,550050,0,0,3,3,
Oklahoma,U.S. Senate,Randy Brogdon,REP,550050,0,0,0,0,
Oklahoma,U.S. Senate,Eric Mccray,REP,550050,0,0,0,0,
Oklahoma,U.S. Senate,Kevin Crow,REP,550050,0,0,1,1,
Oklahoma,U.S. Senate,James Lankford,REP,550050,0,0,1,1,
Oklahoma,U.S. Senate,Jason Weger,REP,550050,0,0,0,0,
Oklahoma,U.S. House,Shane David Jett,REP,550050,0,0,0,0,05
Oklahoma,U.S. House,Patrice Douglas,REP,550050,0,0,2,2,05
Oklahoma,U.S. House,Mike Turner,REP,550050,0,0,1,1,05
Oklahoma,U.S. House,Steve Russell,REP,550050,0,0,2,2,05
Oklahoma,U.S. House,Harvey Sparks,REP,550050,0,0,0,0,05
Oklahoma,U.S. House,Clark Jolley,REP,550050,0,0,0,0,05
Oklahoma,Superintendent of Public Instruction,John Cox,DEM,550051,0,0,13,13,
Oklahoma,Superintendent of Public Instruction,Jack Jr.,DEM,550051,0,0,7,7,
Oklahoma,Superintendent of Public Instruction,Ivan Holmes,DEM,550051,0,0,9,9,
Oklahoma,Superintendent of Public Instruction,Freda Deskin,DEM,550051,0,0,29,29,
Oklahoma,U.S. Senate,Patrick Michael Hayes,DEM,550051,0,0,7,7,
Oklahoma,U.S. Senate,Jim Rogers,DEM,550051,0,0,11,11,
Oklahoma,U.S. Senate,Connie Johnson,DEM,550051,0,0,36,36,
Oklahoma,U.S. House,Tom Guild,DEM,550051,0,0,19,19,05
Oklahoma,U.S. House,Al Mcaffrey,DEM,550051,0,0,23,23,05
Oklahoma,U.S. House,Leona Leonard,DEM,550051,0,0,18,18,05
Oklahoma,Governor,Dax Ewbank,REP,550051,0,0,19,19,
Oklahoma,Governor,Chad Moody,REP,550051,0,0,29,29,
Oklahoma,Governor,Mary Fallin,REP,550051,0,0,134,134,
Oklahoma,Superintendent of Public Instruction,Brian Kelly,REP,550051,0,0,40,40,
Oklahoma,Superintendent of Public Instruction,Janet Costello Barresi,REP,550051,0,0,46,46,
Oklahoma,Superintendent of Public Instruction,Joy Hofmeister,REP,550051,0,0,95,95,
Oklahoma,Insurance Commissioner,Bill Viner,REP,550051,0,0,38,38,
Oklahoma,Insurance Commissioner,John Doak,REP,550051,0,0,134,134,
Oklahoma,Corporation Commissioner,Todd Hiett,REP,550051,0,0,90,90,
Oklahoma,Corporation Commissioner,Cliff Branan,REP,550051,0,0,84,84,
Oklahoma,U.S. Senate,Evelyn Rogers,REP,550051,0,0,4,4,
Oklahoma,U.S. Senate,Rob Moye,REP,550051,0,0,3,3,
Oklahoma,U.S. Senate,D. Jean Mcbride-Samuels,REP,550051,0,0,2,2,
Oklahoma,U.S. Senate,Jim Inhofe,REP,550051,0,0,161,161,
Oklahoma,U.S. Senate,Erick Paul Wyatt,REP,550051,0,0,10,10,
Oklahoma,U.S. Senate,Andy Craig,REP,550051,0,0,1,1,
Oklahoma,U.S. Senate,T. Shannon,REP,550051,0,0,52,52,
Oklahoma,U.S. Senate,Randy Brogdon,REP,550051,0,0,3,3,
Oklahoma,U.S. Senate,Eric Mccray,REP,550051,0,0,1,1,
Oklahoma,U.S. Senate,Kevin Crow,REP,550051,0,0,2,2,
Oklahoma,U.S. Senate,James Lankford,REP,550051,0,0,127,127,
Oklahoma,U.S. Senate,Jason Weger,REP,550051,0,0,0,0,
Oklahoma,U.S. House,Shane David Jett,REP,550051,0,0,17,17,05
Oklahoma,U.S. House,Patrice Douglas,REP,550051,0,0,61,61,05
Oklahoma,U.S. House,Mike Turner,REP,550051,0,0,19,19,05
Oklahoma,U.S. House,Steve Russell,REP,550051,0,0,36,36,05
Oklahoma,U.S. House,Harvey Sparks,REP,550051,0,0,4,4,05
Oklahoma,U.S. House,Clark Jolley,REP,550051,0,0,47,47,05
Oklahoma,Superintendent of Public Instruction,John Cox,DEM,550052,0,0,23,23,
Oklahoma,Superintendent of Public Instruction,Jack Jr.,DEM,550052,0,0,7,7,
Oklahoma,Superintendent of Public Instruction,Ivan Holmes,DEM,550052,0,0,4,4,
Oklahoma,Superintendent of Public Instruction,Freda Deskin,DEM,550052,0,0,38,38,
Oklahoma,U.S. Senate,Patrick Michael Hayes,DEM,550052,0,0,11,11,
Oklahoma,U.S. Senate,Jim Rogers,DEM,550052,0,0,19,19,
Oklahoma,U.S. Senate,Connie Johnson,DEM,550052,0,0,39,39,
Oklahoma,U.S. House,Tom Guild,DEM,550052,0,0,34,34,05
Oklahoma,U.S. House,Al Mcaffrey,DEM,550052,0,0,18,18,05
Oklahoma,U.S. House,Leona Leonard,DEM,550052,0,0,17,17,05
Oklahoma,Governor,Dax Ewbank,REP,550052,0,0,13,13,
Oklahoma,Governor,Chad Moody,REP,550052,0,0,42,42,
Oklahoma,Governor,Mary Fallin,REP,550052,0,0,290,290,
Oklahoma,Superintendent of Public Instruction,Brian Kelly,REP,550052,0,0,69,69,
Oklahoma,Superintendent of Public Instruction,Janet Costello Barresi,REP,550052,0,0,89,89,
Oklahoma,Superintendent of Public Instruction,Joy Hofmeister,REP,550052,0,0,182,182,
Oklahoma,Insurance Commissioner,Bill Viner,REP,550052,0,0,56,56,
Oklahoma,Insurance Commissioner,John Doak,REP,550052,0,0,245,245,
Oklahoma,Corporation Commissioner,Todd Hiett,REP,550052,0,0,156,156,
Oklahoma,Corporation Commissioner,Cliff Branan,REP,550052,0,0,155,155,
Oklahoma,U.S. Senate,Evelyn Rogers,REP,550052,0,0,7,7,
Oklahoma,U.S. Senate,Rob Moye,REP,550052,0,0,4,4,
Oklahoma,U.S. Senate,D. Jean Mcbride-Samuels,REP,550052,0,0,5,5,
Oklahoma,U.S. Senate,Jim Inhofe,REP,550052,0,0,313,313,
Oklahoma,U.S. Senate,Erick Paul Wyatt,REP,550052,0,0,12,12,
Oklahoma,U.S. Senate,Andy Craig,REP,550052,0,0,1,1,
Oklahoma,U.S. Senate,T. Shannon,REP,550052,0,0,64,64,
Oklahoma,U.S. Senate,Randy Brogdon,REP,550052,0,0,5,5,
Oklahoma,U.S. Senate,Eric Mccray,REP,550052,0,0,1,1,
Oklahoma,U.S. Senate,Kevin Crow,REP,550052,0,0,1,1,
Oklahoma,U.S. Senate,James Lankford,REP,550052,0,0,281,281,
Oklahoma,U.S. Senate,Jason Weger,REP,550052,0,0,0,0,
Oklahoma,U.S. House,Shane David Jett,REP,550052,0,0,20,20,05
Oklahoma,U.S. House,Patrice Douglas,REP,550052,0,0,139,139,05
Oklahoma,U.S. House,Mike Turner,REP,550052,0,0,19,19,05
Oklahoma,U.S. House,Steve Russell,REP,550052,0,0,67,67,05
Oklahoma,U.S. House,Harvey Sparks,REP,550052,0,0,8,8,05
Oklahoma,U.S. House,Clark Jolley,REP,550052,0,0,91,91,05
Oklahoma,Superintendent of Public Instruction,John Cox,DEM,550053,0,0,25,25,
Oklahoma,Superintendent of Public Instruction,Jack Jr.,DEM,550053,0,0,15,15,
Oklahoma,Superintendent of Public Instruction,Ivan Holmes,DEM,550053,0,0,8,8,
Oklahoma,Superintendent of Public Instruction,Freda Deskin,DEM,550053,0,0,35,35,
Oklahoma,U.S. Senate,Patrick Michael Hayes,DEM,550053,0,0,19,19,
Oklahoma,U.S. Senate,Jim Rogers,DEM,550053,0,0,23,23,
Oklahoma,U.S. Senate,Connie Johnson,DEM,550053,0,0,40,40,
Oklahoma,U.S. House,Tom Guild,DEM,550053,0,0,39,39,05
Oklahoma,U.S. House,Al Mcaffrey,DEM,550053,0,0,20,20,05
Oklahoma,U.S. House,Leona Leonard,DEM,550053,0,0,24,24,05
Oklahoma,Governor,Dax Ewbank,REP,550053,0,0,31,31,
Oklahoma,Governor,Chad Moody,REP,550053,0,0,40,40,
Oklahoma,Governor,Mary Fallin,REP,550053,0,0,213,213,
Oklahoma,Superintendent of Public Instruction,Brian Kelly,REP,550053,0,0,62,62,
Oklahoma,Superintendent of Public Instruction,Janet Costello Barresi,REP,550053,0,0,70,70,
Oklahoma,Superintendent of Public Instruction,Joy Hofmeister,REP,550053,0,0,147,147,
Oklahoma,Insurance Commissioner,Bill Viner,REP,550053,0,0,47,47,
Oklahoma,Insurance Commissioner,John Doak,REP,550053,0,0,210,210,
Oklahoma,Corporation Commissioner,Todd Hiett,REP,550053,0,0,130,130,
Oklahoma,Corporation Commissioner,Cliff Branan,REP,550053,0,0,128,128,
Oklahoma,U.S. Senate,Evelyn Rogers,REP,550053,0,0,10,10,
Oklahoma,U.S. Senate,Rob Moye,REP,550053,0,0,5,5,
Oklahoma,U.S. Senate,D. Jean Mcbride-Samuels,REP,550053,0,0,3,3,
Oklahoma,U.S. Senate,Jim Inhofe,REP,550053,0,0,252,252,
Oklahoma,U.S. Senate,Erick Paul Wyatt,REP,550053,0,0,10,10,
Oklahoma,U.S. Senate,Andy Craig,REP,550053,0,0,1,1,
Oklahoma,U.S. Senate,T. Shannon,REP,550053,0,0,77,77,
Oklahoma,U.S. Senate,Randy Brogdon,REP,550053,0,0,10,10,
Oklahoma,U.S. Senate,Eric Mccray,REP,550053,0,0,0,0,
Oklahoma,U.S. Senate,Kevin Crow,REP,550053,0,0,2,2,
Oklahoma,U.S. Senate,James Lankford,REP,550053,0,0,195,195,
Oklahoma,U.S. Senate,Jason Weger,REP,550053,0,0,1,1,
Oklahoma,U.S. House,Shane David Jett,REP,550053,0,0,15,15,05
Oklahoma,U.S. House,Patrice Douglas,REP,550053,0,0,89,89,05
Oklahoma,U.S. House,Mike Turner,REP,550053,0,0,31,31,05
Oklahoma,U.S. House,Steve Russell,REP,550053,0,0,62,62,05
Oklahoma,U.S. House,Harvey Sparks,REP,550053,0,0,3,3,05
Oklahoma,U.S. House,Clark Jolley,REP,550053,0,0,83,83,05
Oklahoma,Superintendent of Public Instruction,John Cox,DEM,550054,0,0,37,37,
Oklahoma,Superintendent of Public Instruction,Jack Jr.,DEM,550054,0,0,13,13,
Oklahoma,Superintendent of Public Instruction,Ivan Holmes,DEM,550054,0,0,6,6,
Oklahoma,Superintendent of Public Instruction,Freda Deskin,DEM,550054,0,0,46,46,
Oklahoma,U.S. Senate,Patrick Michael Hayes,DEM,550054,0,0,20,20,
Oklahoma,U.S. Senate,Jim Rogers,DEM,550054,0,0,31,31,
Oklahoma,U.S. Senate,Connie Johnson,DEM,550054,0,0,48,48,
Oklahoma,U.S. House,Tom Guild,DEM,550054,0,0,41,41,05
Oklahoma,U.S. House,Al Mcaffrey,DEM,550054,0,0,30,30,05
Oklahoma,U.S. House,Leona Leonard,DEM,550054,0,0,30,30,05
Oklahoma,Governor,Dax Ewbank,REP,550054,0,0,32,32,
Oklahoma,Governor,Chad Moody,REP,550054,0,0,59,59,
Oklahoma,Governor,Mary Fallin,REP,550054,0,0,271,271,
Oklahoma,Superintendent of Public Instruction,Brian Kelly,REP,550054,0,0,74,74,
Oklahoma,Superintendent of Public Instruction,Janet Costello Barresi,REP,550054,0,0,87,87,
Oklahoma,Superintendent of Public Instruction,Joy Hofmeister,REP,550054,0,0,201,201,
Oklahoma,Insurance Commissioner,Bill Viner,REP,550054,0,0,60,60,
Oklahoma,Insurance Commissioner,John Doak,REP,550054,0,0,269,269,
Oklahoma,Corporation Commissioner,Todd Hiett,REP,550054,0,0,160,160,
Oklahoma,Corporation Commissioner,Cliff Branan,REP,550054,0,0,170,170,
Oklahoma,U.S. Senate,Evelyn Rogers,REP,550054,0,0,13,13,
Oklahoma,U.S. Senate,Rob Moye,REP,550054,0,0,7,7,
Oklahoma,U.S. Senate,D. Jean Mcbride-Samuels,REP,550054,0,0,4,4,
Oklahoma,U.S. Senate,Jim Inhofe,REP,550054,0,0,323,323,
Oklahoma,U.S. Senate,Erick Paul Wyatt,REP,550054,0,0,10,10,
Oklahoma,U.S. Senate,Andy Craig,REP,550054,0,0,2,2,
Oklahoma,U.S. Senate,T. Shannon,REP,550054,0,0,78,78,
Oklahoma,U.S. Senate,Randy Brogdon,REP,550054,0,0,9,9,
Oklahoma,U.S. Senate,Eric Mccray,REP,550054,0,0,1,1,
Oklahoma,U.S. Senate,Kevin Crow,REP,550054,0,0,0,0,
Oklahoma,U.S. Senate,James Lankford,REP,550054,0,0,276,276,
Oklahoma,U.S. Senate,Jason Weger,REP,550054,0,0,3,3,
Oklahoma,U.S. House,Shane David Jett,REP,550054,0,0,23,23,05
Oklahoma,U.S. House,Patrice Douglas,REP,550054,0,0,105,105,05
Oklahoma,U.S. House,Mike Turner,REP,550054,0,0,30,30,05
Oklahoma,U.S. House,Steve Russell,REP,550054,0,0,89,89,05
Oklahoma,U.S. House,Harvey Sparks,REP,550054,0,0,15,15,05
Oklahoma,U.S. House,Clark Jolley,REP,550054,0,0,100,100,05
Oklahoma,Superintendent of Public Instruction,John Cox,DEM,550055,0,0,26,26,
Oklahoma,Superintendent of Public Instruction,Jack Jr.,DEM,550055,0,0,14,14,
Oklahoma,Superintendent of Public Instruction,Ivan Holmes,DEM,550055,0,0,6,6,
Oklahoma,Superintendent of Public Instruction,Freda Deskin,DEM,550055,0,0,50,50,
Oklahoma,U.S. Senate,Patrick Michael Hayes,DEM,550055,0,0,12,12,
Oklahoma,U.S. Senate,Jim Rogers,DEM,550055,0,0,22,22,
Oklahoma,U.S. Senate,Connie Johnson,DEM,550055,0,0,61,61,
Oklahoma,U.S. House,Tom Guild,DEM,550055,0,0,48,48,05
Oklahoma,U.S. House,Al Mcaffrey,DEM,550055,0,0,31,31,05
Oklahoma,U.S. House,Leona Leonard,DEM,550055,0,0,19,19,05
Oklahoma,Governor,Dax Ewbank,REP,550055,0,0,22,22,
Oklahoma,Governor,Chad Moody,REP,550055,0,0,45,45,
Oklahoma,Governor,Mary Fallin,REP,550055,0,0,251,251,
Oklahoma,Superintendent of Public Instruction,Brian Kelly,REP,550055,0,0,62,62,
Oklahoma,Superintendent of Public Instruction,Janet Costello Barresi,REP,550055,0,0,86,86,
Oklahoma,Superintendent of Public Instruction,Joy Hofmeister,REP,550055,0,0,178,178,
Oklahoma,Insurance Commissioner,Bill Viner,REP,550055,0,0,56,56,
Oklahoma,Insurance Commissioner,John Doak,REP,550055,0,0,242,242,
Oklahoma,Corporation Commissioner,Todd Hiett,REP,550055,0,0,149,149,
Oklahoma,Corporation Commissioner,Cliff Branan,REP,550055,0,0,154,154,
Oklahoma,U.S. Senate,Evelyn Rogers,REP,550055,0,0,14,14,
Oklahoma,U.S. Senate,Rob Moye,REP,550055,0,0,5,5,
Oklahoma,U.S. Senate,D. Jean Mcbride-Samuels,REP,550055,0,0,4,4,
Oklahoma,U.S. Senate,Jim Inhofe,REP,550055,0,0,291,291,
Oklahoma,U.S. Senate,Erick Paul Wyatt,REP,550055,0,0,4,4,
Oklahoma,U.S. Senate,Andy Craig,REP,550055,0,0,2,2,
Oklahoma,U.S. Senate,T. Shannon,REP,550055,0,0,56,56,
Oklahoma,U.S. Senate,Randy Brogdon,REP,550055,0,0,11,11,
Oklahoma,U.S. Senate,Eric Mccray,REP,550055,0,0,1,1,
Oklahoma,U.S. Senate,Kevin Crow,REP,550055,0,0,1,1,
Oklahoma,U.S. Senate,James Lankford,REP,550055,0,0,259,259,
Oklahoma,U.S. Senate,Jason Weger,REP,550055,0,0,1,1,
Oklahoma,U.S. House,Shane David Jett,REP,550055,0,0,16,16,05
Oklahoma,U.S. House,Patrice Douglas,REP,550055,0,0,88,88,05
Oklahoma,U.S. House,Mike Turner,REP,550055,0,0,25,25,05
Oklahoma,U.S. House,Steve Russell,REP,550055,0,0,87,87,05
Oklahoma,U.S. House,Harvey Sparks,REP,550055,0,0,5,5,05
Oklahoma,U.S. House,Clark Jolley,REP,550055,0,0,105,105,05
Oklahoma,Superintendent of Public Instruction,John Cox,DEM,550056,0,0,14,14,
Oklahoma,Superintendent of Public Instruction,Jack Jr.,DEM,550056,0,0,6,6,
Oklahoma,Superintendent of Public Instruction,Ivan Holmes,DEM,550056,0,0,4,4,
Oklahoma,Superintendent of Public Instruction,Freda Deskin,DEM,550056,0,0,22,22,
Oklahoma,U.S. Senate,Patrick Michael Hayes,DEM,550056,0,0,6,6,
Oklahoma,U.S. Senate,Jim Rogers,DEM,550056,0,0,10,10,
Oklahoma,U.S. Senate,Connie Johnson,DEM,550056,0,0,31,31,
Oklahoma,U.S. House,Tom Guild,DEM,550056,0,0,26,26,05
Oklahoma,U.S. House,Al Mcaffrey,DEM,550056,0,0,13,13,05
Oklahoma,U.S. House,Leona Leonard,DEM,550056,0,0,7,7,05
Oklahoma,Governor,Dax Ewbank,REP,550056,0,0,33,33,
Oklahoma,Governor,Chad Moody,REP,550056,0,0,39,39,
Oklahoma,Governor,Mary Fallin,REP,550056,0,0,247,247,
Oklahoma,Superintendent of Public Instruction,Brian Kelly,REP,550056,0,0,61,61,
Oklahoma,Superintendent of Public Instruction,Janet Costello Barresi,REP,550056,0,0,104,104,
Oklahoma,Superintendent of Public Instruction,Joy Hofmeister,REP,550056,0,0,143,143,
Oklahoma,Insurance Commissioner,Bill Viner,REP,550056,0,0,48,48,
Oklahoma,Insurance Commissioner,John Doak,REP,550056,0,0,234,234,
Oklahoma,Corporation Commissioner,Todd Hiett,REP,550056,0,0,143,143,
Oklahoma,Corporation Commissioner,Cliff Branan,REP,550056,0,0,143,143,
Oklahoma,U.S. Senate,Evelyn Rogers,REP,550056,0,0,16,16,
Oklahoma,U.S. Senate,Rob Moye,REP,550056,0,0,7,7,
Oklahoma,U.S. Senate,D. Jean Mcbride-Samuels,REP,550056,0,0,1,1,
Oklahoma,U.S. Senate,Jim Inhofe,REP,550056,0,0,284,284,
Oklahoma,U.S. Senate,Erick Paul Wyatt,REP,550056,0,0,6,6,
Oklahoma,U.S. Senate,Andy Craig,REP,550056,0,0,3,3,
Oklahoma,U.S. Senate,T. Shannon,REP,550056,0,0,73,73,
Oklahoma,U.S. Senate,Randy Brogdon,REP,550056,0,0,10,10,
Oklahoma,U.S. Senate,Eric Mccray,REP,550056,0,0,1,1,
Oklahoma,U.S. Senate,Kevin Crow,REP,550056,0,0,0,0,
Oklahoma,U.S. Senate,James Lankford,REP,550056,0,0,232,232,
Oklahoma,U.S. Senate,Jason Weger,REP,550056,0,0,1,1,
Oklahoma,U.S. House,Shane David Jett,REP,550056,0,0,13,13,05
Oklahoma,U.S. House,Patrice Douglas,REP,550056,0,0,102,102,05
Oklahoma,U.S. House,Mike Turner,REP,550056,0,0,27,27,05
Oklahoma,U.S. House,Steve Russell,REP,550056,0,0,69,69,05
Oklahoma,U.S. House,Harvey Sparks,REP,550056,0,0,4,4,05
Oklahoma,U.S. House,Clark Jolley,REP,550056,0,0,100,100,05
Oklahoma,Superintendent of Public Instruction,John Cox,DEM,550057,0,0,6,6,
Oklahoma,Superintendent of Public Instruction,Jack Jr.,DEM,550057,0,0,4,4,
Oklahoma,Superintendent of Public Instruction,Ivan Holmes,DEM,550057,0,0,3,3,
Oklahoma,Superintendent of Public Instruction,Freda Deskin,DEM,550057,0,0,23,23,
Oklahoma,U.S. Senate,Patrick Michael Hayes,DEM,550057,0,0,5,5,
Oklahoma,U.S. Senate,Jim Rogers,DEM,550057,0,0,7,7,
Oklahoma,U.S. Senate,Connie Johnson,DEM,550057,0,0,24,24,
Oklahoma,U.S. House,Tom Guild,DEM,550057,0,0,16,16,05
Oklahoma,U.S. House,Al Mcaffrey,DEM,550057,0,0,12,12,05
Oklahoma,U.S. House,Leona Leonard,DEM,550057,0,0,7,7,05
Oklahoma,Governor,Dax Ewbank,REP,550057,0,0,27,27,
Oklahoma,Governor,Chad Moody,REP,550057,0,0,28,28,
Oklahoma,Governor,Mary Fallin,REP,550057,0,0,219,219,
Oklahoma,Superintendent of Public Instruction,Brian Kelly,REP,550057,0,0,46,46,
Oklahoma,Superintendent of Public Instruction,Janet Costello Barresi,REP,550057,0,0,104,104,
Oklahoma,Superintendent of Public Instruction,Joy Hofmeister,REP,550057,0,0,122,122,
Oklahoma,Insurance Commissioner,Bill Viner,REP,550057,0,0,42,42,
Oklahoma,Insurance Commissioner,John Doak,REP,550057,0,0,203,203,
Oklahoma,Corporation Commissioner,Todd Hiett,REP,550057,0,0,133,133,
Oklahoma,Corporation Commissioner,Cliff Branan,REP,550057,0,0,119,119,
Oklahoma,U.S. Senate,Evelyn Rogers,REP,550057,0,0,9,9,
Oklahoma,U.S. Senate,Rob Moye,REP,550057,0,0,3,3,
Oklahoma,U.S. Senate,D. Jean Mcbride-Samuels,REP,550057,0,0,2,2,
Oklahoma,U.S. Senate,Jim Inhofe,REP,550057,0,0,256,256,
Oklahoma,U.S. Senate,Erick Paul Wyatt,REP,550057,0,0,6,6,
Oklahoma,U.S. Senate,Andy Craig,REP,550057,0,0,1,1,
Oklahoma,U.S. Senate,T. Shannon,REP,550057,0,0,59,59,
Oklahoma,U.S. Senate,Randy Brogdon,REP,550057,0,0,6,6,
Oklahoma,U.S. Senate,Eric Mccray,REP,550057,0,0,1,1,
Oklahoma,U.S. Senate,Kevin Crow,REP,550057,0,0,1,1,
Oklahoma,U.S. Senate,James Lankford,REP,550057,0,0,215,215,
Oklahoma,U.S. Senate,Jason Weger,REP,550057,0,0,0,0,
Oklahoma,U.S. House,Shane David Jett,REP,550057,0,0,8,8,05
Oklahoma,U.S. House,Patrice Douglas,REP,550057,0,0,72,72,05
Oklahoma,U.S. House,Mike Turner,REP,550057,0,0,36,36,05
Oklahoma,U.S. House,Steve Russell,REP,550057,0,0,72,72,05
Oklahoma,U.S. House,Harvey Sparks,REP,550057,0,0,6,6,05
Oklahoma,U.S. House,Clark Jolley,REP,550057,0,0,83,83,05
Oklahoma,Superintendent of Public Instruction,John Cox,DEM,550058,0,0,34,34,
Oklahoma,Superintendent of Public Instruction,Jack Jr.,DEM,550058,0,0,15,15,
Oklahoma,Superintendent of Public Instruction,Ivan Holmes,DEM,550058,0,0,8,8,
Oklahoma,Superintendent of Public Instruction,Freda Deskin,DEM,550058,0,0,50,50,
Oklahoma,U.S. Senate,Patrick Michael Hayes,DEM,550058,0,0,13,13,
Oklahoma,U.S. Senate,Jim Rogers,DEM,550058,0,0,29,29,
Oklahoma,U.S. Senate,Connie Johnson,DEM,550058,0,0,59,59,
Oklahoma,U.S. House,Tom Guild,DEM,550058,0,0,55,55,05
Oklahoma,U.S. House,Al Mcaffrey,DEM,550058,0,0,34,34,05
Oklahoma,U.S. House,Leona Leonard,DEM,550058,0,0,19,19,05
Oklahoma,Governor,Dax Ewbank,REP,550058,0,0,52,52,
Oklahoma,Governor,Chad Moody,REP,550058,0,0,85,85,
Oklahoma,Governor,Mary Fallin,REP,550058,0,0,685,685,
Oklahoma,Superintendent of Public Instruction,Brian Kelly,REP,550058,0,0,120,120,
Oklahoma,Superintendent of Public Instruction,Janet Costello Barresi,REP,550058,0,0,284,284,
Oklahoma,Superintendent of Public Instruction,Joy Hofmeister,REP,550058,0,0,406,406,
Oklahoma,Insurance Commissioner,Bill Viner,REP,550058,0,0,129,129,
Oklahoma,Insurance Commissioner,John Doak,REP,550058,0,0,594,594,
Oklahoma,Corporation Commissioner,Todd Hiett,REP,550058,0,0,342,342,
Oklahoma,Corporation Commissioner,Cliff Branan,REP,550058,0,0,386,386,
Oklahoma,U.S. Senate,Evelyn Rogers,REP,550058,0,0,22,22,
Oklahoma,U.S. Senate,Rob Moye,REP,550058,0,0,5,5,
Oklahoma,U.S. Senate,D. Jean Mcbride-Samuels,REP,550058,0,0,8,8,
Oklahoma,U.S. Senate,Jim Inhofe,REP,550058,0,0,764,764,
Oklahoma,U.S. Senate,Erick Paul Wyatt,REP,550058,0,0,18,18,
Oklahoma,U.S. Senate,Andy Craig,REP,550058,0,0,2,2,
Oklahoma,U.S. Senate,T. Shannon,REP,550058,0,0,169,169,
Oklahoma,U.S. Senate,Randy Brogdon,REP,550058,0,0,15,15,
Oklahoma,U.S. Senate,Eric Mccray,REP,550058,0,0,1,1,
Oklahoma,U.S. Senate,Kevin Crow,REP,550058,0,0,0,0,
Oklahoma,U.S. Senate,James Lankford,REP,550058,0,0,649,649,
Oklahoma,U.S. Senate,Jason Weger,REP,550058,0,0,1,1,
Oklahoma,U.S. House,Shane David Jett,REP,550058,0,0,36,36,05
Oklahoma,U.S. House,Patrice Douglas,REP,550058,0,0,286,286,05
Oklahoma,U.S. House,Mike Turner,REP,550058,0,0,54,54,05
Oklahoma,U.S. House,Steve Russell,REP,550058,0,0,201,201,05
Oklahoma,U.S. House,Harvey Sparks,REP,550058,0,0,11,11,05
Oklahoma,U.S. House,Clark Jolley,REP,550058,0,0,239,239,05
Oklahoma,Superintendent of Public Instruction,John Cox,DEM,550059,0,0,10,10,
Oklahoma,Superintendent of Public Instruction,Jack Jr.,DEM,550059,0,0,2,2,
Oklahoma,Superintendent of Public Instruction,Ivan Holmes,DEM,550059,0,0,3,3,
Oklahoma,Superintendent of Public Instruction,Freda Deskin,DEM,550059,0,0,22,22,
Oklahoma,U.S. Senate,Patrick Michael Hayes,DEM,550059,0,0,6,6,
Oklahoma,U.S. Senate,Jim Rogers,DEM,550059,0,0,7,7,
Oklahoma,U.S. Senate,Connie Johnson,DEM,550059,0,0,23,23,
Oklahoma,U.S. House,Tom Guild,DEM,550059,0,0,20,20,05
Oklahoma,U.S. House,Al Mcaffrey,DEM,550059,0,0,10,10,05
Oklahoma,U.S. House,Leona Leonard,DEM,550059,0,0,9,9,05
Oklahoma,Governor,Dax Ewbank,REP,550059,0,0,32,32,
Oklahoma,Governor,Chad Moody,REP,550059,0,0,51,51,
Oklahoma,Governor,Mary Fallin,REP,550059,0,0,383,383,
Oklahoma,Superintendent of Public Instruction,Brian Kelly,REP,550059,0,0,85,85,
Oklahoma,Superintendent of Public Instruction,Janet Costello Barresi,REP,550059,0,0,154,154,
Oklahoma,Superintendent of Public Instruction,Joy Hofmeister,REP,550059,0,0,216,216,
Oklahoma,Insurance Commissioner,Bill Viner,REP,550059,0,0,74,74,
Oklahoma,Insurance Commissioner,John Doak,REP,550059,0,0,346,346,
Oklahoma,Corporation Commissioner,Todd Hiett,REP,550059,0,0,215,215,
Oklahoma,Corporation Commissioner,Cliff Branan,REP,550059,0,0,204,204,
Oklahoma,U.S. Senate,Evelyn Rogers,REP,550059,0,0,13,13,
Oklahoma,U.S. Senate,Rob Moye,REP,550059,0,0,8,8,
Oklahoma,U.S. Senate,D. Jean Mcbride-Samuels,REP,550059,0,0,3,3,
Oklahoma,U.S. Senate,Jim Inhofe,REP,550059,0,0,424,424,
Oklahoma,U.S. Senate,Erick Paul Wyatt,REP,550059,0,0,10,10,
Oklahoma,U.S. Senate,Andy Craig,REP,550059,0,0,1,1,
Oklahoma,U.S. Senate,T. Shannon,REP,550059,0,0,98,98,
Oklahoma,U.S. Senate,Randy Brogdon,REP,550059,0,0,23,23,
Oklahoma,U.S. Senate,Eric Mccray,REP,550059,0,0,1,1,
Oklahoma,U.S. Senate,Kevin Crow,REP,550059,0,0,2,2,
Oklahoma,U.S. Senate,James Lankford,REP,550059,0,0,344,344,
Oklahoma,U.S. Senate,Jason Weger,REP,550059,0,0,2,2,
Oklahoma,U.S. House,Shane David Jett,REP,550059,0,0,18,18,05
Oklahoma,U.S. House,Patrice Douglas,REP,550059,0,0,151,151,05
Oklahoma,U.S. House,Mike Turner,REP,550059,0,0,35,35,05
Oklahoma,U.S. House,Steve Russell,REP,550059,0,0,125,125,05
Oklahoma,U.S. House,Harvey Sparks,REP,550059,0,0,9,9,05
Oklahoma,U.S. House,Clark Jolley,REP,550059,0,0,123,123,05
Oklahoma,State House,Jason Murphey,REP,550059,0,0,398,398,31
Oklahoma,State House,Andrew Muchmore,REP,550059,0,0,45,45,31
Oklahoma,Superintendent of Public Instruction,John Cox,DEM,550060,0,0,29,29,
Oklahoma,Superintendent of Public Instruction,Jack Jr.,DEM,550060,0,0,10,10,
Oklahoma,Superintendent of Public Instruction,Ivan Holmes,DEM,550060,0,0,4,4,
Oklahoma,Superintendent of Public Instruction,Freda Deskin,DEM,550060,0,0,63,63,
Oklahoma,U.S. Senate,Patrick Michael Hayes,DEM,550060,0,0,14,14,
Oklahoma,U.S. Senate,Jim Rogers,DEM,550060,0,0,27,27,
Oklahoma,U.S. Senate,Connie Johnson,DEM,550060,0,0,63,63,
Oklahoma,U.S. House,Tom Guild,DEM,550060,0,0,45,45,05
Oklahoma,U.S. House,Al Mcaffrey,DEM,550060,0,0,41,41,05
Oklahoma,U.S. House,Leona Leonard,DEM,550060,0,0,17,17,05
Oklahoma,Governor,Dax Ewbank,REP,550060,0,0,43,43,
Oklahoma,Governor,Chad Moody,REP,550060,0,0,56,56,
Oklahoma,Governor,Mary Fallin,REP,550060,0,0,507,507,
Oklahoma,Superintendent of Public Instruction,Brian Kelly,REP,550060,0,0,96,96,
Oklahoma,Superintendent of Public Instruction,Janet Costello Barresi,REP,550060,0,0,218,218,
Oklahoma,Superintendent of Public Instruction,Joy Hofmeister,REP,550060,0,0,276,276,
Oklahoma,Insurance Commissioner,Bill Viner,REP,550060,0,0,113,113,
Oklahoma,Insurance Commissioner,John Doak,REP,550060,0,0,438,438,
Oklahoma,Corporation Commissioner,Todd Hiett,REP,550060,0,0,267,267,
Oklahoma,Corporation Commissioner,Cliff Branan,REP,550060,0,0,271,271,
Oklahoma,U.S. Senate,Evelyn Rogers,REP,550060,0,0,19,19,
Oklahoma,U.S. Senate,Rob Moye,REP,550060,0,0,11,11,
Oklahoma,U.S. Senate,D. Jean Mcbride-Samuels,REP,550060,0,0,5,5,
Oklahoma,U.S. Senate,Jim Inhofe,REP,550060,0,0,552,552,
Oklahoma,U.S. Senate,Erick Paul Wyatt,REP,550060,0,0,11,11,
Oklahoma,U.S. Senate,Andy Craig,REP,550060,0,0,2,2,
Oklahoma,U.S. Senate,T. Shannon,REP,550060,0,0,128,128,
Oklahoma,U.S. Senate,Randy Brogdon,REP,550060,0,0,13,13,
Oklahoma,U.S. Senate,Eric Mccray,REP,550060,0,0,0,0,
Oklahoma,U.S. Senate,Kevin Crow,REP,550060,0,0,2,2,
Oklahoma,U.S. Senate,James Lankford,REP,550060,0,0,466,466,
Oklahoma,U.S. Senate,Jason Weger,REP,550060,0,0,0,0,
Oklahoma,U.S. House,Shane David Jett,REP,550060,0,0,23,23,05
Oklahoma,U.S. House,Patrice Douglas,REP,550060,0,0,193,193,05
Oklahoma,U.S. House,Mike Turner,REP,550060,0,0,38,38,05
Oklahoma,U.S. House,Steve Russell,REP,550060,0,0,142,142,05
Oklahoma,U.S. House,Harvey Sparks,REP,550060,0,0,14,14,05
Oklahoma,U.S. House,Clark Jolley,REP,550060,0,0,189,189,05
Oklahoma,Superintendent of Public Instruction,John Cox,DEM,550061,0,0,22,22,
Oklahoma,Superintendent of Public Instruction,Jack Jr.,DEM,550061,0,0,12,12,
Oklahoma,Superintendent of Public Instruction,Ivan Holmes,DEM,550061,0,0,5,5,
Oklahoma,Superintendent of Public Instruction,Freda Deskin,DEM,550061,0,0,50,50,
Oklahoma,U.S. Senate,Patrick Michael Hayes,DEM,550061,0,0,7,7,
Oklahoma,U.S. Senate,Jim Rogers,DEM,550061,0,0,15,15,
Oklahoma,U.S. Senate,Connie Johnson,DEM,550061,0,0,62,62,
Oklahoma,U.S. House,Tom Guild,DEM,550061,0,0,43,43,05
Oklahoma,U.S. House,Al Mcaffrey,DEM,550061,0,0,19,19,05
Oklahoma,U.S. House,Leona Leonard,DEM,550061,0,0,24,24,05
Oklahoma,Governor,Dax Ewbank,REP,550061,0,0,50,50,
Oklahoma,Governor,Chad Moody,REP,550061,0,0,51,51,
Oklahoma,Governor,Mary Fallin,REP,550061,0,0,507,507,
Oklahoma,Superintendent of Public Instruction,Brian Kelly,REP,550061,0,0,109,109,
Oklahoma,Superintendent of Public Instruction,Janet Costello Barresi,REP,550061,0,0,244,244,
Oklahoma,Superintendent of Public Instruction,Joy Hofmeister,REP,550061,0,0,255,255,
Oklahoma,Insurance Commissioner,Bill Viner,REP,550061,0,0,83,83,
Oklahoma,Insurance Commissioner,John Doak,REP,550061,0,0,482,482,
Oklahoma,Corporation Commissioner,Todd Hiett,REP,550061,0,0,276,276,
Oklahoma,Corporation Commissioner,Cliff Branan,REP,550061,0,0,287,287,
Oklahoma,U.S. Senate,Evelyn Rogers,REP,550061,0,0,19,19,
Oklahoma,U.S. Senate,Rob Moye,REP,550061,0,0,7,7,
Oklahoma,U.S. Senate,D. Jean Mcbride-Samuels,REP,550061,0,0,8,8,
Oklahoma,U.S. Senate,Jim Inhofe,REP,550061,0,0,573,573,
Oklahoma,U.S. Senate,Erick Paul Wyatt,REP,550061,0,0,9,9,
Oklahoma,U.S. Senate,Andy Craig,REP,550061,0,0,3,3,
Oklahoma,U.S. Senate,T. Shannon,REP,550061,0,0,115,115,
Oklahoma,U.S. Senate,Randy Brogdon,REP,550061,0,0,22,22,
Oklahoma,U.S. Senate,Eric Mccray,REP,550061,0,0,3,3,
Oklahoma,U.S. Senate,Kevin Crow,REP,550061,0,0,2,2,
Oklahoma,U.S. Senate,James Lankford,REP,550061,0,0,472,472,
Oklahoma,U.S. Senate,Jason Weger,REP,550061,0,0,4,4,
Oklahoma,U.S. House,Shane David Jett,REP,550061,0,0,28,28,05
Oklahoma,U.S. House,Patrice Douglas,REP,550061,0,0,176,176,05
Oklahoma,U.S. House,Mike Turner,REP,550061,0,0,47,47,05
Oklahoma,U.S. House,Steve Russell,REP,550061,0,0,156,156,05
Oklahoma,U.S. House,Harvey Sparks,REP,550061,0,0,10,10,05
Oklahoma,U.S. House,Clark Jolley,REP,550061,0,0,198,198,05
Oklahoma,Superintendent of Public Instruction,John Cox,DEM,550062,0,0,35,35,
Oklahoma,Superintendent of Public Instruction,Jack Jr.,DEM,550062,0,0,18,18,
Oklahoma,Superintendent of Public Instruction,Ivan Holmes,DEM,550062,0,0,6,6,
Oklahoma,Superintendent of Public Instruction,Freda Deskin,DEM,550062,0,0,58,58,
Oklahoma,U.S. Senate,Patrick Michael Hayes,DEM,550062,0,0,17,17,
Oklahoma,U.S. Senate,Jim Rogers,DEM,550062,0,0,23,23,
Oklahoma,U.S. Senate,Connie Johnson,DEM,550062,0,0,68,68,
Oklahoma,U.S. House,Tom Guild,DEM,550062,0,0,50,50,05
Oklahoma,U.S. House,Al Mcaffrey,DEM,550062,0,0,42,42,05
Oklahoma,U.S. House,Leona Leonard,DEM,550062,0,0,19,19,05
Oklahoma,Governor,Dax Ewbank,REP,550062,0,0,51,51,
Oklahoma,Governor,Chad Moody,REP,550062,0,0,69,69,
Oklahoma,Governor,Mary Fallin,REP,550062,0,0,579,579,
Oklahoma,Superintendent of Public Instruction,Brian Kelly,REP,550062,0,0,128,128,
Oklahoma,Superintendent of Public Instruction,Janet Costello Barresi,REP,550062,0,0,237,237,
Oklahoma,Superintendent of Public Instruction,Joy Hofmeister,REP,550062,0,0,331,331,
Oklahoma,Insurance Commissioner,Bill Viner,REP,550062,0,0,105,105,
Oklahoma,Insurance Commissioner,John Doak,REP,550062,0,0,519,519,
Oklahoma,Corporation Commissioner,Todd Hiett,REP,550062,0,0,332,332,
Oklahoma,Corporation Commissioner,Cliff Branan,REP,550062,0,0,285,285,
Oklahoma,U.S. Senate,Evelyn Rogers,REP,550062,0,0,28,28,
Oklahoma,U.S. Senate,Rob Moye,REP,550062,0,0,10,10,
Oklahoma,U.S. Senate,D. Jean Mcbride-Samuels,REP,550062,0,0,3,3,
Oklahoma,U.S. Senate,Jim Inhofe,REP,550062,0,0,626,626,
Oklahoma,U.S. Senate,Erick Paul Wyatt,REP,550062,0,0,20,20,
Oklahoma,U.S. Senate,Andy Craig,REP,550062,0,0,1,1,
Oklahoma,U.S. Senate,T. Shannon,REP,550062,0,0,136,136,
Oklahoma,U.S. Senate,Randy Brogdon,REP,550062,0,0,26,26,
Oklahoma,U.S. Senate,Eric Mccray,REP,550062,0,0,0,0,
Oklahoma,U.S. Senate,Kevin Crow,REP,550062,0,0,1,1,
Oklahoma,U.S. Senate,James Lankford,REP,550062,0,0,549,549,
Oklahoma,U.S. Senate,Jason Weger,REP,550062,0,0,2,2,
Oklahoma,U.S. House,Shane David Jett,REP,550062,0,0,43,43,05
Oklahoma,U.S. House,Patrice Douglas,REP,550062,0,0,193,193,05
Oklahoma,U.S. House,Mike Turner,REP,550062,0,0,47,47,05
Oklahoma,U.S. House,Steve Russell,REP,550062,0,0,165,165,05
Oklahoma,U.S. House,Harvey Sparks,REP,550062,0,0,15,15,05
Oklahoma,U.S. House,Clark Jolley,REP,550062,0,0,237,237,05
Oklahoma,Superintendent of Public Instruction,John Cox,DEM,550063,0,0,6,6,
Oklahoma,Superintendent of Public Instruction,Jack Jr.,DEM,550063,0,0,2,2,
Oklahoma,Superintendent of Public Instruction,Ivan Holmes,DEM,550063,0,0,2,2,
Oklahoma,Superintendent of Public Instruction,Freda Deskin,DEM,550063,0,0,14,14,
Oklahoma,U.S. Senate,Patrick Michael Hayes,DEM,550063,0,0,9,9,
Oklahoma,U.S. Senate,Jim Rogers,DEM,550063,0,0,3,3,
Oklahoma,U.S. Senate,Connie Johnson,DEM,550063,0,0,9,9,
Oklahoma,U.S. House,Tom Guild,DEM,550063,0,0,7,7,05
Oklahoma,U.S. House,Al Mcaffrey,DEM,550063,0,0,10,10,05
Oklahoma,U.S. House,Leona Leonard,DEM,550063,0,0,5,5,05
Oklahoma,Governor,Dax Ewbank,REP,550063,0,0,17,17,
Oklahoma,Governor,Chad Moody,REP,550063,0,0,23,23,
Oklahoma,Governor,Mary Fallin,REP,550063,0,0,196,196,
Oklahoma,Superintendent of Public Instruction,Brian Kelly,REP,550063,0,0,33,33,
Oklahoma,Superintendent of Public Instruction,Janet Costello Barresi,REP,550063,0,0,96,96,
Oklahoma,Superintendent of Public Instruction,Joy Hofmeister,REP,550063,0,0,98,98,
Oklahoma,Insurance Commissioner,Bill Viner,REP,550063,0,0,41,41,
Oklahoma,Insurance Commissioner,John Doak,REP,550063,0,0,163,163,
Oklahoma,Corporation Commissioner,Todd Hiett,REP,550063,0,0,98,98,
Oklahoma,Corporation Commissioner,Cliff Branan,REP,550063,0,0,104,104,
Oklahoma,U.S. Senate,Evelyn Rogers,REP,550063,0,0,5,5,
Oklahoma,U.S. Senate,Rob Moye,REP,550063,0,0,3,3,
Oklahoma,U.S. Senate,D. Jean Mcbride-Samuels,REP,550063,0,0,3,3,
Oklahoma,U.S. Senate,Jim Inhofe,REP,550063,0,0,221,221,
Oklahoma,U.S. Senate,Erick Paul Wyatt,REP,550063,0,0,2,2,
Oklahoma,U.S. Senate,Andy Craig,REP,550063,0,0,0,0,
Oklahoma,U.S. Senate,T. Shannon,REP,550063,0,0,37,37,
Oklahoma,U.S. Senate,Randy Brogdon,REP,550063,0,0,7,7,
Oklahoma,U.S. Senate,Eric Mccray,REP,550063,0,0,2,2,
Oklahoma,U.S. Senate,Kevin Crow,REP,550063,0,0,0,0,
Oklahoma,U.S. Senate,James Lankford,REP,550063,0,0,190,190,
Oklahoma,U.S. Senate,Jason Weger,REP,550063,0,0,2,2,
Oklahoma,U.S. House,Shane David Jett,REP,550063,0,0,10,10,05
Oklahoma,U.S. House,Patrice Douglas,REP,550063,0,0,59,59,05
Oklahoma,U.S. House,Mike Turner,REP,550063,0,0,22,22,05
Oklahoma,U.S. House,Steve Russell,REP,550063,0,0,61,61,05
Oklahoma,U.S. House,Harvey Sparks,REP,550063,0,0,10,10,05
Oklahoma,U.S. House,Clark Jolley,REP,550063,0,0,69,69,05
Oklahoma,Superintendent of Public Instruction,John Cox,DEM,550064,0,0,15,15,
Oklahoma,Superintendent of Public Instruction,Jack Jr.,DEM,550064,0,0,9,9,
Oklahoma,Superintendent of Public Instruction,Ivan Holmes,DEM,550064,0,0,7,7,
Oklahoma,Superintendent of Public Instruction,Freda Deskin,DEM,550064,0,0,32,32,
Oklahoma,U.S. Senate,Patrick Michael Hayes,DEM,550064,0,0,5,5,
Oklahoma,U.S. Senate,Jim Rogers,DEM,550064,0,0,16,16,
Oklahoma,U.S. Senate,Connie Johnson,DEM,550064,0,0,40,40,
Oklahoma,U.S. House,Tom Guild,DEM,550064,0,0,27,27,05
Oklahoma,U.S. House,Al Mcaffrey,DEM,550064,0,0,22,22,05
Oklahoma,U.S. House,Leona Leonard,DEM,550064,0,0,14,14,05
Oklahoma,Governor,Dax Ewbank,REP,550064,0,0,43,43,
Oklahoma,Governor,Chad Moody,REP,550064,0,0,50,50,
Oklahoma,Governor,Mary Fallin,REP,550064,0,0,415,415,
Oklahoma,Superintendent of Public Instruction,Brian Kelly,REP,550064,0,0,106,106,
Oklahoma,Superintendent of Public Instruction,Janet Costello Barresi,REP,550064,0,0,170,170,
Oklahoma,Superintendent of Public Instruction,Joy Hofmeister,REP,550064,0,0,225,225,
Oklahoma,Insurance Commissioner,Bill Viner,REP,550064,0,0,93,93,
Oklahoma,Insurance Commissioner,John Doak,REP,550064,0,0,378,378,
Oklahoma,Corporation Commissioner,Todd Hiett,REP,550064,0,0,229,229,
Oklahoma,Corporation Commissioner,Cliff Branan,REP,550064,0,0,237,237,
Oklahoma,U.S. Senate,Evelyn Rogers,REP,550064,0,0,19,19,
Oklahoma,U.S. Senate,Rob Moye,REP,550064,0,0,10,10,
Oklahoma,U.S. Senate,D. Jean Mcbride-Samuels,REP,550064,0,0,2,2,
Oklahoma,U.S. Senate,Jim Inhofe,REP,550064,0,0,450,450,
Oklahoma,U.S. Senate,Erick Paul Wyatt,REP,550064,0,0,20,20,
Oklahoma,U.S. Senate,Andy Craig,REP,550064,0,0,5,5,
Oklahoma,U.S. Senate,T. Shannon,REP,550064,0,0,115,115,
Oklahoma,U.S. Senate,Randy Brogdon,REP,550064,0,0,17,17,
Oklahoma,U.S. Senate,Eric Mccray,REP,550064,0,0,0,0,
Oklahoma,U.S. Senate,Kevin Crow,REP,550064,0,0,2,2,
Oklahoma,U.S. Senate,James Lankford,REP,550064,0,0,375,375,
Oklahoma,U.S. Senate,Jason Weger,REP,550064,0,0,0,0,
Oklahoma,U.S. House,Shane David Jett,REP,550064,0,0,29,29,05
Oklahoma,U.S. House,Patrice Douglas,REP,550064,0,0,144,144,05
Oklahoma,U.S. House,Mike Turner,REP,550064,0,0,31,31,05
Oklahoma,U.S. House,Steve Russell,REP,550064,0,0,129,129,05
Oklahoma,U.S. House,Harvey Sparks,REP,550064,0,0,31,31,05
Oklahoma,U.S. House,Clark Jolley,REP,550064,0,0,143,143,05
Oklahoma,Superintendent of Public Instruction,John Cox,DEM,550065,0,0,14,14,
Oklahoma,Superintendent of Public Instruction,Jack Jr.,DEM,550065,0,0,8,8,
Oklahoma,Superintendent of Public Instruction,Ivan Holmes,DEM,550065,0,0,5,5,
Oklahoma,Superintendent of Public Instruction,Freda Deskin,DEM,550065,0,0,27,27,
Oklahoma,U.S. Senate,Patrick Michael Hayes,DEM,550065,0,0,4,4,
Oklahoma,U.S. Senate,Jim Rogers,DEM,550065,0,0,6,6,
Oklahoma,U.S. Senate,Connie Johnson,DEM,550065,0,0,45,45,
Oklahoma,U.S. House,Tom Guild,DEM,550065,0,0,23,23,05
Oklahoma,U.S. House,Al Mcaffrey,DEM,550065,0,0,13,13,05
Oklahoma,U.S. House,Leona Leonard,DEM,550065,0,0,18,18,05
Oklahoma,Governor,Dax Ewbank,REP,550065,0,0,22,22,
Oklahoma,Governor,Chad Moody,REP,550065,0,0,35,35,
Oklahoma,Governor,Mary Fallin,REP,550065,0,0,159,159,
Oklahoma,Superintendent of Public Instruction,Brian Kelly,REP,550065,0,0,55,55,
Oklahoma,Superintendent of Public Instruction,Janet Costello Barresi,REP,550065,0,0,64,64,
Oklahoma,Superintendent of Public Instruction,Joy Hofmeister,REP,550065,0,0,95,95,
Oklahoma,Insurance Commissioner,Bill Viner,REP,550065,0,0,38,38,
Oklahoma,Insurance Commissioner,John Doak,REP,550065,0,0,152,152,
Oklahoma,Corporation Commissioner,Todd Hiett,REP,550065,0,0,97,97,
Oklahoma,Corporation Commissioner,Cliff Branan,REP,550065,0,0,101,101,
Oklahoma,U.S. Senate,Evelyn Rogers,REP,550065,0,0,6,6,
Oklahoma,U.S. Senate,Rob Moye,REP,550065,0,0,3,3,
Oklahoma,U.S. Senate,D. Jean Mcbride-Samuels,REP,550065,0,0,5,5,
Oklahoma,U.S. Senate,Jim Inhofe,REP,550065,0,0,197,197,
Oklahoma,U.S. Senate,Erick Paul Wyatt,REP,550065,0,0,5,5,
Oklahoma,U.S. Senate,Andy Craig,REP,550065,0,0,0,0,
Oklahoma,U.S. Senate,T. Shannon,REP,550065,0,0,60,60,
Oklahoma,U.S. Senate,Randy Brogdon,REP,550065,0,0,12,12,
Oklahoma,U.S. Senate,Eric Mccray,REP,550065,0,0,0,0,
Oklahoma,U.S. Senate,Kevin Crow,REP,550065,0,0,1,1,
Oklahoma,U.S. Senate,James Lankford,REP,550065,0,0,149,149,
Oklahoma,U.S. Senate,Jason Weger,REP,550065,0,0,1,1,
Oklahoma,U.S. House,Shane David Jett,REP,550065,0,0,14,14,05
Oklahoma,U.S. House,Patrice Douglas,REP,550065,0,0,50,50,05
Oklahoma,U.S. House,Mike Turner,REP,550065,0,0,33,33,05
Oklahoma,U.S. House,Steve Russell,REP,550065,0,0,57,57,05
Oklahoma,U.S. House,Harvey Sparks,REP,550065,0,0,2,2,05
Oklahoma,U.S. House,Clark Jolley,REP,550065,0,0,57,57,05
Oklahoma,Superintendent of Public Instruction,John Cox,DEM,550066,0,0,108,108,
Oklahoma,Superintendent of Public Instruction,Jack Jr.,DEM,550066,0,0,37,37,
Oklahoma,Superintendent of Public Instruction,Ivan Holmes,DEM,550066,0,0,56,56,
Oklahoma,Superintendent of Public Instruction,Freda Deskin,DEM,550066,0,0,160,160,
Oklahoma,U.S. Senate,Patrick Michael Hayes,DEM,550066,0,0,25,25,
Oklahoma,U.S. Senate,Jim Rogers,DEM,550066,0,0,15,15,
Oklahoma,U.S. Senate,Connie Johnson,DEM,550066,0,0,345,345,
Oklahoma,U.S. House,Tom Guild,DEM,550066,0,0,138,138,05
Oklahoma,U.S. House,Al Mcaffrey,DEM,550066,0,0,75,75,05
Oklahoma,U.S. House,Leona Leonard,DEM,550066,0,0,143,143,05
Oklahoma,State Senate,Christine Byrd,DEM,550066,0,0,55,55,48
Oklahoma,State Senate,Anastasia Pittman,DEM,550066,0,0,332,332,48
Oklahoma,State House,Mike Shelton,DEM,550066,0,0,325,325,97
Oklahoma,State House,Bruce Fisher,DEM,550066,0,0,63,63,97
Oklahoma,Governor,Dax Ewbank,REP,550066,0,0,9,9,
Oklahoma,Governor,Chad Moody,REP,550066,0,0,17,17,
Oklahoma,Governor,Mary Fallin,REP,550066,0,0,68,68,
Oklahoma,Superintendent of Public Instruction,Brian Kelly,REP,550066,0,0,13,13,
Oklahoma,Superintendent of Public Instruction,Janet Costello Barresi,REP,550066,0,0,43,43,
Oklahoma,Superintendent of Public Instruction,Joy Hofmeister,REP,550066,0,0,38,38,
Oklahoma,Insurance Commissioner,Bill Viner,REP,550066,0,0,13,13,
Oklahoma,Insurance Commissioner,John Doak,REP,550066,0,0,73,73,
Oklahoma,Corporation Commissioner,Todd Hiett,REP,550066,0,0,34,34,
Oklahoma,Corporation Commissioner,Cliff Branan,REP,550066,0,0,50,50,
Oklahoma,U.S. Senate,Evelyn Rogers,REP,550066,0,0,6,6,
Oklahoma,U.S. Senate,Rob Moye,REP,550066,0,0,4,4,
Oklahoma,U.S. Senate,D. Jean Mcbride-Samuels,REP,550066,0,0,4,4,
Oklahoma,U.S. Senate,Jim Inhofe,REP,550066,0,0,74,74,
Oklahoma,U.S. Senate,Erick Paul Wyatt,REP,550066,0,0,3,3,
Oklahoma,U.S. Senate,Andy Craig,REP,550066,0,0,1,1,
Oklahoma,U.S. Senate,T. Shannon,REP,550066,0,0,29,29,
Oklahoma,U.S. Senate,Randy Brogdon,REP,550066,0,0,5,5,
Oklahoma,U.S. Senate,Eric Mccray,REP,550066,0,0,1,1,
Oklahoma,U.S. Senate,Kevin Crow,REP,550066,0,0,1,1,
Oklahoma,U.S. Senate,James Lankford,REP,550066,0,0,59,59,
Oklahoma,U.S. Senate,Jason Weger,REP,550066,0,0,0,0,
Oklahoma,U.S. House,Shane David Jett,REP,550066,0,0,10,10,05
Oklahoma,U.S. House,Patrice Douglas,REP,550066,0,0,21,21,05
Oklahoma,U.S. House,Mike Turner,REP,550066,0,0,17,17,05
Oklahoma,U.S. House,Steve Russell,REP,550066,0,0,23,23,05
Oklahoma,U.S. House,Harvey Sparks,REP,550066,0,0,2,2,05
Oklahoma,U.S. House,Clark Jolley,REP,550066,0,0,19,19,05
Oklahoma,Superintendent of Public Instruction,John Cox,DEM,550067,0,0,20,20,
Oklahoma,Superintendent of Public Instruction,Jack Jr.,DEM,550067,0,0,11,11,
Oklahoma,Superintendent of Public Instruction,Ivan Holmes,DEM,550067,0,0,1,1,
Oklahoma,Superintendent of Public Instruction,Freda Deskin,DEM,550067,0,0,36,36,
Oklahoma,U.S. Senate,Patrick Michael Hayes,DEM,550067,0,0,14,14,
Oklahoma,U.S. Senate,Jim Rogers,DEM,550067,0,0,24,24,
Oklahoma,U.S. Senate,Connie Johnson,DEM,550067,0,0,30,30,
Oklahoma,U.S. House,Tom Guild,DEM,550067,0,0,29,29,05
Oklahoma,U.S. House,Al Mcaffrey,DEM,550067,0,0,17,17,05
Oklahoma,U.S. House,Leona Leonard,DEM,550067,0,0,22,22,05
Oklahoma,Governor,Dax Ewbank,REP,550067,0,0,22,22,
Oklahoma,Governor,Chad Moody,REP,550067,0,0,48,48,
Oklahoma,Governor,Mary Fallin,REP,550067,0,0,218,218,
Oklahoma,Superintendent of Public Instruction,Brian Kelly,REP,550067,0,0,77,77,
Oklahoma,Superintendent of Public Instruction,Janet Costello Barresi,REP,550067,0,0,62,62,
Oklahoma,Superintendent of Public Instruction,Joy Hofmeister,REP,550067,0,0,147,147,
Oklahoma,Insurance Commissioner,Bill Viner,REP,550067,0,0,77,77,
Oklahoma,Insurance Commissioner,John Doak,REP,550067,0,0,187,187,
Oklahoma,Corporation Commissioner,Todd Hiett,REP,550067,0,0,109,109,
Oklahoma,Corporation Commissioner,Cliff Branan,REP,550067,0,0,154,154,
Oklahoma,U.S. Senate,Evelyn Rogers,REP,550067,0,0,14,14,
Oklahoma,U.S. Senate,Rob Moye,REP,550067,0,0,4,4,
Oklahoma,U.S. Senate,D. Jean Mcbride-Samuels,REP,550067,0,0,2,2,
Oklahoma,U.S. Senate,Jim Inhofe,REP,550067,0,0,253,253,
Oklahoma,U.S. Senate,Erick Paul Wyatt,REP,550067,0,0,10,10,
Oklahoma,U.S. Senate,Andy Craig,REP,550067,0,0,1,1,
Oklahoma,U.S. Senate,T. Shannon,REP,550067,0,0,93,93,
Oklahoma,U.S. Senate,Randy Brogdon,REP,550067,0,0,11,11,
Oklahoma,U.S. Senate,Eric Mccray,REP,550067,0,0,4,4,
Oklahoma,U.S. Senate,Kevin Crow,REP,550067,0,0,1,1,
Oklahoma,U.S. Senate,James Lankford,REP,550067,0,0,183,183,
Oklahoma,U.S. Senate,Jason Weger,REP,550067,0,0,0,0,
Oklahoma,U.S. House,Shane David Jett,REP,550067,0,0,57,57,05
Oklahoma,U.S. House,Patrice Douglas,REP,550067,0,0,40,40,05
Oklahoma,U.S. House,Mike Turner,REP,550067,0,0,57,57,05
Oklahoma,U.S. House,Steve Russell,REP,550067,0,0,85,85,05
Oklahoma,U.S. House,Harvey Sparks,REP,550067,0,0,8,8,05
Oklahoma,U.S. House,Clark Jolley,REP,550067,0,0,29,29,05
Oklahoma,State House,A. Bailey,REP,550067,0,0,84,84,10
Oklahoma,State House,Gary Banz,REP,550067,0,0,176,176,10
Oklahoma,Superintendent of Public Instruction,John Cox,DEM,550068,0,0,11,11,
Oklahoma,Superintendent of Public Instruction,Jack Jr.,DEM,550068,0,0,5,5,
Oklahoma,Superintendent of Public Instruction,Ivan Holmes,DEM,550068,0,0,1,1,
Oklahoma,Superintendent of Public Instruction,Freda Deskin,DEM,550068,0,0,24,24,
Oklahoma,U.S. Senate,Patrick Michael Hayes,DEM,550068,0,0,10,10,
Oklahoma,U.S. Senate,Jim Rogers,DEM,550068,0,0,6,6,
Oklahoma,U.S. Senate,Connie Johnson,DEM,550068,0,0,24,24,
Oklahoma,U.S. House,Tom Guild,DEM,550068,0,0,21,21,05
Oklahoma,U.S. House,Al Mcaffrey,DEM,550068,0,0,10,10,05
Oklahoma,U.S. House,Leona Leonard,DEM,550068,0,0,9,9,05
Oklahoma,Governor,Dax Ewbank,REP,550068,0,0,11,11,
Oklahoma,Governor,Chad Moody,REP,550068,0,0,26,26,
Oklahoma,Governor,Mary Fallin,REP,550068,0,0,142,142,
Oklahoma,Superintendent of Public Instruction,Brian Kelly,REP,550068,0,0,44,44,
Oklahoma,Superintendent of Public Instruction,Janet Costello Barresi,REP,550068,0,0,40,40,
Oklahoma,Superintendent of Public Instruction,Joy Hofmeister,REP,550068,0,0,92,92,
Oklahoma,Insurance Commissioner,Bill Viner,REP,550068,0,0,35,35,
Oklahoma,Insurance Commissioner,John Doak,REP,550068,0,0,139,139,
Oklahoma,Corporation Commissioner,Todd Hiett,REP,550068,0,0,79,79,
Oklahoma,Corporation Commissioner,Cliff Branan,REP,550068,0,0,92,92,
Oklahoma,U.S. Senate,Evelyn Rogers,REP,550068,0,0,3,3,
Oklahoma,U.S. Senate,Rob Moye,REP,550068,0,0,1,1,
Oklahoma,U.S. Senate,D. Jean Mcbride-Samuels,REP,550068,0,0,3,3,
Oklahoma,U.S. Senate,Jim Inhofe,REP,550068,0,0,163,163,
Oklahoma,U.S. Senate,Erick Paul Wyatt,REP,550068,0,0,6,6,
Oklahoma,U.S. Senate,Andy Craig,REP,550068,0,0,1,1,
Oklahoma,U.S. Senate,T. Shannon,REP,550068,0,0,48,48,
Oklahoma,U.S. Senate,Randy Brogdon,REP,550068,0,0,7,7,
Oklahoma,U.S. Senate,Eric Mccray,REP,550068,0,0,2,2,
Oklahoma,U.S. Senate,Kevin Crow,REP,550068,0,0,1,1,
Oklahoma,U.S. Senate,James Lankford,REP,550068,0,0,120,120,
Oklahoma,U.S. Senate,Jason Weger,REP,550068,0,0,0,0,
Oklahoma,U.S. House,Shane David Jett,REP,550068,0,0,26,26,05
Oklahoma,U.S. House,Patrice Douglas,REP,550068,0,0,34,34,05
Oklahoma,U.S. House,Mike Turner,REP,550068,0,0,33,33,05
Oklahoma,U.S. House,Steve Russell,REP,550068,0,0,61,61,05
Oklahoma,U.S. House,Harvey Sparks,REP,550068,0,0,4,4,05
Oklahoma,U.S. House,Clark Jolley,REP,550068,0,0,17,17,05
Oklahoma,Superintendent of Public Instruction,John Cox,DEM,550069,0,0,30,30,
Oklahoma,Superintendent of Public Instruction,Jack Jr.,DEM,550069,0,0,7,7,
Oklahoma,Superintendent of Public Instruction,Ivan Holmes,DEM,550069,0,0,4,4,
Oklahoma,Superintendent of Public Instruction,Freda Deskin,DEM,550069,0,0,27,27,
Oklahoma,U.S. Senate,Patrick Michael Hayes,DEM,550069,0,0,11,11,
Oklahoma,U.S. Senate,Jim Rogers,DEM,550069,0,0,20,20,
Oklahoma,U.S. Senate,Connie Johnson,DEM,550069,0,0,38,38,
Oklahoma,U.S. House,Tom Guild,DEM,550069,0,0,31,31,05
Oklahoma,U.S. House,Al Mcaffrey,DEM,550069,0,0,18,18,05
Oklahoma,U.S. House,Leona Leonard,DEM,550069,0,0,20,20,05
Oklahoma,Governor,Dax Ewbank,REP,550069,0,0,23,23,
Oklahoma,Governor,Chad Moody,REP,550069,0,0,43,43,
Oklahoma,Governor,Mary Fallin,REP,550069,0,0,170,170,
Oklahoma,Superintendent of Public Instruction,Brian Kelly,REP,550069,0,0,56,56,
Oklahoma,Superintendent of Public Instruction,Janet Costello Barresi,REP,550069,0,0,63,63,
Oklahoma,Superintendent of Public Instruction,Joy Hofmeister,REP,550069,0,0,120,120,
Oklahoma,Insurance Commissioner,Bill Viner,REP,550069,0,0,53,53,
Oklahoma,Insurance Commissioner,John Doak,REP,550069,0,0,173,173,
Oklahoma,Corporation Commissioner,Todd Hiett,REP,550069,0,0,100,100,
Oklahoma,Corporation Commissioner,Cliff Branan,REP,550069,0,0,119,119,
Oklahoma,U.S. Senate,Evelyn Rogers,REP,550069,0,0,11,11,
Oklahoma,U.S. Senate,Rob Moye,REP,550069,0,0,4,4,
Oklahoma,U.S. Senate,D. Jean Mcbride-Samuels,REP,550069,0,0,7,7,
Oklahoma,U.S. Senate,Jim Inhofe,REP,550069,0,0,208,208,
Oklahoma,U.S. Senate,Erick Paul Wyatt,REP,550069,0,0,9,9,
Oklahoma,U.S. Senate,Andy Craig,REP,550069,0,0,3,3,
Oklahoma,U.S. Senate,T. Shannon,REP,550069,0,0,52,52,
Oklahoma,U.S. Senate,Randy Brogdon,REP,550069,0,0,7,7,
Oklahoma,U.S. Senate,Eric Mccray,REP,550069,0,0,3,3,
Oklahoma,U.S. Senate,Kevin Crow,REP,550069,0,0,0,0,
Oklahoma,U.S. Senate,James Lankford,REP,550069,0,0,176,176,
Oklahoma,U.S. Senate,Jason Weger,REP,550069,0,0,0,0,
Oklahoma,U.S. House,Shane David Jett,REP,550069,0,0,38,38,05
Oklahoma,U.S. House,Patrice Douglas,REP,550069,0,0,42,42,05
Oklahoma,U.S. House,Mike Turner,REP,550069,0,0,41,41,05
Oklahoma,U.S. House,Steve Russell,REP,550069,0,0,73,73,05
Oklahoma,U.S. House,Harvey Sparks,REP,550069,0,0,13,13,05
Oklahoma,U.S. House,Clark Jolley,REP,550069,0,0,24,24,05
Oklahoma,Superintendent of Public Instruction,John Cox,DEM,550070,0,0,27,27,
Oklahoma,Superintendent of Public Instruction,Jack Jr.,DEM,550070,0,0,15,15,
Oklahoma,Superintendent of Public Instruction,Ivan Holmes,DEM,550070,0,0,3,3,
Oklahoma,Superintendent of Public Instruction,Freda Deskin,DEM,550070,0,0,22,22,
Oklahoma,U.S. Senate,Patrick Michael Hayes,DEM,550070,0,0,11,11,
Oklahoma,U.S. Senate,Jim Rogers,DEM,550070,0,0,29,29,
Oklahoma,U.S. Senate,Connie Johnson,DEM,550070,0,0,25,25,
Oklahoma,U.S. House,Tom Guild,DEM,550070,0,0,29,29,05
Oklahoma,U.S. House,Al Mcaffrey,DEM,550070,0,0,13,13,05
Oklahoma,U.S. House,Leona Leonard,DEM,550070,0,0,22,22,05
Oklahoma,Governor,Dax Ewbank,REP,550070,0,0,9,9,
Oklahoma,Governor,Chad Moody,REP,550070,0,0,34,34,
Oklahoma,Governor,Mary Fallin,REP,550070,0,0,181,181,
Oklahoma,Superintendent of Public Instruction,Brian Kelly,REP,550070,0,0,60,60,
Oklahoma,Superintendent of Public Instruction,Janet Costello Barresi,REP,550070,0,0,43,43,
Oklahoma,Superintendent of Public Instruction,Joy Hofmeister,REP,550070,0,0,119,119,
Oklahoma,Insurance Commissioner,Bill Viner,REP,550070,0,0,56,56,
Oklahoma,Insurance Commissioner,John Doak,REP,550070,0,0,151,151,
Oklahoma,Corporation Commissioner,Todd Hiett,REP,550070,0,0,93,93,
Oklahoma,Corporation Commissioner,Cliff Branan,REP,550070,0,0,114,114,
Oklahoma,U.S. Senate,Evelyn Rogers,REP,550070,0,0,6,6,
Oklahoma,U.S. Senate,Rob Moye,REP,550070,0,0,5,5,
Oklahoma,U.S. Senate,D. Jean Mcbride-Samuels,REP,550070,0,0,5,5,
Oklahoma,U.S. Senate,Jim Inhofe,REP,550070,0,0,202,202,
Oklahoma,U.S. Senate,Erick Paul Wyatt,REP,550070,0,0,2,2,
Oklahoma,U.S. Senate,Andy Craig,REP,550070,0,0,1,1,
Oklahoma,U.S. Senate,T. Shannon,REP,550070,0,0,45,45,
Oklahoma,U.S. Senate,Randy Brogdon,REP,550070,0,0,3,3,
Oklahoma,U.S. Senate,Eric Mccray,REP,550070,0,0,5,5,
Oklahoma,U.S. Senate,Kevin Crow,REP,550070,0,0,1,1,
Oklahoma,U.S. Senate,James Lankford,REP,550070,0,0,170,170,
Oklahoma,U.S. Senate,Jason Weger,REP,550070,0,0,0,0,
Oklahoma,U.S. House,Shane David Jett,REP,550070,0,0,41,41,05
Oklahoma,U.S. House,Patrice Douglas,REP,550070,0,0,43,43,05
Oklahoma,U.S. House,Mike Turner,REP,550070,0,0,33,33,05
Oklahoma,U.S. House,Steve Russell,REP,550070,0,0,71,71,05
Oklahoma,U.S. House,Harvey Sparks,REP,550070,0,0,7,7,05
Oklahoma,U.S. House,Clark Jolley,REP,550070,0,0,24,24,05
Oklahoma,Superintendent of Public Instruction,John Cox,DEM,550071,0,0,37,37,
Oklahoma,Superintendent of Public Instruction,Jack Jr.,DEM,550071,0,0,8,8,
Oklahoma,Superintendent of Public Instruction,Ivan Holmes,DEM,550071,0,0,8,8,
Oklahoma,Superintendent of Public Instruction,Freda Deskin,DEM,550071,0,0,33,33,
Oklahoma,U.S. Senate,Patrick Michael Hayes,DEM,550071,0,0,14,14,
Oklahoma,U.S. Senate,Jim Rogers,DEM,550071,0,0,35,35,
Oklahoma,U.S. Senate,Connie Johnson,DEM,550071,0,0,34,34,
Oklahoma,U.S. House,Tom Guild,DEM,550071,0,0,45,45,05
Oklahoma,U.S. House,Al Mcaffrey,DEM,550071,0,0,14,14,05
Oklahoma,U.S. House,Leona Leonard,DEM,550071,0,0,23,23,05
Oklahoma,Governor,Dax Ewbank,REP,550071,0,0,22,22,
Oklahoma,Governor,Chad Moody,REP,550071,0,0,31,31,
Oklahoma,Governor,Mary Fallin,REP,550071,0,0,211,211,
Oklahoma,Superintendent of Public Instruction,Brian Kelly,REP,550071,0,0,74,74,
Oklahoma,Superintendent of Public Instruction,Janet Costello Barresi,REP,550071,0,0,60,60,
Oklahoma,Superintendent of Public Instruction,Joy Hofmeister,REP,550071,0,0,119,119,
Oklahoma,Insurance Commissioner,Bill Viner,REP,550071,0,0,63,63,
Oklahoma,Insurance Commissioner,John Doak,REP,550071,0,0,172,172,
Oklahoma,Corporation Commissioner,Todd Hiett,REP,550071,0,0,112,112,
Oklahoma,Corporation Commissioner,Cliff Branan,REP,550071,0,0,122,122,
Oklahoma,U.S. Senate,Evelyn Rogers,REP,550071,0,0,12,12,
Oklahoma,U.S. Senate,Rob Moye,REP,550071,0,0,6,6,
Oklahoma,U.S. Senate,D. Jean Mcbride-Samuels,REP,550071,0,0,1,1,
Oklahoma,U.S. Senate,Jim Inhofe,REP,550071,0,0,226,226,
Oklahoma,U.S. Senate,Erick Paul Wyatt,REP,550071,0,0,12,12,
Oklahoma,U.S. Senate,Andy Craig,REP,550071,0,0,1,1,
Oklahoma,U.S. Senate,T. Shannon,REP,550071,0,0,47,47,
Oklahoma,U.S. Senate,Randy Brogdon,REP,550071,0,0,12,12,
Oklahoma,U.S. Senate,Eric Mccray,REP,550071,0,0,0,0,
Oklahoma,U.S. Senate,Kevin Crow,REP,550071,0,0,3,3,
Oklahoma,U.S. Senate,James Lankford,REP,550071,0,0,197,197,
Oklahoma,U.S. Senate,Jason Weger,REP,550071,0,0,5,5,
Oklahoma,U.S. House,Shane David Jett,REP,550071,0,0,39,39,05
Oklahoma,U.S. House,Patrice Douglas,REP,550071,0,0,39,39,05
Oklahoma,U.S. House,Mike Turner,REP,550071,0,0,42,42,05
Oklahoma,U.S. House,Steve Russell,REP,550071,0,0,79,79,05
Oklahoma,U.S. House,Harvey Sparks,REP,550071,0,0,11,11,05
Oklahoma,U.S. House,Clark Jolley,REP,550071,0,0,39,39,05
Oklahoma,Superintendent of Public Instruction,John Cox,DEM,550072,0,0,27,27,
Oklahoma,Superintendent of Public Instruction,Jack Jr.,DEM,550072,0,0,8,8,
Oklahoma,Superintendent of Public Instruction,Ivan Holmes,DEM,550072,0,0,11,11,
Oklahoma,Superintendent of Public Instruction,Freda Deskin,DEM,550072,0,0,28,28,
Oklahoma,U.S. Senate,Patrick Michael Hayes,DEM,550072,0,0,16,16,
Oklahoma,U.S. Senate,Jim Rogers,DEM,550072,0,0,25,25,
Oklahoma,U.S. Senate,Connie Johnson,DEM,550072,0,0,32,32,
Oklahoma,U.S. House,Tom Guild,DEM,550072,0,0,41,41,05
Oklahoma,U.S. House,Al Mcaffrey,DEM,550072,0,0,15,15,05
Oklahoma,U.S. House,Leona Leonard,DEM,550072,0,0,17,17,05
Oklahoma,Governor,Dax Ewbank,REP,550072,0,0,13,13,
Oklahoma,Governor,Chad Moody,REP,550072,0,0,45,45,
Oklahoma,Governor,Mary Fallin,REP,550072,0,0,131,131,
Oklahoma,Superintendent of Public Instruction,Brian Kelly,REP,550072,0,0,52,52,
Oklahoma,Superintendent of Public Instruction,Janet Costello Barresi,REP,550072,0,0,28,28,
Oklahoma,Superintendent of Public Instruction,Joy Hofmeister,REP,550072,0,0,107,107,
Oklahoma,Insurance Commissioner,Bill Viner,REP,550072,0,0,40,40,
Oklahoma,Insurance Commissioner,John Doak,REP,550072,0,0,130,130,
Oklahoma,Corporation Commissioner,Todd Hiett,REP,550072,0,0,75,75,
Oklahoma,Corporation Commissioner,Cliff Branan,REP,550072,0,0,96,96,
Oklahoma,U.S. Senate,Evelyn Rogers,REP,550072,0,0,6,6,
Oklahoma,U.S. Senate,Rob Moye,REP,550072,0,0,5,5,
Oklahoma,U.S. Senate,D. Jean Mcbride-Samuels,REP,550072,0,0,3,3,
Oklahoma,U.S. Senate,Jim Inhofe,REP,550072,0,0,164,164,
Oklahoma,U.S. Senate,Erick Paul Wyatt,REP,550072,0,0,10,10,
Oklahoma,U.S. Senate,Andy Craig,REP,550072,0,0,1,1,
Oklahoma,U.S. Senate,T. Shannon,REP,550072,0,0,45,45,
Oklahoma,U.S. Senate,Randy Brogdon,REP,550072,0,0,1,1,
Oklahoma,U.S. Senate,Eric Mccray,REP,550072,0,0,2,2,
Oklahoma,U.S. Senate,Kevin Crow,REP,550072,0,0,1,1,
Oklahoma,U.S. Senate,James Lankford,REP,550072,0,0,136,136,
Oklahoma,U.S. Senate,Jason Weger,REP,550072,0,0,3,3,
Oklahoma,U.S. House,Shane David Jett,REP,550072,0,0,36,36,05
Oklahoma,U.S. House,Patrice Douglas,REP,550072,0,0,29,29,05
Oklahoma,U.S. House,Mike Turner,REP,550072,0,0,25,25,05
Oklahoma,U.S. House,Steve Russell,REP,550072,0,0,48,48,05
Oklahoma,U.S. House,Harvey Sparks,REP,550072,0,0,7,7,05
Oklahoma,U.S. House,Clark Jolley,REP,550072,0,0,39,39,05
Oklahoma,Superintendent of Public Instruction,John Cox,DEM,550073,0,0,7,7,
Oklahoma,Superintendent of Public Instruction,Jack Jr.,DEM,550073,0,0,6,6,
Oklahoma,Superintendent of Public Instruction,Ivan Holmes,DEM,550073,0,0,3,3,
Oklahoma,Superintendent of Public Instruction,Freda Deskin,DEM,550073,0,0,3,3,
Oklahoma,U.S. Senate,Patrick Michael Hayes,DEM,550073,0,0,5,5,
Oklahoma,U.S. Senate,Jim Rogers,DEM,550073,0,0,6,6,
Oklahoma,U.S. Senate,Connie Johnson,DEM,550073,0,0,7,7,
Oklahoma,U.S. House,Tom Guild,DEM,550073,0,0,11,11,05
Oklahoma,U.S. House,Al Mcaffrey,DEM,550073,0,0,5,5,05
Oklahoma,U.S. House,Leona Leonard,DEM,550073,0,0,2,2,05
Oklahoma,State House,Mike Shelton,DEM,550073,0,0,15,15,97
Oklahoma,State House,Bruce Fisher,DEM,550073,0,0,6,6,97
Oklahoma,Governor,Dax Ewbank,REP,550073,0,0,6,6,
Oklahoma,Governor,Chad Moody,REP,550073,0,0,14,14,
Oklahoma,Governor,Mary Fallin,REP,550073,0,0,37,37,
Oklahoma,Superintendent of Public Instruction,Brian Kelly,REP,550073,0,0,12,12,
Oklahoma,Superintendent of Public Instruction,Janet Costello Barresi,REP,550073,0,0,17,17,
Oklahoma,Superintendent of Public Instruction,Joy Hofmeister,REP,550073,0,0,28,28,
Oklahoma,Insurance Commissioner,Bill Viner,REP,550073,0,0,10,10,
Oklahoma,Insurance Commissioner,John Doak,REP,550073,0,0,44,44,
Oklahoma,Corporation Commissioner,Todd Hiett,REP,550073,0,0,16,16,
Oklahoma,Corporation Commissioner,Cliff Branan,REP,550073,0,0,35,35,
Oklahoma,U.S. Senate,Evelyn Rogers,REP,550073,0,0,3,3,
Oklahoma,U.S. Senate,Rob Moye,REP,550073,0,0,0,0,
Oklahoma,U.S. Senate,D. Jean Mcbride-Samuels,REP,550073,0,0,3,3,
Oklahoma,U.S. Senate,Jim Inhofe,REP,550073,0,0,48,48,
Oklahoma,U.S. Senate,Erick Paul Wyatt,REP,550073,0,0,3,3,
Oklahoma,U.S. Senate,Andy Craig,REP,550073,0,0,2,2,
Oklahoma,U.S. Senate,T. Shannon,REP,550073,0,0,20,20,
Oklahoma,U.S. Senate,Randy Brogdon,REP,550073,0,0,4,4,
Oklahoma,U.S. Senate,Eric Mccray,REP,550073,0,0,0,0,
Oklahoma,U.S. Senate,Kevin Crow,REP,550073,0,0,1,1,
Oklahoma,U.S. Senate,James Lankford,REP,550073,0,0,29,29,
Oklahoma,U.S. Senate,Jason Weger,REP,550073,0,0,1,1,
Oklahoma,U.S. House,Shane David Jett,REP,550073,0,0,13,13,05
Oklahoma,U.S. House,Patrice Douglas,REP,550073,0,0,13,13,05
Oklahoma,U.S. House,Mike Turner,REP,550073,0,0,5,5,05
Oklahoma,U.S. House,Steve Russell,REP,550073,0,0,15,15,05
Oklahoma,U.S. House,Harvey Sparks,REP,550073,0,0,3,3,05
Oklahoma,U.S. House,Clark Jolley,REP,550073,0,0,8,8,05
Oklahoma,Superintendent of Public Instruction,John Cox,DEM,550074,0,0,15,15,
Oklahoma,Superintendent of Public Instruction,Jack Jr.,DEM,550074,0,0,7,7,
Oklahoma,Superintendent of Public Instruction,Ivan Holmes,DEM,550074,0,0,6,6,
Oklahoma,Superintendent of Public Instruction,Freda Deskin,DEM,550074,0,0,37,37,
Oklahoma,U.S. Senate,Patrick Michael Hayes,DEM,550074,0,0,3,3,
Oklahoma,U.S. Senate,Jim Rogers,DEM,550074,0,0,2,2,
Oklahoma,U.S. Senate,Connie Johnson,DEM,550074,0,0,66,66,
Oklahoma,U.S. House,Tom Guild,DEM,550074,0,0,6,6,05
Oklahoma,U.S. House,Al Mcaffrey,DEM,550074,0,0,9,9,05
Oklahoma,U.S. House,Leona Leonard,DEM,550074,0,0,47,47,05
Oklahoma,State Senate,Christine Byrd,DEM,550074,0,0,7,7,48
Oklahoma,State Senate,Anastasia Pittman,DEM,550074,0,0,63,63,48
Oklahoma,State House,Mike Shelton,DEM,550074,0,0,50,50,97
Oklahoma,State House,Bruce Fisher,DEM,550074,0,0,22,22,97
Oklahoma,Governor,Dax Ewbank,REP,550074,0,0,0,0,
Oklahoma,Governor,Chad Moody,REP,550074,0,0,1,1,
Oklahoma,Governor,Mary Fallin,REP,550074,0,0,10,10,
Oklahoma,Superintendent of Public Instruction,Brian Kelly,REP,550074,0,0,2,2,
Oklahoma,Superintendent of Public Instruction,Janet Costello Barresi,REP,550074,0,0,1,1,
Oklahoma,Superintendent of Public Instruction,Joy Hofmeister,REP,550074,0,0,8,8,
Oklahoma,Insurance Commissioner,Bill Viner,REP,550074,0,0,2,2,
Oklahoma,Insurance Commissioner,John Doak,REP,550074,0,0,9,9,
Oklahoma,Corporation Commissioner,Todd Hiett,REP,550074,0,0,3,3,
Oklahoma,Corporation Commissioner,Cliff Branan,REP,550074,0,0,7,7,
Oklahoma,U.S. Senate,Evelyn Rogers,REP,550074,0,0,0,0,
Oklahoma,U.S. Senate,Rob Moye,REP,550074,0,0,0,0,
Oklahoma,U.S. Senate,D. Jean Mcbride-Samuels,REP,550074,0,0,0,0,
Oklahoma,U.S. Senate,Jim Inhofe,REP,550074,0,0,10,10,
Oklahoma,U.S. Senate,Erick Paul Wyatt,REP,550074,0,0,0,0,
Oklahoma,U.S. Senate,Andy Craig,REP,550074,0,0,0,0,
Oklahoma,U.S. Senate,T. Shannon,REP,550074,0,0,6,6,
Oklahoma,U.S. Senate,Randy Brogdon,REP,550074,0,0,0,0,
Oklahoma,U.S. Senate,Eric Mccray,REP,550074,0,0,0,0,
Oklahoma,U.S. Senate,Kevin Crow,REP,550074,0,0,0,0,
Oklahoma,U.S. Senate,James Lankford,REP,550074,0,0,5,5,
Oklahoma,U.S. Senate,Jason Weger,REP,550074,0,0,0,0,
Oklahoma,U.S. House,Shane David Jett,REP,550074,0,0,3,3,05
Oklahoma,U.S. House,Patrice Douglas,REP,550074,0,0,0,0,05
Oklahoma,U.S. House,Mike Turner,REP,550074,0,0,0,0,05
Oklahoma,U.S. House,Steve Russell,REP,550074,0,0,4,4,05
Oklahoma,U.S. House,Harvey Sparks,REP,550074,0,0,0,0,05
Oklahoma,U.S. House,Clark Jolley,REP,550074,0,0,3,3,05
Oklahoma,Superintendent of Public Instruction,John Cox,DEM,550075,0,0,74,74,
Oklahoma,Superintendent of Public Instruction,Jack Jr.,DEM,550075,0,0,33,33,
Oklahoma,Superintendent of Public Instruction,Ivan Holmes,DEM,550075,0,0,28,28,
Oklahoma,Superintendent of Public Instruction,Freda Deskin,DEM,550075,0,0,111,111,
Oklahoma,U.S. Senate,Patrick Michael Hayes,DEM,550075,0,0,9,9,
Oklahoma,U.S. Senate,Jim Rogers,DEM,550075,0,0,14,14,
Oklahoma,U.S. Senate,Connie Johnson,DEM,550075,0,0,232,232,
Oklahoma,U.S. House,Tom Guild,DEM,550075,0,0,88,88,05
Oklahoma,U.S. House,Al Mcaffrey,DEM,550075,0,0,28,28,05
Oklahoma,U.S. House,Leona Leonard,DEM,550075,0,0,121,121,05
Oklahoma,State Senate,Christine Byrd,DEM,550075,0,0,41,41,48
Oklahoma,State Senate,Anastasia Pittman,DEM,550075,0,0,216,216,48
Oklahoma,State House,Mike Shelton,DEM,550075,0,0,199,199,97
Oklahoma,State House,Bruce Fisher,DEM,550075,0,0,58,58,97
Oklahoma,Governor,Dax Ewbank,REP,550075,0,0,10,10,
Oklahoma,Governor,Chad Moody,REP,550075,0,0,11,11,
Oklahoma,Governor,Mary Fallin,REP,550075,0,0,50,50,
Oklahoma,Superintendent of Public Instruction,Brian Kelly,REP,550075,0,0,15,15,
Oklahoma,Superintendent of Public Instruction,Janet Costello Barresi,REP,550075,0,0,18,18,
Oklahoma,Superintendent of Public Instruction,Joy Hofmeister,REP,550075,0,0,38,38,
Oklahoma,Insurance Commissioner,Bill Viner,REP,550075,0,0,16,16,
Oklahoma,Insurance Commissioner,John Doak,REP,550075,0,0,55,55,
Oklahoma,Corporation Commissioner,Todd Hiett,REP,550075,0,0,39,39,
Oklahoma,Corporation Commissioner,Cliff Branan,REP,550075,0,0,32,32,
Oklahoma,U.S. Senate,Evelyn Rogers,REP,550075,0,0,5,5,
Oklahoma,U.S. Senate,Rob Moye,REP,550075,0,0,2,2,
Oklahoma,U.S. Senate,D. Jean Mcbride-Samuels,REP,550075,0,0,2,2,
Oklahoma,U.S. Senate,Jim Inhofe,REP,550075,0,0,58,58,
Oklahoma,U.S. Senate,Erick Paul Wyatt,REP,550075,0,0,3,3,
Oklahoma,U.S. Senate,Andy Craig,REP,550075,0,0,1,1,
Oklahoma,U.S. Senate,T. Shannon,REP,550075,0,0,19,19,
Oklahoma,U.S. Senate,Randy Brogdon,REP,550075,0,0,5,5,
Oklahoma,U.S. Senate,Eric Mccray,REP,550075,0,0,0,0,
Oklahoma,U.S. Senate,Kevin Crow,REP,550075,0,0,1,1,
Oklahoma,U.S. Senate,James Lankford,REP,550075,0,0,43,43,
Oklahoma,U.S. Senate,Jason Weger,REP,550075,0,0,0,0,
Oklahoma,U.S. House,Shane David Jett,REP,550075,0,0,15,15,05
Oklahoma,U.S. House,Patrice Douglas,REP,550075,0,0,17,17,05
Oklahoma,U.S. House,Mike Turner,REP,550075,0,0,7,7,05
Oklahoma,U.S. House,Steve Russell,REP,550075,0,0,20,20,05
Oklahoma,U.S. House,Harvey Sparks,REP,550075,0,0,0,0,05
Oklahoma,U.S. House,Clark Jolley,REP,550075,0,0,9,9,05
Oklahoma,Superintendent of Public Instruction,John Cox,DEM,550076,0,0,53,53,
Oklahoma,Superintendent of Public Instruction,Jack Jr.,DEM,550076,0,0,13,13,
Oklahoma,Superintendent of Public Instruction,Ivan Holmes,DEM,550076,0,0,5,5,
Oklahoma,Superintendent of Public Instruction,Freda Deskin,DEM,550076,0,0,62,62,
Oklahoma,U.S. Senate,Patrick Michael Hayes,DEM,550076,0,0,20,20,
Oklahoma,U.S. Senate,Jim Rogers,DEM,550076,0,0,43,43,
Oklahoma,U.S. Senate,Connie Johnson,DEM,550076,0,0,64,64,
Oklahoma,U.S. House,Tom Guild,DEM,550076,0,0,54,54,05
Oklahoma,U.S. House,Al Mcaffrey,DEM,550076,0,0,35,35,05
Oklahoma,U.S. House,Leona Leonard,DEM,550076,0,0,38,38,05
Oklahoma,Governor,Dax Ewbank,REP,550076,0,0,26,26,
Oklahoma,Governor,Chad Moody,REP,550076,0,0,50,50,
Oklahoma,Governor,Mary Fallin,REP,550076,0,0,125,125,
Oklahoma,Superintendent of Public Instruction,Brian Kelly,REP,550076,0,0,67,67,
Oklahoma,Superintendent of Public Instruction,Janet Costello Barresi,REP,550076,0,0,49,49,
Oklahoma,Superintendent of Public Instruction,Joy Hofmeister,REP,550076,0,0,82,82,
Oklahoma,Insurance Commissioner,Bill Viner,REP,550076,0,0,56,56,
Oklahoma,Insurance Commissioner,John Doak,REP,550076,0,0,133,133,
Oklahoma,Corporation Commissioner,Todd Hiett,REP,550076,0,0,88,88,
Oklahoma,Corporation Commissioner,Cliff Branan,REP,550076,0,0,104,104,
Oklahoma,U.S. Senate,Evelyn Rogers,REP,550076,0,0,11,11,
Oklahoma,U.S. Senate,Rob Moye,REP,550076,0,0,8,8,
Oklahoma,U.S. Senate,D. Jean Mcbride-Samuels,REP,550076,0,0,9,9,
Oklahoma,U.S. Senate,Jim Inhofe,REP,550076,0,0,160,160,
Oklahoma,U.S. Senate,Erick Paul Wyatt,REP,550076,0,0,10,10,
Oklahoma,U.S. Senate,Andy Craig,REP,550076,0,0,0,0,
Oklahoma,U.S. Senate,T. Shannon,REP,550076,0,0,51,51,
Oklahoma,U.S. Senate,Randy Brogdon,REP,550076,0,0,12,12,
Oklahoma,U.S. Senate,Eric Mccray,REP,550076,0,0,2,2,
Oklahoma,U.S. Senate,Kevin Crow,REP,550076,0,0,3,3,
Oklahoma,U.S. Senate,James Lankford,REP,550076,0,0,130,130,
Oklahoma,U.S. Senate,Jason Weger,REP,550076,0,0,2,2,
Oklahoma,U.S. House,Shane David Jett,REP,550076,0,0,17,17,05
Oklahoma,U.S. House,Patrice Douglas,REP,550076,0,0,42,42,05
Oklahoma,U.S. House,Mike Turner,REP,550076,0,0,33,33,05
Oklahoma,U.S. House,Steve Russell,REP,550076,0,0,52,52,05
Oklahoma,U.S. House,Harvey Sparks,REP,550076,0,0,12,12,05
Oklahoma,U.S. House,Clark Jolley,REP,550076,0,0,40,40,05
Oklahoma,Superintendent of Public Instruction,John Cox,DEM,550077,0,0,81,81,
Oklahoma,Superintendent of Public Instruction,Jack Jr.,DEM,550077,0,0,24,24,
Oklahoma,Superintendent of Public Instruction,Ivan Holmes,DEM,550077,0,0,41,41,
Oklahoma,Superintendent of Public Instruction,Freda Deskin,DEM,550077,0,0,111,111,
Oklahoma,U.S. Senate,Patrick Michael Hayes,DEM,550077,0,0,24,24,
Oklahoma,U.S. Senate,Jim Rogers,DEM,550077,0,0,24,24,
Oklahoma,U.S. Senate,Connie Johnson,DEM,550077,0,0,223,223,
Oklahoma,U.S. House,Tom Guild,DEM,550077,0,0,107,107,05
Oklahoma,U.S. House,Al Mcaffrey,DEM,550077,0,0,54,54,05
Oklahoma,U.S. House,Leona Leonard,DEM,550077,0,0,90,90,05
Oklahoma,State Senate,Christine Byrd,DEM,550077,0,0,48,48,48
Oklahoma,State Senate,Anastasia Pittman,DEM,550077,0,0,220,220,48
Oklahoma,State House,Mike Shelton,DEM,550077,0,0,205,205,97
Oklahoma,State House,Bruce Fisher,DEM,550077,0,0,69,69,97
Oklahoma,Governor,Dax Ewbank,REP,550077,0,0,7,7,
Oklahoma,Governor,Chad Moody,REP,550077,0,0,6,6,
Oklahoma,Governor,Mary Fallin,REP,550077,0,0,79,79,
Oklahoma,Superintendent of Public Instruction,Brian Kelly,REP,550077,0,0,28,28,
Oklahoma,Superintendent of Public Instruction,Janet Costello Barresi,REP,550077,0,0,22,22,
Oklahoma,Superintendent of Public Instruction,Joy Hofmeister,REP,550077,0,0,42,42,
Oklahoma,Insurance Commissioner,Bill Viner,REP,550077,0,0,20,20,
Oklahoma,Insurance Commissioner,John Doak,REP,550077,0,0,68,68,
Oklahoma,Corporation Commissioner,Todd Hiett,REP,550077,0,0,37,37,
Oklahoma,Corporation Commissioner,Cliff Branan,REP,550077,0,0,47,47,
Oklahoma,U.S. Senate,Evelyn Rogers,REP,550077,0,0,1,1,
Oklahoma,U.S. Senate,Rob Moye,REP,550077,0,0,3,3,
Oklahoma,U.S. Senate,D. Jean Mcbride-Samuels,REP,550077,0,0,1,1,
Oklahoma,U.S. Senate,Jim Inhofe,REP,550077,0,0,82,82,
Oklahoma,U.S. Senate,Erick Paul Wyatt,REP,550077,0,0,2,2,
Oklahoma,U.S. Senate,Andy Craig,REP,550077,0,0,1,1,
Oklahoma,U.S. Senate,T. Shannon,REP,550077,0,0,21,21,
Oklahoma,U.S. Senate,Randy Brogdon,REP,550077,0,0,4,4,
Oklahoma,U.S. Senate,Eric Mccray,REP,550077,0,0,0,0,
Oklahoma,U.S. Senate,Kevin Crow,REP,550077,0,0,1,1,
Oklahoma,U.S. Senate,James Lankford,REP,550077,0,0,62,62,
Oklahoma,U.S. Senate,Jason Weger,REP,550077,0,0,2,2,
Oklahoma,U.S. House,Shane David Jett,REP,550077,0,0,7,7,05
Oklahoma,U.S. House,Patrice Douglas,REP,550077,0,0,12,12,05
Oklahoma,U.S. House,Mike Turner,REP,550077,0,0,25,25,05
Oklahoma,U.S. House,Steve Russell,REP,550077,0,0,31,31,05
Oklahoma,U.S. House,Harvey Sparks,REP,550077,0,0,6,6,05
Oklahoma,U.S. House,Clark Jolley,REP,550077,0,0,9,9,05
Oklahoma,Superintendent of Public Instruction,John Cox,DEM,550078,0,0,51,51,
Oklahoma,Superintendent of Public Instruction,Jack Jr.,DEM,550078,0,0,12,12,
Oklahoma,Superintendent of Public Instruction,Ivan Holmes,DEM,550078,0,0,25,25,
Oklahoma,Superintendent of Public Instruction,Freda Deskin,DEM,550078,0,0,81,81,
Oklahoma,U.S. Senate,Patrick Michael Hayes,DEM,550078,0,0,16,16,
Oklahoma,U.S. Senate,Jim Rogers,DEM,550078,0,0,7,7,
Oklahoma,U.S. Senate,Connie Johnson,DEM,550078,0,0,150,150,
Oklahoma,U.S. House,Tom Guild,DEM,550078,0,0,60,60,05
Oklahoma,U.S. House,Al Mcaffrey,DEM,550078,0,0,27,27,05
Oklahoma,U.S. House,Leona Leonard,DEM,550078,0,0,76,76,05
Oklahoma,State Senate,Christine Byrd,DEM,550078,0,0,32,32,48
Oklahoma,State Senate,Anastasia Pittman,DEM,550078,0,0,140,140,48
Oklahoma,State House,Mike Shelton,DEM,550078,0,0,142,142,97
Oklahoma,State House,Bruce Fisher,DEM,550078,0,0,30,30,97
Oklahoma,Governor,Dax Ewbank,REP,550078,0,0,3,3,
Oklahoma,Governor,Chad Moody,REP,550078,0,0,8,8,
Oklahoma,Governor,Mary Fallin,REP,550078,0,0,25,25,
Oklahoma,Superintendent of Public Instruction,Brian Kelly,REP,550078,0,0,12,12,
Oklahoma,Superintendent of Public Instruction,Janet Costello Barresi,REP,550078,0,0,8,8,
Oklahoma,Superintendent of Public Instruction,Joy Hofmeister,REP,550078,0,0,16,16,
Oklahoma,Insurance Commissioner,Bill Viner,REP,550078,0,0,12,12,
Oklahoma,Insurance Commissioner,John Doak,REP,550078,0,0,23,23,
Oklahoma,Corporation Commissioner,Todd Hiett,REP,550078,0,0,20,20,
Oklahoma,Corporation Commissioner,Cliff Branan,REP,550078,0,0,15,15,
Oklahoma,U.S. Senate,Evelyn Rogers,REP,550078,0,0,4,4,
Oklahoma,U.S. Senate,Rob Moye,REP,550078,0,0,0,0,
Oklahoma,U.S. Senate,D. Jean Mcbride-Samuels,REP,550078,0,0,2,2,
Oklahoma,U.S. Senate,Jim Inhofe,REP,550078,0,0,24,24,
Oklahoma,U.S. Senate,Erick Paul Wyatt,REP,550078,0,0,6,6,
Oklahoma,U.S. Senate,Andy Craig,REP,550078,0,0,1,1,
Oklahoma,U.S. Senate,T. Shannon,REP,550078,0,0,7,7,
Oklahoma,U.S. Senate,Randy Brogdon,REP,550078,0,0,5,5,
Oklahoma,U.S. Senate,Eric Mccray,REP,550078,0,0,0,0,
Oklahoma,U.S. Senate,Kevin Crow,REP,550078,0,0,0,0,
Oklahoma,U.S. Senate,James Lankford,REP,550078,0,0,22,22,
Oklahoma,U.S. Senate,Jason Weger,REP,550078,0,0,1,1,
Oklahoma,U.S. House,Shane David Jett,REP,550078,0,0,2,2,05
Oklahoma,U.S. House,Patrice Douglas,REP,550078,0,0,10,10,05
Oklahoma,U.S. House,Mike Turner,REP,550078,0,0,7,7,05
Oklahoma,U.S. House,Steve Russell,REP,550078,0,0,7,7,05
Oklahoma,U.S. House,Harvey Sparks,REP,550078,0,0,4,4,05
Oklahoma,U.S. House,Clark Jolley,REP,550078,0,0,5,5,05
Oklahoma,Superintendent of Public Instruction,John Cox,DEM,550079,0,0,46,46,
Oklahoma,Superintendent of Public Instruction,Jack Jr.,DEM,550079,0,0,21,21,
Oklahoma,Superintendent of Public Instruction,Ivan Holmes,DEM,550079,0,0,20,20,
Oklahoma,Superintendent of Public Instruction,Freda Deskin,DEM,550079,0,0,99,99,
Oklahoma,U.S. Senate,Patrick Michael Hayes,DEM,550079,0,0,17,17,
Oklahoma,U.S. Senate,Jim Rogers,DEM,550079,0,0,7,7,
Oklahoma,U.S. Senate,Connie Johnson,DEM,550079,0,0,167,167,
Oklahoma,U.S. House,Tom Guild,DEM,550079,0,0,67,67,05
Oklahoma,U.S. House,Al Mcaffrey,DEM,550079,0,0,30,30,05
Oklahoma,U.S. House,Leona Leonard,DEM,550079,0,0,90,90,05
Oklahoma,State Senate,Christine Byrd,DEM,550079,0,0,38,38,48
Oklahoma,State Senate,Anastasia Pittman,DEM,550079,0,0,153,153,48
Oklahoma,State House,Mike Shelton,DEM,550079,0,0,155,155,97
Oklahoma,State House,Bruce Fisher,DEM,550079,0,0,36,36,97
Oklahoma,Governor,Dax Ewbank,REP,550079,0,0,9,9,
Oklahoma,Governor,Chad Moody,REP,550079,0,0,8,8,
Oklahoma,Governor,Mary Fallin,REP,550079,0,0,39,39,
Oklahoma,Superintendent of Public Instruction,Brian Kelly,REP,550079,0,0,13,13,
Oklahoma,Superintendent of Public Instruction,Janet Costello Barresi,REP,550079,0,0,12,12,
Oklahoma,Superintendent of Public Instruction,Joy Hofmeister,REP,550079,0,0,29,29,
Oklahoma,Insurance Commissioner,Bill Viner,REP,550079,0,0,11,11,
Oklahoma,Insurance Commissioner,John Doak,REP,550079,0,0,41,41,
Oklahoma,Corporation Commissioner,Todd Hiett,REP,550079,0,0,28,28,
Oklahoma,Corporation Commissioner,Cliff Branan,REP,550079,0,0,24,24,
Oklahoma,U.S. Senate,Evelyn Rogers,REP,550079,0,0,1,1,
Oklahoma,U.S. Senate,Rob Moye,REP,550079,0,0,1,1,
Oklahoma,U.S. Senate,D. Jean Mcbride-Samuels,REP,550079,0,0,0,0,
Oklahoma,U.S. Senate,Jim Inhofe,REP,550079,0,0,49,49,
Oklahoma,U.S. Senate,Erick Paul Wyatt,REP,550079,0,0,2,2,
Oklahoma,U.S. Senate,Andy Craig,REP,550079,0,0,1,1,
Oklahoma,U.S. Senate,T. Shannon,REP,550079,0,0,14,14,
Oklahoma,U.S. Senate,Randy Brogdon,REP,550079,0,0,4,4,
Oklahoma,U.S. Senate,Eric Mccray,REP,550079,0,0,0,0,
Oklahoma,U.S. Senate,Kevin Crow,REP,550079,0,0,0,0,
Oklahoma,U.S. Senate,James Lankford,REP,550079,0,0,37,37,
Oklahoma,U.S. Senate,Jason Weger,REP,550079,0,0,0,0,
Oklahoma,U.S. House,Shane David Jett,REP,550079,0,0,10,10,05
Oklahoma,U.S. House,Patrice Douglas,REP,550079,0,0,10,10,05
Oklahoma,U.S. House,Mike Turner,REP,550079,0,0,10,10,05
Oklahoma,U.S. House,Steve Russell,REP,550079,0,0,16,16,05
Oklahoma,U.S. House,Harvey Sparks,REP,550079,0,0,3,3,05
Oklahoma,U.S. House,Clark Jolley,REP,550079,0,0,4,4,05
Oklahoma,Superintendent of Public Instruction,John Cox,DEM,550080,0,0,55,55,
Oklahoma,Superintendent of Public Instruction,Jack Jr.,DEM,550080,0,0,23,23,
Oklahoma,Superintendent of Public Instruction,Ivan Holmes,DEM,550080,0,0,17,17,
Oklahoma,Superintendent of Public Instruction,Freda Deskin,DEM,550080,0,0,70,70,
Oklahoma,U.S. Senate,Patrick Michael Hayes,DEM,550080,0,0,28,28,
Oklahoma,U.S. Senate,Jim Rogers,DEM,550080,0,0,42,42,
Oklahoma,U.S. Senate,Connie Johnson,DEM,550080,0,0,95,95,
Oklahoma,U.S. House,Bert Smith,DEM,550080,0,0,115,115,04
Oklahoma,U.S. House,Tae Si,DEM,550080,0,0,43,43,04
Oklahoma,Governor,Dax Ewbank,REP,550080,0,0,27,27,
Oklahoma,Governor,Chad Moody,REP,550080,0,0,51,51,
Oklahoma,Governor,Mary Fallin,REP,550080,0,0,270,270,
Oklahoma,Superintendent of Public Instruction,Brian Kelly,REP,550080,0,0,97,97,
Oklahoma,Superintendent of Public Instruction,Janet Costello Barresi,REP,550080,0,0,73,73,
Oklahoma,Superintendent of Public Instruction,Joy Hofmeister,REP,550080,0,0,180,180,
Oklahoma,Insurance Commissioner,Bill Viner,REP,550080,0,0,84,84,
Oklahoma,Insurance Commissioner,John Doak,REP,550080,0,0,243,243,
Oklahoma,Corporation Commissioner,Todd Hiett,REP,550080,0,0,145,145,
Oklahoma,Corporation Commissioner,Cliff Branan,REP,550080,0,0,177,177,
Oklahoma,U.S. Senate,Evelyn Rogers,REP,550080,0,0,23,23,
Oklahoma,U.S. Senate,Rob Moye,REP,550080,0,0,17,17,
Oklahoma,U.S. Senate,D. Jean Mcbride-Samuels,REP,550080,0,0,1,1,
Oklahoma,U.S. Senate,Jim Inhofe,REP,550080,0,0,298,298,
Oklahoma,U.S. Senate,Erick Paul Wyatt,REP,550080,0,0,10,10,
Oklahoma,U.S. Senate,Andy Craig,REP,550080,0,0,3,3,
Oklahoma,U.S. Senate,T. Shannon,REP,550080,0,0,84,84,
Oklahoma,U.S. Senate,Randy Brogdon,REP,550080,0,0,8,8,
Oklahoma,U.S. Senate,Eric Mccray,REP,550080,0,0,3,3,
Oklahoma,U.S. Senate,Kevin Crow,REP,550080,0,0,3,3,
Oklahoma,U.S. Senate,James Lankford,REP,550080,0,0,250,250,
Oklahoma,U.S. Senate,Jason Weger,REP,550080,0,0,2,2,
Oklahoma,U.S. House,Anna Flatt,REP,550080,0,0,46,46,04
Oklahoma,U.S. House,Tom Cole,REP,550080,0,0,301,301,04
Oklahoma,State Senate,Greg Childers,REP,550080,0,0,157,157,42
Oklahoma,State Senate,Jack Fry,REP,550080,0,0,184,184,42
Oklahoma,State House,Charlie Joyner,REP,550080,0,0,191,191,95
Oklahoma,State House,Max Wolfley,REP,550080,0,0,91,91,95
Oklahoma,State House,Brent Rinehart,REP,550080,0,0,64,64,95
Oklahoma,Superintendent of Public Instruction,John Cox,DEM,550081,0,0,23,23,
Oklahoma,Superintendent of Public Instruction,Jack Jr.,DEM,550081,0,0,13,13,
Oklahoma,Superintendent of Public Instruction,Ivan Holmes,DEM,550081,0,0,7,7,
Oklahoma,Superintendent of Public Instruction,Freda Deskin,DEM,550081,0,0,45,45,
Oklahoma,U.S. Senate,Patrick Michael Hayes,DEM,550081,0,0,17,17,
Oklahoma,U.S. Senate,Jim Rogers,DEM,550081,0,0,34,34,
Oklahoma,U.S. Senate,Connie Johnson,DEM,550081,0,0,37,37,
Oklahoma,U.S. House,Bert Smith,DEM,550081,0,0,62,62,04
Oklahoma,U.S. House,Tae Si,DEM,550081,0,0,24,24,04
Oklahoma,Governor,Dax Ewbank,REP,550081,0,0,13,13,
Oklahoma,Governor,Chad Moody,REP,550081,0,0,31,31,
Oklahoma,Governor,Mary Fallin,REP,550081,0,0,113,113,
Oklahoma,Superintendent of Public Instruction,Brian Kelly,REP,550081,0,0,37,37,
Oklahoma,Superintendent of Public Instruction,Janet Costello Barresi,REP,550081,0,0,48,48,
Oklahoma,Superintendent of Public Instruction,Joy Hofmeister,REP,550081,0,0,69,69,
Oklahoma,Insurance Commissioner,Bill Viner,REP,550081,0,0,41,41,
Oklahoma,Insurance Commissioner,John Doak,REP,550081,0,0,108,108,
Oklahoma,Corporation Commissioner,Todd Hiett,REP,550081,0,0,74,74,
Oklahoma,Corporation Commissioner,Cliff Branan,REP,550081,0,0,78,78,
Oklahoma,U.S. Senate,Evelyn Rogers,REP,550081,0,0,5,5,
Oklahoma,U.S. Senate,Rob Moye,REP,550081,0,0,6,6,
Oklahoma,U.S. Senate,D. Jean Mcbride-Samuels,REP,550081,0,0,0,0,
Oklahoma,U.S. Senate,Jim Inhofe,REP,550081,0,0,140,140,
Oklahoma,U.S. Senate,Erick Paul Wyatt,REP,550081,0,0,8,8,
Oklahoma,U.S. Senate,Andy Craig,REP,550081,0,0,1,1,
Oklahoma,U.S. Senate,T. Shannon,REP,550081,0,0,58,58,
Oklahoma,U.S. Senate,Randy Brogdon,REP,550081,0,0,7,7,
Oklahoma,U.S. Senate,Eric Mccray,REP,550081,0,0,2,2,
Oklahoma,U.S. Senate,Kevin Crow,REP,550081,0,0,2,2,
Oklahoma,U.S. Senate,James Lankford,REP,550081,0,0,90,90,
Oklahoma,U.S. Senate,Jason Weger,REP,550081,0,0,0,0,
Oklahoma,U.S. House,Anna Flatt,REP,550081,0,0,22,22,04
Oklahoma,U.S. House,Tom Cole,REP,550081,0,0,139,139,04
Oklahoma,State Senate,Greg Childers,REP,550081,0,0,65,65,42
Oklahoma,State Senate,Jack Fry,REP,550081,0,0,87,87,42
Oklahoma,State House,Charlie Joyner,REP,550081,0,0,84,84,95
Oklahoma,State House,Max Wolfley,REP,550081,0,0,36,36,95
Oklahoma,State House,Brent Rinehart,REP,550081,0,0,36,36,95
Oklahoma,Superintendent of Public Instruction,John Cox,DEM,550082,0,0,10,10,
Oklahoma,Superintendent of Public Instruction,Jack Jr.,DEM,550082,0,0,9,9,
Oklahoma,Superintendent of Public Instruction,Ivan Holmes,DEM,550082,0,0,4,4,
Oklahoma,Superintendent of Public Instruction,Freda Deskin,DEM,550082,0,0,29,29,
Oklahoma,U.S. Senate,Patrick Michael Hayes,DEM,550082,0,0,8,8,
Oklahoma,U.S. Senate,Jim Rogers,DEM,550082,0,0,18,18,
Oklahoma,U.S. Senate,Connie Johnson,DEM,550082,0,0,26,26,
Oklahoma,U.S. House,Bert Smith,DEM,550082,0,0,39,39,04
Oklahoma,U.S. House,Tae Si,DEM,550082,0,0,13,13,04
Oklahoma,Governor,Dax Ewbank,REP,550082,0,0,6,6,
Oklahoma,Governor,Chad Moody,REP,550082,0,0,11,11,
Oklahoma,Governor,Mary Fallin,REP,550082,0,0,44,44,
Oklahoma,Superintendent of Public Instruction,Brian Kelly,REP,550082,0,0,20,20,
Oklahoma,Superintendent of Public Instruction,Janet Costello Barresi,REP,550082,0,0,16,16,
Oklahoma,Superintendent of Public Instruction,Joy Hofmeister,REP,550082,0,0,21,21,
Oklahoma,Insurance Commissioner,Bill Viner,REP,550082,0,0,12,12,
Oklahoma,Insurance Commissioner,John Doak,REP,550082,0,0,41,41,
Oklahoma,Corporation Commissioner,Todd Hiett,REP,550082,0,0,22,22,
Oklahoma,Corporation Commissioner,Cliff Branan,REP,550082,0,0,30,30,
Oklahoma,U.S. Senate,Evelyn Rogers,REP,550082,0,0,4,4,
Oklahoma,U.S. Senate,Rob Moye,REP,550082,0,0,1,1,
Oklahoma,U.S. Senate,D. Jean Mcbride-Samuels,REP,550082,0,0,0,0,
Oklahoma,U.S. Senate,Jim Inhofe,REP,550082,0,0,51,51,
Oklahoma,U.S. Senate,Erick Paul Wyatt,REP,550082,0,0,2,2,
Oklahoma,U.S. Senate,Andy Craig,REP,550082,0,0,0,0,
Oklahoma,U.S. Senate,T. Shannon,REP,550082,0,0,16,16,
Oklahoma,U.S. Senate,Randy Brogdon,REP,550082,0,0,1,1,
Oklahoma,U.S. Senate,Eric Mccray,REP,550082,0,0,0,0,
Oklahoma,U.S. Senate,Kevin Crow,REP,550082,0,0,1,1,
Oklahoma,U.S. Senate,James Lankford,REP,550082,0,0,43,43,
Oklahoma,U.S. Senate,Jason Weger,REP,550082,0,0,1,1,
Oklahoma,U.S. House,Anna Flatt,REP,550082,0,0,10,10,04
Oklahoma,U.S. House,Tom Cole,REP,550082,0,0,51,51,04
Oklahoma,State Senate,Greg Childers,REP,550082,0,0,27,27,42
Oklahoma,State Senate,Jack Fry,REP,550082,0,0,30,30,42
Oklahoma,State House,Charlie Joyner,REP,550082,0,0,34,34,95
Oklahoma,State House,Max Wolfley,REP,550082,0,0,15,15,95
Oklahoma,State House,Brent Rinehart,REP,550082,0,0,9,9,95
Oklahoma,Superintendent of Public Instruction,John Cox,DEM,550083,0,0,24,24,
Oklahoma,Superintendent of Public Instruction,Jack Jr.,DEM,550083,0,0,15,15,
Oklahoma,Superintendent of Public Instruction,Ivan Holmes,DEM,550083,0,0,9,9,
Oklahoma,Superintendent of Public Instruction,Freda Deskin,DEM,550083,0,0,41,41,
Oklahoma,U.S. Senate,Patrick Michael Hayes,DEM,550083,0,0,13,13,
Oklahoma,U.S. Senate,Jim Rogers,DEM,550083,0,0,18,18,
Oklahoma,U.S. Senate,Connie Johnson,DEM,550083,0,0,57,57,
Oklahoma,U.S. House,Bert Smith,DEM,550083,0,0,55,55,04
Oklahoma,U.S. House,Tae Si,DEM,550083,0,0,33,33,04
Oklahoma,Governor,Dax Ewbank,REP,550083,0,0,15,15,
Oklahoma,Governor,Chad Moody,REP,550083,0,0,38,38,
Oklahoma,Governor,Mary Fallin,REP,550083,0,0,112,112,
Oklahoma,Superintendent of Public Instruction,Brian Kelly,REP,550083,0,0,62,62,
Oklahoma,Superintendent of Public Instruction,Janet Costello Barresi,REP,550083,0,0,39,39,
Oklahoma,Superintendent of Public Instruction,Joy Hofmeister,REP,550083,0,0,62,62,
Oklahoma,Insurance Commissioner,Bill Viner,REP,550083,0,0,44,44,
Oklahoma,Insurance Commissioner,John Doak,REP,550083,0,0,110,110,
Oklahoma,Corporation Commissioner,Todd Hiett,REP,550083,0,0,73,73,
Oklahoma,Corporation Commissioner,Cliff Branan,REP,550083,0,0,78,78,
Oklahoma,U.S. Senate,Evelyn Rogers,REP,550083,0,0,10,10,
Oklahoma,U.S. Senate,Rob Moye,REP,550083,0,0,10,10,
Oklahoma,U.S. Senate,D. Jean Mcbride-Samuels,REP,550083,0,0,3,3,
Oklahoma,U.S. Senate,Jim Inhofe,REP,550083,0,0,131,131,
Oklahoma,U.S. Senate,Erick Paul Wyatt,REP,550083,0,0,9,9,
Oklahoma,U.S. Senate,Andy Craig,REP,550083,0,0,2,2,
Oklahoma,U.S. Senate,T. Shannon,REP,550083,0,0,51,51,
Oklahoma,U.S. Senate,Randy Brogdon,REP,550083,0,0,5,5,
Oklahoma,U.S. Senate,Eric Mccray,REP,550083,0,0,5,5,
Oklahoma,U.S. Senate,Kevin Crow,REP,550083,0,0,2,2,
Oklahoma,U.S. Senate,James Lankford,REP,550083,0,0,100,100,
Oklahoma,U.S. Senate,Jason Weger,REP,550083,0,0,0,0,
Oklahoma,U.S. House,Anna Flatt,REP,550083,0,0,33,33,04
Oklahoma,U.S. House,Tom Cole,REP,550083,0,0,134,134,04
Oklahoma,State Senate,Greg Childers,REP,550083,0,0,66,66,42
Oklahoma,State Senate,Jack Fry,REP,550083,0,0,95,95,42
Oklahoma,State House,Charlie Joyner,REP,550083,0,0,86,86,95
Oklahoma,State House,Max Wolfley,REP,550083,0,0,26,26,95
Oklahoma,State House,Brent Rinehart,REP,550083,0,0,51,51,95
Oklahoma,Superintendent of Public Instruction,John Cox,DEM,550084,0,0,19,19,
Oklahoma,Superintendent of Public Instruction,Jack Jr.,DEM,550084,0,0,17,17,
Oklahoma,Superintendent of Public Instruction,Ivan Holmes,DEM,550084,0,0,7,7,
Oklahoma,Superintendent of Public Instruction,Freda Deskin,DEM,550084,0,0,33,33,
Oklahoma,U.S. Senate,Patrick Michael Hayes,DEM,550084,0,0,4,4,
Oklahoma,U.S. Senate,Jim Rogers,DEM,550084,0,0,22,22,
Oklahoma,U.S. Senate,Connie Johnson,DEM,550084,0,0,47,47,
Oklahoma,U.S. House,Bert Smith,DEM,550084,0,0,44,44,04
Oklahoma,U.S. House,Tae Si,DEM,550084,0,0,26,26,04
Oklahoma,Governor,Dax Ewbank,REP,550084,0,0,13,13,
Oklahoma,Governor,Chad Moody,REP,550084,0,0,24,24,
Oklahoma,Governor,Mary Fallin,REP,550084,0,0,100,100,
Oklahoma,Superintendent of Public Instruction,Brian Kelly,REP,550084,0,0,44,44,
Oklahoma,Superintendent of Public Instruction,Janet Costello Barresi,REP,550084,0,0,31,31,
Oklahoma,Superintendent of Public Instruction,Joy Hofmeister,REP,550084,0,0,64,64,
Oklahoma,Insurance Commissioner,Bill Viner,REP,550084,0,0,30,30,
Oklahoma,Insurance Commissioner,John Doak,REP,550084,0,0,101,101,
Oklahoma,Corporation Commissioner,Todd Hiett,REP,550084,0,0,57,57,
Oklahoma,Corporation Commissioner,Cliff Branan,REP,550084,0,0,72,72,
Oklahoma,U.S. Senate,Evelyn Rogers,REP,550084,0,0,7,7,
Oklahoma,U.S. Senate,Rob Moye,REP,550084,0,0,4,4,
Oklahoma,U.S. Senate,D. Jean Mcbride-Samuels,REP,550084,0,0,1,1,
Oklahoma,U.S. Senate,Jim Inhofe,REP,550084,0,0,120,120,
Oklahoma,U.S. Senate,Erick Paul Wyatt,REP,550084,0,0,3,3,
Oklahoma,U.S. Senate,Andy Craig,REP,550084,0,0,2,2,
Oklahoma,U.S. Senate,T. Shannon,REP,550084,0,0,45,45,
Oklahoma,U.S. Senate,Randy Brogdon,REP,550084,0,0,1,1,
Oklahoma,U.S. Senate,Eric Mccray,REP,550084,0,0,1,1,
Oklahoma,U.S. Senate,Kevin Crow,REP,550084,0,0,2,2,
Oklahoma,U.S. Senate,James Lankford,REP,550084,0,0,86,86,
Oklahoma,U.S. Senate,Jason Weger,REP,550084,0,0,2,2,
Oklahoma,U.S. House,Anna Flatt,REP,550084,0,0,28,28,04
Oklahoma,U.S. House,Tom Cole,REP,550084,0,0,108,108,04
Oklahoma,State Senate,Greg Childers,REP,550084,0,0,49,49,42
Oklahoma,State Senate,Jack Fry,REP,550084,0,0,84,84,42
Oklahoma,State House,Charlie Joyner,REP,550084,0,0,72,72,95
Oklahoma,State House,Max Wolfley,REP,550084,0,0,24,24,95
Oklahoma,State House,Brent Rinehart,REP,550084,0,0,39,39,95
Oklahoma,Superintendent of Public Instruction,John Cox,DEM,550085,0,0,46,46,
Oklahoma,Superintendent of Public Instruction,Jack Jr.,DEM,550085,0,0,12,12,
Oklahoma,Superintendent of Public Instruction,Ivan Holmes,DEM,550085,0,0,6,6,
Oklahoma,Superintendent of Public Instruction,Freda Deskin,DEM,550085,0,0,48,48,
Oklahoma,U.S. Senate,Patrick Michael Hayes,DEM,550085,0,0,25,25,
Oklahoma,U.S. Senate,Jim Rogers,DEM,550085,0,0,23,23,
Oklahoma,U.S. Senate,Connie Johnson,DEM,550085,0,0,61,61,
Oklahoma,U.S. House,Bert Smith,DEM,550085,0,0,71,71,04
Oklahoma,U.S. House,Tae Si,DEM,550085,0,0,33,33,04
Oklahoma,Governor,Dax Ewbank,REP,550085,0,0,8,8,
Oklahoma,Governor,Chad Moody,REP,550085,0,0,53,53,
Oklahoma,Governor,Mary Fallin,REP,550085,0,0,145,145,
Oklahoma,Superintendent of Public Instruction,Brian Kelly,REP,550085,0,0,54,54,
Oklahoma,Superintendent of Public Instruction,Janet Costello Barresi,REP,550085,0,0,37,37,
Oklahoma,Superintendent of Public Instruction,Joy Hofmeister,REP,550085,0,0,106,106,
Oklahoma,Insurance Commissioner,Bill Viner,REP,550085,0,0,55,55,
Oklahoma,Insurance Commissioner,John Doak,REP,550085,0,0,129,129,
Oklahoma,Corporation Commissioner,Todd Hiett,REP,550085,0,0,76,76,
Oklahoma,Corporation Commissioner,Cliff Branan,REP,550085,0,0,101,101,
Oklahoma,U.S. Senate,Evelyn Rogers,REP,550085,0,0,14,14,
Oklahoma,U.S. Senate,Rob Moye,REP,550085,0,0,5,5,
Oklahoma,U.S. Senate,D. Jean Mcbride-Samuels,REP,550085,0,0,3,3,
Oklahoma,U.S. Senate,Jim Inhofe,REP,550085,0,0,171,171,
Oklahoma,U.S. Senate,Erick Paul Wyatt,REP,550085,0,0,13,13,
Oklahoma,U.S. Senate,Andy Craig,REP,550085,0,0,1,1,
Oklahoma,U.S. Senate,T. Shannon,REP,550085,0,0,80,80,
Oklahoma,U.S. Senate,Randy Brogdon,REP,550085,0,0,3,3,
Oklahoma,U.S. Senate,Eric Mccray,REP,550085,0,0,1,1,
Oklahoma,U.S. Senate,Kevin Crow,REP,550085,0,0,5,5,
Oklahoma,U.S. Senate,James Lankford,REP,550085,0,0,117,117,
Oklahoma,U.S. Senate,Jason Weger,REP,550085,0,0,0,0,
Oklahoma,U.S. House,Anna Flatt,REP,550085,0,0,26,26,04
Oklahoma,U.S. House,Tom Cole,REP,550085,0,0,180,180,04
Oklahoma,State Senate,Greg Childers,REP,550085,0,0,71,71,42
Oklahoma,State Senate,Jack Fry,REP,550085,0,0,126,126,42
Oklahoma,State House,Charlie Joyner,REP,550085,0,0,115,115,95
Oklahoma,State House,Max Wolfley,REP,550085,0,0,38,38,95
Oklahoma,State House,Brent Rinehart,REP,550085,0,0,50,50,95
Oklahoma,Superintendent of Public Instruction,John Cox,DEM,550086,0,0,47,47,
Oklahoma,Superintendent of Public Instruction,Jack Jr.,DEM,550086,0,0,23,23,
Oklahoma,Superintendent of Public Instruction,Ivan Holmes,DEM,550086,0,0,20,20,
Oklahoma,Superintendent of Public Instruction,Freda Deskin,DEM,550086,0,0,69,69,
Oklahoma,U.S. Senate,Patrick Michael Hayes,DEM,550086,0,0,25,25,
Oklahoma,U.S. Senate,Jim Rogers,DEM,550086,0,0,41,41,
Oklahoma,U.S. Senate,Connie Johnson,DEM,550086,0,0,89,89,
Oklahoma,U.S. House,Bert Smith,DEM,550086,0,0,112,112,04
Oklahoma,U.S. House,Tae Si,DEM,550086,0,0,41,41,04
Oklahoma,Governor,Dax Ewbank,REP,550086,0,0,29,29,
Oklahoma,Governor,Chad Moody,REP,550086,0,0,51,51,
Oklahoma,Governor,Mary Fallin,REP,550086,0,0,245,245,
Oklahoma,Superintendent of Public Instruction,Brian Kelly,REP,550086,0,0,66,66,
Oklahoma,Superintendent of Public Instruction,Janet Costello Barresi,REP,550086,0,0,111,111,
Oklahoma,Superintendent of Public Instruction,Joy Hofmeister,REP,550086,0,0,145,145,
Oklahoma,Insurance Commissioner,Bill Viner,REP,550086,0,0,62,62,
Oklahoma,Insurance Commissioner,John Doak,REP,550086,0,0,239,239,
Oklahoma,Corporation Commissioner,Todd Hiett,REP,550086,0,0,130,130,
Oklahoma,Corporation Commissioner,Cliff Branan,REP,550086,0,0,168,168,
Oklahoma,U.S. Senate,Evelyn Rogers,REP,550086,0,0,17,17,
Oklahoma,U.S. Senate,Rob Moye,REP,550086,0,0,5,5,
Oklahoma,U.S. Senate,D. Jean Mcbride-Samuels,REP,550086,0,0,3,3,
Oklahoma,U.S. Senate,Jim Inhofe,REP,550086,0,0,294,294,
Oklahoma,U.S. Senate,Erick Paul Wyatt,REP,550086,0,0,5,5,
Oklahoma,U.S. Senate,Andy Craig,REP,550086,0,0,0,0,
Oklahoma,U.S. Senate,T. Shannon,REP,550086,0,0,84,84,
Oklahoma,U.S. Senate,Randy Brogdon,REP,550086,0,0,8,8,
Oklahoma,U.S. Senate,Eric Mccray,REP,550086,0,0,2,2,
Oklahoma,U.S. Senate,Kevin Crow,REP,550086,0,0,4,4,
Oklahoma,U.S. Senate,James Lankford,REP,550086,0,0,229,229,
Oklahoma,U.S. Senate,Jason Weger,REP,550086,0,0,0,0,
Oklahoma,U.S. House,Anna Flatt,REP,550086,0,0,41,41,04
Oklahoma,U.S. House,Tom Cole,REP,550086,0,0,283,283,04
Oklahoma,State Senate,Greg Childers,REP,550086,0,0,126,126,42
Oklahoma,State Senate,Jack Fry,REP,550086,0,0,186,186,42
Oklahoma,State House,Charlie Joyner,REP,550086,0,0,218,218,95
Oklahoma,State House,Max Wolfley,REP,550086,0,0,46,46,95
Oklahoma,State House,Brent Rinehart,REP,550086,0,0,61,61,95
Oklahoma,Superintendent of Public Instruction,John Cox,DEM,550087,0,0,21,21,
Oklahoma,Superintendent of Public Instruction,Jack Jr.,DEM,550087,0,0,13,13,
Oklahoma,Superintendent of Public Instruction,Ivan Holmes,DEM,550087,0,0,7,7,
Oklahoma,Superintendent of Public Instruction,Freda Deskin,DEM,550087,0,0,24,24,
Oklahoma,U.S. Senate,Patrick Michael Hayes,DEM,550087,0,0,11,11,
Oklahoma,U.S. Senate,Jim Rogers,DEM,550087,0,0,8,8,
Oklahoma,U.S. Senate,Connie Johnson,DEM,550087,0,0,46,46,
Oklahoma,U.S. House,Bert Smith,DEM,550087,0,0,39,39,04
Oklahoma,U.S. House,Tae Si,DEM,550087,0,0,21,21,04
Oklahoma,Governor,Dax Ewbank,REP,550087,0,0,7,7,
Oklahoma,Governor,Chad Moody,REP,550087,0,0,16,16,
Oklahoma,Governor,Mary Fallin,REP,550087,0,0,38,38,
Oklahoma,Superintendent of Public Instruction,Brian Kelly,REP,550087,0,0,16,16,
Oklahoma,Superintendent of Public Instruction,Janet Costello Barresi,REP,550087,0,0,16,16,
Oklahoma,Superintendent of Public Instruction,Joy Hofmeister,REP,550087,0,0,29,29,
Oklahoma,Insurance Commissioner,Bill Viner,REP,550087,0,0,11,11,
Oklahoma,Insurance Commissioner,John Doak,REP,550087,0,0,46,46,
Oklahoma,Corporation Commissioner,Todd Hiett,REP,550087,0,0,24,24,
Oklahoma,Corporation Commissioner,Cliff Branan,REP,550087,0,0,34,34,
Oklahoma,U.S. Senate,Evelyn Rogers,REP,550087,0,0,3,3,
Oklahoma,U.S. Senate,Rob Moye,REP,550087,0,0,3,3,
Oklahoma,U.S. Senate,D. Jean Mcbride-Samuels,REP,550087,0,0,1,1,
Oklahoma,U.S. Senate,Jim Inhofe,REP,550087,0,0,51,51,
Oklahoma,U.S. Senate,Erick Paul Wyatt,REP,550087,0,0,3,3,
Oklahoma,U.S. Senate,Andy Craig,REP,550087,0,0,0,0,
Oklahoma,U.S. Senate,T. Shannon,REP,550087,0,0,12,12,
Oklahoma,U.S. Senate,Randy Brogdon,REP,550087,0,0,6,6,
Oklahoma,U.S. Senate,Eric Mccray,REP,550087,0,0,0,0,
Oklahoma,U.S. Senate,Kevin Crow,REP,550087,0,0,3,3,
Oklahoma,U.S. Senate,James Lankford,REP,550087,0,0,40,40,
Oklahoma,U.S. Senate,Jason Weger,REP,550087,0,0,0,0,
Oklahoma,U.S. House,Anna Flatt,REP,550087,0,0,14,14,04
Oklahoma,U.S. House,Tom Cole,REP,550087,0,0,47,47,04
Oklahoma,State Senate,Greg Childers,REP,550087,0,0,25,25,42
Oklahoma,State Senate,Jack Fry,REP,550087,0,0,35,35,42
Oklahoma,State House,Charlie Joyner,REP,550087,0,0,31,31,95
Oklahoma,State House,Max Wolfley,REP,550087,0,0,10,10,95
Oklahoma,State House,Brent Rinehart,REP,550087,0,0,19,19,95
Oklahoma,Superintendent of Public Instruction,John Cox,DEM,550088,0,0,8,8,
Oklahoma,Superintendent of Public Instruction,Jack Jr.,DEM,550088,0,0,4,4,
Oklahoma,Superintendent of Public Instruction,Ivan Holmes,DEM,550088,0,0,7,7,
Oklahoma,Superintendent of Public Instruction,Freda Deskin,DEM,550088,0,0,19,19,
Oklahoma,U.S. Senate,Patrick Michael Hayes,DEM,550088,0,0,3,3,
Oklahoma,U.S. Senate,Jim Rogers,DEM,550088,0,0,5,5,
Oklahoma,U.S. Senate,Connie Johnson,DEM,550088,0,0,32,32,
Oklahoma,U.S. House,Bert Smith,DEM,550088,0,0,22,22,04
Oklahoma,U.S. House,Tae Si,DEM,550088,0,0,14,14,04
Oklahoma,Governor,Dax Ewbank,REP,550088,0,0,5,5,
Oklahoma,Governor,Chad Moody,REP,550088,0,0,4,4,
Oklahoma,Governor,Mary Fallin,REP,550088,0,0,26,26,
Oklahoma,Superintendent of Public Instruction,Brian Kelly,REP,550088,0,0,5,5,
Oklahoma,Superintendent of Public Instruction,Janet Costello Barresi,REP,550088,0,0,8,8,
Oklahoma,Superintendent of Public Instruction,Joy Hofmeister,REP,550088,0,0,21,21,
Oklahoma,Insurance Commissioner,Bill Viner,REP,550088,0,0,8,8,
Oklahoma,Insurance Commissioner,John Doak,REP,550088,0,0,24,24,
Oklahoma,Corporation Commissioner,Todd Hiett,REP,550088,0,0,18,18,
Oklahoma,Corporation Commissioner,Cliff Branan,REP,550088,0,0,13,13,
Oklahoma,U.S. Senate,Evelyn Rogers,REP,550088,0,0,4,4,
Oklahoma,U.S. Senate,Rob Moye,REP,550088,0,0,1,1,
Oklahoma,U.S. Senate,D. Jean Mcbride-Samuels,REP,550088,0,0,1,1,
Oklahoma,U.S. Senate,Jim Inhofe,REP,550088,0,0,26,26,
Oklahoma,U.S. Senate,Erick Paul Wyatt,REP,550088,0,0,3,3,
Oklahoma,U.S. Senate,Andy Craig,REP,550088,0,0,0,0,
Oklahoma,U.S. Senate,T. Shannon,REP,550088,0,0,6,6,
Oklahoma,U.S. Senate,Randy Brogdon,REP,550088,0,0,4,4,
Oklahoma,U.S. Senate,Eric Mccray,REP,550088,0,0,1,1,
Oklahoma,U.S. Senate,Kevin Crow,REP,550088,0,0,1,1,
Oklahoma,U.S. Senate,James Lankford,REP,550088,0,0,23,23,
Oklahoma,U.S. Senate,Jason Weger,REP,550088,0,0,0,0,
Oklahoma,U.S. House,Anna Flatt,REP,550088,0,0,10,10,04
Oklahoma,U.S. House,Tom Cole,REP,550088,0,0,25,25,04
Oklahoma,State Senate,Greg Childers,REP,550088,0,0,14,14,42
Oklahoma,State Senate,Jack Fry,REP,550088,0,0,18,18,42
Oklahoma,State House,A. Bailey,REP,550088,0,0,13,13,10
Oklahoma,State House,Gary Banz,REP,550088,0,0,19,19,10
Oklahoma,Superintendent of Public Instruction,John Cox,DEM,550089,0,0,43,43,
Oklahoma,Superintendent of Public Instruction,Jack Jr.,DEM,550089,0,0,17,17,
Oklahoma,Superintendent of Public Instruction,Ivan Holmes,DEM,550089,0,0,11,11,
Oklahoma,Superintendent of Public Instruction,Freda Deskin,DEM,550089,0,0,55,55,
Oklahoma,U.S. Senate,Patrick Michael Hayes,DEM,550089,0,0,17,17,
Oklahoma,U.S. Senate,Jim Rogers,DEM,550089,0,0,14,14,
Oklahoma,U.S. Senate,Connie Johnson,DEM,550089,0,0,94,94,
Oklahoma,U.S. House,Tom Guild,DEM,550089,0,0,40,40,05
Oklahoma,U.S. House,Al Mcaffrey,DEM,550089,0,0,28,28,05
Oklahoma,U.S. House,Leona Leonard,DEM,550089,0,0,53,53,05
Oklahoma,State Senate,Christine Byrd,DEM,550089,0,0,36,36,48
Oklahoma,State Senate,Anastasia Pittman,DEM,550089,0,0,92,92,48
Oklahoma,State House,Mike Shelton,DEM,550089,0,0,83,83,97
Oklahoma,State House,Bruce Fisher,DEM,550089,0,0,45,45,97
Oklahoma,Governor,Dax Ewbank,REP,550089,0,0,8,8,
Oklahoma,Governor,Chad Moody,REP,550089,0,0,9,9,
Oklahoma,Governor,Mary Fallin,REP,550089,0,0,33,33,
Oklahoma,Superintendent of Public Instruction,Brian Kelly,REP,550089,0,0,22,22,
Oklahoma,Superintendent of Public Instruction,Janet Costello Barresi,REP,550089,0,0,10,10,
Oklahoma,Superintendent of Public Instruction,Joy Hofmeister,REP,550089,0,0,16,16,
Oklahoma,Insurance Commissioner,Bill Viner,REP,550089,0,0,15,15,
Oklahoma,Insurance Commissioner,John Doak,REP,550089,0,0,33,33,
Oklahoma,Corporation Commissioner,Todd Hiett,REP,550089,0,0,26,26,
Oklahoma,Corporation Commissioner,Cliff Branan,REP,550089,0,0,22,22,
Oklahoma,U.S. Senate,Evelyn Rogers,REP,550089,0,0,2,2,
Oklahoma,U.S. Senate,Rob Moye,REP,550089,0,0,1,1,
Oklahoma,U.S. Senate,D. Jean Mcbride-Samuels,REP,550089,0,0,2,2,
Oklahoma,U.S. Senate,Jim Inhofe,REP,550089,0,0,41,41,
Oklahoma,U.S. Senate,Erick Paul Wyatt,REP,550089,0,0,3,3,
Oklahoma,U.S. Senate,Andy Craig,REP,550089,0,0,0,0,
Oklahoma,U.S. Senate,T. Shannon,REP,550089,0,0,15,15,
Oklahoma,U.S. Senate,Randy Brogdon,REP,550089,0,0,4,4,
Oklahoma,U.S. Senate,Eric Mccray,REP,550089,0,0,0,0,
Oklahoma,U.S. Senate,Kevin Crow,REP,550089,0,0,1,1,
Oklahoma,U.S. Senate,James Lankford,REP,550089,0,0,30,30,
Oklahoma,U.S. Senate,Jason Weger,REP,550089,0,0,0,0,
Oklahoma,U.S. House,Shane David Jett,REP,550089,0,0,5,5,05
Oklahoma,U.S. House,Patrice Douglas,REP,550089,0,0,10,10,05
Oklahoma,U.S. House,Mike Turner,REP,550089,0,0,17,17,05
Oklahoma,U.S. House,Steve Russell,REP,550089,0,0,12,12,05
Oklahoma,U.S. House,Harvey Sparks,REP,550089,0,0,0,0,05
Oklahoma,U.S. House,Clark Jolley,REP,550089,0,0,6,6,05
Oklahoma,Superintendent of Public Instruction,John Cox,DEM,550090,0,0,2,2,
Oklahoma,Superintendent of Public Instruction,Jack Jr.,DEM,550090,0,0,2,2,
Oklahoma,Superintendent of Public Instruction,Ivan Holmes,DEM,550090,0,0,3,3,
Oklahoma,Superintendent of Public Instruction,Freda Deskin,DEM,550090,0,0,17,17,
Oklahoma,U.S. Senate,Patrick Michael Hayes,DEM,550090,0,0,4,4,
Oklahoma,U.S. Senate,Jim Rogers,DEM,550090,0,0,1,1,
Oklahoma,U.S. Senate,Connie Johnson,DEM,550090,0,0,19,19,
Oklahoma,U.S. House,Tom Guild,DEM,550090,0,0,8,8,05
Oklahoma,U.S. House,Al Mcaffrey,DEM,550090,0,0,4,4,05
Oklahoma,U.S. House,Leona Leonard,DEM,550090,0,0,12,12,05
Oklahoma,State Senate,Christine Byrd,DEM,550090,0,0,4,4,48
Oklahoma,State Senate,Anastasia Pittman,DEM,550090,0,0,20,20,48
Oklahoma,Governor,Dax Ewbank,REP,550090,0,0,1,1,
Oklahoma,Governor,Chad Moody,REP,550090,0,0,2,2,
Oklahoma,Governor,Mary Fallin,REP,550090,0,0,15,15,
Oklahoma,Superintendent of Public Instruction,Brian Kelly,REP,550090,0,0,5,5,
Oklahoma,Superintendent of Public Instruction,Janet Costello Barresi,REP,550090,0,0,5,5,
Oklahoma,Superintendent of Public Instruction,Joy Hofmeister,REP,550090,0,0,8,8,
Oklahoma,Insurance Commissioner,Bill Viner,REP,550090,0,0,9,9,
Oklahoma,Insurance Commissioner,John Doak,REP,550090,0,0,9,9,
Oklahoma,Corporation Commissioner,Todd Hiett,REP,550090,0,0,6,6,
Oklahoma,Corporation Commissioner,Cliff Branan,REP,550090,0,0,11,11,
Oklahoma,U.S. Senate,Evelyn Rogers,REP,550090,0,0,0,0,
Oklahoma,U.S. Senate,Rob Moye,REP,550090,0,0,1,1,
Oklahoma,U.S. Senate,D. Jean Mcbride-Samuels,REP,550090,0,0,0,0,
Oklahoma,U.S. Senate,Jim Inhofe,REP,550090,0,0,16,16,
Oklahoma,U.S. Senate,Erick Paul Wyatt,REP,550090,0,0,1,1,
Oklahoma,U.S. Senate,Andy Craig,REP,550090,0,0,0,0,
Oklahoma,U.S. Senate,T. Shannon,REP,550090,0,0,4,4,
Oklahoma,U.S. Senate,Randy Brogdon,REP,550090,0,0,0,0,
Oklahoma,U.S. Senate,Eric Mccray,REP,550090,0,0,0,0,
Oklahoma,U.S. Senate,Kevin Crow,REP,550090,0,0,1,1,
Oklahoma,U.S. Senate,James Lankford,REP,550090,0,0,13,13,
Oklahoma,U.S. Senate,Jason Weger,REP,550090,0,0,0,0,
Oklahoma,U.S. House,Shane David Jett,REP,550090,0,0,3,3,05
Oklahoma,U.S. House,Patrice Douglas,REP,550090,0,0,2,2,05
Oklahoma,U.S. House,Mike Turner,REP,550090,0,0,5,5,05
Oklahoma,U.S. House,Steve Russell,REP,550090,0,0,6,6,05
Oklahoma,U.S. House,Harvey Sparks,REP,550090,0,0,1,1,05
Oklahoma,U.S. House,Clark Jolley,REP,550090,0,0,1,1,05
Oklahoma,State House,A. Bailey,REP,550090,0,0,5,5,10
Oklahoma,State House,Gary Banz,REP,550090,0,0,13,13,10
Oklahoma,Superintendent of Public Instruction,John Cox,DEM,550091,0,0,15,15,
Oklahoma,Superintendent of Public Instruction,Jack Jr.,DEM,550091,0,0,1,1,
Oklahoma,Superintendent of Public Instruction,Ivan Holmes,DEM,550091,0,0,1,1,
Oklahoma,Superintendent of Public Instruction,Freda Deskin,DEM,550091,0,0,8,8,
Oklahoma,U.S. Senate,Patrick Michael Hayes,DEM,550091,0,0,2,2,
Oklahoma,U.S. Senate,Jim Rogers,DEM,550091,0,0,5,5,
Oklahoma,U.S. Senate,Connie Johnson,DEM,550091,0,0,18,18,
Oklahoma,U.S. House,Bert Smith,DEM,550091,0,0,16,16,04
Oklahoma,U.S. House,Tae Si,DEM,550091,0,0,8,8,04
Oklahoma,State Senate,Christine Byrd,DEM,550091,0,0,10,10,48
Oklahoma,State Senate,Anastasia Pittman,DEM,550091,0,0,15,15,48
Oklahoma,Governor,Dax Ewbank,REP,550091,0,0,1,1,
Oklahoma,Governor,Chad Moody,REP,550091,0,0,2,2,
Oklahoma,Governor,Mary Fallin,REP,550091,0,0,17,17,
Oklahoma,Superintendent of Public Instruction,Brian Kelly,REP,550091,0,0,4,4,
Oklahoma,Superintendent of Public Instruction,Janet Costello Barresi,REP,550091,0,0,6,6,
Oklahoma,Superintendent of Public Instruction,Joy Hofmeister,REP,550091,0,0,10,10,
Oklahoma,Insurance Commissioner,Bill Viner,REP,550091,0,0,7,7,
Oklahoma,Insurance Commissioner,John Doak,REP,550091,0,0,10,10,
Oklahoma,Corporation Commissioner,Todd Hiett,REP,550091,0,0,11,11,
Oklahoma,Corporation Commissioner,Cliff Branan,REP,550091,0,0,8,8,
Oklahoma,U.S. Senate,Evelyn Rogers,REP,550091,0,0,0,0,
Oklahoma,U.S. Senate,Rob Moye,REP,550091,0,0,2,2,
Oklahoma,U.S. Senate,D. Jean Mcbride-Samuels,REP,550091,0,0,0,0,
Oklahoma,U.S. Senate,Jim Inhofe,REP,550091,0,0,17,17,
Oklahoma,U.S. Senate,Erick Paul Wyatt,REP,550091,0,0,1,1,
Oklahoma,U.S. Senate,Andy Craig,REP,550091,0,0,0,0,
Oklahoma,U.S. Senate,T. Shannon,REP,550091,0,0,5,5,
Oklahoma,U.S. Senate,Randy Brogdon,REP,550091,0,0,1,1,
Oklahoma,U.S. Senate,Eric Mccray,REP,550091,0,0,0,0,
Oklahoma,U.S. Senate,Kevin Crow,REP,550091,0,0,1,1,
Oklahoma,U.S. Senate,James Lankford,REP,550091,0,0,14,14,
Oklahoma,U.S. Senate,Jason Weger,REP,550091,0,0,0,0,
Oklahoma,U.S. House,Anna Flatt,REP,550091,0,0,4,4,04
Oklahoma,U.S. House,Tom Cole,REP,550091,0,0,17,17,04
Oklahoma,State House,A. Bailey,REP,550091,0,0,3,3,10
Oklahoma,State House,Gary Banz,REP,550091,0,0,18,18,10
Oklahoma,Superintendent of Public Instruction,John Cox,DEM,550092,0,0,54,54,
Oklahoma,Superintendent of Public Instruction,Jack Jr.,DEM,550092,0,0,23,23,
Oklahoma,Superintendent of Public Instruction,Ivan Holmes,DEM,550092,0,0,15,15,
Oklahoma,Superintendent of Public Instruction,Freda Deskin,DEM,550092,0,0,98,98,
Oklahoma,U.S. Senate,Patrick Michael Hayes,DEM,550092,0,0,19,19,
Oklahoma,U.S. Senate,Jim Rogers,DEM,550092,0,0,35,35,
Oklahoma,U.S. Senate,Connie Johnson,DEM,550092,0,0,133,133,
Oklahoma,U.S. House,Bert Smith,DEM,550092,0,0,125,125,04
Oklahoma,U.S. House,Tae Si,DEM,550092,0,0,54,54,04
Oklahoma,Governor,Dax Ewbank,REP,550092,0,0,24,24,
Oklahoma,Governor,Chad Moody,REP,550092,0,0,43,43,
Oklahoma,Governor,Mary Fallin,REP,550092,0,0,173,173,
Oklahoma,Superintendent of Public Instruction,Brian Kelly,REP,550092,0,0,68,68,
Oklahoma,Superintendent of Public Instruction,Janet Costello Barresi,REP,550092,0,0,51,51,
Oklahoma,Superintendent of Public Instruction,Joy Hofmeister,REP,550092,0,0,114,114,
Oklahoma,Insurance Commissioner,Bill Viner,REP,550092,0,0,54,54,
Oklahoma,Insurance Commissioner,John Doak,REP,550092,0,0,167,167,
Oklahoma,Corporation Commissioner,Todd Hiett,REP,550092,0,0,94,94,
Oklahoma,Corporation Commissioner,Cliff Branan,REP,550092,0,0,128,128,
Oklahoma,U.S. Senate,Evelyn Rogers,REP,550092,0,0,14,14,
Oklahoma,U.S. Senate,Rob Moye,REP,550092,0,0,6,6,
Oklahoma,U.S. Senate,D. Jean Mcbride-Samuels,REP,550092,0,0,4,4,
Oklahoma,U.S. Senate,Jim Inhofe,REP,550092,0,0,206,206,
Oklahoma,U.S. Senate,Erick Paul Wyatt,REP,550092,0,0,7,7,
Oklahoma,U.S. Senate,Andy Craig,REP,550092,0,0,2,2,
Oklahoma,U.S. Senate,T. Shannon,REP,550092,0,0,56,56,
Oklahoma,U.S. Senate,Randy Brogdon,REP,550092,0,0,5,5,
Oklahoma,U.S. Senate,Eric Mccray,REP,550092,0,0,4,4,
Oklahoma,U.S. Senate,Kevin Crow,REP,550092,0,0,1,1,
Oklahoma,U.S. Senate,James Lankford,REP,550092,0,0,171,171,
Oklahoma,U.S. Senate,Jason Weger,REP,550092,0,0,0,0,
Oklahoma,U.S. House,Anna Flatt,REP,550092,0,0,39,39,04
Oklahoma,U.S. House,Tom Cole,REP,550092,0,0,199,199,04
Oklahoma,State Senate,Greg Childers,REP,550092,0,0,85,85,42
Oklahoma,State Senate,Jack Fry,REP,550092,0,0,148,148,42
Oklahoma,State House,A. Bailey,REP,550092,0,0,41,41,10
Oklahoma,State House,Gary Banz,REP,550092,0,0,188,188,10
Oklahoma,Superintendent of Public Instruction,John Cox,DEM,550093,0,0,20,20,
Oklahoma,Superintendent of Public Instruction,Jack Jr.,DEM,550093,0,0,4,4,
Oklahoma,Superintendent of Public Instruction,Ivan Holmes,DEM,550093,0,0,5,5,
Oklahoma,Superintendent of Public Instruction,Freda Deskin,DEM,550093,0,0,23,23,
Oklahoma,U.S. Senate,Patrick Michael Hayes,DEM,550093,0,0,9,9,
Oklahoma,U.S. Senate,Jim Rogers,DEM,550093,0,0,9,9,
Oklahoma,U.S. Senate,Connie Johnson,DEM,550093,0,0,34,34,
Oklahoma,U.S. House,Bert Smith,DEM,550093,0,0,31,31,04
Oklahoma,U.S. House,Tae Si,DEM,550093,0,0,14,14,04
Oklahoma,Governor,Dax Ewbank,REP,550093,0,0,20,20,
Oklahoma,Governor,Chad Moody,REP,550093,0,0,34,34,
Oklahoma,Governor,Mary Fallin,REP,550093,0,0,161,161,
Oklahoma,Superintendent of Public Instruction,Brian Kelly,REP,550093,0,0,49,49,
Oklahoma,Superintendent of Public Instruction,Janet Costello Barresi,REP,550093,0,0,52,52,
Oklahoma,Superintendent of Public Instruction,Joy Hofmeister,REP,550093,0,0,116,116,
Oklahoma,Insurance Commissioner,Bill Viner,REP,550093,0,0,42,42,
Oklahoma,Insurance Commissioner,John Doak,REP,550093,0,0,155,155,
Oklahoma,Corporation Commissioner,Todd Hiett,REP,550093,0,0,91,91,
Oklahoma,Corporation Commissioner,Cliff Branan,REP,550093,0,0,105,105,
Oklahoma,U.S. Senate,Evelyn Rogers,REP,550093,0,0,7,7,
Oklahoma,U.S. Senate,Rob Moye,REP,550093,0,0,0,0,
Oklahoma,U.S. Senate,D. Jean Mcbride-Samuels,REP,550093,0,0,4,4,
Oklahoma,U.S. Senate,Jim Inhofe,REP,550093,0,0,203,203,
Oklahoma,U.S. Senate,Erick Paul Wyatt,REP,550093,0,0,3,3,
Oklahoma,U.S. Senate,Andy Craig,REP,550093,0,0,0,0,
Oklahoma,U.S. Senate,T. Shannon,REP,550093,0,0,40,40,
Oklahoma,U.S. Senate,Randy Brogdon,REP,550093,0,0,2,2,
Oklahoma,U.S. Senate,Eric Mccray,REP,550093,0,0,2,2,
Oklahoma,U.S. Senate,Kevin Crow,REP,550093,0,0,0,0,
Oklahoma,U.S. Senate,James Lankford,REP,550093,0,0,174,174,
Oklahoma,U.S. Senate,Jason Weger,REP,550093,0,0,0,0,
Oklahoma,U.S. House,Anna Flatt,REP,550093,0,0,20,20,04
Oklahoma,U.S. House,Tom Cole,REP,550093,0,0,195,195,04
Oklahoma,State House,A. Bailey,REP,550093,0,0,26,26,10
Oklahoma,State House,Gary Banz,REP,550093,0,0,185,185,10
Oklahoma,Superintendent of Public Instruction,John Cox,DEM,550094,0,0,21,21,
Oklahoma,Superintendent of Public Instruction,Jack Jr.,DEM,550094,0,0,12,12,
Oklahoma,Superintendent of Public Instruction,Ivan Holmes,DEM,550094,0,0,5,5,
Oklahoma,Superintendent of Public Instruction,Freda Deskin,DEM,550094,0,0,37,37,
Oklahoma,U.S. Senate,Patrick Michael Hayes,DEM,550094,0,0,8,8,
Oklahoma,U.S. Senate,Jim Rogers,DEM,550094,0,0,14,14,
Oklahoma,U.S. Senate,Connie Johnson,DEM,550094,0,0,52,52,
Oklahoma,U.S. House,Bert Smith,DEM,550094,0,0,55,55,04
Oklahoma,U.S. House,Tae Si,DEM,550094,0,0,17,17,04
Oklahoma,Governor,Dax Ewbank,REP,550094,0,0,24,24,
Oklahoma,Governor,Chad Moody,REP,550094,0,0,41,41,
Oklahoma,Governor,Mary Fallin,REP,550094,0,0,194,194,
Oklahoma,Superintendent of Public Instruction,Brian Kelly,REP,550094,0,0,68,68,
Oklahoma,Superintendent of Public Instruction,Janet Costello Barresi,REP,550094,0,0,64,64,
Oklahoma,Superintendent of Public Instruction,Joy Hofmeister,REP,550094,0,0,125,125,
Oklahoma,Insurance Commissioner,Bill Viner,REP,550094,0,0,70,70,
Oklahoma,Insurance Commissioner,John Doak,REP,550094,0,0,170,170,
Oklahoma,Corporation Commissioner,Todd Hiett,REP,550094,0,0,120,120,
Oklahoma,Corporation Commissioner,Cliff Branan,REP,550094,0,0,117,117,
Oklahoma,U.S. Senate,Evelyn Rogers,REP,550094,0,0,8,8,
Oklahoma,U.S. Senate,Rob Moye,REP,550094,0,0,5,5,
Oklahoma,U.S. Senate,D. Jean Mcbride-Samuels,REP,550094,0,0,2,2,
Oklahoma,U.S. Senate,Jim Inhofe,REP,550094,0,0,227,227,
Oklahoma,U.S. Senate,Erick Paul Wyatt,REP,550094,0,0,14,14,
Oklahoma,U.S. Senate,Andy Craig,REP,550094,0,0,3,3,
Oklahoma,U.S. Senate,T. Shannon,REP,550094,0,0,57,57,
Oklahoma,U.S. Senate,Randy Brogdon,REP,550094,0,0,8,8,
Oklahoma,U.S. Senate,Eric Mccray,REP,550094,0,0,1,1,
Oklahoma,U.S. Senate,Kevin Crow,REP,550094,0,0,3,3,
Oklahoma,U.S. Senate,James Lankford,REP,550094,0,0,187,187,
Oklahoma,U.S. Senate,Jason Weger,REP,550094,0,0,2,2,
Oklahoma,U.S. House,Anna Flatt,REP,550094,0,0,26,26,04
Oklahoma,U.S. House,Tom Cole,REP,550094,0,0,231,231,04
Oklahoma,State Senate,Greg Childers,REP,550094,0,0,90,90,42
Oklahoma,State Senate,Jack Fry,REP,550094,0,0,155,155,42
Oklahoma,State House,A. Bailey,REP,550094,0,0,36,36,10
Oklahoma,State House,Gary Banz,REP,550094,0,0,219,219,10
Oklahoma,Superintendent of Public Instruction,John Cox,DEM,550095,0,0,35,35,
Oklahoma,Superintendent of Public Instruction,Jack Jr.,DEM,550095,0,0,15,15,
Oklahoma,Superintendent of Public Instruction,Ivan Holmes,DEM,550095,0,0,5,5,
Oklahoma,Superintendent of Public Instruction,Freda Deskin,DEM,550095,0,0,53,53,
Oklahoma,U.S. Senate,Patrick Michael Hayes,DEM,550095,0,0,22,22,
Oklahoma,U.S. Senate,Jim Rogers,DEM,550095,0,0,25,25,
Oklahoma,U.S. Senate,Connie Johnson,DEM,550095,0,0,56,56,
Oklahoma,U.S. House,Bert Smith,DEM,550095,0,0,77,77,04
Oklahoma,U.S. House,Tae Si,DEM,550095,0,0,25,25,04
Oklahoma,Governor,Dax Ewbank,REP,550095,0,0,13,13,
Oklahoma,Governor,Chad Moody,REP,550095,0,0,34,34,
Oklahoma,Governor,Mary Fallin,REP,550095,0,0,162,162,
Oklahoma,Superintendent of Public Instruction,Brian Kelly,REP,550095,0,0,34,34,
Oklahoma,Superintendent of Public Instruction,Janet Costello Barresi,REP,550095,0,0,49,49,
Oklahoma,Superintendent of Public Instruction,Joy Hofmeister,REP,550095,0,0,123,123,
Oklahoma,Insurance Commissioner,Bill Viner,REP,550095,0,0,26,26,
Oklahoma,Insurance Commissioner,John Doak,REP,550095,0,0,162,162,
Oklahoma,Corporation Commissioner,Todd Hiett,REP,550095,0,0,83,83,
Oklahoma,Corporation Commissioner,Cliff Branan,REP,550095,0,0,99,99,
Oklahoma,U.S. Senate,Evelyn Rogers,REP,550095,0,0,3,3,
Oklahoma,U.S. Senate,Rob Moye,REP,550095,0,0,7,7,
Oklahoma,U.S. Senate,D. Jean Mcbride-Samuels,REP,550095,0,0,2,2,
Oklahoma,U.S. Senate,Jim Inhofe,REP,550095,0,0,179,179,
Oklahoma,U.S. Senate,Erick Paul Wyatt,REP,550095,0,0,13,13,
Oklahoma,U.S. Senate,Andy Craig,REP,550095,0,0,0,0,
Oklahoma,U.S. Senate,T. Shannon,REP,550095,0,0,37,37,
Oklahoma,U.S. Senate,Randy Brogdon,REP,550095,0,0,4,4,
Oklahoma,U.S. Senate,Eric Mccray,REP,550095,0,0,4,4,
Oklahoma,U.S. Senate,Kevin Crow,REP,550095,0,0,2,2,
Oklahoma,U.S. Senate,James Lankford,REP,550095,0,0,162,162,
Oklahoma,U.S. Senate,Jason Weger,REP,550095,0,0,0,0,
Oklahoma,U.S. House,Anna Flatt,REP,550095,0,0,36,36,04
Oklahoma,U.S. House,Tom Cole,REP,550095,0,0,172,172,04
Oklahoma,State Senate,Greg Childers,REP,550095,0,0,40,40,42
Oklahoma,State Senate,Jack Fry,REP,550095,0,0,166,166,42
Oklahoma,State House,A. Bailey,REP,550095,0,0,27,27,10
Oklahoma,State House,Gary Banz,REP,550095,0,0,178,178,10
Oklahoma,Superintendent of Public Instruction,John Cox,DEM,550096,0,0,41,41,
Oklahoma,Superintendent of Public Instruction,Jack Jr.,DEM,550096,0,0,7,7,
Oklahoma,Superintendent of Public Instruction,Ivan Holmes,DEM,550096,0,0,9,9,
Oklahoma,Superintendent of Public Instruction,Freda Deskin,DEM,550096,0,0,45,45,
Oklahoma,U.S. Senate,Patrick Michael Hayes,DEM,550096,0,0,14,14,
Oklahoma,U.S. Senate,Jim Rogers,DEM,550096,0,0,26,26,
Oklahoma,U.S. Senate,Connie Johnson,DEM,550096,0,0,57,57,
Oklahoma,U.S. House,Bert Smith,DEM,550096,0,0,75,75,04
Oklahoma,U.S. House,Tae Si,DEM,550096,0,0,20,20,04
Oklahoma,Governor,Dax Ewbank,REP,550096,0,0,18,18,
Oklahoma,Governor,Chad Moody,REP,550096,0,0,32,32,
Oklahoma,Governor,Mary Fallin,REP,550096,0,0,179,179,
Oklahoma,Superintendent of Public Instruction,Brian Kelly,REP,550096,0,0,52,52,
Oklahoma,Superintendent of Public Instruction,Janet Costello Barresi,REP,550096,0,0,52,52,
Oklahoma,Superintendent of Public Instruction,Joy Hofmeister,REP,550096,0,0,122,122,
Oklahoma,Insurance Commissioner,Bill Viner,REP,550096,0,0,56,56,
Oklahoma,Insurance Commissioner,John Doak,REP,550096,0,0,160,160,
Oklahoma,Corporation Commissioner,Todd Hiett,REP,550096,0,0,109,109,
Oklahoma,Corporation Commissioner,Cliff Branan,REP,550096,0,0,105,105,
Oklahoma,U.S. Senate,Evelyn Rogers,REP,550096,0,0,3,3,
Oklahoma,U.S. Senate,Rob Moye,REP,550096,0,0,4,4,
Oklahoma,U.S. Senate,D. Jean Mcbride-Samuels,REP,550096,0,0,3,3,
Oklahoma,U.S. Senate,Jim Inhofe,REP,550096,0,0,206,206,
Oklahoma,U.S. Senate,Erick Paul Wyatt,REP,550096,0,0,9,9,
Oklahoma,U.S. Senate,Andy Craig,REP,550096,0,0,4,4,
Oklahoma,U.S. Senate,T. Shannon,REP,550096,0,0,67,67,
Oklahoma,U.S. Senate,Randy Brogdon,REP,550096,0,0,4,4,
Oklahoma,U.S. Senate,Eric Mccray,REP,550096,0,0,0,0,
Oklahoma,U.S. Senate,Kevin Crow,REP,550096,0,0,1,1,
Oklahoma,U.S. Senate,James Lankford,REP,550096,0,0,151,151,
Oklahoma,U.S. Senate,Jason Weger,REP,550096,0,0,2,2,
Oklahoma,U.S. House,Anna Flatt,REP,550096,0,0,31,31,04
Oklahoma,U.S. House,Tom Cole,REP,550096,0,0,196,196,04
Oklahoma,State Senate,Greg Childers,REP,550096,0,0,90,90,42
Oklahoma,State Senate,Jack Fry,REP,550096,0,0,128,128,42
Oklahoma,State House,A. Bailey,REP,550096,0,0,32,32,10
Oklahoma,State House,Gary Banz,REP,550096,0,0,190,190,10
Oklahoma,Superintendent of Public Instruction,John Cox,DEM,550097,0,0,38,38,
Oklahoma,Superintendent of Public Instruction,Jack Jr.,DEM,550097,0,0,14,14,
Oklahoma,Superintendent of Public Instruction,Ivan Holmes,DEM,550097,0,0,3,3,
Oklahoma,Superintendent of Public Instruction,Freda Deskin,DEM,550097,0,0,49,49,
Oklahoma,U.S. Senate,Patrick Michael Hayes,DEM,550097,0,0,17,17,
Oklahoma,U.S. Senate,Jim Rogers,DEM,550097,0,0,31,31,
Oklahoma,U.S. Senate,Connie Johnson,DEM,550097,0,0,55,55,
Oklahoma,U.S. House,Bert Smith,DEM,550097,0,0,73,73,04
Oklahoma,U.S. House,Tae Si,DEM,550097,0,0,24,24,04
Oklahoma,Governor,Dax Ewbank,REP,550097,0,0,17,17,
Oklahoma,Governor,Chad Moody,REP,550097,0,0,32,32,
Oklahoma,Governor,Mary Fallin,REP,550097,0,0,148,148,
Oklahoma,Superintendent of Public Instruction,Brian Kelly,REP,550097,0,0,44,44,
Oklahoma,Superintendent of Public Instruction,Janet Costello Barresi,REP,550097,0,0,52,52,
Oklahoma,Superintendent of Public Instruction,Joy Hofmeister,REP,550097,0,0,99,99,
Oklahoma,Insurance Commissioner,Bill Viner,REP,550097,0,0,32,32,
Oklahoma,Insurance Commissioner,John Doak,REP,550097,0,0,149,149,
Oklahoma,Corporation Commissioner,Todd Hiett,REP,550097,0,0,87,87,
Oklahoma,Corporation Commissioner,Cliff Branan,REP,550097,0,0,97,97,
Oklahoma,U.S. Senate,Evelyn Rogers,REP,550097,0,0,8,8,
Oklahoma,U.S. Senate,Rob Moye,REP,550097,0,0,2,2,
Oklahoma,U.S. Senate,D. Jean Mcbride-Samuels,REP,550097,0,0,2,2,
Oklahoma,U.S. Senate,Jim Inhofe,REP,550097,0,0,175,175,
Oklahoma,U.S. Senate,Erick Paul Wyatt,REP,550097,0,0,7,7,
Oklahoma,U.S. Senate,Andy Craig,REP,550097,0,0,0,0,
Oklahoma,U.S. Senate,T. Shannon,REP,550097,0,0,37,37,
Oklahoma,U.S. Senate,Randy Brogdon,REP,550097,0,0,0,0,
Oklahoma,U.S. Senate,Eric Mccray,REP,550097,0,0,1,1,
Oklahoma,U.S. Senate,Kevin Crow,REP,550097,0,0,0,0,
Oklahoma,U.S. Senate,James Lankford,REP,550097,0,0,156,156,
Oklahoma,U.S. Senate,Jason Weger,REP,550097,0,0,4,4,
Oklahoma,U.S. House,Anna Flatt,REP,550097,0,0,23,23,04
Oklahoma,U.S. House,Tom Cole,REP,550097,0,0,172,172,04
Oklahoma,State Senate,Greg Childers,REP,550097,0,0,66,66,42
Oklahoma,State Senate,Jack Fry,REP,550097,0,0,120,120,42
Oklahoma,State House,A. Bailey,REP,550097,0,0,26,26,10
Oklahoma,State House,Gary Banz,REP,550097,0,0,163,163,10
Oklahoma,Superintendent of Public Instruction,John Cox,DEM,550098,0,0,20,20,
Oklahoma,Superintendent of Public Instruction,Jack Jr.,DEM,550098,0,0,10,10,
Oklahoma,Superintendent of Public Instruction,Ivan Holmes,DEM,550098,0,0,5,5,
Oklahoma,Superintendent of Public Instruction,Freda Deskin,DEM,550098,0,0,36,36,
Oklahoma,U.S. Senate,Patrick Michael Hayes,DEM,550098,0,0,11,11,
Oklahoma,U.S. Senate,Jim Rogers,DEM,550098,0,0,15,15,
Oklahoma,U.S. Senate,Connie Johnson,DEM,550098,0,0,44,44,
Oklahoma,U.S. House,Bert Smith,DEM,550098,0,0,45,45,04
Oklahoma,U.S. House,Tae Si,DEM,550098,0,0,24,24,04
Oklahoma,Governor,Dax Ewbank,REP,550098,0,0,42,42,
Oklahoma,Governor,Chad Moody,REP,550098,0,0,49,49,
Oklahoma,Governor,Mary Fallin,REP,550098,0,0,311,311,
Oklahoma,Superintendent of Public Instruction,Brian Kelly,REP,550098,0,0,85,85,
Oklahoma,Superintendent of Public Instruction,Janet Costello Barresi,REP,550098,0,0,90,90,
Oklahoma,Superintendent of Public Instruction,Joy Hofmeister,REP,550098,0,0,223,223,
Oklahoma,Insurance Commissioner,Bill Viner,REP,550098,0,0,86,86,
Oklahoma,Insurance Commissioner,John Doak,REP,550098,0,0,272,272,
Oklahoma,Corporation Commissioner,Todd Hiett,REP,550098,0,0,176,176,
Oklahoma,Corporation Commissioner,Cliff Branan,REP,550098,0,0,176,176,
Oklahoma,U.S. Senate,Evelyn Rogers,REP,550098,0,0,13,13,
Oklahoma,U.S. Senate,Rob Moye,REP,550098,0,0,4,4,
Oklahoma,U.S. Senate,D. Jean Mcbride-Samuels,REP,550098,0,0,3,3,
Oklahoma,U.S. Senate,Jim Inhofe,REP,550098,0,0,370,370,
Oklahoma,U.S. Senate,Erick Paul Wyatt,REP,550098,0,0,8,8,
Oklahoma,U.S. Senate,Andy Craig,REP,550098,0,0,1,1,
Oklahoma,U.S. Senate,T. Shannon,REP,550098,0,0,121,121,
Oklahoma,U.S. Senate,Randy Brogdon,REP,550098,0,0,11,11,
Oklahoma,U.S. Senate,Eric Mccray,REP,550098,0,0,1,1,
Oklahoma,U.S. Senate,Kevin Crow,REP,550098,0,0,3,3,
Oklahoma,U.S. Senate,James Lankford,REP,550098,0,0,270,270,
Oklahoma,U.S. Senate,Jason Weger,REP,550098,0,0,0,0,
Oklahoma,U.S. House,Anna Flatt,REP,550098,0,0,51,51,04
Oklahoma,U.S. House,Tom Cole,REP,550098,0,0,350,350,04
Oklahoma,State Senate,Greg Childers,REP,550098,0,0,132,132,42
Oklahoma,State Senate,Jack Fry,REP,550098,0,0,260,260,42
Oklahoma,State House,A. Bailey,REP,550098,0,0,49,49,10
Oklahoma,State House,Gary Banz,REP,550098,0,0,335,335,10
Oklahoma,Superintendent of Public Instruction,John Cox,DEM,550099,0,0,22,22,
Oklahoma,Superintendent of Public Instruction,Jack Jr.,DEM,550099,0,0,12,12,
Oklahoma,Superintendent of Public Instruction,Ivan Holmes,DEM,550099,0,0,11,11,
Oklahoma,Superintendent of Public Instruction,Freda Deskin,DEM,550099,0,0,55,55,
Oklahoma,U.S. Senate,Patrick Michael Hayes,DEM,550099,0,0,12,12,
Oklahoma,U.S. Senate,Jim Rogers,DEM,550099,0,0,25,25,
Oklahoma,U.S. Senate,Connie Johnson,DEM,550099,0,0,57,57,
Oklahoma,U.S. House,Tom Guild,DEM,550099,0,0,29,29,05
Oklahoma,U.S. House,Al Mcaffrey,DEM,550099,0,0,50,50,05
Oklahoma,U.S. House,Leona Leonard,DEM,550099,0,0,15,15,05
Oklahoma,Governor,Dax Ewbank,REP,550099,0,0,18,18,
Oklahoma,Governor,Chad Moody,REP,550099,0,0,43,43,
Oklahoma,Governor,Mary Fallin,REP,550099,0,0,267,267,
Oklahoma,Superintendent of Public Instruction,Brian Kelly,REP,550099,0,0,46,46,
Oklahoma,Superintendent of Public Instruction,Janet Costello Barresi,REP,550099,0,0,173,173,
Oklahoma,Superintendent of Public Instruction,Joy Hofmeister,REP,550099,0,0,107,107,
Oklahoma,Insurance Commissioner,Bill Viner,REP,550099,0,0,55,55,
Oklahoma,Insurance Commissioner,John Doak,REP,550099,0,0,225,225,
Oklahoma,Corporation Commissioner,Todd Hiett,REP,550099,0,0,56,56,
Oklahoma,Corporation Commissioner,Cliff Branan,REP,550099,0,0,269,269,
Oklahoma,U.S. Senate,Evelyn Rogers,REP,550099,0,0,20,20,
Oklahoma,U.S. Senate,Rob Moye,REP,550099,0,0,6,6,
Oklahoma,U.S. Senate,D. Jean Mcbride-Samuels,REP,550099,0,0,3,3,
Oklahoma,U.S. Senate,Jim Inhofe,REP,550099,0,0,286,286,
Oklahoma,U.S. Senate,Erick Paul Wyatt,REP,550099,0,0,6,6,
Oklahoma,U.S. Senate,Andy Craig,REP,550099,0,0,1,1,
Oklahoma,U.S. Senate,T. Shannon,REP,550099,0,0,57,57,
Oklahoma,U.S. Senate,Randy Brogdon,REP,550099,0,0,2,2,
Oklahoma,U.S. Senate,Eric Mccray,REP,550099,0,0,0,0,
Oklahoma,U.S. Senate,Kevin Crow,REP,550099,0,0,1,1,
Oklahoma,U.S. Senate,James Lankford,REP,550099,0,0,274,274,
Oklahoma,U.S. Senate,Jason Weger,REP,550099,0,0,1,1,
Oklahoma,U.S. House,Shane David Jett,REP,550099,0,0,27,27,05
Oklahoma,U.S. House,Patrice Douglas,REP,550099,0,0,102,102,05
Oklahoma,U.S. House,Mike Turner,REP,550099,0,0,46,46,05
Oklahoma,U.S. House,Steve Russell,REP,550099,0,0,83,83,05
Oklahoma,U.S. House,Harvey Sparks,REP,550099,0,0,11,11,05
Oklahoma,U.S. House,Clark Jolley,REP,550099,0,0,48,48,05
Oklahoma,State Senate,Ervin Yen,REP,550099,0,0,187,187,40
Oklahoma,State Senate,Joe Howell,REP,550099,0,0,46,46,40
Oklahoma,State Senate,Michael Taylor,REP,550099,0,0,20,20,40
Oklahoma,State Senate,Brian Winslow,REP,550099,0,0,26,26,40
Oklahoma,State Senate,Steve Kern,REP,550099,0,0,22,22,40
Oklahoma,State Senate,David Hooten,REP,550099,0,0,29,29,40
Oklahoma,Superintendent of Public Instruction,John Cox,DEM,550100,0,0,16,16,
Oklahoma,Superintendent of Public Instruction,Jack Jr.,DEM,550100,0,0,7,7,
Oklahoma,Superintendent of Public Instruction,Ivan Holmes,DEM,550100,0,0,4,4,
Oklahoma,Superintendent of Public Instruction,Freda Deskin,DEM,550100,0,0,58,58,
Oklahoma,U.S. Senate,Patrick Michael Hayes,DEM,550100,0,0,10,10,
Oklahoma,U.S. Senate,Jim Rogers,DEM,550100,0,0,10,10,
Oklahoma,U.S. Senate,Connie Johnson,DEM,550100,0,0,59,59,
Oklahoma,U.S. House,Tom Guild,DEM,550100,0,0,23,23,05
Oklahoma,U.S. House,Al Mcaffrey,DEM,550100,0,0,47,47,05
Oklahoma,U.S. House,Leona Leonard,DEM,550100,0,0,15,15,05
Oklahoma,Governor,Dax Ewbank,REP,550100,0,0,17,17,
Oklahoma,Governor,Chad Moody,REP,550100,0,0,43,43,
Oklahoma,Governor,Mary Fallin,REP,550100,0,0,417,417,
Oklahoma,Superintendent of Public Instruction,Brian Kelly,REP,550100,0,0,61,61,
Oklahoma,Superintendent of Public Instruction,Janet Costello Barresi,REP,550100,0,0,278,278,
Oklahoma,Superintendent of Public Instruction,Joy Hofmeister,REP,550100,0,0,126,126,
Oklahoma,Insurance Commissioner,Bill Viner,REP,550100,0,0,51,51,
Oklahoma,Insurance Commissioner,John Doak,REP,550100,0,0,351,351,
Oklahoma,Corporation Commissioner,Todd Hiett,REP,550100,0,0,94,94,
Oklahoma,Corporation Commissioner,Cliff Branan,REP,550100,0,0,377,377,
Oklahoma,U.S. Senate,Evelyn Rogers,REP,550100,0,0,22,22,
Oklahoma,U.S. Senate,Rob Moye,REP,550100,0,0,8,8,
Oklahoma,U.S. Senate,D. Jean Mcbride-Samuels,REP,550100,0,0,7,7,
Oklahoma,U.S. Senate,Jim Inhofe,REP,550100,0,0,425,425,
Oklahoma,U.S. Senate,Erick Paul Wyatt,REP,550100,0,0,3,3,
Oklahoma,U.S. Senate,Andy Craig,REP,550100,0,0,4,4,
Oklahoma,U.S. Senate,T. Shannon,REP,550100,0,0,94,94,
Oklahoma,U.S. Senate,Randy Brogdon,REP,550100,0,0,11,11,
Oklahoma,U.S. Senate,Eric Mccray,REP,550100,0,0,1,1,
Oklahoma,U.S. Senate,Kevin Crow,REP,550100,0,0,2,2,
Oklahoma,U.S. Senate,James Lankford,REP,550100,0,0,373,373,
Oklahoma,U.S. Senate,Jason Weger,REP,550100,0,0,0,0,
Oklahoma,U.S. House,Shane David Jett,REP,550100,0,0,25,25,05
Oklahoma,U.S. House,Patrice Douglas,REP,550100,0,0,170,170,05
Oklahoma,U.S. House,Mike Turner,REP,550100,0,0,46,46,05
Oklahoma,U.S. House,Steve Russell,REP,550100,0,0,123,123,05
Oklahoma,U.S. House,Harvey Sparks,REP,550100,0,0,8,8,05
Oklahoma,U.S. House,Clark Jolley,REP,550100,0,0,78,78,05
Oklahoma,State Senate,Ervin Yen,REP,550100,0,0,281,281,40
Oklahoma,State Senate,Joe Howell,REP,550100,0,0,104,104,40
Oklahoma,State Senate,Michael Taylor,REP,550100,0,0,8,8,40
Oklahoma,State Senate,Brian Winslow,REP,550100,0,0,14,14,40
Oklahoma,State Senate,Steve Kern,REP,550100,0,0,22,22,40
Oklahoma,State Senate,David Hooten,REP,550100,0,0,50,50,40
Oklahoma,Superintendent of Public Instruction,John Cox,DEM,550101,0,0,5,5,
Oklahoma,Superintendent of Public Instruction,Jack Jr.,DEM,550101,0,0,2,2,
Oklahoma,Superintendent of Public Instruction,Ivan Holmes,DEM,550101,0,0,4,4,
Oklahoma,Superintendent of Public Instruction,Freda Deskin,DEM,550101,0,0,15,15,
Oklahoma,U.S. Senate,Patrick Michael Hayes,DEM,550101,0,0,5,5,
Oklahoma,U.S. Senate,Jim Rogers,DEM,550101,0,0,6,6,
Oklahoma,U.S. Senate,Connie Johnson,DEM,550101,0,0,13,13,
Oklahoma,U.S. House,Tom Guild,DEM,550101,0,0,10,10,05
Oklahoma,U.S. House,Al Mcaffrey,DEM,550101,0,0,11,11,05
Oklahoma,U.S. House,Leona Leonard,DEM,550101,0,0,4,4,05
Oklahoma,Governor,Dax Ewbank,REP,550101,0,0,3,3,
Oklahoma,Governor,Chad Moody,REP,550101,0,0,20,20,
Oklahoma,Governor,Mary Fallin,REP,550101,0,0,192,192,
Oklahoma,Superintendent of Public Instruction,Brian Kelly,REP,550101,0,0,23,23,
Oklahoma,Superintendent of Public Instruction,Janet Costello Barresi,REP,550101,0,0,136,136,
Oklahoma,Superintendent of Public Instruction,Joy Hofmeister,REP,550101,0,0,52,52,
Oklahoma,Insurance Commissioner,Bill Viner,REP,550101,0,0,20,20,
Oklahoma,Insurance Commissioner,John Doak,REP,550101,0,0,160,160,
Oklahoma,Corporation Commissioner,Todd Hiett,REP,550101,0,0,30,30,
Oklahoma,Corporation Commissioner,Cliff Branan,REP,550101,0,0,181,181,
Oklahoma,U.S. Senate,Evelyn Rogers,REP,550101,0,0,7,7,
Oklahoma,U.S. Senate,Rob Moye,REP,550101,0,0,3,3,
Oklahoma,U.S. Senate,D. Jean Mcbride-Samuels,REP,550101,0,0,1,1,
Oklahoma,U.S. Senate,Jim Inhofe,REP,550101,0,0,199,199,
Oklahoma,U.S. Senate,Erick Paul Wyatt,REP,550101,0,0,5,5,
Oklahoma,U.S. Senate,Andy Craig,REP,550101,0,0,0,0,
Oklahoma,U.S. Senate,T. Shannon,REP,550101,0,0,42,42,
Oklahoma,U.S. Senate,Randy Brogdon,REP,550101,0,0,2,2,
Oklahoma,U.S. Senate,Eric Mccray,REP,550101,0,0,2,2,
Oklahoma,U.S. Senate,Kevin Crow,REP,550101,0,0,1,1,
Oklahoma,U.S. Senate,James Lankford,REP,550101,0,0,174,174,
Oklahoma,U.S. Senate,Jason Weger,REP,550101,0,0,0,0,
Oklahoma,U.S. House,Shane David Jett,REP,550101,0,0,14,14,05
Oklahoma,U.S. House,Patrice Douglas,REP,550101,0,0,56,56,05
Oklahoma,U.S. House,Mike Turner,REP,550101,0,0,30,30,05
Oklahoma,U.S. House,Steve Russell,REP,550101,0,0,64,64,05
Oklahoma,U.S. House,Harvey Sparks,REP,550101,0,0,10,10,05
Oklahoma,U.S. House,Clark Jolley,REP,550101,0,0,29,29,05
Oklahoma,State Senate,Ervin Yen,REP,550101,0,0,149,149,40
Oklahoma,State Senate,Joe Howell,REP,550101,0,0,39,39,40
Oklahoma,State Senate,Michael Taylor,REP,550101,0,0,4,4,40
Oklahoma,State Senate,Brian Winslow,REP,550101,0,0,2,2,40
Oklahoma,State Senate,Steve Kern,REP,550101,0,0,5,5,40
Oklahoma,State Senate,David Hooten,REP,550101,0,0,19,19,40
Oklahoma,Superintendent of Public Instruction,John Cox,DEM,550102,0,0,31,31,
Oklahoma,Superintendent of Public Instruction,Jack Jr.,DEM,550102,0,0,11,11,
Oklahoma,Superintendent of Public Instruction,Ivan Holmes,DEM,550102,0,0,11,11,
Oklahoma,Superintendent of Public Instruction,Freda Deskin,DEM,550102,0,0,74,74,
Oklahoma,U.S. Senate,Patrick Michael Hayes,DEM,550102,0,0,14,14,
Oklahoma,U.S. Senate,Jim Rogers,DEM,550102,0,0,29,29,
Oklahoma,U.S. Senate,Connie Johnson,DEM,550102,0,0,80,80,
Oklahoma,U.S. House,Tom Guild,DEM,550102,0,0,46,46,05
Oklahoma,U.S. House,Al Mcaffrey,DEM,550102,0,0,51,51,05
Oklahoma,U.S. House,Leona Leonard,DEM,550102,0,0,26,26,05
Oklahoma,Governor,Dax Ewbank,REP,550102,0,0,28,28,
Oklahoma,Governor,Chad Moody,REP,550102,0,0,41,41,
Oklahoma,Governor,Mary Fallin,REP,550102,0,0,354,354,
Oklahoma,Superintendent of Public Instruction,Brian Kelly,REP,550102,0,0,75,75,
Oklahoma,Superintendent of Public Instruction,Janet Costello Barresi,REP,550102,0,0,209,209,
Oklahoma,Superintendent of Public Instruction,Joy Hofmeister,REP,550102,0,0,133,133,
Oklahoma,Insurance Commissioner,Bill Viner,REP,550102,0,0,63,63,
Oklahoma,Insurance Commissioner,John Doak,REP,550102,0,0,324,324,
Oklahoma,Corporation Commissioner,Todd Hiett,REP,550102,0,0,130,130,
Oklahoma,Corporation Commissioner,Cliff Branan,REP,550102,0,0,271,271,
Oklahoma,U.S. Senate,Evelyn Rogers,REP,550102,0,0,15,15,
Oklahoma,U.S. Senate,Rob Moye,REP,550102,0,0,8,8,
Oklahoma,U.S. Senate,D. Jean Mcbride-Samuels,REP,550102,0,0,4,4,
Oklahoma,U.S. Senate,Jim Inhofe,REP,550102,0,0,384,384,
Oklahoma,U.S. Senate,Erick Paul Wyatt,REP,550102,0,0,14,14,
Oklahoma,U.S. Senate,Andy Craig,REP,550102,0,0,5,5,
Oklahoma,U.S. Senate,T. Shannon,REP,550102,0,0,69,69,
Oklahoma,U.S. Senate,Randy Brogdon,REP,550102,0,0,8,8,
Oklahoma,U.S. Senate,Eric Mccray,REP,550102,0,0,4,4,
Oklahoma,U.S. Senate,Kevin Crow,REP,550102,0,0,3,3,
Oklahoma,U.S. Senate,James Lankford,REP,550102,0,0,338,338,
Oklahoma,U.S. Senate,Jason Weger,REP,550102,0,0,1,1,
Oklahoma,U.S. House,Shane David Jett,REP,550102,0,0,25,25,05
Oklahoma,U.S. House,Patrice Douglas,REP,550102,0,0,125,125,05
Oklahoma,U.S. House,Mike Turner,REP,550102,0,0,77,77,05
Oklahoma,U.S. House,Steve Russell,REP,550102,0,0,93,93,05
Oklahoma,U.S. House,Harvey Sparks,REP,550102,0,0,13,13,05
Oklahoma,U.S. House,Clark Jolley,REP,550102,0,0,68,68,05
Oklahoma,State Senate,Ervin Yen,REP,550102,0,0,251,251,40
Oklahoma,State Senate,Joe Howell,REP,550102,0,0,50,50,40
Oklahoma,State Senate,Michael Taylor,REP,550102,0,0,19,19,40
Oklahoma,State Senate,Brian Winslow,REP,550102,0,0,21,21,40
Oklahoma,State Senate,Steve Kern,REP,550102,0,0,41,41,40
Oklahoma,State Senate,David Hooten,REP,550102,0,0,42,42,40
Oklahoma,Superintendent of Public Instruction,John Cox,DEM,550103,0,0,15,15,
Oklahoma,Superintendent of Public Instruction,Jack Jr.,DEM,550103,0,0,16,16,
Oklahoma,Superintendent of Public Instruction,Ivan Holmes,DEM,550103,0,0,2,2,
Oklahoma,Superintendent of Public Instruction,Freda Deskin,DEM,550103,0,0,36,36,
Oklahoma,U.S. Senate,Patrick Michael Hayes,DEM,550103,0,0,12,12,
Oklahoma,U.S. Senate,Jim Rogers,DEM,550103,0,0,12,12,
Oklahoma,U.S. Senate,Connie Johnson,DEM,550103,0,0,47,47,
Oklahoma,U.S. House,Tom Guild,DEM,550103,0,0,25,25,05
Oklahoma,U.S. House,Al Mcaffrey,DEM,550103,0,0,29,29,05
Oklahoma,U.S. House,Leona Leonard,DEM,550103,0,0,17,17,05
Oklahoma,Governor,Dax Ewbank,REP,550103,0,0,18,18,
Oklahoma,Governor,Chad Moody,REP,550103,0,0,19,19,
Oklahoma,Governor,Mary Fallin,REP,550103,0,0,132,132,
Oklahoma,Superintendent of Public Instruction,Brian Kelly,REP,550103,0,0,33,33,
Oklahoma,Superintendent of Public Instruction,Janet Costello Barresi,REP,550103,0,0,58,58,
Oklahoma,Superintendent of Public Instruction,Joy Hofmeister,REP,550103,0,0,76,76,
Oklahoma,Insurance Commissioner,Bill Viner,REP,550103,0,0,35,35,
Oklahoma,Insurance Commissioner,John Doak,REP,550103,0,0,115,115,
Oklahoma,Corporation Commissioner,Todd Hiett,REP,550103,0,0,67,67,
Oklahoma,Corporation Commissioner,Cliff Branan,REP,550103,0,0,94,94,
Oklahoma,U.S. Senate,Evelyn Rogers,REP,550103,0,0,5,5,
Oklahoma,U.S. Senate,Rob Moye,REP,550103,0,0,2,2,
Oklahoma,U.S. Senate,D. Jean Mcbride-Samuels,REP,550103,0,0,4,4,
Oklahoma,U.S. Senate,Jim Inhofe,REP,550103,0,0,146,146,
Oklahoma,U.S. Senate,Erick Paul Wyatt,REP,550103,0,0,6,6,
Oklahoma,U.S. Senate,Andy Craig,REP,550103,0,0,0,0,
Oklahoma,U.S. Senate,T. Shannon,REP,550103,0,0,47,47,
Oklahoma,U.S. Senate,Randy Brogdon,REP,550103,0,0,6,6,
Oklahoma,U.S. Senate,Eric Mccray,REP,550103,0,0,1,1,
Oklahoma,U.S. Senate,Kevin Crow,REP,550103,0,0,6,6,
Oklahoma,U.S. Senate,James Lankford,REP,550103,0,0,111,111,
Oklahoma,U.S. Senate,Jason Weger,REP,550103,0,0,0,0,
Oklahoma,U.S. House,Shane David Jett,REP,550103,0,0,13,13,05
Oklahoma,U.S. House,Patrice Douglas,REP,550103,0,0,55,55,05
Oklahoma,U.S. House,Mike Turner,REP,550103,0,0,20,20,05
Oklahoma,U.S. House,Steve Russell,REP,550103,0,0,43,43,05
Oklahoma,U.S. House,Harvey Sparks,REP,550103,0,0,10,10,05
Oklahoma,U.S. House,Clark Jolley,REP,550103,0,0,21,21,05
Oklahoma,State Senate,Ervin Yen,REP,550103,0,0,46,46,40
Oklahoma,State Senate,Joe Howell,REP,550103,0,0,24,24,40
Oklahoma,State Senate,Michael Taylor,REP,550103,0,0,10,10,40
Oklahoma,State Senate,Brian Winslow,REP,550103,0,0,30,30,40
Oklahoma,State Senate,Steve Kern,REP,550103,0,0,34,34,40
Oklahoma,State Senate,David Hooten,REP,550103,0,0,20,20,40
Oklahoma,Superintendent of Public Instruction,John Cox,DEM,550104,0,0,24,24,
Oklahoma,Superintendent of Public Instruction,Jack Jr.,DEM,550104,0,0,7,7,
Oklahoma,Superintendent of Public Instruction,Ivan Holmes,DEM,550104,0,0,5,5,
Oklahoma,Superintendent of Public Instruction,Freda Deskin,DEM,550104,0,0,38,38,
Oklahoma,U.S. Senate,Patrick Michael Hayes,DEM,550104,0,0,11,11,
Oklahoma,U.S. Senate,Jim Rogers,DEM,550104,0,0,14,14,
Oklahoma,U.S. Senate,Connie Johnson,DEM,550104,0,0,47,47,
Oklahoma,U.S. House,Tom Guild,DEM,550104,0,0,34,34,05
Oklahoma,U.S. House,Al Mcaffrey,DEM,550104,0,0,24,24,05
Oklahoma,U.S. House,Leona Leonard,DEM,550104,0,0,14,14,05
Oklahoma,Governor,Dax Ewbank,REP,550104,0,0,10,10,
Oklahoma,Governor,Chad Moody,REP,550104,0,0,28,28,
Oklahoma,Governor,Mary Fallin,REP,550104,0,0,109,109,
Oklahoma,Superintendent of Public Instruction,Brian Kelly,REP,550104,0,0,32,32,
Oklahoma,Superintendent of Public Instruction,Janet Costello Barresi,REP,550104,0,0,45,45,
Oklahoma,Superintendent of Public Instruction,Joy Hofmeister,REP,550104,0,0,66,66,
Oklahoma,Insurance Commissioner,Bill Viner,REP,550104,0,0,29,29,
Oklahoma,Insurance Commissioner,John Doak,REP,550104,0,0,111,111,
Oklahoma,Corporation Commissioner,Todd Hiett,REP,550104,0,0,52,52,
Oklahoma,Corporation Commissioner,Cliff Branan,REP,550104,0,0,81,81,
Oklahoma,U.S. Senate,Evelyn Rogers,REP,550104,0,0,6,6,
Oklahoma,U.S. Senate,Rob Moye,REP,550104,0,0,1,1,
Oklahoma,U.S. Senate,D. Jean Mcbride-Samuels,REP,550104,0,0,4,4,
Oklahoma,U.S. Senate,Jim Inhofe,REP,550104,0,0,130,130,
Oklahoma,U.S. Senate,Erick Paul Wyatt,REP,550104,0,0,6,6,
Oklahoma,U.S. Senate,Andy Craig,REP,550104,0,0,2,2,
Oklahoma,U.S. Senate,T. Shannon,REP,550104,0,0,22,22,
Oklahoma,U.S. Senate,Randy Brogdon,REP,550104,0,0,1,1,
Oklahoma,U.S. Senate,Eric Mccray,REP,550104,0,0,2,2,
Oklahoma,U.S. Senate,Kevin Crow,REP,550104,0,0,3,3,
Oklahoma,U.S. Senate,James Lankford,REP,550104,0,0,115,115,
Oklahoma,U.S. Senate,Jason Weger,REP,550104,0,0,1,1,
Oklahoma,U.S. House,Shane David Jett,REP,550104,0,0,24,24,05
Oklahoma,U.S. House,Patrice Douglas,REP,550104,0,0,26,26,05
Oklahoma,U.S. House,Mike Turner,REP,550104,0,0,24,24,05
Oklahoma,U.S. House,Steve Russell,REP,550104,0,0,42,42,05
Oklahoma,U.S. House,Harvey Sparks,REP,550104,0,0,13,13,05
Oklahoma,U.S. House,Clark Jolley,REP,550104,0,0,11,11,05
Oklahoma,Superintendent of Public Instruction,John Cox,DEM,550105,0,0,18,18,
Oklahoma,Superintendent of Public Instruction,Jack Jr.,DEM,550105,0,0,14,14,
Oklahoma,Superintendent of Public Instruction,Ivan Holmes,DEM,550105,0,0,3,3,
Oklahoma,Superintendent of Public Instruction,Freda Deskin,DEM,550105,0,0,50,50,
Oklahoma,U.S. Senate,Patrick Michael Hayes,DEM,550105,0,0,17,17,
Oklahoma,U.S. Senate,Jim Rogers,DEM,550105,0,0,17,17,
Oklahoma,U.S. Senate,Connie Johnson,DEM,550105,0,0,49,49,
Oklahoma,U.S. House,Tom Guild,DEM,550105,0,0,31,31,05
Oklahoma,U.S. House,Al Mcaffrey,DEM,550105,0,0,34,34,05
Oklahoma,U.S. House,Leona Leonard,DEM,550105,0,0,16,16,05
Oklahoma,Governor,Dax Ewbank,REP,550105,0,0,11,11,
Oklahoma,Governor,Chad Moody,REP,550105,0,0,26,26,
Oklahoma,Governor,Mary Fallin,REP,550105,0,0,209,209,
Oklahoma,Superintendent of Public Instruction,Brian Kelly,REP,550105,0,0,38,38,
Oklahoma,Superintendent of Public Instruction,Janet Costello Barresi,REP,550105,0,0,95,95,
Oklahoma,Superintendent of Public Instruction,Joy Hofmeister,REP,550105,0,0,105,105,
Oklahoma,Insurance Commissioner,Bill Viner,REP,550105,0,0,63,63,
Oklahoma,Insurance Commissioner,John Doak,REP,550105,0,0,162,162,
Oklahoma,Corporation Commissioner,Todd Hiett,REP,550105,0,0,93,93,
Oklahoma,Corporation Commissioner,Cliff Branan,REP,550105,0,0,135,135,
Oklahoma,U.S. Senate,Evelyn Rogers,REP,550105,0,0,16,16,
Oklahoma,U.S. Senate,Rob Moye,REP,550105,0,0,2,2,
Oklahoma,U.S. Senate,D. Jean Mcbride-Samuels,REP,550105,0,0,6,6,
Oklahoma,U.S. Senate,Jim Inhofe,REP,550105,0,0,213,213,
Oklahoma,U.S. Senate,Erick Paul Wyatt,REP,550105,0,0,6,6,
Oklahoma,U.S. Senate,Andy Craig,REP,550105,0,0,1,1,
Oklahoma,U.S. Senate,T. Shannon,REP,550105,0,0,46,46,
Oklahoma,U.S. Senate,Randy Brogdon,REP,550105,0,0,6,6,
Oklahoma,U.S. Senate,Eric Mccray,REP,550105,0,0,3,3,
Oklahoma,U.S. Senate,Kevin Crow,REP,550105,0,0,1,1,
Oklahoma,U.S. Senate,James Lankford,REP,550105,0,0,190,190,
Oklahoma,U.S. Senate,Jason Weger,REP,550105,0,0,2,2,
Oklahoma,U.S. House,Shane David Jett,REP,550105,0,0,18,18,05
Oklahoma,U.S. House,Patrice Douglas,REP,550105,0,0,67,67,05
Oklahoma,U.S. House,Mike Turner,REP,550105,0,0,37,37,05
Oklahoma,U.S. House,Steve Russell,REP,550105,0,0,66,66,05
Oklahoma,U.S. House,Harvey Sparks,REP,550105,0,0,17,17,05
Oklahoma,U.S. House,Clark Jolley,REP,550105,0,0,34,34,05
Oklahoma,Superintendent of Public Instruction,John Cox,DEM,550106,0,0,33,33,
Oklahoma,Superintendent of Public Instruction,Jack Jr.,DEM,550106,0,0,11,11,
Oklahoma,Superintendent of Public Instruction,Ivan Holmes,DEM,550106,0,0,13,13,
Oklahoma,Superintendent of Public Instruction,Freda Deskin,DEM,550106,0,0,58,58,
Oklahoma,U.S. Senate,Patrick Michael Hayes,DEM,550106,0,0,20,20,
Oklahoma,U.S. Senate,Jim Rogers,DEM,550106,0,0,30,30,
Oklahoma,U.S. Senate,Connie Johnson,DEM,550106,0,0,61,61,
Oklahoma,U.S. House,Tom Guild,DEM,550106,0,0,51,51,05
Oklahoma,U.S. House,Al Mcaffrey,DEM,550106,0,0,42,42,05
Oklahoma,U.S. House,Leona Leonard,DEM,550106,0,0,26,26,05
Oklahoma,Governor,Dax Ewbank,REP,550106,0,0,22,22,
Oklahoma,Governor,Chad Moody,REP,550106,0,0,44,44,
Oklahoma,Governor,Mary Fallin,REP,550106,0,0,257,257,
Oklahoma,Superintendent of Public Instruction,Brian Kelly,REP,550106,0,0,46,46,
Oklahoma,Superintendent of Public Instruction,Janet Costello Barresi,REP,550106,0,0,122,122,
Oklahoma,Superintendent of Public Instruction,Joy Hofmeister,REP,550106,0,0,149,149,
Oklahoma,Insurance Commissioner,Bill Viner,REP,550106,0,0,46,46,
Oklahoma,Insurance Commissioner,John Doak,REP,550106,0,0,249,249,
Oklahoma,Corporation Commissioner,Todd Hiett,REP,550106,0,0,117,117,
Oklahoma,Corporation Commissioner,Cliff Branan,REP,550106,0,0,174,174,
Oklahoma,U.S. Senate,Evelyn Rogers,REP,550106,0,0,11,11,
Oklahoma,U.S. Senate,Rob Moye,REP,550106,0,0,5,5,
Oklahoma,U.S. Senate,D. Jean Mcbride-Samuels,REP,550106,0,0,3,3,
Oklahoma,U.S. Senate,Jim Inhofe,REP,550106,0,0,289,289,
Oklahoma,U.S. Senate,Erick Paul Wyatt,REP,550106,0,0,8,8,
Oklahoma,U.S. Senate,Andy Craig,REP,550106,0,0,2,2,
Oklahoma,U.S. Senate,T. Shannon,REP,550106,0,0,70,70,
Oklahoma,U.S. Senate,Randy Brogdon,REP,550106,0,0,13,13,
Oklahoma,U.S. Senate,Eric Mccray,REP,550106,0,0,3,3,
Oklahoma,U.S. Senate,Kevin Crow,REP,550106,0,0,1,1,
Oklahoma,U.S. Senate,James Lankford,REP,550106,0,0,235,235,
Oklahoma,U.S. Senate,Jason Weger,REP,550106,0,0,0,0,
Oklahoma,U.S. House,Shane David Jett,REP,550106,0,0,32,32,05
Oklahoma,U.S. House,Patrice Douglas,REP,550106,0,0,74,74,05
Oklahoma,U.S. House,Mike Turner,REP,550106,0,0,47,47,05
Oklahoma,U.S. House,Steve Russell,REP,550106,0,0,86,86,05
Oklahoma,U.S. House,Harvey Sparks,REP,550106,0,0,26,26,05
Oklahoma,U.S. House,Clark Jolley,REP,550106,0,0,41,41,05
Oklahoma,Superintendent of Public Instruction,John Cox,DEM,550107,0,0,13,13,
Oklahoma,Superintendent of Public Instruction,Jack Jr.,DEM,550107,0,0,1,1,
Oklahoma,Superintendent of Public Instruction,Ivan Holmes,DEM,550107,0,0,2,2,
Oklahoma,Superintendent of Public Instruction,Freda Deskin,DEM,550107,0,0,14,14,
Oklahoma,U.S. Senate,Patrick Michael Hayes,DEM,550107,0,0,6,6,
Oklahoma,U.S. Senate,Jim Rogers,DEM,550107,0,0,2,2,
Oklahoma,U.S. Senate,Connie Johnson,DEM,550107,0,0,23,23,
Oklahoma,U.S. House,Tom Guild,DEM,550107,0,0,12,12,05
Oklahoma,U.S. House,Al Mcaffrey,DEM,550107,0,0,4,4,05
Oklahoma,U.S. House,Leona Leonard,DEM,550107,0,0,11,11,05
Oklahoma,Governor,Dax Ewbank,REP,550107,0,0,9,9,
Oklahoma,Governor,Chad Moody,REP,550107,0,0,17,17,
Oklahoma,Governor,Mary Fallin,REP,550107,0,0,44,44,
Oklahoma,Superintendent of Public Instruction,Brian Kelly,REP,550107,0,0,20,20,
Oklahoma,Superintendent of Public Instruction,Janet Costello Barresi,REP,550107,0,0,20,20,
Oklahoma,Superintendent of Public Instruction,Joy Hofmeister,REP,550107,0,0,30,30,
Oklahoma,Insurance Commissioner,Bill Viner,REP,550107,0,0,15,15,
Oklahoma,Insurance Commissioner,John Doak,REP,550107,0,0,51,51,
Oklahoma,Corporation Commissioner,Todd Hiett,REP,550107,0,0,30,30,
Oklahoma,Corporation Commissioner,Cliff Branan,REP,550107,0,0,36,36,
Oklahoma,U.S. Senate,Evelyn Rogers,REP,550107,0,0,3,3,
Oklahoma,U.S. Senate,Rob Moye,REP,550107,0,0,1,1,
Oklahoma,U.S. Senate,D. Jean Mcbride-Samuels,REP,550107,0,0,1,1,
Oklahoma,U.S. Senate,Jim Inhofe,REP,550107,0,0,61,61,
Oklahoma,U.S. Senate,Erick Paul Wyatt,REP,550107,0,0,3,3,
Oklahoma,U.S. Senate,Andy Craig,REP,550107,0,0,1,1,
Oklahoma,U.S. Senate,T. Shannon,REP,550107,0,0,18,18,
Oklahoma,U.S. Senate,Randy Brogdon,REP,550107,0,0,10,10,
Oklahoma,U.S. Senate,Eric Mccray,REP,550107,0,0,0,0,
Oklahoma,U.S. Senate,Kevin Crow,REP,550107,0,0,2,2,
Oklahoma,U.S. Senate,James Lankford,REP,550107,0,0,39,39,
Oklahoma,U.S. Senate,Jason Weger,REP,550107,0,0,0,0,
Oklahoma,U.S. House,Shane David Jett,REP,550107,0,0,7,7,05
Oklahoma,U.S. House,Patrice Douglas,REP,550107,0,0,10,10,05
Oklahoma,U.S. House,Mike Turner,REP,550107,0,0,6,6,05
Oklahoma,U.S. House,Steve Russell,REP,550107,0,0,24,24,05
Oklahoma,U.S. House,Harvey Sparks,REP,550107,0,0,6,6,05
Oklahoma,U.S. House,Clark Jolley,REP,550107,0,0,14,14,05
Oklahoma,Superintendent of Public Instruction,John Cox,DEM,550108,0,0,8,8,
Oklahoma,Superintendent of Public Instruction,Jack Jr.,DEM,550108,0,0,7,7,
Oklahoma,Superintendent of Public Instruction,Ivan Holmes,DEM,550108,0,0,1,1,
Oklahoma,Superintendent of Public Instruction,Freda Deskin,DEM,550108,0,0,18,18,
Oklahoma,U.S. Senate,Patrick Michael Hayes,DEM,550108,0,0,4,4,
Oklahoma,U.S. Senate,Jim Rogers,DEM,550108,0,0,3,3,
Oklahoma,U.S. Senate,Connie Johnson,DEM,550108,0,0,27,27,
Oklahoma,U.S. House,Tom Guild,DEM,550108,0,0,10,10,05
Oklahoma,U.S. House,Al Mcaffrey,DEM,550108,0,0,12,12,05
Oklahoma,U.S. House,Leona Leonard,DEM,550108,0,0,11,11,05
Oklahoma,Governor,Dax Ewbank,REP,550108,0,0,13,13,
Oklahoma,Governor,Chad Moody,REP,550108,0,0,13,13,
Oklahoma,Governor,Mary Fallin,REP,550108,0,0,75,75,
Oklahoma,Superintendent of Public Instruction,Brian Kelly,REP,550108,0,0,24,24,
Oklahoma,Superintendent of Public Instruction,Janet Costello Barresi,REP,550108,0,0,24,24,
Oklahoma,Superintendent of Public Instruction,Joy Hofmeister,REP,550108,0,0,50,50,
Oklahoma,Insurance Commissioner,Bill Viner,REP,550108,0,0,14,14,
Oklahoma,Insurance Commissioner,John Doak,REP,550108,0,0,73,73,
Oklahoma,Corporation Commissioner,Todd Hiett,REP,550108,0,0,41,41,
Oklahoma,Corporation Commissioner,Cliff Branan,REP,550108,0,0,45,45,
Oklahoma,U.S. Senate,Evelyn Rogers,REP,550108,0,0,1,1,
Oklahoma,U.S. Senate,Rob Moye,REP,550108,0,0,0,0,
Oklahoma,U.S. Senate,D. Jean Mcbride-Samuels,REP,550108,0,0,0,0,
Oklahoma,U.S. Senate,Jim Inhofe,REP,550108,0,0,91,91,
Oklahoma,U.S. Senate,Erick Paul Wyatt,REP,550108,0,0,4,4,
Oklahoma,U.S. Senate,Andy Craig,REP,550108,0,0,0,0,
Oklahoma,U.S. Senate,T. Shannon,REP,550108,0,0,20,20,
Oklahoma,U.S. Senate,Randy Brogdon,REP,550108,0,0,4,4,
Oklahoma,U.S. Senate,Eric Mccray,REP,550108,0,0,0,0,
Oklahoma,U.S. Senate,Kevin Crow,REP,550108,0,0,1,1,
Oklahoma,U.S. Senate,James Lankford,REP,550108,0,0,74,74,
Oklahoma,U.S. Senate,Jason Weger,REP,550108,0,0,0,0,
Oklahoma,U.S. House,Shane David Jett,REP,550108,0,0,8,8,05
Oklahoma,U.S. House,Patrice Douglas,REP,550108,0,0,25,25,05
Oklahoma,U.S. House,Mike Turner,REP,550108,0,0,14,14,05
Oklahoma,U.S. House,Steve Russell,REP,550108,0,0,21,21,05
Oklahoma,U.S. House,Harvey Sparks,REP,550108,0,0,4,4,05
Oklahoma,U.S. House,Clark Jolley,REP,550108,0,0,25,25,05
Oklahoma,Superintendent of Public Instruction,John Cox,DEM,550109,0,0,31,31,
Oklahoma,Superintendent of Public Instruction,Jack Jr.,DEM,550109,0,0,16,16,
Oklahoma,Superintendent of Public Instruction,Ivan Holmes,DEM,550109,0,0,11,11,
Oklahoma,Superintendent of Public Instruction,Freda Deskin,DEM,550109,0,0,54,54,
Oklahoma,U.S. Senate,Patrick Michael Hayes,DEM,550109,0,0,11,11,
Oklahoma,U.S. Senate,Jim Rogers,DEM,550109,0,0,24,24,
Oklahoma,U.S. Senate,Connie Johnson,DEM,550109,0,0,79,79,
Oklahoma,U.S. House,Tom Guild,DEM,550109,0,0,49,49,05
Oklahoma,U.S. House,Al Mcaffrey,DEM,550109,0,0,40,40,05
Oklahoma,U.S. House,Leona Leonard,DEM,550109,0,0,21,21,05
Oklahoma,State House,Mike Shelton,DEM,550109,0,0,93,93,97
Oklahoma,State House,Bruce Fisher,DEM,550109,0,0,25,25,97
Oklahoma,Governor,Dax Ewbank,REP,550109,0,0,31,31,
Oklahoma,Governor,Chad Moody,REP,550109,0,0,56,56,
Oklahoma,Governor,Mary Fallin,REP,550109,0,0,375,375,
Oklahoma,Superintendent of Public Instruction,Brian Kelly,REP,550109,0,0,59,59,
Oklahoma,Superintendent of Public Instruction,Janet Costello Barresi,REP,550109,0,0,160,160,
Oklahoma,Superintendent of Public Instruction,Joy Hofmeister,REP,550109,0,0,231,231,
Oklahoma,Insurance Commissioner,Bill Viner,REP,550109,0,0,79,79,
Oklahoma,Insurance Commissioner,John Doak,REP,550109,0,0,331,331,
Oklahoma,Corporation Commissioner,Todd Hiett,REP,550109,0,0,183,183,
Oklahoma,Corporation Commissioner,Cliff Branan,REP,550109,0,0,219,219,
Oklahoma,U.S. Senate,Evelyn Rogers,REP,550109,0,0,16,16,
Oklahoma,U.S. Senate,Rob Moye,REP,550109,0,0,9,9,
Oklahoma,U.S. Senate,D. Jean Mcbride-Samuels,REP,550109,0,0,3,3,
Oklahoma,U.S. Senate,Jim Inhofe,REP,550109,0,0,411,411,
Oklahoma,U.S. Senate,Erick Paul Wyatt,REP,550109,0,0,16,16,
Oklahoma,U.S. Senate,Andy Craig,REP,550109,0,0,3,3,
Oklahoma,U.S. Senate,T. Shannon,REP,550109,0,0,86,86,
Oklahoma,U.S. Senate,Randy Brogdon,REP,550109,0,0,11,11,
Oklahoma,U.S. Senate,Eric Mccray,REP,550109,0,0,2,2,
Oklahoma,U.S. Senate,Kevin Crow,REP,550109,0,0,1,1,
Oklahoma,U.S. Senate,James Lankford,REP,550109,0,0,363,363,
Oklahoma,U.S. Senate,Jason Weger,REP,550109,0,0,1,1,
Oklahoma,U.S. House,Shane David Jett,REP,550109,0,0,33,33,05
Oklahoma,U.S. House,Patrice Douglas,REP,550109,0,0,139,139,05
Oklahoma,U.S. House,Mike Turner,REP,550109,0,0,42,42,05
Oklahoma,U.S. House,Steve Russell,REP,550109,0,0,123,123,05
Oklahoma,U.S. House,Harvey Sparks,REP,550109,0,0,15,15,05
Oklahoma,U.S. House,Clark Jolley,REP,550109,0,0,97,97,05
Oklahoma,Superintendent of Public Instruction,John Cox,DEM,550110,0,0,2,2,
Oklahoma,Superintendent of Public Instruction,Jack Jr.,DEM,550110,0,0,0,0,
Oklahoma,Superintendent of Public Instruction,Ivan Holmes,DEM,550110,0,0,1,1,
Oklahoma,Superintendent of Public Instruction,Freda Deskin,DEM,550110,0,0,10,10,
Oklahoma,U.S. Senate,Patrick Michael Hayes,DEM,550110,0,0,1,1,
Oklahoma,U.S. Senate,Jim Rogers,DEM,550110,0,0,2,2,
Oklahoma,U.S. Senate,Connie Johnson,DEM,550110,0,0,8,8,
Oklahoma,U.S. House,Tom Guild,DEM,550110,0,0,3,3,05
Oklahoma,U.S. House,Al Mcaffrey,DEM,550110,0,0,7,7,05
Oklahoma,U.S. House,Leona Leonard,DEM,550110,0,0,2,2,05
Oklahoma,State House,Mike Shelton,DEM,550110,0,0,8,8,97
Oklahoma,State House,Bruce Fisher,DEM,550110,0,0,3,3,97
Oklahoma,Governor,Dax Ewbank,REP,550110,0,0,12,12,
Oklahoma,Governor,Chad Moody,REP,550110,0,0,15,15,
Oklahoma,Governor,Mary Fallin,REP,550110,0,0,125,125,
Oklahoma,Superintendent of Public Instruction,Brian Kelly,REP,550110,0,0,19,19,
Oklahoma,Superintendent of Public Instruction,Janet Costello Barresi,REP,550110,0,0,60,60,
Oklahoma,Superintendent of Public Instruction,Joy Hofmeister,REP,550110,0,0,66,66,
Oklahoma,Insurance Commissioner,Bill Viner,REP,550110,0,0,23,23,
Oklahoma,Insurance Commissioner,John Doak,REP,550110,0,0,109,109,
Oklahoma,Corporation Commissioner,Todd Hiett,REP,550110,0,0,57,57,
Oklahoma,Corporation Commissioner,Cliff Branan,REP,550110,0,0,81,81,
Oklahoma,U.S. Senate,Evelyn Rogers,REP,550110,0,0,2,2,
Oklahoma,U.S. Senate,Rob Moye,REP,550110,0,0,2,2,
Oklahoma,U.S. Senate,D. Jean Mcbride-Samuels,REP,550110,0,0,2,2,
Oklahoma,U.S. Senate,Jim Inhofe,REP,550110,0,0,137,137,
Oklahoma,U.S. Senate,Erick Paul Wyatt,REP,550110,0,0,3,3,
Oklahoma,U.S. Senate,Andy Craig,REP,550110,0,0,1,1,
Oklahoma,U.S. Senate,T. Shannon,REP,550110,0,0,33,33,
Oklahoma,U.S. Senate,Randy Brogdon,REP,550110,0,0,0,0,
Oklahoma,U.S. Senate,Eric Mccray,REP,550110,0,0,0,0,
Oklahoma,U.S. Senate,Kevin Crow,REP,550110,0,0,0,0,
Oklahoma,U.S. Senate,James Lankford,REP,550110,0,0,119,119,
Oklahoma,U.S. Senate,Jason Weger,REP,550110,0,0,1,1,
Oklahoma,U.S. House,Shane David Jett,REP,550110,0,0,6,6,05
Oklahoma,U.S. House,Patrice Douglas,REP,550110,0,0,55,55,05
Oklahoma,U.S. House,Mike Turner,REP,550110,0,0,16,16,05
Oklahoma,U.S. House,Steve Russell,REP,550110,0,0,29,29,05
Oklahoma,U.S. House,Harvey Sparks,REP,550110,0,0,0,0,05
Oklahoma,U.S. House,Clark Jolley,REP,550110,0,0,43,43,05
Oklahoma,Superintendent of Public Instruction,John Cox,DEM,550111,0,0,36,36,
Oklahoma,Superintendent of Public Instruction,Jack Jr.,DEM,550111,0,0,20,20,
Oklahoma,Superintendent of Public Instruction,Ivan Holmes,DEM,550111,0,0,2,2,
Oklahoma,Superintendent of Public Instruction,Freda Deskin,DEM,550111,0,0,51,51,
Oklahoma,U.S. Senate,Patrick Michael Hayes,DEM,550111,0,0,8,8,
Oklahoma,U.S. Senate,Jim Rogers,DEM,550111,0,0,23,23,
Oklahoma,U.S. Senate,Connie Johnson,DEM,550111,0,0,74,74,
Oklahoma,U.S. House,Tom Guild,DEM,550111,0,0,48,48,05
Oklahoma,U.S. House,Al Mcaffrey,DEM,550111,0,0,41,41,05
Oklahoma,U.S. House,Leona Leonard,DEM,550111,0,0,19,19,05
Oklahoma,Governor,Dax Ewbank,REP,550111,0,0,31,31,
Oklahoma,Governor,Chad Moody,REP,550111,0,0,70,70,
Oklahoma,Governor,Mary Fallin,REP,550111,0,0,378,378,
Oklahoma,Superintendent of Public Instruction,Brian Kelly,REP,550111,0,0,70,70,
Oklahoma,Superintendent of Public Instruction,Janet Costello Barresi,REP,550111,0,0,149,149,
Oklahoma,Superintendent of Public Instruction,Joy Hofmeister,REP,550111,0,0,251,251,
Oklahoma,Insurance Commissioner,Bill Viner,REP,550111,0,0,73,73,
Oklahoma,Insurance Commissioner,John Doak,REP,550111,0,0,359,359,
Oklahoma,Corporation Commissioner,Todd Hiett,REP,550111,0,0,201,201,
Oklahoma,Corporation Commissioner,Cliff Branan,REP,550111,0,0,223,223,
Oklahoma,U.S. Senate,Evelyn Rogers,REP,550111,0,0,26,26,
Oklahoma,U.S. Senate,Rob Moye,REP,550111,0,0,5,5,
Oklahoma,U.S. Senate,D. Jean Mcbride-Samuels,REP,550111,0,0,5,5,
Oklahoma,U.S. Senate,Jim Inhofe,REP,550111,0,0,421,421,
Oklahoma,U.S. Senate,Erick Paul Wyatt,REP,550111,0,0,14,14,
Oklahoma,U.S. Senate,Andy Craig,REP,550111,0,0,1,1,
Oklahoma,U.S. Senate,T. Shannon,REP,550111,0,0,100,100,
Oklahoma,U.S. Senate,Randy Brogdon,REP,550111,0,0,9,9,
Oklahoma,U.S. Senate,Eric Mccray,REP,550111,0,0,1,1,
Oklahoma,U.S. Senate,Kevin Crow,REP,550111,0,0,1,1,
Oklahoma,U.S. Senate,James Lankford,REP,550111,0,0,373,373,
Oklahoma,U.S. Senate,Jason Weger,REP,550111,0,0,1,1,
Oklahoma,U.S. House,Shane David Jett,REP,550111,0,0,22,22,05
Oklahoma,U.S. House,Patrice Douglas,REP,550111,0,0,147,147,05
Oklahoma,U.S. House,Mike Turner,REP,550111,0,0,40,40,05
Oklahoma,U.S. House,Steve Russell,REP,550111,0,0,111,111,05
Oklahoma,U.S. House,Harvey Sparks,REP,550111,0,0,15,15,05
Oklahoma,U.S. House,Clark Jolley,REP,550111,0,0,142,142,05
Oklahoma,Superintendent of Public Instruction,John Cox,DEM,550112,0,0,4,4,
Oklahoma,Superintendent of Public Instruction,Jack Jr.,DEM,550112,0,0,2,2,
Oklahoma,Superintendent of Public Instruction,Ivan Holmes,DEM,550112,0,0,2,2,
Oklahoma,Superintendent of Public Instruction,Freda Deskin,DEM,550112,0,0,17,17,
Oklahoma,U.S. Senate,Patrick Michael Hayes,DEM,550112,0,0,3,3,
Oklahoma,U.S. Senate,Jim Rogers,DEM,550112,0,0,1,1,
Oklahoma,U.S. Senate,Connie Johnson,DEM,550112,0,0,21,21,
Oklahoma,U.S. House,Tom Guild,DEM,550112,0,0,6,6,05
Oklahoma,U.S. House,Al Mcaffrey,DEM,550112,0,0,10,10,05
Oklahoma,U.S. House,Leona Leonard,DEM,550112,0,0,8,8,05
Oklahoma,State Senate,Christine Byrd,DEM,550112,0,0,11,11,48
Oklahoma,State Senate,Anastasia Pittman,DEM,550112,0,0,14,14,48
Oklahoma,State House,Mike Shelton,DEM,550112,0,0,22,22,97
Oklahoma,State House,Bruce Fisher,DEM,550112,0,0,3,3,97
Oklahoma,Governor,Dax Ewbank,REP,550112,0,0,8,8,
Oklahoma,Governor,Chad Moody,REP,550112,0,0,4,4,
Oklahoma,Governor,Mary Fallin,REP,550112,0,0,36,36,
Oklahoma,Superintendent of Public Instruction,Brian Kelly,REP,550112,0,0,9,9,
Oklahoma,Superintendent of Public Instruction,Janet Costello Barresi,REP,550112,0,0,14,14,
Oklahoma,Superintendent of Public Instruction,Joy Hofmeister,REP,550112,0,0,23,23,
Oklahoma,Insurance Commissioner,Bill Viner,REP,550112,0,0,10,10,
Oklahoma,Insurance Commissioner,John Doak,REP,550112,0,0,31,31,
Oklahoma,Corporation Commissioner,Todd Hiett,REP,550112,0,0,32,32,
Oklahoma,Corporation Commissioner,Cliff Branan,REP,550112,0,0,14,14,
Oklahoma,U.S. Senate,Evelyn Rogers,REP,550112,0,0,0,0,
Oklahoma,U.S. Senate,Rob Moye,REP,550112,0,0,2,2,
Oklahoma,U.S. Senate,D. Jean Mcbride-Samuels,REP,550112,0,0,0,0,
Oklahoma,U.S. Senate,Jim Inhofe,REP,550112,0,0,42,42,
Oklahoma,U.S. Senate,Erick Paul Wyatt,REP,550112,0,0,2,2,
Oklahoma,U.S. Senate,Andy Craig,REP,550112,0,0,0,0,
Oklahoma,U.S. Senate,T. Shannon,REP,550112,0,0,5,5,
Oklahoma,U.S. Senate,Randy Brogdon,REP,550112,0,0,3,3,
Oklahoma,U.S. Senate,Eric Mccray,REP,550112,0,0,0,0,
Oklahoma,U.S. Senate,Kevin Crow,REP,550112,0,0,0,0,
Oklahoma,U.S. Senate,James Lankford,REP,550112,0,0,40,40,
Oklahoma,U.S. Senate,Jason Weger,REP,550112,0,0,0,0,
Oklahoma,U.S. House,Shane David Jett,REP,550112,0,0,2,2,05
Oklahoma,U.S. House,Patrice Douglas,REP,550112,0,0,13,13,05
Oklahoma,U.S. House,Mike Turner,REP,550112,0,0,2,2,05
Oklahoma,U.S. House,Steve Russell,REP,550112,0,0,19,19,05
Oklahoma,U.S. House,Harvey Sparks,REP,550112,0,0,4,4,05
Oklahoma,U.S. House,Clark Jolley,REP,550112,0,0,8,8,05
Oklahoma,Superintendent of Public Instruction,John Cox,DEM,550113,0,0,11,11,
Oklahoma,Superintendent of Public Instruction,Jack Jr.,DEM,550113,0,0,1,1,
Oklahoma,Superintendent of Public Instruction,Ivan Holmes,DEM,550113,0,0,5,5,
Oklahoma,Superintendent of Public Instruction,Freda Deskin,DEM,550113,0,0,29,29,
Oklahoma,U.S. Senate,Patrick Michael Hayes,DEM,550113,0,0,4,4,
Oklahoma,U.S. Senate,Jim Rogers,DEM,550113,0,0,3,3,
Oklahoma,U.S. Senate,Connie Johnson,DEM,550113,0,0,38,38,
Oklahoma,U.S. House,Tom Guild,DEM,550113,0,0,15,15,05
Oklahoma,U.S. House,Al Mcaffrey,DEM,550113,0,0,17,17,05
Oklahoma,U.S. House,Leona Leonard,DEM,550113,0,0,13,13,05
Oklahoma,State Senate,Christine Byrd,DEM,550113,0,0,8,8,48
Oklahoma,State Senate,Anastasia Pittman,DEM,550113,0,0,35,35,48
Oklahoma,State House,Mike Shelton,DEM,550113,0,0,41,41,97
Oklahoma,State House,Bruce Fisher,DEM,550113,0,0,6,6,97
Oklahoma,Governor,Dax Ewbank,REP,550113,0,0,7,7,
Oklahoma,Governor,Chad Moody,REP,550113,0,0,8,8,
Oklahoma,Governor,Mary Fallin,REP,550113,0,0,46,46,
Oklahoma,Superintendent of Public Instruction,Brian Kelly,REP,550113,0,0,14,14,
Oklahoma,Superintendent of Public Instruction,Janet Costello Barresi,REP,550113,0,0,16,16,
Oklahoma,Superintendent of Public Instruction,Joy Hofmeister,REP,550113,0,0,29,29,
Oklahoma,Insurance Commissioner,Bill Viner,REP,550113,0,0,8,8,
Oklahoma,Insurance Commissioner,John Doak,REP,550113,0,0,46,46,
Oklahoma,Corporation Commissioner,Todd Hiett,REP,550113,0,0,21,21,
Oklahoma,Corporation Commissioner,Cliff Branan,REP,550113,0,0,35,35,
Oklahoma,U.S. Senate,Evelyn Rogers,REP,550113,0,0,3,3,
Oklahoma,U.S. Senate,Rob Moye,REP,550113,0,0,2,2,
Oklahoma,U.S. Senate,D. Jean Mcbride-Samuels,REP,550113,0,0,2,2,
Oklahoma,U.S. Senate,Jim Inhofe,REP,550113,0,0,50,50,
Oklahoma,U.S. Senate,Erick Paul Wyatt,REP,550113,0,0,2,2,
Oklahoma,U.S. Senate,Andy Craig,REP,550113,0,0,0,0,
Oklahoma,U.S. Senate,T. Shannon,REP,550113,0,0,14,14,
Oklahoma,U.S. Senate,Randy Brogdon,REP,550113,0,0,2,2,
Oklahoma,U.S. Senate,Eric Mccray,REP,550113,0,0,0,0,
Oklahoma,U.S. Senate,Kevin Crow,REP,550113,0,0,1,1,
Oklahoma,U.S. Senate,James Lankford,REP,550113,0,0,44,44,
Oklahoma,U.S. Senate,Jason Weger,REP,550113,0,0,0,0,
Oklahoma,U.S. House,Shane David Jett,REP,550113,0,0,3,3,05
Oklahoma,U.S. House,Patrice Douglas,REP,550113,0,0,16,16,05
Oklahoma,U.S. House,Mike Turner,REP,550113,0,0,12,12,05
Oklahoma,U.S. House,Steve Russell,REP,550113,0,0,19,19,05
Oklahoma,U.S. House,Harvey Sparks,REP,550113,0,0,2,2,05
Oklahoma,U.S. House,Clark Jolley,REP,550113,0,0,9,9,05
Oklahoma,Superintendent of Public Instruction,John Cox,DEM,550114,0,0,100,100,
Oklahoma,Superintendent of Public Instruction,Jack Jr.,DEM,550114,0,0,32,32,
Oklahoma,Superintendent of Public Instruction,Ivan Holmes,DEM,550114,0,0,51,51,
Oklahoma,Superintendent of Public Instruction,Freda Deskin,DEM,550114,0,0,174,174,
Oklahoma,U.S. Senate,Patrick Michael Hayes,DEM,550114,0,0,10,10,
Oklahoma,U.S. Senate,Jim Rogers,DEM,550114,0,0,10,10,
Oklahoma,U.S. Senate,Connie Johnson,DEM,550114,0,0,358,358,
Oklahoma,U.S. House,Tom Guild,DEM,550114,0,0,153,153,05
Oklahoma,U.S. House,Al Mcaffrey,DEM,550114,0,0,63,63,05
Oklahoma,U.S. House,Leona Leonard,DEM,550114,0,0,138,138,05
Oklahoma,State Senate,Christine Byrd,DEM,550114,0,0,56,56,48
Oklahoma,State Senate,Anastasia Pittman,DEM,550114,0,0,329,329,48
Oklahoma,State House,Mike Shelton,DEM,550114,0,0,312,312,97
Oklahoma,State House,Bruce Fisher,DEM,550114,0,0,74,74,97
Oklahoma,Governor,Dax Ewbank,REP,550114,0,0,2,2,
Oklahoma,Governor,Chad Moody,REP,550114,0,0,3,3,
Oklahoma,Governor,Mary Fallin,REP,550114,0,0,22,22,
Oklahoma,Superintendent of Public Instruction,Brian Kelly,REP,550114,0,0,1,1,
Oklahoma,Superintendent of Public Instruction,Janet Costello Barresi,REP,550114,0,0,10,10,
Oklahoma,Superintendent of Public Instruction,Joy Hofmeister,REP,550114,0,0,17,17,
Oklahoma,Insurance Commissioner,Bill Viner,REP,550114,0,0,5,5,
Oklahoma,Insurance Commissioner,John Doak,REP,550114,0,0,22,22,
Oklahoma,Corporation Commissioner,Todd Hiett,REP,550114,0,0,12,12,
Oklahoma,Corporation Commissioner,Cliff Branan,REP,550114,0,0,11,11,
Oklahoma,U.S. Senate,Evelyn Rogers,REP,550114,0,0,2,2,
Oklahoma,U.S. Senate,Rob Moye,REP,550114,0,0,0,0,
Oklahoma,U.S. Senate,D. Jean Mcbride-Samuels,REP,550114,0,0,1,1,
Oklahoma,U.S. Senate,Jim Inhofe,REP,550114,0,0,23,23,
Oklahoma,U.S. Senate,Erick Paul Wyatt,REP,550114,0,0,1,1,
Oklahoma,U.S. Senate,Andy Craig,REP,550114,0,0,0,0,
Oklahoma,U.S. Senate,T. Shannon,REP,550114,0,0,9,9,
Oklahoma,U.S. Senate,Randy Brogdon,REP,550114,0,0,1,1,
Oklahoma,U.S. Senate,Eric Mccray,REP,550114,0,0,1,1,
Oklahoma,U.S. Senate,Kevin Crow,REP,550114,0,0,0,0,
Oklahoma,U.S. Senate,James Lankford,REP,550114,0,0,16,16,
Oklahoma,U.S. Senate,Jason Weger,REP,550114,0,0,1,1,
Oklahoma,U.S. House,Shane David Jett,REP,550114,0,0,3,3,05
Oklahoma,U.S. House,Patrice Douglas,REP,550114,0,0,6,6,05
Oklahoma,U.S. House,Mike Turner,REP,550114,0,0,6,6,05
Oklahoma,U.S. House,Steve Russell,REP,550114,0,0,7,7,05
Oklahoma,U.S. House,Harvey Sparks,REP,550114,0,0,0,0,05
Oklahoma,U.S. House,Clark Jolley,REP,550114,0,0,5,5,05
Oklahoma,Superintendent of Public Instruction,John Cox,DEM,550115,0,0,126,126,
Oklahoma,Superintendent of Public Instruction,Jack Jr.,DEM,550115,0,0,39,39,
Oklahoma,Superintendent of Public Instruction,Ivan Holmes,DEM,550115,0,0,66,66,
Oklahoma,Superintendent of Public Instruction,Freda Deskin,DEM,550115,0,0,181,181,
Oklahoma,U.S. Senate,Patrick Michael Hayes,DEM,550115,0,0,14,14,
Oklahoma,U.S. Senate,Jim Rogers,DEM,550115,0,0,11,11,
Oklahoma,U.S. Senate,Connie Johnson,DEM,550115,0,0,415,415,
Oklahoma,U.S. House,Tom Guild,DEM,550115,0,0,131,131,05
Oklahoma,U.S. House,Al Mcaffrey,DEM,550115,0,0,65,65,05
Oklahoma,U.S. House,Leona Leonard,DEM,550115,0,0,200,200,05
Oklahoma,State Senate,Christine Byrd,DEM,550115,0,0,52,52,48
Oklahoma,State Senate,Anastasia Pittman,DEM,550115,0,0,392,392,48
Oklahoma,State House,Mike Shelton,DEM,550115,0,0,362,362,97
Oklahoma,State House,Bruce Fisher,DEM,550115,0,0,85,85,97
Oklahoma,Governor,Dax Ewbank,REP,550115,0,0,6,6,
Oklahoma,Governor,Chad Moody,REP,550115,0,0,6,6,
Oklahoma,Governor,Mary Fallin,REP,550115,0,0,3,3,
Oklahoma,Superintendent of Public Instruction,Brian Kelly,REP,550115,0,0,4,4,
Oklahoma,Superintendent of Public Instruction,Janet Costello Barresi,REP,550115,0,0,3,3,
Oklahoma,Superintendent of Public Instruction,Joy Hofmeister,REP,550115,0,0,7,7,
Oklahoma,Insurance Commissioner,Bill Viner,REP,550115,0,0,4,4,
Oklahoma,Insurance Commissioner,John Doak,REP,550115,0,0,11,11,
Oklahoma,Corporation Commissioner,Todd Hiett,REP,550115,0,0,11,11,
Oklahoma,Corporation Commissioner,Cliff Branan,REP,550115,0,0,3,3,
Oklahoma,U.S. Senate,Evelyn Rogers,REP,550115,0,0,4,4,
Oklahoma,U.S. Senate,Rob Moye,REP,550115,0,0,0,0,
Oklahoma,U.S. Senate,D. Jean Mcbride-Samuels,REP,550115,0,0,1,1,
Oklahoma,U.S. Senate,Jim Inhofe,REP,550115,0,0,9,9,
Oklahoma,U.S. Senate,Erick Paul Wyatt,REP,550115,0,0,0,0,
Oklahoma,U.S. Senate,Andy Craig,REP,550115,0,0,1,1,
Oklahoma,U.S. Senate,T. Shannon,REP,550115,0,0,2,2,
Oklahoma,U.S. Senate,Randy Brogdon,REP,550115,0,0,3,3,
Oklahoma,U.S. Senate,Eric Mccray,REP,550115,0,0,0,0,
Oklahoma,U.S. Senate,Kevin Crow,REP,550115,0,0,1,1,
Oklahoma,U.S. Senate,James Lankford,REP,550115,0,0,8,8,
Oklahoma,U.S. Senate,Jason Weger,REP,550115,0,0,0,0,
Oklahoma,U.S. House,Shane David Jett,REP,550115,0,0,2,2,05
Oklahoma,U.S. House,Patrice Douglas,REP,550115,0,0,2,2,05
Oklahoma,U.S. House,Mike Turner,REP,550115,0,0,7,7,05
Oklahoma,U.S. House,Steve Russell,REP,550115,0,0,1,1,05
Oklahoma,U.S. House,Harvey Sparks,REP,550115,0,0,2,2,05
Oklahoma,U.S. House,Clark Jolley,REP,550115,0,0,1,1,05
Oklahoma,Superintendent of Public Instruction,John Cox,DEM,550116,0,0,9,9,
Oklahoma,Superintendent of Public Instruction,Jack Jr.,DEM,550116,0,0,10,10,
Oklahoma,Superintendent of Public Instruction,Ivan Holmes,DEM,550116,0,0,1,1,
Oklahoma,Superintendent of Public Instruction,Freda Deskin,DEM,550116,0,0,34,34,
Oklahoma,U.S. Senate,Patrick Michael Hayes,DEM,550116,0,0,6,6,
Oklahoma,U.S. Senate,Jim Rogers,DEM,550116,0,0,4,4,
Oklahoma,U.S. Senate,Connie Johnson,DEM,550116,0,0,39,39,
Oklahoma,U.S. House,Tom Guild,DEM,550116,0,0,14,14,05
Oklahoma,U.S. House,Al Mcaffrey,DEM,550116,0,0,27,27,05
Oklahoma,U.S. House,Leona Leonard,DEM,550116,0,0,8,8,05
Oklahoma,State Senate,Christine Byrd,DEM,550116,0,0,4,4,48
Oklahoma,State Senate,Anastasia Pittman,DEM,550116,0,0,50,50,48
Oklahoma,State House,Steve Davis,DEM,550116,0,0,9,9,99
Oklahoma,State House,Eleanor Darden Thompson,DEM,550116,0,0,31,31,99
Oklahoma,State House,George Young,DEM,550116,0,0,10,10,99
Oklahoma,Governor,Dax Ewbank,REP,550116,0,0,5,5,
Oklahoma,Governor,Chad Moody,REP,550116,0,0,11,11,
Oklahoma,Governor,Mary Fallin,REP,550116,0,0,36,36,
Oklahoma,Superintendent of Public Instruction,Brian Kelly,REP,550116,0,0,12,12,
Oklahoma,Superintendent of Public Instruction,Janet Costello Barresi,REP,550116,0,0,15,15,
Oklahoma,Superintendent of Public Instruction,Joy Hofmeister,REP,550116,0,0,23,23,
Oklahoma,Insurance Commissioner,Bill Viner,REP,550116,0,0,7,7,
Oklahoma,Insurance Commissioner,John Doak,REP,550116,0,0,37,37,
Oklahoma,Corporation Commissioner,Todd Hiett,REP,550116,0,0,18,18,
Oklahoma,Corporation Commissioner,Cliff Branan,REP,550116,0,0,30,30,
Oklahoma,U.S. Senate,Evelyn Rogers,REP,550116,0,0,1,1,
Oklahoma,U.S. Senate,Rob Moye,REP,550116,0,0,2,2,
Oklahoma,U.S. Senate,D. Jean Mcbride-Samuels,REP,550116,0,0,0,0,
Oklahoma,U.S. Senate,Jim Inhofe,REP,550116,0,0,44,44,
Oklahoma,U.S. Senate,Erick Paul Wyatt,REP,550116,0,0,5,5,
Oklahoma,U.S. Senate,Andy Craig,REP,550116,0,0,0,0,
Oklahoma,U.S. Senate,T. Shannon,REP,550116,0,0,16,16,
Oklahoma,U.S. Senate,Randy Brogdon,REP,550116,0,0,0,0,
Oklahoma,U.S. Senate,Eric Mccray,REP,550116,0,0,0,0,
Oklahoma,U.S. Senate,Kevin Crow,REP,550116,0,0,2,2,
Oklahoma,U.S. Senate,James Lankford,REP,550116,0,0,33,33,
Oklahoma,U.S. Senate,Jason Weger,REP,550116,0,0,1,1,
Oklahoma,U.S. House,Shane David Jett,REP,550116,0,0,4,4,05
Oklahoma,U.S. House,Patrice Douglas,REP,550116,0,0,12,12,05
Oklahoma,U.S. House,Mike Turner,REP,550116,0,0,8,8,05
Oklahoma,U.S. House,Steve Russell,REP,550116,0,0,14,14,05
Oklahoma,U.S. House,Harvey Sparks,REP,550116,0,0,6,6,05
Oklahoma,U.S. House,Clark Jolley,REP,550116,0,0,7,7,05
Oklahoma,Superintendent of Public Instruction,John Cox,DEM,550117,0,0,129,129,
Oklahoma,Superintendent of Public Instruction,Jack Jr.,DEM,550117,0,0,40,40,
Oklahoma,Superintendent of Public Instruction,Ivan Holmes,DEM,550117,0,0,60,60,
Oklahoma,Superintendent of Public Instruction,Freda Deskin,DEM,550117,0,0,230,230,
Oklahoma,U.S. Senate,Patrick Michael Hayes,DEM,550117,0,0,13,13,
Oklahoma,U.S. Senate,Jim Rogers,DEM,550117,0,0,20,20,
Oklahoma,U.S. Senate,Connie Johnson,DEM,550117,0,0,454,454,
Oklahoma,U.S. House,Tom Guild,DEM,550117,0,0,212,212,05
Oklahoma,U.S. House,Al Mcaffrey,DEM,550117,0,0,85,85,05
Oklahoma,U.S. House,Leona Leonard,DEM,550117,0,0,154,154,05
Oklahoma,State Senate,Christine Byrd,DEM,550117,0,0,70,70,48
Oklahoma,State Senate,Anastasia Pittman,DEM,550117,0,0,416,416,48
Oklahoma,State House,Mike Shelton,DEM,550117,0,0,421,421,97
Oklahoma,State House,Bruce Fisher,DEM,550117,0,0,71,71,97
Oklahoma,Governor,Dax Ewbank,REP,550117,0,0,2,2,
Oklahoma,Governor,Chad Moody,REP,550117,0,0,10,10,
Oklahoma,Governor,Mary Fallin,REP,550117,0,0,37,37,
Oklahoma,Superintendent of Public Instruction,Brian Kelly,REP,550117,0,0,12,12,
Oklahoma,Superintendent of Public Instruction,Janet Costello Barresi,REP,550117,0,0,18,18,
Oklahoma,Superintendent of Public Instruction,Joy Hofmeister,REP,550117,0,0,19,19,
Oklahoma,Insurance Commissioner,Bill Viner,REP,550117,0,0,12,12,
Oklahoma,Insurance Commissioner,John Doak,REP,550117,0,0,29,29,
Oklahoma,Corporation Commissioner,Todd Hiett,REP,550117,0,0,23,23,
Oklahoma,Corporation Commissioner,Cliff Branan,REP,550117,0,0,20,20,
Oklahoma,U.S. Senate,Evelyn Rogers,REP,550117,0,0,2,2,
Oklahoma,U.S. Senate,Rob Moye,REP,550117,0,0,0,0,
Oklahoma,U.S. Senate,D. Jean Mcbride-Samuels,REP,550117,0,0,0,0,
Oklahoma,U.S. Senate,Jim Inhofe,REP,550117,0,0,37,37,
Oklahoma,U.S. Senate,Erick Paul Wyatt,REP,550117,0,0,4,4,
Oklahoma,U.S. Senate,Andy Craig,REP,550117,0,0,0,0,
Oklahoma,U.S. Senate,T. Shannon,REP,550117,0,0,15,15,
Oklahoma,U.S. Senate,Randy Brogdon,REP,550117,0,0,0,0,
Oklahoma,U.S. Senate,Eric Mccray,REP,550117,0,0,1,1,
Oklahoma,U.S. Senate,Kevin Crow,REP,550117,0,0,1,1,
Oklahoma,U.S. Senate,James Lankford,REP,550117,0,0,32,32,
Oklahoma,U.S. Senate,Jason Weger,REP,550117,0,0,0,0,
Oklahoma,U.S. House,Shane David Jett,REP,550117,0,0,3,3,05
Oklahoma,U.S. House,Patrice Douglas,REP,550117,0,0,12,12,05
Oklahoma,U.S. House,Mike Turner,REP,550117,0,0,9,9,05
Oklahoma,U.S. House,Steve Russell,REP,550117,0,0,11,11,05
Oklahoma,U.S. House,Harvey Sparks,REP,550117,0,0,4,4,05
Oklahoma,U.S. House,Clark Jolley,REP,550117,0,0,4,4,05
Oklahoma,Superintendent of Public Instruction,John Cox,DEM,550118,0,0,71,71,
Oklahoma,Superintendent of Public Instruction,Jack Jr.,DEM,550118,0,0,26,26,
Oklahoma,Superintendent of Public Instruction,Ivan Holmes,DEM,550118,0,0,35,35,
Oklahoma,Superintendent of Public Instruction,Freda Deskin,DEM,550118,0,0,99,99,
Oklahoma,U.S. Senate,Patrick Michael Hayes,DEM,550118,0,0,16,16,
Oklahoma,U.S. Senate,Jim Rogers,DEM,550118,0,0,20,20,
Oklahoma,U.S. Senate,Connie Johnson,DEM,550118,0,0,200,200,
Oklahoma,U.S. House,Tom Guild,DEM,550118,0,0,107,107,05
Oklahoma,U.S. House,Al Mcaffrey,DEM,550118,0,0,44,44,05
Oklahoma,U.S. House,Leona Leonard,DEM,550118,0,0,69,69,05
Oklahoma,State Senate,Christine Byrd,DEM,550118,0,0,42,42,48
Oklahoma,State Senate,Anastasia Pittman,DEM,550118,0,0,198,198,48
Oklahoma,State House,Steve Davis,DEM,550118,0,0,83,83,99
Oklahoma,State House,Eleanor Darden Thompson,DEM,550118,0,0,47,47,99
Oklahoma,State House,George Young,DEM,550118,0,0,102,102,99
Oklahoma,Governor,Dax Ewbank,REP,550118,0,0,11,11,
Oklahoma,Governor,Chad Moody,REP,550118,0,0,21,21,
Oklahoma,Governor,Mary Fallin,REP,550118,0,0,42,42,
Oklahoma,Superintendent of Public Instruction,Brian Kelly,REP,550118,0,0,18,18,
Oklahoma,Superintendent of Public Instruction,Janet Costello Barresi,REP,550118,0,0,13,13,
Oklahoma,Superintendent of Public Instruction,Joy Hofmeister,REP,550118,0,0,39,39,
Oklahoma,Insurance Commissioner,Bill Viner,REP,550118,0,0,22,22,
Oklahoma,Insurance Commissioner,John Doak,REP,550118,0,0,45,45,
Oklahoma,Corporation Commissioner,Todd Hiett,REP,550118,0,0,24,24,
Oklahoma,Corporation Commissioner,Cliff Branan,REP,550118,0,0,42,42,
Oklahoma,U.S. Senate,Evelyn Rogers,REP,550118,0,0,3,3,
Oklahoma,U.S. Senate,Rob Moye,REP,550118,0,0,4,4,
Oklahoma,U.S. Senate,D. Jean Mcbride-Samuels,REP,550118,0,0,1,1,
Oklahoma,U.S. Senate,Jim Inhofe,REP,550118,0,0,58,58,
Oklahoma,U.S. Senate,Erick Paul Wyatt,REP,550118,0,0,7,7,
Oklahoma,U.S. Senate,Andy Craig,REP,550118,0,0,1,1,
Oklahoma,U.S. Senate,T. Shannon,REP,550118,0,0,22,22,
Oklahoma,U.S. Senate,Randy Brogdon,REP,550118,0,0,2,2,
Oklahoma,U.S. Senate,Eric Mccray,REP,550118,0,0,2,2,
Oklahoma,U.S. Senate,Kevin Crow,REP,550118,0,0,1,1,
Oklahoma,U.S. Senate,James Lankford,REP,550118,0,0,44,44,
Oklahoma,U.S. Senate,Jason Weger,REP,550118,0,0,1,1,
Oklahoma,U.S. House,Shane David Jett,REP,550118,0,0,7,7,05
Oklahoma,U.S. House,Patrice Douglas,REP,550118,0,0,17,17,05
Oklahoma,U.S. House,Mike Turner,REP,550118,0,0,11,11,05
Oklahoma,U.S. House,Steve Russell,REP,550118,0,0,24,24,05
Oklahoma,U.S. House,Harvey Sparks,REP,550118,0,0,2,2,05
Oklahoma,U.S. House,Clark Jolley,REP,550118,0,0,8,8,05
Oklahoma,Superintendent of Public Instruction,John Cox,DEM,550119,0,0,3,3,
Oklahoma,Superintendent of Public Instruction,Jack Jr.,DEM,550119,0,0,5,5,
Oklahoma,Superintendent of Public Instruction,Ivan Holmes,DEM,550119,0,0,1,1,
Oklahoma,Superintendent of Public Instruction,Freda Deskin,DEM,550119,0,0,15,15,
Oklahoma,U.S. Senate,Patrick Michael Hayes,DEM,550119,0,0,4,4,
Oklahoma,U.S. Senate,Jim Rogers,DEM,550119,0,0,4,4,
Oklahoma,U.S. Senate,Connie Johnson,DEM,550119,0,0,16,16,
Oklahoma,U.S. House,Tom Guild,DEM,550119,0,0,9,9,05
Oklahoma,U.S. House,Al Mcaffrey,DEM,550119,0,0,12,12,05
Oklahoma,U.S. House,Leona Leonard,DEM,550119,0,0,2,2,05
Oklahoma,Governor,Dax Ewbank,REP,550119,0,0,4,4,
Oklahoma,Governor,Chad Moody,REP,550119,0,0,4,4,
Oklahoma,Governor,Mary Fallin,REP,550119,0,0,49,49,
Oklahoma,Superintendent of Public Instruction,Brian Kelly,REP,550119,0,0,6,6,
Oklahoma,Superintendent of Public Instruction,Janet Costello Barresi,REP,550119,0,0,32,32,
Oklahoma,Superintendent of Public Instruction,Joy Hofmeister,REP,550119,0,0,17,17,
Oklahoma,Insurance Commissioner,Bill Viner,REP,550119,0,0,5,5,
Oklahoma,Insurance Commissioner,John Doak,REP,550119,0,0,46,46,
Oklahoma,Corporation Commissioner,Todd Hiett,REP,550119,0,0,10,10,
Oklahoma,Corporation Commissioner,Cliff Branan,REP,550119,0,0,46,46,
Oklahoma,U.S. Senate,Evelyn Rogers,REP,550119,0,0,1,1,
Oklahoma,U.S. Senate,Rob Moye,REP,550119,0,0,1,1,
Oklahoma,U.S. Senate,D. Jean Mcbride-Samuels,REP,550119,0,0,1,1,
Oklahoma,U.S. Senate,Jim Inhofe,REP,550119,0,0,53,53,
Oklahoma,U.S. Senate,Erick Paul Wyatt,REP,550119,0,0,0,0,
Oklahoma,U.S. Senate,Andy Craig,REP,550119,0,0,1,1,
Oklahoma,U.S. Senate,T. Shannon,REP,550119,0,0,18,18,
Oklahoma,U.S. Senate,Randy Brogdon,REP,550119,0,0,2,2,
Oklahoma,U.S. Senate,Eric Mccray,REP,550119,0,0,0,0,
Oklahoma,U.S. Senate,Kevin Crow,REP,550119,0,0,0,0,
Oklahoma,U.S. Senate,James Lankford,REP,550119,0,0,38,38,
Oklahoma,U.S. Senate,Jason Weger,REP,550119,0,0,0,0,
Oklahoma,U.S. House,Shane David Jett,REP,550119,0,0,5,5,05
Oklahoma,U.S. House,Patrice Douglas,REP,550119,0,0,14,14,05
Oklahoma,U.S. House,Mike Turner,REP,550119,0,0,2,2,05
Oklahoma,U.S. House,Steve Russell,REP,550119,0,0,23,23,05
Oklahoma,U.S. House,Harvey Sparks,REP,550119,0,0,3,3,05
Oklahoma,U.S. House,Clark Jolley,REP,550119,0,0,7,7,05
Oklahoma,State Senate,Ervin Yen,REP,550119,0,0,28,28,40
Oklahoma,State Senate,Joe Howell,REP,550119,0,0,9,9,40
Oklahoma,State Senate,Michael Taylor,REP,550119,0,0,3,3,40
Oklahoma,State Senate,Brian Winslow,REP,550119,0,0,4,4,40
Oklahoma,State Senate,Steve Kern,REP,550119,0,0,1,1,40
Oklahoma,State Senate,David Hooten,REP,550119,0,0,12,12,40
Oklahoma,Superintendent of Public Instruction,John Cox,DEM,550120,0,0,30,30,
Oklahoma,Superintendent of Public Instruction,Jack Jr.,DEM,550120,0,0,21,21,
Oklahoma,Superintendent of Public Instruction,Ivan Holmes,DEM,550120,0,0,17,17,
Oklahoma,Superintendent of Public Instruction,Freda Deskin,DEM,550120,0,0,94,94,
Oklahoma,U.S. Senate,Patrick Michael Hayes,DEM,550120,0,0,12,12,
Oklahoma,U.S. Senate,Jim Rogers,DEM,550120,0,0,13,13,
Oklahoma,U.S. Senate,Connie Johnson,DEM,550120,0,0,138,138,
Oklahoma,U.S. House,Tom Guild,DEM,550120,0,0,53,53,05
Oklahoma,U.S. House,Al Mcaffrey,DEM,550120,0,0,21,21,05
Oklahoma,U.S. House,Leona Leonard,DEM,550120,0,0,82,82,05
Oklahoma,State Senate,Christine Byrd,DEM,550120,0,0,28,28,48
Oklahoma,State Senate,Anastasia Pittman,DEM,550120,0,0,136,136,48
Oklahoma,State House,Steve Davis,DEM,550120,0,0,46,46,99
Oklahoma,State House,Eleanor Darden Thompson,DEM,550120,0,0,43,43,99
Oklahoma,State House,George Young,DEM,550120,0,0,74,74,99
Oklahoma,Governor,Dax Ewbank,REP,550120,0,0,9,9,
Oklahoma,Governor,Chad Moody,REP,550120,0,0,13,13,
Oklahoma,Governor,Mary Fallin,REP,550120,0,0,45,45,
Oklahoma,Superintendent of Public Instruction,Brian Kelly,REP,550120,0,0,26,26,
Oklahoma,Superintendent of Public Instruction,Janet Costello Barresi,REP,550120,0,0,14,14,
Oklahoma,Superintendent of Public Instruction,Joy Hofmeister,REP,550120,0,0,29,29,
Oklahoma,Insurance Commissioner,Bill Viner,REP,550120,0,0,12,12,
Oklahoma,Insurance Commissioner,John Doak,REP,550120,0,0,50,50,
Oklahoma,Corporation Commissioner,Todd Hiett,REP,550120,0,0,30,30,
Oklahoma,Corporation Commissioner,Cliff Branan,REP,550120,0,0,32,32,
Oklahoma,U.S. Senate,Evelyn Rogers,REP,550120,0,0,4,4,
Oklahoma,U.S. Senate,Rob Moye,REP,550120,0,0,3,3,
Oklahoma,U.S. Senate,D. Jean Mcbride-Samuels,REP,550120,0,0,1,1,
Oklahoma,U.S. Senate,Jim Inhofe,REP,550120,0,0,55,55,
Oklahoma,U.S. Senate,Erick Paul Wyatt,REP,550120,0,0,3,3,
Oklahoma,U.S. Senate,Andy Craig,REP,550120,0,0,1,1,
Oklahoma,U.S. Senate,T. Shannon,REP,550120,0,0,23,23,
Oklahoma,U.S. Senate,Randy Brogdon,REP,550120,0,0,3,3,
Oklahoma,U.S. Senate,Eric Mccray,REP,550120,0,0,0,0,
Oklahoma,U.S. Senate,Kevin Crow,REP,550120,0,0,4,4,
Oklahoma,U.S. Senate,James Lankford,REP,550120,0,0,39,39,
Oklahoma,U.S. Senate,Jason Weger,REP,550120,0,0,0,0,
Oklahoma,U.S. House,Shane David Jett,REP,550120,0,0,7,7,05
Oklahoma,U.S. House,Patrice Douglas,REP,550120,0,0,15,15,05
Oklahoma,U.S. House,Mike Turner,REP,550120,0,0,11,11,05
Oklahoma,U.S. House,Steve Russell,REP,550120,0,0,24,24,05
Oklahoma,U.S. House,Harvey Sparks,REP,550120,0,0,4,4,05
Oklahoma,U.S. House,Clark Jolley,REP,550120,0,0,8,8,05
Oklahoma,Superintendent of Public Instruction,John Cox,DEM,550121,0,0,66,66,
Oklahoma,Superintendent of Public Instruction,Jack Jr.,DEM,550121,0,0,25,25,
Oklahoma,Superintendent of Public Instruction,Ivan Holmes,DEM,550121,0,0,33,33,
Oklahoma,Superintendent of Public Instruction,Freda Deskin,DEM,550121,0,0,111,111,
Oklahoma,U.S. Senate,Patrick Michael Hayes,DEM,550121,0,0,9,9,
Oklahoma,U.S. Senate,Jim Rogers,DEM,550121,0,0,10,10,
Oklahoma,U.S. Senate,Connie Johnson,DEM,550121,0,0,227,227,
Oklahoma,U.S. House,Tom Guild,DEM,550121,0,0,76,76,05
Oklahoma,U.S. House,Al Mcaffrey,DEM,550121,0,0,36,36,05
Oklahoma,U.S. House,Leona Leonard,DEM,550121,0,0,120,120,05
Oklahoma,State Senate,Christine Byrd,DEM,550121,0,0,29,29,48
Oklahoma,State Senate,Anastasia Pittman,DEM,550121,0,0,219,219,48
Oklahoma,State House,Steve Davis,DEM,550121,0,0,76,76,99
Oklahoma,State House,Eleanor Darden Thompson,DEM,550121,0,0,79,79,99
Oklahoma,State House,George Young,DEM,550121,0,0,91,91,99
Oklahoma,Governor,Dax Ewbank,REP,550121,0,0,5,5,
Oklahoma,Governor,Chad Moody,REP,550121,0,0,8,8,
Oklahoma,Governor,Mary Fallin,REP,550121,0,0,35,35,
Oklahoma,Superintendent of Public Instruction,Brian Kelly,REP,550121,0,0,9,9,
Oklahoma,Superintendent of Public Instruction,Janet Costello Barresi,REP,550121,0,0,15,15,
Oklahoma,Superintendent of Public Instruction,Joy Hofmeister,REP,550121,0,0,22,22,
Oklahoma,Insurance Commissioner,Bill Viner,REP,550121,0,0,8,8,
Oklahoma,Insurance Commissioner,John Doak,REP,550121,0,0,36,36,
Oklahoma,Corporation Commissioner,Todd Hiett,REP,550121,0,0,26,26,
Oklahoma,Corporation Commissioner,Cliff Branan,REP,550121,0,0,16,16,
Oklahoma,U.S. Senate,Evelyn Rogers,REP,550121,0,0,2,2,
Oklahoma,U.S. Senate,Rob Moye,REP,550121,0,0,1,1,
Oklahoma,U.S. Senate,D. Jean Mcbride-Samuels,REP,550121,0,0,2,2,
Oklahoma,U.S. Senate,Jim Inhofe,REP,550121,0,0,39,39,
Oklahoma,U.S. Senate,Erick Paul Wyatt,REP,550121,0,0,4,4,
Oklahoma,U.S. Senate,Andy Craig,REP,550121,0,0,0,0,
Oklahoma,U.S. Senate,T. Shannon,REP,550121,0,0,14,14,
Oklahoma,U.S. Senate,Randy Brogdon,REP,550121,0,0,3,3,
Oklahoma,U.S. Senate,Eric Mccray,REP,550121,0,0,2,2,
Oklahoma,U.S. Senate,Kevin Crow,REP,550121,0,0,0,0,
Oklahoma,U.S. Senate,James Lankford,REP,550121,0,0,30,30,
Oklahoma,U.S. Senate,Jason Weger,REP,550121,0,0,0,0,
Oklahoma,U.S. House,Shane David Jett,REP,550121,0,0,5,5,05
Oklahoma,U.S. House,Patrice Douglas,REP,550121,0,0,14,14,05
Oklahoma,U.S. House,Mike Turner,REP,550121,0,0,3,3,05
Oklahoma,U.S. House,Steve Russell,REP,550121,0,0,9,9,05
Oklahoma,U.S. House,Harvey Sparks,REP,550121,0,0,3,3,05
Oklahoma,U.S. House,Clark Jolley,REP,550121,0,0,11,11,05
Oklahoma,Superintendent of Public Instruction,John Cox,DEM,550122,0,0,33,33,
Oklahoma,Superintendent of Public Instruction,Jack Jr.,DEM,550122,0,0,12,12,
Oklahoma,Superintendent of Public Instruction,Ivan Holmes,DEM,550122,0,0,13,13,
Oklahoma,Superintendent of Public Instruction,Freda Deskin,DEM,550122,0,0,74,74,
Oklahoma,U.S. Senate,Patrick Michael Hayes,DEM,550122,0,0,10,10,
Oklahoma,U.S. Senate,Jim Rogers,DEM,550122,0,0,4,4,
Oklahoma,U.S. Senate,Connie Johnson,DEM,550122,0,0,126,126,
Oklahoma,U.S. House,Tom Guild,DEM,550122,0,0,51,51,05
Oklahoma,U.S. House,Al Mcaffrey,DEM,550122,0,0,26,26,05
Oklahoma,U.S. House,Leona Leonard,DEM,550122,0,0,53,53,05
Oklahoma,State Senate,Christine Byrd,DEM,550122,0,0,31,31,48
Oklahoma,State Senate,Anastasia Pittman,DEM,550122,0,0,110,110,48
Oklahoma,State House,Steve Davis,DEM,550122,0,0,27,27,99
Oklahoma,State House,Eleanor Darden Thompson,DEM,550122,0,0,53,53,99
Oklahoma,State House,George Young,DEM,550122,0,0,61,61,99
Oklahoma,Governor,Dax Ewbank,REP,550122,0,0,5,5,
Oklahoma,Governor,Chad Moody,REP,550122,0,0,5,5,
Oklahoma,Governor,Mary Fallin,REP,550122,0,0,73,73,
Oklahoma,Superintendent of Public Instruction,Brian Kelly,REP,550122,0,0,12,12,
Oklahoma,Superintendent of Public Instruction,Janet Costello Barresi,REP,550122,0,0,37,37,
Oklahoma,Superintendent of Public Instruction,Joy Hofmeister,REP,550122,0,0,30,30,
Oklahoma,Insurance Commissioner,Bill Viner,REP,550122,0,0,10,10,
Oklahoma,Insurance Commissioner,John Doak,REP,550122,0,0,66,66,
Oklahoma,Corporation Commissioner,Todd Hiett,REP,550122,0,0,31,31,
Oklahoma,Corporation Commissioner,Cliff Branan,REP,550122,0,0,43,43,
Oklahoma,U.S. Senate,Evelyn Rogers,REP,550122,0,0,3,3,
Oklahoma,U.S. Senate,Rob Moye,REP,550122,0,0,1,1,
Oklahoma,U.S. Senate,D. Jean Mcbride-Samuels,REP,550122,0,0,2,2,
Oklahoma,U.S. Senate,Jim Inhofe,REP,550122,0,0,70,70,
Oklahoma,U.S. Senate,Erick Paul Wyatt,REP,550122,0,0,1,1,
Oklahoma,U.S. Senate,Andy Craig,REP,550122,0,0,0,0,
Oklahoma,U.S. Senate,T. Shannon,REP,550122,0,0,16,16,
Oklahoma,U.S. Senate,Randy Brogdon,REP,550122,0,0,3,3,
Oklahoma,U.S. Senate,Eric Mccray,REP,550122,0,0,0,0,
Oklahoma,U.S. Senate,Kevin Crow,REP,550122,0,0,1,1,
Oklahoma,U.S. Senate,James Lankford,REP,550122,0,0,62,62,
Oklahoma,U.S. Senate,Jason Weger,REP,550122,0,0,0,0,
Oklahoma,U.S. House,Shane David Jett,REP,550122,0,0,2,2,05
Oklahoma,U.S. House,Patrice Douglas,REP,550122,0,0,24,24,05
Oklahoma,U.S. House,Mike Turner,REP,550122,0,0,17,17,05
Oklahoma,U.S. House,Steve Russell,REP,550122,0,0,16,16,05
Oklahoma,U.S. House,Harvey Sparks,REP,550122,0,0,6,6,05
Oklahoma,U.S. House,Clark Jolley,REP,550122,0,0,16,16,05
Oklahoma,Superintendent of Public Instruction,John Cox,DEM,550123,0,0,60,60,
Oklahoma,Superintendent of Public Instruction,Jack Jr.,DEM,550123,0,0,26,26,
Oklahoma,Superintendent of Public Instruction,Ivan Holmes,DEM,550123,0,0,29,29,
Oklahoma,Superintendent of Public Instruction,Freda Deskin,DEM,550123,0,0,112,112,
Oklahoma,U.S. Senate,Patrick Michael Hayes,DEM,550123,0,0,13,13,
Oklahoma,U.S. Senate,Jim Rogers,DEM,550123,0,0,14,14,
Oklahoma,U.S. Senate,Connie Johnson,DEM,550123,0,0,203,203,
Oklahoma,U.S. House,Tom Guild,DEM,550123,0,0,82,82,05
Oklahoma,U.S. House,Al Mcaffrey,DEM,550123,0,0,61,61,05
Oklahoma,U.S. House,Leona Leonard,DEM,550123,0,0,73,73,05
Oklahoma,State Senate,Christine Byrd,DEM,550123,0,0,33,33,48
Oklahoma,State Senate,Anastasia Pittman,DEM,550123,0,0,200,200,48
Oklahoma,State House,Steve Davis,DEM,550123,0,0,57,57,99
Oklahoma,State House,Eleanor Darden Thompson,DEM,550123,0,0,59,59,99
Oklahoma,State House,George Young,DEM,550123,0,0,115,115,99
Oklahoma,Governor,Dax Ewbank,REP,550123,0,0,12,12,
Oklahoma,Governor,Chad Moody,REP,550123,0,0,17,17,
Oklahoma,Governor,Mary Fallin,REP,550123,0,0,107,107,
Oklahoma,Superintendent of Public Instruction,Brian Kelly,REP,550123,0,0,25,25,
Oklahoma,Superintendent of Public Instruction,Janet Costello Barresi,REP,550123,0,0,54,54,
Oklahoma,Superintendent of Public Instruction,Joy Hofmeister,REP,550123,0,0,49,49,
Oklahoma,Insurance Commissioner,Bill Viner,REP,550123,0,0,26,26,
Oklahoma,Insurance Commissioner,John Doak,REP,550123,0,0,95,95,
Oklahoma,Corporation Commissioner,Todd Hiett,REP,550123,0,0,38,38,
Oklahoma,Corporation Commissioner,Cliff Branan,REP,550123,0,0,83,83,
Oklahoma,U.S. Senate,Evelyn Rogers,REP,550123,0,0,4,4,
Oklahoma,U.S. Senate,Rob Moye,REP,550123,0,0,1,1,
Oklahoma,U.S. Senate,D. Jean Mcbride-Samuels,REP,550123,0,0,6,6,
Oklahoma,U.S. Senate,Jim Inhofe,REP,550123,0,0,116,116,
Oklahoma,U.S. Senate,Erick Paul Wyatt,REP,550123,0,0,2,2,
Oklahoma,U.S. Senate,Andy Craig,REP,550123,0,0,1,1,
Oklahoma,U.S. Senate,T. Shannon,REP,550123,0,0,25,25,
Oklahoma,U.S. Senate,Randy Brogdon,REP,550123,0,0,2,2,
Oklahoma,U.S. Senate,Eric Mccray,REP,550123,0,0,2,2,
Oklahoma,U.S. Senate,Kevin Crow,REP,550123,0,0,1,1,
Oklahoma,U.S. Senate,James Lankford,REP,550123,0,0,104,104,
Oklahoma,U.S. Senate,Jason Weger,REP,550123,0,0,0,0,
Oklahoma,U.S. House,Shane David Jett,REP,550123,0,0,10,10,05
Oklahoma,U.S. House,Patrice Douglas,REP,550123,0,0,34,34,05
Oklahoma,U.S. House,Mike Turner,REP,550123,0,0,26,26,05
Oklahoma,U.S. House,Steve Russell,REP,550123,0,0,29,29,05
Oklahoma,U.S. House,Harvey Sparks,REP,550123,0,0,8,8,05
Oklahoma,U.S. House,Clark Jolley,REP,550123,0,0,17,17,05
Oklahoma,Superintendent of Public Instruction,John Cox,DEM,550124,0,0,36,36,
Oklahoma,Superintendent of Public Instruction,Jack Jr.,DEM,550124,0,0,25,25,
Oklahoma,Superintendent of Public Instruction,Ivan Holmes,DEM,550124,0,0,16,16,
Oklahoma,Superintendent of Public Instruction,Freda Deskin,DEM,550124,0,0,85,85,
Oklahoma,U.S. Senate,Patrick Michael Hayes,DEM,550124,0,0,11,11,
Oklahoma,U.S. Senate,Jim Rogers,DEM,550124,0,0,11,11,
Oklahoma,U.S. Senate,Connie Johnson,DEM,550124,0,0,143,143,
Oklahoma,U.S. House,Tom Guild,DEM,550124,0,0,74,74,05
Oklahoma,U.S. House,Al Mcaffrey,DEM,550124,0,0,32,32,05
Oklahoma,U.S. House,Leona Leonard,DEM,550124,0,0,54,54,05
Oklahoma,State Senate,Christine Byrd,DEM,550124,0,0,42,42,48
Oklahoma,State Senate,Anastasia Pittman,DEM,550124,0,0,122,122,48
Oklahoma,Governor,Dax Ewbank,REP,550124,0,0,15,15,
Oklahoma,Governor,Chad Moody,REP,550124,0,0,27,27,
Oklahoma,Governor,Mary Fallin,REP,550124,0,0,160,160,
Oklahoma,Superintendent of Public Instruction,Brian Kelly,REP,550124,0,0,49,49,
Oklahoma,Superintendent of Public Instruction,Janet Costello Barresi,REP,550124,0,0,84,84,
Oklahoma,Superintendent of Public Instruction,Joy Hofmeister,REP,550124,0,0,68,68,
Oklahoma,Insurance Commissioner,Bill Viner,REP,550124,0,0,28,28,
Oklahoma,Insurance Commissioner,John Doak,REP,550124,0,0,160,160,
Oklahoma,Corporation Commissioner,Todd Hiett,REP,550124,0,0,63,63,
Oklahoma,Corporation Commissioner,Cliff Branan,REP,550124,0,0,120,120,
Oklahoma,U.S. Senate,Evelyn Rogers,REP,550124,0,0,10,10,
Oklahoma,U.S. Senate,Rob Moye,REP,550124,0,0,5,5,
Oklahoma,U.S. Senate,D. Jean Mcbride-Samuels,REP,550124,0,0,2,2,
Oklahoma,U.S. Senate,Jim Inhofe,REP,550124,0,0,174,174,
Oklahoma,U.S. Senate,Erick Paul Wyatt,REP,550124,0,0,4,4,
Oklahoma,U.S. Senate,Andy Craig,REP,550124,0,0,0,0,
Oklahoma,U.S. Senate,T. Shannon,REP,550124,0,0,53,53,
Oklahoma,U.S. Senate,Randy Brogdon,REP,550124,0,0,2,2,
Oklahoma,U.S. Senate,Eric Mccray,REP,550124,0,0,3,3,
Oklahoma,U.S. Senate,Kevin Crow,REP,550124,0,0,1,1,
Oklahoma,U.S. Senate,James Lankford,REP,550124,0,0,141,141,
Oklahoma,U.S. Senate,Jason Weger,REP,550124,0,0,2,2,
Oklahoma,U.S. House,Shane David Jett,REP,550124,0,0,17,17,05
Oklahoma,U.S. House,Patrice Douglas,REP,550124,0,0,53,53,05
Oklahoma,U.S. House,Mike Turner,REP,550124,0,0,30,30,05
Oklahoma,U.S. House,Steve Russell,REP,550124,0,0,44,44,05
Oklahoma,U.S. House,Harvey Sparks,REP,550124,0,0,15,15,05
Oklahoma,U.S. House,Clark Jolley,REP,550124,0,0,32,32,05
Oklahoma,Superintendent of Public Instruction,John Cox,DEM,550125,0,0,10,10,
Oklahoma,Superintendent of Public Instruction,Jack Jr.,DEM,550125,0,0,6,6,
Oklahoma,Superintendent of Public Instruction,Ivan Holmes,DEM,550125,0,0,4,4,
Oklahoma,Superintendent of Public Instruction,Freda Deskin,DEM,550125,0,0,26,26,
Oklahoma,U.S. Senate,Patrick Michael Hayes,DEM,550125,0,0,3,3,
Oklahoma,U.S. Senate,Jim Rogers,DEM,550125,0,0,3,3,
Oklahoma,U.S. Senate,Connie Johnson,DEM,550125,0,0,40,40,
Oklahoma,U.S. House,Tom Guild,DEM,550125,0,0,13,13,05
Oklahoma,U.S. House,Al Mcaffrey,DEM,550125,0,0,10,10,05
Oklahoma,U.S. House,Leona Leonard,DEM,550125,0,0,20,20,05
Oklahoma,State Senate,Christine Byrd,DEM,550125,0,0,6,6,48
Oklahoma,State Senate,Anastasia Pittman,DEM,550125,0,0,39,39,48
Oklahoma,State House,Steve Davis,DEM,550125,0,0,9,9,99
Oklahoma,State House,Eleanor Darden Thompson,DEM,550125,0,0,18,18,99
Oklahoma,State House,George Young,DEM,550125,0,0,18,18,99
Oklahoma,Governor,Dax Ewbank,REP,550125,0,0,1,1,
Oklahoma,Governor,Chad Moody,REP,550125,0,0,4,4,
Oklahoma,Governor,Mary Fallin,REP,550125,0,0,29,29,
Oklahoma,Superintendent of Public Instruction,Brian Kelly,REP,550125,0,0,7,7,
Oklahoma,Superintendent of Public Instruction,Janet Costello Barresi,REP,550125,0,0,9,9,
Oklahoma,Superintendent of Public Instruction,Joy Hofmeister,REP,550125,0,0,18,18,
Oklahoma,Insurance Commissioner,Bill Viner,REP,550125,0,0,6,6,
Oklahoma,Insurance Commissioner,John Doak,REP,550125,0,0,28,28,
Oklahoma,Corporation Commissioner,Todd Hiett,REP,550125,0,0,9,9,
Oklahoma,Corporation Commissioner,Cliff Branan,REP,550125,0,0,23,23,
Oklahoma,U.S. Senate,Evelyn Rogers,REP,550125,0,0,1,1,
Oklahoma,U.S. Senate,Rob Moye,REP,550125,0,0,2,2,
Oklahoma,U.S. Senate,D. Jean Mcbride-Samuels,REP,550125,0,0,0,0,
Oklahoma,U.S. Senate,Jim Inhofe,REP,550125,0,0,29,29,
Oklahoma,U.S. Senate,Erick Paul Wyatt,REP,550125,0,0,2,2,
Oklahoma,U.S. Senate,Andy Craig,REP,550125,0,0,0,0,
Oklahoma,U.S. Senate,T. Shannon,REP,550125,0,0,6,6,
Oklahoma,U.S. Senate,Randy Brogdon,REP,550125,0,0,1,1,
Oklahoma,U.S. Senate,Eric Mccray,REP,550125,0,0,1,1,
Oklahoma,U.S. Senate,Kevin Crow,REP,550125,0,0,0,0,
Oklahoma,U.S. Senate,James Lankford,REP,550125,0,0,26,26,
Oklahoma,U.S. Senate,Jason Weger,REP,550125,0,0,0,0,
Oklahoma,U.S. House,Shane David Jett,REP,550125,0,0,7,7,05
Oklahoma,U.S. House,Patrice Douglas,REP,550125,0,0,5,5,05
Oklahoma,U.S. House,Mike Turner,REP,550125,0,0,5,5,05
Oklahoma,U.S. House,Steve Russell,REP,550125,0,0,9,9,05
Oklahoma,U.S. House,Harvey Sparks,REP,550125,0,0,1,1,05
Oklahoma,U.S. House,Clark Jolley,REP,550125,0,0,6,6,05
Oklahoma,Superintendent of Public Instruction,John Cox,DEM,550126,0,0,30,30,
Oklahoma,Superintendent of Public Instruction,Jack Jr.,DEM,550126,0,0,12,12,
Oklahoma,Superintendent of Public Instruction,Ivan Holmes,DEM,550126,0,0,14,14,
Oklahoma,Superintendent of Public Instruction,Freda Deskin,DEM,550126,0,0,47,47,
Oklahoma,U.S. Senate,Patrick Michael Hayes,DEM,550126,0,0,10,10,
Oklahoma,U.S. Senate,Jim Rogers,DEM,550126,0,0,12,12,
Oklahoma,U.S. Senate,Connie Johnson,DEM,550126,0,0,83,83,
Oklahoma,U.S. House,Tom Guild,DEM,550126,0,0,51,51,05
Oklahoma,U.S. House,Al Mcaffrey,DEM,550126,0,0,21,21,05
Oklahoma,U.S. House,Leona Leonard,DEM,550126,0,0,31,31,05
Oklahoma,State Senate,Christine Byrd,DEM,550126,0,0,24,24,48
Oklahoma,State Senate,Anastasia Pittman,DEM,550126,0,0,78,78,48
Oklahoma,Governor,Dax Ewbank,REP,550126,0,0,14,14,
Oklahoma,Governor,Chad Moody,REP,550126,0,0,25,25,
Oklahoma,Governor,Mary Fallin,REP,550126,0,0,77,77,
Oklahoma,Superintendent of Public Instruction,Brian Kelly,REP,550126,0,0,25,25,
Oklahoma,Superintendent of Public Instruction,Janet Costello Barresi,REP,550126,0,0,35,35,
Oklahoma,Superintendent of Public Instruction,Joy Hofmeister,REP,550126,0,0,51,51,
Oklahoma,Insurance Commissioner,Bill Viner,REP,550126,0,0,32,32,
Oklahoma,Insurance Commissioner,John Doak,REP,550126,0,0,73,73,
Oklahoma,Corporation Commissioner,Todd Hiett,REP,550126,0,0,47,47,
Oklahoma,Corporation Commissioner,Cliff Branan,REP,550126,0,0,54,54,
Oklahoma,U.S. Senate,Evelyn Rogers,REP,550126,0,0,5,5,
Oklahoma,U.S. Senate,Rob Moye,REP,550126,0,0,3,3,
Oklahoma,U.S. Senate,D. Jean Mcbride-Samuels,REP,550126,0,0,1,1,
Oklahoma,U.S. Senate,Jim Inhofe,REP,550126,0,0,100,100,
Oklahoma,U.S. Senate,Erick Paul Wyatt,REP,550126,0,0,3,3,
Oklahoma,U.S. Senate,Andy Craig,REP,550126,0,0,0,0,
Oklahoma,U.S. Senate,T. Shannon,REP,550126,0,0,38,38,
Oklahoma,U.S. Senate,Randy Brogdon,REP,550126,0,0,7,7,
Oklahoma,U.S. Senate,Eric Mccray,REP,550126,0,0,1,1,
Oklahoma,U.S. Senate,Kevin Crow,REP,550126,0,0,2,2,
Oklahoma,U.S. Senate,James Lankford,REP,550126,0,0,68,68,
Oklahoma,U.S. Senate,Jason Weger,REP,550126,0,0,0,0,
Oklahoma,U.S. House,Shane David Jett,REP,550126,0,0,7,7,05
Oklahoma,U.S. House,Patrice Douglas,REP,550126,0,0,31,31,05
Oklahoma,U.S. House,Mike Turner,REP,550126,0,0,18,18,05
Oklahoma,U.S. House,Steve Russell,REP,550126,0,0,29,29,05
Oklahoma,U.S. House,Harvey Sparks,REP,550126,0,0,5,5,05
Oklahoma,U.S. House,Clark Jolley,REP,550126,0,0,16,16,05
Oklahoma,Superintendent of Public Instruction,John Cox,DEM,550127,0,0,29,29,
Oklahoma,Superintendent of Public Instruction,Jack Jr.,DEM,550127,0,0,11,11,
Oklahoma,Superintendent of Public Instruction,Ivan Holmes,DEM,550127,0,0,3,3,
Oklahoma,Superintendent of Public Instruction,Freda Deskin,DEM,550127,0,0,35,35,
Oklahoma,U.S. Senate,Patrick Michael Hayes,DEM,550127,0,0,9,9,
Oklahoma,U.S. Senate,Jim Rogers,DEM,550127,0,0,15,15,
Oklahoma,U.S. Senate,Connie Johnson,DEM,550127,0,0,52,52,
Oklahoma,U.S. House,Tom Guild,DEM,550127,0,0,37,37,05
Oklahoma,U.S. House,Al Mcaffrey,DEM,550127,0,0,17,17,05
Oklahoma,U.S. House,Leona Leonard,DEM,550127,0,0,23,23,05
Oklahoma,Governor,Dax Ewbank,REP,550127,0,0,16,16,
Oklahoma,Governor,Chad Moody,REP,550127,0,0,29,29,
Oklahoma,Governor,Mary Fallin,REP,550127,0,0,301,301,
Oklahoma,Superintendent of Public Instruction,Brian Kelly,REP,550127,0,0,70,70,
Oklahoma,Superintendent of Public Instruction,Janet Costello Barresi,REP,550127,0,0,131,131,
Oklahoma,Superintendent of Public Instruction,Joy Hofmeister,REP,550127,0,0,144,144,
Oklahoma,Insurance Commissioner,Bill Viner,REP,550127,0,0,57,57,
Oklahoma,Insurance Commissioner,John Doak,REP,550127,0,0,262,262,
Oklahoma,Corporation Commissioner,Todd Hiett,REP,550127,0,0,152,152,
Oklahoma,Corporation Commissioner,Cliff Branan,REP,550127,0,0,168,168,
Oklahoma,U.S. Senate,Evelyn Rogers,REP,550127,0,0,8,8,
Oklahoma,U.S. Senate,Rob Moye,REP,550127,0,0,6,6,
Oklahoma,U.S. Senate,D. Jean Mcbride-Samuels,REP,550127,0,0,3,3,
Oklahoma,U.S. Senate,Jim Inhofe,REP,550127,0,0,320,320,
Oklahoma,U.S. Senate,Erick Paul Wyatt,REP,550127,0,0,7,7,
Oklahoma,U.S. Senate,Andy Craig,REP,550127,0,0,2,2,
Oklahoma,U.S. Senate,T. Shannon,REP,550127,0,0,70,70,
Oklahoma,U.S. Senate,Randy Brogdon,REP,550127,0,0,0,0,
Oklahoma,U.S. Senate,Eric Mccray,REP,550127,0,0,0,0,
Oklahoma,U.S. Senate,Kevin Crow,REP,550127,0,0,2,2,
Oklahoma,U.S. Senate,James Lankford,REP,550127,0,0,277,277,
Oklahoma,U.S. Senate,Jason Weger,REP,550127,0,0,0,0,
Oklahoma,U.S. House,Shane David Jett,REP,550127,0,0,32,32,05
Oklahoma,U.S. House,Patrice Douglas,REP,550127,0,0,94,94,05
Oklahoma,U.S. House,Mike Turner,REP,550127,0,0,44,44,05
Oklahoma,U.S. House,Steve Russell,REP,550127,0,0,81,81,05
Oklahoma,U.S. House,Harvey Sparks,REP,550127,0,0,7,7,05
Oklahoma,U.S. House,Clark Jolley,REP,550127,0,0,75,75,05
Oklahoma,Superintendent of Public Instruction,John Cox,DEM,550128,0,0,25,25,
Oklahoma,Superintendent of Public Instruction,Jack Jr.,DEM,550128,0,0,8,8,
Oklahoma,Superintendent of Public Instruction,Ivan Holmes,DEM,550128,0,0,6,6,
Oklahoma,Superintendent of Public Instruction,Freda Deskin,DEM,550128,0,0,44,44,
Oklahoma,U.S. Senate,Patrick Michael Hayes,DEM,550128,0,0,6,6,
Oklahoma,U.S. Senate,Jim Rogers,DEM,550128,0,0,14,14,
Oklahoma,U.S. Senate,Connie Johnson,DEM,550128,0,0,64,64,
Oklahoma,U.S. House,Tom Guild,DEM,550128,0,0,38,38,05
Oklahoma,U.S. House,Al Mcaffrey,DEM,550128,0,0,20,20,05
Oklahoma,U.S. House,Leona Leonard,DEM,550128,0,0,22,22,05
Oklahoma,Governor,Dax Ewbank,REP,550128,0,0,19,19,
Oklahoma,Governor,Chad Moody,REP,550128,0,0,16,16,
Oklahoma,Governor,Mary Fallin,REP,550128,0,0,195,195,
Oklahoma,Superintendent of Public Instruction,Brian Kelly,REP,550128,0,0,45,45,
Oklahoma,Superintendent of Public Instruction,Janet Costello Barresi,REP,550128,0,0,69,69,
Oklahoma,Superintendent of Public Instruction,Joy Hofmeister,REP,550128,0,0,113,113,
Oklahoma,Insurance Commissioner,Bill Viner,REP,550128,0,0,44,44,
Oklahoma,Insurance Commissioner,John Doak,REP,550128,0,0,161,161,
Oklahoma,Corporation Commissioner,Todd Hiett,REP,550128,0,0,91,91,
Oklahoma,Corporation Commissioner,Cliff Branan,REP,550128,0,0,120,120,
Oklahoma,U.S. Senate,Evelyn Rogers,REP,550128,0,0,7,7,
Oklahoma,U.S. Senate,Rob Moye,REP,550128,0,0,3,3,
Oklahoma,U.S. Senate,D. Jean Mcbride-Samuels,REP,550128,0,0,0,0,
Oklahoma,U.S. Senate,Jim Inhofe,REP,550128,0,0,214,214,
Oklahoma,U.S. Senate,Erick Paul Wyatt,REP,550128,0,0,5,5,
Oklahoma,U.S. Senate,Andy Craig,REP,550128,0,0,3,3,
Oklahoma,U.S. Senate,T. Shannon,REP,550128,0,0,57,57,
Oklahoma,U.S. Senate,Randy Brogdon,REP,550128,0,0,9,9,
Oklahoma,U.S. Senate,Eric Mccray,REP,550128,0,0,1,1,
Oklahoma,U.S. Senate,Kevin Crow,REP,550128,0,0,0,0,
Oklahoma,U.S. Senate,James Lankford,REP,550128,0,0,164,164,
Oklahoma,U.S. Senate,Jason Weger,REP,550128,0,0,1,1,
Oklahoma,U.S. House,Shane David Jett,REP,550128,0,0,20,20,05
Oklahoma,U.S. House,Patrice Douglas,REP,550128,0,0,52,52,05
Oklahoma,U.S. House,Mike Turner,REP,550128,0,0,35,35,05
Oklahoma,U.S. House,Steve Russell,REP,550128,0,0,63,63,05
Oklahoma,U.S. House,Harvey Sparks,REP,550128,0,0,13,13,05
Oklahoma,U.S. House,Clark Jolley,REP,550128,0,0,38,38,05
Oklahoma,Superintendent of Public Instruction,John Cox,DEM,550129,0,0,13,13,
Oklahoma,Superintendent of Public Instruction,Jack Jr.,DEM,550129,0,0,6,6,
Oklahoma,Superintendent of Public Instruction,Ivan Holmes,DEM,550129,0,0,5,5,
Oklahoma,Superintendent of Public Instruction,Freda Deskin,DEM,550129,0,0,24,24,
Oklahoma,U.S. Senate,Patrick Michael Hayes,DEM,550129,0,0,11,11,
Oklahoma,U.S. Senate,Jim Rogers,DEM,550129,0,0,4,4,
Oklahoma,U.S. Senate,Connie Johnson,DEM,550129,0,0,33,33,
Oklahoma,U.S. House,Tom Guild,DEM,550129,0,0,23,23,05
Oklahoma,U.S. House,Al Mcaffrey,DEM,550129,0,0,12,12,05
Oklahoma,U.S. House,Leona Leonard,DEM,550129,0,0,14,14,05
Oklahoma,Governor,Dax Ewbank,REP,550129,0,0,8,8,
Oklahoma,Governor,Chad Moody,REP,550129,0,0,11,11,
Oklahoma,Governor,Mary Fallin,REP,550129,0,0,138,138,
Oklahoma,Superintendent of Public Instruction,Brian Kelly,REP,550129,0,0,29,29,
Oklahoma,Superintendent of Public Instruction,Janet Costello Barresi,REP,550129,0,0,74,74,
Oklahoma,Superintendent of Public Instruction,Joy Hofmeister,REP,550129,0,0,46,46,
Oklahoma,Insurance Commissioner,Bill Viner,REP,550129,0,0,16,16,
Oklahoma,Insurance Commissioner,John Doak,REP,550129,0,0,107,107,
Oklahoma,Corporation Commissioner,Todd Hiett,REP,550129,0,0,55,55,
Oklahoma,Corporation Commissioner,Cliff Branan,REP,550129,0,0,73,73,
Oklahoma,U.S. Senate,Evelyn Rogers,REP,550129,0,0,11,11,
Oklahoma,U.S. Senate,Rob Moye,REP,550129,0,0,0,0,
Oklahoma,U.S. Senate,D. Jean Mcbride-Samuels,REP,550129,0,0,2,2,
Oklahoma,U.S. Senate,Jim Inhofe,REP,550129,0,0,135,135,
Oklahoma,U.S. Senate,Erick Paul Wyatt,REP,550129,0,0,4,4,
Oklahoma,U.S. Senate,Andy Craig,REP,550129,0,0,0,0,
Oklahoma,U.S. Senate,T. Shannon,REP,550129,0,0,21,21,
Oklahoma,U.S. Senate,Randy Brogdon,REP,550129,0,0,1,1,
Oklahoma,U.S. Senate,Eric Mccray,REP,550129,0,0,1,1,
Oklahoma,U.S. Senate,Kevin Crow,REP,550129,0,0,2,2,
Oklahoma,U.S. Senate,James Lankford,REP,550129,0,0,132,132,
Oklahoma,U.S. Senate,Jason Weger,REP,550129,0,0,1,1,
Oklahoma,U.S. House,Shane David Jett,REP,550129,0,0,13,13,05
Oklahoma,U.S. House,Patrice Douglas,REP,550129,0,0,53,53,05
Oklahoma,U.S. House,Mike Turner,REP,550129,0,0,13,13,05
Oklahoma,U.S. House,Steve Russell,REP,550129,0,0,37,37,05
Oklahoma,U.S. House,Harvey Sparks,REP,550129,0,0,8,8,05
Oklahoma,U.S. House,Clark Jolley,REP,550129,0,0,22,22,05
Oklahoma,Superintendent of Public Instruction,John Cox,DEM,550130,0,0,40,40,
Oklahoma,Superintendent of Public Instruction,Jack Jr.,DEM,550130,0,0,11,11,
Oklahoma,Superintendent of Public Instruction,Ivan Holmes,DEM,550130,0,0,14,14,
Oklahoma,Superintendent of Public Instruction,Freda Deskin,DEM,550130,0,0,62,62,
Oklahoma,U.S. Senate,Patrick Michael Hayes,DEM,550130,0,0,17,17,
Oklahoma,U.S. Senate,Jim Rogers,DEM,550130,0,0,12,12,
Oklahoma,U.S. Senate,Connie Johnson,DEM,550130,0,0,96,96,
Oklahoma,U.S. House,Tom Guild,DEM,550130,0,0,56,56,05
Oklahoma,U.S. House,Al Mcaffrey,DEM,550130,0,0,34,34,05
Oklahoma,U.S. House,Leona Leonard,DEM,550130,0,0,35,35,05
Oklahoma,Governor,Dax Ewbank,REP,550130,0,0,44,44,
Oklahoma,Governor,Chad Moody,REP,550130,0,0,57,57,
Oklahoma,Governor,Mary Fallin,REP,550130,0,0,367,367,
Oklahoma,Superintendent of Public Instruction,Brian Kelly,REP,550130,0,0,78,78,
Oklahoma,Superintendent of Public Instruction,Janet Costello Barresi,REP,550130,0,0,134,134,
Oklahoma,Superintendent of Public Instruction,Joy Hofmeister,REP,550130,0,0,244,244,
Oklahoma,Insurance Commissioner,Bill Viner,REP,550130,0,0,77,77,
Oklahoma,Insurance Commissioner,John Doak,REP,550130,0,0,333,333,
Oklahoma,Corporation Commissioner,Todd Hiett,REP,550130,0,0,189,189,
Oklahoma,Corporation Commissioner,Cliff Branan,REP,550130,0,0,230,230,
Oklahoma,U.S. Senate,Evelyn Rogers,REP,550130,0,0,14,14,
Oklahoma,U.S. Senate,Rob Moye,REP,550130,0,0,13,13,
Oklahoma,U.S. Senate,D. Jean Mcbride-Samuels,REP,550130,0,0,7,7,
Oklahoma,U.S. Senate,Jim Inhofe,REP,550130,0,0,416,416,
Oklahoma,U.S. Senate,Erick Paul Wyatt,REP,550130,0,0,14,14,
Oklahoma,U.S. Senate,Andy Craig,REP,550130,0,0,8,8,
Oklahoma,U.S. Senate,T. Shannon,REP,550130,0,0,99,99,
Oklahoma,U.S. Senate,Randy Brogdon,REP,550130,0,0,13,13,
Oklahoma,U.S. Senate,Eric Mccray,REP,550130,0,0,5,5,
Oklahoma,U.S. Senate,Kevin Crow,REP,550130,0,0,2,2,
Oklahoma,U.S. Senate,James Lankford,REP,550130,0,0,344,344,
Oklahoma,U.S. Senate,Jason Weger,REP,550130,0,0,1,1,
Oklahoma,U.S. House,Shane David Jett,REP,550130,0,0,39,39,05
Oklahoma,U.S. House,Patrice Douglas,REP,550130,0,0,129,129,05
Oklahoma,U.S. House,Mike Turner,REP,550130,0,0,48,48,05
Oklahoma,U.S. House,Steve Russell,REP,550130,0,0,120,120,05
Oklahoma,U.S. House,Harvey Sparks,REP,550130,0,0,28,28,05
Oklahoma,U.S. House,Clark Jolley,REP,550130,0,0,80,80,05
Oklahoma,Superintendent of Public Instruction,John Cox,DEM,550131,0,0,11,11,
Oklahoma,Superintendent of Public Instruction,Jack Jr.,DEM,550131,0,0,4,4,
Oklahoma,Superintendent of Public Instruction,Ivan Holmes,DEM,550131,0,0,2,2,
Oklahoma,Superintendent of Public Instruction,Freda Deskin,DEM,550131,0,0,39,39,
Oklahoma,U.S. Senate,Patrick Michael Hayes,DEM,550131,0,0,8,8,
Oklahoma,U.S. Senate,Jim Rogers,DEM,550131,0,0,11,11,
Oklahoma,U.S. Senate,Connie Johnson,DEM,550131,0,0,40,40,
Oklahoma,U.S. House,Tom Guild,DEM,550131,0,0,24,24,05
Oklahoma,U.S. House,Al Mcaffrey,DEM,550131,0,0,17,17,05
Oklahoma,U.S. House,Leona Leonard,DEM,550131,0,0,17,17,05
Oklahoma,Governor,Dax Ewbank,REP,550131,0,0,8,8,
Oklahoma,Governor,Chad Moody,REP,550131,0,0,23,23,
Oklahoma,Governor,Mary Fallin,REP,550131,0,0,203,203,
Oklahoma,Superintendent of Public Instruction,Brian Kelly,REP,550131,0,0,38,38,
Oklahoma,Superintendent of Public Instruction,Janet Costello Barresi,REP,550131,0,0,89,89,
Oklahoma,Superintendent of Public Instruction,Joy Hofmeister,REP,550131,0,0,112,112,
Oklahoma,Insurance Commissioner,Bill Viner,REP,550131,0,0,24,24,
Oklahoma,Insurance Commissioner,John Doak,REP,550131,0,0,190,190,
Oklahoma,Corporation Commissioner,Todd Hiett,REP,550131,0,0,79,79,
Oklahoma,Corporation Commissioner,Cliff Branan,REP,550131,0,0,130,130,
Oklahoma,U.S. Senate,Evelyn Rogers,REP,550131,0,0,4,4,
Oklahoma,U.S. Senate,Rob Moye,REP,550131,0,0,2,2,
Oklahoma,U.S. Senate,D. Jean Mcbride-Samuels,REP,550131,0,0,1,1,
Oklahoma,U.S. Senate,Jim Inhofe,REP,550131,0,0,223,223,
Oklahoma,U.S. Senate,Erick Paul Wyatt,REP,550131,0,0,4,4,
Oklahoma,U.S. Senate,Andy Craig,REP,550131,0,0,1,1,
Oklahoma,U.S. Senate,T. Shannon,REP,550131,0,0,38,38,
Oklahoma,U.S. Senate,Randy Brogdon,REP,550131,0,0,4,4,
Oklahoma,U.S. Senate,Eric Mccray,REP,550131,0,0,2,2,
Oklahoma,U.S. Senate,Kevin Crow,REP,550131,0,0,0,0,
Oklahoma,U.S. Senate,James Lankford,REP,550131,0,0,195,195,
Oklahoma,U.S. Senate,Jason Weger,REP,550131,0,0,0,0,
Oklahoma,U.S. House,Shane David Jett,REP,550131,0,0,18,18,05
Oklahoma,U.S. House,Patrice Douglas,REP,550131,0,0,82,82,05
Oklahoma,U.S. House,Mike Turner,REP,550131,0,0,20,20,05
Oklahoma,U.S. House,Steve Russell,REP,550131,0,0,55,55,05
Oklahoma,U.S. House,Harvey Sparks,REP,550131,0,0,10,10,05
Oklahoma,U.S. House,Clark Jolley,REP,550131,0,0,44,44,05
Oklahoma,Superintendent of Public Instruction,John Cox,DEM,550132,0,0,12,12,
Oklahoma,Superintendent of Public Instruction,Jack Jr.,DEM,550132,0,0,2,2,
Oklahoma,Superintendent of Public Instruction,Ivan Holmes,DEM,550132,0,0,3,3,
Oklahoma,Superintendent of Public Instruction,Freda Deskin,DEM,550132,0,0,29,29,
Oklahoma,U.S. Senate,Patrick Michael Hayes,DEM,550132,0,0,6,6,
Oklahoma,U.S. Senate,Jim Rogers,DEM,550132,0,0,5,5,
Oklahoma,U.S. Senate,Connie Johnson,DEM,550132,0,0,31,31,
Oklahoma,U.S. House,Tom Guild,DEM,550132,0,0,22,22,05
Oklahoma,U.S. House,Al Mcaffrey,DEM,550132,0,0,11,11,05
Oklahoma,U.S. House,Leona Leonard,DEM,550132,0,0,11,11,05
Oklahoma,Governor,Dax Ewbank,REP,550132,0,0,9,9,
Oklahoma,Governor,Chad Moody,REP,550132,0,0,21,21,
Oklahoma,Governor,Mary Fallin,REP,550132,0,0,199,199,
Oklahoma,Superintendent of Public Instruction,Brian Kelly,REP,550132,0,0,31,31,
Oklahoma,Superintendent of Public Instruction,Janet Costello Barresi,REP,550132,0,0,76,76,
Oklahoma,Superintendent of Public Instruction,Joy Hofmeister,REP,550132,0,0,115,115,
Oklahoma,Insurance Commissioner,Bill Viner,REP,550132,0,0,45,45,
Oklahoma,Insurance Commissioner,John Doak,REP,550132,0,0,157,157,
Oklahoma,Corporation Commissioner,Todd Hiett,REP,550132,0,0,108,108,
Oklahoma,Corporation Commissioner,Cliff Branan,REP,550132,0,0,101,101,
Oklahoma,U.S. Senate,Evelyn Rogers,REP,550132,0,0,8,8,
Oklahoma,U.S. Senate,Rob Moye,REP,550132,0,0,4,4,
Oklahoma,U.S. Senate,D. Jean Mcbride-Samuels,REP,550132,0,0,0,0,
Oklahoma,U.S. Senate,Jim Inhofe,REP,550132,0,0,211,211,
Oklahoma,U.S. Senate,Erick Paul Wyatt,REP,550132,0,0,5,5,
Oklahoma,U.S. Senate,Andy Craig,REP,550132,0,0,0,0,
Oklahoma,U.S. Senate,T. Shannon,REP,550132,0,0,57,57,
Oklahoma,U.S. Senate,Randy Brogdon,REP,550132,0,0,2,2,
Oklahoma,U.S. Senate,Eric Mccray,REP,550132,0,0,0,0,
Oklahoma,U.S. Senate,Kevin Crow,REP,550132,0,0,0,0,
Oklahoma,U.S. Senate,James Lankford,REP,550132,0,0,172,172,
Oklahoma,U.S. Senate,Jason Weger,REP,550132,0,0,0,0,
Oklahoma,U.S. House,Shane David Jett,REP,550132,0,0,17,17,05
Oklahoma,U.S. House,Patrice Douglas,REP,550132,0,0,52,52,05
Oklahoma,U.S. House,Mike Turner,REP,550132,0,0,31,31,05
Oklahoma,U.S. House,Steve Russell,REP,550132,0,0,60,60,05
Oklahoma,U.S. House,Harvey Sparks,REP,550132,0,0,6,6,05
Oklahoma,U.S. House,Clark Jolley,REP,550132,0,0,54,54,05
Oklahoma,Superintendent of Public Instruction,John Cox,DEM,550133,0,0,14,14,
Oklahoma,Superintendent of Public Instruction,Jack Jr.,DEM,550133,0,0,4,4,
Oklahoma,Superintendent of Public Instruction,Ivan Holmes,DEM,550133,0,0,2,2,
Oklahoma,Superintendent of Public Instruction,Freda Deskin,DEM,550133,0,0,15,15,
Oklahoma,U.S. Senate,Patrick Michael Hayes,DEM,550133,0,0,5,5,
Oklahoma,U.S. Senate,Jim Rogers,DEM,550133,0,0,8,8,
Oklahoma,U.S. Senate,Connie Johnson,DEM,550133,0,0,23,23,
Oklahoma,U.S. House,Tom Guild,DEM,550133,0,0,22,22,05
Oklahoma,U.S. House,Al Mcaffrey,DEM,550133,0,0,8,8,05
Oklahoma,U.S. House,Leona Leonard,DEM,550133,0,0,3,3,05
Oklahoma,Governor,Dax Ewbank,REP,550133,0,0,24,24,
Oklahoma,Governor,Chad Moody,REP,550133,0,0,33,33,
Oklahoma,Governor,Mary Fallin,REP,550133,0,0,156,156,
Oklahoma,Superintendent of Public Instruction,Brian Kelly,REP,550133,0,0,42,42,
Oklahoma,Superintendent of Public Instruction,Janet Costello Barresi,REP,550133,0,0,46,46,
Oklahoma,Superintendent of Public Instruction,Joy Hofmeister,REP,550133,0,0,125,125,
Oklahoma,Insurance Commissioner,Bill Viner,REP,550133,0,0,39,39,
Oklahoma,Insurance Commissioner,John Doak,REP,550133,0,0,164,164,
Oklahoma,Corporation Commissioner,Todd Hiett,REP,550133,0,0,100,100,
Oklahoma,Corporation Commissioner,Cliff Branan,REP,550133,0,0,104,104,
Oklahoma,U.S. Senate,Evelyn Rogers,REP,550133,0,0,3,3,
Oklahoma,U.S. Senate,Rob Moye,REP,550133,0,0,7,7,
Oklahoma,U.S. Senate,D. Jean Mcbride-Samuels,REP,550133,0,0,2,2,
Oklahoma,U.S. Senate,Jim Inhofe,REP,550133,0,0,188,188,
Oklahoma,U.S. Senate,Erick Paul Wyatt,REP,550133,0,0,14,14,
Oklahoma,U.S. Senate,Andy Craig,REP,550133,0,0,0,0,
Oklahoma,U.S. Senate,T. Shannon,REP,550133,0,0,54,54,
Oklahoma,U.S. Senate,Randy Brogdon,REP,550133,0,0,12,12,
Oklahoma,U.S. Senate,Eric Mccray,REP,550133,0,0,1,1,
Oklahoma,U.S. Senate,Kevin Crow,REP,550133,0,0,1,1,
Oklahoma,U.S. Senate,James Lankford,REP,550133,0,0,146,146,
Oklahoma,U.S. Senate,Jason Weger,REP,550133,0,0,1,1,
Oklahoma,U.S. House,Shane David Jett,REP,550133,0,0,24,24,05
Oklahoma,U.S. House,Patrice Douglas,REP,550133,0,0,42,42,05
Oklahoma,U.S. House,Mike Turner,REP,550133,0,0,27,27,05
Oklahoma,U.S. House,Steve Russell,REP,550133,0,0,51,51,05
Oklahoma,U.S. House,Harvey Sparks,REP,550133,0,0,5,5,05
Oklahoma,U.S. House,Clark Jolley,REP,550133,0,0,58,58,05
Oklahoma,State Senate,Mark Thomas,REP,550133,0,0,64,64,22
Oklahoma,State Senate,Leif Francel,REP,550133,0,0,47,47,22
Oklahoma,State Senate,Stephanie Bice,REP,550133,0,0,92,92,22
Oklahoma,Superintendent of Public Instruction,John Cox,DEM,550134,0,0,27,27,
Oklahoma,Superintendent of Public Instruction,Jack Jr.,DEM,550134,0,0,18,18,
Oklahoma,Superintendent of Public Instruction,Ivan Holmes,DEM,550134,0,0,5,5,
Oklahoma,Superintendent of Public Instruction,Freda Deskin,DEM,550134,0,0,44,44,
Oklahoma,U.S. Senate,Patrick Michael Hayes,DEM,550134,0,0,17,17,
Oklahoma,U.S. Senate,Jim Rogers,DEM,550134,0,0,7,7,
Oklahoma,U.S. Senate,Connie Johnson,DEM,550134,0,0,70,70,
Oklahoma,U.S. House,Tom Guild,DEM,550134,0,0,29,29,05
Oklahoma,U.S. House,Al Mcaffrey,DEM,550134,0,0,31,31,05
Oklahoma,U.S. House,Leona Leonard,DEM,550134,0,0,32,32,05
Oklahoma,Governor,Dax Ewbank,REP,550134,0,0,47,47,
Oklahoma,Governor,Chad Moody,REP,550134,0,0,64,64,
Oklahoma,Governor,Mary Fallin,REP,550134,0,0,443,443,
Oklahoma,Superintendent of Public Instruction,Brian Kelly,REP,550134,0,0,97,97,
Oklahoma,Superintendent of Public Instruction,Janet Costello Barresi,REP,550134,0,0,152,152,
Oklahoma,Superintendent of Public Instruction,Joy Hofmeister,REP,550134,0,0,298,298,
Oklahoma,Insurance Commissioner,Bill Viner,REP,550134,0,0,91,91,
Oklahoma,Insurance Commissioner,John Doak,REP,550134,0,0,414,414,
Oklahoma,Corporation Commissioner,Todd Hiett,REP,550134,0,0,239,239,
Oklahoma,Corporation Commissioner,Cliff Branan,REP,550134,0,0,271,271,
Oklahoma,U.S. Senate,Evelyn Rogers,REP,550134,0,0,23,23,
Oklahoma,U.S. Senate,Rob Moye,REP,550134,0,0,9,9,
Oklahoma,U.S. Senate,D. Jean Mcbride-Samuels,REP,550134,0,0,6,6,
Oklahoma,U.S. Senate,Jim Inhofe,REP,550134,0,0,483,483,
Oklahoma,U.S. Senate,Erick Paul Wyatt,REP,550134,0,0,22,22,
Oklahoma,U.S. Senate,Andy Craig,REP,550134,0,0,2,2,
Oklahoma,U.S. Senate,T. Shannon,REP,550134,0,0,126,126,
Oklahoma,U.S. Senate,Randy Brogdon,REP,550134,0,0,25,25,
Oklahoma,U.S. Senate,Eric Mccray,REP,550134,0,0,2,2,
Oklahoma,U.S. Senate,Kevin Crow,REP,550134,0,0,2,2,
Oklahoma,U.S. Senate,James Lankford,REP,550134,0,0,401,401,
Oklahoma,U.S. Senate,Jason Weger,REP,550134,0,0,2,2,
Oklahoma,U.S. House,Shane David Jett,REP,550134,0,0,41,41,05
Oklahoma,U.S. House,Patrice Douglas,REP,550134,0,0,138,138,05
Oklahoma,U.S. House,Mike Turner,REP,550134,0,0,98,98,05
Oklahoma,U.S. House,Steve Russell,REP,550134,0,0,142,142,05
Oklahoma,U.S. House,Harvey Sparks,REP,550134,0,0,20,20,05
Oklahoma,U.S. House,Clark Jolley,REP,550134,0,0,103,103,05
Oklahoma,State Senate,Mark Thomas,REP,550134,0,0,158,158,22
Oklahoma,State Senate,Leif Francel,REP,550134,0,0,101,101,22
Oklahoma,State Senate,Stephanie Bice,REP,550134,0,0,252,252,22
Oklahoma,State House,Gregory Duke Brown,REP,550134,0,0,17,17,82
Oklahoma,State House,Dustin Hopson,REP,550134,0,0,63,63,82
Oklahoma,State House,Adam Pugh,REP,550134,0,0,164,164,82
Oklahoma,State House,Kevin Calvey,REP,550134,0,0,256,256,82
Oklahoma,State House,Paul Ruckel,REP,550134,0,0,14,14,82
Oklahoma,Superintendent of Public Instruction,John Cox,DEM,550135,0,0,3,3,
Oklahoma,Superintendent of Public Instruction,Jack Jr.,DEM,550135,0,0,4,4,
Oklahoma,Superintendent of Public Instruction,Ivan Holmes,DEM,550135,0,0,0,0,
Oklahoma,Superintendent of Public Instruction,Freda Deskin,DEM,550135,0,0,14,14,
Oklahoma,U.S. Senate,Patrick Michael Hayes,DEM,550135,0,0,0,0,
Oklahoma,U.S. Senate,Jim Rogers,DEM,550135,0,0,6,6,
Oklahoma,U.S. Senate,Connie Johnson,DEM,550135,0,0,15,15,
Oklahoma,U.S. House,Tom Guild,DEM,550135,0,0,10,10,05
Oklahoma,U.S. House,Al Mcaffrey,DEM,550135,0,0,6,6,05
Oklahoma,U.S. House,Leona Leonard,DEM,550135,0,0,5,5,05
Oklahoma,Governor,Dax Ewbank,REP,550135,0,0,11,11,
Oklahoma,Governor,Chad Moody,REP,550135,0,0,18,18,
Oklahoma,Governor,Mary Fallin,REP,550135,0,0,80,80,
Oklahoma,Superintendent of Public Instruction,Brian Kelly,REP,550135,0,0,18,18,
Oklahoma,Superintendent of Public Instruction,Janet Costello Barresi,REP,550135,0,0,24,24,
Oklahoma,Superintendent of Public Instruction,Joy Hofmeister,REP,550135,0,0,64,64,
Oklahoma,Insurance Commissioner,Bill Viner,REP,550135,0,0,22,22,
Oklahoma,Insurance Commissioner,John Doak,REP,550135,0,0,74,74,
Oklahoma,Corporation Commissioner,Todd Hiett,REP,550135,0,0,44,44,
Oklahoma,Corporation Commissioner,Cliff Branan,REP,550135,0,0,52,52,
Oklahoma,U.S. Senate,Evelyn Rogers,REP,550135,0,0,3,3,
Oklahoma,U.S. Senate,Rob Moye,REP,550135,0,0,1,1,
Oklahoma,U.S. Senate,D. Jean Mcbride-Samuels,REP,550135,0,0,5,5,
Oklahoma,U.S. Senate,Jim Inhofe,REP,550135,0,0,91,91,
Oklahoma,U.S. Senate,Erick Paul Wyatt,REP,550135,0,0,4,4,
Oklahoma,U.S. Senate,Andy Craig,REP,550135,0,0,0,0,
Oklahoma,U.S. Senate,T. Shannon,REP,550135,0,0,25,25,
Oklahoma,U.S. Senate,Randy Brogdon,REP,550135,0,0,2,2,
Oklahoma,U.S. Senate,Eric Mccray,REP,550135,0,0,0,0,
Oklahoma,U.S. Senate,Kevin Crow,REP,550135,0,0,0,0,
Oklahoma,U.S. Senate,James Lankford,REP,550135,0,0,80,80,
Oklahoma,U.S. Senate,Jason Weger,REP,550135,0,0,1,1,
Oklahoma,U.S. House,Shane David Jett,REP,550135,0,0,7,7,05
Oklahoma,U.S. House,Patrice Douglas,REP,550135,0,0,24,24,05
Oklahoma,U.S. House,Mike Turner,REP,550135,0,0,19,19,05
Oklahoma,U.S. House,Steve Russell,REP,550135,0,0,26,26,05
Oklahoma,U.S. House,Harvey Sparks,REP,550135,0,0,4,4,05
Oklahoma,U.S. House,Clark Jolley,REP,550135,0,0,20,20,05
Oklahoma,State Senate,Mark Thomas,REP,550135,0,0,20,20,22
Oklahoma,State Senate,Leif Francel,REP,550135,0,0,24,24,22
Oklahoma,State Senate,Stephanie Bice,REP,550135,0,0,56,56,22
Oklahoma,State House,Gregory Duke Brown,REP,550135,0,0,4,4,82
Oklahoma,State House,Dustin Hopson,REP,550135,0,0,18,18,82
Oklahoma,State House,Adam Pugh,REP,550135,0,0,31,31,82
Oklahoma,State House,Kevin Calvey,REP,550135,0,0,42,42,82
Oklahoma,State House,Paul Ruckel,REP,550135,0,0,3,3,82
Oklahoma,Superintendent of Public Instruction,John Cox,DEM,550136,0,0,27,27,
Oklahoma,Superintendent of Public Instruction,Jack Jr.,DEM,550136,0,0,16,16,
Oklahoma,Superintendent of Public Instruction,Ivan Holmes,DEM,550136,0,0,7,7,
Oklahoma,Superintendent of Public Instruction,Freda Deskin,DEM,550136,0,0,50,50,
Oklahoma,U.S. Senate,Patrick Michael Hayes,DEM,550136,0,0,17,17,
Oklahoma,U.S. Senate,Jim Rogers,DEM,550136,0,0,19,19,
Oklahoma,U.S. Senate,Connie Johnson,DEM,550136,0,0,63,63,
Oklahoma,U.S. House,Tom Guild,DEM,550136,0,0,41,41,05
Oklahoma,U.S. House,Al Mcaffrey,DEM,550136,0,0,28,28,05
Oklahoma,U.S. House,Leona Leonard,DEM,550136,0,0,29,29,05
Oklahoma,Governor,Dax Ewbank,REP,550136,0,0,51,51,
Oklahoma,Governor,Chad Moody,REP,550136,0,0,71,71,
Oklahoma,Governor,Mary Fallin,REP,550136,0,0,380,380,
Oklahoma,Superintendent of Public Instruction,Brian Kelly,REP,550136,0,0,92,92,
Oklahoma,Superintendent of Public Instruction,Janet Costello Barresi,REP,550136,0,0,138,138,
Oklahoma,Superintendent of Public Instruction,Joy Hofmeister,REP,550136,0,0,271,271,
Oklahoma,Insurance Commissioner,Bill Viner,REP,550136,0,0,89,89,
Oklahoma,Insurance Commissioner,John Doak,REP,550136,0,0,368,368,
Oklahoma,Corporation Commissioner,Todd Hiett,REP,550136,0,0,199,199,
Oklahoma,Corporation Commissioner,Cliff Branan,REP,550136,0,0,265,265,
Oklahoma,U.S. Senate,Evelyn Rogers,REP,550136,0,0,28,28,
Oklahoma,U.S. Senate,Rob Moye,REP,550136,0,0,12,12,
Oklahoma,U.S. Senate,D. Jean Mcbride-Samuels,REP,550136,0,0,5,5,
Oklahoma,U.S. Senate,Jim Inhofe,REP,550136,0,0,448,448,
Oklahoma,U.S. Senate,Erick Paul Wyatt,REP,550136,0,0,10,10,
Oklahoma,U.S. Senate,Andy Craig,REP,550136,0,0,1,1,
Oklahoma,U.S. Senate,T. Shannon,REP,550136,0,0,130,130,
Oklahoma,U.S. Senate,Randy Brogdon,REP,550136,0,0,11,11,
Oklahoma,U.S. Senate,Eric Mccray,REP,550136,0,0,1,1,
Oklahoma,U.S. Senate,Kevin Crow,REP,550136,0,0,2,2,
Oklahoma,U.S. Senate,James Lankford,REP,550136,0,0,365,365,
Oklahoma,U.S. Senate,Jason Weger,REP,550136,0,0,3,3,
Oklahoma,U.S. House,Shane David Jett,REP,550136,0,0,42,42,05
Oklahoma,U.S. House,Patrice Douglas,REP,550136,0,0,126,126,05
Oklahoma,U.S. House,Mike Turner,REP,550136,0,0,124,124,05
Oklahoma,U.S. House,Steve Russell,REP,550136,0,0,86,86,05
Oklahoma,U.S. House,Harvey Sparks,REP,550136,0,0,13,13,05
Oklahoma,U.S. House,Clark Jolley,REP,550136,0,0,96,96,05
Oklahoma,State Senate,Mark Thomas,REP,550136,0,0,145,145,22
Oklahoma,State Senate,Leif Francel,REP,550136,0,0,100,100,22
Oklahoma,State Senate,Stephanie Bice,REP,550136,0,0,221,221,22
Oklahoma,State House,Gregory Duke Brown,REP,550136,0,0,10,10,82
Oklahoma,State House,Dustin Hopson,REP,550136,0,0,38,38,82
Oklahoma,State House,Adam Pugh,REP,550136,0,0,213,213,82
Oklahoma,State House,Kevin Calvey,REP,550136,0,0,215,215,82
Oklahoma,State House,Paul Ruckel,REP,550136,0,0,5,5,82
Oklahoma,Superintendent of Public Instruction,John Cox,DEM,550137,0,0,8,8,
Oklahoma,Superintendent of Public Instruction,Jack Jr.,DEM,550137,0,0,3,3,
Oklahoma,Superintendent of Public Instruction,Ivan Holmes,DEM,550137,0,0,6,6,
Oklahoma,Superintendent of Public Instruction,Freda Deskin,DEM,550137,0,0,17,17,
Oklahoma,U.S. Senate,Patrick Michael Hayes,DEM,550137,0,0,8,8,
Oklahoma,U.S. Senate,Jim Rogers,DEM,550137,0,0,7,7,
Oklahoma,U.S. Senate,Connie Johnson,DEM,550137,0,0,19,19,
Oklahoma,U.S. House,Tom Guild,DEM,550137,0,0,14,14,05
Oklahoma,U.S. House,Al Mcaffrey,DEM,550137,0,0,16,16,05
Oklahoma,U.S. House,Leona Leonard,DEM,550137,0,0,5,5,05
Oklahoma,Governor,Dax Ewbank,REP,550137,0,0,39,39,
Oklahoma,Governor,Chad Moody,REP,550137,0,0,44,44,
Oklahoma,Governor,Mary Fallin,REP,550137,0,0,274,274,
Oklahoma,Superintendent of Public Instruction,Brian Kelly,REP,550137,0,0,66,66,
Oklahoma,Superintendent of Public Instruction,Janet Costello Barresi,REP,550137,0,0,93,93,
Oklahoma,Superintendent of Public Instruction,Joy Hofmeister,REP,550137,0,0,196,196,
Oklahoma,Insurance Commissioner,Bill Viner,REP,550137,0,0,73,73,
Oklahoma,Insurance Commissioner,John Doak,REP,550137,0,0,236,236,
Oklahoma,Corporation Commissioner,Todd Hiett,REP,550137,0,0,150,150,
Oklahoma,Corporation Commissioner,Cliff Branan,REP,550137,0,0,166,166,
Oklahoma,U.S. Senate,Evelyn Rogers,REP,550137,0,0,12,12,
Oklahoma,U.S. Senate,Rob Moye,REP,550137,0,0,6,6,
Oklahoma,U.S. Senate,D. Jean Mcbride-Samuels,REP,550137,0,0,3,3,
Oklahoma,U.S. Senate,Jim Inhofe,REP,550137,0,0,322,322,
Oklahoma,U.S. Senate,Erick Paul Wyatt,REP,550137,0,0,7,7,
Oklahoma,U.S. Senate,Andy Craig,REP,550137,0,0,2,2,
Oklahoma,U.S. Senate,T. Shannon,REP,550137,0,0,95,95,
Oklahoma,U.S. Senate,Randy Brogdon,REP,550137,0,0,10,10,
Oklahoma,U.S. Senate,Eric Mccray,REP,550137,0,0,1,1,
Oklahoma,U.S. Senate,Kevin Crow,REP,550137,0,0,0,0,
Oklahoma,U.S. Senate,James Lankford,REP,550137,0,0,255,255,
Oklahoma,U.S. Senate,Jason Weger,REP,550137,0,0,0,0,
Oklahoma,U.S. House,Shane David Jett,REP,550137,0,0,30,30,05
Oklahoma,U.S. House,Patrice Douglas,REP,550137,0,0,106,106,05
Oklahoma,U.S. House,Mike Turner,REP,550137,0,0,49,49,05
Oklahoma,U.S. House,Steve Russell,REP,550137,0,0,91,91,05
Oklahoma,U.S. House,Harvey Sparks,REP,550137,0,0,15,15,05
Oklahoma,U.S. House,Clark Jolley,REP,550137,0,0,47,47,05
Oklahoma,State Senate,Mark Thomas,REP,550137,0,0,87,87,22
Oklahoma,State Senate,Leif Francel,REP,550137,0,0,99,99,22
Oklahoma,State Senate,Stephanie Bice,REP,550137,0,0,129,129,22
Oklahoma,State House,Gregory Duke Brown,REP,550137,0,0,8,8,82
Oklahoma,State House,Dustin Hopson,REP,550137,0,0,52,52,82
Oklahoma,State House,Adam Pugh,REP,550137,0,0,126,126,82
Oklahoma,State House,Kevin Calvey,REP,550137,0,0,136,136,82
Oklahoma,State House,Paul Ruckel,REP,550137,0,0,7,7,82
Oklahoma,Superintendent of Public Instruction,John Cox,DEM,550138,0,0,10,10,
Oklahoma,Superintendent of Public Instruction,Jack Jr.,DEM,550138,0,0,3,3,
Oklahoma,Superintendent of Public Instruction,Ivan Holmes,DEM,550138,0,0,2,2,
Oklahoma,Superintendent of Public Instruction,Freda Deskin,DEM,550138,0,0,12,12,
Oklahoma,U.S. Senate,Patrick Michael Hayes,DEM,550138,0,0,5,5,
Oklahoma,U.S. Senate,Jim Rogers,DEM,550138,0,0,8,8,
Oklahoma,U.S. Senate,Connie Johnson,DEM,550138,0,0,10,10,
Oklahoma,U.S. House,Tom Guild,DEM,550138,0,0,10,10,05
Oklahoma,U.S. House,Al Mcaffrey,DEM,550138,0,0,6,6,05
Oklahoma,U.S. House,Leona Leonard,DEM,550138,0,0,7,7,05
Oklahoma,Governor,Dax Ewbank,REP,550138,0,0,9,9,
Oklahoma,Governor,Chad Moody,REP,550138,0,0,23,23,
Oklahoma,Governor,Mary Fallin,REP,550138,0,0,131,131,
Oklahoma,Superintendent of Public Instruction,Brian Kelly,REP,550138,0,0,25,25,
Oklahoma,Superintendent of Public Instruction,Janet Costello Barresi,REP,550138,0,0,57,57,
Oklahoma,Superintendent of Public Instruction,Joy Hofmeister,REP,550138,0,0,76,76,
Oklahoma,Insurance Commissioner,Bill Viner,REP,550138,0,0,20,20,
Oklahoma,Insurance Commissioner,John Doak,REP,550138,0,0,126,126,
Oklahoma,Corporation Commissioner,Todd Hiett,REP,550138,0,0,74,74,
Oklahoma,Corporation Commissioner,Cliff Branan,REP,550138,0,0,67,67,
Oklahoma,U.S. Senate,Evelyn Rogers,REP,550138,0,0,1,1,
Oklahoma,U.S. Senate,Rob Moye,REP,550138,0,0,4,4,
Oklahoma,U.S. Senate,D. Jean Mcbride-Samuels,REP,550138,0,0,0,0,
Oklahoma,U.S. Senate,Jim Inhofe,REP,550138,0,0,151,151,
Oklahoma,U.S. Senate,Erick Paul Wyatt,REP,550138,0,0,6,6,
Oklahoma,U.S. Senate,Andy Craig,REP,550138,0,0,1,1,
Oklahoma,U.S. Senate,T. Shannon,REP,550138,0,0,33,33,
Oklahoma,U.S. Senate,Randy Brogdon,REP,550138,0,0,2,2,
Oklahoma,U.S. Senate,Eric Mccray,REP,550138,0,0,0,0,
Oklahoma,U.S. Senate,Kevin Crow,REP,550138,0,0,0,0,
Oklahoma,U.S. Senate,James Lankford,REP,550138,0,0,131,131,
Oklahoma,U.S. Senate,Jason Weger,REP,550138,0,0,0,0,
Oklahoma,U.S. House,Shane David Jett,REP,550138,0,0,14,14,05
Oklahoma,U.S. House,Patrice Douglas,REP,550138,0,0,45,45,05
Oklahoma,U.S. House,Mike Turner,REP,550138,0,0,19,19,05
Oklahoma,U.S. House,Steve Russell,REP,550138,0,0,43,43,05
Oklahoma,U.S. House,Harvey Sparks,REP,550138,0,0,10,10,05
Oklahoma,U.S. House,Clark Jolley,REP,550138,0,0,23,23,05
Oklahoma,State Senate,Mark Thomas,REP,550138,0,0,38,38,22
Oklahoma,State Senate,Leif Francel,REP,550138,0,0,49,49,22
Oklahoma,State Senate,Stephanie Bice,REP,550138,0,0,61,61,22
Oklahoma,State House,Ross Vanhooser,REP,550138,0,0,53,53,41
Oklahoma,State House,John Enns,REP,550138,0,0,84,84,41
Oklahoma,Superintendent of Public Instruction,John Cox,DEM,550139,0,0,25,25,
Oklahoma,Superintendent of Public Instruction,Jack Jr.,DEM,550139,0,0,12,12,
Oklahoma,Superintendent of Public Instruction,Ivan Holmes,DEM,550139,0,0,6,6,
Oklahoma,Superintendent of Public Instruction,Freda Deskin,DEM,550139,0,0,39,39,
Oklahoma,U.S. Senate,Patrick Michael Hayes,DEM,550139,0,0,17,17,
Oklahoma,U.S. Senate,Jim Rogers,DEM,550139,0,0,9,9,
Oklahoma,U.S. Senate,Connie Johnson,DEM,550139,0,0,53,53,
Oklahoma,U.S. House,Tom Guild,DEM,550139,0,0,33,33,05
Oklahoma,U.S. House,Al Mcaffrey,DEM,550139,0,0,24,24,05
Oklahoma,U.S. House,Leona Leonard,DEM,550139,0,0,21,21,05
Oklahoma,Governor,Dax Ewbank,REP,550139,0,0,34,34,
Oklahoma,Governor,Chad Moody,REP,550139,0,0,74,74,
Oklahoma,Governor,Mary Fallin,REP,550139,0,0,401,401,
Oklahoma,Superintendent of Public Instruction,Brian Kelly,REP,550139,0,0,75,75,
Oklahoma,Superintendent of Public Instruction,Janet Costello Barresi,REP,550139,0,0,160,160,
Oklahoma,Superintendent of Public Instruction,Joy Hofmeister,REP,550139,0,0,276,276,
Oklahoma,Insurance Commissioner,Bill Viner,REP,550139,0,0,58,58,
Oklahoma,Insurance Commissioner,John Doak,REP,550139,0,0,395,395,
Oklahoma,Corporation Commissioner,Todd Hiett,REP,550139,0,0,205,205,
Oklahoma,Corporation Commissioner,Cliff Branan,REP,550139,0,0,258,258,
Oklahoma,U.S. Senate,Evelyn Rogers,REP,550139,0,0,16,16,
Oklahoma,U.S. Senate,Rob Moye,REP,550139,0,0,6,6,
Oklahoma,U.S. Senate,D. Jean Mcbride-Samuels,REP,550139,0,0,4,4,
Oklahoma,U.S. Senate,Jim Inhofe,REP,550139,0,0,467,467,
Oklahoma,U.S. Senate,Erick Paul Wyatt,REP,550139,0,0,15,15,
Oklahoma,U.S. Senate,Andy Craig,REP,550139,0,0,1,1,
Oklahoma,U.S. Senate,T. Shannon,REP,550139,0,0,105,105,
Oklahoma,U.S. Senate,Randy Brogdon,REP,550139,0,0,14,14,
Oklahoma,U.S. Senate,Eric Mccray,REP,550139,0,0,0,0,
Oklahoma,U.S. Senate,Kevin Crow,REP,550139,0,0,1,1,
Oklahoma,U.S. Senate,James Lankford,REP,550139,0,0,398,398,
Oklahoma,U.S. Senate,Jason Weger,REP,550139,0,0,0,0,
Oklahoma,U.S. House,Shane David Jett,REP,550139,0,0,48,48,05
Oklahoma,U.S. House,Patrice Douglas,REP,550139,0,0,146,146,05
Oklahoma,U.S. House,Mike Turner,REP,550139,0,0,72,72,05
Oklahoma,U.S. House,Steve Russell,REP,550139,0,0,147,147,05
Oklahoma,U.S. House,Harvey Sparks,REP,550139,0,0,19,19,05
Oklahoma,U.S. House,Clark Jolley,REP,550139,0,0,63,63,05
Oklahoma,State House,Gregory Duke Brown,REP,550139,0,0,12,12,82
Oklahoma,State House,Dustin Hopson,REP,550139,0,0,49,49,82
Oklahoma,State House,Adam Pugh,REP,550139,0,0,173,173,82
Oklahoma,State House,Kevin Calvey,REP,550139,0,0,224,224,82
Oklahoma,State House,Paul Ruckel,REP,550139,0,0,9,9,82
Oklahoma,Superintendent of Public Instruction,John Cox,DEM,550140,0,0,10,10,
Oklahoma,Superintendent of Public Instruction,Jack Jr.,DEM,550140,0,0,2,2,
Oklahoma,Superintendent of Public Instruction,Ivan Holmes,DEM,550140,0,0,2,2,
Oklahoma,Superintendent of Public Instruction,Freda Deskin,DEM,550140,0,0,22,22,
Oklahoma,U.S. Senate,Patrick Michael Hayes,DEM,550140,0,0,8,8,
Oklahoma,U.S. Senate,Jim Rogers,DEM,550140,0,0,5,5,
Oklahoma,U.S. Senate,Connie Johnson,DEM,550140,0,0,22,22,
Oklahoma,U.S. House,Tom Guild,DEM,550140,0,0,13,13,05
Oklahoma,U.S. House,Al Mcaffrey,DEM,550140,0,0,9,9,05
Oklahoma,U.S. House,Leona Leonard,DEM,550140,0,0,15,15,05
Oklahoma,Governor,Dax Ewbank,REP,550140,0,0,8,8,
Oklahoma,Governor,Chad Moody,REP,550140,0,0,23,23,
Oklahoma,Governor,Mary Fallin,REP,550140,0,0,243,243,
Oklahoma,Superintendent of Public Instruction,Brian Kelly,REP,550140,0,0,35,35,
Oklahoma,Superintendent of Public Instruction,Janet Costello Barresi,REP,550140,0,0,124,124,
Oklahoma,Superintendent of Public Instruction,Joy Hofmeister,REP,550140,0,0,106,106,
Oklahoma,Insurance Commissioner,Bill Viner,REP,550140,0,0,44,44,
Oklahoma,Insurance Commissioner,John Doak,REP,550140,0,0,201,201,
Oklahoma,Corporation Commissioner,Todd Hiett,REP,550140,0,0,125,125,
Oklahoma,Corporation Commissioner,Cliff Branan,REP,550140,0,0,119,119,
Oklahoma,U.S. Senate,Evelyn Rogers,REP,550140,0,0,12,12,
Oklahoma,U.S. Senate,Rob Moye,REP,550140,0,0,2,2,
Oklahoma,U.S. Senate,D. Jean Mcbride-Samuels,REP,550140,0,0,2,2,
Oklahoma,U.S. Senate,Jim Inhofe,REP,550140,0,0,254,254,
Oklahoma,U.S. Senate,Erick Paul Wyatt,REP,550140,0,0,2,2,
Oklahoma,U.S. Senate,Andy Craig,REP,550140,0,0,0,0,
Oklahoma,U.S. Senate,T. Shannon,REP,550140,0,0,48,48,
Oklahoma,U.S. Senate,Randy Brogdon,REP,550140,0,0,9,9,
Oklahoma,U.S. Senate,Eric Mccray,REP,550140,0,0,1,1,
Oklahoma,U.S. Senate,Kevin Crow,REP,550140,0,0,1,1,
Oklahoma,U.S. Senate,James Lankford,REP,550140,0,0,219,219,
Oklahoma,U.S. Senate,Jason Weger,REP,550140,0,0,0,0,
Oklahoma,U.S. House,Shane David Jett,REP,550140,0,0,19,19,05
Oklahoma,U.S. House,Patrice Douglas,REP,550140,0,0,93,93,05
Oklahoma,U.S. House,Mike Turner,REP,550140,0,0,61,61,05
Oklahoma,U.S. House,Steve Russell,REP,550140,0,0,42,42,05
Oklahoma,U.S. House,Harvey Sparks,REP,550140,0,0,9,9,05
Oklahoma,U.S. House,Clark Jolley,REP,550140,0,0,41,41,05
Oklahoma,State House,Gregory Duke Brown,REP,550140,0,0,4,4,82
Oklahoma,State House,Dustin Hopson,REP,550140,0,0,25,25,82
Oklahoma,State House,Adam Pugh,REP,550140,0,0,59,59,82
Oklahoma,State House,Kevin Calvey,REP,550140,0,0,153,153,82
Oklahoma,State House,Paul Ruckel,REP,550140,0,0,8,8,82
Oklahoma,Superintendent of Public Instruction,John Cox,DEM,550141,0,0,29,29,
Oklahoma,Superintendent of Public Instruction,Jack Jr.,DEM,550141,0,0,3,3,
Oklahoma,Superintendent of Public Instruction,Ivan Holmes,DEM,550141,0,0,5,5,
Oklahoma,Superintendent of Public Instruction,Freda Deskin,DEM,550141,0,0,46,46,
Oklahoma,U.S. Senate,Patrick Michael Hayes,DEM,550141,0,0,11,11,
Oklahoma,U.S. Senate,Jim Rogers,DEM,550141,0,0,19,19,
Oklahoma,U.S. Senate,Connie Johnson,DEM,550141,0,0,50,50,
Oklahoma,U.S. House,Tom Guild,DEM,550141,0,0,31,31,05
Oklahoma,U.S. House,Al Mcaffrey,DEM,550141,0,0,34,34,05
Oklahoma,U.S. House,Leona Leonard,DEM,550141,0,0,16,16,05
Oklahoma,Governor,Dax Ewbank,REP,550141,0,0,26,26,
Oklahoma,Governor,Chad Moody,REP,550141,0,0,43,43,
Oklahoma,Governor,Mary Fallin,REP,550141,0,0,333,333,
Oklahoma,Superintendent of Public Instruction,Brian Kelly,REP,550141,0,0,55,55,
Oklahoma,Superintendent of Public Instruction,Janet Costello Barresi,REP,550141,0,0,135,135,
Oklahoma,Superintendent of Public Instruction,Joy Hofmeister,REP,550141,0,0,204,204,
Oklahoma,Insurance Commissioner,Bill Viner,REP,550141,0,0,59,59,
Oklahoma,Insurance Commissioner,John Doak,REP,550141,0,0,303,303,
Oklahoma,Corporation Commissioner,Todd Hiett,REP,550141,0,0,169,169,
Oklahoma,Corporation Commissioner,Cliff Branan,REP,550141,0,0,200,200,
Oklahoma,U.S. Senate,Evelyn Rogers,REP,550141,0,0,12,12,
Oklahoma,U.S. Senate,Rob Moye,REP,550141,0,0,7,7,
Oklahoma,U.S. Senate,D. Jean Mcbride-Samuels,REP,550141,0,0,4,4,
Oklahoma,U.S. Senate,Jim Inhofe,REP,550141,0,0,360,360,
Oklahoma,U.S. Senate,Erick Paul Wyatt,REP,550141,0,0,16,16,
Oklahoma,U.S. Senate,Andy Craig,REP,550141,0,0,2,2,
Oklahoma,U.S. Senate,T. Shannon,REP,550141,0,0,91,91,
Oklahoma,U.S. Senate,Randy Brogdon,REP,550141,0,0,5,5,
Oklahoma,U.S. Senate,Eric Mccray,REP,550141,0,0,0,0,
Oklahoma,U.S. Senate,Kevin Crow,REP,550141,0,0,1,1,
Oklahoma,U.S. Senate,James Lankford,REP,550141,0,0,302,302,
Oklahoma,U.S. Senate,Jason Weger,REP,550141,0,0,3,3,
Oklahoma,U.S. House,Shane David Jett,REP,550141,0,0,38,38,05
Oklahoma,U.S. House,Patrice Douglas,REP,550141,0,0,110,110,05
Oklahoma,U.S. House,Mike Turner,REP,550141,0,0,60,60,05
Oklahoma,U.S. House,Steve Russell,REP,550141,0,0,112,112,05
Oklahoma,U.S. House,Harvey Sparks,REP,550141,0,0,20,20,05
Oklahoma,U.S. House,Clark Jolley,REP,550141,0,0,45,45,05
Oklahoma,State House,Ross Vanhooser,REP,550141,0,0,156,156,41
Oklahoma,State House,John Enns,REP,550141,0,0,207,207,41
Oklahoma,Superintendent of Public Instruction,John Cox,DEM,550142,0,0,31,31,
Oklahoma,Superintendent of Public Instruction,Jack Jr.,DEM,550142,0,0,14,14,
Oklahoma,Superintendent of Public Instruction,Ivan Holmes,DEM,550142,0,0,10,10,
Oklahoma,Superintendent of Public Instruction,Freda Deskin,DEM,550142,0,0,62,62,
Oklahoma,U.S. Senate,Patrick Michael Hayes,DEM,550142,0,0,18,18,
Oklahoma,U.S. Senate,Jim Rogers,DEM,550142,0,0,17,17,
Oklahoma,U.S. Senate,Connie Johnson,DEM,550142,0,0,80,80,
Oklahoma,U.S. House,Tom Guild,DEM,550142,0,0,50,50,05
Oklahoma,U.S. House,Al Mcaffrey,DEM,550142,0,0,37,37,05
Oklahoma,U.S. House,Leona Leonard,DEM,550142,0,0,27,27,05
Oklahoma,Governor,Dax Ewbank,REP,550142,0,0,30,30,
Oklahoma,Governor,Chad Moody,REP,550142,0,0,60,60,
Oklahoma,Governor,Mary Fallin,REP,550142,0,0,397,397,
Oklahoma,Superintendent of Public Instruction,Brian Kelly,REP,550142,0,0,85,85,
Oklahoma,Superintendent of Public Instruction,Janet Costello Barresi,REP,550142,0,0,149,149,
Oklahoma,Superintendent of Public Instruction,Joy Hofmeister,REP,550142,0,0,243,243,
Oklahoma,Insurance Commissioner,Bill Viner,REP,550142,0,0,88,88,
Oklahoma,Insurance Commissioner,John Doak,REP,550142,0,0,346,346,
Oklahoma,Corporation Commissioner,Todd Hiett,REP,550142,0,0,198,198,
Oklahoma,Corporation Commissioner,Cliff Branan,REP,550142,0,0,240,240,
Oklahoma,U.S. Senate,Evelyn Rogers,REP,550142,0,0,16,16,
Oklahoma,U.S. Senate,Rob Moye,REP,550142,0,0,11,11,
Oklahoma,U.S. Senate,D. Jean Mcbride-Samuels,REP,550142,0,0,6,6,
Oklahoma,U.S. Senate,Jim Inhofe,REP,550142,0,0,435,435,
Oklahoma,U.S. Senate,Erick Paul Wyatt,REP,550142,0,0,11,11,
Oklahoma,U.S. Senate,Andy Craig,REP,550142,0,0,1,1,
Oklahoma,U.S. Senate,T. Shannon,REP,550142,0,0,118,118,
Oklahoma,U.S. Senate,Randy Brogdon,REP,550142,0,0,9,9,
Oklahoma,U.S. Senate,Eric Mccray,REP,550142,0,0,2,2,
Oklahoma,U.S. Senate,Kevin Crow,REP,550142,0,0,2,2,
Oklahoma,U.S. Senate,James Lankford,REP,550142,0,0,364,364,
Oklahoma,U.S. Senate,Jason Weger,REP,550142,0,0,2,2,
Oklahoma,U.S. House,Shane David Jett,REP,550142,0,0,43,43,05
Oklahoma,U.S. House,Patrice Douglas,REP,550142,0,0,109,109,05
Oklahoma,U.S. House,Mike Turner,REP,550142,0,0,98,98,05
Oklahoma,U.S. House,Steve Russell,REP,550142,0,0,118,118,05
Oklahoma,U.S. House,Harvey Sparks,REP,550142,0,0,32,32,05
Oklahoma,U.S. House,Clark Jolley,REP,550142,0,0,64,64,05
Oklahoma,State House,Gregory Duke Brown,REP,550142,0,0,9,9,82
Oklahoma,State House,Dustin Hopson,REP,550142,0,0,45,45,82
Oklahoma,State House,Adam Pugh,REP,550142,0,0,116,116,82
Oklahoma,State House,Kevin Calvey,REP,550142,0,0,268,268,82
Oklahoma,State House,Paul Ruckel,REP,550142,0,0,10,10,82
Oklahoma,Superintendent of Public Instruction,John Cox,DEM,550143,0,0,16,16,
Oklahoma,Superintendent of Public Instruction,Jack Jr.,DEM,550143,0,0,4,4,
Oklahoma,Superintendent of Public Instruction,Ivan Holmes,DEM,550143,0,0,5,5,
Oklahoma,Superintendent of Public Instruction,Freda Deskin,DEM,550143,0,0,32,32,
Oklahoma,U.S. Senate,Patrick Michael Hayes,DEM,550143,0,0,5,5,
Oklahoma,U.S. Senate,Jim Rogers,DEM,550143,0,0,13,13,
Oklahoma,U.S. Senate,Connie Johnson,DEM,550143,0,0,37,37,
Oklahoma,U.S. House,Tom Guild,DEM,550143,0,0,20,20,05
Oklahoma,U.S. House,Al Mcaffrey,DEM,550143,0,0,19,19,05
Oklahoma,U.S. House,Leona Leonard,DEM,550143,0,0,15,15,05
Oklahoma,Governor,Dax Ewbank,REP,550143,0,0,8,8,
Oklahoma,Governor,Chad Moody,REP,550143,0,0,29,29,
Oklahoma,Governor,Mary Fallin,REP,550143,0,0,342,342,
Oklahoma,Superintendent of Public Instruction,Brian Kelly,REP,550143,0,0,56,56,
Oklahoma,Superintendent of Public Instruction,Janet Costello Barresi,REP,550143,0,0,200,200,
Oklahoma,Superintendent of Public Instruction,Joy Hofmeister,REP,550143,0,0,113,113,
Oklahoma,Insurance Commissioner,Bill Viner,REP,550143,0,0,64,64,
Oklahoma,Insurance Commissioner,John Doak,REP,550143,0,0,276,276,
Oklahoma,Corporation Commissioner,Todd Hiett,REP,550143,0,0,143,143,
Oklahoma,Corporation Commissioner,Cliff Branan,REP,550143,0,0,201,201,
Oklahoma,U.S. Senate,Evelyn Rogers,REP,550143,0,0,11,11,
Oklahoma,U.S. Senate,Rob Moye,REP,550143,0,0,4,4,
Oklahoma,U.S. Senate,D. Jean Mcbride-Samuels,REP,550143,0,0,3,3,
Oklahoma,U.S. Senate,Jim Inhofe,REP,550143,0,0,356,356,
Oklahoma,U.S. Senate,Erick Paul Wyatt,REP,550143,0,0,5,5,
Oklahoma,U.S. Senate,Andy Craig,REP,550143,0,0,1,1,
Oklahoma,U.S. Senate,T. Shannon,REP,550143,0,0,64,64,
Oklahoma,U.S. Senate,Randy Brogdon,REP,550143,0,0,6,6,
Oklahoma,U.S. Senate,Eric Mccray,REP,550143,0,0,1,1,
Oklahoma,U.S. Senate,Kevin Crow,REP,550143,0,0,0,0,
Oklahoma,U.S. Senate,James Lankford,REP,550143,0,0,311,311,
Oklahoma,U.S. Senate,Jason Weger,REP,550143,0,0,0,0,
Oklahoma,U.S. House,Shane David Jett,REP,550143,0,0,19,19,05
Oklahoma,U.S. House,Patrice Douglas,REP,550143,0,0,94,94,05
Oklahoma,U.S. House,Mike Turner,REP,550143,0,0,82,82,05
Oklahoma,U.S. House,Steve Russell,REP,550143,0,0,104,104,05
Oklahoma,U.S. House,Harvey Sparks,REP,550143,0,0,16,16,05
Oklahoma,U.S. House,Clark Jolley,REP,550143,0,0,48,48,05
Oklahoma,State House,Gregory Duke Brown,REP,550143,0,0,12,12,82
Oklahoma,State House,Dustin Hopson,REP,550143,0,0,25,25,82
Oklahoma,State House,Adam Pugh,REP,550143,0,0,103,103,82
Oklahoma,State House,Kevin Calvey,REP,550143,0,0,208,208,82
Oklahoma,State House,Paul Ruckel,REP,550143,0,0,1,1,82
Oklahoma,Superintendent of Public Instruction,John Cox,DEM,550144,0,0,21,21,
Oklahoma,Superintendent of Public Instruction,Jack Jr.,DEM,550144,0,0,7,7,
Oklahoma,Superintendent of Public Instruction,Ivan Holmes,DEM,550144,0,0,6,6,
Oklahoma,Superintendent of Public Instruction,Freda Deskin,DEM,550144,0,0,42,42,
Oklahoma,U.S. Senate,Patrick Michael Hayes,DEM,550144,0,0,11,11,
Oklahoma,U.S. Senate,Jim Rogers,DEM,550144,0,0,17,17,
Oklahoma,U.S. Senate,Connie Johnson,DEM,550144,0,0,47,47,
Oklahoma,U.S. House,Tom Guild,DEM,550144,0,0,31,31,05
Oklahoma,U.S. House,Al Mcaffrey,DEM,550144,0,0,22,22,05
Oklahoma,U.S. House,Leona Leonard,DEM,550144,0,0,19,19,05
Oklahoma,Governor,Dax Ewbank,REP,550144,0,0,27,27,
Oklahoma,Governor,Chad Moody,REP,550144,0,0,34,34,
Oklahoma,Governor,Mary Fallin,REP,550144,0,0,346,346,
Oklahoma,Superintendent of Public Instruction,Brian Kelly,REP,550144,0,0,68,68,
Oklahoma,Superintendent of Public Instruction,Janet Costello Barresi,REP,550144,0,0,180,180,
Oklahoma,Superintendent of Public Instruction,Joy Hofmeister,REP,550144,0,0,154,154,
Oklahoma,Insurance Commissioner,Bill Viner,REP,550144,0,0,69,69,
Oklahoma,Insurance Commissioner,John Doak,REP,550144,0,0,305,305,
Oklahoma,Corporation Commissioner,Todd Hiett,REP,550144,0,0,164,164,
Oklahoma,Corporation Commissioner,Cliff Branan,REP,550144,0,0,211,211,
Oklahoma,U.S. Senate,Evelyn Rogers,REP,550144,0,0,9,9,
Oklahoma,U.S. Senate,Rob Moye,REP,550144,0,0,7,7,
Oklahoma,U.S. Senate,D. Jean Mcbride-Samuels,REP,550144,0,0,4,4,
Oklahoma,U.S. Senate,Jim Inhofe,REP,550144,0,0,372,372,
Oklahoma,U.S. Senate,Erick Paul Wyatt,REP,550144,0,0,11,11,
Oklahoma,U.S. Senate,Andy Craig,REP,550144,0,0,3,3,
Oklahoma,U.S. Senate,T. Shannon,REP,550144,0,0,69,69,
Oklahoma,U.S. Senate,Randy Brogdon,REP,550144,0,0,5,5,
Oklahoma,U.S. Senate,Eric Mccray,REP,550144,0,0,0,0,
Oklahoma,U.S. Senate,Kevin Crow,REP,550144,0,0,2,2,
Oklahoma,U.S. Senate,James Lankford,REP,550144,0,0,330,330,
Oklahoma,U.S. Senate,Jason Weger,REP,550144,0,0,0,0,
Oklahoma,U.S. House,Shane David Jett,REP,550144,0,0,23,23,05
Oklahoma,U.S. House,Patrice Douglas,REP,550144,0,0,87,87,05
Oklahoma,U.S. House,Mike Turner,REP,550144,0,0,124,124,05
Oklahoma,U.S. House,Steve Russell,REP,550144,0,0,116,116,05
Oklahoma,U.S. House,Harvey Sparks,REP,550144,0,0,14,14,05
Oklahoma,U.S. House,Clark Jolley,REP,550144,0,0,37,37,05
Oklahoma,State House,Gregory Duke Brown,REP,550144,0,0,4,4,82
Oklahoma,State House,Dustin Hopson,REP,550144,0,0,50,50,82
Oklahoma,State House,Adam Pugh,REP,550144,0,0,73,73,82
Oklahoma,State House,Kevin Calvey,REP,550144,0,0,262,262,82
Oklahoma,State House,Paul Ruckel,REP,550144,0,0,7,7,82
Oklahoma,Superintendent of Public Instruction,John Cox,DEM,550145,0,0,18,18,
Oklahoma,Superintendent of Public Instruction,Jack Jr.,DEM,550145,0,0,4,4,
Oklahoma,Superintendent of Public Instruction,Ivan Holmes,DEM,550145,0,0,3,3,
Oklahoma,Superintendent of Public Instruction,Freda Deskin,DEM,550145,0,0,40,40,
Oklahoma,U.S. Senate,Patrick Michael Hayes,DEM,550145,0,0,13,13,
Oklahoma,U.S. Senate,Jim Rogers,DEM,550145,0,0,12,12,
Oklahoma,U.S. Senate,Connie Johnson,DEM,550145,0,0,38,38,
Oklahoma,U.S. House,Tom Guild,DEM,550145,0,0,19,19,05
Oklahoma,U.S. House,Al Mcaffrey,DEM,550145,0,0,32,32,05
Oklahoma,U.S. House,Leona Leonard,DEM,550145,0,0,12,12,05
Oklahoma,Governor,Dax Ewbank,REP,550145,0,0,12,12,
Oklahoma,Governor,Chad Moody,REP,550145,0,0,30,30,
Oklahoma,Governor,Mary Fallin,REP,550145,0,0,349,349,
Oklahoma,Superintendent of Public Instruction,Brian Kelly,REP,550145,0,0,33,33,
Oklahoma,Superintendent of Public Instruction,Janet Costello Barresi,REP,550145,0,0,249,249,
Oklahoma,Superintendent of Public Instruction,Joy Hofmeister,REP,550145,0,0,103,103,
Oklahoma,Insurance Commissioner,Bill Viner,REP,550145,0,0,46,46,
Oklahoma,Insurance Commissioner,John Doak,REP,550145,0,0,303,303,
Oklahoma,Corporation Commissioner,Todd Hiett,REP,550145,0,0,91,91,
Oklahoma,Corporation Commissioner,Cliff Branan,REP,550145,0,0,273,273,
Oklahoma,U.S. Senate,Evelyn Rogers,REP,550145,0,0,6,6,
Oklahoma,U.S. Senate,Rob Moye,REP,550145,0,0,5,5,
Oklahoma,U.S. Senate,D. Jean Mcbride-Samuels,REP,550145,0,0,2,2,
Oklahoma,U.S. Senate,Jim Inhofe,REP,550145,0,0,363,363,
Oklahoma,U.S. Senate,Erick Paul Wyatt,REP,550145,0,0,6,6,
Oklahoma,U.S. Senate,Andy Craig,REP,550145,0,0,0,0,
Oklahoma,U.S. Senate,T. Shannon,REP,550145,0,0,62,62,
Oklahoma,U.S. Senate,Randy Brogdon,REP,550145,0,0,2,2,
Oklahoma,U.S. Senate,Eric Mccray,REP,550145,0,0,2,2,
Oklahoma,U.S. Senate,Kevin Crow,REP,550145,0,0,0,0,
Oklahoma,U.S. Senate,James Lankford,REP,550145,0,0,322,322,
Oklahoma,U.S. Senate,Jason Weger,REP,550145,0,0,2,2,
Oklahoma,U.S. House,Shane David Jett,REP,550145,0,0,24,24,05
Oklahoma,U.S. House,Patrice Douglas,REP,550145,0,0,107,107,05
Oklahoma,U.S. House,Mike Turner,REP,550145,0,0,64,64,05
Oklahoma,U.S. House,Steve Russell,REP,550145,0,0,98,98,05
Oklahoma,U.S. House,Harvey Sparks,REP,550145,0,0,16,16,05
Oklahoma,U.S. House,Clark Jolley,REP,550145,0,0,56,56,05
Oklahoma,Superintendent of Public Instruction,John Cox,DEM,550146,0,0,18,18,
Oklahoma,Superintendent of Public Instruction,Jack Jr.,DEM,550146,0,0,10,10,
Oklahoma,Superintendent of Public Instruction,Ivan Holmes,DEM,550146,0,0,6,6,
Oklahoma,Superintendent of Public Instruction,Freda Deskin,DEM,550146,0,0,62,62,
Oklahoma,U.S. Senate,Patrick Michael Hayes,DEM,550146,0,0,15,15,
Oklahoma,U.S. Senate,Jim Rogers,DEM,550146,0,0,15,15,
Oklahoma,U.S. Senate,Connie Johnson,DEM,550146,0,0,62,62,
Oklahoma,U.S. House,Tom Guild,DEM,550146,0,0,28,28,05
Oklahoma,U.S. House,Al Mcaffrey,DEM,550146,0,0,53,53,05
Oklahoma,U.S. House,Leona Leonard,DEM,550146,0,0,15,15,05
Oklahoma,Governor,Dax Ewbank,REP,550146,0,0,25,25,
Oklahoma,Governor,Chad Moody,REP,550146,0,0,55,55,
Oklahoma,Governor,Mary Fallin,REP,550146,0,0,447,447,
Oklahoma,Superintendent of Public Instruction,Brian Kelly,REP,550146,0,0,54,54,
Oklahoma,Superintendent of Public Instruction,Janet Costello Barresi,REP,550146,0,0,297,297,
Oklahoma,Superintendent of Public Instruction,Joy Hofmeister,REP,550146,0,0,174,174,
Oklahoma,Insurance Commissioner,Bill Viner,REP,550146,0,0,78,78,
Oklahoma,Insurance Commissioner,John Doak,REP,550146,0,0,415,415,
Oklahoma,Corporation Commissioner,Todd Hiett,REP,550146,0,0,150,150,
Oklahoma,Corporation Commissioner,Cliff Branan,REP,550146,0,0,350,350,
Oklahoma,U.S. Senate,Evelyn Rogers,REP,550146,0,0,18,18,
Oklahoma,U.S. Senate,Rob Moye,REP,550146,0,0,5,5,
Oklahoma,U.S. Senate,D. Jean Mcbride-Samuels,REP,550146,0,0,4,4,
Oklahoma,U.S. Senate,Jim Inhofe,REP,550146,0,0,489,489,
Oklahoma,U.S. Senate,Erick Paul Wyatt,REP,550146,0,0,9,9,
Oklahoma,U.S. Senate,Andy Craig,REP,550146,0,0,0,0,
Oklahoma,U.S. Senate,T. Shannon,REP,550146,0,0,86,86,
Oklahoma,U.S. Senate,Randy Brogdon,REP,550146,0,0,8,8,
Oklahoma,U.S. Senate,Eric Mccray,REP,550146,0,0,2,2,
Oklahoma,U.S. Senate,Kevin Crow,REP,550146,0,0,2,2,
Oklahoma,U.S. Senate,James Lankford,REP,550146,0,0,433,433,
Oklahoma,U.S. Senate,Jason Weger,REP,550146,0,0,2,2,
Oklahoma,U.S. House,Shane David Jett,REP,550146,0,0,42,42,05
Oklahoma,U.S. House,Patrice Douglas,REP,550146,0,0,184,184,05
Oklahoma,U.S. House,Mike Turner,REP,550146,0,0,61,61,05
Oklahoma,U.S. House,Steve Russell,REP,550146,0,0,120,120,05
Oklahoma,U.S. House,Harvey Sparks,REP,550146,0,0,37,37,05
Oklahoma,U.S. House,Clark Jolley,REP,550146,0,0,69,69,05
Oklahoma,Superintendent of Public Instruction,John Cox,DEM,550147,0,0,8,8,
Oklahoma,Superintendent of Public Instruction,Jack Jr.,DEM,550147,0,0,2,2,
Oklahoma,Superintendent of Public Instruction,Ivan Holmes,DEM,550147,0,0,3,3,
Oklahoma,Superintendent of Public Instruction,Freda Deskin,DEM,550147,0,0,23,23,
Oklahoma,U.S. Senate,Patrick Michael Hayes,DEM,550147,0,0,7,7,
Oklahoma,U.S. Senate,Jim Rogers,DEM,550147,0,0,3,3,
Oklahoma,U.S. Senate,Connie Johnson,DEM,550147,0,0,26,26,
Oklahoma,U.S. House,Tom Guild,DEM,550147,0,0,11,11,05
Oklahoma,U.S. House,Al Mcaffrey,DEM,550147,0,0,14,14,05
Oklahoma,U.S. House,Leona Leonard,DEM,550147,0,0,9,9,05
Oklahoma,Governor,Dax Ewbank,REP,550147,0,0,7,7,
Oklahoma,Governor,Chad Moody,REP,550147,0,0,5,5,
Oklahoma,Governor,Mary Fallin,REP,550147,0,0,130,130,
Oklahoma,Superintendent of Public Instruction,Brian Kelly,REP,550147,0,0,17,17,
Oklahoma,Superintendent of Public Instruction,Janet Costello Barresi,REP,550147,0,0,56,56,
Oklahoma,Superintendent of Public Instruction,Joy Hofmeister,REP,550147,0,0,70,70,
Oklahoma,Insurance Commissioner,Bill Viner,REP,550147,0,0,17,17,
Oklahoma,Insurance Commissioner,John Doak,REP,550147,0,0,107,107,
Oklahoma,Corporation Commissioner,Todd Hiett,REP,550147,0,0,52,52,
Oklahoma,Corporation Commissioner,Cliff Branan,REP,550147,0,0,74,74,
Oklahoma,U.S. Senate,Evelyn Rogers,REP,550147,0,0,6,6,
Oklahoma,U.S. Senate,Rob Moye,REP,550147,0,0,2,2,
Oklahoma,U.S. Senate,D. Jean Mcbride-Samuels,REP,550147,0,0,1,1,
Oklahoma,U.S. Senate,Jim Inhofe,REP,550147,0,0,124,124,
Oklahoma,U.S. Senate,Erick Paul Wyatt,REP,550147,0,0,4,4,
Oklahoma,U.S. Senate,Andy Craig,REP,550147,0,0,0,0,
Oklahoma,U.S. Senate,T. Shannon,REP,550147,0,0,22,22,
Oklahoma,U.S. Senate,Randy Brogdon,REP,550147,0,0,2,2,
Oklahoma,U.S. Senate,Eric Mccray,REP,550147,0,0,0,0,
Oklahoma,U.S. Senate,Kevin Crow,REP,550147,0,0,0,0,
Oklahoma,U.S. Senate,James Lankford,REP,550147,0,0,121,121,
Oklahoma,U.S. Senate,Jason Weger,REP,550147,0,0,0,0,
Oklahoma,U.S. House,Shane David Jett,REP,550147,0,0,9,9,05
Oklahoma,U.S. House,Patrice Douglas,REP,550147,0,0,42,42,05
Oklahoma,U.S. House,Mike Turner,REP,550147,0,0,18,18,05
Oklahoma,U.S. House,Steve Russell,REP,550147,0,0,40,40,05
Oklahoma,U.S. House,Harvey Sparks,REP,550147,0,0,18,18,05
Oklahoma,U.S. House,Clark Jolley,REP,550147,0,0,15,15,05
Oklahoma,Superintendent of Public Instruction,John Cox,DEM,550148,0,0,40,40,
Oklahoma,Superintendent of Public Instruction,Jack Jr.,DEM,550148,0,0,11,11,
Oklahoma,Superintendent of Public Instruction,Ivan Holmes,DEM,550148,0,0,4,4,
Oklahoma,Superintendent of Public Instruction,Freda Deskin,DEM,550148,0,0,69,69,
Oklahoma,U.S. Senate,Patrick Michael Hayes,DEM,550148,0,0,18,18,
Oklahoma,U.S. Senate,Jim Rogers,DEM,550148,0,0,29,29,
Oklahoma,U.S. Senate,Connie Johnson,DEM,550148,0,0,75,75,
Oklahoma,U.S. House,Tom Guild,DEM,550148,0,0,56,56,05
Oklahoma,U.S. House,Al Mcaffrey,DEM,550148,0,0,38,38,05
Oklahoma,U.S. House,Leona Leonard,DEM,550148,0,0,28,28,05
Oklahoma,Governor,Dax Ewbank,REP,550148,0,0,36,36,
Oklahoma,Governor,Chad Moody,REP,550148,0,0,38,38,
Oklahoma,Governor,Mary Fallin,REP,550148,0,0,373,373,
Oklahoma,Superintendent of Public Instruction,Brian Kelly,REP,550148,0,0,85,85,
Oklahoma,Superintendent of Public Instruction,Janet Costello Barresi,REP,550148,0,0,159,159,
Oklahoma,Superintendent of Public Instruction,Joy Hofmeister,REP,550148,0,0,200,200,
Oklahoma,Insurance Commissioner,Bill Viner,REP,550148,0,0,72,72,
Oklahoma,Insurance Commissioner,John Doak,REP,550148,0,0,328,328,
Oklahoma,Corporation Commissioner,Todd Hiett,REP,550148,0,0,180,180,
Oklahoma,Corporation Commissioner,Cliff Branan,REP,550148,0,0,224,224,
Oklahoma,U.S. Senate,Evelyn Rogers,REP,550148,0,0,15,15,
Oklahoma,U.S. Senate,Rob Moye,REP,550148,0,0,4,4,
Oklahoma,U.S. Senate,D. Jean Mcbride-Samuels,REP,550148,0,0,4,4,
Oklahoma,U.S. Senate,Jim Inhofe,REP,550148,0,0,402,402,
Oklahoma,U.S. Senate,Erick Paul Wyatt,REP,550148,0,0,16,16,
Oklahoma,U.S. Senate,Andy Craig,REP,550148,0,0,5,5,
Oklahoma,U.S. Senate,T. Shannon,REP,550148,0,0,77,77,
Oklahoma,U.S. Senate,Randy Brogdon,REP,550148,0,0,9,9,
Oklahoma,U.S. Senate,Eric Mccray,REP,550148,0,0,1,1,
Oklahoma,U.S. Senate,Kevin Crow,REP,550148,0,0,1,1,
Oklahoma,U.S. Senate,James Lankford,REP,550148,0,0,357,357,
Oklahoma,U.S. Senate,Jason Weger,REP,550148,0,0,2,2,
Oklahoma,U.S. House,Shane David Jett,REP,550148,0,0,39,39,05
Oklahoma,U.S. House,Patrice Douglas,REP,550148,0,0,92,92,05
Oklahoma,U.S. House,Mike Turner,REP,550148,0,0,111,111,05
Oklahoma,U.S. House,Steve Russell,REP,550148,0,0,110,110,05
Oklahoma,U.S. House,Harvey Sparks,REP,550148,0,0,27,27,05
Oklahoma,U.S. House,Clark Jolley,REP,550148,0,0,57,57,05
Oklahoma,State House,Gregory Duke Brown,REP,550148,0,0,9,9,82
Oklahoma,State House,Dustin Hopson,REP,550148,0,0,51,51,82
Oklahoma,State House,Adam Pugh,REP,550148,0,0,121,121,82
Oklahoma,State House,Kevin Calvey,REP,550148,0,0,230,230,82
Oklahoma,State House,Paul Ruckel,REP,550148,0,0,15,15,82
Oklahoma,Superintendent of Public Instruction,John Cox,DEM,550149,0,0,26,26,
Oklahoma,Superintendent of Public Instruction,Jack Jr.,DEM,550149,0,0,8,8,
Oklahoma,Superintendent of Public Instruction,Ivan Holmes,DEM,550149,0,0,9,9,
Oklahoma,Superintendent of Public Instruction,Freda Deskin,DEM,550149,0,0,61,61,
Oklahoma,U.S. Senate,Patrick Michael Hayes,DEM,550149,0,0,13,13,
Oklahoma,U.S. Senate,Jim Rogers,DEM,550149,0,0,27,27,
Oklahoma,U.S. Senate,Connie Johnson,DEM,550149,0,0,61,61,
Oklahoma,U.S. House,Tom Guild,DEM,550149,0,0,37,37,05
Oklahoma,U.S. House,Al Mcaffrey,DEM,550149,0,0,39,39,05
Oklahoma,U.S. House,Leona Leonard,DEM,550149,0,0,24,24,05
Oklahoma,Governor,Dax Ewbank,REP,550149,0,0,30,30,
Oklahoma,Governor,Chad Moody,REP,550149,0,0,66,66,
Oklahoma,Governor,Mary Fallin,REP,550149,0,0,588,588,
Oklahoma,Superintendent of Public Instruction,Brian Kelly,REP,550149,0,0,114,114,
Oklahoma,Superintendent of Public Instruction,Janet Costello Barresi,REP,550149,0,0,231,231,
Oklahoma,Superintendent of Public Instruction,Joy Hofmeister,REP,550149,0,0,320,320,
Oklahoma,Insurance Commissioner,Bill Viner,REP,550149,0,0,115,115,
Oklahoma,Insurance Commissioner,John Doak,REP,550149,0,0,502,502,
Oklahoma,Corporation Commissioner,Todd Hiett,REP,550149,0,0,276,276,
Oklahoma,Corporation Commissioner,Cliff Branan,REP,550149,0,0,336,336,
Oklahoma,U.S. Senate,Evelyn Rogers,REP,550149,0,0,23,23,
Oklahoma,U.S. Senate,Rob Moye,REP,550149,0,0,6,6,
Oklahoma,U.S. Senate,D. Jean Mcbride-Samuels,REP,550149,0,0,8,8,
Oklahoma,U.S. Senate,Jim Inhofe,REP,550149,0,0,623,623,
Oklahoma,U.S. Senate,Erick Paul Wyatt,REP,550149,0,0,18,18,
Oklahoma,U.S. Senate,Andy Craig,REP,550149,0,0,6,6,
Oklahoma,U.S. Senate,T. Shannon,REP,550149,0,0,126,126,
Oklahoma,U.S. Senate,Randy Brogdon,REP,550149,0,0,15,15,
Oklahoma,U.S. Senate,Eric Mccray,REP,550149,0,0,3,3,
Oklahoma,U.S. Senate,Kevin Crow,REP,550149,0,0,3,3,
Oklahoma,U.S. Senate,James Lankford,REP,550149,0,0,544,544,
Oklahoma,U.S. Senate,Jason Weger,REP,550149,0,0,1,1,
Oklahoma,U.S. House,Shane David Jett,REP,550149,0,0,57,57,05
Oklahoma,U.S. House,Patrice Douglas,REP,550149,0,0,162,162,05
Oklahoma,U.S. House,Mike Turner,REP,550149,0,0,155,155,05
Oklahoma,U.S. House,Steve Russell,REP,550149,0,0,169,169,05
Oklahoma,U.S. House,Harvey Sparks,REP,550149,0,0,40,40,05
Oklahoma,U.S. House,Clark Jolley,REP,550149,0,0,72,72,05
Oklahoma,State House,Gregory Duke Brown,REP,550149,0,0,25,25,82
Oklahoma,State House,Dustin Hopson,REP,550149,0,0,80,80,82
Oklahoma,State House,Adam Pugh,REP,550149,0,0,158,158,82
Oklahoma,State House,Kevin Calvey,REP,550149,0,0,380,380,82
Oklahoma,State House,Paul Ruckel,REP,550149,0,0,8,8,82
Oklahoma,Superintendent of Public Instruction,John Cox,DEM,550150,0,0,31,31,
Oklahoma,Superintendent of Public Instruction,Jack Jr.,DEM,550150,0,0,14,14,
Oklahoma,Superintendent of Public Instruction,Ivan Holmes,DEM,550150,0,0,2,2,
Oklahoma,Superintendent of Public Instruction,Freda Deskin,DEM,550150,0,0,59,59,
Oklahoma,U.S. Senate,Patrick Michael Hayes,DEM,550150,0,0,8,8,
Oklahoma,U.S. Senate,Jim Rogers,DEM,550150,0,0,24,24,
Oklahoma,U.S. Senate,Connie Johnson,DEM,550150,0,0,70,70,
Oklahoma,U.S. House,Tom Guild,DEM,550150,0,0,45,45,05
Oklahoma,U.S. House,Al Mcaffrey,DEM,550150,0,0,27,27,05
Oklahoma,U.S. House,Leona Leonard,DEM,550150,0,0,30,30,05
Oklahoma,Governor,Dax Ewbank,REP,550150,0,0,14,14,
Oklahoma,Governor,Chad Moody,REP,550150,0,0,57,57,
Oklahoma,Governor,Mary Fallin,REP,550150,0,0,357,357,
Oklahoma,Superintendent of Public Instruction,Brian Kelly,REP,550150,0,0,92,92,
Oklahoma,Superintendent of Public Instruction,Janet Costello Barresi,REP,550150,0,0,101,101,
Oklahoma,Superintendent of Public Instruction,Joy Hofmeister,REP,550150,0,0,227,227,
Oklahoma,Insurance Commissioner,Bill Viner,REP,550150,0,0,71,71,
Oklahoma,Insurance Commissioner,John Doak,REP,550150,0,0,316,316,
Oklahoma,Corporation Commissioner,Todd Hiett,REP,550150,0,0,152,152,
Oklahoma,Corporation Commissioner,Cliff Branan,REP,550150,0,0,238,238,
Oklahoma,U.S. Senate,Evelyn Rogers,REP,550150,0,0,16,16,
Oklahoma,U.S. Senate,Rob Moye,REP,550150,0,0,10,10,
Oklahoma,U.S. Senate,D. Jean Mcbride-Samuels,REP,550150,0,0,5,5,
Oklahoma,U.S. Senate,Jim Inhofe,REP,550150,0,0,378,378,
Oklahoma,U.S. Senate,Erick Paul Wyatt,REP,550150,0,0,10,10,
Oklahoma,U.S. Senate,Andy Craig,REP,550150,0,0,5,5,
Oklahoma,U.S. Senate,T. Shannon,REP,550150,0,0,93,93,
Oklahoma,U.S. Senate,Randy Brogdon,REP,550150,0,0,4,4,
Oklahoma,U.S. Senate,Eric Mccray,REP,550150,0,0,3,3,
Oklahoma,U.S. Senate,Kevin Crow,REP,550150,0,0,1,1,
Oklahoma,U.S. Senate,James Lankford,REP,550150,0,0,330,330,
Oklahoma,U.S. Senate,Jason Weger,REP,550150,0,0,2,2,
Oklahoma,U.S. House,Shane David Jett,REP,550150,0,0,42,42,05
Oklahoma,U.S. House,Patrice Douglas,REP,550150,0,0,113,113,05
Oklahoma,U.S. House,Mike Turner,REP,550150,0,0,37,37,05
Oklahoma,U.S. House,Steve Russell,REP,550150,0,0,129,129,05
Oklahoma,U.S. House,Harvey Sparks,REP,550150,0,0,43,43,05
Oklahoma,U.S. House,Clark Jolley,REP,550150,0,0,45,45,05
Oklahoma,Superintendent of Public Instruction,John Cox,DEM,550151,0,0,26,26,
Oklahoma,Superintendent of Public Instruction,Jack Jr.,DEM,550151,0,0,13,13,
Oklahoma,Superintendent of Public Instruction,Ivan Holmes,DEM,550151,0,0,8,8,
Oklahoma,Superintendent of Public Instruction,Freda Deskin,DEM,550151,0,0,65,65,
Oklahoma,U.S. Senate,Patrick Michael Hayes,DEM,550151,0,0,11,11,
Oklahoma,U.S. Senate,Jim Rogers,DEM,550151,0,0,19,19,
Oklahoma,U.S. Senate,Connie Johnson,DEM,550151,0,0,77,77,
Oklahoma,U.S. House,Tom Guild,DEM,550151,0,0,44,44,05
Oklahoma,U.S. House,Al Mcaffrey,DEM,550151,0,0,29,29,05
Oklahoma,U.S. House,Leona Leonard,DEM,550151,0,0,35,35,05
Oklahoma,Governor,Dax Ewbank,REP,550151,0,0,27,27,
Oklahoma,Governor,Chad Moody,REP,550151,0,0,50,50,
Oklahoma,Governor,Mary Fallin,REP,550151,0,0,372,372,
Oklahoma,Superintendent of Public Instruction,Brian Kelly,REP,550151,0,0,102,102,
Oklahoma,Superintendent of Public Instruction,Janet Costello Barresi,REP,550151,0,0,123,123,
Oklahoma,Superintendent of Public Instruction,Joy Hofmeister,REP,550151,0,0,225,225,
Oklahoma,Insurance Commissioner,Bill Viner,REP,550151,0,0,77,77,
Oklahoma,Insurance Commissioner,John Doak,REP,550151,0,0,337,337,
Oklahoma,Corporation Commissioner,Todd Hiett,REP,550151,0,0,198,198,
Oklahoma,Corporation Commissioner,Cliff Branan,REP,550151,0,0,222,222,
Oklahoma,U.S. Senate,Evelyn Rogers,REP,550151,0,0,17,17,
Oklahoma,U.S. Senate,Rob Moye,REP,550151,0,0,11,11,
Oklahoma,U.S. Senate,D. Jean Mcbride-Samuels,REP,550151,0,0,6,6,
Oklahoma,U.S. Senate,Jim Inhofe,REP,550151,0,0,400,400,
Oklahoma,U.S. Senate,Erick Paul Wyatt,REP,550151,0,0,15,15,
Oklahoma,U.S. Senate,Andy Craig,REP,550151,0,0,3,3,
Oklahoma,U.S. Senate,T. Shannon,REP,550151,0,0,84,84,
Oklahoma,U.S. Senate,Randy Brogdon,REP,550151,0,0,8,8,
Oklahoma,U.S. Senate,Eric Mccray,REP,550151,0,0,3,3,
Oklahoma,U.S. Senate,Kevin Crow,REP,550151,0,0,0,0,
Oklahoma,U.S. Senate,James Lankford,REP,550151,0,0,356,356,
Oklahoma,U.S. Senate,Jason Weger,REP,550151,0,0,2,2,
Oklahoma,U.S. House,Shane David Jett,REP,550151,0,0,43,43,05
Oklahoma,U.S. House,Patrice Douglas,REP,550151,0,0,99,99,05
Oklahoma,U.S. House,Mike Turner,REP,550151,0,0,84,84,05
Oklahoma,U.S. House,Steve Russell,REP,550151,0,0,140,140,05
Oklahoma,U.S. House,Harvey Sparks,REP,550151,0,0,24,24,05
Oklahoma,U.S. House,Clark Jolley,REP,550151,0,0,47,47,05
Oklahoma,Superintendent of Public Instruction,John Cox,DEM,550152,0,0,30,30,
Oklahoma,Superintendent of Public Instruction,Jack Jr.,DEM,550152,0,0,15,15,
Oklahoma,Superintendent of Public Instruction,Ivan Holmes,DEM,550152,0,0,6,6,
Oklahoma,Superintendent of Public Instruction,Freda Deskin,DEM,550152,0,0,46,46,
Oklahoma,U.S. Senate,Patrick Michael Hayes,DEM,550152,0,0,18,18,
Oklahoma,U.S. Senate,Jim Rogers,DEM,550152,0,0,17,17,
Oklahoma,U.S. Senate,Connie Johnson,DEM,550152,0,0,61,61,
Oklahoma,U.S. House,Tom Guild,DEM,550152,0,0,37,37,05
Oklahoma,U.S. House,Al Mcaffrey,DEM,550152,0,0,38,38,05
Oklahoma,U.S. House,Leona Leonard,DEM,550152,0,0,21,21,05
Oklahoma,Governor,Dax Ewbank,REP,550152,0,0,33,33,
Oklahoma,Governor,Chad Moody,REP,550152,0,0,46,46,
Oklahoma,Governor,Mary Fallin,REP,550152,0,0,344,344,
Oklahoma,Superintendent of Public Instruction,Brian Kelly,REP,550152,0,0,82,82,
Oklahoma,Superintendent of Public Instruction,Janet Costello Barresi,REP,550152,0,0,149,149,
Oklahoma,Superintendent of Public Instruction,Joy Hofmeister,REP,550152,0,0,185,185,
Oklahoma,Insurance Commissioner,Bill Viner,REP,550152,0,0,80,80,
Oklahoma,Insurance Commissioner,John Doak,REP,550152,0,0,315,315,
Oklahoma,Corporation Commissioner,Todd Hiett,REP,550152,0,0,188,188,
Oklahoma,Corporation Commissioner,Cliff Branan,REP,550152,0,0,197,197,
Oklahoma,U.S. Senate,Evelyn Rogers,REP,550152,0,0,15,15,
Oklahoma,U.S. Senate,Rob Moye,REP,550152,0,0,3,3,
Oklahoma,U.S. Senate,D. Jean Mcbride-Samuels,REP,550152,0,0,2,2,
Oklahoma,U.S. Senate,Jim Inhofe,REP,550152,0,0,391,391,
Oklahoma,U.S. Senate,Erick Paul Wyatt,REP,550152,0,0,9,9,
Oklahoma,U.S. Senate,Andy Craig,REP,550152,0,0,3,3,
Oklahoma,U.S. Senate,T. Shannon,REP,550152,0,0,59,59,
Oklahoma,U.S. Senate,Randy Brogdon,REP,550152,0,0,19,19,
Oklahoma,U.S. Senate,Eric Mccray,REP,550152,0,0,0,0,
Oklahoma,U.S. Senate,Kevin Crow,REP,550152,0,0,1,1,
Oklahoma,U.S. Senate,James Lankford,REP,550152,0,0,343,343,
Oklahoma,U.S. Senate,Jason Weger,REP,550152,0,0,1,1,
Oklahoma,U.S. House,Shane David Jett,REP,550152,0,0,34,34,05
Oklahoma,U.S. House,Patrice Douglas,REP,550152,0,0,108,108,05
Oklahoma,U.S. House,Mike Turner,REP,550152,0,0,53,53,05
Oklahoma,U.S. House,Steve Russell,REP,550152,0,0,118,118,05
Oklahoma,U.S. House,Harvey Sparks,REP,550152,0,0,41,41,05
Oklahoma,U.S. House,Clark Jolley,REP,550152,0,0,56,56,05
Oklahoma,Superintendent of Public Instruction,John Cox,DEM,550153,0,0,43,43,
Oklahoma,Superintendent of Public Instruction,Jack Jr.,DEM,550153,0,0,12,12,
Oklahoma,Superintendent of Public Instruction,Ivan Holmes,DEM,550153,0,0,12,12,
Oklahoma,Superintendent of Public Instruction,Freda Deskin,DEM,550153,0,0,68,68,
Oklahoma,U.S. Senate,Patrick Michael Hayes,DEM,550153,0,0,21,21,
Oklahoma,U.S. Senate,Jim Rogers,DEM,550153,0,0,32,32,
Oklahoma,U.S. Senate,Connie Johnson,DEM,550153,0,0,79,79,
Oklahoma,U.S. House,Tom Guild,DEM,550153,0,0,68,68,05
Oklahoma,U.S. House,Al Mcaffrey,DEM,550153,0,0,35,35,05
Oklahoma,U.S. House,Leona Leonard,DEM,550153,0,0,31,31,05
Oklahoma,Governor,Dax Ewbank,REP,550153,0,0,35,35,
Oklahoma,Governor,Chad Moody,REP,550153,0,0,55,55,
Oklahoma,Governor,Mary Fallin,REP,550153,0,0,415,415,
Oklahoma,Superintendent of Public Instruction,Brian Kelly,REP,550153,0,0,112,112,
Oklahoma,Superintendent of Public Instruction,Janet Costello Barresi,REP,550153,0,0,138,138,
Oklahoma,Superintendent of Public Instruction,Joy Hofmeister,REP,550153,0,0,240,240,
Oklahoma,Insurance Commissioner,Bill Viner,REP,550153,0,0,89,89,
Oklahoma,Insurance Commissioner,John Doak,REP,550153,0,0,363,363,
Oklahoma,Corporation Commissioner,Todd Hiett,REP,550153,0,0,230,230,
Oklahoma,Corporation Commissioner,Cliff Branan,REP,550153,0,0,223,223,
Oklahoma,U.S. Senate,Evelyn Rogers,REP,550153,0,0,23,23,
Oklahoma,U.S. Senate,Rob Moye,REP,550153,0,0,5,5,
Oklahoma,U.S. Senate,D. Jean Mcbride-Samuels,REP,550153,0,0,7,7,
Oklahoma,U.S. Senate,Jim Inhofe,REP,550153,0,0,445,445,
Oklahoma,U.S. Senate,Erick Paul Wyatt,REP,550153,0,0,16,16,
Oklahoma,U.S. Senate,Andy Craig,REP,550153,0,0,2,2,
Oklahoma,U.S. Senate,T. Shannon,REP,550153,0,0,94,94,
Oklahoma,U.S. Senate,Randy Brogdon,REP,550153,0,0,13,13,
Oklahoma,U.S. Senate,Eric Mccray,REP,550153,0,0,2,2,
Oklahoma,U.S. Senate,Kevin Crow,REP,550153,0,0,5,5,
Oklahoma,U.S. Senate,James Lankford,REP,550153,0,0,392,392,
Oklahoma,U.S. Senate,Jason Weger,REP,550153,0,0,1,1,
Oklahoma,U.S. House,Shane David Jett,REP,550153,0,0,52,52,05
Oklahoma,U.S. House,Patrice Douglas,REP,550153,0,0,98,98,05
Oklahoma,U.S. House,Mike Turner,REP,550153,0,0,85,85,05
Oklahoma,U.S. House,Steve Russell,REP,550153,0,0,151,151,05
Oklahoma,U.S. House,Harvey Sparks,REP,550153,0,0,40,40,05
Oklahoma,U.S. House,Clark Jolley,REP,550153,0,0,52,52,05
Oklahoma,Superintendent of Public Instruction,John Cox,DEM,550154,0,0,70,70,
Oklahoma,Superintendent of Public Instruction,Jack Jr.,DEM,550154,0,0,18,18,
Oklahoma,Superintendent of Public Instruction,Ivan Holmes,DEM,550154,0,0,8,8,
Oklahoma,Superintendent of Public Instruction,Freda Deskin,DEM,550154,0,0,82,82,
Oklahoma,U.S. Senate,Patrick Michael Hayes,DEM,550154,0,0,25,25,
Oklahoma,U.S. Senate,Jim Rogers,DEM,550154,0,0,30,30,
Oklahoma,U.S. Senate,Connie Johnson,DEM,550154,0,0,121,121,
Oklahoma,U.S. House,Tom Guild,DEM,550154,0,0,80,80,05
Oklahoma,U.S. House,Al Mcaffrey,DEM,550154,0,0,47,47,05
Oklahoma,U.S. House,Leona Leonard,DEM,550154,0,0,50,50,05
Oklahoma,Governor,Dax Ewbank,REP,550154,0,0,38,38,
Oklahoma,Governor,Chad Moody,REP,550154,0,0,75,75,
Oklahoma,Governor,Mary Fallin,REP,550154,0,0,440,440,
Oklahoma,Superintendent of Public Instruction,Brian Kelly,REP,550154,0,0,114,114,
Oklahoma,Superintendent of Public Instruction,Janet Costello Barresi,REP,550154,0,0,175,175,
Oklahoma,Superintendent of Public Instruction,Joy Hofmeister,REP,550154,0,0,254,254,
Oklahoma,Insurance Commissioner,Bill Viner,REP,550154,0,0,109,109,
Oklahoma,Insurance Commissioner,John Doak,REP,550154,0,0,399,399,
Oklahoma,Corporation Commissioner,Todd Hiett,REP,550154,0,0,240,240,
Oklahoma,Corporation Commissioner,Cliff Branan,REP,550154,0,0,268,268,
Oklahoma,U.S. Senate,Evelyn Rogers,REP,550154,0,0,28,28,
Oklahoma,U.S. Senate,Rob Moye,REP,550154,0,0,7,7,
Oklahoma,U.S. Senate,D. Jean Mcbride-Samuels,REP,550154,0,0,9,9,
Oklahoma,U.S. Senate,Jim Inhofe,REP,550154,0,0,497,497,
Oklahoma,U.S. Senate,Erick Paul Wyatt,REP,550154,0,0,9,9,
Oklahoma,U.S. Senate,Andy Craig,REP,550154,0,0,1,1,
Oklahoma,U.S. Senate,T. Shannon,REP,550154,0,0,105,105,
Oklahoma,U.S. Senate,Randy Brogdon,REP,550154,0,0,9,9,
Oklahoma,U.S. Senate,Eric Mccray,REP,550154,0,0,3,3,
Oklahoma,U.S. Senate,Kevin Crow,REP,550154,0,0,2,2,
Oklahoma,U.S. Senate,James Lankford,REP,550154,0,0,437,437,
Oklahoma,U.S. Senate,Jason Weger,REP,550154,0,0,5,5,
Oklahoma,U.S. House,Shane David Jett,REP,550154,0,0,57,57,05
Oklahoma,U.S. House,Patrice Douglas,REP,550154,0,0,150,150,05
Oklahoma,U.S. House,Mike Turner,REP,550154,0,0,56,56,05
Oklahoma,U.S. House,Steve Russell,REP,550154,0,0,161,161,05
Oklahoma,U.S. House,Harvey Sparks,REP,550154,0,0,45,45,05
Oklahoma,U.S. House,Clark Jolley,REP,550154,0,0,70,70,05
Oklahoma,Superintendent of Public Instruction,John Cox,DEM,550155,0,0,16,16,
Oklahoma,Superintendent of Public Instruction,Jack Jr.,DEM,550155,0,0,4,4,
Oklahoma,Superintendent of Public Instruction,Ivan Holmes,DEM,550155,0,0,8,8,
Oklahoma,Superintendent of Public Instruction,Freda Deskin,DEM,550155,0,0,19,19,
Oklahoma,U.S. Senate,Patrick Michael Hayes,DEM,550155,0,0,10,10,
Oklahoma,U.S. Senate,Jim Rogers,DEM,550155,0,0,10,10,
Oklahoma,U.S. Senate,Connie Johnson,DEM,550155,0,0,27,27,
Oklahoma,U.S. House,Tom Guild,DEM,550155,0,0,30,30,05
Oklahoma,U.S. House,Al Mcaffrey,DEM,550155,0,0,11,11,05
Oklahoma,U.S. House,Leona Leonard,DEM,550155,0,0,4,4,05
Oklahoma,Governor,Dax Ewbank,REP,550155,0,0,7,7,
Oklahoma,Governor,Chad Moody,REP,550155,0,0,15,15,
Oklahoma,Governor,Mary Fallin,REP,550155,0,0,110,110,
Oklahoma,Superintendent of Public Instruction,Brian Kelly,REP,550155,0,0,26,26,
Oklahoma,Superintendent of Public Instruction,Janet Costello Barresi,REP,550155,0,0,37,37,
Oklahoma,Superintendent of Public Instruction,Joy Hofmeister,REP,550155,0,0,63,63,
Oklahoma,Insurance Commissioner,Bill Viner,REP,550155,0,0,22,22,
Oklahoma,Insurance Commissioner,John Doak,REP,550155,0,0,100,100,
Oklahoma,Corporation Commissioner,Todd Hiett,REP,550155,0,0,51,51,
Oklahoma,Corporation Commissioner,Cliff Branan,REP,550155,0,0,65,65,
Oklahoma,U.S. Senate,Evelyn Rogers,REP,550155,0,0,2,2,
Oklahoma,U.S. Senate,Rob Moye,REP,550155,0,0,2,2,
Oklahoma,U.S. Senate,D. Jean Mcbride-Samuels,REP,550155,0,0,3,3,
Oklahoma,U.S. Senate,Jim Inhofe,REP,550155,0,0,119,119,
Oklahoma,U.S. Senate,Erick Paul Wyatt,REP,550155,0,0,6,6,
Oklahoma,U.S. Senate,Andy Craig,REP,550155,0,0,0,0,
Oklahoma,U.S. Senate,T. Shannon,REP,550155,0,0,24,24,
Oklahoma,U.S. Senate,Randy Brogdon,REP,550155,0,0,0,0,
Oklahoma,U.S. Senate,Eric Mccray,REP,550155,0,0,2,2,
Oklahoma,U.S. Senate,Kevin Crow,REP,550155,0,0,1,1,
Oklahoma,U.S. Senate,James Lankford,REP,550155,0,0,105,105,
Oklahoma,U.S. Senate,Jason Weger,REP,550155,0,0,0,0,
Oklahoma,U.S. House,Shane David Jett,REP,550155,0,0,12,12,05
Oklahoma,U.S. House,Patrice Douglas,REP,550155,0,0,29,29,05
Oklahoma,U.S. House,Mike Turner,REP,550155,0,0,23,23,05
Oklahoma,U.S. House,Steve Russell,REP,550155,0,0,40,40,05
Oklahoma,U.S. House,Harvey Sparks,REP,550155,0,0,15,15,05
Oklahoma,U.S. House,Clark Jolley,REP,550155,0,0,8,8,05
Oklahoma,Superintendent of Public Instruction,John Cox,DEM,550156,0,0,35,35,
Oklahoma,Superintendent of Public Instruction,Jack Jr.,DEM,550156,0,0,15,15,
Oklahoma,Superintendent of Public Instruction,Ivan Holmes,DEM,550156,0,0,14,14,
Oklahoma,Superintendent of Public Instruction,Freda Deskin,DEM,550156,0,0,82,82,
Oklahoma,U.S. Senate,Patrick Michael Hayes,DEM,550156,0,0,16,16,
Oklahoma,U.S. Senate,Jim Rogers,DEM,550156,0,0,23,23,
Oklahoma,U.S. Senate,Connie Johnson,DEM,550156,0,0,98,98,
Oklahoma,U.S. House,Tom Guild,DEM,550156,0,0,48,48,05
Oklahoma,U.S. House,Al Mcaffrey,DEM,550156,0,0,50,50,05
Oklahoma,U.S. House,Leona Leonard,DEM,550156,0,0,42,42,05
Oklahoma,Governor,Dax Ewbank,REP,550156,0,0,29,29,
Oklahoma,Governor,Chad Moody,REP,550156,0,0,41,41,
Oklahoma,Governor,Mary Fallin,REP,550156,0,0,296,296,
Oklahoma,Superintendent of Public Instruction,Brian Kelly,REP,550156,0,0,80,80,
Oklahoma,Superintendent of Public Instruction,Janet Costello Barresi,REP,550156,0,0,123,123,
Oklahoma,Superintendent of Public Instruction,Joy Hofmeister,REP,550156,0,0,159,159,
Oklahoma,Insurance Commissioner,Bill Viner,REP,550156,0,0,67,67,
Oklahoma,Insurance Commissioner,John Doak,REP,550156,0,0,266,266,
Oklahoma,Corporation Commissioner,Todd Hiett,REP,550156,0,0,128,128,
Oklahoma,Corporation Commissioner,Cliff Branan,REP,550156,0,0,208,208,
Oklahoma,U.S. Senate,Evelyn Rogers,REP,550156,0,0,15,15,
Oklahoma,U.S. Senate,Rob Moye,REP,550156,0,0,6,6,
Oklahoma,U.S. Senate,D. Jean Mcbride-Samuels,REP,550156,0,0,6,6,
Oklahoma,U.S. Senate,Jim Inhofe,REP,550156,0,0,329,329,
Oklahoma,U.S. Senate,Erick Paul Wyatt,REP,550156,0,0,8,8,
Oklahoma,U.S. Senate,Andy Craig,REP,550156,0,0,3,3,
Oklahoma,U.S. Senate,T. Shannon,REP,550156,0,0,62,62,
Oklahoma,U.S. Senate,Randy Brogdon,REP,550156,0,0,3,3,
Oklahoma,U.S. Senate,Eric Mccray,REP,550156,0,0,0,0,
Oklahoma,U.S. Senate,Kevin Crow,REP,550156,0,0,2,2,
Oklahoma,U.S. Senate,James Lankford,REP,550156,0,0,300,300,
Oklahoma,U.S. Senate,Jason Weger,REP,550156,0,0,1,1,
Oklahoma,U.S. House,Shane David Jett,REP,550156,0,0,41,41,05
Oklahoma,U.S. House,Patrice Douglas,REP,550156,0,0,103,103,05
Oklahoma,U.S. House,Mike Turner,REP,550156,0,0,38,38,05
Oklahoma,U.S. House,Steve Russell,REP,550156,0,0,109,109,05
Oklahoma,U.S. House,Harvey Sparks,REP,550156,0,0,29,29,05
Oklahoma,U.S. House,Clark Jolley,REP,550156,0,0,34,34,05
Oklahoma,Superintendent of Public Instruction,John Cox,DEM,550157,0,0,0,0,
Oklahoma,Superintendent of Public Instruction,Jack Jr.,DEM,550157,0,0,1,1,
Oklahoma,Superintendent of Public Instruction,Ivan Holmes,DEM,550157,0,0,0,0,
Oklahoma,Superintendent of Public Instruction,Freda Deskin,DEM,550157,0,0,0,0,
Oklahoma,U.S. Senate,Patrick Michael Hayes,DEM,550157,0,0,0,0,
Oklahoma,U.S. Senate,Jim Rogers,DEM,550157,0,0,0,0,
Oklahoma,U.S. Senate,Connie Johnson,DEM,550157,0,0,1,1,
Oklahoma,U.S. House,Tom Guild,DEM,550157,0,0,1,1,05
Oklahoma,U.S. House,Al Mcaffrey,DEM,550157,0,0,0,0,05
Oklahoma,U.S. House,Leona Leonard,DEM,550157,0,0,0,0,05
Oklahoma,Governor,Dax Ewbank,REP,550157,0,0,0,0,
Oklahoma,Governor,Chad Moody,REP,550157,0,0,1,1,
Oklahoma,Governor,Mary Fallin,REP,550157,0,0,6,6,
Oklahoma,Superintendent of Public Instruction,Brian Kelly,REP,550157,0,0,3,3,
Oklahoma,Superintendent of Public Instruction,Janet Costello Barresi,REP,550157,0,0,1,1,
Oklahoma,Superintendent of Public Instruction,Joy Hofmeister,REP,550157,0,0,3,3,
Oklahoma,Insurance Commissioner,Bill Viner,REP,550157,0,0,1,1,
Oklahoma,Insurance Commissioner,John Doak,REP,550157,0,0,5,5,
Oklahoma,Corporation Commissioner,Todd Hiett,REP,550157,0,0,5,5,
Oklahoma,Corporation Commissioner,Cliff Branan,REP,550157,0,0,2,2,
Oklahoma,U.S. Senate,Evelyn Rogers,REP,550157,0,0,0,0,
Oklahoma,U.S. Senate,Rob Moye,REP,550157,0,0,0,0,
Oklahoma,U.S. Senate,D. Jean Mcbride-Samuels,REP,550157,0,0,0,0,
Oklahoma,U.S. Senate,Jim Inhofe,REP,550157,0,0,7,7,
Oklahoma,U.S. Senate,Erick Paul Wyatt,REP,550157,0,0,0,0,
Oklahoma,U.S. Senate,Andy Craig,REP,550157,0,0,0,0,
Oklahoma,U.S. Senate,T. Shannon,REP,550157,0,0,0,0,
Oklahoma,U.S. Senate,Randy Brogdon,REP,550157,0,0,1,1,
Oklahoma,U.S. Senate,Eric Mccray,REP,550157,0,0,0,0,
Oklahoma,U.S. Senate,Kevin Crow,REP,550157,0,0,0,0,
Oklahoma,U.S. Senate,James Lankford,REP,550157,0,0,6,6,
Oklahoma,U.S. Senate,Jason Weger,REP,550157,0,0,0,0,
Oklahoma,U.S. House,Shane David Jett,REP,550157,0,0,0,0,05
Oklahoma,U.S. House,Patrice Douglas,REP,550157,0,0,2,2,05
Oklahoma,U.S. House,Mike Turner,REP,550157,0,0,2,2,05
Oklahoma,U.S. House,Steve Russell,REP,550157,0,0,3,3,05
Oklahoma,U.S. House,Harvey Sparks,REP,550157,0,0,0,0,05
Oklahoma,U.S. House,Clark Jolley,REP,550157,0,0,0,0,05
Oklahoma,Superintendent of Public Instruction,John Cox,DEM,550158,0,0,21,21,
Oklahoma,Superintendent of Public Instruction,Jack Jr.,DEM,550158,0,0,8,8,
Oklahoma,Superintendent of Public Instruction,Ivan Holmes,DEM,550158,0,0,6,6,
Oklahoma,Superintendent of Public Instruction,Freda Deskin,DEM,550158,0,0,50,50,
Oklahoma,U.S. Senate,Patrick Michael Hayes,DEM,550158,0,0,9,9,
Oklahoma,U.S. Senate,Jim Rogers,DEM,550158,0,0,13,13,
Oklahoma,U.S. Senate,Connie Johnson,DEM,550158,0,0,61,61,
Oklahoma,U.S. House,Tom Guild,DEM,550158,0,0,33,33,05
Oklahoma,U.S. House,Al Mcaffrey,DEM,550158,0,0,20,20,05
Oklahoma,U.S. House,Leona Leonard,DEM,550158,0,0,29,29,05
Oklahoma,Governor,Dax Ewbank,REP,550158,0,0,12,12,
Oklahoma,Governor,Chad Moody,REP,550158,0,0,32,32,
Oklahoma,Governor,Mary Fallin,REP,550158,0,0,209,209,
Oklahoma,Superintendent of Public Instruction,Brian Kelly,REP,550158,0,0,55,55,
Oklahoma,Superintendent of Public Instruction,Janet Costello Barresi,REP,550158,0,0,91,91,
Oklahoma,Superintendent of Public Instruction,Joy Hofmeister,REP,550158,0,0,102,102,
Oklahoma,Insurance Commissioner,Bill Viner,REP,550158,0,0,58,58,
Oklahoma,Insurance Commissioner,John Doak,REP,550158,0,0,174,174,
Oklahoma,Corporation Commissioner,Todd Hiett,REP,550158,0,0,99,99,
Oklahoma,Corporation Commissioner,Cliff Branan,REP,550158,0,0,128,128,
Oklahoma,U.S. Senate,Evelyn Rogers,REP,550158,0,0,6,6,
Oklahoma,U.S. Senate,Rob Moye,REP,550158,0,0,8,8,
Oklahoma,U.S. Senate,D. Jean Mcbride-Samuels,REP,550158,0,0,4,4,
Oklahoma,U.S. Senate,Jim Inhofe,REP,550158,0,0,229,229,
Oklahoma,U.S. Senate,Erick Paul Wyatt,REP,550158,0,0,6,6,
Oklahoma,U.S. Senate,Andy Craig,REP,550158,0,0,0,0,
Oklahoma,U.S. Senate,T. Shannon,REP,550158,0,0,61,61,
Oklahoma,U.S. Senate,Randy Brogdon,REP,550158,0,0,3,3,
Oklahoma,U.S. Senate,Eric Mccray,REP,550158,0,0,1,1,
Oklahoma,U.S. Senate,Kevin Crow,REP,550158,0,0,0,0,
Oklahoma,U.S. Senate,James Lankford,REP,550158,0,0,189,189,
Oklahoma,U.S. Senate,Jason Weger,REP,550158,0,0,0,0,
Oklahoma,U.S. House,Shane David Jett,REP,550158,0,0,23,23,05
Oklahoma,U.S. House,Patrice Douglas,REP,550158,0,0,42,42,05
Oklahoma,U.S. House,Mike Turner,REP,550158,0,0,43,43,05
Oklahoma,U.S. House,Steve Russell,REP,550158,0,0,72,72,05
Oklahoma,U.S. House,Harvey Sparks,REP,550158,0,0,32,32,05
Oklahoma,U.S. House,Clark Jolley,REP,550158,0,0,30,30,05
Oklahoma,Superintendent of Public Instruction,John Cox,DEM,550159,0,0,33,33,
Oklahoma,Superintendent of Public Instruction,Jack Jr.,DEM,550159,0,0,4,4,
Oklahoma,Superintendent of Public Instruction,Ivan Holmes,DEM,550159,0,0,9,9,
Oklahoma,Superintendent of Public Instruction,Freda Deskin,DEM,550159,0,0,55,55,
Oklahoma,U.S. Senate,Patrick Michael Hayes,DEM,550159,0,0,16,16,
Oklahoma,U.S. Senate,Jim Rogers,DEM,550159,0,0,18,18,
Oklahoma,U.S. Senate,Connie Johnson,DEM,550159,0,0,63,63,
Oklahoma,U.S. House,Tom Guild,DEM,550159,0,0,43,43,05
Oklahoma,U.S. House,Al Mcaffrey,DEM,550159,0,0,26,26,05
Oklahoma,U.S. House,Leona Leonard,DEM,550159,0,0,29,29,05
Oklahoma,Governor,Dax Ewbank,REP,550159,0,0,24,24,
Oklahoma,Governor,Chad Moody,REP,550159,0,0,49,49,
Oklahoma,Governor,Mary Fallin,REP,550159,0,0,206,206,
Oklahoma,Superintendent of Public Instruction,Brian Kelly,REP,550159,0,0,65,65,
Oklahoma,Superintendent of Public Instruction,Janet Costello Barresi,REP,550159,0,0,63,63,
Oklahoma,Superintendent of Public Instruction,Joy Hofmeister,REP,550159,0,0,149,149,
Oklahoma,Insurance Commissioner,Bill Viner,REP,550159,0,0,62,62,
Oklahoma,Insurance Commissioner,John Doak,REP,550159,0,0,199,199,
Oklahoma,Corporation Commissioner,Todd Hiett,REP,550159,0,0,124,124,
Oklahoma,Corporation Commissioner,Cliff Branan,REP,550159,0,0,133,133,
Oklahoma,U.S. Senate,Evelyn Rogers,REP,550159,0,0,12,12,
Oklahoma,U.S. Senate,Rob Moye,REP,550159,0,0,6,6,
Oklahoma,U.S. Senate,D. Jean Mcbride-Samuels,REP,550159,0,0,4,4,
Oklahoma,U.S. Senate,Jim Inhofe,REP,550159,0,0,239,239,
Oklahoma,U.S. Senate,Erick Paul Wyatt,REP,550159,0,0,16,16,
Oklahoma,U.S. Senate,Andy Craig,REP,550159,0,0,2,2,
Oklahoma,U.S. Senate,T. Shannon,REP,550159,0,0,65,65,
Oklahoma,U.S. Senate,Randy Brogdon,REP,550159,0,0,8,8,
Oklahoma,U.S. Senate,Eric Mccray,REP,550159,0,0,3,3,
Oklahoma,U.S. Senate,Kevin Crow,REP,550159,0,0,3,3,
Oklahoma,U.S. Senate,James Lankford,REP,550159,0,0,195,195,
Oklahoma,U.S. Senate,Jason Weger,REP,550159,0,0,4,4,
Oklahoma,U.S. House,Shane David Jett,REP,550159,0,0,29,29,05
Oklahoma,U.S. House,Patrice Douglas,REP,550159,0,0,63,63,05
Oklahoma,U.S. House,Mike Turner,REP,550159,0,0,44,44,05
Oklahoma,U.S. House,Steve Russell,REP,550159,0,0,75,75,05
Oklahoma,U.S. House,Harvey Sparks,REP,550159,0,0,28,28,05
Oklahoma,U.S. House,Clark Jolley,REP,550159,0,0,31,31,05
Oklahoma,Superintendent of Public Instruction,John Cox,DEM,550160,0,0,20,20,
Oklahoma,Superintendent of Public Instruction,Jack Jr.,DEM,550160,0,0,8,8,
Oklahoma,Superintendent of Public Instruction,Ivan Holmes,DEM,550160,0,0,6,6,
Oklahoma,Superintendent of Public Instruction,Freda Deskin,DEM,550160,0,0,38,38,
Oklahoma,U.S. Senate,Patrick Michael Hayes,DEM,550160,0,0,4,4,
Oklahoma,U.S. Senate,Jim Rogers,DEM,550160,0,0,19,19,
Oklahoma,U.S. Senate,Connie Johnson,DEM,550160,0,0,47,47,
Oklahoma,U.S. House,Tom Guild,DEM,550160,0,0,27,27,05
Oklahoma,U.S. House,Al Mcaffrey,DEM,550160,0,0,26,26,05
Oklahoma,U.S. House,Leona Leonard,DEM,550160,0,0,16,16,05
Oklahoma,Governor,Dax Ewbank,REP,550160,0,0,16,16,
Oklahoma,Governor,Chad Moody,REP,550160,0,0,45,45,
Oklahoma,Governor,Mary Fallin,REP,550160,0,0,389,389,
Oklahoma,Superintendent of Public Instruction,Brian Kelly,REP,550160,0,0,74,74,
Oklahoma,Superintendent of Public Instruction,Janet Costello Barresi,REP,550160,0,0,140,140,
Oklahoma,Superintendent of Public Instruction,Joy Hofmeister,REP,550160,0,0,223,223,
Oklahoma,Insurance Commissioner,Bill Viner,REP,550160,0,0,76,76,
Oklahoma,Insurance Commissioner,John Doak,REP,550160,0,0,332,332,
Oklahoma,Corporation Commissioner,Todd Hiett,REP,550160,0,0,172,172,
Oklahoma,Corporation Commissioner,Cliff Branan,REP,550160,0,0,239,239,
Oklahoma,U.S. Senate,Evelyn Rogers,REP,550160,0,0,12,12,
Oklahoma,U.S. Senate,Rob Moye,REP,550160,0,0,2,2,
Oklahoma,U.S. Senate,D. Jean Mcbride-Samuels,REP,550160,0,0,1,1,
Oklahoma,U.S. Senate,Jim Inhofe,REP,550160,0,0,425,425,
Oklahoma,U.S. Senate,Erick Paul Wyatt,REP,550160,0,0,5,5,
Oklahoma,U.S. Senate,Andy Craig,REP,550160,0,0,1,1,
Oklahoma,U.S. Senate,T. Shannon,REP,550160,0,0,62,62,
Oklahoma,U.S. Senate,Randy Brogdon,REP,550160,0,0,8,8,
Oklahoma,U.S. Senate,Eric Mccray,REP,550160,0,0,0,0,
Oklahoma,U.S. Senate,Kevin Crow,REP,550160,0,0,1,1,
Oklahoma,U.S. Senate,James Lankford,REP,550160,0,0,378,378,
Oklahoma,U.S. Senate,Jason Weger,REP,550160,0,0,0,0,
Oklahoma,U.S. House,Shane David Jett,REP,550160,0,0,35,35,05
Oklahoma,U.S. House,Patrice Douglas,REP,550160,0,0,98,98,05
Oklahoma,U.S. House,Mike Turner,REP,550160,0,0,62,62,05
Oklahoma,U.S. House,Steve Russell,REP,550160,0,0,134,134,05
Oklahoma,U.S. House,Harvey Sparks,REP,550160,0,0,56,56,05
Oklahoma,U.S. House,Clark Jolley,REP,550160,0,0,44,44,05
Oklahoma,Superintendent of Public Instruction,John Cox,DEM,550161,0,0,16,16,
Oklahoma,Superintendent of Public Instruction,Jack Jr.,DEM,550161,0,0,5,5,
Oklahoma,Superintendent of Public Instruction,Ivan Holmes,DEM,550161,0,0,6,6,
Oklahoma,Superintendent of Public Instruction,Freda Deskin,DEM,550161,0,0,30,30,
Oklahoma,U.S. Senate,Patrick Michael Hayes,DEM,550161,0,0,6,6,
Oklahoma,U.S. Senate,Jim Rogers,DEM,550161,0,0,9,9,
Oklahoma,U.S. Senate,Connie Johnson,DEM,550161,0,0,42,42,
Oklahoma,U.S. House,Tom Guild,DEM,550161,0,0,32,32,05
Oklahoma,U.S. House,Al Mcaffrey,DEM,550161,0,0,13,13,05
Oklahoma,U.S. House,Leona Leonard,DEM,550161,0,0,12,12,05
Oklahoma,Governor,Dax Ewbank,REP,550161,0,0,12,12,
Oklahoma,Governor,Chad Moody,REP,550161,0,0,22,22,
Oklahoma,Governor,Mary Fallin,REP,550161,0,0,106,106,
Oklahoma,Superintendent of Public Instruction,Brian Kelly,REP,550161,0,0,35,35,
Oklahoma,Superintendent of Public Instruction,Janet Costello Barresi,REP,550161,0,0,50,50,
Oklahoma,Superintendent of Public Instruction,Joy Hofmeister,REP,550161,0,0,52,52,
Oklahoma,Insurance Commissioner,Bill Viner,REP,550161,0,0,17,17,
Oklahoma,Insurance Commissioner,John Doak,REP,550161,0,0,111,111,
Oklahoma,Corporation Commissioner,Todd Hiett,REP,550161,0,0,48,48,
Oklahoma,Corporation Commissioner,Cliff Branan,REP,550161,0,0,77,77,
Oklahoma,U.S. Senate,Evelyn Rogers,REP,550161,0,0,10,10,
Oklahoma,U.S. Senate,Rob Moye,REP,550161,0,0,3,3,
Oklahoma,U.S. Senate,D. Jean Mcbride-Samuels,REP,550161,0,0,3,3,
Oklahoma,U.S. Senate,Jim Inhofe,REP,550161,0,0,118,118,
Oklahoma,U.S. Senate,Erick Paul Wyatt,REP,550161,0,0,4,4,
Oklahoma,U.S. Senate,Andy Craig,REP,550161,0,0,0,0,
Oklahoma,U.S. Senate,T. Shannon,REP,550161,0,0,26,26,
Oklahoma,U.S. Senate,Randy Brogdon,REP,550161,0,0,8,8,
Oklahoma,U.S. Senate,Eric Mccray,REP,550161,0,0,1,1,
Oklahoma,U.S. Senate,Kevin Crow,REP,550161,0,0,1,1,
Oklahoma,U.S. Senate,James Lankford,REP,550161,0,0,105,105,
Oklahoma,U.S. Senate,Jason Weger,REP,550161,0,0,1,1,
Oklahoma,U.S. House,Shane David Jett,REP,550161,0,0,12,12,05
Oklahoma,U.S. House,Patrice Douglas,REP,550161,0,0,27,27,05
Oklahoma,U.S. House,Mike Turner,REP,550161,0,0,40,40,05
Oklahoma,U.S. House,Steve Russell,REP,550161,0,0,32,32,05
Oklahoma,U.S. House,Harvey Sparks,REP,550161,0,0,21,21,05
Oklahoma,U.S. House,Clark Jolley,REP,550161,0,0,9,9,05
Oklahoma,Superintendent of Public Instruction,John Cox,DEM,550162,0,0,14,14,
Oklahoma,Superintendent of Public Instruction,Jack Jr.,DEM,550162,0,0,2,2,
Oklahoma,Superintendent of Public Instruction,Ivan Holmes,DEM,550162,0,0,10,10,
Oklahoma,Superintendent of Public Instruction,Freda Deskin,DEM,550162,0,0,33,33,
Oklahoma,U.S. Senate,Patrick Michael Hayes,DEM,550162,0,0,8,8,
Oklahoma,U.S. Senate,Jim Rogers,DEM,550162,0,0,11,11,
Oklahoma,U.S. Senate,Connie Johnson,DEM,550162,0,0,44,44,
Oklahoma,U.S. House,Tom Guild,DEM,550162,0,0,32,32,05
Oklahoma,U.S. House,Al Mcaffrey,DEM,550162,0,0,13,13,05
Oklahoma,U.S. House,Leona Leonard,DEM,550162,0,0,16,16,05
Oklahoma,Governor,Dax Ewbank,REP,550162,0,0,5,5,
Oklahoma,Governor,Chad Moody,REP,550162,0,0,50,50,
Oklahoma,Governor,Mary Fallin,REP,550162,0,0,203,203,
Oklahoma,Superintendent of Public Instruction,Brian Kelly,REP,550162,0,0,47,47,
Oklahoma,Superintendent of Public Instruction,Janet Costello Barresi,REP,550162,0,0,97,97,
Oklahoma,Superintendent of Public Instruction,Joy Hofmeister,REP,550162,0,0,106,106,
Oklahoma,Insurance Commissioner,Bill Viner,REP,550162,0,0,41,41,
Oklahoma,Insurance Commissioner,John Doak,REP,550162,0,0,185,185,
Oklahoma,Corporation Commissioner,Todd Hiett,REP,550162,0,0,108,108,
Oklahoma,Corporation Commissioner,Cliff Branan,REP,550162,0,0,125,125,
Oklahoma,U.S. Senate,Evelyn Rogers,REP,550162,0,0,6,6,
Oklahoma,U.S. Senate,Rob Moye,REP,550162,0,0,3,3,
Oklahoma,U.S. Senate,D. Jean Mcbride-Samuels,REP,550162,0,0,3,3,
Oklahoma,U.S. Senate,Jim Inhofe,REP,550162,0,0,235,235,
Oklahoma,U.S. Senate,Erick Paul Wyatt,REP,550162,0,0,11,11,
Oklahoma,U.S. Senate,Andy Craig,REP,550162,0,0,0,0,
Oklahoma,U.S. Senate,T. Shannon,REP,550162,0,0,61,61,
Oklahoma,U.S. Senate,Randy Brogdon,REP,550162,0,0,6,6,
Oklahoma,U.S. Senate,Eric Mccray,REP,550162,0,0,2,2,
Oklahoma,U.S. Senate,Kevin Crow,REP,550162,0,0,3,3,
Oklahoma,U.S. Senate,James Lankford,REP,550162,0,0,189,189,
Oklahoma,U.S. Senate,Jason Weger,REP,550162,0,0,0,0,
Oklahoma,U.S. House,Shane David Jett,REP,550162,0,0,15,15,05
Oklahoma,U.S. House,Patrice Douglas,REP,550162,0,0,52,52,05
Oklahoma,U.S. House,Mike Turner,REP,550162,0,0,49,49,05
Oklahoma,U.S. House,Steve Russell,REP,550162,0,0,84,84,05
Oklahoma,U.S. House,Harvey Sparks,REP,550162,0,0,17,17,05
Oklahoma,U.S. House,Clark Jolley,REP,550162,0,0,27,27,05
Oklahoma,Superintendent of Public Instruction,John Cox,DEM,550163,0,0,24,24,
Oklahoma,Superintendent of Public Instruction,Jack Jr.,DEM,550163,0,0,11,11,
Oklahoma,Superintendent of Public Instruction,Ivan Holmes,DEM,550163,0,0,2,2,
Oklahoma,Superintendent of Public Instruction,Freda Deskin,DEM,550163,0,0,36,36,
Oklahoma,U.S. Senate,Patrick Michael Hayes,DEM,550163,0,0,12,12,
Oklahoma,U.S. Senate,Jim Rogers,DEM,550163,0,0,7,7,
Oklahoma,U.S. Senate,Connie Johnson,DEM,550163,0,0,51,51,
Oklahoma,U.S. House,Tom Guild,DEM,550163,0,0,33,33,05
Oklahoma,U.S. House,Al Mcaffrey,DEM,550163,0,0,23,23,05
Oklahoma,U.S. House,Leona Leonard,DEM,550163,0,0,17,17,05
Oklahoma,Governor,Dax Ewbank,REP,550163,0,0,20,20,
Oklahoma,Governor,Chad Moody,REP,550163,0,0,20,20,
Oklahoma,Governor,Mary Fallin,REP,550163,0,0,121,121,
Oklahoma,Superintendent of Public Instruction,Brian Kelly,REP,550163,0,0,54,54,
Oklahoma,Superintendent of Public Instruction,Janet Costello Barresi,REP,550163,0,0,42,42,
Oklahoma,Superintendent of Public Instruction,Joy Hofmeister,REP,550163,0,0,63,63,
Oklahoma,Insurance Commissioner,Bill Viner,REP,550163,0,0,26,26,
Oklahoma,Insurance Commissioner,John Doak,REP,550163,0,0,126,126,
Oklahoma,Corporation Commissioner,Todd Hiett,REP,550163,0,0,90,90,
Oklahoma,Corporation Commissioner,Cliff Branan,REP,550163,0,0,65,65,
Oklahoma,U.S. Senate,Evelyn Rogers,REP,550163,0,0,5,5,
Oklahoma,U.S. Senate,Rob Moye,REP,550163,0,0,3,3,
Oklahoma,U.S. Senate,D. Jean Mcbride-Samuels,REP,550163,0,0,1,1,
Oklahoma,U.S. Senate,Jim Inhofe,REP,550163,0,0,143,143,
Oklahoma,U.S. Senate,Erick Paul Wyatt,REP,550163,0,0,9,9,
Oklahoma,U.S. Senate,Andy Craig,REP,550163,0,0,0,0,
Oklahoma,U.S. Senate,T. Shannon,REP,550163,0,0,49,49,
Oklahoma,U.S. Senate,Randy Brogdon,REP,550163,0,0,11,11,
Oklahoma,U.S. Senate,Eric Mccray,REP,550163,0,0,1,1,
Oklahoma,U.S. Senate,Kevin Crow,REP,550163,0,0,1,1,
Oklahoma,U.S. Senate,James Lankford,REP,550163,0,0,99,99,
Oklahoma,U.S. Senate,Jason Weger,REP,550163,0,0,1,1,
Oklahoma,U.S. House,Shane David Jett,REP,550163,0,0,24,24,05
Oklahoma,U.S. House,Patrice Douglas,REP,550163,0,0,31,31,05
Oklahoma,U.S. House,Mike Turner,REP,550163,0,0,21,21,05
Oklahoma,U.S. House,Steve Russell,REP,550163,0,0,56,56,05
Oklahoma,U.S. House,Harvey Sparks,REP,550163,0,0,14,14,05
Oklahoma,U.S. House,Clark Jolley,REP,550163,0,0,14,14,05
Oklahoma,Superintendent of Public Instruction,John Cox,DEM,550164,0,0,15,15,
Oklahoma,Superintendent of Public Instruction,Jack Jr.,DEM,550164,0,0,5,5,
Oklahoma,Superintendent of Public Instruction,Ivan Holmes,DEM,550164,0,0,4,4,
Oklahoma,Superintendent of Public Instruction,Freda Deskin,DEM,550164,0,0,22,22,
Oklahoma,U.S. Senate,Patrick Michael Hayes,DEM,550164,0,0,12,12,
Oklahoma,U.S. Senate,Jim Rogers,DEM,550164,0,0,7,7,
Oklahoma,U.S. Senate,Connie Johnson,DEM,550164,0,0,27,27,
Oklahoma,U.S. House,Tom Guild,DEM,550164,0,0,22,22,05
Oklahoma,U.S. House,Al Mcaffrey,DEM,550164,0,0,14,14,05
Oklahoma,U.S. House,Leona Leonard,DEM,550164,0,0,9,9,05
Oklahoma,Governor,Dax Ewbank,REP,550164,0,0,10,10,
Oklahoma,Governor,Chad Moody,REP,550164,0,0,29,29,
Oklahoma,Governor,Mary Fallin,REP,550164,0,0,75,75,
Oklahoma,Superintendent of Public Instruction,Brian Kelly,REP,550164,0,0,33,33,
Oklahoma,Superintendent of Public Instruction,Janet Costello Barresi,REP,550164,0,0,20,20,
Oklahoma,Superintendent of Public Instruction,Joy Hofmeister,REP,550164,0,0,60,60,
Oklahoma,Insurance Commissioner,Bill Viner,REP,550164,0,0,30,30,
Oklahoma,Insurance Commissioner,John Doak,REP,550164,0,0,74,74,
Oklahoma,Corporation Commissioner,Todd Hiett,REP,550164,0,0,50,50,
Oklahoma,Corporation Commissioner,Cliff Branan,REP,550164,0,0,56,56,
Oklahoma,U.S. Senate,Evelyn Rogers,REP,550164,0,0,6,6,
Oklahoma,U.S. Senate,Rob Moye,REP,550164,0,0,2,2,
Oklahoma,U.S. Senate,D. Jean Mcbride-Samuels,REP,550164,0,0,4,4,
Oklahoma,U.S. Senate,Jim Inhofe,REP,550164,0,0,99,99,
Oklahoma,U.S. Senate,Erick Paul Wyatt,REP,550164,0,0,3,3,
Oklahoma,U.S. Senate,Andy Craig,REP,550164,0,0,3,3,
Oklahoma,U.S. Senate,T. Shannon,REP,550164,0,0,30,30,
Oklahoma,U.S. Senate,Randy Brogdon,REP,550164,0,0,4,4,
Oklahoma,U.S. Senate,Eric Mccray,REP,550164,0,0,1,1,
Oklahoma,U.S. Senate,Kevin Crow,REP,550164,0,0,1,1,
Oklahoma,U.S. Senate,James Lankford,REP,550164,0,0,73,73,
Oklahoma,U.S. Senate,Jason Weger,REP,550164,0,0,3,3,
Oklahoma,U.S. House,Shane David Jett,REP,550164,0,0,10,10,05
Oklahoma,U.S. House,Patrice Douglas,REP,550164,0,0,27,27,05
Oklahoma,U.S. House,Mike Turner,REP,550164,0,0,12,12,05
Oklahoma,U.S. House,Steve Russell,REP,550164,0,0,45,45,05
Oklahoma,U.S. House,Harvey Sparks,REP,550164,0,0,6,6,05
Oklahoma,U.S. House,Clark Jolley,REP,550164,0,0,9,9,05
Oklahoma,Superintendent of Public Instruction,John Cox,DEM,550165,0,0,9,9,
Oklahoma,Superintendent of Public Instruction,Jack Jr.,DEM,550165,0,0,6,6,
Oklahoma,Superintendent of Public Instruction,Ivan Holmes,DEM,550165,0,0,4,4,
Oklahoma,Superintendent of Public Instruction,Freda Deskin,DEM,550165,0,0,23,23,
Oklahoma,U.S. Senate,Patrick Michael Hayes,DEM,550165,0,0,10,10,
Oklahoma,U.S. Senate,Jim Rogers,DEM,550165,0,0,14,14,
Oklahoma,U.S. Senate,Connie Johnson,DEM,550165,0,0,17,17,
Oklahoma,U.S. House,Tom Guild,DEM,550165,0,0,20,20,05
Oklahoma,U.S. House,Al Mcaffrey,DEM,550165,0,0,13,13,05
Oklahoma,U.S. House,Leona Leonard,DEM,550165,0,0,9,9,05
Oklahoma,Governor,Dax Ewbank,REP,550165,0,0,18,18,
Oklahoma,Governor,Chad Moody,REP,550165,0,0,35,35,
Oklahoma,Governor,Mary Fallin,REP,550165,0,0,200,200,
Oklahoma,Superintendent of Public Instruction,Brian Kelly,REP,550165,0,0,62,62,
Oklahoma,Superintendent of Public Instruction,Janet Costello Barresi,REP,550165,0,0,55,55,
Oklahoma,Superintendent of Public Instruction,Joy Hofmeister,REP,550165,0,0,138,138,
Oklahoma,Insurance Commissioner,Bill Viner,REP,550165,0,0,51,51,
Oklahoma,Insurance Commissioner,John Doak,REP,550165,0,0,179,179,
Oklahoma,Corporation Commissioner,Todd Hiett,REP,550165,0,0,108,108,
Oklahoma,Corporation Commissioner,Cliff Branan,REP,550165,0,0,117,117,
Oklahoma,U.S. Senate,Evelyn Rogers,REP,550165,0,0,12,12,
Oklahoma,U.S. Senate,Rob Moye,REP,550165,0,0,5,5,
Oklahoma,U.S. Senate,D. Jean Mcbride-Samuels,REP,550165,0,0,2,2,
Oklahoma,U.S. Senate,Jim Inhofe,REP,550165,0,0,220,220,
Oklahoma,U.S. Senate,Erick Paul Wyatt,REP,550165,0,0,9,9,
Oklahoma,U.S. Senate,Andy Craig,REP,550165,0,0,3,3,
Oklahoma,U.S. Senate,T. Shannon,REP,550165,0,0,67,67,
Oklahoma,U.S. Senate,Randy Brogdon,REP,550165,0,0,9,9,
Oklahoma,U.S. Senate,Eric Mccray,REP,550165,0,0,1,1,
Oklahoma,U.S. Senate,Kevin Crow,REP,550165,0,0,2,2,
Oklahoma,U.S. Senate,James Lankford,REP,550165,0,0,173,173,
Oklahoma,U.S. Senate,Jason Weger,REP,550165,0,0,1,1,
Oklahoma,U.S. House,Shane David Jett,REP,550165,0,0,26,26,05
Oklahoma,U.S. House,Patrice Douglas,REP,550165,0,0,43,43,05
Oklahoma,U.S. House,Mike Turner,REP,550165,0,0,32,32,05
Oklahoma,U.S. House,Steve Russell,REP,550165,0,0,86,86,05
Oklahoma,U.S. House,Harvey Sparks,REP,550165,0,0,12,12,05
Oklahoma,U.S. House,Clark Jolley,REP,550165,0,0,43,43,05
Oklahoma,Superintendent of Public Instruction,John Cox,DEM,550166,0,0,5,5,
Oklahoma,Superintendent of Public Instruction,Jack Jr.,DEM,550166,0,0,1,1,
Oklahoma,Superintendent of Public Instruction,Ivan Holmes,DEM,550166,0,0,3,3,
Oklahoma,Superintendent of Public Instruction,Freda Deskin,DEM,550166,0,0,5,5,
Oklahoma,U.S. Senate,Patrick Michael Hayes,DEM,550166,0,0,4,4,
Oklahoma,U.S. Senate,Jim Rogers,DEM,550166,0,0,5,5,
Oklahoma,U.S. Senate,Connie Johnson,DEM,550166,0,0,4,4,
Oklahoma,U.S. House,Tom Guild,DEM,550166,0,0,8,8,05
Oklahoma,U.S. House,Al Mcaffrey,DEM,550166,0,0,3,3,05
Oklahoma,U.S. House,Leona Leonard,DEM,550166,0,0,0,0,05
Oklahoma,Governor,Dax Ewbank,REP,550166,0,0,4,4,
Oklahoma,Governor,Chad Moody,REP,550166,0,0,6,6,
Oklahoma,Governor,Mary Fallin,REP,550166,0,0,45,45,
Oklahoma,Superintendent of Public Instruction,Brian Kelly,REP,550166,0,0,17,17,
Oklahoma,Superintendent of Public Instruction,Janet Costello Barresi,REP,550166,0,0,13,13,
Oklahoma,Superintendent of Public Instruction,Joy Hofmeister,REP,550166,0,0,24,24,
Oklahoma,Insurance Commissioner,Bill Viner,REP,550166,0,0,15,15,
Oklahoma,Insurance Commissioner,John Doak,REP,550166,0,0,36,36,
Oklahoma,Corporation Commissioner,Todd Hiett,REP,550166,0,0,19,19,
Oklahoma,Corporation Commissioner,Cliff Branan,REP,550166,0,0,30,30,
Oklahoma,U.S. Senate,Evelyn Rogers,REP,550166,0,0,1,1,
Oklahoma,U.S. Senate,Rob Moye,REP,550166,0,0,2,2,
Oklahoma,U.S. Senate,D. Jean Mcbride-Samuels,REP,550166,0,0,2,2,
Oklahoma,U.S. Senate,Jim Inhofe,REP,550166,0,0,44,44,
Oklahoma,U.S. Senate,Erick Paul Wyatt,REP,550166,0,0,6,6,
Oklahoma,U.S. Senate,Andy Craig,REP,550166,0,0,0,0,
Oklahoma,U.S. Senate,T. Shannon,REP,550166,0,0,14,14,
Oklahoma,U.S. Senate,Randy Brogdon,REP,550166,0,0,0,0,
Oklahoma,U.S. Senate,Eric Mccray,REP,550166,0,0,0,0,
Oklahoma,U.S. Senate,Kevin Crow,REP,550166,0,0,0,0,
Oklahoma,U.S. Senate,James Lankford,REP,550166,0,0,42,42,
Oklahoma,U.S. Senate,Jason Weger,REP,550166,0,0,0,0,
Oklahoma,U.S. House,Shane David Jett,REP,550166,0,0,6,6,05
Oklahoma,U.S. House,Patrice Douglas,REP,550166,0,0,11,11,05
Oklahoma,U.S. House,Mike Turner,REP,550166,0,0,11,11,05
Oklahoma,U.S. House,Steve Russell,REP,550166,0,0,14,14,05
Oklahoma,U.S. House,Harvey Sparks,REP,550166,0,0,2,2,05
Oklahoma,U.S. House,Clark Jolley,REP,550166,0,0,11,11,05
Oklahoma,Superintendent of Public Instruction,John Cox,DEM,550167,0,0,11,11,
Oklahoma,Superintendent of Public Instruction,Jack Jr.,DEM,550167,0,0,5,5,
Oklahoma,Superintendent of Public Instruction,Ivan Holmes,DEM,550167,0,0,3,3,
Oklahoma,Superintendent of Public Instruction,Freda Deskin,DEM,550167,0,0,14,14,
Oklahoma,U.S. Senate,Patrick Michael Hayes,DEM,550167,0,0,6,6,
Oklahoma,U.S. Senate,Jim Rogers,DEM,550167,0,0,11,11,
Oklahoma,U.S. Senate,Connie Johnson,DEM,550167,0,0,14,14,
Oklahoma,U.S. House,Tom Guild,DEM,550167,0,0,8,8,05
Oklahoma,U.S. House,Al Mcaffrey,DEM,550167,0,0,21,21,05
Oklahoma,U.S. House,Leona Leonard,DEM,550167,0,0,4,4,05
Oklahoma,State Senate,Wilfredo Santos Rivera,DEM,550167,0,0,9,9,46
Oklahoma,State Senate,Kay Floyd,DEM,550167,0,0,24,24,46
Oklahoma,Governor,Dax Ewbank,REP,550167,0,0,1,1,
Oklahoma,Governor,Chad Moody,REP,550167,0,0,7,7,
Oklahoma,Governor,Mary Fallin,REP,550167,0,0,32,32,
Oklahoma,Superintendent of Public Instruction,Brian Kelly,REP,550167,0,0,13,13,
Oklahoma,Superintendent of Public Instruction,Janet Costello Barresi,REP,550167,0,0,15,15,
Oklahoma,Superintendent of Public Instruction,Joy Hofmeister,REP,550167,0,0,10,10,
Oklahoma,Insurance Commissioner,Bill Viner,REP,550167,0,0,3,3,
Oklahoma,Insurance Commissioner,John Doak,REP,550167,0,0,35,35,
Oklahoma,Corporation Commissioner,Todd Hiett,REP,550167,0,0,18,18,
Oklahoma,Corporation Commissioner,Cliff Branan,REP,550167,0,0,20,20,
Oklahoma,U.S. Senate,Evelyn Rogers,REP,550167,0,0,1,1,
Oklahoma,U.S. Senate,Rob Moye,REP,550167,0,0,0,0,
Oklahoma,U.S. Senate,D. Jean Mcbride-Samuels,REP,550167,0,0,0,0,
Oklahoma,U.S. Senate,Jim Inhofe,REP,550167,0,0,38,38,
Oklahoma,U.S. Senate,Erick Paul Wyatt,REP,550167,0,0,0,0,
Oklahoma,U.S. Senate,Andy Craig,REP,550167,0,0,0,0,
Oklahoma,U.S. Senate,T. Shannon,REP,550167,0,0,8,8,
Oklahoma,U.S. Senate,Randy Brogdon,REP,550167,0,0,2,2,
Oklahoma,U.S. Senate,Eric Mccray,REP,550167,0,0,1,1,
Oklahoma,U.S. Senate,Kevin Crow,REP,550167,0,0,0,0,
Oklahoma,U.S. Senate,James Lankford,REP,550167,0,0,30,30,
Oklahoma,U.S. Senate,Jason Weger,REP,550167,0,0,0,0,
Oklahoma,U.S. House,Shane David Jett,REP,550167,0,0,5,5,05
Oklahoma,U.S. House,Patrice Douglas,REP,550167,0,0,8,8,05
Oklahoma,U.S. House,Mike Turner,REP,550167,0,0,5,5,05
Oklahoma,U.S. House,Steve Russell,REP,550167,0,0,8,8,05
Oklahoma,U.S. House,Harvey Sparks,REP,550167,0,0,7,7,05
Oklahoma,U.S. House,Clark Jolley,REP,550167,0,0,6,6,05
Oklahoma,Superintendent of Public Instruction,John Cox,DEM,550168,0,0,7,7,
Oklahoma,Superintendent of Public Instruction,Jack Jr.,DEM,550168,0,0,4,4,
Oklahoma,Superintendent of Public Instruction,Ivan Holmes,DEM,550168,0,0,0,0,
Oklahoma,Superintendent of Public Instruction,Freda Deskin,DEM,550168,0,0,8,8,
Oklahoma,U.S. Senate,Patrick Michael Hayes,DEM,550168,0,0,3,3,
Oklahoma,U.S. Senate,Jim Rogers,DEM,550168,0,0,7,7,
Oklahoma,U.S. Senate,Connie Johnson,DEM,550168,0,0,9,9,
Oklahoma,U.S. House,Tom Guild,DEM,550168,0,0,6,6,05
Oklahoma,U.S. House,Al Mcaffrey,DEM,550168,0,0,8,8,05
Oklahoma,U.S. House,Leona Leonard,DEM,550168,0,0,5,5,05
Oklahoma,Governor,Dax Ewbank,REP,550168,0,0,3,3,
Oklahoma,Governor,Chad Moody,REP,550168,0,0,12,12,
Oklahoma,Governor,Mary Fallin,REP,550168,0,0,25,25,
Oklahoma,Superintendent of Public Instruction,Brian Kelly,REP,550168,0,0,13,13,
Oklahoma,Superintendent of Public Instruction,Janet Costello Barresi,REP,550168,0,0,8,8,
Oklahoma,Superintendent of Public Instruction,Joy Hofmeister,REP,550168,0,0,20,20,
Oklahoma,Insurance Commissioner,Bill Viner,REP,550168,0,0,11,11,
Oklahoma,Insurance Commissioner,John Doak,REP,550168,0,0,30,30,
Oklahoma,Corporation Commissioner,Todd Hiett,REP,550168,0,0,24,24,
Oklahoma,Corporation Commissioner,Cliff Branan,REP,550168,0,0,15,15,
Oklahoma,U.S. Senate,Evelyn Rogers,REP,550168,0,0,3,3,
Oklahoma,U.S. Senate,Rob Moye,REP,550168,0,0,3,3,
Oklahoma,U.S. Senate,D. Jean Mcbride-Samuels,REP,550168,0,0,0,0,
Oklahoma,U.S. Senate,Jim Inhofe,REP,550168,0,0,33,33,
Oklahoma,U.S. Senate,Erick Paul Wyatt,REP,550168,0,0,2,2,
Oklahoma,U.S. Senate,Andy Craig,REP,550168,0,0,0,0,
Oklahoma,U.S. Senate,T. Shannon,REP,550168,0,0,13,13,
Oklahoma,U.S. Senate,Randy Brogdon,REP,550168,0,0,0,0,
Oklahoma,U.S. Senate,Eric Mccray,REP,550168,0,0,1,1,
Oklahoma,U.S. Senate,Kevin Crow,REP,550168,0,0,2,2,
Oklahoma,U.S. Senate,James Lankford,REP,550168,0,0,24,24,
Oklahoma,U.S. Senate,Jason Weger,REP,550168,0,0,1,1,
Oklahoma,U.S. House,Shane David Jett,REP,550168,0,0,8,8,05
Oklahoma,U.S. House,Patrice Douglas,REP,550168,0,0,6,6,05
Oklahoma,U.S. House,Mike Turner,REP,550168,0,0,4,4,05
Oklahoma,U.S. House,Steve Russell,REP,550168,0,0,12,12,05
Oklahoma,U.S. House,Harvey Sparks,REP,550168,0,0,7,7,05
Oklahoma,U.S. House,Clark Jolley,REP,550168,0,0,3,3,05
Oklahoma,Superintendent of Public Instruction,John Cox,DEM,550169,0,0,17,17,
Oklahoma,Superintendent of Public Instruction,Jack Jr.,DEM,550169,0,0,8,8,
Oklahoma,Superintendent of Public Instruction,Ivan Holmes,DEM,550169,0,0,4,4,
Oklahoma,Superintendent of Public Instruction,Freda Deskin,DEM,550169,0,0,28,28,
Oklahoma,U.S. Senate,Patrick Michael Hayes,DEM,550169,0,0,10,10,
Oklahoma,U.S. Senate,Jim Rogers,DEM,550169,0,0,8,8,
Oklahoma,U.S. Senate,Connie Johnson,DEM,550169,0,0,36,36,
Oklahoma,U.S. House,Tom Guild,DEM,550169,0,0,22,22,05
Oklahoma,U.S. House,Al Mcaffrey,DEM,550169,0,0,14,14,05
Oklahoma,U.S. House,Leona Leonard,DEM,550169,0,0,19,19,05
Oklahoma,Governor,Dax Ewbank,REP,550169,0,0,12,12,
Oklahoma,Governor,Chad Moody,REP,550169,0,0,25,25,
Oklahoma,Governor,Mary Fallin,REP,550169,0,0,132,132,
Oklahoma,Superintendent of Public Instruction,Brian Kelly,REP,550169,0,0,50,50,
Oklahoma,Superintendent of Public Instruction,Janet Costello Barresi,REP,550169,0,0,40,40,
Oklahoma,Superintendent of Public Instruction,Joy Hofmeister,REP,550169,0,0,71,71,
Oklahoma,Insurance Commissioner,Bill Viner,REP,550169,0,0,32,32,
Oklahoma,Insurance Commissioner,John Doak,REP,550169,0,0,124,124,
Oklahoma,Corporation Commissioner,Todd Hiett,REP,550169,0,0,71,71,
Oklahoma,Corporation Commissioner,Cliff Branan,REP,550169,0,0,83,83,
Oklahoma,U.S. Senate,Evelyn Rogers,REP,550169,0,0,9,9,
Oklahoma,U.S. Senate,Rob Moye,REP,550169,0,0,6,6,
Oklahoma,U.S. Senate,D. Jean Mcbride-Samuels,REP,550169,0,0,1,1,
Oklahoma,U.S. Senate,Jim Inhofe,REP,550169,0,0,144,144,
Oklahoma,U.S. Senate,Erick Paul Wyatt,REP,550169,0,0,6,6,
Oklahoma,U.S. Senate,Andy Craig,REP,550169,0,0,1,1,
Oklahoma,U.S. Senate,T. Shannon,REP,550169,0,0,31,31,
Oklahoma,U.S. Senate,Randy Brogdon,REP,550169,0,0,9,9,
Oklahoma,U.S. Senate,Eric Mccray,REP,550169,0,0,1,1,
Oklahoma,U.S. Senate,Kevin Crow,REP,550169,0,0,0,0,
Oklahoma,U.S. Senate,James Lankford,REP,550169,0,0,128,128,
Oklahoma,U.S. Senate,Jason Weger,REP,550169,0,0,0,0,
Oklahoma,U.S. House,Shane David Jett,REP,550169,0,0,15,15,05
Oklahoma,U.S. House,Patrice Douglas,REP,550169,0,0,38,38,05
Oklahoma,U.S. House,Mike Turner,REP,550169,0,0,20,20,05
Oklahoma,U.S. House,Steve Russell,REP,550169,0,0,46,46,05
Oklahoma,U.S. House,Harvey Sparks,REP,550169,0,0,22,22,05
Oklahoma,U.S. House,Clark Jolley,REP,550169,0,0,24,24,05
Oklahoma,Superintendent of Public Instruction,John Cox,DEM,550170,0,0,26,26,
Oklahoma,Superintendent of Public Instruction,Jack Jr.,DEM,550170,0,0,8,8,
Oklahoma,Superintendent of Public Instruction,Ivan Holmes,DEM,550170,0,0,4,4,
Oklahoma,Superintendent of Public Instruction,Freda Deskin,DEM,550170,0,0,36,36,
Oklahoma,U.S. Senate,Patrick Michael Hayes,DEM,550170,0,0,22,22,
Oklahoma,U.S. Senate,Jim Rogers,DEM,550170,0,0,15,15,
Oklahoma,U.S. Senate,Connie Johnson,DEM,550170,0,0,36,36,
Oklahoma,U.S. House,Tom Guild,DEM,550170,0,0,29,29,05
Oklahoma,U.S. House,Al Mcaffrey,DEM,550170,0,0,19,19,05
Oklahoma,U.S. House,Leona Leonard,DEM,550170,0,0,23,23,05
Oklahoma,Governor,Dax Ewbank,REP,550170,0,0,12,12,
Oklahoma,Governor,Chad Moody,REP,550170,0,0,18,18,
Oklahoma,Governor,Mary Fallin,REP,550170,0,0,108,108,
Oklahoma,Superintendent of Public Instruction,Brian Kelly,REP,550170,0,0,37,37,
Oklahoma,Superintendent of Public Instruction,Janet Costello Barresi,REP,550170,0,0,43,43,
Oklahoma,Superintendent of Public Instruction,Joy Hofmeister,REP,550170,0,0,54,54,
Oklahoma,Insurance Commissioner,Bill Viner,REP,550170,0,0,28,28,
Oklahoma,Insurance Commissioner,John Doak,REP,550170,0,0,104,104,
Oklahoma,Corporation Commissioner,Todd Hiett,REP,550170,0,0,52,52,
Oklahoma,Corporation Commissioner,Cliff Branan,REP,550170,0,0,74,74,
Oklahoma,U.S. Senate,Evelyn Rogers,REP,550170,0,0,8,8,
Oklahoma,U.S. Senate,Rob Moye,REP,550170,0,0,1,1,
Oklahoma,U.S. Senate,D. Jean Mcbride-Samuels,REP,550170,0,0,5,5,
Oklahoma,U.S. Senate,Jim Inhofe,REP,550170,0,0,116,116,
Oklahoma,U.S. Senate,Erick Paul Wyatt,REP,550170,0,0,4,4,
Oklahoma,U.S. Senate,Andy Craig,REP,550170,0,0,4,4,
Oklahoma,U.S. Senate,T. Shannon,REP,550170,0,0,41,41,
Oklahoma,U.S. Senate,Randy Brogdon,REP,550170,0,0,10,10,
Oklahoma,U.S. Senate,Eric Mccray,REP,550170,0,0,2,2,
Oklahoma,U.S. Senate,Kevin Crow,REP,550170,0,0,2,2,
Oklahoma,U.S. Senate,James Lankford,REP,550170,0,0,79,79,
Oklahoma,U.S. Senate,Jason Weger,REP,550170,0,0,0,0,
Oklahoma,U.S. House,Shane David Jett,REP,550170,0,0,11,11,05
Oklahoma,U.S. House,Patrice Douglas,REP,550170,0,0,22,22,05
Oklahoma,U.S. House,Mike Turner,REP,550170,0,0,23,23,05
Oklahoma,U.S. House,Steve Russell,REP,550170,0,0,34,34,05
Oklahoma,U.S. House,Harvey Sparks,REP,550170,0,0,27,27,05
Oklahoma,U.S. House,Clark Jolley,REP,550170,0,0,15,15,05
Oklahoma,Superintendent of Public Instruction,John Cox,DEM,550171,0,0,33,33,
Oklahoma,Superintendent of Public Instruction,Jack Jr.,DEM,550171,0,0,25,25,
Oklahoma,Superintendent of Public Instruction,Ivan Holmes,DEM,550171,0,0,10,10,
Oklahoma,Superintendent of Public Instruction,Freda Deskin,DEM,550171,0,0,65,65,
Oklahoma,U.S. Senate,Patrick Michael Hayes,DEM,550171,0,0,23,23,
Oklahoma,U.S. Senate,Jim Rogers,DEM,550171,0,0,29,29,
Oklahoma,U.S. Senate,Connie Johnson,DEM,550171,0,0,76,76,
Oklahoma,U.S. House,Tom Guild,DEM,550171,0,0,48,48,05
Oklahoma,U.S. House,Al Mcaffrey,DEM,550171,0,0,48,48,05
Oklahoma,U.S. House,Leona Leonard,DEM,550171,0,0,35,35,05
Oklahoma,Governor,Dax Ewbank,REP,550171,0,0,16,16,
Oklahoma,Governor,Chad Moody,REP,550171,0,0,40,40,
Oklahoma,Governor,Mary Fallin,REP,550171,0,0,129,129,
Oklahoma,Superintendent of Public Instruction,Brian Kelly,REP,550171,0,0,43,43,
Oklahoma,Superintendent of Public Instruction,Janet Costello Barresi,REP,550171,0,0,62,62,
Oklahoma,Superintendent of Public Instruction,Joy Hofmeister,REP,550171,0,0,79,79,
Oklahoma,Insurance Commissioner,Bill Viner,REP,550171,0,0,37,37,
Oklahoma,Insurance Commissioner,John Doak,REP,550171,0,0,141,141,
Oklahoma,Corporation Commissioner,Todd Hiett,REP,550171,0,0,93,93,
Oklahoma,Corporation Commissioner,Cliff Branan,REP,550171,0,0,84,84,
Oklahoma,U.S. Senate,Evelyn Rogers,REP,550171,0,0,12,12,
Oklahoma,U.S. Senate,Rob Moye,REP,550171,0,0,5,5,
Oklahoma,U.S. Senate,D. Jean Mcbride-Samuels,REP,550171,0,0,5,5,
Oklahoma,U.S. Senate,Jim Inhofe,REP,550171,0,0,150,150,
Oklahoma,U.S. Senate,Erick Paul Wyatt,REP,550171,0,0,11,11,
Oklahoma,U.S. Senate,Andy Craig,REP,550171,0,0,1,1,
Oklahoma,U.S. Senate,T. Shannon,REP,550171,0,0,49,49,
Oklahoma,U.S. Senate,Randy Brogdon,REP,550171,0,0,11,11,
Oklahoma,U.S. Senate,Eric Mccray,REP,550171,0,0,2,2,
Oklahoma,U.S. Senate,Kevin Crow,REP,550171,0,0,2,2,
Oklahoma,U.S. Senate,James Lankford,REP,550171,0,0,121,121,
Oklahoma,U.S. Senate,Jason Weger,REP,550171,0,0,0,0,
Oklahoma,U.S. House,Shane David Jett,REP,550171,0,0,20,20,05
Oklahoma,U.S. House,Patrice Douglas,REP,550171,0,0,37,37,05
Oklahoma,U.S. House,Mike Turner,REP,550171,0,0,32,32,05
Oklahoma,U.S. House,Steve Russell,REP,550171,0,0,43,43,05
Oklahoma,U.S. House,Harvey Sparks,REP,550171,0,0,27,27,05
Oklahoma,U.S. House,Clark Jolley,REP,550171,0,0,21,21,05
Oklahoma,Superintendent of Public Instruction,John Cox,DEM,550172,0,0,25,25,
Oklahoma,Superintendent of Public Instruction,Jack Jr.,DEM,550172,0,0,19,19,
Oklahoma,Superintendent of Public Instruction,Ivan Holmes,DEM,550172,0,0,14,14,
Oklahoma,Superintendent of Public Instruction,Freda Deskin,DEM,550172,0,0,63,63,
Oklahoma,U.S. Senate,Patrick Michael Hayes,DEM,550172,0,0,21,21,
Oklahoma,U.S. Senate,Jim Rogers,DEM,550172,0,0,29,29,
Oklahoma,U.S. Senate,Connie Johnson,DEM,550172,0,0,66,66,
Oklahoma,U.S. House,Tom Guild,DEM,550172,0,0,54,54,05
Oklahoma,U.S. House,Al Mcaffrey,DEM,550172,0,0,37,37,05
Oklahoma,U.S. House,Leona Leonard,DEM,550172,0,0,27,27,05
Oklahoma,Governor,Dax Ewbank,REP,550172,0,0,22,22,
Oklahoma,Governor,Chad Moody,REP,550172,0,0,37,37,
Oklahoma,Governor,Mary Fallin,REP,550172,0,0,159,159,
Oklahoma,Superintendent of Public Instruction,Brian Kelly,REP,550172,0,0,77,77,
Oklahoma,Superintendent of Public Instruction,Janet Costello Barresi,REP,550172,0,0,53,53,
Oklahoma,Superintendent of Public Instruction,Joy Hofmeister,REP,550172,0,0,81,81,
Oklahoma,Insurance Commissioner,Bill Viner,REP,550172,0,0,50,50,
Oklahoma,Insurance Commissioner,John Doak,REP,550172,0,0,155,155,
Oklahoma,Corporation Commissioner,Todd Hiett,REP,550172,0,0,81,81,
Oklahoma,Corporation Commissioner,Cliff Branan,REP,550172,0,0,125,125,
Oklahoma,U.S. Senate,Evelyn Rogers,REP,550172,0,0,12,12,
Oklahoma,U.S. Senate,Rob Moye,REP,550172,0,0,4,4,
Oklahoma,U.S. Senate,D. Jean Mcbride-Samuels,REP,550172,0,0,3,3,
Oklahoma,U.S. Senate,Jim Inhofe,REP,550172,0,0,179,179,
Oklahoma,U.S. Senate,Erick Paul Wyatt,REP,550172,0,0,13,13,
Oklahoma,U.S. Senate,Andy Craig,REP,550172,0,0,1,1,
Oklahoma,U.S. Senate,T. Shannon,REP,550172,0,0,53,53,
Oklahoma,U.S. Senate,Randy Brogdon,REP,550172,0,0,19,19,
Oklahoma,U.S. Senate,Eric Mccray,REP,550172,0,0,2,2,
Oklahoma,U.S. Senate,Kevin Crow,REP,550172,0,0,1,1,
Oklahoma,U.S. Senate,James Lankford,REP,550172,0,0,140,140,
Oklahoma,U.S. Senate,Jason Weger,REP,550172,0,0,4,4,
Oklahoma,U.S. House,Shane David Jett,REP,550172,0,0,20,20,05
Oklahoma,U.S. House,Patrice Douglas,REP,550172,0,0,51,51,05
Oklahoma,U.S. House,Mike Turner,REP,550172,0,0,32,32,05
Oklahoma,U.S. House,Steve Russell,REP,550172,0,0,53,53,05
Oklahoma,U.S. House,Harvey Sparks,REP,550172,0,0,33,33,05
Oklahoma,U.S. House,Clark Jolley,REP,550172,0,0,21,21,05
Oklahoma,State Senate,Ervin Yen,REP,550172,0,0,44,44,40
Oklahoma,State Senate,Joe Howell,REP,550172,0,0,10,10,40
Oklahoma,State Senate,Michael Taylor,REP,550172,0,0,26,26,40
Oklahoma,State Senate,Brian Winslow,REP,550172,0,0,34,34,40
Oklahoma,State Senate,Steve Kern,REP,550172,0,0,74,74,40
Oklahoma,State Senate,David Hooten,REP,550172,0,0,21,21,40
Oklahoma,Superintendent of Public Instruction,John Cox,DEM,550173,0,0,35,35,
Oklahoma,Superintendent of Public Instruction,Jack Jr.,DEM,550173,0,0,4,4,
Oklahoma,Superintendent of Public Instruction,Ivan Holmes,DEM,550173,0,0,5,5,
Oklahoma,Superintendent of Public Instruction,Freda Deskin,DEM,550173,0,0,64,64,
Oklahoma,U.S. Senate,Patrick Michael Hayes,DEM,550173,0,0,18,18,
Oklahoma,U.S. Senate,Jim Rogers,DEM,550173,0,0,21,21,
Oklahoma,U.S. Senate,Connie Johnson,DEM,550173,0,0,69,69,
Oklahoma,U.S. House,Tom Guild,DEM,550173,0,0,32,32,05
Oklahoma,U.S. House,Al Mcaffrey,DEM,550173,0,0,47,47,05
Oklahoma,U.S. House,Leona Leonard,DEM,550173,0,0,29,29,05
Oklahoma,Governor,Dax Ewbank,REP,550173,0,0,28,28,
Oklahoma,Governor,Chad Moody,REP,550173,0,0,39,39,
Oklahoma,Governor,Mary Fallin,REP,550173,0,0,273,273,
Oklahoma,Superintendent of Public Instruction,Brian Kelly,REP,550173,0,0,72,72,
Oklahoma,Superintendent of Public Instruction,Janet Costello Barresi,REP,550173,0,0,142,142,
Oklahoma,Superintendent of Public Instruction,Joy Hofmeister,REP,550173,0,0,114,114,
Oklahoma,Insurance Commissioner,Bill Viner,REP,550173,0,0,59,59,
Oklahoma,Insurance Commissioner,John Doak,REP,550173,0,0,243,243,
Oklahoma,Corporation Commissioner,Todd Hiett,REP,550173,0,0,148,148,
Oklahoma,Corporation Commissioner,Cliff Branan,REP,550173,0,0,163,163,
Oklahoma,U.S. Senate,Evelyn Rogers,REP,550173,0,0,13,13,
Oklahoma,U.S. Senate,Rob Moye,REP,550173,0,0,10,10,
Oklahoma,U.S. Senate,D. Jean Mcbride-Samuels,REP,550173,0,0,5,5,
Oklahoma,U.S. Senate,Jim Inhofe,REP,550173,0,0,298,298,
Oklahoma,U.S. Senate,Erick Paul Wyatt,REP,550173,0,0,11,11,
Oklahoma,U.S. Senate,Andy Craig,REP,550173,0,0,1,1,
Oklahoma,U.S. Senate,T. Shannon,REP,550173,0,0,50,50,
Oklahoma,U.S. Senate,Randy Brogdon,REP,550173,0,0,14,14,
Oklahoma,U.S. Senate,Eric Mccray,REP,550173,0,0,1,1,
Oklahoma,U.S. Senate,Kevin Crow,REP,550173,0,0,0,0,
Oklahoma,U.S. Senate,James Lankford,REP,550173,0,0,280,280,
Oklahoma,U.S. Senate,Jason Weger,REP,550173,0,0,0,0,
Oklahoma,U.S. House,Shane David Jett,REP,550173,0,0,36,36,05
Oklahoma,U.S. House,Patrice Douglas,REP,550173,0,0,77,77,05
Oklahoma,U.S. House,Mike Turner,REP,550173,0,0,49,49,05
Oklahoma,U.S. House,Steve Russell,REP,550173,0,0,97,97,05
Oklahoma,U.S. House,Harvey Sparks,REP,550173,0,0,30,30,05
Oklahoma,U.S. House,Clark Jolley,REP,550173,0,0,33,33,05
Oklahoma,State Senate,Ervin Yen,REP,550173,0,0,77,77,40
Oklahoma,State Senate,Joe Howell,REP,550173,0,0,38,38,40
Oklahoma,State Senate,Michael Taylor,REP,550173,0,0,19,19,40
Oklahoma,State Senate,Brian Winslow,REP,550173,0,0,55,55,40
Oklahoma,State Senate,Steve Kern,REP,550173,0,0,116,116,40
Oklahoma,State Senate,David Hooten,REP,550173,0,0,30,30,40
Oklahoma,Superintendent of Public Instruction,John Cox,DEM,550174,0,0,17,17,
Oklahoma,Superintendent of Public Instruction,Jack Jr.,DEM,550174,0,0,4,4,
Oklahoma,Superintendent of Public Instruction,Ivan Holmes,DEM,550174,0,0,3,3,
Oklahoma,Superintendent of Public Instruction,Freda Deskin,DEM,550174,0,0,33,33,
Oklahoma,U.S. Senate,Patrick Michael Hayes,DEM,550174,0,0,4,4,
Oklahoma,U.S. Senate,Jim Rogers,DEM,550174,0,0,21,21,
Oklahoma,U.S. Senate,Connie Johnson,DEM,550174,0,0,30,30,
Oklahoma,U.S. House,Tom Guild,DEM,550174,0,0,27,27,05
Oklahoma,U.S. House,Al Mcaffrey,DEM,550174,0,0,23,23,05
Oklahoma,U.S. House,Leona Leonard,DEM,550174,0,0,7,7,05
Oklahoma,Governor,Dax Ewbank,REP,550174,0,0,11,11,
Oklahoma,Governor,Chad Moody,REP,550174,0,0,16,16,
Oklahoma,Governor,Mary Fallin,REP,550174,0,0,143,143,
Oklahoma,Superintendent of Public Instruction,Brian Kelly,REP,550174,0,0,43,43,
Oklahoma,Superintendent of Public Instruction,Janet Costello Barresi,REP,550174,0,0,66,66,
Oklahoma,Superintendent of Public Instruction,Joy Hofmeister,REP,550174,0,0,64,64,
Oklahoma,Insurance Commissioner,Bill Viner,REP,550174,0,0,28,28,
Oklahoma,Insurance Commissioner,John Doak,REP,550174,0,0,135,135,
Oklahoma,Corporation Commissioner,Todd Hiett,REP,550174,0,0,69,69,
Oklahoma,Corporation Commissioner,Cliff Branan,REP,550174,0,0,84,84,
Oklahoma,U.S. Senate,Evelyn Rogers,REP,550174,0,0,7,7,
Oklahoma,U.S. Senate,Rob Moye,REP,550174,0,0,2,2,
Oklahoma,U.S. Senate,D. Jean Mcbride-Samuels,REP,550174,0,0,4,4,
Oklahoma,U.S. Senate,Jim Inhofe,REP,550174,0,0,157,157,
Oklahoma,U.S. Senate,Erick Paul Wyatt,REP,550174,0,0,2,2,
Oklahoma,U.S. Senate,Andy Craig,REP,550174,0,0,0,0,
Oklahoma,U.S. Senate,T. Shannon,REP,550174,0,0,28,28,
Oklahoma,U.S. Senate,Randy Brogdon,REP,550174,0,0,5,5,
Oklahoma,U.S. Senate,Eric Mccray,REP,550174,0,0,1,1,
Oklahoma,U.S. Senate,Kevin Crow,REP,550174,0,0,0,0,
Oklahoma,U.S. Senate,James Lankford,REP,550174,0,0,140,140,
Oklahoma,U.S. Senate,Jason Weger,REP,550174,0,0,0,0,
Oklahoma,U.S. House,Shane David Jett,REP,550174,0,0,16,16,05
Oklahoma,U.S. House,Patrice Douglas,REP,550174,0,0,47,47,05
Oklahoma,U.S. House,Mike Turner,REP,550174,0,0,16,16,05
Oklahoma,U.S. House,Steve Russell,REP,550174,0,0,54,54,05
Oklahoma,U.S. House,Harvey Sparks,REP,550174,0,0,12,12,05
Oklahoma,U.S. House,Clark Jolley,REP,550174,0,0,15,15,05
Oklahoma,State Senate,Ervin Yen,REP,550174,0,0,49,49,40
Oklahoma,State Senate,Joe Howell,REP,550174,0,0,6,6,40
Oklahoma,State Senate,Michael Taylor,REP,550174,0,0,18,18,40
Oklahoma,State Senate,Brian Winslow,REP,550174,0,0,28,28,40
Oklahoma,State Senate,Steve Kern,REP,550174,0,0,50,50,40
Oklahoma,State Senate,David Hooten,REP,550174,0,0,14,14,40
Oklahoma,Superintendent of Public Instruction,John Cox,DEM,550175,0,0,9,9,
Oklahoma,Superintendent of Public Instruction,Jack Jr.,DEM,550175,0,0,2,2,
Oklahoma,Superintendent of Public Instruction,Ivan Holmes,DEM,550175,0,0,4,4,
Oklahoma,Superintendent of Public Instruction,Freda Deskin,DEM,550175,0,0,17,17,
Oklahoma,U.S. Senate,Patrick Michael Hayes,DEM,550175,0,0,3,3,
Oklahoma,U.S. Senate,Jim Rogers,DEM,550175,0,0,12,12,
Oklahoma,U.S. Senate,Connie Johnson,DEM,550175,0,0,14,14,
Oklahoma,U.S. House,Tom Guild,DEM,550175,0,0,12,12,05
Oklahoma,U.S. House,Al Mcaffrey,DEM,550175,0,0,7,7,05
Oklahoma,U.S. House,Leona Leonard,DEM,550175,0,0,8,8,05
Oklahoma,Governor,Dax Ewbank,REP,550175,0,0,11,11,
Oklahoma,Governor,Chad Moody,REP,550175,0,0,18,18,
Oklahoma,Governor,Mary Fallin,REP,550175,0,0,47,47,
Oklahoma,Superintendent of Public Instruction,Brian Kelly,REP,550175,0,0,24,24,
Oklahoma,Superintendent of Public Instruction,Janet Costello Barresi,REP,550175,0,0,9,9,
Oklahoma,Superintendent of Public Instruction,Joy Hofmeister,REP,550175,0,0,41,41,
Oklahoma,Insurance Commissioner,Bill Viner,REP,550175,0,0,22,22,
Oklahoma,Insurance Commissioner,John Doak,REP,550175,0,0,47,47,
Oklahoma,Corporation Commissioner,Todd Hiett,REP,550175,0,0,28,28,
Oklahoma,Corporation Commissioner,Cliff Branan,REP,550175,0,0,42,42,
Oklahoma,U.S. Senate,Evelyn Rogers,REP,550175,0,0,5,5,
Oklahoma,U.S. Senate,Rob Moye,REP,550175,0,0,2,2,
Oklahoma,U.S. Senate,D. Jean Mcbride-Samuels,REP,550175,0,0,2,2,
Oklahoma,U.S. Senate,Jim Inhofe,REP,550175,0,0,59,59,
Oklahoma,U.S. Senate,Erick Paul Wyatt,REP,550175,0,0,5,5,
Oklahoma,U.S. Senate,Andy Craig,REP,550175,0,0,0,0,
Oklahoma,U.S. Senate,T. Shannon,REP,550175,0,0,16,16,
Oklahoma,U.S. Senate,Randy Brogdon,REP,550175,0,0,7,7,
Oklahoma,U.S. Senate,Eric Mccray,REP,550175,0,0,0,0,
Oklahoma,U.S. Senate,Kevin Crow,REP,550175,0,0,3,3,
Oklahoma,U.S. Senate,James Lankford,REP,550175,0,0,46,46,
Oklahoma,U.S. Senate,Jason Weger,REP,550175,0,0,2,2,
Oklahoma,U.S. House,Shane David Jett,REP,550175,0,0,4,4,05
Oklahoma,U.S. House,Patrice Douglas,REP,550175,0,0,23,23,05
Oklahoma,U.S. House,Mike Turner,REP,550175,0,0,9,9,05
Oklahoma,U.S. House,Steve Russell,REP,550175,0,0,19,19,05
Oklahoma,U.S. House,Harvey Sparks,REP,550175,0,0,7,7,05
Oklahoma,U.S. House,Clark Jolley,REP,550175,0,0,9,9,05
Oklahoma,State Senate,Ervin Yen,REP,550175,0,0,17,17,40
Oklahoma,State Senate,Joe Howell,REP,550175,0,0,3,3,40
Oklahoma,State Senate,Michael Taylor,REP,550175,0,0,4,4,40
Oklahoma,State Senate,Brian Winslow,REP,550175,0,0,16,16,40
Oklahoma,State Senate,Steve Kern,REP,550175,0,0,22,22,40
Oklahoma,State Senate,David Hooten,REP,550175,0,0,11,11,40
Oklahoma,Superintendent of Public Instruction,John Cox,DEM,550176,0,0,37,37,
Oklahoma,Superintendent of Public Instruction,Jack Jr.,DEM,550176,0,0,11,11,
Oklahoma,Superintendent of Public Instruction,Ivan Holmes,DEM,550176,0,0,4,4,
Oklahoma,Superintendent of Public Instruction,Freda Deskin,DEM,550176,0,0,43,43,
Oklahoma,U.S. Senate,Patrick Michael Hayes,DEM,550176,0,0,11,11,
Oklahoma,U.S. Senate,Jim Rogers,DEM,550176,0,0,18,18,
Oklahoma,U.S. Senate,Connie Johnson,DEM,550176,0,0,64,64,
Oklahoma,U.S. House,Tom Guild,DEM,550176,0,0,42,42,05
Oklahoma,U.S. House,Al Mcaffrey,DEM,550176,0,0,34,34,05
Oklahoma,U.S. House,Leona Leonard,DEM,550176,0,0,20,20,05
Oklahoma,Governor,Dax Ewbank,REP,550176,0,0,21,21,
Oklahoma,Governor,Chad Moody,REP,550176,0,0,32,32,
Oklahoma,Governor,Mary Fallin,REP,550176,0,0,205,205,
Oklahoma,Superintendent of Public Instruction,Brian Kelly,REP,550176,0,0,57,57,
Oklahoma,Superintendent of Public Instruction,Janet Costello Barresi,REP,550176,0,0,77,77,
Oklahoma,Superintendent of Public Instruction,Joy Hofmeister,REP,550176,0,0,127,127,
Oklahoma,Insurance Commissioner,Bill Viner,REP,550176,0,0,42,42,
Oklahoma,Insurance Commissioner,John Doak,REP,550176,0,0,203,203,
Oklahoma,Corporation Commissioner,Todd Hiett,REP,550176,0,0,87,87,
Oklahoma,Corporation Commissioner,Cliff Branan,REP,550176,0,0,159,159,
Oklahoma,U.S. Senate,Evelyn Rogers,REP,550176,0,0,15,15,
Oklahoma,U.S. Senate,Rob Moye,REP,550176,0,0,5,5,
Oklahoma,U.S. Senate,D. Jean Mcbride-Samuels,REP,550176,0,0,6,6,
Oklahoma,U.S. Senate,Jim Inhofe,REP,550176,0,0,223,223,
Oklahoma,U.S. Senate,Erick Paul Wyatt,REP,550176,0,0,7,7,
Oklahoma,U.S. Senate,Andy Craig,REP,550176,0,0,1,1,
Oklahoma,U.S. Senate,T. Shannon,REP,550176,0,0,60,60,
Oklahoma,U.S. Senate,Randy Brogdon,REP,550176,0,0,13,13,
Oklahoma,U.S. Senate,Eric Mccray,REP,550176,0,0,2,2,
Oklahoma,U.S. Senate,Kevin Crow,REP,550176,0,0,1,1,
Oklahoma,U.S. Senate,James Lankford,REP,550176,0,0,187,187,
Oklahoma,U.S. Senate,Jason Weger,REP,550176,0,0,2,2,
Oklahoma,U.S. House,Shane David Jett,REP,550176,0,0,32,32,05
Oklahoma,U.S. House,Patrice Douglas,REP,550176,0,0,70,70,05
Oklahoma,U.S. House,Mike Turner,REP,550176,0,0,31,31,05
Oklahoma,U.S. House,Steve Russell,REP,550176,0,0,68,68,05
Oklahoma,U.S. House,Harvey Sparks,REP,550176,0,0,24,24,05
Oklahoma,U.S. House,Clark Jolley,REP,550176,0,0,25,25,05
Oklahoma,State Senate,Ervin Yen,REP,550176,0,0,102,102,40
Oklahoma,State Senate,Joe Howell,REP,550176,0,0,9,9,40
Oklahoma,State Senate,Michael Taylor,REP,550176,0,0,20,20,40
Oklahoma,State Senate,Brian Winslow,REP,550176,0,0,30,30,40
Oklahoma,State Senate,Steve Kern,REP,550176,0,0,59,59,40
Oklahoma,State Senate,David Hooten,REP,550176,0,0,34,34,40
Oklahoma,Superintendent of Public Instruction,John Cox,DEM,550177,0,0,21,21,
Oklahoma,Superintendent of Public Instruction,Jack Jr.,DEM,550177,0,0,7,7,
Oklahoma,Superintendent of Public Instruction,Ivan Holmes,DEM,550177,0,0,8,8,
Oklahoma,Superintendent of Public Instruction,Freda Deskin,DEM,550177,0,0,54,54,
Oklahoma,U.S. Senate,Patrick Michael Hayes,DEM,550177,0,0,16,16,
Oklahoma,U.S. Senate,Jim Rogers,DEM,550177,0,0,17,17,
Oklahoma,U.S. Senate,Connie Johnson,DEM,550177,0,0,57,57,
Oklahoma,U.S. House,Tom Guild,DEM,550177,0,0,35,35,05
Oklahoma,U.S. House,Al Mcaffrey,DEM,550177,0,0,32,32,05
Oklahoma,U.S. House,Leona Leonard,DEM,550177,0,0,24,24,05
Oklahoma,Governor,Dax Ewbank,REP,550177,0,0,12,12,
Oklahoma,Governor,Chad Moody,REP,550177,0,0,31,31,
Oklahoma,Governor,Mary Fallin,REP,550177,0,0,228,228,
Oklahoma,Superintendent of Public Instruction,Brian Kelly,REP,550177,0,0,57,57,
Oklahoma,Superintendent of Public Instruction,Janet Costello Barresi,REP,550177,0,0,102,102,
Oklahoma,Superintendent of Public Instruction,Joy Hofmeister,REP,550177,0,0,108,108,
Oklahoma,Insurance Commissioner,Bill Viner,REP,550177,0,0,40,40,
Oklahoma,Insurance Commissioner,John Doak,REP,550177,0,0,202,202,
Oklahoma,Corporation Commissioner,Todd Hiett,REP,550177,0,0,102,102,
Oklahoma,Corporation Commissioner,Cliff Branan,REP,550177,0,0,149,149,
Oklahoma,U.S. Senate,Evelyn Rogers,REP,550177,0,0,3,3,
Oklahoma,U.S. Senate,Rob Moye,REP,550177,0,0,2,2,
Oklahoma,U.S. Senate,D. Jean Mcbride-Samuels,REP,550177,0,0,3,3,
Oklahoma,U.S. Senate,Jim Inhofe,REP,550177,0,0,252,252,
Oklahoma,U.S. Senate,Erick Paul Wyatt,REP,550177,0,0,7,7,
Oklahoma,U.S. Senate,Andy Craig,REP,550177,0,0,0,0,
Oklahoma,U.S. Senate,T. Shannon,REP,550177,0,0,55,55,
Oklahoma,U.S. Senate,Randy Brogdon,REP,550177,0,0,6,6,
Oklahoma,U.S. Senate,Eric Mccray,REP,550177,0,0,2,2,
Oklahoma,U.S. Senate,Kevin Crow,REP,550177,0,0,1,1,
Oklahoma,U.S. Senate,James Lankford,REP,550177,0,0,209,209,
Oklahoma,U.S. Senate,Jason Weger,REP,550177,0,0,2,2,
Oklahoma,U.S. House,Shane David Jett,REP,550177,0,0,19,19,05
Oklahoma,U.S. House,Patrice Douglas,REP,550177,0,0,45,45,05
Oklahoma,U.S. House,Mike Turner,REP,550177,0,0,59,59,05
Oklahoma,U.S. House,Steve Russell,REP,550177,0,0,76,76,05
Oklahoma,U.S. House,Harvey Sparks,REP,550177,0,0,29,29,05
Oklahoma,U.S. House,Clark Jolley,REP,550177,0,0,29,29,05
Oklahoma,State Senate,Ervin Yen,REP,550177,0,0,67,67,40
Oklahoma,State Senate,Joe Howell,REP,550177,0,0,15,15,40
Oklahoma,State Senate,Michael Taylor,REP,550177,0,0,35,35,40
Oklahoma,State Senate,Brian Winslow,REP,550177,0,0,25,25,40
Oklahoma,State Senate,Steve Kern,REP,550177,0,0,86,86,40
Oklahoma,State Senate,David Hooten,REP,550177,0,0,34,34,40
Oklahoma,Superintendent of Public Instruction,John Cox,DEM,550178,0,0,20,20,
Oklahoma,Superintendent of Public Instruction,Jack Jr.,DEM,550178,0,0,5,5,
Oklahoma,Superintendent of Public Instruction,Ivan Holmes,DEM,550178,0,0,5,5,
Oklahoma,Superintendent of Public Instruction,Freda Deskin,DEM,550178,0,0,38,38,
Oklahoma,U.S. Senate,Patrick Michael Hayes,DEM,550178,0,0,7,7,
Oklahoma,U.S. Senate,Jim Rogers,DEM,550178,0,0,15,15,
Oklahoma,U.S. Senate,Connie Johnson,DEM,550178,0,0,48,48,
Oklahoma,U.S. House,Tom Guild,DEM,550178,0,0,28,28,05
Oklahoma,U.S. House,Al Mcaffrey,DEM,550178,0,0,26,26,05
Oklahoma,U.S. House,Leona Leonard,DEM,550178,0,0,16,16,05
Oklahoma,Governor,Dax Ewbank,REP,550178,0,0,15,15,
Oklahoma,Governor,Chad Moody,REP,550178,0,0,27,27,
Oklahoma,Governor,Mary Fallin,REP,550178,0,0,134,134,
Oklahoma,Superintendent of Public Instruction,Brian Kelly,REP,550178,0,0,51,51,
Oklahoma,Superintendent of Public Instruction,Janet Costello Barresi,REP,550178,0,0,46,46,
Oklahoma,Superintendent of Public Instruction,Joy Hofmeister,REP,550178,0,0,75,75,
Oklahoma,Insurance Commissioner,Bill Viner,REP,550178,0,0,39,39,
Oklahoma,Insurance Commissioner,John Doak,REP,550178,0,0,122,122,
Oklahoma,Corporation Commissioner,Todd Hiett,REP,550178,0,0,68,68,
Oklahoma,Corporation Commissioner,Cliff Branan,REP,550178,0,0,93,93,
Oklahoma,U.S. Senate,Evelyn Rogers,REP,550178,0,0,11,11,
Oklahoma,U.S. Senate,Rob Moye,REP,550178,0,0,3,3,
Oklahoma,U.S. Senate,D. Jean Mcbride-Samuels,REP,550178,0,0,3,3,
Oklahoma,U.S. Senate,Jim Inhofe,REP,550178,0,0,151,151,
Oklahoma,U.S. Senate,Erick Paul Wyatt,REP,550178,0,0,5,5,
Oklahoma,U.S. Senate,Andy Craig,REP,550178,0,0,3,3,
Oklahoma,U.S. Senate,T. Shannon,REP,550178,0,0,33,33,
Oklahoma,U.S. Senate,Randy Brogdon,REP,550178,0,0,4,4,
Oklahoma,U.S. Senate,Eric Mccray,REP,550178,0,0,1,1,
Oklahoma,U.S. Senate,Kevin Crow,REP,550178,0,0,3,3,
Oklahoma,U.S. Senate,James Lankford,REP,550178,0,0,133,133,
Oklahoma,U.S. Senate,Jason Weger,REP,550178,0,0,4,4,
Oklahoma,U.S. House,Shane David Jett,REP,550178,0,0,19,19,05
Oklahoma,U.S. House,Patrice Douglas,REP,550178,0,0,38,38,05
Oklahoma,U.S. House,Mike Turner,REP,550178,0,0,28,28,05
Oklahoma,U.S. House,Steve Russell,REP,550178,0,0,29,29,05
Oklahoma,U.S. House,Harvey Sparks,REP,550178,0,0,27,27,05
Oklahoma,U.S. House,Clark Jolley,REP,550178,0,0,25,25,05
Oklahoma,State Senate,Ervin Yen,REP,550178,0,0,45,45,40
Oklahoma,State Senate,Joe Howell,REP,550178,0,0,14,14,40
Oklahoma,State Senate,Michael Taylor,REP,550178,0,0,22,22,40
Oklahoma,State Senate,Brian Winslow,REP,550178,0,0,23,23,40
Oklahoma,State Senate,Steve Kern,REP,550178,0,0,47,47,40
Oklahoma,State Senate,David Hooten,REP,550178,0,0,21,21,40
Oklahoma,Superintendent of Public Instruction,John Cox,DEM,550179,0,0,43,43,
Oklahoma,Superintendent of Public Instruction,Jack Jr.,DEM,550179,0,0,5,5,
Oklahoma,Superintendent of Public Instruction,Ivan Holmes,DEM,550179,0,0,11,11,
Oklahoma,Superintendent of Public Instruction,Freda Deskin,DEM,550179,0,0,69,69,
Oklahoma,U.S. Senate,Patrick Michael Hayes,DEM,550179,0,0,19,19,
Oklahoma,U.S. Senate,Jim Rogers,DEM,550179,0,0,20,20,
Oklahoma,U.S. Senate,Connie Johnson,DEM,550179,0,0,88,88,
Oklahoma,U.S. House,Tom Guild,DEM,550179,0,0,50,50,05
Oklahoma,U.S. House,Al Mcaffrey,DEM,550179,0,0,55,55,05
Oklahoma,U.S. House,Leona Leonard,DEM,550179,0,0,17,17,05
Oklahoma,Governor,Dax Ewbank,REP,550179,0,0,24,24,
Oklahoma,Governor,Chad Moody,REP,550179,0,0,51,51,
Oklahoma,Governor,Mary Fallin,REP,550179,0,0,220,220,
Oklahoma,Superintendent of Public Instruction,Brian Kelly,REP,550179,0,0,55,55,
Oklahoma,Superintendent of Public Instruction,Janet Costello Barresi,REP,550179,0,0,121,121,
Oklahoma,Superintendent of Public Instruction,Joy Hofmeister,REP,550179,0,0,117,117,
Oklahoma,Insurance Commissioner,Bill Viner,REP,550179,0,0,56,56,
Oklahoma,Insurance Commissioner,John Doak,REP,550179,0,0,215,215,
Oklahoma,Corporation Commissioner,Todd Hiett,REP,550179,0,0,97,97,
Oklahoma,Corporation Commissioner,Cliff Branan,REP,550179,0,0,170,170,
Oklahoma,U.S. Senate,Evelyn Rogers,REP,550179,0,0,14,14,
Oklahoma,U.S. Senate,Rob Moye,REP,550179,0,0,5,5,
Oklahoma,U.S. Senate,D. Jean Mcbride-Samuels,REP,550179,0,0,5,5,
Oklahoma,U.S. Senate,Jim Inhofe,REP,550179,0,0,259,259,
Oklahoma,U.S. Senate,Erick Paul Wyatt,REP,550179,0,0,8,8,
Oklahoma,U.S. Senate,Andy Craig,REP,550179,0,0,2,2,
Oklahoma,U.S. Senate,T. Shannon,REP,550179,0,0,53,53,
Oklahoma,U.S. Senate,Randy Brogdon,REP,550179,0,0,10,10,
Oklahoma,U.S. Senate,Eric Mccray,REP,550179,0,0,0,0,
Oklahoma,U.S. Senate,Kevin Crow,REP,550179,0,0,1,1,
Oklahoma,U.S. Senate,James Lankford,REP,550179,0,0,228,228,
Oklahoma,U.S. Senate,Jason Weger,REP,550179,0,0,3,3,
Oklahoma,U.S. House,Shane David Jett,REP,550179,0,0,21,21,05
Oklahoma,U.S. House,Patrice Douglas,REP,550179,0,0,84,84,05
Oklahoma,U.S. House,Mike Turner,REP,550179,0,0,37,37,05
Oklahoma,U.S. House,Steve Russell,REP,550179,0,0,72,72,05
Oklahoma,U.S. House,Harvey Sparks,REP,550179,0,0,13,13,05
Oklahoma,U.S. House,Clark Jolley,REP,550179,0,0,51,51,05
Oklahoma,State Senate,Ervin Yen,REP,550179,0,0,136,136,40
Oklahoma,State Senate,Joe Howell,REP,550179,0,0,17,17,40
Oklahoma,State Senate,Michael Taylor,REP,550179,0,0,20,20,40
Oklahoma,State Senate,Brian Winslow,REP,550179,0,0,35,35,40
Oklahoma,State Senate,Steve Kern,REP,550179,0,0,35,35,40
Oklahoma,State Senate,David Hooten,REP,550179,0,0,40,40,40
Oklahoma,Superintendent of Public Instruction,John Cox,DEM,550180,0,0,20,20,
Oklahoma,Superintendent of Public Instruction,Jack Jr.,DEM,550180,0,0,9,9,
Oklahoma,Superintendent of Public Instruction,Ivan Holmes,DEM,550180,0,0,4,4,
Oklahoma,Superintendent of Public Instruction,Freda Deskin,DEM,550180,0,0,33,33,
Oklahoma,U.S. Senate,Patrick Michael Hayes,DEM,550180,0,0,14,14,
Oklahoma,U.S. Senate,Jim Rogers,DEM,550180,0,0,12,12,
Oklahoma,U.S. Senate,Connie Johnson,DEM,550180,0,0,37,37,
Oklahoma,U.S. House,Tom Guild,DEM,550180,0,0,32,32,05
Oklahoma,U.S. House,Al Mcaffrey,DEM,550180,0,0,19,19,05
Oklahoma,U.S. House,Leona Leonard,DEM,550180,0,0,12,12,05
Oklahoma,Governor,Dax Ewbank,REP,550180,0,0,9,9,
Oklahoma,Governor,Chad Moody,REP,550180,0,0,27,27,
Oklahoma,Governor,Mary Fallin,REP,550180,0,0,130,130,
Oklahoma,Superintendent of Public Instruction,Brian Kelly,REP,550180,0,0,45,45,
Oklahoma,Superintendent of Public Instruction,Janet Costello Barresi,REP,550180,0,0,48,48,
Oklahoma,Superintendent of Public Instruction,Joy Hofmeister,REP,550180,0,0,71,71,
Oklahoma,Insurance Commissioner,Bill Viner,REP,550180,0,0,26,26,
Oklahoma,Insurance Commissioner,John Doak,REP,550180,0,0,135,135,
Oklahoma,Corporation Commissioner,Todd Hiett,REP,550180,0,0,59,59,
Oklahoma,Corporation Commissioner,Cliff Branan,REP,550180,0,0,93,93,
Oklahoma,U.S. Senate,Evelyn Rogers,REP,550180,0,0,7,7,
Oklahoma,U.S. Senate,Rob Moye,REP,550180,0,0,2,2,
Oklahoma,U.S. Senate,D. Jean Mcbride-Samuels,REP,550180,0,0,3,3,
Oklahoma,U.S. Senate,Jim Inhofe,REP,550180,0,0,150,150,
Oklahoma,U.S. Senate,Erick Paul Wyatt,REP,550180,0,0,4,4,
Oklahoma,U.S. Senate,Andy Craig,REP,550180,0,0,2,2,
Oklahoma,U.S. Senate,T. Shannon,REP,550180,0,0,38,38,
Oklahoma,U.S. Senate,Randy Brogdon,REP,550180,0,0,6,6,
Oklahoma,U.S. Senate,Eric Mccray,REP,550180,0,0,2,2,
Oklahoma,U.S. Senate,Kevin Crow,REP,550180,0,0,1,1,
Oklahoma,U.S. Senate,James Lankford,REP,550180,0,0,116,116,
Oklahoma,U.S. Senate,Jason Weger,REP,550180,0,0,1,1,
Oklahoma,U.S. House,Shane David Jett,REP,550180,0,0,20,20,05
Oklahoma,U.S. House,Patrice Douglas,REP,550180,0,0,45,45,05
Oklahoma,U.S. House,Mike Turner,REP,550180,0,0,21,21,05
Oklahoma,U.S. House,Steve Russell,REP,550180,0,0,41,41,05
Oklahoma,U.S. House,Harvey Sparks,REP,550180,0,0,7,7,05
Oklahoma,U.S. House,Clark Jolley,REP,550180,0,0,31,31,05
Oklahoma,State Senate,Ervin Yen,REP,550180,0,0,73,73,40
Oklahoma,State Senate,Joe Howell,REP,550180,0,0,4,4,40
Oklahoma,State Senate,Michael Taylor,REP,550180,0,0,5,5,40
Oklahoma,State Senate,Brian Winslow,REP,550180,0,0,21,21,40
Oklahoma,State Senate,Steve Kern,REP,550180,0,0,31,31,40
Oklahoma,State Senate,David Hooten,REP,550180,0,0,27,27,40
Oklahoma,Superintendent of Public Instruction,John Cox,DEM,550181,0,0,11,11,
Oklahoma,Superintendent of Public Instruction,Jack Jr.,DEM,550181,0,0,6,6,
Oklahoma,Superintendent of Public Instruction,Ivan Holmes,DEM,550181,0,0,4,4,
Oklahoma,Superintendent of Public Instruction,Freda Deskin,DEM,550181,0,0,33,33,
Oklahoma,U.S. Senate,Patrick Michael Hayes,DEM,550181,0,0,12,12,
Oklahoma,U.S. Senate,Jim Rogers,DEM,550181,0,0,6,6,
Oklahoma,U.S. Senate,Connie Johnson,DEM,550181,0,0,36,36,
Oklahoma,U.S. House,Tom Guild,DEM,550181,0,0,14,14,05
Oklahoma,U.S. House,Al Mcaffrey,DEM,550181,0,0,28,28,05
Oklahoma,U.S. House,Leona Leonard,DEM,550181,0,0,12,12,05
Oklahoma,Governor,Dax Ewbank,REP,550181,0,0,12,12,
Oklahoma,Governor,Chad Moody,REP,550181,0,0,24,24,
Oklahoma,Governor,Mary Fallin,REP,550181,0,0,83,83,
Oklahoma,Superintendent of Public Instruction,Brian Kelly,REP,550181,0,0,25,25,
Oklahoma,Superintendent of Public Instruction,Janet Costello Barresi,REP,550181,0,0,38,38,
Oklahoma,Superintendent of Public Instruction,Joy Hofmeister,REP,550181,0,0,53,53,
Oklahoma,Insurance Commissioner,Bill Viner,REP,550181,0,0,26,26,
Oklahoma,Insurance Commissioner,John Doak,REP,550181,0,0,85,85,
Oklahoma,Corporation Commissioner,Todd Hiett,REP,550181,0,0,40,40,
Oklahoma,Corporation Commissioner,Cliff Branan,REP,550181,0,0,68,68,
Oklahoma,U.S. Senate,Evelyn Rogers,REP,550181,0,0,12,12,
Oklahoma,U.S. Senate,Rob Moye,REP,550181,0,0,3,3,
Oklahoma,U.S. Senate,D. Jean Mcbride-Samuels,REP,550181,0,0,2,2,
Oklahoma,U.S. Senate,Jim Inhofe,REP,550181,0,0,96,96,
Oklahoma,U.S. Senate,Erick Paul Wyatt,REP,550181,0,0,4,4,
Oklahoma,U.S. Senate,Andy Craig,REP,550181,0,0,1,1,
Oklahoma,U.S. Senate,T. Shannon,REP,550181,0,0,31,31,
Oklahoma,U.S. Senate,Randy Brogdon,REP,550181,0,0,3,3,
Oklahoma,U.S. Senate,Eric Mccray,REP,550181,0,0,1,1,
Oklahoma,U.S. Senate,Kevin Crow,REP,550181,0,0,2,2,
Oklahoma,U.S. Senate,James Lankford,REP,550181,0,0,79,79,
Oklahoma,U.S. Senate,Jason Weger,REP,550181,0,0,3,3,
Oklahoma,U.S. House,Shane David Jett,REP,550181,0,0,11,11,05
Oklahoma,U.S. House,Patrice Douglas,REP,550181,0,0,35,35,05
Oklahoma,U.S. House,Mike Turner,REP,550181,0,0,18,18,05
Oklahoma,U.S. House,Steve Russell,REP,550181,0,0,26,26,05
Oklahoma,U.S. House,Harvey Sparks,REP,550181,0,0,9,9,05
Oklahoma,U.S. House,Clark Jolley,REP,550181,0,0,13,13,05
Oklahoma,State Senate,Ervin Yen,REP,550181,0,0,56,56,40
Oklahoma,State Senate,Joe Howell,REP,550181,0,0,8,8,40
Oklahoma,State Senate,Michael Taylor,REP,550181,0,0,9,9,40
Oklahoma,State Senate,Brian Winslow,REP,550181,0,0,11,11,40
Oklahoma,State Senate,Steve Kern,REP,550181,0,0,19,19,40
Oklahoma,State Senate,David Hooten,REP,550181,0,0,10,10,40
Oklahoma,Superintendent of Public Instruction,John Cox,DEM,550182,0,0,16,16,
Oklahoma,Superintendent of Public Instruction,Jack Jr.,DEM,550182,0,0,6,6,
Oklahoma,Superintendent of Public Instruction,Ivan Holmes,DEM,550182,0,0,7,7,
Oklahoma,Superintendent of Public Instruction,Freda Deskin,DEM,550182,0,0,29,29,
Oklahoma,U.S. Senate,Patrick Michael Hayes,DEM,550182,0,0,12,12,
Oklahoma,U.S. Senate,Jim Rogers,DEM,550182,0,0,7,7,
Oklahoma,U.S. Senate,Connie Johnson,DEM,550182,0,0,37,37,
Oklahoma,U.S. House,Tom Guild,DEM,550182,0,0,24,24,05
Oklahoma,U.S. House,Al Mcaffrey,DEM,550182,0,0,18,18,05
Oklahoma,U.S. House,Leona Leonard,DEM,550182,0,0,14,14,05
Oklahoma,Governor,Dax Ewbank,REP,550182,0,0,8,8,
Oklahoma,Governor,Chad Moody,REP,550182,0,0,10,10,
Oklahoma,Governor,Mary Fallin,REP,550182,0,0,40,40,
Oklahoma,Superintendent of Public Instruction,Brian Kelly,REP,550182,0,0,16,16,
Oklahoma,Superintendent of Public Instruction,Janet Costello Barresi,REP,550182,0,0,19,19,
Oklahoma,Superintendent of Public Instruction,Joy Hofmeister,REP,550182,0,0,22,22,
Oklahoma,Insurance Commissioner,Bill Viner,REP,550182,0,0,12,12,
Oklahoma,Insurance Commissioner,John Doak,REP,550182,0,0,39,39,
Oklahoma,Corporation Commissioner,Todd Hiett,REP,550182,0,0,17,17,
Oklahoma,Corporation Commissioner,Cliff Branan,REP,550182,0,0,35,35,
Oklahoma,U.S. Senate,Evelyn Rogers,REP,550182,0,0,2,2,
Oklahoma,U.S. Senate,Rob Moye,REP,550182,0,0,0,0,
Oklahoma,U.S. Senate,D. Jean Mcbride-Samuels,REP,550182,0,0,1,1,
Oklahoma,U.S. Senate,Jim Inhofe,REP,550182,0,0,52,52,
Oklahoma,U.S. Senate,Erick Paul Wyatt,REP,550182,0,0,0,0,
Oklahoma,U.S. Senate,Andy Craig,REP,550182,0,0,1,1,
Oklahoma,U.S. Senate,T. Shannon,REP,550182,0,0,14,14,
Oklahoma,U.S. Senate,Randy Brogdon,REP,550182,0,0,1,1,
Oklahoma,U.S. Senate,Eric Mccray,REP,550182,0,0,0,0,
Oklahoma,U.S. Senate,Kevin Crow,REP,550182,0,0,0,0,
Oklahoma,U.S. Senate,James Lankford,REP,550182,0,0,40,40,
Oklahoma,U.S. Senate,Jason Weger,REP,550182,0,0,1,1,
Oklahoma,U.S. House,Shane David Jett,REP,550182,0,0,6,6,05
Oklahoma,U.S. House,Patrice Douglas,REP,550182,0,0,14,14,05
Oklahoma,U.S. House,Mike Turner,REP,550182,0,0,3,3,05
Oklahoma,U.S. House,Steve Russell,REP,550182,0,0,14,14,05
Oklahoma,U.S. House,Harvey Sparks,REP,550182,0,0,10,10,05
Oklahoma,U.S. House,Clark Jolley,REP,550182,0,0,9,9,05
Oklahoma,State Senate,Ervin Yen,REP,550182,0,0,15,15,40
Oklahoma,State Senate,Joe Howell,REP,550182,0,0,5,5,40
Oklahoma,State Senate,Michael Taylor,REP,550182,0,0,8,8,40
Oklahoma,State Senate,Brian Winslow,REP,550182,0,0,4,4,40
Oklahoma,State Senate,Steve Kern,REP,550182,0,0,10,10,40
Oklahoma,State Senate,David Hooten,REP,550182,0,0,12,12,40
Oklahoma,Superintendent of Public Instruction,John Cox,DEM,550183,0,0,39,39,
Oklahoma,Superintendent of Public Instruction,Jack Jr.,DEM,550183,0,0,16,16,
Oklahoma,Superintendent of Public Instruction,Ivan Holmes,DEM,550183,0,0,13,13,
Oklahoma,Superintendent of Public Instruction,Freda Deskin,DEM,550183,0,0,67,67,
Oklahoma,U.S. Senate,Patrick Michael Hayes,DEM,550183,0,0,16,16,
Oklahoma,U.S. Senate,Jim Rogers,DEM,550183,0,0,28,28,
Oklahoma,U.S. Senate,Connie Johnson,DEM,550183,0,0,89,89,
Oklahoma,U.S. House,Tom Guild,DEM,550183,0,0,50,50,05
Oklahoma,U.S. House,Al Mcaffrey,DEM,550183,0,0,60,60,05
Oklahoma,U.S. House,Leona Leonard,DEM,550183,0,0,28,28,05
Oklahoma,Governor,Dax Ewbank,REP,550183,0,0,12,12,
Oklahoma,Governor,Chad Moody,REP,550183,0,0,29,29,
Oklahoma,Governor,Mary Fallin,REP,550183,0,0,163,163,
Oklahoma,Superintendent of Public Instruction,Brian Kelly,REP,550183,0,0,46,46,
Oklahoma,Superintendent of Public Instruction,Janet Costello Barresi,REP,550183,0,0,77,77,
Oklahoma,Superintendent of Public Instruction,Joy Hofmeister,REP,550183,0,0,77,77,
Oklahoma,Insurance Commissioner,Bill Viner,REP,550183,0,0,40,40,
Oklahoma,Insurance Commissioner,John Doak,REP,550183,0,0,149,149,
Oklahoma,Corporation Commissioner,Todd Hiett,REP,550183,0,0,77,77,
Oklahoma,Corporation Commissioner,Cliff Branan,REP,550183,0,0,104,104,
Oklahoma,U.S. Senate,Evelyn Rogers,REP,550183,0,0,12,12,
Oklahoma,U.S. Senate,Rob Moye,REP,550183,0,0,1,1,
Oklahoma,U.S. Senate,D. Jean Mcbride-Samuels,REP,550183,0,0,5,5,
Oklahoma,U.S. Senate,Jim Inhofe,REP,550183,0,0,176,176,
Oklahoma,U.S. Senate,Erick Paul Wyatt,REP,550183,0,0,6,6,
Oklahoma,U.S. Senate,Andy Craig,REP,550183,0,0,0,0,
Oklahoma,U.S. Senate,T. Shannon,REP,550183,0,0,39,39,
Oklahoma,U.S. Senate,Randy Brogdon,REP,550183,0,0,5,5,
Oklahoma,U.S. Senate,Eric Mccray,REP,550183,0,0,4,4,
Oklahoma,U.S. Senate,Kevin Crow,REP,550183,0,0,1,1,
Oklahoma,U.S. Senate,James Lankford,REP,550183,0,0,156,156,
Oklahoma,U.S. Senate,Jason Weger,REP,550183,0,0,1,1,
Oklahoma,U.S. House,Shane David Jett,REP,550183,0,0,16,16,05
Oklahoma,U.S. House,Patrice Douglas,REP,550183,0,0,46,46,05
Oklahoma,U.S. House,Mike Turner,REP,550183,0,0,47,47,05
Oklahoma,U.S. House,Steve Russell,REP,550183,0,0,57,57,05
Oklahoma,U.S. House,Harvey Sparks,REP,550183,0,0,20,20,05
Oklahoma,U.S. House,Clark Jolley,REP,550183,0,0,12,12,05
Oklahoma,State Senate,Ervin Yen,REP,550183,0,0,47,47,40
Oklahoma,State Senate,Joe Howell,REP,550183,0,0,10,10,40
Oklahoma,State Senate,Michael Taylor,REP,550183,0,0,20,20,40
Oklahoma,State Senate,Brian Winslow,REP,550183,0,0,27,27,40
Oklahoma,State Senate,Steve Kern,REP,550183,0,0,66,66,40
Oklahoma,State Senate,David Hooten,REP,550183,0,0,24,24,40
Oklahoma,Superintendent of Public Instruction,John Cox,DEM,550184,0,0,36,36,
Oklahoma,Superintendent of Public Instruction,Jack Jr.,DEM,550184,0,0,30,30,
Oklahoma,Superintendent of Public Instruction,Ivan Holmes,DEM,550184,0,0,8,8,
Oklahoma,Superintendent of Public Instruction,Freda Deskin,DEM,550184,0,0,64,64,
Oklahoma,U.S. Senate,Patrick Michael Hayes,DEM,550184,0,0,31,31,
Oklahoma,U.S. Senate,Jim Rogers,DEM,550184,0,0,22,22,
Oklahoma,U.S. Senate,Connie Johnson,DEM,550184,0,0,84,84,
Oklahoma,U.S. House,Tom Guild,DEM,550184,0,0,62,62,05
Oklahoma,U.S. House,Al Mcaffrey,DEM,550184,0,0,50,50,05
Oklahoma,U.S. House,Leona Leonard,DEM,550184,0,0,27,27,05
Oklahoma,Governor,Dax Ewbank,REP,550184,0,0,22,22,
Oklahoma,Governor,Chad Moody,REP,550184,0,0,35,35,
Oklahoma,Governor,Mary Fallin,REP,550184,0,0,123,123,
Oklahoma,Superintendent of Public Instruction,Brian Kelly,REP,550184,0,0,49,49,
Oklahoma,Superintendent of Public Instruction,Janet Costello Barresi,REP,550184,0,0,66,66,
Oklahoma,Superintendent of Public Instruction,Joy Hofmeister,REP,550184,0,0,64,64,
Oklahoma,Insurance Commissioner,Bill Viner,REP,550184,0,0,55,55,
Oklahoma,Insurance Commissioner,John Doak,REP,550184,0,0,118,118,
Oklahoma,Corporation Commissioner,Todd Hiett,REP,550184,0,0,75,75,
Oklahoma,Corporation Commissioner,Cliff Branan,REP,550184,0,0,96,96,
Oklahoma,U.S. Senate,Evelyn Rogers,REP,550184,0,0,17,17,
Oklahoma,U.S. Senate,Rob Moye,REP,550184,0,0,9,9,
Oklahoma,U.S. Senate,D. Jean Mcbride-Samuels,REP,550184,0,0,4,4,
Oklahoma,U.S. Senate,Jim Inhofe,REP,550184,0,0,139,139,
Oklahoma,U.S. Senate,Erick Paul Wyatt,REP,550184,0,0,10,10,
Oklahoma,U.S. Senate,Andy Craig,REP,550184,0,0,2,2,
Oklahoma,U.S. Senate,T. Shannon,REP,550184,0,0,42,42,
Oklahoma,U.S. Senate,Randy Brogdon,REP,550184,0,0,8,8,
Oklahoma,U.S. Senate,Eric Mccray,REP,550184,0,0,7,7,
Oklahoma,U.S. Senate,Kevin Crow,REP,550184,0,0,5,5,
Oklahoma,U.S. Senate,James Lankford,REP,550184,0,0,116,116,
Oklahoma,U.S. Senate,Jason Weger,REP,550184,0,0,1,1,
Oklahoma,U.S. House,Shane David Jett,REP,550184,0,0,18,18,05
Oklahoma,U.S. House,Patrice Douglas,REP,550184,0,0,34,34,05
Oklahoma,U.S. House,Mike Turner,REP,550184,0,0,34,34,05
Oklahoma,U.S. House,Steve Russell,REP,550184,0,0,45,45,05
Oklahoma,U.S. House,Harvey Sparks,REP,550184,0,0,23,23,05
Oklahoma,U.S. House,Clark Jolley,REP,550184,0,0,24,24,05
Oklahoma,State Senate,Ervin Yen,REP,550184,0,0,46,46,40
Oklahoma,State Senate,Joe Howell,REP,550184,0,0,11,11,40
Oklahoma,State Senate,Michael Taylor,REP,550184,0,0,10,10,40
Oklahoma,State Senate,Brian Winslow,REP,550184,0,0,44,44,40
Oklahoma,State Senate,Steve Kern,REP,550184,0,0,43,43,40
Oklahoma,State Senate,David Hooten,REP,550184,0,0,22,22,40
Oklahoma,Superintendent of Public Instruction,John Cox,DEM,550185,0,0,17,17,
Oklahoma,Superintendent of Public Instruction,Jack Jr.,DEM,550185,0,0,4,4,
Oklahoma,Superintendent of Public Instruction,Ivan Holmes,DEM,550185,0,0,5,5,
Oklahoma,Superintendent of Public Instruction,Freda Deskin,DEM,550185,0,0,39,39,
Oklahoma,U.S. Senate,Patrick Michael Hayes,DEM,550185,0,0,8,8,
Oklahoma,U.S. Senate,Jim Rogers,DEM,550185,0,0,8,8,
Oklahoma,U.S. Senate,Connie Johnson,DEM,550185,0,0,47,47,
Oklahoma,U.S. House,Tom Guild,DEM,550185,0,0,22,22,05
Oklahoma,U.S. House,Al Mcaffrey,DEM,550185,0,0,36,36,05
Oklahoma,U.S. House,Leona Leonard,DEM,550185,0,0,7,7,05
Oklahoma,State House,John Gibbons,DEM,550185,0,0,8,8,88
Oklahoma,State House,Mark Faulk,DEM,550185,0,0,21,21,88
Oklahoma,State House,Paula Sophia,DEM,550185,0,0,18,18,88
Oklahoma,State House,Jason Dunnington,DEM,550185,0,0,20,20,88
Oklahoma,Governor,Dax Ewbank,REP,550185,0,0,5,5,
Oklahoma,Governor,Chad Moody,REP,550185,0,0,8,8,
Oklahoma,Governor,Mary Fallin,REP,550185,0,0,34,34,
Oklahoma,Superintendent of Public Instruction,Brian Kelly,REP,550185,0,0,15,15,
Oklahoma,Superintendent of Public Instruction,Janet Costello Barresi,REP,550185,0,0,8,8,
Oklahoma,Superintendent of Public Instruction,Joy Hofmeister,REP,550185,0,0,21,21,
Oklahoma,Insurance Commissioner,Bill Viner,REP,550185,0,0,7,7,
Oklahoma,Insurance Commissioner,John Doak,REP,550185,0,0,35,35,
Oklahoma,Corporation Commissioner,Todd Hiett,REP,550185,0,0,19,19,
Oklahoma,Corporation Commissioner,Cliff Branan,REP,550185,0,0,21,21,
Oklahoma,U.S. Senate,Evelyn Rogers,REP,550185,0,0,3,3,
Oklahoma,U.S. Senate,Rob Moye,REP,550185,0,0,0,0,
Oklahoma,U.S. Senate,D. Jean Mcbride-Samuels,REP,550185,0,0,0,0,
Oklahoma,U.S. Senate,Jim Inhofe,REP,550185,0,0,42,42,
Oklahoma,U.S. Senate,Erick Paul Wyatt,REP,550185,0,0,1,1,
Oklahoma,U.S. Senate,Andy Craig,REP,550185,0,0,0,0,
Oklahoma,U.S. Senate,T. Shannon,REP,550185,0,0,11,11,
Oklahoma,U.S. Senate,Randy Brogdon,REP,550185,0,0,3,3,
Oklahoma,U.S. Senate,Eric Mccray,REP,550185,0,0,0,0,
Oklahoma,U.S. Senate,Kevin Crow,REP,550185,0,0,0,0,
Oklahoma,U.S. Senate,James Lankford,REP,550185,0,0,31,31,
Oklahoma,U.S. Senate,Jason Weger,REP,550185,0,0,2,2,
Oklahoma,U.S. House,Shane David Jett,REP,550185,0,0,4,4,05
Oklahoma,U.S. House,Patrice Douglas,REP,550185,0,0,8,8,05
Oklahoma,U.S. House,Mike Turner,REP,550185,0,0,8,8,05
Oklahoma,U.S. House,Steve Russell,REP,550185,0,0,16,16,05
Oklahoma,U.S. House,Harvey Sparks,REP,550185,0,0,2,2,05
Oklahoma,U.S. House,Clark Jolley,REP,550185,0,0,5,5,05
Oklahoma,State Senate,Ervin Yen,REP,550185,0,0,12,12,40
Oklahoma,State Senate,Joe Howell,REP,550185,0,0,2,2,40
Oklahoma,State Senate,Michael Taylor,REP,550185,0,0,3,3,40
Oklahoma,State Senate,Brian Winslow,REP,550185,0,0,8,8,40
Oklahoma,State Senate,Steve Kern,REP,550185,0,0,16,16,40
Oklahoma,State Senate,David Hooten,REP,550185,0,0,2,2,40
Oklahoma,Superintendent of Public Instruction,John Cox,DEM,550186,0,0,15,15,
Oklahoma,Superintendent of Public Instruction,Jack Jr.,DEM,550186,0,0,10,10,
Oklahoma,Superintendent of Public Instruction,Ivan Holmes,DEM,550186,0,0,10,10,
Oklahoma,Superintendent of Public Instruction,Freda Deskin,DEM,550186,0,0,75,75,
Oklahoma,U.S. Senate,Patrick Michael Hayes,DEM,550186,0,0,17,17,
Oklahoma,U.S. Senate,Jim Rogers,DEM,550186,0,0,7,7,
Oklahoma,U.S. Senate,Connie Johnson,DEM,550186,0,0,83,83,
Oklahoma,U.S. House,Tom Guild,DEM,550186,0,0,27,27,05
Oklahoma,U.S. House,Al Mcaffrey,DEM,550186,0,0,71,71,05
Oklahoma,U.S. House,Leona Leonard,DEM,550186,0,0,15,15,05
Oklahoma,State House,John Gibbons,DEM,550186,0,0,7,7,88
Oklahoma,State House,Mark Faulk,DEM,550186,0,0,28,28,88
Oklahoma,State House,Paula Sophia,DEM,550186,0,0,29,29,88
Oklahoma,State House,Jason Dunnington,DEM,550186,0,0,54,54,88
Oklahoma,Governor,Dax Ewbank,REP,550186,0,0,5,5,
Oklahoma,Governor,Chad Moody,REP,550186,0,0,19,19,
Oklahoma,Governor,Mary Fallin,REP,550186,0,0,88,88,
Oklahoma,Superintendent of Public Instruction,Brian Kelly,REP,550186,0,0,22,22,
Oklahoma,Superintendent of Public Instruction,Janet Costello Barresi,REP,550186,0,0,43,43,
Oklahoma,Superintendent of Public Instruction,Joy Hofmeister,REP,550186,0,0,45,45,
Oklahoma,Insurance Commissioner,Bill Viner,REP,550186,0,0,21,21,
Oklahoma,Insurance Commissioner,John Doak,REP,550186,0,0,78,78,
Oklahoma,Corporation Commissioner,Todd Hiett,REP,550186,0,0,39,39,
Oklahoma,Corporation Commissioner,Cliff Branan,REP,550186,0,0,54,54,
Oklahoma,U.S. Senate,Evelyn Rogers,REP,550186,0,0,5,5,
Oklahoma,U.S. Senate,Rob Moye,REP,550186,0,0,2,2,
Oklahoma,U.S. Senate,D. Jean Mcbride-Samuels,REP,550186,0,0,5,5,
Oklahoma,U.S. Senate,Jim Inhofe,REP,550186,0,0,96,96,
Oklahoma,U.S. Senate,Erick Paul Wyatt,REP,550186,0,0,3,3,
Oklahoma,U.S. Senate,Andy Craig,REP,550186,0,0,0,0,
Oklahoma,U.S. Senate,T. Shannon,REP,550186,0,0,36,36,
Oklahoma,U.S. Senate,Randy Brogdon,REP,550186,0,0,5,5,
Oklahoma,U.S. Senate,Eric Mccray,REP,550186,0,0,0,0,
Oklahoma,U.S. Senate,Kevin Crow,REP,550186,0,0,0,0,
Oklahoma,U.S. Senate,James Lankford,REP,550186,0,0,74,74,
Oklahoma,U.S. Senate,Jason Weger,REP,550186,0,0,0,0,
Oklahoma,U.S. House,Shane David Jett,REP,550186,0,0,14,14,05
Oklahoma,U.S. House,Patrice Douglas,REP,550186,0,0,19,19,05
Oklahoma,U.S. House,Mike Turner,REP,550186,0,0,13,13,05
Oklahoma,U.S. House,Steve Russell,REP,550186,0,0,33,33,05
Oklahoma,U.S. House,Harvey Sparks,REP,550186,0,0,6,6,05
Oklahoma,U.S. House,Clark Jolley,REP,550186,0,0,15,15,05
Oklahoma,Superintendent of Public Instruction,John Cox,DEM,550187,0,0,3,3,
Oklahoma,Superintendent of Public Instruction,Jack Jr.,DEM,550187,0,0,4,4,
Oklahoma,Superintendent of Public Instruction,Ivan Holmes,DEM,550187,0,0,1,1,
Oklahoma,Superintendent of Public Instruction,Freda Deskin,DEM,550187,0,0,10,10,
Oklahoma,U.S. Senate,Patrick Michael Hayes,DEM,550187,0,0,4,4,
Oklahoma,U.S. Senate,Jim Rogers,DEM,550187,0,0,3,3,
Oklahoma,U.S. Senate,Connie Johnson,DEM,550187,0,0,11,11,
Oklahoma,U.S. House,Tom Guild,DEM,550187,0,0,6,6,05
Oklahoma,U.S. House,Al Mcaffrey,DEM,550187,0,0,8,8,05
Oklahoma,U.S. House,Leona Leonard,DEM,550187,0,0,4,4,05
Oklahoma,Governor,Dax Ewbank,REP,550187,0,0,4,4,
Oklahoma,Governor,Chad Moody,REP,550187,0,0,3,3,
Oklahoma,Governor,Mary Fallin,REP,550187,0,0,5,5,
Oklahoma,Superintendent of Public Instruction,Brian Kelly,REP,550187,0,0,6,6,
Oklahoma,Superintendent of Public Instruction,Janet Costello Barresi,REP,550187,0,0,4,4,
Oklahoma,Superintendent of Public Instruction,Joy Hofmeister,REP,550187,0,0,2,2,
Oklahoma,Insurance Commissioner,Bill Viner,REP,550187,0,0,1,1,
Oklahoma,Insurance Commissioner,John Doak,REP,550187,0,0,10,10,
Oklahoma,Corporation Commissioner,Todd Hiett,REP,550187,0,0,2,2,
Oklahoma,Corporation Commissioner,Cliff Branan,REP,550187,0,0,7,7,
Oklahoma,U.S. Senate,Evelyn Rogers,REP,550187,0,0,1,1,
Oklahoma,U.S. Senate,Rob Moye,REP,550187,0,0,0,0,
Oklahoma,U.S. Senate,D. Jean Mcbride-Samuels,REP,550187,0,0,0,0,
Oklahoma,U.S. Senate,Jim Inhofe,REP,550187,0,0,10,10,
Oklahoma,U.S. Senate,Erick Paul Wyatt,REP,550187,0,0,1,1,
Oklahoma,U.S. Senate,Andy Craig,REP,550187,0,0,1,1,
Oklahoma,U.S. Senate,T. Shannon,REP,550187,0,0,4,4,
Oklahoma,U.S. Senate,Randy Brogdon,REP,550187,0,0,1,1,
Oklahoma,U.S. Senate,Eric Mccray,REP,550187,0,0,0,0,
Oklahoma,U.S. Senate,Kevin Crow,REP,550187,0,0,0,0,
Oklahoma,U.S. Senate,James Lankford,REP,550187,0,0,5,5,
Oklahoma,U.S. Senate,Jason Weger,REP,550187,0,0,1,1,
Oklahoma,U.S. House,Shane David Jett,REP,550187,0,0,1,1,05
Oklahoma,U.S. House,Patrice Douglas,REP,550187,0,0,3,3,05
Oklahoma,U.S. House,Mike Turner,REP,550187,0,0,0,0,05
Oklahoma,U.S. House,Steve Russell,REP,550187,0,0,4,4,05
Oklahoma,U.S. House,Harvey Sparks,REP,550187,0,0,1,1,05
Oklahoma,U.S. House,Clark Jolley,REP,550187,0,0,1,1,05
Oklahoma,Superintendent of Public Instruction,John Cox,DEM,550188,0,0,0,0,
Oklahoma,Superintendent of Public Instruction,Jack Jr.,DEM,550188,0,0,0,0,
Oklahoma,Superintendent of Public Instruction,Ivan Holmes,DEM,550188,0,0,0,0,
Oklahoma,Superintendent of Public Instruction,Freda Deskin,DEM,550188,0,0,2,2,
Oklahoma,U.S. Senate,Patrick Michael Hayes,DEM,550188,0,0,0,0,
Oklahoma,U.S. Senate,Jim Rogers,DEM,550188,0,0,0,0,
Oklahoma,U.S. Senate,Connie Johnson,DEM,550188,0,0,2,2,
Oklahoma,U.S. House,Tom Guild,DEM,550188,0,0,2,2,05
Oklahoma,U.S. House,Al Mcaffrey,DEM,550188,0,0,0,0,05
Oklahoma,U.S. House,Leona Leonard,DEM,550188,0,0,0,0,05
Oklahoma,Governor,Dax Ewbank,REP,550188,0,0,0,0,
Oklahoma,Governor,Chad Moody,REP,550188,0,0,0,0,
Oklahoma,Governor,Mary Fallin,REP,550188,0,0,0,0,
Oklahoma,Superintendent of Public Instruction,Brian Kelly,REP,550188,0,0,0,0,
Oklahoma,Superintendent of Public Instruction,Janet Costello Barresi,REP,550188,0,0,0,0,
Oklahoma,Superintendent of Public Instruction,Joy Hofmeister,REP,550188,0,0,0,0,
Oklahoma,Insurance Commissioner,Bill Viner,REP,550188,0,0,0,0,
Oklahoma,Insurance Commissioner,John Doak,REP,550188,0,0,0,0,
Oklahoma,Corporation Commissioner,Todd Hiett,REP,550188,0,0,0,0,
Oklahoma,Corporation Commissioner,Cliff Branan,REP,550188,0,0,0,0,
Oklahoma,U.S. Senate,Evelyn Rogers,REP,550188,0,0,0,0,
Oklahoma,U.S. Senate,Rob Moye,REP,550188,0,0,0,0,
Oklahoma,U.S. Senate,D. Jean Mcbride-Samuels,REP,550188,0,0,0,0,
Oklahoma,U.S. Senate,Jim Inhofe,REP,550188,0,0,0,0,
Oklahoma,U.S. Senate,Erick Paul Wyatt,REP,550188,0,0,0,0,
Oklahoma,U.S. Senate,Andy Craig,REP,550188,0,0,0,0,
Oklahoma,U.S. Senate,T. Shannon,REP,550188,0,0,0,0,
Oklahoma,U.S. Senate,Randy Brogdon,REP,550188,0,0,0,0,
Oklahoma,U.S. Senate,Eric Mccray,REP,550188,0,0,0,0,
Oklahoma,U.S. Senate,Kevin Crow,REP,550188,0,0,0,0,
Oklahoma,U.S. Senate,James Lankford,REP,550188,0,0,0,0,
Oklahoma,U.S. Senate,Jason Weger,REP,550188,0,0,0,0,
Oklahoma,U.S. House,Shane David Jett,REP,550188,0,0,0,0,05
Oklahoma,U.S. House,Patrice Douglas,REP,550188,0,0,0,0,05
Oklahoma,U.S. House,Mike Turner,REP,550188,0,0,0,0,05
Oklahoma,U.S. House,Steve Russell,REP,550188,0,0,0,0,05
Oklahoma,U.S. House,Harvey Sparks,REP,550188,0,0,0,0,05
Oklahoma,U.S. House,Clark Jolley,REP,550188,0,0,0,0,05
Oklahoma,Superintendent of Public Instruction,John Cox,DEM,550189,0,0,1,1,
Oklahoma,Superintendent of Public Instruction,Jack Jr.,DEM,550189,0,0,2,2,
Oklahoma,Superintendent of Public Instruction,Ivan Holmes,DEM,550189,0,0,1,1,
Oklahoma,Superintendent of Public Instruction,Freda Deskin,DEM,550189,0,0,5,5,
Oklahoma,U.S. Senate,Patrick Michael Hayes,DEM,550189,0,0,0,0,
Oklahoma,U.S. Senate,Jim Rogers,DEM,550189,0,0,4,4,
Oklahoma,U.S. Senate,Connie Johnson,DEM,550189,0,0,6,6,
Oklahoma,U.S. House,Tom Guild,DEM,550189,0,0,4,4,05
Oklahoma,U.S. House,Al Mcaffrey,DEM,550189,0,0,2,2,05
Oklahoma,U.S. House,Leona Leonard,DEM,550189,0,0,4,4,05
Oklahoma,Governor,Dax Ewbank,REP,550189,0,0,2,2,
Oklahoma,Governor,Chad Moody,REP,550189,0,0,5,5,
Oklahoma,Governor,Mary Fallin,REP,550189,0,0,12,12,
Oklahoma,Superintendent of Public Instruction,Brian Kelly,REP,550189,0,0,5,5,
Oklahoma,Superintendent of Public Instruction,Janet Costello Barresi,REP,550189,0,0,8,8,
Oklahoma,Superintendent of Public Instruction,Joy Hofmeister,REP,550189,0,0,8,8,
Oklahoma,Insurance Commissioner,Bill Viner,REP,550189,0,0,5,5,
Oklahoma,Insurance Commissioner,John Doak,REP,550189,0,0,14,14,
Oklahoma,Corporation Commissioner,Todd Hiett,REP,550189,0,0,6,6,
Oklahoma,Corporation Commissioner,Cliff Branan,REP,550189,0,0,12,12,
Oklahoma,U.S. Senate,Evelyn Rogers,REP,550189,0,0,1,1,
Oklahoma,U.S. Senate,Rob Moye,REP,550189,0,0,0,0,
Oklahoma,U.S. Senate,D. Jean Mcbride-Samuels,REP,550189,0,0,0,0,
Oklahoma,U.S. Senate,Jim Inhofe,REP,550189,0,0,18,18,
Oklahoma,U.S. Senate,Erick Paul Wyatt,REP,550189,0,0,1,1,
Oklahoma,U.S. Senate,Andy Craig,REP,550189,0,0,0,0,
Oklahoma,U.S. Senate,T. Shannon,REP,550189,0,0,4,4,
Oklahoma,U.S. Senate,Randy Brogdon,REP,550189,0,0,0,0,
Oklahoma,U.S. Senate,Eric Mccray,REP,550189,0,0,0,0,
Oklahoma,U.S. Senate,Kevin Crow,REP,550189,0,0,0,0,
Oklahoma,U.S. Senate,James Lankford,REP,550189,0,0,17,17,
Oklahoma,U.S. Senate,Jason Weger,REP,550189,0,0,0,0,
Oklahoma,U.S. House,Shane David Jett,REP,550189,0,0,4,4,05
Oklahoma,U.S. House,Patrice Douglas,REP,550189,0,0,1,1,05
Oklahoma,U.S. House,Mike Turner,REP,550189,0,0,6,6,05
Oklahoma,U.S. House,Steve Russell,REP,550189,0,0,4,4,05
Oklahoma,U.S. House,Harvey Sparks,REP,550189,0,0,3,3,05
Oklahoma,U.S. House,Clark Jolley,REP,550189,0,0,3,3,05
Oklahoma,Superintendent of Public Instruction,John Cox,DEM,550190,0,0,7,7,
Oklahoma,Superintendent of Public Instruction,Jack Jr.,DEM,550190,0,0,4,4,
Oklahoma,Superintendent of Public Instruction,Ivan Holmes,DEM,550190,0,0,6,6,
Oklahoma,Superintendent of Public Instruction,Freda Deskin,DEM,550190,0,0,21,21,
Oklahoma,U.S. Senate,Patrick Michael Hayes,DEM,550190,0,0,3,3,
Oklahoma,U.S. Senate,Jim Rogers,DEM,550190,0,0,7,7,
Oklahoma,U.S. Senate,Connie Johnson,DEM,550190,0,0,27,27,
Oklahoma,U.S. House,Tom Guild,DEM,550190,0,0,10,10,05
Oklahoma,U.S. House,Al Mcaffrey,DEM,550190,0,0,17,17,05
Oklahoma,U.S. House,Leona Leonard,DEM,550190,0,0,11,11,05
Oklahoma,State Senate,Wilfredo Santos Rivera,DEM,550190,0,0,13,13,46
Oklahoma,State Senate,Kay Floyd,DEM,550190,0,0,24,24,46
Oklahoma,Governor,Dax Ewbank,REP,550190,0,0,3,3,
Oklahoma,Governor,Chad Moody,REP,550190,0,0,14,14,
Oklahoma,Governor,Mary Fallin,REP,550190,0,0,19,19,
Oklahoma,Superintendent of Public Instruction,Brian Kelly,REP,550190,0,0,10,10,
Oklahoma,Superintendent of Public Instruction,Janet Costello Barresi,REP,550190,0,0,6,6,
Oklahoma,Superintendent of Public Instruction,Joy Hofmeister,REP,550190,0,0,19,19,
Oklahoma,Insurance Commissioner,Bill Viner,REP,550190,0,0,9,9,
Oklahoma,Insurance Commissioner,John Doak,REP,550190,0,0,24,24,
Oklahoma,Corporation Commissioner,Todd Hiett,REP,550190,0,0,19,19,
Oklahoma,Corporation Commissioner,Cliff Branan,REP,550190,0,0,16,16,
Oklahoma,U.S. Senate,Evelyn Rogers,REP,550190,0,0,8,8,
Oklahoma,U.S. Senate,Rob Moye,REP,550190,0,0,1,1,
Oklahoma,U.S. Senate,D. Jean Mcbride-Samuels,REP,550190,0,0,3,3,
Oklahoma,U.S. Senate,Jim Inhofe,REP,550190,0,0,20,20,
Oklahoma,U.S. Senate,Erick Paul Wyatt,REP,550190,0,0,4,4,
Oklahoma,U.S. Senate,Andy Craig,REP,550190,0,0,2,2,
Oklahoma,U.S. Senate,T. Shannon,REP,550190,0,0,11,11,
Oklahoma,U.S. Senate,Randy Brogdon,REP,550190,0,0,0,0,
Oklahoma,U.S. Senate,Eric Mccray,REP,550190,0,0,1,1,
Oklahoma,U.S. Senate,Kevin Crow,REP,550190,0,0,1,1,
Oklahoma,U.S. Senate,James Lankford,REP,550190,0,0,20,20,
Oklahoma,U.S. Senate,Jason Weger,REP,550190,0,0,1,1,
Oklahoma,U.S. House,Shane David Jett,REP,550190,0,0,5,5,05
Oklahoma,U.S. House,Patrice Douglas,REP,550190,0,0,8,8,05
Oklahoma,U.S. House,Mike Turner,REP,550190,0,0,6,6,05
Oklahoma,U.S. House,Steve Russell,REP,550190,0,0,6,6,05
Oklahoma,U.S. House,Harvey Sparks,REP,550190,0,0,6,6,05
Oklahoma,U.S. House,Clark Jolley,REP,550190,0,0,4,4,05
Oklahoma,Superintendent of Public Instruction,John Cox,DEM,550191,0,0,29,29,
Oklahoma,Superintendent of Public Instruction,Jack Jr.,DEM,550191,0,0,10,10,
Oklahoma,Superintendent of Public Instruction,Ivan Holmes,DEM,550191,0,0,5,5,
Oklahoma,Superintendent of Public Instruction,Freda Deskin,DEM,550191,0,0,49,49,
Oklahoma,U.S. Senate,Patrick Michael Hayes,DEM,550191,0,0,11,11,
Oklahoma,U.S. Senate,Jim Rogers,DEM,550191,0,0,16,16,
Oklahoma,U.S. Senate,Connie Johnson,DEM,550191,0,0,65,65,
Oklahoma,U.S. House,Tom Guild,DEM,550191,0,0,35,35,05
Oklahoma,U.S. House,Al Mcaffrey,DEM,550191,0,0,57,57,05
Oklahoma,U.S. House,Leona Leonard,DEM,550191,0,0,8,8,05
Oklahoma,State House,John Gibbons,DEM,550191,0,0,19,19,88
Oklahoma,State House,Mark Faulk,DEM,550191,0,0,17,17,88
Oklahoma,State House,Paula Sophia,DEM,550191,0,0,19,19,88
Oklahoma,State House,Jason Dunnington,DEM,550191,0,0,44,44,88
Oklahoma,Governor,Dax Ewbank,REP,550191,0,0,10,10,
Oklahoma,Governor,Chad Moody,REP,550191,0,0,12,12,
Oklahoma,Governor,Mary Fallin,REP,550191,0,0,38,38,
Oklahoma,Superintendent of Public Instruction,Brian Kelly,REP,550191,0,0,15,15,
Oklahoma,Superintendent of Public Instruction,Janet Costello Barresi,REP,550191,0,0,20,20,
Oklahoma,Superintendent of Public Instruction,Joy Hofmeister,REP,550191,0,0,26,26,
Oklahoma,Insurance Commissioner,Bill Viner,REP,550191,0,0,15,15,
Oklahoma,Insurance Commissioner,John Doak,REP,550191,0,0,40,40,
Oklahoma,Corporation Commissioner,Todd Hiett,REP,550191,0,0,30,30,
Oklahoma,Corporation Commissioner,Cliff Branan,REP,550191,0,0,24,24,
Oklahoma,U.S. Senate,Evelyn Rogers,REP,550191,0,0,4,4,
Oklahoma,U.S. Senate,Rob Moye,REP,550191,0,0,3,3,
Oklahoma,U.S. Senate,D. Jean Mcbride-Samuels,REP,550191,0,0,2,2,
Oklahoma,U.S. Senate,Jim Inhofe,REP,550191,0,0,46,46,
Oklahoma,U.S. Senate,Erick Paul Wyatt,REP,550191,0,0,3,3,
Oklahoma,U.S. Senate,Andy Craig,REP,550191,0,0,0,0,
Oklahoma,U.S. Senate,T. Shannon,REP,550191,0,0,12,12,
Oklahoma,U.S. Senate,Randy Brogdon,REP,550191,0,0,6,6,
Oklahoma,U.S. Senate,Eric Mccray,REP,550191,0,0,1,1,
Oklahoma,U.S. Senate,Kevin Crow,REP,550191,0,0,4,4,
Oklahoma,U.S. Senate,James Lankford,REP,550191,0,0,37,37,
Oklahoma,U.S. Senate,Jason Weger,REP,550191,0,0,1,1,
Oklahoma,U.S. House,Shane David Jett,REP,550191,0,0,4,4,05
Oklahoma,U.S. House,Patrice Douglas,REP,550191,0,0,8,8,05
Oklahoma,U.S. House,Mike Turner,REP,550191,0,0,9,9,05
Oklahoma,U.S. House,Steve Russell,REP,550191,0,0,16,16,05
Oklahoma,U.S. House,Harvey Sparks,REP,550191,0,0,10,10,05
Oklahoma,U.S. House,Clark Jolley,REP,550191,0,0,10,10,05
Oklahoma,Superintendent of Public Instruction,John Cox,DEM,550192,0,0,56,56,
Oklahoma,Superintendent of Public Instruction,Jack Jr.,DEM,550192,0,0,31,31,
Oklahoma,Superintendent of Public Instruction,Ivan Holmes,DEM,550192,0,0,26,26,
Oklahoma,Superintendent of Public Instruction,Freda Deskin,DEM,550192,0,0,127,127,
Oklahoma,U.S. Senate,Patrick Michael Hayes,DEM,550192,0,0,33,33,
Oklahoma,U.S. Senate,Jim Rogers,DEM,550192,0,0,33,33,
Oklahoma,U.S. Senate,Connie Johnson,DEM,550192,0,0,170,170,
Oklahoma,U.S. House,Tom Guild,DEM,550192,0,0,72,72,05
Oklahoma,U.S. House,Al Mcaffrey,DEM,550192,0,0,144,144,05
Oklahoma,U.S. House,Leona Leonard,DEM,550192,0,0,33,33,05
Oklahoma,State House,John Gibbons,DEM,550192,0,0,48,48,88
Oklahoma,State House,Mark Faulk,DEM,550192,0,0,46,46,88
Oklahoma,State House,Paula Sophia,DEM,550192,0,0,47,47,88
Oklahoma,State House,Jason Dunnington,DEM,550192,0,0,118,118,88
Oklahoma,Governor,Dax Ewbank,REP,550192,0,0,20,20,
Oklahoma,Governor,Chad Moody,REP,550192,0,0,39,39,
Oklahoma,Governor,Mary Fallin,REP,550192,0,0,98,98,
Oklahoma,Superintendent of Public Instruction,Brian Kelly,REP,550192,0,0,31,31,
Oklahoma,Superintendent of Public Instruction,Janet Costello Barresi,REP,550192,0,0,49,49,
Oklahoma,Superintendent of Public Instruction,Joy Hofmeister,REP,550192,0,0,77,77,
Oklahoma,Insurance Commissioner,Bill Viner,REP,550192,0,0,41,41,
Oklahoma,Insurance Commissioner,John Doak,REP,550192,0,0,102,102,
Oklahoma,Corporation Commissioner,Todd Hiett,REP,550192,0,0,64,64,
Oklahoma,Corporation Commissioner,Cliff Branan,REP,550192,0,0,74,74,
Oklahoma,U.S. Senate,Evelyn Rogers,REP,550192,0,0,12,12,
Oklahoma,U.S. Senate,Rob Moye,REP,550192,0,0,2,2,
Oklahoma,U.S. Senate,D. Jean Mcbride-Samuels,REP,550192,0,0,2,2,
Oklahoma,U.S. Senate,Jim Inhofe,REP,550192,0,0,128,128,
Oklahoma,U.S. Senate,Erick Paul Wyatt,REP,550192,0,0,7,7,
Oklahoma,U.S. Senate,Andy Craig,REP,550192,0,0,0,0,
Oklahoma,U.S. Senate,T. Shannon,REP,550192,0,0,49,49,
Oklahoma,U.S. Senate,Randy Brogdon,REP,550192,0,0,1,1,
Oklahoma,U.S. Senate,Eric Mccray,REP,550192,0,0,3,3,
Oklahoma,U.S. Senate,Kevin Crow,REP,550192,0,0,0,0,
Oklahoma,U.S. Senate,James Lankford,REP,550192,0,0,105,105,
Oklahoma,U.S. Senate,Jason Weger,REP,550192,0,0,5,5,
Oklahoma,U.S. House,Shane David Jett,REP,550192,0,0,19,19,05
Oklahoma,U.S. House,Patrice Douglas,REP,550192,0,0,32,32,05
Oklahoma,U.S. House,Mike Turner,REP,550192,0,0,23,23,05
Oklahoma,U.S. House,Steve Russell,REP,550192,0,0,34,34,05
Oklahoma,U.S. House,Harvey Sparks,REP,550192,0,0,27,27,05
Oklahoma,U.S. House,Clark Jolley,REP,550192,0,0,18,18,05
Oklahoma,Superintendent of Public Instruction,John Cox,DEM,550193,0,0,36,36,
Oklahoma,Superintendent of Public Instruction,Jack Jr.,DEM,550193,0,0,13,13,
Oklahoma,Superintendent of Public Instruction,Ivan Holmes,DEM,550193,0,0,17,17,
Oklahoma,Superintendent of Public Instruction,Freda Deskin,DEM,550193,0,0,82,82,
Oklahoma,U.S. Senate,Patrick Michael Hayes,DEM,550193,0,0,22,22,
Oklahoma,U.S. Senate,Jim Rogers,DEM,550193,0,0,11,11,
Oklahoma,U.S. Senate,Connie Johnson,DEM,550193,0,0,120,120,
Oklahoma,U.S. House,Tom Guild,DEM,550193,0,0,35,35,05
Oklahoma,U.S. House,Al Mcaffrey,DEM,550193,0,0,102,102,05
Oklahoma,U.S. House,Leona Leonard,DEM,550193,0,0,17,17,05
Oklahoma,State House,John Gibbons,DEM,550193,0,0,22,22,88
Oklahoma,State House,Mark Faulk,DEM,550193,0,0,29,29,88
Oklahoma,State House,Paula Sophia,DEM,550193,0,0,39,39,88
Oklahoma,State House,Jason Dunnington,DEM,550193,0,0,66,66,88
Oklahoma,Governor,Dax Ewbank,REP,550193,0,0,12,12,
Oklahoma,Governor,Chad Moody,REP,550193,0,0,27,27,
Oklahoma,Governor,Mary Fallin,REP,550193,0,0,72,72,
Oklahoma,Superintendent of Public Instruction,Brian Kelly,REP,550193,0,0,24,24,
Oklahoma,Superintendent of Public Instruction,Janet Costello Barresi,REP,550193,0,0,35,35,
Oklahoma,Superintendent of Public Instruction,Joy Hofmeister,REP,550193,0,0,52,52,
Oklahoma,Insurance Commissioner,Bill Viner,REP,550193,0,0,26,26,
Oklahoma,Insurance Commissioner,John Doak,REP,550193,0,0,81,81,
Oklahoma,Corporation Commissioner,Todd Hiett,REP,550193,0,0,48,48,
Oklahoma,Corporation Commissioner,Cliff Branan,REP,550193,0,0,55,55,
Oklahoma,U.S. Senate,Evelyn Rogers,REP,550193,0,0,9,9,
Oklahoma,U.S. Senate,Rob Moye,REP,550193,0,0,1,1,
Oklahoma,U.S. Senate,D. Jean Mcbride-Samuels,REP,550193,0,0,5,5,
Oklahoma,U.S. Senate,Jim Inhofe,REP,550193,0,0,92,92,
Oklahoma,U.S. Senate,Erick Paul Wyatt,REP,550193,0,0,6,6,
Oklahoma,U.S. Senate,Andy Craig,REP,550193,0,0,0,0,
Oklahoma,U.S. Senate,T. Shannon,REP,550193,0,0,34,34,
Oklahoma,U.S. Senate,Randy Brogdon,REP,550193,0,0,3,3,
Oklahoma,U.S. Senate,Eric Mccray,REP,550193,0,0,3,3,
Oklahoma,U.S. Senate,Kevin Crow,REP,550193,0,0,3,3,
Oklahoma,U.S. Senate,James Lankford,REP,550193,0,0,71,71,
Oklahoma,U.S. Senate,Jason Weger,REP,550193,0,0,0,0,
Oklahoma,U.S. House,Shane David Jett,REP,550193,0,0,15,15,05
Oklahoma,U.S. House,Patrice Douglas,REP,550193,0,0,23,23,05
Oklahoma,U.S. House,Mike Turner,REP,550193,0,0,11,11,05
Oklahoma,U.S. House,Steve Russell,REP,550193,0,0,28,28,05
Oklahoma,U.S. House,Harvey Sparks,REP,550193,0,0,10,10,05
Oklahoma,U.S. House,Clark Jolley,REP,550193,0,0,19,19,05
Oklahoma,Superintendent of Public Instruction,John Cox,DEM,550194,0,0,33,33,
Oklahoma,Superintendent of Public Instruction,Jack Jr.,DEM,550194,0,0,22,22,
Oklahoma,Superintendent of Public Instruction,Ivan Holmes,DEM,550194,0,0,11,11,
Oklahoma,Superintendent of Public Instruction,Freda Deskin,DEM,550194,0,0,72,72,
Oklahoma,U.S. Senate,Patrick Michael Hayes,DEM,550194,0,0,21,21,
Oklahoma,U.S. Senate,Jim Rogers,DEM,550194,0,0,21,21,
Oklahoma,U.S. Senate,Connie Johnson,DEM,550194,0,0,93,93,
Oklahoma,U.S. House,Tom Guild,DEM,550194,0,0,46,46,05
Oklahoma,U.S. House,Al Mcaffrey,DEM,550194,0,0,68,68,05
Oklahoma,U.S. House,Leona Leonard,DEM,550194,0,0,24,24,05
Oklahoma,State House,John Gibbons,DEM,550194,0,0,27,27,88
Oklahoma,State House,Mark Faulk,DEM,550194,0,0,23,23,88
Oklahoma,State House,Paula Sophia,DEM,550194,0,0,37,37,88
Oklahoma,State House,Jason Dunnington,DEM,550194,0,0,58,58,88
Oklahoma,Governor,Dax Ewbank,REP,550194,0,0,10,10,
Oklahoma,Governor,Chad Moody,REP,550194,0,0,25,25,
Oklahoma,Governor,Mary Fallin,REP,550194,0,0,59,59,
Oklahoma,Superintendent of Public Instruction,Brian Kelly,REP,550194,0,0,32,32,
Oklahoma,Superintendent of Public Instruction,Janet Costello Barresi,REP,550194,0,0,27,27,
Oklahoma,Superintendent of Public Instruction,Joy Hofmeister,REP,550194,0,0,35,35,
Oklahoma,Insurance Commissioner,Bill Viner,REP,550194,0,0,15,15,
Oklahoma,Insurance Commissioner,John Doak,REP,550194,0,0,75,75,
Oklahoma,Corporation Commissioner,Todd Hiett,REP,550194,0,0,36,36,
Oklahoma,Corporation Commissioner,Cliff Branan,REP,550194,0,0,51,51,
Oklahoma,U.S. Senate,Evelyn Rogers,REP,550194,0,0,6,6,
Oklahoma,U.S. Senate,Rob Moye,REP,550194,0,0,1,1,
Oklahoma,U.S. Senate,D. Jean Mcbride-Samuels,REP,550194,0,0,3,3,
Oklahoma,U.S. Senate,Jim Inhofe,REP,550194,0,0,76,76,
Oklahoma,U.S. Senate,Erick Paul Wyatt,REP,550194,0,0,6,6,
Oklahoma,U.S. Senate,Andy Craig,REP,550194,0,0,2,2,
Oklahoma,U.S. Senate,T. Shannon,REP,550194,0,0,23,23,
Oklahoma,U.S. Senate,Randy Brogdon,REP,550194,0,0,2,2,
Oklahoma,U.S. Senate,Eric Mccray,REP,550194,0,0,0,0,
Oklahoma,U.S. Senate,Kevin Crow,REP,550194,0,0,1,1,
Oklahoma,U.S. Senate,James Lankford,REP,550194,0,0,63,63,
Oklahoma,U.S. Senate,Jason Weger,REP,550194,0,0,3,3,
Oklahoma,U.S. House,Shane David Jett,REP,550194,0,0,11,11,05
Oklahoma,U.S. House,Patrice Douglas,REP,550194,0,0,23,23,05
Oklahoma,U.S. House,Mike Turner,REP,550194,0,0,12,12,05
Oklahoma,U.S. House,Steve Russell,REP,550194,0,0,17,17,05
Oklahoma,U.S. House,Harvey Sparks,REP,550194,0,0,10,10,05
Oklahoma,U.S. House,Clark Jolley,REP,550194,0,0,20,20,05
Oklahoma,State Senate,Ervin Yen,REP,550194,0,0,23,23,40
Oklahoma,State Senate,Joe Howell,REP,550194,0,0,9,9,40
Oklahoma,State Senate,Michael Taylor,REP,550194,0,0,5,5,40
Oklahoma,State Senate,Brian Winslow,REP,550194,0,0,18,18,40
Oklahoma,State Senate,Steve Kern,REP,550194,0,0,21,21,40
Oklahoma,State Senate,David Hooten,REP,550194,0,0,12,12,40
Oklahoma,Superintendent of Public Instruction,John Cox,DEM,550195,0,0,46,46,
Oklahoma,Superintendent of Public Instruction,Jack Jr.,DEM,550195,0,0,16,16,
Oklahoma,Superintendent of Public Instruction,Ivan Holmes,DEM,550195,0,0,11,11,
Oklahoma,Superintendent of Public Instruction,Freda Deskin,DEM,550195,0,0,109,109,
Oklahoma,U.S. Senate,Patrick Michael Hayes,DEM,550195,0,0,29,29,
Oklahoma,U.S. Senate,Jim Rogers,DEM,550195,0,0,29,29,
Oklahoma,U.S. Senate,Connie Johnson,DEM,550195,0,0,123,123,
Oklahoma,U.S. House,Tom Guild,DEM,550195,0,0,63,63,05
Oklahoma,U.S. House,Al Mcaffrey,DEM,550195,0,0,89,89,05
Oklahoma,U.S. House,Leona Leonard,DEM,550195,0,0,33,33,05
Oklahoma,Governor,Dax Ewbank,REP,550195,0,0,20,20,
Oklahoma,Governor,Chad Moody,REP,550195,0,0,51,51,
Oklahoma,Governor,Mary Fallin,REP,550195,0,0,236,236,
Oklahoma,Superintendent of Public Instruction,Brian Kelly,REP,550195,0,0,72,72,
Oklahoma,Superintendent of Public Instruction,Janet Costello Barresi,REP,550195,0,0,111,111,
Oklahoma,Superintendent of Public Instruction,Joy Hofmeister,REP,550195,0,0,114,114,
Oklahoma,Insurance Commissioner,Bill Viner,REP,550195,0,0,60,60,
Oklahoma,Insurance Commissioner,John Doak,REP,550195,0,0,221,221,
Oklahoma,Corporation Commissioner,Todd Hiett,REP,550195,0,0,119,119,
Oklahoma,Corporation Commissioner,Cliff Branan,REP,550195,0,0,156,156,
Oklahoma,U.S. Senate,Evelyn Rogers,REP,550195,0,0,19,19,
Oklahoma,U.S. Senate,Rob Moye,REP,550195,0,0,10,10,
Oklahoma,U.S. Senate,D. Jean Mcbride-Samuels,REP,550195,0,0,6,6,
Oklahoma,U.S. Senate,Jim Inhofe,REP,550195,0,0,257,257,
Oklahoma,U.S. Senate,Erick Paul Wyatt,REP,550195,0,0,12,12,
Oklahoma,U.S. Senate,Andy Craig,REP,550195,0,0,2,2,
Oklahoma,U.S. Senate,T. Shannon,REP,550195,0,0,77,77,
Oklahoma,U.S. Senate,Randy Brogdon,REP,550195,0,0,14,14,
Oklahoma,U.S. Senate,Eric Mccray,REP,550195,0,0,5,5,
Oklahoma,U.S. Senate,Kevin Crow,REP,550195,0,0,4,4,
Oklahoma,U.S. Senate,James Lankford,REP,550195,0,0,204,204,
Oklahoma,U.S. Senate,Jason Weger,REP,550195,0,0,3,3,
Oklahoma,U.S. House,Shane David Jett,REP,550195,0,0,28,28,05
Oklahoma,U.S. House,Patrice Douglas,REP,550195,0,0,64,64,05
Oklahoma,U.S. House,Mike Turner,REP,550195,0,0,62,62,05
Oklahoma,U.S. House,Steve Russell,REP,550195,0,0,98,98,05
Oklahoma,U.S. House,Harvey Sparks,REP,550195,0,0,17,17,05
Oklahoma,U.S. House,Clark Jolley,REP,550195,0,0,29,29,05
Oklahoma,State Senate,Ervin Yen,REP,550195,0,0,96,96,40
Oklahoma,State Senate,Joe Howell,REP,550195,0,0,35,35,40
Oklahoma,State Senate,Michael Taylor,REP,550195,0,0,30,30,40
Oklahoma,State Senate,Brian Winslow,REP,550195,0,0,43,43,40
Oklahoma,State Senate,Steve Kern,REP,550195,0,0,53,53,40
Oklahoma,State Senate,David Hooten,REP,550195,0,0,34,34,40
Oklahoma,Superintendent of Public Instruction,John Cox,DEM,550196,0,0,38,38,
Oklahoma,Superintendent of Public Instruction,Jack Jr.,DEM,550196,0,0,17,17,
Oklahoma,Superintendent of Public Instruction,Ivan Holmes,DEM,550196,0,0,22,22,
Oklahoma,Superintendent of Public Instruction,Freda Deskin,DEM,550196,0,0,117,117,
Oklahoma,U.S. Senate,Patrick Michael Hayes,DEM,550196,0,0,23,23,
Oklahoma,U.S. Senate,Jim Rogers,DEM,550196,0,0,22,22,
Oklahoma,U.S. Senate,Connie Johnson,DEM,550196,0,0,146,146,
Oklahoma,U.S. House,Tom Guild,DEM,550196,0,0,43,43,05
Oklahoma,U.S. House,Al Mcaffrey,DEM,550196,0,0,128,128,05
Oklahoma,U.S. House,Leona Leonard,DEM,550196,0,0,22,22,05
Oklahoma,Governor,Dax Ewbank,REP,550196,0,0,19,19,
Oklahoma,Governor,Chad Moody,REP,550196,0,0,65,65,
Oklahoma,Governor,Mary Fallin,REP,550196,0,0,450,450,
Oklahoma,Superintendent of Public Instruction,Brian Kelly,REP,550196,0,0,85,85,
Oklahoma,Superintendent of Public Instruction,Janet Costello Barresi,REP,550196,0,0,296,296,
Oklahoma,Superintendent of Public Instruction,Joy Hofmeister,REP,550196,0,0,149,149,
Oklahoma,Insurance Commissioner,Bill Viner,REP,550196,0,0,86,86,
Oklahoma,Insurance Commissioner,John Doak,REP,550196,0,0,401,401,
Oklahoma,Corporation Commissioner,Todd Hiett,REP,550196,0,0,165,165,
Oklahoma,Corporation Commissioner,Cliff Branan,REP,550196,0,0,336,336,
Oklahoma,U.S. Senate,Evelyn Rogers,REP,550196,0,0,24,24,
Oklahoma,U.S. Senate,Rob Moye,REP,550196,0,0,7,7,
Oklahoma,U.S. Senate,D. Jean Mcbride-Samuels,REP,550196,0,0,6,6,
Oklahoma,U.S. Senate,Jim Inhofe,REP,550196,0,0,490,490,
Oklahoma,U.S. Senate,Erick Paul Wyatt,REP,550196,0,0,13,13,
Oklahoma,U.S. Senate,Andy Craig,REP,550196,0,0,2,2,
Oklahoma,U.S. Senate,T. Shannon,REP,550196,0,0,105,105,
Oklahoma,U.S. Senate,Randy Brogdon,REP,550196,0,0,7,7,
Oklahoma,U.S. Senate,Eric Mccray,REP,550196,0,0,2,2,
Oklahoma,U.S. Senate,Kevin Crow,REP,550196,0,0,4,4,
Oklahoma,U.S. Senate,James Lankford,REP,550196,0,0,422,422,
Oklahoma,U.S. Senate,Jason Weger,REP,550196,0,0,1,1,
Oklahoma,U.S. House,Shane David Jett,REP,550196,0,0,51,51,05
Oklahoma,U.S. House,Patrice Douglas,REP,550196,0,0,162,162,05
Oklahoma,U.S. House,Mike Turner,REP,550196,0,0,71,71,05
Oklahoma,U.S. House,Steve Russell,REP,550196,0,0,134,134,05
Oklahoma,U.S. House,Harvey Sparks,REP,550196,0,0,24,24,05
Oklahoma,U.S. House,Clark Jolley,REP,550196,0,0,68,68,05
Oklahoma,State Senate,Ervin Yen,REP,550196,0,0,292,292,40
Oklahoma,State Senate,Joe Howell,REP,550196,0,0,64,64,40
Oklahoma,State Senate,Michael Taylor,REP,550196,0,0,15,15,40
Oklahoma,State Senate,Brian Winslow,REP,550196,0,0,39,39,40
Oklahoma,State Senate,Steve Kern,REP,550196,0,0,50,50,40
Oklahoma,State Senate,David Hooten,REP,550196,0,0,65,65,40
Oklahoma,Superintendent of Public Instruction,John Cox,DEM,550197,0,0,44,44,
Oklahoma,Superintendent of Public Instruction,Jack Jr.,DEM,550197,0,0,18,18,
Oklahoma,Superintendent of Public Instruction,Ivan Holmes,DEM,550197,0,0,21,21,
Oklahoma,Superintendent of Public Instruction,Freda Deskin,DEM,550197,0,0,106,106,
Oklahoma,U.S. Senate,Patrick Michael Hayes,DEM,550197,0,0,22,22,
Oklahoma,U.S. Senate,Jim Rogers,DEM,550197,0,0,23,23,
Oklahoma,U.S. Senate,Connie Johnson,DEM,550197,0,0,145,145,
Oklahoma,U.S. House,Tom Guild,DEM,550197,0,0,57,57,05
Oklahoma,U.S. House,Al Mcaffrey,DEM,550197,0,0,116,116,05
Oklahoma,U.S. House,Leona Leonard,DEM,550197,0,0,23,23,05
Oklahoma,State House,John Gibbons,DEM,550197,0,0,44,44,88
Oklahoma,State House,Mark Faulk,DEM,550197,0,0,35,35,88
Oklahoma,State House,Paula Sophia,DEM,550197,0,0,40,40,88
Oklahoma,State House,Jason Dunnington,DEM,550197,0,0,82,82,88
Oklahoma,Governor,Dax Ewbank,REP,550197,0,0,7,7,
Oklahoma,Governor,Chad Moody,REP,550197,0,0,27,27,
Oklahoma,Governor,Mary Fallin,REP,550197,0,0,59,59,
Oklahoma,Superintendent of Public Instruction,Brian Kelly,REP,550197,0,0,28,28,
Oklahoma,Superintendent of Public Instruction,Janet Costello Barresi,REP,550197,0,0,21,21,
Oklahoma,Superintendent of Public Instruction,Joy Hofmeister,REP,550197,0,0,41,41,
Oklahoma,Insurance Commissioner,Bill Viner,REP,550197,0,0,21,21,
Oklahoma,Insurance Commissioner,John Doak,REP,550197,0,0,67,67,
Oklahoma,Corporation Commissioner,Todd Hiett,REP,550197,0,0,40,40,
Oklahoma,Corporation Commissioner,Cliff Branan,REP,550197,0,0,52,52,
Oklahoma,U.S. Senate,Evelyn Rogers,REP,550197,0,0,13,13,
Oklahoma,U.S. Senate,Rob Moye,REP,550197,0,0,0,0,
Oklahoma,U.S. Senate,D. Jean Mcbride-Samuels,REP,550197,0,0,2,2,
Oklahoma,U.S. Senate,Jim Inhofe,REP,550197,0,0,73,73,
Oklahoma,U.S. Senate,Erick Paul Wyatt,REP,550197,0,0,4,4,
Oklahoma,U.S. Senate,Andy Craig,REP,550197,0,0,1,1,
Oklahoma,U.S. Senate,T. Shannon,REP,550197,0,0,26,26,
Oklahoma,U.S. Senate,Randy Brogdon,REP,550197,0,0,3,3,
Oklahoma,U.S. Senate,Eric Mccray,REP,550197,0,0,3,3,
Oklahoma,U.S. Senate,Kevin Crow,REP,550197,0,0,0,0,
Oklahoma,U.S. Senate,James Lankford,REP,550197,0,0,60,60,
Oklahoma,U.S. Senate,Jason Weger,REP,550197,0,0,1,1,
Oklahoma,U.S. House,Shane David Jett,REP,550197,0,0,7,7,05
Oklahoma,U.S. House,Patrice Douglas,REP,550197,0,0,12,12,05
Oklahoma,U.S. House,Mike Turner,REP,550197,0,0,13,13,05
Oklahoma,U.S. House,Steve Russell,REP,550197,0,0,31,31,05
Oklahoma,U.S. House,Harvey Sparks,REP,550197,0,0,6,6,05
Oklahoma,U.S. House,Clark Jolley,REP,550197,0,0,22,22,05
Oklahoma,State Senate,Ervin Yen,REP,550197,0,0,27,27,40
Oklahoma,State Senate,Joe Howell,REP,550197,0,0,4,4,40
Oklahoma,State Senate,Michael Taylor,REP,550197,0,0,12,12,40
Oklahoma,State Senate,Brian Winslow,REP,550197,0,0,11,11,40
Oklahoma,State Senate,Steve Kern,REP,550197,0,0,23,23,40
Oklahoma,State Senate,David Hooten,REP,550197,0,0,16,16,40
Oklahoma,Superintendent of Public Instruction,John Cox,DEM,550198,0,0,35,35,
Oklahoma,Superintendent of Public Instruction,Jack Jr.,DEM,550198,0,0,21,21,
Oklahoma,Superintendent of Public Instruction,Ivan Holmes,DEM,550198,0,0,21,21,
Oklahoma,Superintendent of Public Instruction,Freda Deskin,DEM,550198,0,0,76,76,
Oklahoma,U.S. Senate,Patrick Michael Hayes,DEM,550198,0,0,15,15,
Oklahoma,U.S. Senate,Jim Rogers,DEM,550198,0,0,26,26,
Oklahoma,U.S. Senate,Connie Johnson,DEM,550198,0,0,117,117,
Oklahoma,U.S. House,Tom Guild,DEM,550198,0,0,42,42,05
Oklahoma,U.S. House,Al Mcaffrey,DEM,550198,0,0,99,99,05
Oklahoma,U.S. House,Leona Leonard,DEM,550198,0,0,16,16,05
Oklahoma,State Senate,Wilfredo Santos Rivera,DEM,550198,0,0,18,18,46
Oklahoma,State Senate,Kay Floyd,DEM,550198,0,0,141,141,46
Oklahoma,Governor,Dax Ewbank,REP,550198,0,0,14,14,
Oklahoma,Governor,Chad Moody,REP,550198,0,0,27,27,
Oklahoma,Governor,Mary Fallin,REP,550198,0,0,90,90,
Oklahoma,Superintendent of Public Instruction,Brian Kelly,REP,550198,0,0,15,15,
Oklahoma,Superintendent of Public Instruction,Janet Costello Barresi,REP,550198,0,0,58,58,
Oklahoma,Superintendent of Public Instruction,Joy Hofmeister,REP,550198,0,0,56,56,
Oklahoma,Insurance Commissioner,Bill Viner,REP,550198,0,0,34,34,
Oklahoma,Insurance Commissioner,John Doak,REP,550198,0,0,83,83,
Oklahoma,Corporation Commissioner,Todd Hiett,REP,550198,0,0,48,48,
Oklahoma,Corporation Commissioner,Cliff Branan,REP,550198,0,0,70,70,
Oklahoma,U.S. Senate,Evelyn Rogers,REP,550198,0,0,9,9,
Oklahoma,U.S. Senate,Rob Moye,REP,550198,0,0,2,2,
Oklahoma,U.S. Senate,D. Jean Mcbride-Samuels,REP,550198,0,0,6,6,
Oklahoma,U.S. Senate,Jim Inhofe,REP,550198,0,0,108,108,
Oklahoma,U.S. Senate,Erick Paul Wyatt,REP,550198,0,0,2,2,
Oklahoma,U.S. Senate,Andy Craig,REP,550198,0,0,0,0,
Oklahoma,U.S. Senate,T. Shannon,REP,550198,0,0,36,36,
Oklahoma,U.S. Senate,Randy Brogdon,REP,550198,0,0,5,5,
Oklahoma,U.S. Senate,Eric Mccray,REP,550198,0,0,3,3,
Oklahoma,U.S. Senate,Kevin Crow,REP,550198,0,0,6,6,
Oklahoma,U.S. Senate,James Lankford,REP,550198,0,0,80,80,
Oklahoma,U.S. Senate,Jason Weger,REP,550198,0,0,1,1,
Oklahoma,U.S. House,Shane David Jett,REP,550198,0,0,15,15,05
Oklahoma,U.S. House,Patrice Douglas,REP,550198,0,0,23,23,05
Oklahoma,U.S. House,Mike Turner,REP,550198,0,0,20,20,05
Oklahoma,U.S. House,Steve Russell,REP,550198,0,0,35,35,05
Oklahoma,U.S. House,Harvey Sparks,REP,550198,0,0,11,11,05
Oklahoma,U.S. House,Clark Jolley,REP,550198,0,0,18,18,05
Oklahoma,Superintendent of Public Instruction,John Cox,DEM,550199,0,0,36,36,
Oklahoma,Superintendent of Public Instruction,Jack Jr.,DEM,550199,0,0,20,20,
Oklahoma,Superintendent of Public Instruction,Ivan Holmes,DEM,550199,0,0,13,13,
Oklahoma,Superintendent of Public Instruction,Freda Deskin,DEM,550199,0,0,123,123,
Oklahoma,U.S. Senate,Patrick Michael Hayes,DEM,550199,0,0,16,16,
Oklahoma,U.S. Senate,Jim Rogers,DEM,550199,0,0,21,21,
Oklahoma,U.S. Senate,Connie Johnson,DEM,550199,0,0,154,154,
Oklahoma,U.S. House,Tom Guild,DEM,550199,0,0,46,46,05
Oklahoma,U.S. House,Al Mcaffrey,DEM,550199,0,0,138,138,05
Oklahoma,U.S. House,Leona Leonard,DEM,550199,0,0,13,13,05
Oklahoma,State Senate,Wilfredo Santos Rivera,DEM,550199,0,0,13,13,46
Oklahoma,State Senate,Kay Floyd,DEM,550199,0,0,184,184,46
Oklahoma,Governor,Dax Ewbank,REP,550199,0,0,12,12,
Oklahoma,Governor,Chad Moody,REP,550199,0,0,36,36,
Oklahoma,Governor,Mary Fallin,REP,550199,0,0,101,101,
Oklahoma,Superintendent of Public Instruction,Brian Kelly,REP,550199,0,0,27,27,
Oklahoma,Superintendent of Public Instruction,Janet Costello Barresi,REP,550199,0,0,64,64,
Oklahoma,Superintendent of Public Instruction,Joy Hofmeister,REP,550199,0,0,60,60,
Oklahoma,Insurance Commissioner,Bill Viner,REP,550199,0,0,29,29,
Oklahoma,Insurance Commissioner,John Doak,REP,550199,0,0,103,103,
Oklahoma,Corporation Commissioner,Todd Hiett,REP,550199,0,0,48,48,
Oklahoma,Corporation Commissioner,Cliff Branan,REP,550199,0,0,81,81,
Oklahoma,U.S. Senate,Evelyn Rogers,REP,550199,0,0,14,14,
Oklahoma,U.S. Senate,Rob Moye,REP,550199,0,0,4,4,
Oklahoma,U.S. Senate,D. Jean Mcbride-Samuels,REP,550199,0,0,3,3,
Oklahoma,U.S. Senate,Jim Inhofe,REP,550199,0,0,125,125,
Oklahoma,U.S. Senate,Erick Paul Wyatt,REP,550199,0,0,5,5,
Oklahoma,U.S. Senate,Andy Craig,REP,550199,0,0,2,2,
Oklahoma,U.S. Senate,T. Shannon,REP,550199,0,0,37,37,
Oklahoma,U.S. Senate,Randy Brogdon,REP,550199,0,0,6,6,
Oklahoma,U.S. Senate,Eric Mccray,REP,550199,0,0,2,2,
Oklahoma,U.S. Senate,Kevin Crow,REP,550199,0,0,3,3,
Oklahoma,U.S. Senate,James Lankford,REP,550199,0,0,104,104,
Oklahoma,U.S. Senate,Jason Weger,REP,550199,0,0,0,0,
Oklahoma,U.S. House,Shane David Jett,REP,550199,0,0,21,21,05
Oklahoma,U.S. House,Patrice Douglas,REP,550199,0,0,33,33,05
Oklahoma,U.S. House,Mike Turner,REP,550199,0,0,22,22,05
Oklahoma,U.S. House,Steve Russell,REP,550199,0,0,31,31,05
Oklahoma,U.S. House,Harvey Sparks,REP,550199,0,0,10,10,05
Oklahoma,U.S. House,Clark Jolley,REP,550199,0,0,26,26,05
Oklahoma,Superintendent of Public Instruction,John Cox,DEM,550200,0,0,70,70,
Oklahoma,Superintendent of Public Instruction,Jack Jr.,DEM,550200,0,0,47,47,
Oklahoma,Superintendent of Public Instruction,Ivan Holmes,DEM,550200,0,0,38,38,
Oklahoma,Superintendent of Public Instruction,Freda Deskin,DEM,550200,0,0,149,149,
Oklahoma,U.S. Senate,Patrick Michael Hayes,DEM,550200,0,0,26,26,
Oklahoma,U.S. Senate,Jim Rogers,DEM,550200,0,0,24,24,
Oklahoma,U.S. Senate,Connie Johnson,DEM,550200,0,0,262,262,
Oklahoma,U.S. House,Tom Guild,DEM,550200,0,0,56,56,05
Oklahoma,U.S. House,Al Mcaffrey,DEM,550200,0,0,238,238,05
Oklahoma,U.S. House,Leona Leonard,DEM,550200,0,0,34,34,05
Oklahoma,State Senate,Wilfredo Santos Rivera,DEM,550200,0,0,38,38,46
Oklahoma,State Senate,Kay Floyd,DEM,550200,0,0,288,288,46
Oklahoma,State House,John Gibbons,DEM,550200,0,0,58,58,88
Oklahoma,State House,Mark Faulk,DEM,550200,0,0,62,62,88
Oklahoma,State House,Paula Sophia,DEM,550200,0,0,105,105,88
Oklahoma,State House,Jason Dunnington,DEM,550200,0,0,104,104,88
Oklahoma,Governor,Dax Ewbank,REP,550200,0,0,17,17,
Oklahoma,Governor,Chad Moody,REP,550200,0,0,47,47,
Oklahoma,Governor,Mary Fallin,REP,550200,0,0,91,91,
Oklahoma,Superintendent of Public Instruction,Brian Kelly,REP,550200,0,0,27,27,
Oklahoma,Superintendent of Public Instruction,Janet Costello Barresi,REP,550200,0,0,56,56,
Oklahoma,Superintendent of Public Instruction,Joy Hofmeister,REP,550200,0,0,68,68,
Oklahoma,Insurance Commissioner,Bill Viner,REP,550200,0,0,33,33,
Oklahoma,Insurance Commissioner,John Doak,REP,550200,0,0,104,104,
Oklahoma,Corporation Commissioner,Todd Hiett,REP,550200,0,0,66,66,
Oklahoma,Corporation Commissioner,Cliff Branan,REP,550200,0,0,71,71,
Oklahoma,U.S. Senate,Evelyn Rogers,REP,550200,0,0,17,17,
Oklahoma,U.S. Senate,Rob Moye,REP,550200,0,0,3,3,
Oklahoma,U.S. Senate,D. Jean Mcbride-Samuels,REP,550200,0,0,3,3,
Oklahoma,U.S. Senate,Jim Inhofe,REP,550200,0,0,118,118,
Oklahoma,U.S. Senate,Erick Paul Wyatt,REP,550200,0,0,9,9,
Oklahoma,U.S. Senate,Andy Craig,REP,550200,0,0,1,1,
Oklahoma,U.S. Senate,T. Shannon,REP,550200,0,0,44,44,
Oklahoma,U.S. Senate,Randy Brogdon,REP,550200,0,0,7,7,
Oklahoma,U.S. Senate,Eric Mccray,REP,550200,0,0,5,5,
Oklahoma,U.S. Senate,Kevin Crow,REP,550200,0,0,4,4,
Oklahoma,U.S. Senate,James Lankford,REP,550200,0,0,93,93,
Oklahoma,U.S. Senate,Jason Weger,REP,550200,0,0,1,1,
Oklahoma,U.S. House,Shane David Jett,REP,550200,0,0,13,13,05
Oklahoma,U.S. House,Patrice Douglas,REP,550200,0,0,39,39,05
Oklahoma,U.S. House,Mike Turner,REP,550200,0,0,18,18,05
Oklahoma,U.S. House,Steve Russell,REP,550200,0,0,35,35,05
Oklahoma,U.S. House,Harvey Sparks,REP,550200,0,0,10,10,05
Oklahoma,U.S. House,Clark Jolley,REP,550200,0,0,32,32,05
Oklahoma,Superintendent of Public Instruction,John Cox,DEM,550201,0,0,40,40,
Oklahoma,Superintendent of Public Instruction,Jack Jr.,DEM,550201,0,0,15,15,
Oklahoma,Superintendent of Public Instruction,Ivan Holmes,DEM,550201,0,0,20,20,
Oklahoma,Superintendent of Public Instruction,Freda Deskin,DEM,550201,0,0,80,80,
Oklahoma,U.S. Senate,Patrick Michael Hayes,DEM,550201,0,0,25,25,
Oklahoma,U.S. Senate,Jim Rogers,DEM,550201,0,0,24,24,
Oklahoma,U.S. Senate,Connie Johnson,DEM,550201,0,0,108,108,
Oklahoma,U.S. House,Tom Guild,DEM,550201,0,0,37,37,05
Oklahoma,U.S. House,Al Mcaffrey,DEM,550201,0,0,102,102,05
Oklahoma,U.S. House,Leona Leonard,DEM,550201,0,0,22,22,05
Oklahoma,State House,John Gibbons,DEM,550201,0,0,32,32,88
Oklahoma,State House,Mark Faulk,DEM,550201,0,0,40,40,88
Oklahoma,State House,Paula Sophia,DEM,550201,0,0,34,34,88
Oklahoma,State House,Jason Dunnington,DEM,550201,0,0,54,54,88
Oklahoma,Governor,Dax Ewbank,REP,550201,0,0,4,4,
Oklahoma,Governor,Chad Moody,REP,550201,0,0,17,17,
Oklahoma,Governor,Mary Fallin,REP,550201,0,0,58,58,
Oklahoma,Superintendent of Public Instruction,Brian Kelly,REP,550201,0,0,24,24,
Oklahoma,Superintendent of Public Instruction,Janet Costello Barresi,REP,550201,0,0,37,37,
Oklahoma,Superintendent of Public Instruction,Joy Hofmeister,REP,550201,0,0,16,16,
Oklahoma,Insurance Commissioner,Bill Viner,REP,550201,0,0,18,18,
Oklahoma,Insurance Commissioner,John Doak,REP,550201,0,0,57,57,
Oklahoma,Corporation Commissioner,Todd Hiett,REP,550201,0,0,26,26,
Oklahoma,Corporation Commissioner,Cliff Branan,REP,550201,0,0,47,47,
Oklahoma,U.S. Senate,Evelyn Rogers,REP,550201,0,0,7,7,
Oklahoma,U.S. Senate,Rob Moye,REP,550201,0,0,2,2,
Oklahoma,U.S. Senate,D. Jean Mcbride-Samuels,REP,550201,0,0,6,6,
Oklahoma,U.S. Senate,Jim Inhofe,REP,550201,0,0,59,59,
Oklahoma,U.S. Senate,Erick Paul Wyatt,REP,550201,0,0,2,2,
Oklahoma,U.S. Senate,Andy Craig,REP,550201,0,0,1,1,
Oklahoma,U.S. Senate,T. Shannon,REP,550201,0,0,11,11,
Oklahoma,U.S. Senate,Randy Brogdon,REP,550201,0,0,1,1,
Oklahoma,U.S. Senate,Eric Mccray,REP,550201,0,0,0,0,
Oklahoma,U.S. Senate,Kevin Crow,REP,550201,0,0,5,5,
Oklahoma,U.S. Senate,James Lankford,REP,550201,0,0,59,59,
Oklahoma,U.S. Senate,Jason Weger,REP,550201,0,0,1,1,
Oklahoma,U.S. House,Shane David Jett,REP,550201,0,0,5,5,05
Oklahoma,U.S. House,Patrice Douglas,REP,550201,0,0,18,18,05
Oklahoma,U.S. House,Mike Turner,REP,550201,0,0,14,14,05
Oklahoma,U.S. House,Steve Russell,REP,550201,0,0,23,23,05
Oklahoma,U.S. House,Harvey Sparks,REP,550201,0,0,4,4,05
Oklahoma,U.S. House,Clark Jolley,REP,550201,0,0,12,12,05
Oklahoma,State Senate,Ervin Yen,REP,550201,0,0,21,21,40
Oklahoma,State Senate,Joe Howell,REP,550201,0,0,5,5,40
Oklahoma,State Senate,Michael Taylor,REP,550201,0,0,12,12,40
Oklahoma,State Senate,Brian Winslow,REP,550201,0,0,18,18,40
Oklahoma,State Senate,Steve Kern,REP,550201,0,0,11,11,40
Oklahoma,State Senate,David Hooten,REP,550201,0,0,11,11,40
Oklahoma,Superintendent of Public Instruction,John Cox,DEM,550202,0,0,23,23,
Oklahoma,Superintendent of Public Instruction,Jack Jr.,DEM,550202,0,0,16,16,
Oklahoma,Superintendent of Public Instruction,Ivan Holmes,DEM,550202,0,0,22,22,
Oklahoma,Superintendent of Public Instruction,Freda Deskin,DEM,550202,0,0,64,64,
Oklahoma,U.S. Senate,Patrick Michael Hayes,DEM,550202,0,0,18,18,
Oklahoma,U.S. Senate,Jim Rogers,DEM,550202,0,0,19,19,
Oklahoma,U.S. Senate,Connie Johnson,DEM,550202,0,0,90,90,
Oklahoma,U.S. House,Tom Guild,DEM,550202,0,0,32,32,05
Oklahoma,U.S. House,Al Mcaffrey,DEM,550202,0,0,85,85,05
Oklahoma,U.S. House,Leona Leonard,DEM,550202,0,0,17,17,05
Oklahoma,State House,John Gibbons,DEM,550202,0,0,16,16,88
Oklahoma,State House,Mark Faulk,DEM,550202,0,0,39,39,88
Oklahoma,State House,Paula Sophia,DEM,550202,0,0,34,34,88
Oklahoma,State House,Jason Dunnington,DEM,550202,0,0,46,46,88
Oklahoma,Governor,Dax Ewbank,REP,550202,0,0,14,14,
Oklahoma,Governor,Chad Moody,REP,550202,0,0,22,22,
Oklahoma,Governor,Mary Fallin,REP,550202,0,0,62,62,
Oklahoma,Superintendent of Public Instruction,Brian Kelly,REP,550202,0,0,26,26,
Oklahoma,Superintendent of Public Instruction,Janet Costello Barresi,REP,550202,0,0,28,28,
Oklahoma,Superintendent of Public Instruction,Joy Hofmeister,REP,550202,0,0,41,41,
Oklahoma,Insurance Commissioner,Bill Viner,REP,550202,0,0,19,19,
Oklahoma,Insurance Commissioner,John Doak,REP,550202,0,0,70,70,
Oklahoma,Corporation Commissioner,Todd Hiett,REP,550202,0,0,51,51,
Oklahoma,Corporation Commissioner,Cliff Branan,REP,550202,0,0,36,36,
Oklahoma,U.S. Senate,Evelyn Rogers,REP,550202,0,0,9,9,
Oklahoma,U.S. Senate,Rob Moye,REP,550202,0,0,0,0,
Oklahoma,U.S. Senate,D. Jean Mcbride-Samuels,REP,550202,0,0,2,2,
Oklahoma,U.S. Senate,Jim Inhofe,REP,550202,0,0,75,75,
Oklahoma,U.S. Senate,Erick Paul Wyatt,REP,550202,0,0,7,7,
Oklahoma,U.S. Senate,Andy Craig,REP,550202,0,0,1,1,
Oklahoma,U.S. Senate,T. Shannon,REP,550202,0,0,33,33,
Oklahoma,U.S. Senate,Randy Brogdon,REP,550202,0,0,4,4,
Oklahoma,U.S. Senate,Eric Mccray,REP,550202,0,0,1,1,
Oklahoma,U.S. Senate,Kevin Crow,REP,550202,0,0,1,1,
Oklahoma,U.S. Senate,James Lankford,REP,550202,0,0,55,55,
Oklahoma,U.S. Senate,Jason Weger,REP,550202,0,0,1,1,
Oklahoma,U.S. House,Shane David Jett,REP,550202,0,0,13,13,05
Oklahoma,U.S. House,Patrice Douglas,REP,550202,0,0,20,20,05
Oklahoma,U.S. House,Mike Turner,REP,550202,0,0,13,13,05
Oklahoma,U.S. House,Steve Russell,REP,550202,0,0,17,17,05
Oklahoma,U.S. House,Harvey Sparks,REP,550202,0,0,16,16,05
Oklahoma,U.S. House,Clark Jolley,REP,550202,0,0,13,13,05
Oklahoma,State Senate,Ervin Yen,REP,550202,0,0,41,41,40
Oklahoma,State Senate,Joe Howell,REP,550202,0,0,7,7,40
Oklahoma,State Senate,Michael Taylor,REP,550202,0,0,15,15,40
Oklahoma,State Senate,Brian Winslow,REP,550202,0,0,7,7,40
Oklahoma,State Senate,Steve Kern,REP,550202,0,0,14,14,40
Oklahoma,State Senate,David Hooten,REP,550202,0,0,7,7,40
Oklahoma,Superintendent of Public Instruction,John Cox,DEM,550203,0,0,31,31,
Oklahoma,Superintendent of Public Instruction,Jack Jr.,DEM,550203,0,0,12,12,
Oklahoma,Superintendent of Public Instruction,Ivan Holmes,DEM,550203,0,0,12,12,
Oklahoma,Superintendent of Public Instruction,Freda Deskin,DEM,550203,0,0,67,67,
Oklahoma,U.S. Senate,Patrick Michael Hayes,DEM,550203,0,0,21,21,
Oklahoma,U.S. Senate,Jim Rogers,DEM,550203,0,0,10,10,
Oklahoma,U.S. Senate,Connie Johnson,DEM,550203,0,0,90,90,
Oklahoma,U.S. House,Tom Guild,DEM,550203,0,0,32,32,05
Oklahoma,U.S. House,Al Mcaffrey,DEM,550203,0,0,72,72,05
Oklahoma,U.S. House,Leona Leonard,DEM,550203,0,0,20,20,05
Oklahoma,State Senate,Wilfredo Santos Rivera,DEM,550203,0,0,21,21,46
Oklahoma,State Senate,Kay Floyd,DEM,550203,0,0,102,102,46
Oklahoma,State House,John Gibbons,DEM,550203,0,0,16,16,88
Oklahoma,State House,Mark Faulk,DEM,550203,0,0,30,30,88
Oklahoma,State House,Paula Sophia,DEM,550203,0,0,35,35,88
Oklahoma,State House,Jason Dunnington,DEM,550203,0,0,47,47,88
Oklahoma,Governor,Dax Ewbank,REP,550203,0,0,7,7,
Oklahoma,Governor,Chad Moody,REP,550203,0,0,21,21,
Oklahoma,Governor,Mary Fallin,REP,550203,0,0,54,54,
Oklahoma,Superintendent of Public Instruction,Brian Kelly,REP,550203,0,0,18,18,
Oklahoma,Superintendent of Public Instruction,Janet Costello Barresi,REP,550203,0,0,23,23,
Oklahoma,Superintendent of Public Instruction,Joy Hofmeister,REP,550203,0,0,42,42,
Oklahoma,Insurance Commissioner,Bill Viner,REP,550203,0,0,24,24,
Oklahoma,Insurance Commissioner,John Doak,REP,550203,0,0,51,51,
Oklahoma,Corporation Commissioner,Todd Hiett,REP,550203,0,0,44,44,
Oklahoma,Corporation Commissioner,Cliff Branan,REP,550203,0,0,35,35,
Oklahoma,U.S. Senate,Evelyn Rogers,REP,550203,0,0,6,6,
Oklahoma,U.S. Senate,Rob Moye,REP,550203,0,0,2,2,
Oklahoma,U.S. Senate,D. Jean Mcbride-Samuels,REP,550203,0,0,5,5,
Oklahoma,U.S. Senate,Jim Inhofe,REP,550203,0,0,61,61,
Oklahoma,U.S. Senate,Erick Paul Wyatt,REP,550203,0,0,9,9,
Oklahoma,U.S. Senate,Andy Craig,REP,550203,0,0,5,5,
Oklahoma,U.S. Senate,T. Shannon,REP,550203,0,0,15,15,
Oklahoma,U.S. Senate,Randy Brogdon,REP,550203,0,0,3,3,
Oklahoma,U.S. Senate,Eric Mccray,REP,550203,0,0,0,0,
Oklahoma,U.S. Senate,Kevin Crow,REP,550203,0,0,3,3,
Oklahoma,U.S. Senate,James Lankford,REP,550203,0,0,53,53,
Oklahoma,U.S. Senate,Jason Weger,REP,550203,0,0,4,4,
Oklahoma,U.S. House,Shane David Jett,REP,550203,0,0,9,9,05
Oklahoma,U.S. House,Patrice Douglas,REP,550203,0,0,17,17,05
Oklahoma,U.S. House,Mike Turner,REP,550203,0,0,12,12,05
Oklahoma,U.S. House,Steve Russell,REP,550203,0,0,19,19,05
Oklahoma,U.S. House,Harvey Sparks,REP,550203,0,0,12,12,05
Oklahoma,U.S. House,Clark Jolley,REP,550203,0,0,12,12,05
Oklahoma,Superintendent of Public Instruction,John Cox,DEM,550204,0,0,63,63,
Oklahoma,Superintendent of Public Instruction,Jack Jr.,DEM,550204,0,0,22,22,
Oklahoma,Superintendent of Public Instruction,Ivan Holmes,DEM,550204,0,0,26,26,
Oklahoma,Superintendent of Public Instruction,Freda Deskin,DEM,550204,0,0,238,238,
Oklahoma,U.S. Senate,Patrick Michael Hayes,DEM,550204,0,0,41,41,
Oklahoma,U.S. Senate,Jim Rogers,DEM,550204,0,0,36,36,
Oklahoma,U.S. Senate,Connie Johnson,DEM,550204,0,0,266,266,
Oklahoma,U.S. House,Tom Guild,DEM,550204,0,0,38,38,05
Oklahoma,U.S. House,Al Mcaffrey,DEM,550204,0,0,330,330,05
Oklahoma,U.S. House,Leona Leonard,DEM,550204,0,0,15,15,05
Oklahoma,State Senate,Wilfredo Santos Rivera,DEM,550204,0,0,37,37,46
Oklahoma,State Senate,Kay Floyd,DEM,550204,0,0,349,349,46
Oklahoma,State House,John Gibbons,DEM,550204,0,0,62,62,88
Oklahoma,State House,Mark Faulk,DEM,550204,0,0,58,58,88
Oklahoma,State House,Paula Sophia,DEM,550204,0,0,77,77,88
Oklahoma,State House,Jason Dunnington,DEM,550204,0,0,191,191,88
Oklahoma,Governor,Dax Ewbank,REP,550204,0,0,21,21,
Oklahoma,Governor,Chad Moody,REP,550204,0,0,58,58,
Oklahoma,Governor,Mary Fallin,REP,550204,0,0,166,166,
Oklahoma,Superintendent of Public Instruction,Brian Kelly,REP,550204,0,0,38,38,
Oklahoma,Superintendent of Public Instruction,Janet Costello Barresi,REP,550204,0,0,102,102,
Oklahoma,Superintendent of Public Instruction,Joy Hofmeister,REP,550204,0,0,101,101,
Oklahoma,Insurance Commissioner,Bill Viner,REP,550204,0,0,52,52,
Oklahoma,Insurance Commissioner,John Doak,REP,550204,0,0,156,156,
Oklahoma,Corporation Commissioner,Todd Hiett,REP,550204,0,0,96,96,
Oklahoma,Corporation Commissioner,Cliff Branan,REP,550204,0,0,120,120,
Oklahoma,U.S. Senate,Evelyn Rogers,REP,550204,0,0,18,18,
Oklahoma,U.S. Senate,Rob Moye,REP,550204,0,0,4,4,
Oklahoma,U.S. Senate,D. Jean Mcbride-Samuels,REP,550204,0,0,9,9,
Oklahoma,U.S. Senate,Jim Inhofe,REP,550204,0,0,201,201,
Oklahoma,U.S. Senate,Erick Paul Wyatt,REP,550204,0,0,10,10,
Oklahoma,U.S. Senate,Andy Craig,REP,550204,0,0,1,1,
Oklahoma,U.S. Senate,T. Shannon,REP,550204,0,0,72,72,
Oklahoma,U.S. Senate,Randy Brogdon,REP,550204,0,0,10,10,
Oklahoma,U.S. Senate,Eric Mccray,REP,550204,0,0,1,1,
Oklahoma,U.S. Senate,Kevin Crow,REP,550204,0,0,6,6,
Oklahoma,U.S. Senate,James Lankford,REP,550204,0,0,158,158,
Oklahoma,U.S. Senate,Jason Weger,REP,550204,0,0,1,1,
Oklahoma,U.S. House,Shane David Jett,REP,550204,0,0,35,35,05
Oklahoma,U.S. House,Patrice Douglas,REP,550204,0,0,64,64,05
Oklahoma,U.S. House,Mike Turner,REP,550204,0,0,28,28,05
Oklahoma,U.S. House,Steve Russell,REP,550204,0,0,40,40,05
Oklahoma,U.S. House,Harvey Sparks,REP,550204,0,0,12,12,05
Oklahoma,U.S. House,Clark Jolley,REP,550204,0,0,47,47,05
Oklahoma,Superintendent of Public Instruction,John Cox,DEM,550205,0,0,13,13,
Oklahoma,Superintendent of Public Instruction,Jack Jr.,DEM,550205,0,0,6,6,
Oklahoma,Superintendent of Public Instruction,Ivan Holmes,DEM,550205,0,0,5,5,
Oklahoma,Superintendent of Public Instruction,Freda Deskin,DEM,550205,0,0,36,36,
Oklahoma,U.S. Senate,Patrick Michael Hayes,DEM,550205,0,0,3,3,
Oklahoma,U.S. Senate,Jim Rogers,DEM,550205,0,0,6,6,
Oklahoma,U.S. Senate,Connie Johnson,DEM,550205,0,0,54,54,
Oklahoma,U.S. House,Tom Guild,DEM,550205,0,0,13,13,05
Oklahoma,U.S. House,Al Mcaffrey,DEM,550205,0,0,38,38,05
Oklahoma,U.S. House,Leona Leonard,DEM,550205,0,0,10,10,05
Oklahoma,State Senate,Wilfredo Santos Rivera,DEM,550205,0,0,16,16,46
Oklahoma,State Senate,Kay Floyd,DEM,550205,0,0,47,47,46
Oklahoma,Governor,Dax Ewbank,REP,550205,0,0,4,4,
Oklahoma,Governor,Chad Moody,REP,550205,0,0,12,12,
Oklahoma,Governor,Mary Fallin,REP,550205,0,0,62,62,
Oklahoma,Superintendent of Public Instruction,Brian Kelly,REP,550205,0,0,18,18,
Oklahoma,Superintendent of Public Instruction,Janet Costello Barresi,REP,550205,0,0,28,28,
Oklahoma,Superintendent of Public Instruction,Joy Hofmeister,REP,550205,0,0,29,29,
Oklahoma,Insurance Commissioner,Bill Viner,REP,550205,0,0,14,14,
Oklahoma,Insurance Commissioner,John Doak,REP,550205,0,0,55,55,
Oklahoma,Corporation Commissioner,Todd Hiett,REP,550205,0,0,25,25,
Oklahoma,Corporation Commissioner,Cliff Branan,REP,550205,0,0,50,50,
Oklahoma,U.S. Senate,Evelyn Rogers,REP,550205,0,0,2,2,
Oklahoma,U.S. Senate,Rob Moye,REP,550205,0,0,4,4,
Oklahoma,U.S. Senate,D. Jean Mcbride-Samuels,REP,550205,0,0,2,2,
Oklahoma,U.S. Senate,Jim Inhofe,REP,550205,0,0,67,67,
Oklahoma,U.S. Senate,Erick Paul Wyatt,REP,550205,0,0,1,1,
Oklahoma,U.S. Senate,Andy Craig,REP,550205,0,0,0,0,
Oklahoma,U.S. Senate,T. Shannon,REP,550205,0,0,26,26,
Oklahoma,U.S. Senate,Randy Brogdon,REP,550205,0,0,1,1,
Oklahoma,U.S. Senate,Eric Mccray,REP,550205,0,0,1,1,
Oklahoma,U.S. Senate,Kevin Crow,REP,550205,0,0,1,1,
Oklahoma,U.S. Senate,James Lankford,REP,550205,0,0,48,48,
Oklahoma,U.S. Senate,Jason Weger,REP,550205,0,0,1,1,
Oklahoma,U.S. House,Shane David Jett,REP,550205,0,0,11,11,05
Oklahoma,U.S. House,Patrice Douglas,REP,550205,0,0,24,24,05
Oklahoma,U.S. House,Mike Turner,REP,550205,0,0,9,9,05
Oklahoma,U.S. House,Steve Russell,REP,550205,0,0,18,18,05
Oklahoma,U.S. House,Harvey Sparks,REP,550205,0,0,1,1,05
Oklahoma,U.S. House,Clark Jolley,REP,550205,0,0,13,13,05
Oklahoma,Superintendent of Public Instruction,John Cox,DEM,550206,0,0,11,11,
Oklahoma,Superintendent of Public Instruction,Jack Jr.,DEM,550206,0,0,5,5,
Oklahoma,Superintendent of Public Instruction,Ivan Holmes,DEM,550206,0,0,3,3,
Oklahoma,Superintendent of Public Instruction,Freda Deskin,DEM,550206,0,0,16,16,
Oklahoma,U.S. Senate,Patrick Michael Hayes,DEM,550206,0,0,4,4,
Oklahoma,U.S. Senate,Jim Rogers,DEM,550206,0,0,14,14,
Oklahoma,U.S. Senate,Connie Johnson,DEM,550206,0,0,19,19,
Oklahoma,U.S. House,Tom Guild,DEM,550206,0,0,16,16,05
Oklahoma,U.S. House,Al Mcaffrey,DEM,550206,0,0,12,12,05
Oklahoma,U.S. House,Leona Leonard,DEM,550206,0,0,10,10,05
Oklahoma,State Senate,Wilfredo Santos Rivera,DEM,550206,0,0,15,15,46
Oklahoma,State Senate,Kay Floyd,DEM,550206,0,0,23,23,46
Oklahoma,Governor,Dax Ewbank,REP,550206,0,0,2,2,
Oklahoma,Governor,Chad Moody,REP,550206,0,0,2,2,
Oklahoma,Governor,Mary Fallin,REP,550206,0,0,18,18,
Oklahoma,Superintendent of Public Instruction,Brian Kelly,REP,550206,0,0,8,8,
Oklahoma,Superintendent of Public Instruction,Janet Costello Barresi,REP,550206,0,0,9,9,
Oklahoma,Superintendent of Public Instruction,Joy Hofmeister,REP,550206,0,0,4,4,
Oklahoma,Insurance Commissioner,Bill Viner,REP,550206,0,0,4,4,
Oklahoma,Insurance Commissioner,John Doak,REP,550206,0,0,17,17,
Oklahoma,Corporation Commissioner,Todd Hiett,REP,550206,0,0,7,7,
Oklahoma,Corporation Commissioner,Cliff Branan,REP,550206,0,0,13,13,
Oklahoma,U.S. Senate,Evelyn Rogers,REP,550206,0,0,1,1,
Oklahoma,U.S. Senate,Rob Moye,REP,550206,0,0,0,0,
Oklahoma,U.S. Senate,D. Jean Mcbride-Samuels,REP,550206,0,0,1,1,
Oklahoma,U.S. Senate,Jim Inhofe,REP,550206,0,0,16,16,
Oklahoma,U.S. Senate,Erick Paul Wyatt,REP,550206,0,0,3,3,
Oklahoma,U.S. Senate,Andy Craig,REP,550206,0,0,0,0,
Oklahoma,U.S. Senate,T. Shannon,REP,550206,0,0,8,8,
Oklahoma,U.S. Senate,Randy Brogdon,REP,550206,0,0,1,1,
Oklahoma,U.S. Senate,Eric Mccray,REP,550206,0,0,0,0,
Oklahoma,U.S. Senate,Kevin Crow,REP,550206,0,0,0,0,
Oklahoma,U.S. Senate,James Lankford,REP,550206,0,0,13,13,
Oklahoma,U.S. Senate,Jason Weger,REP,550206,0,0,0,0,
Oklahoma,U.S. House,Shane David Jett,REP,550206,0,0,4,4,05
Oklahoma,U.S. House,Patrice Douglas,REP,550206,0,0,4,4,05
Oklahoma,U.S. House,Mike Turner,REP,550206,0,0,2,2,05
Oklahoma,U.S. House,Steve Russell,REP,550206,0,0,4,4,05
Oklahoma,U.S. House,Harvey Sparks,REP,550206,0,0,1,1,05
Oklahoma,U.S. House,Clark Jolley,REP,550206,0,0,6,6,05
Oklahoma,Superintendent of Public Instruction,John Cox,DEM,550207,0,0,41,41,
Oklahoma,Superintendent of Public Instruction,Jack Jr.,DEM,550207,0,0,3,3,
Oklahoma,Superintendent of Public Instruction,Ivan Holmes,DEM,550207,0,0,17,17,
Oklahoma,Superintendent of Public Instruction,Freda Deskin,DEM,550207,0,0,60,60,
Oklahoma,U.S. Senate,Patrick Michael Hayes,DEM,550207,0,0,21,21,
Oklahoma,U.S. Senate,Jim Rogers,DEM,550207,0,0,31,31,
Oklahoma,U.S. Senate,Connie Johnson,DEM,550207,0,0,67,67,
Oklahoma,U.S. House,Tom Guild,DEM,550207,0,0,50,50,05
Oklahoma,U.S. House,Al Mcaffrey,DEM,550207,0,0,34,34,05
Oklahoma,U.S. House,Leona Leonard,DEM,550207,0,0,37,37,05
Oklahoma,State Senate,Wilfredo Santos Rivera,DEM,550207,0,0,46,46,46
Oklahoma,State Senate,Kay Floyd,DEM,550207,0,0,76,76,46
Oklahoma,State House,Virginia Poindexter,DEM,550207,0,0,12,12,89
Oklahoma,State House,Shane Stone,DEM,550207,0,0,41,41,89
Oklahoma,State House,Chris Bryant,DEM,550207,0,0,16,16,89
Oklahoma,State House,Mary Sosa,DEM,550207,0,0,64,64,89
Oklahoma,Governor,Dax Ewbank,REP,550207,0,0,8,8,
Oklahoma,Governor,Chad Moody,REP,550207,0,0,11,11,
Oklahoma,Governor,Mary Fallin,REP,550207,0,0,58,58,
Oklahoma,Superintendent of Public Instruction,Brian Kelly,REP,550207,0,0,30,30,
Oklahoma,Superintendent of Public Instruction,Janet Costello Barresi,REP,550207,0,0,25,25,
Oklahoma,Superintendent of Public Instruction,Joy Hofmeister,REP,550207,0,0,22,22,
Oklahoma,Insurance Commissioner,Bill Viner,REP,550207,0,0,16,16,
Oklahoma,Insurance Commissioner,John Doak,REP,550207,0,0,60,60,
Oklahoma,Corporation Commissioner,Todd Hiett,REP,550207,0,0,32,32,
Oklahoma,Corporation Commissioner,Cliff Branan,REP,550207,0,0,44,44,
Oklahoma,U.S. Senate,Evelyn Rogers,REP,550207,0,0,1,1,
Oklahoma,U.S. Senate,Rob Moye,REP,550207,0,0,4,4,
Oklahoma,U.S. Senate,D. Jean Mcbride-Samuels,REP,550207,0,0,1,1,
Oklahoma,U.S. Senate,Jim Inhofe,REP,550207,0,0,68,68,
Oklahoma,U.S. Senate,Erick Paul Wyatt,REP,550207,0,0,3,3,
Oklahoma,U.S. Senate,Andy Craig,REP,550207,0,0,0,0,
Oklahoma,U.S. Senate,T. Shannon,REP,550207,0,0,21,21,
Oklahoma,U.S. Senate,Randy Brogdon,REP,550207,0,0,0,0,
Oklahoma,U.S. Senate,Eric Mccray,REP,550207,0,0,1,1,
Oklahoma,U.S. Senate,Kevin Crow,REP,550207,0,0,3,3,
Oklahoma,U.S. Senate,James Lankford,REP,550207,0,0,53,53,
Oklahoma,U.S. Senate,Jason Weger,REP,550207,0,0,0,0,
Oklahoma,U.S. House,Shane David Jett,REP,550207,0,0,12,12,05
Oklahoma,U.S. House,Patrice Douglas,REP,550207,0,0,16,16,05
Oklahoma,U.S. House,Mike Turner,REP,550207,0,0,14,14,05
Oklahoma,U.S. House,Steve Russell,REP,550207,0,0,11,11,05
Oklahoma,U.S. House,Harvey Sparks,REP,550207,0,0,7,7,05
Oklahoma,U.S. House,Clark Jolley,REP,550207,0,0,18,18,05
Oklahoma,Superintendent of Public Instruction,John Cox,DEM,550208,0,0,2,2,
Oklahoma,Superintendent of Public Instruction,Jack Jr.,DEM,550208,0,0,0,0,
Oklahoma,Superintendent of Public Instruction,Ivan Holmes,DEM,550208,0,0,0,0,
Oklahoma,Superintendent of Public Instruction,Freda Deskin,DEM,550208,0,0,1,1,
Oklahoma,U.S. Senate,Patrick Michael Hayes,DEM,550208,0,0,2,2,
Oklahoma,U.S. Senate,Jim Rogers,DEM,550208,0,0,0,0,
Oklahoma,U.S. Senate,Connie Johnson,DEM,550208,0,0,1,1,
Oklahoma,U.S. House,Tom Guild,DEM,550208,0,0,1,1,05
Oklahoma,U.S. House,Al Mcaffrey,DEM,550208,0,0,0,0,05
Oklahoma,U.S. House,Leona Leonard,DEM,550208,0,0,0,0,05
Oklahoma,State House,Virginia Poindexter,DEM,550208,0,0,1,1,89
Oklahoma,State House,Shane Stone,DEM,550208,0,0,0,0,89
Oklahoma,State House,Chris Bryant,DEM,550208,0,0,2,2,89
Oklahoma,State House,Mary Sosa,DEM,550208,0,0,0,0,89
Oklahoma,Governor,Dax Ewbank,REP,550208,0,0,0,0,
Oklahoma,Governor,Chad Moody,REP,550208,0,0,0,0,
Oklahoma,Governor,Mary Fallin,REP,550208,0,0,0,0,
Oklahoma,Superintendent of Public Instruction,Brian Kelly,REP,550208,0,0,0,0,
Oklahoma,Superintendent of Public Instruction,Janet Costello Barresi,REP,550208,0,0,0,0,
Oklahoma,Superintendent of Public Instruction,Joy Hofmeister,REP,550208,0,0,0,0,
Oklahoma,Insurance Commissioner,Bill Viner,REP,550208,0,0,0,0,
Oklahoma,Insurance Commissioner,John Doak,REP,550208,0,0,0,0,
Oklahoma,Corporation Commissioner,Todd Hiett,REP,550208,0,0,0,0,
Oklahoma,Corporation Commissioner,Cliff Branan,REP,550208,0,0,0,0,
Oklahoma,U.S. Senate,Evelyn Rogers,REP,550208,0,0,0,0,
Oklahoma,U.S. Senate,Rob Moye,REP,550208,0,0,0,0,
Oklahoma,U.S. Senate,D. Jean Mcbride-Samuels,REP,550208,0,0,0,0,
Oklahoma,U.S. Senate,Jim Inhofe,REP,550208,0,0,0,0,
Oklahoma,U.S. Senate,Erick Paul Wyatt,REP,550208,0,0,0,0,
Oklahoma,U.S. Senate,Andy Craig,REP,550208,0,0,0,0,
Oklahoma,U.S. Senate,T. Shannon,REP,550208,0,0,0,0,
Oklahoma,U.S. Senate,Randy Brogdon,REP,550208,0,0,0,0,
Oklahoma,U.S. Senate,Eric Mccray,REP,550208,0,0,0,0,
Oklahoma,U.S. Senate,Kevin Crow,REP,550208,0,0,0,0,
Oklahoma,U.S. Senate,James Lankford,REP,550208,0,0,0,0,
Oklahoma,U.S. Senate,Jason Weger,REP,550208,0,0,0,0,
Oklahoma,U.S. House,Shane David Jett,REP,550208,0,0,0,0,05
Oklahoma,U.S. House,Patrice Douglas,REP,550208,0,0,0,0,05
Oklahoma,U.S. House,Mike Turner,REP,550208,0,0,0,0,05
Oklahoma,U.S. House,Steve Russell,REP,550208,0,0,0,0,05
Oklahoma,U.S. House,Harvey Sparks,REP,550208,0,0,0,0,05
Oklahoma,U.S. House,Clark Jolley,REP,550208,0,0,0,0,05
Oklahoma,Superintendent of Public Instruction,John Cox,DEM,550209,0,0,30,30,
Oklahoma,Superintendent of Public Instruction,Jack Jr.,DEM,550209,0,0,9,9,
Oklahoma,Superintendent of Public Instruction,Ivan Holmes,DEM,550209,0,0,21,21,
Oklahoma,Superintendent of Public Instruction,Freda Deskin,DEM,550209,0,0,47,47,
Oklahoma,U.S. Senate,Patrick Michael Hayes,DEM,550209,0,0,14,14,
Oklahoma,U.S. Senate,Jim Rogers,DEM,550209,0,0,27,27,
Oklahoma,U.S. Senate,Connie Johnson,DEM,550209,0,0,63,63,
Oklahoma,U.S. House,Tom Guild,DEM,550209,0,0,48,48,05
Oklahoma,U.S. House,Al Mcaffrey,DEM,550209,0,0,27,27,05
Oklahoma,U.S. House,Leona Leonard,DEM,550209,0,0,31,31,05
Oklahoma,State Senate,Wilfredo Santos Rivera,DEM,550209,0,0,41,41,46
Oklahoma,State Senate,Kay Floyd,DEM,550209,0,0,67,67,46
Oklahoma,State House,Virginia Poindexter,DEM,550209,0,0,12,12,89
Oklahoma,State House,Shane Stone,DEM,550209,0,0,32,32,89
Oklahoma,State House,Chris Bryant,DEM,550209,0,0,18,18,89
Oklahoma,State House,Mary Sosa,DEM,550209,0,0,54,54,89
Oklahoma,Governor,Dax Ewbank,REP,550209,0,0,4,4,
Oklahoma,Governor,Chad Moody,REP,550209,0,0,8,8,
Oklahoma,Governor,Mary Fallin,REP,550209,0,0,57,57,
Oklahoma,Superintendent of Public Instruction,Brian Kelly,REP,550209,0,0,20,20,
Oklahoma,Superintendent of Public Instruction,Janet Costello Barresi,REP,550209,0,0,18,18,
Oklahoma,Superintendent of Public Instruction,Joy Hofmeister,REP,550209,0,0,31,31,
Oklahoma,Insurance Commissioner,Bill Viner,REP,550209,0,0,8,8,
Oklahoma,Insurance Commissioner,John Doak,REP,550209,0,0,60,60,
Oklahoma,Corporation Commissioner,Todd Hiett,REP,550209,0,0,29,29,
Oklahoma,Corporation Commissioner,Cliff Branan,REP,550209,0,0,40,40,
Oklahoma,U.S. Senate,Evelyn Rogers,REP,550209,0,0,8,8,
Oklahoma,U.S. Senate,Rob Moye,REP,550209,0,0,0,0,
Oklahoma,U.S. Senate,D. Jean Mcbride-Samuels,REP,550209,0,0,1,1,
Oklahoma,U.S. Senate,Jim Inhofe,REP,550209,0,0,55,55,
Oklahoma,U.S. Senate,Erick Paul Wyatt,REP,550209,0,0,5,5,
Oklahoma,U.S. Senate,Andy Craig,REP,550209,0,0,1,1,
Oklahoma,U.S. Senate,T. Shannon,REP,550209,0,0,18,18,
Oklahoma,U.S. Senate,Randy Brogdon,REP,550209,0,0,3,3,
Oklahoma,U.S. Senate,Eric Mccray,REP,550209,0,0,0,0,
Oklahoma,U.S. Senate,Kevin Crow,REP,550209,0,0,0,0,
Oklahoma,U.S. Senate,James Lankford,REP,550209,0,0,45,45,
Oklahoma,U.S. Senate,Jason Weger,REP,550209,0,0,2,2,
Oklahoma,U.S. House,Shane David Jett,REP,550209,0,0,13,13,05
Oklahoma,U.S. House,Patrice Douglas,REP,550209,0,0,9,9,05
Oklahoma,U.S. House,Mike Turner,REP,550209,0,0,18,18,05
Oklahoma,U.S. House,Steve Russell,REP,550209,0,0,15,15,05
Oklahoma,U.S. House,Harvey Sparks,REP,550209,0,0,4,4,05
Oklahoma,U.S. House,Clark Jolley,REP,550209,0,0,10,10,05
Oklahoma,Superintendent of Public Instruction,John Cox,DEM,550210,0,0,25,25,
Oklahoma,Superintendent of Public Instruction,Jack Jr.,DEM,550210,0,0,13,13,
Oklahoma,Superintendent of Public Instruction,Ivan Holmes,DEM,550210,0,0,16,16,
Oklahoma,Superintendent of Public Instruction,Freda Deskin,DEM,550210,0,0,31,31,
Oklahoma,U.S. Senate,Patrick Michael Hayes,DEM,550210,0,0,22,22,
Oklahoma,U.S. Senate,Jim Rogers,DEM,550210,0,0,32,32,
Oklahoma,U.S. Senate,Connie Johnson,DEM,550210,0,0,28,28,
Oklahoma,U.S. House,Tom Guild,DEM,550210,0,0,35,35,05
Oklahoma,U.S. House,Al Mcaffrey,DEM,550210,0,0,34,34,05
Oklahoma,U.S. House,Leona Leonard,DEM,550210,0,0,17,17,05
Oklahoma,State Senate,Wilfredo Santos Rivera,DEM,550210,0,0,26,26,46
Oklahoma,State Senate,Kay Floyd,DEM,550210,0,0,61,61,46
Oklahoma,State House,Virginia Poindexter,DEM,550210,0,0,4,4,89
Oklahoma,State House,Shane Stone,DEM,550210,0,0,28,28,89
Oklahoma,State House,Chris Bryant,DEM,550210,0,0,24,24,89
Oklahoma,State House,Mary Sosa,DEM,550210,0,0,36,36,89
Oklahoma,Governor,Dax Ewbank,REP,550210,0,0,3,3,
Oklahoma,Governor,Chad Moody,REP,550210,0,0,10,10,
Oklahoma,Governor,Mary Fallin,REP,550210,0,0,49,49,
Oklahoma,Superintendent of Public Instruction,Brian Kelly,REP,550210,0,0,14,14,
Oklahoma,Superintendent of Public Instruction,Janet Costello Barresi,REP,550210,0,0,15,15,
Oklahoma,Superintendent of Public Instruction,Joy Hofmeister,REP,550210,0,0,32,32,
Oklahoma,Insurance Commissioner,Bill Viner,REP,550210,0,0,11,11,
Oklahoma,Insurance Commissioner,John Doak,REP,550210,0,0,47,47,
Oklahoma,Corporation Commissioner,Todd Hiett,REP,550210,0,0,30,30,
Oklahoma,Corporation Commissioner,Cliff Branan,REP,550210,0,0,29,29,
Oklahoma,U.S. Senate,Evelyn Rogers,REP,550210,0,0,5,5,
Oklahoma,U.S. Senate,Rob Moye,REP,550210,0,0,0,0,
Oklahoma,U.S. Senate,D. Jean Mcbride-Samuels,REP,550210,0,0,0,0,
Oklahoma,U.S. Senate,Jim Inhofe,REP,550210,0,0,53,53,
Oklahoma,U.S. Senate,Erick Paul Wyatt,REP,550210,0,0,3,3,
Oklahoma,U.S. Senate,Andy Craig,REP,550210,0,0,1,1,
Oklahoma,U.S. Senate,T. Shannon,REP,550210,0,0,17,17,
Oklahoma,U.S. Senate,Randy Brogdon,REP,550210,0,0,1,1,
Oklahoma,U.S. Senate,Eric Mccray,REP,550210,0,0,1,1,
Oklahoma,U.S. Senate,Kevin Crow,REP,550210,0,0,2,2,
Oklahoma,U.S. Senate,James Lankford,REP,550210,0,0,38,38,
Oklahoma,U.S. Senate,Jason Weger,REP,550210,0,0,1,1,
Oklahoma,U.S. House,Shane David Jett,REP,550210,0,0,7,7,05
Oklahoma,U.S. House,Patrice Douglas,REP,550210,0,0,11,11,05
Oklahoma,U.S. House,Mike Turner,REP,550210,0,0,14,14,05
Oklahoma,U.S. House,Steve Russell,REP,550210,0,0,16,16,05
Oklahoma,U.S. House,Harvey Sparks,REP,550210,0,0,3,3,05
Oklahoma,U.S. House,Clark Jolley,REP,550210,0,0,8,8,05
Oklahoma,Superintendent of Public Instruction,John Cox,DEM,550211,0,0,22,22,
Oklahoma,Superintendent of Public Instruction,Jack Jr.,DEM,550211,0,0,16,16,
Oklahoma,Superintendent of Public Instruction,Ivan Holmes,DEM,550211,0,0,8,8,
Oklahoma,Superintendent of Public Instruction,Freda Deskin,DEM,550211,0,0,28,28,
Oklahoma,U.S. Senate,Patrick Michael Hayes,DEM,550211,0,0,17,17,
Oklahoma,U.S. Senate,Jim Rogers,DEM,550211,0,0,27,27,
Oklahoma,U.S. Senate,Connie Johnson,DEM,550211,0,0,28,28,
Oklahoma,U.S. House,Tom Guild,DEM,550211,0,0,35,35,05
Oklahoma,U.S. House,Al Mcaffrey,DEM,550211,0,0,21,21,05
Oklahoma,U.S. House,Leona Leonard,DEM,550211,0,0,18,18,05
Oklahoma,State Senate,Wilfredo Santos Rivera,DEM,550211,0,0,28,28,46
Oklahoma,State Senate,Kay Floyd,DEM,550211,0,0,47,47,46
Oklahoma,State House,Virginia Poindexter,DEM,550211,0,0,1,1,89
Oklahoma,State House,Shane Stone,DEM,550211,0,0,36,36,89
Oklahoma,State House,Chris Bryant,DEM,550211,0,0,12,12,89
Oklahoma,State House,Mary Sosa,DEM,550211,0,0,32,32,89
Oklahoma,Governor,Dax Ewbank,REP,550211,0,0,3,3,
Oklahoma,Governor,Chad Moody,REP,550211,0,0,5,5,
Oklahoma,Governor,Mary Fallin,REP,550211,0,0,34,34,
Oklahoma,Superintendent of Public Instruction,Brian Kelly,REP,550211,0,0,11,11,
Oklahoma,Superintendent of Public Instruction,Janet Costello Barresi,REP,550211,0,0,10,10,
Oklahoma,Superintendent of Public Instruction,Joy Hofmeister,REP,550211,0,0,21,21,
Oklahoma,Insurance Commissioner,Bill Viner,REP,550211,0,0,14,14,
Oklahoma,Insurance Commissioner,John Doak,REP,550211,0,0,26,26,
Oklahoma,Corporation Commissioner,Todd Hiett,REP,550211,0,0,18,18,
Oklahoma,Corporation Commissioner,Cliff Branan,REP,550211,0,0,22,22,
Oklahoma,U.S. Senate,Evelyn Rogers,REP,550211,0,0,2,2,
Oklahoma,U.S. Senate,Rob Moye,REP,550211,0,0,2,2,
Oklahoma,U.S. Senate,D. Jean Mcbride-Samuels,REP,550211,0,0,0,0,
Oklahoma,U.S. Senate,Jim Inhofe,REP,550211,0,0,36,36,
Oklahoma,U.S. Senate,Erick Paul Wyatt,REP,550211,0,0,2,2,
Oklahoma,U.S. Senate,Andy Craig,REP,550211,0,0,0,0,
Oklahoma,U.S. Senate,T. Shannon,REP,550211,0,0,10,10,
Oklahoma,U.S. Senate,Randy Brogdon,REP,550211,0,0,1,1,
Oklahoma,U.S. Senate,Eric Mccray,REP,550211,0,0,0,0,
Oklahoma,U.S. Senate,Kevin Crow,REP,550211,0,0,0,0,
Oklahoma,U.S. Senate,James Lankford,REP,550211,0,0,29,29,
Oklahoma,U.S. Senate,Jason Weger,REP,550211,0,0,2,2,
Oklahoma,U.S. House,Shane David Jett,REP,550211,0,0,10,10,05
Oklahoma,U.S. House,Patrice Douglas,REP,550211,0,0,6,6,05
Oklahoma,U.S. House,Mike Turner,REP,550211,0,0,7,7,05
Oklahoma,U.S. House,Steve Russell,REP,550211,0,0,14,14,05
Oklahoma,U.S. House,Harvey Sparks,REP,550211,0,0,0,0,05
Oklahoma,U.S. House,Clark Jolley,REP,550211,0,0,4,4,05
Oklahoma,Superintendent of Public Instruction,John Cox,DEM,550212,0,0,19,19,
Oklahoma,Superintendent of Public Instruction,Jack Jr.,DEM,550212,0,0,8,8,
Oklahoma,Superintendent of Public Instruction,Ivan Holmes,DEM,550212,0,0,6,6,
Oklahoma,Superintendent of Public Instruction,Freda Deskin,DEM,550212,0,0,44,44,
Oklahoma,U.S. Senate,Patrick Michael Hayes,DEM,550212,0,0,14,14,
Oklahoma,U.S. Senate,Jim Rogers,DEM,550212,0,0,24,24,
Oklahoma,U.S. Senate,Connie Johnson,DEM,550212,0,0,37,37,
Oklahoma,U.S. House,Tom Guild,DEM,550212,0,0,21,21,05
Oklahoma,U.S. House,Al Mcaffrey,DEM,550212,0,0,29,29,05
Oklahoma,U.S. House,Leona Leonard,DEM,550212,0,0,27,27,05
Oklahoma,State Senate,Wilfredo Santos Rivera,DEM,550212,0,0,24,24,46
Oklahoma,State Senate,Kay Floyd,DEM,550212,0,0,55,55,46
Oklahoma,State House,Virginia Poindexter,DEM,550212,0,0,11,11,89
Oklahoma,State House,Shane Stone,DEM,550212,0,0,28,28,89
Oklahoma,State House,Chris Bryant,DEM,550212,0,0,11,11,89
Oklahoma,State House,Mary Sosa,DEM,550212,0,0,30,30,89
Oklahoma,Governor,Dax Ewbank,REP,550212,0,0,7,7,
Oklahoma,Governor,Chad Moody,REP,550212,0,0,6,6,
Oklahoma,Governor,Mary Fallin,REP,550212,0,0,50,50,
Oklahoma,Superintendent of Public Instruction,Brian Kelly,REP,550212,0,0,14,14,
Oklahoma,Superintendent of Public Instruction,Janet Costello Barresi,REP,550212,0,0,15,15,
Oklahoma,Superintendent of Public Instruction,Joy Hofmeister,REP,550212,0,0,29,29,
Oklahoma,Insurance Commissioner,Bill Viner,REP,550212,0,0,10,10,
Oklahoma,Insurance Commissioner,John Doak,REP,550212,0,0,44,44,
Oklahoma,Corporation Commissioner,Todd Hiett,REP,550212,0,0,24,24,
Oklahoma,Corporation Commissioner,Cliff Branan,REP,550212,0,0,33,33,
Oklahoma,U.S. Senate,Evelyn Rogers,REP,550212,0,0,0,0,
Oklahoma,U.S. Senate,Rob Moye,REP,550212,0,0,1,1,
Oklahoma,U.S. Senate,D. Jean Mcbride-Samuels,REP,550212,0,0,1,1,
Oklahoma,U.S. Senate,Jim Inhofe,REP,550212,0,0,55,55,
Oklahoma,U.S. Senate,Erick Paul Wyatt,REP,550212,0,0,2,2,
Oklahoma,U.S. Senate,Andy Craig,REP,550212,0,0,0,0,
Oklahoma,U.S. Senate,T. Shannon,REP,550212,0,0,10,10,
Oklahoma,U.S. Senate,Randy Brogdon,REP,550212,0,0,1,1,
Oklahoma,U.S. Senate,Eric Mccray,REP,550212,0,0,0,0,
Oklahoma,U.S. Senate,Kevin Crow,REP,550212,0,0,1,1,
Oklahoma,U.S. Senate,James Lankford,REP,550212,0,0,51,51,
Oklahoma,U.S. Senate,Jason Weger,REP,550212,0,0,1,1,
Oklahoma,U.S. House,Shane David Jett,REP,550212,0,0,5,5,05
Oklahoma,U.S. House,Patrice Douglas,REP,550212,0,0,18,18,05
Oklahoma,U.S. House,Mike Turner,REP,550212,0,0,14,14,05
Oklahoma,U.S. House,Steve Russell,REP,550212,0,0,11,11,05
Oklahoma,U.S. House,Harvey Sparks,REP,550212,0,0,5,5,05
Oklahoma,U.S. House,Clark Jolley,REP,550212,0,0,8,8,05
Oklahoma,Superintendent of Public Instruction,John Cox,DEM,550213,0,0,17,17,
Oklahoma,Superintendent of Public Instruction,Jack Jr.,DEM,550213,0,0,4,4,
Oklahoma,Superintendent of Public Instruction,Ivan Holmes,DEM,550213,0,0,12,12,
Oklahoma,Superintendent of Public Instruction,Freda Deskin,DEM,550213,0,0,21,21,
Oklahoma,U.S. Senate,Patrick Michael Hayes,DEM,550213,0,0,8,8,
Oklahoma,U.S. Senate,Jim Rogers,DEM,550213,0,0,13,13,
Oklahoma,U.S. Senate,Connie Johnson,DEM,550213,0,0,34,34,
Oklahoma,U.S. House,Tom Guild,DEM,550213,0,0,20,20,05
Oklahoma,U.S. House,Al Mcaffrey,DEM,550213,0,0,18,18,05
Oklahoma,U.S. House,Leona Leonard,DEM,550213,0,0,16,16,05
Oklahoma,State Senate,Wilfredo Santos Rivera,DEM,550213,0,0,30,30,46
Oklahoma,State Senate,Kay Floyd,DEM,550213,0,0,24,24,46
Oklahoma,State House,Virginia Poindexter,DEM,550213,0,0,4,4,89
Oklahoma,State House,Shane Stone,DEM,550213,0,0,19,19,89
Oklahoma,State House,Chris Bryant,DEM,550213,0,0,7,7,89
Oklahoma,State House,Mary Sosa,DEM,550213,0,0,30,30,89
Oklahoma,Governor,Dax Ewbank,REP,550213,0,0,2,2,
Oklahoma,Governor,Chad Moody,REP,550213,0,0,4,4,
Oklahoma,Governor,Mary Fallin,REP,550213,0,0,19,19,
Oklahoma,Superintendent of Public Instruction,Brian Kelly,REP,550213,0,0,8,8,
Oklahoma,Superintendent of Public Instruction,Janet Costello Barresi,REP,550213,0,0,8,8,
Oklahoma,Superintendent of Public Instruction,Joy Hofmeister,REP,550213,0,0,7,7,
Oklahoma,Insurance Commissioner,Bill Viner,REP,550213,0,0,2,2,
Oklahoma,Insurance Commissioner,John Doak,REP,550213,0,0,21,21,
Oklahoma,Corporation Commissioner,Todd Hiett,REP,550213,0,0,11,11,
Oklahoma,Corporation Commissioner,Cliff Branan,REP,550213,0,0,11,11,
Oklahoma,U.S. Senate,Evelyn Rogers,REP,550213,0,0,5,5,
Oklahoma,U.S. Senate,Rob Moye,REP,550213,0,0,1,1,
Oklahoma,U.S. Senate,D. Jean Mcbride-Samuels,REP,550213,0,0,0,0,
Oklahoma,U.S. Senate,Jim Inhofe,REP,550213,0,0,16,16,
Oklahoma,U.S. Senate,Erick Paul Wyatt,REP,550213,0,0,2,2,
Oklahoma,U.S. Senate,Andy Craig,REP,550213,0,0,0,0,
Oklahoma,U.S. Senate,T. Shannon,REP,550213,0,0,7,7,
Oklahoma,U.S. Senate,Randy Brogdon,REP,550213,0,0,1,1,
Oklahoma,U.S. Senate,Eric Mccray,REP,550213,0,0,0,0,
Oklahoma,U.S. Senate,Kevin Crow,REP,550213,0,0,0,0,
Oklahoma,U.S. Senate,James Lankford,REP,550213,0,0,16,16,
Oklahoma,U.S. Senate,Jason Weger,REP,550213,0,0,1,1,
Oklahoma,U.S. House,Shane David Jett,REP,550213,0,0,4,4,05
Oklahoma,U.S. House,Patrice Douglas,REP,550213,0,0,6,6,05
Oklahoma,U.S. House,Mike Turner,REP,550213,0,0,4,4,05
Oklahoma,U.S. House,Steve Russell,REP,550213,0,0,3,3,05
Oklahoma,U.S. House,Harvey Sparks,REP,550213,0,0,1,1,05
Oklahoma,U.S. House,Clark Jolley,REP,550213,0,0,5,5,05
Oklahoma,Superintendent of Public Instruction,John Cox,DEM,550214,0,0,5,5,
Oklahoma,Superintendent of Public Instruction,Jack Jr.,DEM,550214,0,0,4,4,
Oklahoma,Superintendent of Public Instruction,Ivan Holmes,DEM,550214,0,0,4,4,
Oklahoma,Superintendent of Public Instruction,Freda Deskin,DEM,550214,0,0,13,13,
Oklahoma,U.S. Senate,Patrick Michael Hayes,DEM,550214,0,0,3,3,
Oklahoma,U.S. Senate,Jim Rogers,DEM,550214,0,0,5,5,
Oklahoma,U.S. Senate,Connie Johnson,DEM,550214,0,0,18,18,
Oklahoma,U.S. House,Tom Guild,DEM,550214,0,0,11,11,05
Oklahoma,U.S. House,Al Mcaffrey,DEM,550214,0,0,5,5,05
Oklahoma,U.S. House,Leona Leonard,DEM,550214,0,0,10,10,05
Oklahoma,Governor,Dax Ewbank,REP,550214,0,0,5,5,
Oklahoma,Governor,Chad Moody,REP,550214,0,0,10,10,
Oklahoma,Governor,Mary Fallin,REP,550214,0,0,43,43,
Oklahoma,Superintendent of Public Instruction,Brian Kelly,REP,550214,0,0,16,16,
Oklahoma,Superintendent of Public Instruction,Janet Costello Barresi,REP,550214,0,0,16,16,
Oklahoma,Superintendent of Public Instruction,Joy Hofmeister,REP,550214,0,0,25,25,
Oklahoma,Insurance Commissioner,Bill Viner,REP,550214,0,0,11,11,
Oklahoma,Insurance Commissioner,John Doak,REP,550214,0,0,42,42,
Oklahoma,Corporation Commissioner,Todd Hiett,REP,550214,0,0,25,25,
Oklahoma,Corporation Commissioner,Cliff Branan,REP,550214,0,0,26,26,
Oklahoma,U.S. Senate,Evelyn Rogers,REP,550214,0,0,1,1,
Oklahoma,U.S. Senate,Rob Moye,REP,550214,0,0,1,1,
Oklahoma,U.S. Senate,D. Jean Mcbride-Samuels,REP,550214,0,0,1,1,
Oklahoma,U.S. Senate,Jim Inhofe,REP,550214,0,0,52,52,
Oklahoma,U.S. Senate,Erick Paul Wyatt,REP,550214,0,0,2,2,
Oklahoma,U.S. Senate,Andy Craig,REP,550214,0,0,0,0,
Oklahoma,U.S. Senate,T. Shannon,REP,550214,0,0,15,15,
Oklahoma,U.S. Senate,Randy Brogdon,REP,550214,0,0,0,0,
Oklahoma,U.S. Senate,Eric Mccray,REP,550214,0,0,0,0,
Oklahoma,U.S. Senate,Kevin Crow,REP,550214,0,0,2,2,
Oklahoma,U.S. Senate,James Lankford,REP,550214,0,0,39,39,
Oklahoma,U.S. Senate,Jason Weger,REP,550214,0,0,0,0,
Oklahoma,U.S. House,Shane David Jett,REP,550214,0,0,6,6,05
Oklahoma,U.S. House,Patrice Douglas,REP,550214,0,0,12,12,05
Oklahoma,U.S. House,Mike Turner,REP,550214,0,0,9,9,05
Oklahoma,U.S. House,Steve Russell,REP,550214,0,0,17,17,05
Oklahoma,U.S. House,Harvey Sparks,REP,550214,0,0,2,2,05
Oklahoma,U.S. House,Clark Jolley,REP,550214,0,0,6,6,05
Oklahoma,Superintendent of Public Instruction,John Cox,DEM,550215,0,0,12,12,
Oklahoma,Superintendent of Public Instruction,Jack Jr.,DEM,550215,0,0,11,11,
Oklahoma,Superintendent of Public Instruction,Ivan Holmes,DEM,550215,0,0,4,4,
Oklahoma,Superintendent of Public Instruction,Freda Deskin,DEM,550215,0,0,27,27,
Oklahoma,U.S. Senate,Patrick Michael Hayes,DEM,550215,0,0,10,10,
Oklahoma,U.S. Senate,Jim Rogers,DEM,550215,0,0,19,19,
Oklahoma,U.S. Senate,Connie Johnson,DEM,550215,0,0,23,23,
Oklahoma,U.S. House,Tom Guild,DEM,550215,0,0,15,15,05
Oklahoma,U.S. House,Al Mcaffrey,DEM,550215,0,0,20,20,05
Oklahoma,U.S. House,Leona Leonard,DEM,550215,0,0,18,18,05
Oklahoma,State Senate,Wilfredo Santos Rivera,DEM,550215,0,0,16,16,46
Oklahoma,State Senate,Kay Floyd,DEM,550215,0,0,38,38,46
Oklahoma,Governor,Dax Ewbank,REP,550215,0,0,2,2,
Oklahoma,Governor,Chad Moody,REP,550215,0,0,6,6,
Oklahoma,Governor,Mary Fallin,REP,550215,0,0,57,57,
Oklahoma,Superintendent of Public Instruction,Brian Kelly,REP,550215,0,0,18,18,
Oklahoma,Superintendent of Public Instruction,Janet Costello Barresi,REP,550215,0,0,20,20,
Oklahoma,Superintendent of Public Instruction,Joy Hofmeister,REP,550215,0,0,25,25,
Oklahoma,Insurance Commissioner,Bill Viner,REP,550215,0,0,15,15,
Oklahoma,Insurance Commissioner,John Doak,REP,550215,0,0,46,46,
Oklahoma,Corporation Commissioner,Todd Hiett,REP,550215,0,0,29,29,
Oklahoma,Corporation Commissioner,Cliff Branan,REP,550215,0,0,32,32,
Oklahoma,U.S. Senate,Evelyn Rogers,REP,550215,0,0,3,3,
Oklahoma,U.S. Senate,Rob Moye,REP,550215,0,0,0,0,
Oklahoma,U.S. Senate,D. Jean Mcbride-Samuels,REP,550215,0,0,0,0,
Oklahoma,U.S. Senate,Jim Inhofe,REP,550215,0,0,59,59,
Oklahoma,U.S. Senate,Erick Paul Wyatt,REP,550215,0,0,1,1,
Oklahoma,U.S. Senate,Andy Craig,REP,550215,0,0,1,1,
Oklahoma,U.S. Senate,T. Shannon,REP,550215,0,0,14,14,
Oklahoma,U.S. Senate,Randy Brogdon,REP,550215,0,0,0,0,
Oklahoma,U.S. Senate,Eric Mccray,REP,550215,0,0,0,0,
Oklahoma,U.S. Senate,Kevin Crow,REP,550215,0,0,1,1,
Oklahoma,U.S. Senate,James Lankford,REP,550215,0,0,49,49,
Oklahoma,U.S. Senate,Jason Weger,REP,550215,0,0,0,0,
Oklahoma,U.S. House,Shane David Jett,REP,550215,0,0,13,13,05
Oklahoma,U.S. House,Patrice Douglas,REP,550215,0,0,10,10,05
Oklahoma,U.S. House,Mike Turner,REP,550215,0,0,21,21,05
Oklahoma,U.S. House,Steve Russell,REP,550215,0,0,13,13,05
Oklahoma,U.S. House,Harvey Sparks,REP,550215,0,0,0,0,05
Oklahoma,U.S. House,Clark Jolley,REP,550215,0,0,6,6,05
Oklahoma,Superintendent of Public Instruction,John Cox,DEM,550216,0,0,1,1,
Oklahoma,Superintendent of Public Instruction,Jack Jr.,DEM,550216,0,0,0,0,
Oklahoma,Superintendent of Public Instruction,Ivan Holmes,DEM,550216,0,0,0,0,
Oklahoma,Superintendent of Public Instruction,Freda Deskin,DEM,550216,0,0,1,1,
Oklahoma,U.S. Senate,Patrick Michael Hayes,DEM,550216,0,0,1,1,
Oklahoma,U.S. Senate,Jim Rogers,DEM,550216,0,0,0,0,
Oklahoma,U.S. Senate,Connie Johnson,DEM,550216,0,0,1,1,
Oklahoma,U.S. House,Tom Guild,DEM,550216,0,0,0,0,05
Oklahoma,U.S. House,Al Mcaffrey,DEM,550216,0,0,2,2,05
Oklahoma,U.S. House,Leona Leonard,DEM,550216,0,0,0,0,05
Oklahoma,State Senate,Wilfredo Santos Rivera,DEM,550216,0,0,1,1,46
Oklahoma,State Senate,Kay Floyd,DEM,550216,0,0,1,1,46
Oklahoma,Governor,Dax Ewbank,REP,550216,0,0,0,0,
Oklahoma,Governor,Chad Moody,REP,550216,0,0,0,0,
Oklahoma,Governor,Mary Fallin,REP,550216,0,0,0,0,
Oklahoma,Superintendent of Public Instruction,Brian Kelly,REP,550216,0,0,0,0,
Oklahoma,Superintendent of Public Instruction,Janet Costello Barresi,REP,550216,0,0,0,0,
Oklahoma,Superintendent of Public Instruction,Joy Hofmeister,REP,550216,0,0,0,0,
Oklahoma,Insurance Commissioner,Bill Viner,REP,550216,0,0,0,0,
Oklahoma,Insurance Commissioner,John Doak,REP,550216,0,0,0,0,
Oklahoma,Corporation Commissioner,Todd Hiett,REP,550216,0,0,0,0,
Oklahoma,Corporation Commissioner,Cliff Branan,REP,550216,0,0,0,0,
Oklahoma,U.S. Senate,Evelyn Rogers,REP,550216,0,0,0,0,
Oklahoma,U.S. Senate,Rob Moye,REP,550216,0,0,0,0,
Oklahoma,U.S. Senate,D. Jean Mcbride-Samuels,REP,550216,0,0,0,0,
Oklahoma,U.S. Senate,Jim Inhofe,REP,550216,0,0,0,0,
Oklahoma,U.S. Senate,Erick Paul Wyatt,REP,550216,0,0,0,0,
Oklahoma,U.S. Senate,Andy Craig,REP,550216,0,0,0,0,
Oklahoma,U.S. Senate,T. Shannon,REP,550216,0,0,0,0,
Oklahoma,U.S. Senate,Randy Brogdon,REP,550216,0,0,0,0,
Oklahoma,U.S. Senate,Eric Mccray,REP,550216,0,0,0,0,
Oklahoma,U.S. Senate,Kevin Crow,REP,550216,0,0,0,0,
Oklahoma,U.S. Senate,James Lankford,REP,550216,0,0,0,0,
Oklahoma,U.S. Senate,Jason Weger,REP,550216,0,0,0,0,
Oklahoma,U.S. House,Shane David Jett,REP,550216,0,0,0,0,05
Oklahoma,U.S. House,Patrice Douglas,REP,550216,0,0,0,0,05
Oklahoma,U.S. House,Mike Turner,REP,550216,0,0,0,0,05
Oklahoma,U.S. House,Steve Russell,REP,550216,0,0,0,0,05
Oklahoma,U.S. House,Harvey Sparks,REP,550216,0,0,0,0,05
Oklahoma,U.S. House,Clark Jolley,REP,550216,0,0,0,0,05
Oklahoma,Superintendent of Public Instruction,John Cox,DEM,550217,0,0,15,15,
Oklahoma,Superintendent of Public Instruction,Jack Jr.,DEM,550217,0,0,3,3,
Oklahoma,Superintendent of Public Instruction,Ivan Holmes,DEM,550217,0,0,8,8,
Oklahoma,Superintendent of Public Instruction,Freda Deskin,DEM,550217,0,0,25,25,
Oklahoma,U.S. Senate,Patrick Michael Hayes,DEM,550217,0,0,14,14,
Oklahoma,U.S. Senate,Jim Rogers,DEM,550217,0,0,13,13,
Oklahoma,U.S. Senate,Connie Johnson,DEM,550217,0,0,22,22,
Oklahoma,U.S. House,Tom Guild,DEM,550217,0,0,21,21,05
Oklahoma,U.S. House,Al Mcaffrey,DEM,550217,0,0,21,21,05
Oklahoma,U.S. House,Leona Leonard,DEM,550217,0,0,9,9,05
Oklahoma,Governor,Dax Ewbank,REP,550217,0,0,5,5,
Oklahoma,Governor,Chad Moody,REP,550217,0,0,12,12,
Oklahoma,Governor,Mary Fallin,REP,550217,0,0,93,93,
Oklahoma,Superintendent of Public Instruction,Brian Kelly,REP,550217,0,0,27,27,
Oklahoma,Superintendent of Public Instruction,Janet Costello Barresi,REP,550217,0,0,41,41,
Oklahoma,Superintendent of Public Instruction,Joy Hofmeister,REP,550217,0,0,41,41,
Oklahoma,Insurance Commissioner,Bill Viner,REP,550217,0,0,26,26,
Oklahoma,Insurance Commissioner,John Doak,REP,550217,0,0,80,80,
Oklahoma,Corporation Commissioner,Todd Hiett,REP,550217,0,0,45,45,
Oklahoma,Corporation Commissioner,Cliff Branan,REP,550217,0,0,54,54,
Oklahoma,U.S. Senate,Evelyn Rogers,REP,550217,0,0,6,6,
Oklahoma,U.S. Senate,Rob Moye,REP,550217,0,0,2,2,
Oklahoma,U.S. Senate,D. Jean Mcbride-Samuels,REP,550217,0,0,4,4,
Oklahoma,U.S. Senate,Jim Inhofe,REP,550217,0,0,95,95,
Oklahoma,U.S. Senate,Erick Paul Wyatt,REP,550217,0,0,2,2,
Oklahoma,U.S. Senate,Andy Craig,REP,550217,0,0,0,0,
Oklahoma,U.S. Senate,T. Shannon,REP,550217,0,0,29,29,
Oklahoma,U.S. Senate,Randy Brogdon,REP,550217,0,0,0,0,
Oklahoma,U.S. Senate,Eric Mccray,REP,550217,0,0,3,3,
Oklahoma,U.S. Senate,Kevin Crow,REP,550217,0,0,2,2,
Oklahoma,U.S. Senate,James Lankford,REP,550217,0,0,79,79,
Oklahoma,U.S. Senate,Jason Weger,REP,550217,0,0,0,0,
Oklahoma,U.S. House,Shane David Jett,REP,550217,0,0,9,9,05
Oklahoma,U.S. House,Patrice Douglas,REP,550217,0,0,24,24,05
Oklahoma,U.S. House,Mike Turner,REP,550217,0,0,13,13,05
Oklahoma,U.S. House,Steve Russell,REP,550217,0,0,43,43,05
Oklahoma,U.S. House,Harvey Sparks,REP,550217,0,0,5,5,05
Oklahoma,U.S. House,Clark Jolley,REP,550217,0,0,14,14,05
Oklahoma,Superintendent of Public Instruction,John Cox,DEM,550218,0,0,23,23,
Oklahoma,Superintendent of Public Instruction,Jack Jr.,DEM,550218,0,0,12,12,
Oklahoma,Superintendent of Public Instruction,Ivan Holmes,DEM,550218,0,0,8,8,
Oklahoma,Superintendent of Public Instruction,Freda Deskin,DEM,550218,0,0,38,38,
Oklahoma,U.S. Senate,Patrick Michael Hayes,DEM,550218,0,0,15,15,
Oklahoma,U.S. Senate,Jim Rogers,DEM,550218,0,0,22,22,
Oklahoma,U.S. Senate,Connie Johnson,DEM,550218,0,0,43,43,
Oklahoma,U.S. House,Tom Guild,DEM,550218,0,0,25,25,05
Oklahoma,U.S. House,Al Mcaffrey,DEM,550218,0,0,28,28,05
Oklahoma,U.S. House,Leona Leonard,DEM,550218,0,0,27,27,05
Oklahoma,Governor,Dax Ewbank,REP,550218,0,0,5,5,
Oklahoma,Governor,Chad Moody,REP,550218,0,0,15,15,
Oklahoma,Governor,Mary Fallin,REP,550218,0,0,124,124,
Oklahoma,Superintendent of Public Instruction,Brian Kelly,REP,550218,0,0,30,30,
Oklahoma,Superintendent of Public Instruction,Janet Costello Barresi,REP,550218,0,0,50,50,
Oklahoma,Superintendent of Public Instruction,Joy Hofmeister,REP,550218,0,0,63,63,
Oklahoma,Insurance Commissioner,Bill Viner,REP,550218,0,0,27,27,
Oklahoma,Insurance Commissioner,John Doak,REP,550218,0,0,110,110,
Oklahoma,Corporation Commissioner,Todd Hiett,REP,550218,0,0,67,67,
Oklahoma,Corporation Commissioner,Cliff Branan,REP,550218,0,0,65,65,
Oklahoma,U.S. Senate,Evelyn Rogers,REP,550218,0,0,5,5,
Oklahoma,U.S. Senate,Rob Moye,REP,550218,0,0,2,2,
Oklahoma,U.S. Senate,D. Jean Mcbride-Samuels,REP,550218,0,0,1,1,
Oklahoma,U.S. Senate,Jim Inhofe,REP,550218,0,0,131,131,
Oklahoma,U.S. Senate,Erick Paul Wyatt,REP,550218,0,0,4,4,
Oklahoma,U.S. Senate,Andy Craig,REP,550218,0,0,0,0,
Oklahoma,U.S. Senate,T. Shannon,REP,550218,0,0,28,28,
Oklahoma,U.S. Senate,Randy Brogdon,REP,550218,0,0,2,2,
Oklahoma,U.S. Senate,Eric Mccray,REP,550218,0,0,1,1,
Oklahoma,U.S. Senate,Kevin Crow,REP,550218,0,0,0,0,
Oklahoma,U.S. Senate,James Lankford,REP,550218,0,0,112,112,
Oklahoma,U.S. Senate,Jason Weger,REP,550218,0,0,0,0,
Oklahoma,U.S. House,Shane David Jett,REP,550218,0,0,4,4,05
Oklahoma,U.S. House,Patrice Douglas,REP,550218,0,0,34,34,05
Oklahoma,U.S. House,Mike Turner,REP,550218,0,0,29,29,05
Oklahoma,U.S. House,Steve Russell,REP,550218,0,0,54,54,05
Oklahoma,U.S. House,Harvey Sparks,REP,550218,0,0,5,5,05
Oklahoma,U.S. House,Clark Jolley,REP,550218,0,0,14,14,05
Oklahoma,Superintendent of Public Instruction,John Cox,DEM,550219,0,0,8,8,
Oklahoma,Superintendent of Public Instruction,Jack Jr.,DEM,550219,0,0,5,5,
Oklahoma,Superintendent of Public Instruction,Ivan Holmes,DEM,550219,0,0,6,6,
Oklahoma,Superintendent of Public Instruction,Freda Deskin,DEM,550219,0,0,23,23,
Oklahoma,U.S. Senate,Patrick Michael Hayes,DEM,550219,0,0,11,11,
Oklahoma,U.S. Senate,Jim Rogers,DEM,550219,0,0,11,11,
Oklahoma,U.S. Senate,Connie Johnson,DEM,550219,0,0,20,20,
Oklahoma,U.S. House,Tom Guild,DEM,550219,0,0,17,17,05
Oklahoma,U.S. House,Al Mcaffrey,DEM,550219,0,0,13,13,05
Oklahoma,U.S. House,Leona Leonard,DEM,550219,0,0,11,11,05
Oklahoma,State Senate,Wilfredo Santos Rivera,DEM,550219,0,0,5,5,46
Oklahoma,State Senate,Kay Floyd,DEM,550219,0,0,36,36,46
Oklahoma,Governor,Dax Ewbank,REP,550219,0,0,5,5,
Oklahoma,Governor,Chad Moody,REP,550219,0,0,14,14,
Oklahoma,Governor,Mary Fallin,REP,550219,0,0,44,44,
Oklahoma,Superintendent of Public Instruction,Brian Kelly,REP,550219,0,0,23,23,
Oklahoma,Superintendent of Public Instruction,Janet Costello Barresi,REP,550219,0,0,13,13,
Oklahoma,Superintendent of Public Instruction,Joy Hofmeister,REP,550219,0,0,27,27,
Oklahoma,Insurance Commissioner,Bill Viner,REP,550219,0,0,19,19,
Oklahoma,Insurance Commissioner,John Doak,REP,550219,0,0,40,40,
Oklahoma,Corporation Commissioner,Todd Hiett,REP,550219,0,0,21,21,
Oklahoma,Corporation Commissioner,Cliff Branan,REP,550219,0,0,37,37,
Oklahoma,U.S. Senate,Evelyn Rogers,REP,550219,0,0,2,2,
Oklahoma,U.S. Senate,Rob Moye,REP,550219,0,0,3,3,
Oklahoma,U.S. Senate,D. Jean Mcbride-Samuels,REP,550219,0,0,2,2,
Oklahoma,U.S. Senate,Jim Inhofe,REP,550219,0,0,53,53,
Oklahoma,U.S. Senate,Erick Paul Wyatt,REP,550219,0,0,2,2,
Oklahoma,U.S. Senate,Andy Craig,REP,550219,0,0,1,1,
Oklahoma,U.S. Senate,T. Shannon,REP,550219,0,0,17,17,
Oklahoma,U.S. Senate,Randy Brogdon,REP,550219,0,0,2,2,
Oklahoma,U.S. Senate,Eric Mccray,REP,550219,0,0,0,0,
Oklahoma,U.S. Senate,Kevin Crow,REP,550219,0,0,0,0,
Oklahoma,U.S. Senate,James Lankford,REP,550219,0,0,42,42,
Oklahoma,U.S. Senate,Jason Weger,REP,550219,0,0,1,1,
Oklahoma,U.S. House,Shane David Jett,REP,550219,0,0,5,5,05
Oklahoma,U.S. House,Patrice Douglas,REP,550219,0,0,17,17,05
Oklahoma,U.S. House,Mike Turner,REP,550219,0,0,15,15,05
Oklahoma,U.S. House,Steve Russell,REP,550219,0,0,13,13,05
Oklahoma,U.S. House,Harvey Sparks,REP,550219,0,0,4,4,05
Oklahoma,U.S. House,Clark Jolley,REP,550219,0,0,7,7,05
Oklahoma,Superintendent of Public Instruction,John Cox,DEM,550220,0,0,24,24,
Oklahoma,Superintendent of Public Instruction,Jack Jr.,DEM,550220,0,0,13,13,
Oklahoma,Superintendent of Public Instruction,Ivan Holmes,DEM,550220,0,0,7,7,
Oklahoma,Superintendent of Public Instruction,Freda Deskin,DEM,550220,0,0,25,25,
Oklahoma,U.S. Senate,Patrick Michael Hayes,DEM,550220,0,0,16,16,
Oklahoma,U.S. Senate,Jim Rogers,DEM,550220,0,0,15,15,
Oklahoma,U.S. Senate,Connie Johnson,DEM,550220,0,0,38,38,
Oklahoma,U.S. House,Tom Guild,DEM,550220,0,0,38,38,05
Oklahoma,U.S. House,Al Mcaffrey,DEM,550220,0,0,16,16,05
Oklahoma,U.S. House,Leona Leonard,DEM,550220,0,0,15,15,05
Oklahoma,Governor,Dax Ewbank,REP,550220,0,0,12,12,
Oklahoma,Governor,Chad Moody,REP,550220,0,0,19,19,
Oklahoma,Governor,Mary Fallin,REP,550220,0,0,88,88,
Oklahoma,Superintendent of Public Instruction,Brian Kelly,REP,550220,0,0,36,36,
Oklahoma,Superintendent of Public Instruction,Janet Costello Barresi,REP,550220,0,0,31,31,
Oklahoma,Superintendent of Public Instruction,Joy Hofmeister,REP,550220,0,0,51,51,
Oklahoma,Insurance Commissioner,Bill Viner,REP,550220,0,0,31,31,
Oklahoma,Insurance Commissioner,John Doak,REP,550220,0,0,79,79,
Oklahoma,Corporation Commissioner,Todd Hiett,REP,550220,0,0,57,57,
Oklahoma,Corporation Commissioner,Cliff Branan,REP,550220,0,0,55,55,
Oklahoma,U.S. Senate,Evelyn Rogers,REP,550220,0,0,2,2,
Oklahoma,U.S. Senate,Rob Moye,REP,550220,0,0,2,2,
Oklahoma,U.S. Senate,D. Jean Mcbride-Samuels,REP,550220,0,0,2,2,
Oklahoma,U.S. Senate,Jim Inhofe,REP,550220,0,0,109,109,
Oklahoma,U.S. Senate,Erick Paul Wyatt,REP,550220,0,0,3,3,
Oklahoma,U.S. Senate,Andy Craig,REP,550220,0,0,0,0,
Oklahoma,U.S. Senate,T. Shannon,REP,550220,0,0,33,33,
Oklahoma,U.S. Senate,Randy Brogdon,REP,550220,0,0,6,6,
Oklahoma,U.S. Senate,Eric Mccray,REP,550220,0,0,2,2,
Oklahoma,U.S. Senate,Kevin Crow,REP,550220,0,0,1,1,
Oklahoma,U.S. Senate,James Lankford,REP,550220,0,0,78,78,
Oklahoma,U.S. Senate,Jason Weger,REP,550220,0,0,0,0,
Oklahoma,U.S. House,Shane David Jett,REP,550220,0,0,6,6,05
Oklahoma,U.S. House,Patrice Douglas,REP,550220,0,0,22,22,05
Oklahoma,U.S. House,Mike Turner,REP,550220,0,0,35,35,05
Oklahoma,U.S. House,Steve Russell,REP,550220,0,0,34,34,05
Oklahoma,U.S. House,Harvey Sparks,REP,550220,0,0,1,1,05
Oklahoma,U.S. House,Clark Jolley,REP,550220,0,0,18,18,05
Oklahoma,Superintendent of Public Instruction,John Cox,DEM,550221,0,0,34,34,
Oklahoma,Superintendent of Public Instruction,Jack Jr.,DEM,550221,0,0,12,12,
Oklahoma,Superintendent of Public Instruction,Ivan Holmes,DEM,550221,0,0,6,6,
Oklahoma,Superintendent of Public Instruction,Freda Deskin,DEM,550221,0,0,66,66,
Oklahoma,U.S. Senate,Patrick Michael Hayes,DEM,550221,0,0,16,16,
Oklahoma,U.S. Senate,Jim Rogers,DEM,550221,0,0,38,38,
Oklahoma,U.S. Senate,Connie Johnson,DEM,550221,0,0,65,65,
Oklahoma,U.S. House,Tom Guild,DEM,550221,0,0,52,52,05
Oklahoma,U.S. House,Al Mcaffrey,DEM,550221,0,0,30,30,05
Oklahoma,U.S. House,Leona Leonard,DEM,550221,0,0,35,35,05
Oklahoma,Governor,Dax Ewbank,REP,550221,0,0,9,9,
Oklahoma,Governor,Chad Moody,REP,550221,0,0,24,24,
Oklahoma,Governor,Mary Fallin,REP,550221,0,0,191,191,
Oklahoma,Superintendent of Public Instruction,Brian Kelly,REP,550221,0,0,56,56,
Oklahoma,Superintendent of Public Instruction,Janet Costello Barresi,REP,550221,0,0,60,60,
Oklahoma,Superintendent of Public Instruction,Joy Hofmeister,REP,550221,0,0,108,108,
Oklahoma,Insurance Commissioner,Bill Viner,REP,550221,0,0,34,34,
Oklahoma,Insurance Commissioner,John Doak,REP,550221,0,0,176,176,
Oklahoma,Corporation Commissioner,Todd Hiett,REP,550221,0,0,117,117,
Oklahoma,Corporation Commissioner,Cliff Branan,REP,550221,0,0,90,90,
Oklahoma,U.S. Senate,Evelyn Rogers,REP,550221,0,0,9,9,
Oklahoma,U.S. Senate,Rob Moye,REP,550221,0,0,3,3,
Oklahoma,U.S. Senate,D. Jean Mcbride-Samuels,REP,550221,0,0,4,4,
Oklahoma,U.S. Senate,Jim Inhofe,REP,550221,0,0,209,209,
Oklahoma,U.S. Senate,Erick Paul Wyatt,REP,550221,0,0,1,1,
Oklahoma,U.S. Senate,Andy Craig,REP,550221,0,0,1,1,
Oklahoma,U.S. Senate,T. Shannon,REP,550221,0,0,50,50,
Oklahoma,U.S. Senate,Randy Brogdon,REP,550221,0,0,4,4,
Oklahoma,U.S. Senate,Eric Mccray,REP,550221,0,0,2,2,
Oklahoma,U.S. Senate,Kevin Crow,REP,550221,0,0,1,1,
Oklahoma,U.S. Senate,James Lankford,REP,550221,0,0,171,171,
Oklahoma,U.S. Senate,Jason Weger,REP,550221,0,0,0,0,
Oklahoma,U.S. House,Shane David Jett,REP,550221,0,0,24,24,05
Oklahoma,U.S. House,Patrice Douglas,REP,550221,0,0,51,51,05
Oklahoma,U.S. House,Mike Turner,REP,550221,0,0,39,39,05
Oklahoma,U.S. House,Steve Russell,REP,550221,0,0,65,65,05
Oklahoma,U.S. House,Harvey Sparks,REP,550221,0,0,13,13,05
Oklahoma,U.S. House,Clark Jolley,REP,550221,0,0,24,24,05
Oklahoma,Superintendent of Public Instruction,John Cox,DEM,550222,0,0,15,15,
Oklahoma,Superintendent of Public Instruction,Jack Jr.,DEM,550222,0,0,7,7,
Oklahoma,Superintendent of Public Instruction,Ivan Holmes,DEM,550222,0,0,6,6,
Oklahoma,Superintendent of Public Instruction,Freda Deskin,DEM,550222,0,0,20,20,
Oklahoma,U.S. Senate,Patrick Michael Hayes,DEM,550222,0,0,4,4,
Oklahoma,U.S. Senate,Jim Rogers,DEM,550222,0,0,13,13,
Oklahoma,U.S. Senate,Connie Johnson,DEM,550222,0,0,31,31,
Oklahoma,U.S. House,Tom Guild,DEM,550222,0,0,19,19,05
Oklahoma,U.S. House,Al Mcaffrey,DEM,550222,0,0,11,11,05
Oklahoma,U.S. House,Leona Leonard,DEM,550222,0,0,19,19,05
Oklahoma,Governor,Dax Ewbank,REP,550222,0,0,5,5,
Oklahoma,Governor,Chad Moody,REP,550222,0,0,12,12,
Oklahoma,Governor,Mary Fallin,REP,550222,0,0,57,57,
Oklahoma,Superintendent of Public Instruction,Brian Kelly,REP,550222,0,0,26,26,
Oklahoma,Superintendent of Public Instruction,Janet Costello Barresi,REP,550222,0,0,21,21,
Oklahoma,Superintendent of Public Instruction,Joy Hofmeister,REP,550222,0,0,25,25,
Oklahoma,Insurance Commissioner,Bill Viner,REP,550222,0,0,16,16,
Oklahoma,Insurance Commissioner,John Doak,REP,550222,0,0,53,53,
Oklahoma,Corporation Commissioner,Todd Hiett,REP,550222,0,0,36,36,
Oklahoma,Corporation Commissioner,Cliff Branan,REP,550222,0,0,31,31,
Oklahoma,U.S. Senate,Evelyn Rogers,REP,550222,0,0,3,3,
Oklahoma,U.S. Senate,Rob Moye,REP,550222,0,0,3,3,
Oklahoma,U.S. Senate,D. Jean Mcbride-Samuels,REP,550222,0,0,1,1,
Oklahoma,U.S. Senate,Jim Inhofe,REP,550222,0,0,60,60,
Oklahoma,U.S. Senate,Erick Paul Wyatt,REP,550222,0,0,4,4,
Oklahoma,U.S. Senate,Andy Craig,REP,550222,0,0,0,0,
Oklahoma,U.S. Senate,T. Shannon,REP,550222,0,0,19,19,
Oklahoma,U.S. Senate,Randy Brogdon,REP,550222,0,0,2,2,
Oklahoma,U.S. Senate,Eric Mccray,REP,550222,0,0,0,0,
Oklahoma,U.S. Senate,Kevin Crow,REP,550222,0,0,2,2,
Oklahoma,U.S. Senate,James Lankford,REP,550222,0,0,47,47,
Oklahoma,U.S. Senate,Jason Weger,REP,550222,0,0,2,2,
Oklahoma,U.S. House,Shane David Jett,REP,550222,0,0,11,11,05
Oklahoma,U.S. House,Patrice Douglas,REP,550222,0,0,16,16,05
Oklahoma,U.S. House,Mike Turner,REP,550222,0,0,14,14,05
Oklahoma,U.S. House,Steve Russell,REP,550222,0,0,18,18,05
Oklahoma,U.S. House,Harvey Sparks,REP,550222,0,0,2,2,05
Oklahoma,U.S. House,Clark Jolley,REP,550222,0,0,9,9,05
Oklahoma,Superintendent of Public Instruction,John Cox,DEM,550223,0,0,18,18,
Oklahoma,Superintendent of Public Instruction,Jack Jr.,DEM,550223,0,0,6,6,
Oklahoma,Superintendent of Public Instruction,Ivan Holmes,DEM,550223,0,0,3,3,
Oklahoma,Superintendent of Public Instruction,Freda Deskin,DEM,550223,0,0,19,19,
Oklahoma,U.S. Senate,Patrick Michael Hayes,DEM,550223,0,0,10,10,
Oklahoma,U.S. Senate,Jim Rogers,DEM,550223,0,0,15,15,
Oklahoma,U.S. Senate,Connie Johnson,DEM,550223,0,0,21,21,
Oklahoma,U.S. House,Tom Guild,DEM,550223,0,0,27,27,05
Oklahoma,U.S. House,Al Mcaffrey,DEM,550223,0,0,11,11,05
Oklahoma,U.S. House,Leona Leonard,DEM,550223,0,0,9,9,05
Oklahoma,Governor,Dax Ewbank,REP,550223,0,0,3,3,
Oklahoma,Governor,Chad Moody,REP,550223,0,0,11,11,
Oklahoma,Governor,Mary Fallin,REP,550223,0,0,43,43,
Oklahoma,Superintendent of Public Instruction,Brian Kelly,REP,550223,0,0,15,15,
Oklahoma,Superintendent of Public Instruction,Janet Costello Barresi,REP,550223,0,0,10,10,
Oklahoma,Superintendent of Public Instruction,Joy Hofmeister,REP,550223,0,0,33,33,
Oklahoma,Insurance Commissioner,Bill Viner,REP,550223,0,0,10,10,
Oklahoma,Insurance Commissioner,John Doak,REP,550223,0,0,46,46,
Oklahoma,Corporation Commissioner,Todd Hiett,REP,550223,0,0,25,25,
Oklahoma,Corporation Commissioner,Cliff Branan,REP,550223,0,0,30,30,
Oklahoma,U.S. Senate,Evelyn Rogers,REP,550223,0,0,6,6,
Oklahoma,U.S. Senate,Rob Moye,REP,550223,0,0,0,0,
Oklahoma,U.S. Senate,D. Jean Mcbride-Samuels,REP,550223,0,0,1,1,
Oklahoma,U.S. Senate,Jim Inhofe,REP,550223,0,0,47,47,
Oklahoma,U.S. Senate,Erick Paul Wyatt,REP,550223,0,0,3,3,
Oklahoma,U.S. Senate,Andy Craig,REP,550223,0,0,0,0,
Oklahoma,U.S. Senate,T. Shannon,REP,550223,0,0,18,18,
Oklahoma,U.S. Senate,Randy Brogdon,REP,550223,0,0,0,0,
Oklahoma,U.S. Senate,Eric Mccray,REP,550223,0,0,1,1,
Oklahoma,U.S. Senate,Kevin Crow,REP,550223,0,0,0,0,
Oklahoma,U.S. Senate,James Lankford,REP,550223,0,0,38,38,
Oklahoma,U.S. Senate,Jason Weger,REP,550223,0,0,0,0,
Oklahoma,U.S. House,Shane David Jett,REP,550223,0,0,12,12,05
Oklahoma,U.S. House,Patrice Douglas,REP,550223,0,0,10,10,05
Oklahoma,U.S. House,Mike Turner,REP,550223,0,0,9,9,05
Oklahoma,U.S. House,Steve Russell,REP,550223,0,0,11,11,05
Oklahoma,U.S. House,Harvey Sparks,REP,550223,0,0,2,2,05
Oklahoma,U.S. House,Clark Jolley,REP,550223,0,0,13,13,05
Oklahoma,Superintendent of Public Instruction,John Cox,DEM,550224,0,0,14,14,
Oklahoma,Superintendent of Public Instruction,Jack Jr.,DEM,550224,0,0,12,12,
Oklahoma,Superintendent of Public Instruction,Ivan Holmes,DEM,550224,0,0,3,3,
Oklahoma,Superintendent of Public Instruction,Freda Deskin,DEM,550224,0,0,27,27,
Oklahoma,U.S. Senate,Patrick Michael Hayes,DEM,550224,0,0,13,13,
Oklahoma,U.S. Senate,Jim Rogers,DEM,550224,0,0,16,16,
Oklahoma,U.S. Senate,Connie Johnson,DEM,550224,0,0,25,25,
Oklahoma,U.S. House,Tom Guild,DEM,550224,0,0,22,22,05
Oklahoma,U.S. House,Al Mcaffrey,DEM,550224,0,0,18,18,05
Oklahoma,U.S. House,Leona Leonard,DEM,550224,0,0,15,15,05
Oklahoma,Governor,Dax Ewbank,REP,550224,0,0,10,10,
Oklahoma,Governor,Chad Moody,REP,550224,0,0,16,16,
Oklahoma,Governor,Mary Fallin,REP,550224,0,0,57,57,
Oklahoma,Superintendent of Public Instruction,Brian Kelly,REP,550224,0,0,26,26,
Oklahoma,Superintendent of Public Instruction,Janet Costello Barresi,REP,550224,0,0,16,16,
Oklahoma,Superintendent of Public Instruction,Joy Hofmeister,REP,550224,0,0,40,40,
Oklahoma,Insurance Commissioner,Bill Viner,REP,550224,0,0,19,19,
Oklahoma,Insurance Commissioner,John Doak,REP,550224,0,0,61,61,
Oklahoma,Corporation Commissioner,Todd Hiett,REP,550224,0,0,40,40,
Oklahoma,Corporation Commissioner,Cliff Branan,REP,550224,0,0,39,39,
Oklahoma,U.S. Senate,Evelyn Rogers,REP,550224,0,0,3,3,
Oklahoma,U.S. Senate,Rob Moye,REP,550224,0,0,3,3,
Oklahoma,U.S. Senate,D. Jean Mcbride-Samuels,REP,550224,0,0,3,3,
Oklahoma,U.S. Senate,Jim Inhofe,REP,550224,0,0,63,63,
Oklahoma,U.S. Senate,Erick Paul Wyatt,REP,550224,0,0,10,10,
Oklahoma,U.S. Senate,Andy Craig,REP,550224,0,0,1,1,
Oklahoma,U.S. Senate,T. Shannon,REP,550224,0,0,24,24,
Oklahoma,U.S. Senate,Randy Brogdon,REP,550224,0,0,1,1,
Oklahoma,U.S. Senate,Eric Mccray,REP,550224,0,0,2,2,
Oklahoma,U.S. Senate,Kevin Crow,REP,550224,0,0,2,2,
Oklahoma,U.S. Senate,James Lankford,REP,550224,0,0,54,54,
Oklahoma,U.S. Senate,Jason Weger,REP,550224,0,0,1,1,
Oklahoma,U.S. House,Shane David Jett,REP,550224,0,0,15,15,05
Oklahoma,U.S. House,Patrice Douglas,REP,550224,0,0,18,18,05
Oklahoma,U.S. House,Mike Turner,REP,550224,0,0,20,20,05
Oklahoma,U.S. House,Steve Russell,REP,550224,0,0,14,14,05
Oklahoma,U.S. House,Harvey Sparks,REP,550224,0,0,3,3,05
Oklahoma,U.S. House,Clark Jolley,REP,550224,0,0,10,10,05
Oklahoma,Superintendent of Public Instruction,John Cox,DEM,550225,0,0,12,12,
Oklahoma,Superintendent of Public Instruction,Jack Jr.,DEM,550225,0,0,1,1,
Oklahoma,Superintendent of Public Instruction,Ivan Holmes,DEM,550225,0,0,3,3,
Oklahoma,Superintendent of Public Instruction,Freda Deskin,DEM,550225,0,0,10,10,
Oklahoma,U.S. Senate,Patrick Michael Hayes,DEM,550225,0,0,9,9,
Oklahoma,U.S. Senate,Jim Rogers,DEM,550225,0,0,6,6,
Oklahoma,U.S. Senate,Connie Johnson,DEM,550225,0,0,11,11,
Oklahoma,U.S. House,Tom Guild,DEM,550225,0,0,13,13,05
Oklahoma,U.S. House,Al Mcaffrey,DEM,550225,0,0,7,7,05
Oklahoma,U.S. House,Leona Leonard,DEM,550225,0,0,6,6,05
Oklahoma,State House,Virginia Poindexter,DEM,550225,0,0,3,3,89
Oklahoma,State House,Shane Stone,DEM,550225,0,0,13,13,89
Oklahoma,State House,Chris Bryant,DEM,550225,0,0,5,5,89
Oklahoma,State House,Mary Sosa,DEM,550225,0,0,5,5,89
Oklahoma,Governor,Dax Ewbank,REP,550225,0,0,0,0,
Oklahoma,Governor,Chad Moody,REP,550225,0,0,4,4,
Oklahoma,Governor,Mary Fallin,REP,550225,0,0,7,7,
Oklahoma,Superintendent of Public Instruction,Brian Kelly,REP,550225,0,0,5,5,
Oklahoma,Superintendent of Public Instruction,Janet Costello Barresi,REP,550225,0,0,3,3,
Oklahoma,Superintendent of Public Instruction,Joy Hofmeister,REP,550225,0,0,3,3,
Oklahoma,Insurance Commissioner,Bill Viner,REP,550225,0,0,4,4,
Oklahoma,Insurance Commissioner,John Doak,REP,550225,0,0,7,7,
Oklahoma,Corporation Commissioner,Todd Hiett,REP,550225,0,0,5,5,
Oklahoma,Corporation Commissioner,Cliff Branan,REP,550225,0,0,6,6,
Oklahoma,U.S. Senate,Evelyn Rogers,REP,550225,0,0,1,1,
Oklahoma,U.S. Senate,Rob Moye,REP,550225,0,0,0,0,
Oklahoma,U.S. Senate,D. Jean Mcbride-Samuels,REP,550225,0,0,0,0,
Oklahoma,U.S. Senate,Jim Inhofe,REP,550225,0,0,10,10,
Oklahoma,U.S. Senate,Erick Paul Wyatt,REP,550225,0,0,0,0,
Oklahoma,U.S. Senate,Andy Craig,REP,550225,0,0,0,0,
Oklahoma,U.S. Senate,T. Shannon,REP,550225,0,0,3,3,
Oklahoma,U.S. Senate,Randy Brogdon,REP,550225,0,0,1,1,
Oklahoma,U.S. Senate,Eric Mccray,REP,550225,0,0,0,0,
Oklahoma,U.S. Senate,Kevin Crow,REP,550225,0,0,0,0,
Oklahoma,U.S. Senate,James Lankford,REP,550225,0,0,7,7,
Oklahoma,U.S. Senate,Jason Weger,REP,550225,0,0,0,0,
Oklahoma,U.S. House,Shane David Jett,REP,550225,0,0,2,2,05
Oklahoma,U.S. House,Patrice Douglas,REP,550225,0,0,1,1,05
Oklahoma,U.S. House,Mike Turner,REP,550225,0,0,2,2,05
Oklahoma,U.S. House,Steve Russell,REP,550225,0,0,4,4,05
Oklahoma,U.S. House,Harvey Sparks,REP,550225,0,0,1,1,05
Oklahoma,U.S. House,Clark Jolley,REP,550225,0,0,1,1,05
Oklahoma,Superintendent of Public Instruction,John Cox,DEM,550226,0,0,22,22,
Oklahoma,Superintendent of Public Instruction,Jack Jr.,DEM,550226,0,0,6,6,
Oklahoma,Superintendent of Public Instruction,Ivan Holmes,DEM,550226,0,0,5,5,
Oklahoma,Superintendent of Public Instruction,Freda Deskin,DEM,550226,0,0,22,22,
Oklahoma,U.S. Senate,Patrick Michael Hayes,DEM,550226,0,0,12,12,
Oklahoma,U.S. Senate,Jim Rogers,DEM,550226,0,0,21,21,
Oklahoma,U.S. Senate,Connie Johnson,DEM,550226,0,0,22,22,
Oklahoma,U.S. House,Tom Guild,DEM,550226,0,0,29,29,05
Oklahoma,U.S. House,Al Mcaffrey,DEM,550226,0,0,11,11,05
Oklahoma,U.S. House,Leona Leonard,DEM,550226,0,0,13,13,05
Oklahoma,Governor,Dax Ewbank,REP,550226,0,0,7,7,
Oklahoma,Governor,Chad Moody,REP,550226,0,0,14,14,
Oklahoma,Governor,Mary Fallin,REP,550226,0,0,88,88,
Oklahoma,Superintendent of Public Instruction,Brian Kelly,REP,550226,0,0,35,35,
Oklahoma,Superintendent of Public Instruction,Janet Costello Barresi,REP,550226,0,0,28,28,
Oklahoma,Superintendent of Public Instruction,Joy Hofmeister,REP,550226,0,0,44,44,
Oklahoma,Insurance Commissioner,Bill Viner,REP,550226,0,0,15,15,
Oklahoma,Insurance Commissioner,John Doak,REP,550226,0,0,82,82,
Oklahoma,Corporation Commissioner,Todd Hiett,REP,550226,0,0,41,41,
Oklahoma,Corporation Commissioner,Cliff Branan,REP,550226,0,0,52,52,
Oklahoma,U.S. Senate,Evelyn Rogers,REP,550226,0,0,1,1,
Oklahoma,U.S. Senate,Rob Moye,REP,550226,0,0,2,2,
Oklahoma,U.S. Senate,D. Jean Mcbride-Samuels,REP,550226,0,0,3,3,
Oklahoma,U.S. Senate,Jim Inhofe,REP,550226,0,0,98,98,
Oklahoma,U.S. Senate,Erick Paul Wyatt,REP,550226,0,0,3,3,
Oklahoma,U.S. Senate,Andy Craig,REP,550226,0,0,3,3,
Oklahoma,U.S. Senate,T. Shannon,REP,550226,0,0,19,19,
Oklahoma,U.S. Senate,Randy Brogdon,REP,550226,0,0,5,5,
Oklahoma,U.S. Senate,Eric Mccray,REP,550226,0,0,0,0,
Oklahoma,U.S. Senate,Kevin Crow,REP,550226,0,0,0,0,
Oklahoma,U.S. Senate,James Lankford,REP,550226,0,0,79,79,
Oklahoma,U.S. Senate,Jason Weger,REP,550226,0,0,1,1,
Oklahoma,U.S. House,Shane David Jett,REP,550226,0,0,17,17,05
Oklahoma,U.S. House,Patrice Douglas,REP,550226,0,0,19,19,05
Oklahoma,U.S. House,Mike Turner,REP,550226,0,0,22,22,05
Oklahoma,U.S. House,Steve Russell,REP,550226,0,0,28,28,05
Oklahoma,U.S. House,Harvey Sparks,REP,550226,0,0,7,7,05
Oklahoma,U.S. House,Clark Jolley,REP,550226,0,0,12,12,05
Oklahoma,Superintendent of Public Instruction,John Cox,DEM,550227,0,0,14,14,
Oklahoma,Superintendent of Public Instruction,Jack Jr.,DEM,550227,0,0,5,5,
Oklahoma,Superintendent of Public Instruction,Ivan Holmes,DEM,550227,0,0,1,1,
Oklahoma,Superintendent of Public Instruction,Freda Deskin,DEM,550227,0,0,27,27,
Oklahoma,U.S. Senate,Patrick Michael Hayes,DEM,550227,0,0,10,10,
Oklahoma,U.S. Senate,Jim Rogers,DEM,550227,0,0,17,17,
Oklahoma,U.S. Senate,Connie Johnson,DEM,550227,0,0,19,19,
Oklahoma,U.S. House,Tom Guild,DEM,550227,0,0,24,24,05
Oklahoma,U.S. House,Al Mcaffrey,DEM,550227,0,0,8,8,05
Oklahoma,U.S. House,Leona Leonard,DEM,550227,0,0,15,15,05
Oklahoma,Governor,Dax Ewbank,REP,550227,0,0,4,4,
Oklahoma,Governor,Chad Moody,REP,550227,0,0,11,11,
Oklahoma,Governor,Mary Fallin,REP,550227,0,0,70,70,
Oklahoma,Superintendent of Public Instruction,Brian Kelly,REP,550227,0,0,26,26,
Oklahoma,Superintendent of Public Instruction,Janet Costello Barresi,REP,550227,0,0,13,13,
Oklahoma,Superintendent of Public Instruction,Joy Hofmeister,REP,550227,0,0,39,39,
Oklahoma,Insurance Commissioner,Bill Viner,REP,550227,0,0,16,16,
Oklahoma,Insurance Commissioner,John Doak,REP,550227,0,0,59,59,
Oklahoma,Corporation Commissioner,Todd Hiett,REP,550227,0,0,33,33,
Oklahoma,Corporation Commissioner,Cliff Branan,REP,550227,0,0,40,40,
Oklahoma,U.S. Senate,Evelyn Rogers,REP,550227,0,0,5,5,
Oklahoma,U.S. Senate,Rob Moye,REP,550227,0,0,0,0,
Oklahoma,U.S. Senate,D. Jean Mcbride-Samuels,REP,550227,0,0,1,1,
Oklahoma,U.S. Senate,Jim Inhofe,REP,550227,0,0,73,73,
Oklahoma,U.S. Senate,Erick Paul Wyatt,REP,550227,0,0,3,3,
Oklahoma,U.S. Senate,Andy Craig,REP,550227,0,0,0,0,
Oklahoma,U.S. Senate,T. Shannon,REP,550227,0,0,21,21,
Oklahoma,U.S. Senate,Randy Brogdon,REP,550227,0,0,2,2,
Oklahoma,U.S. Senate,Eric Mccray,REP,550227,0,0,0,0,
Oklahoma,U.S. Senate,Kevin Crow,REP,550227,0,0,1,1,
Oklahoma,U.S. Senate,James Lankford,REP,550227,0,0,61,61,
Oklahoma,U.S. Senate,Jason Weger,REP,550227,0,0,0,0,
Oklahoma,U.S. House,Shane David Jett,REP,550227,0,0,16,16,05
Oklahoma,U.S. House,Patrice Douglas,REP,550227,0,0,16,16,05
Oklahoma,U.S. House,Mike Turner,REP,550227,0,0,10,10,05
Oklahoma,U.S. House,Steve Russell,REP,550227,0,0,13,13,05
Oklahoma,U.S. House,Harvey Sparks,REP,550227,0,0,2,2,05
Oklahoma,U.S. House,Clark Jolley,REP,550227,0,0,25,25,05
Oklahoma,Superintendent of Public Instruction,John Cox,DEM,550228,0,0,11,11,
Oklahoma,Superintendent of Public Instruction,Jack Jr.,DEM,550228,0,0,7,7,
Oklahoma,Superintendent of Public Instruction,Ivan Holmes,DEM,550228,0,0,7,7,
Oklahoma,Superintendent of Public Instruction,Freda Deskin,DEM,550228,0,0,19,19,
Oklahoma,U.S. Senate,Patrick Michael Hayes,DEM,550228,0,0,6,6,
Oklahoma,U.S. Senate,Jim Rogers,DEM,550228,0,0,8,8,
Oklahoma,U.S. Senate,Connie Johnson,DEM,550228,0,0,30,30,
Oklahoma,U.S. House,Tom Guild,DEM,550228,0,0,18,18,05
Oklahoma,U.S. House,Al Mcaffrey,DEM,550228,0,0,9,9,05
Oklahoma,U.S. House,Leona Leonard,DEM,550228,0,0,17,17,05
Oklahoma,Governor,Dax Ewbank,REP,550228,0,0,8,8,
Oklahoma,Governor,Chad Moody,REP,550228,0,0,12,12,
Oklahoma,Governor,Mary Fallin,REP,550228,0,0,51,51,
Oklahoma,Superintendent of Public Instruction,Brian Kelly,REP,550228,0,0,19,19,
Oklahoma,Superintendent of Public Instruction,Janet Costello Barresi,REP,550228,0,0,13,13,
Oklahoma,Superintendent of Public Instruction,Joy Hofmeister,REP,550228,0,0,37,37,
Oklahoma,Insurance Commissioner,Bill Viner,REP,550228,0,0,11,11,
Oklahoma,Insurance Commissioner,John Doak,REP,550228,0,0,51,51,
Oklahoma,Corporation Commissioner,Todd Hiett,REP,550228,0,0,30,30,
Oklahoma,Corporation Commissioner,Cliff Branan,REP,550228,0,0,34,34,
Oklahoma,U.S. Senate,Evelyn Rogers,REP,550228,0,0,4,4,
Oklahoma,U.S. Senate,Rob Moye,REP,550228,0,0,1,1,
Oklahoma,U.S. Senate,D. Jean Mcbride-Samuels,REP,550228,0,0,2,2,
Oklahoma,U.S. Senate,Jim Inhofe,REP,550228,0,0,61,61,
Oklahoma,U.S. Senate,Erick Paul Wyatt,REP,550228,0,0,1,1,
Oklahoma,U.S. Senate,Andy Craig,REP,550228,0,0,0,0,
Oklahoma,U.S. Senate,T. Shannon,REP,550228,0,0,16,16,
Oklahoma,U.S. Senate,Randy Brogdon,REP,550228,0,0,1,1,
Oklahoma,U.S. Senate,Eric Mccray,REP,550228,0,0,0,0,
Oklahoma,U.S. Senate,Kevin Crow,REP,550228,0,0,2,2,
Oklahoma,U.S. Senate,James Lankford,REP,550228,0,0,52,52,
Oklahoma,U.S. Senate,Jason Weger,REP,550228,0,0,0,0,
Oklahoma,U.S. House,Shane David Jett,REP,550228,0,0,10,10,05
Oklahoma,U.S. House,Patrice Douglas,REP,550228,0,0,12,12,05
Oklahoma,U.S. House,Mike Turner,REP,550228,0,0,13,13,05
Oklahoma,U.S. House,Steve Russell,REP,550228,0,0,22,22,05
Oklahoma,U.S. House,Harvey Sparks,REP,550228,0,0,4,4,05
Oklahoma,U.S. House,Clark Jolley,REP,550228,0,0,7,7,05
Oklahoma,Superintendent of Public Instruction,John Cox,DEM,550229,0,0,18,18,
Oklahoma,Superintendent of Public Instruction,Jack Jr.,DEM,550229,0,0,16,16,
Oklahoma,Superintendent of Public Instruction,Ivan Holmes,DEM,550229,0,0,4,4,
Oklahoma,Superintendent of Public Instruction,Freda Deskin,DEM,550229,0,0,45,45,
Oklahoma,U.S. Senate,Patrick Michael Hayes,DEM,550229,0,0,23,23,
Oklahoma,U.S. Senate,Jim Rogers,DEM,550229,0,0,28,28,
Oklahoma,U.S. Senate,Connie Johnson,DEM,550229,0,0,31,31,
Oklahoma,U.S. House,Tom Guild,DEM,550229,0,0,36,36,05
Oklahoma,U.S. House,Al Mcaffrey,DEM,550229,0,0,18,18,05
Oklahoma,U.S. House,Leona Leonard,DEM,550229,0,0,25,25,05
Oklahoma,Governor,Dax Ewbank,REP,550229,0,0,12,12,
Oklahoma,Governor,Chad Moody,REP,550229,0,0,23,23,
Oklahoma,Governor,Mary Fallin,REP,550229,0,0,118,118,
Oklahoma,Superintendent of Public Instruction,Brian Kelly,REP,550229,0,0,30,30,
Oklahoma,Superintendent of Public Instruction,Janet Costello Barresi,REP,550229,0,0,35,35,
Oklahoma,Superintendent of Public Instruction,Joy Hofmeister,REP,550229,0,0,81,81,
Oklahoma,Insurance Commissioner,Bill Viner,REP,550229,0,0,35,35,
Oklahoma,Insurance Commissioner,John Doak,REP,550229,0,0,101,101,
Oklahoma,Corporation Commissioner,Todd Hiett,REP,550229,0,0,57,57,
Oklahoma,Corporation Commissioner,Cliff Branan,REP,550229,0,0,80,80,
Oklahoma,U.S. Senate,Evelyn Rogers,REP,550229,0,0,7,7,
Oklahoma,U.S. Senate,Rob Moye,REP,550229,0,0,2,2,
Oklahoma,U.S. Senate,D. Jean Mcbride-Samuels,REP,550229,0,0,0,0,
Oklahoma,U.S. Senate,Jim Inhofe,REP,550229,0,0,136,136,
Oklahoma,U.S. Senate,Erick Paul Wyatt,REP,550229,0,0,5,5,
Oklahoma,U.S. Senate,Andy Craig,REP,550229,0,0,1,1,
Oklahoma,U.S. Senate,T. Shannon,REP,550229,0,0,31,31,
Oklahoma,U.S. Senate,Randy Brogdon,REP,550229,0,0,3,3,
Oklahoma,U.S. Senate,Eric Mccray,REP,550229,0,0,3,3,
Oklahoma,U.S. Senate,Kevin Crow,REP,550229,0,0,0,0,
Oklahoma,U.S. Senate,James Lankford,REP,550229,0,0,114,114,
Oklahoma,U.S. Senate,Jason Weger,REP,550229,0,0,0,0,
Oklahoma,U.S. House,Shane David Jett,REP,550229,0,0,10,10,05
Oklahoma,U.S. House,Patrice Douglas,REP,550229,0,0,33,33,05
Oklahoma,U.S. House,Mike Turner,REP,550229,0,0,25,25,05
Oklahoma,U.S. House,Steve Russell,REP,550229,0,0,56,56,05
Oklahoma,U.S. House,Harvey Sparks,REP,550229,0,0,8,8,05
Oklahoma,U.S. House,Clark Jolley,REP,550229,0,0,15,15,05
Oklahoma,Superintendent of Public Instruction,John Cox,DEM,550230,0,0,45,45,
Oklahoma,Superintendent of Public Instruction,Jack Jr.,DEM,550230,0,0,15,15,
Oklahoma,Superintendent of Public Instruction,Ivan Holmes,DEM,550230,0,0,10,10,
Oklahoma,Superintendent of Public Instruction,Freda Deskin,DEM,550230,0,0,35,35,
Oklahoma,U.S. Senate,Patrick Michael Hayes,DEM,550230,0,0,25,25,
Oklahoma,U.S. Senate,Jim Rogers,DEM,550230,0,0,33,33,
Oklahoma,U.S. Senate,Connie Johnson,DEM,550230,0,0,43,43,
Oklahoma,U.S. House,Tom Guild,DEM,550230,0,0,46,46,05
Oklahoma,U.S. House,Al Mcaffrey,DEM,550230,0,0,32,32,05
Oklahoma,U.S. House,Leona Leonard,DEM,550230,0,0,24,24,05
Oklahoma,Governor,Dax Ewbank,REP,550230,0,0,13,13,
Oklahoma,Governor,Chad Moody,REP,550230,0,0,28,28,
Oklahoma,Governor,Mary Fallin,REP,550230,0,0,187,187,
Oklahoma,Superintendent of Public Instruction,Brian Kelly,REP,550230,0,0,56,56,
Oklahoma,Superintendent of Public Instruction,Janet Costello Barresi,REP,550230,0,0,70,70,
Oklahoma,Superintendent of Public Instruction,Joy Hofmeister,REP,550230,0,0,101,101,
Oklahoma,Insurance Commissioner,Bill Viner,REP,550230,0,0,55,55,
Oklahoma,Insurance Commissioner,John Doak,REP,550230,0,0,156,156,
Oklahoma,Corporation Commissioner,Todd Hiett,REP,550230,0,0,98,98,
Oklahoma,Corporation Commissioner,Cliff Branan,REP,550230,0,0,110,110,
Oklahoma,U.S. Senate,Evelyn Rogers,REP,550230,0,0,10,10,
Oklahoma,U.S. Senate,Rob Moye,REP,550230,0,0,5,5,
Oklahoma,U.S. Senate,D. Jean Mcbride-Samuels,REP,550230,0,0,2,2,
Oklahoma,U.S. Senate,Jim Inhofe,REP,550230,0,0,195,195,
Oklahoma,U.S. Senate,Erick Paul Wyatt,REP,550230,0,0,9,9,
Oklahoma,U.S. Senate,Andy Craig,REP,550230,0,0,1,1,
Oklahoma,U.S. Senate,T. Shannon,REP,550230,0,0,42,42,
Oklahoma,U.S. Senate,Randy Brogdon,REP,550230,0,0,1,1,
Oklahoma,U.S. Senate,Eric Mccray,REP,550230,0,0,4,4,
Oklahoma,U.S. Senate,Kevin Crow,REP,550230,0,0,0,0,
Oklahoma,U.S. Senate,James Lankford,REP,550230,0,0,184,184,
Oklahoma,U.S. Senate,Jason Weger,REP,550230,0,0,0,0,
Oklahoma,U.S. House,Shane David Jett,REP,550230,0,0,22,22,05
Oklahoma,U.S. House,Patrice Douglas,REP,550230,0,0,38,38,05
Oklahoma,U.S. House,Mike Turner,REP,550230,0,0,32,32,05
Oklahoma,U.S. House,Steve Russell,REP,550230,0,0,65,65,05
Oklahoma,U.S. House,Harvey Sparks,REP,550230,0,0,17,17,05
Oklahoma,U.S. House,Clark Jolley,REP,550230,0,0,40,40,05
Oklahoma,Superintendent of Public Instruction,John Cox,DEM,550231,0,0,13,13,
Oklahoma,Superintendent of Public Instruction,Jack Jr.,DEM,550231,0,0,6,6,
Oklahoma,Superintendent of Public Instruction,Ivan Holmes,DEM,550231,0,0,4,4,
Oklahoma,Superintendent of Public Instruction,Freda Deskin,DEM,550231,0,0,21,21,
Oklahoma,U.S. Senate,Patrick Michael Hayes,DEM,550231,0,0,7,7,
Oklahoma,U.S. Senate,Jim Rogers,DEM,550231,0,0,9,9,
Oklahoma,U.S. Senate,Connie Johnson,DEM,550231,0,0,24,24,
Oklahoma,U.S. House,Tom Guild,DEM,550231,0,0,16,16,05
Oklahoma,U.S. House,Al Mcaffrey,DEM,550231,0,0,13,13,05
Oklahoma,U.S. House,Leona Leonard,DEM,550231,0,0,13,13,05
Oklahoma,Governor,Dax Ewbank,REP,550231,0,0,7,7,
Oklahoma,Governor,Chad Moody,REP,550231,0,0,19,19,
Oklahoma,Governor,Mary Fallin,REP,550231,0,0,93,93,
Oklahoma,Superintendent of Public Instruction,Brian Kelly,REP,550231,0,0,29,29,
Oklahoma,Superintendent of Public Instruction,Janet Costello Barresi,REP,550231,0,0,32,32,
Oklahoma,Superintendent of Public Instruction,Joy Hofmeister,REP,550231,0,0,54,54,
Oklahoma,Insurance Commissioner,Bill Viner,REP,550231,0,0,19,19,
Oklahoma,Insurance Commissioner,John Doak,REP,550231,0,0,93,93,
Oklahoma,Corporation Commissioner,Todd Hiett,REP,550231,0,0,62,62,
Oklahoma,Corporation Commissioner,Cliff Branan,REP,550231,0,0,47,47,
Oklahoma,U.S. Senate,Evelyn Rogers,REP,550231,0,0,10,10,
Oklahoma,U.S. Senate,Rob Moye,REP,550231,0,0,1,1,
Oklahoma,U.S. Senate,D. Jean Mcbride-Samuels,REP,550231,0,0,1,1,
Oklahoma,U.S. Senate,Jim Inhofe,REP,550231,0,0,101,101,
Oklahoma,U.S. Senate,Erick Paul Wyatt,REP,550231,0,0,5,5,
Oklahoma,U.S. Senate,Andy Craig,REP,550231,0,0,0,0,
Oklahoma,U.S. Senate,T. Shannon,REP,550231,0,0,25,25,
Oklahoma,U.S. Senate,Randy Brogdon,REP,550231,0,0,1,1,
Oklahoma,U.S. Senate,Eric Mccray,REP,550231,0,0,2,2,
Oklahoma,U.S. Senate,Kevin Crow,REP,550231,0,0,1,1,
Oklahoma,U.S. Senate,James Lankford,REP,550231,0,0,88,88,
Oklahoma,U.S. Senate,Jason Weger,REP,550231,0,0,2,2,
Oklahoma,U.S. House,Shane David Jett,REP,550231,0,0,11,11,05
Oklahoma,U.S. House,Patrice Douglas,REP,550231,0,0,22,22,05
Oklahoma,U.S. House,Mike Turner,REP,550231,0,0,21,21,05
Oklahoma,U.S. House,Steve Russell,REP,550231,0,0,43,43,05
Oklahoma,U.S. House,Harvey Sparks,REP,550231,0,0,5,5,05
Oklahoma,U.S. House,Clark Jolley,REP,550231,0,0,15,15,05
Oklahoma,Superintendent of Public Instruction,John Cox,DEM,550232,0,0,18,18,
Oklahoma,Superintendent of Public Instruction,Jack Jr.,DEM,550232,0,0,8,8,
Oklahoma,Superintendent of Public Instruction,Ivan Holmes,DEM,550232,0,0,4,4,
Oklahoma,Superintendent of Public Instruction,Freda Deskin,DEM,550232,0,0,21,21,
Oklahoma,U.S. Senate,Patrick Michael Hayes,DEM,550232,0,0,7,7,
Oklahoma,U.S. Senate,Jim Rogers,DEM,550232,0,0,15,15,
Oklahoma,U.S. Senate,Connie Johnson,DEM,550232,0,0,27,27,
Oklahoma,U.S. House,Tom Guild,DEM,550232,0,0,28,28,05
Oklahoma,U.S. House,Al Mcaffrey,DEM,550232,0,0,10,10,05
Oklahoma,U.S. House,Leona Leonard,DEM,550232,0,0,11,11,05
Oklahoma,Governor,Dax Ewbank,REP,550232,0,0,14,14,
Oklahoma,Governor,Chad Moody,REP,550232,0,0,20,20,
Oklahoma,Governor,Mary Fallin,REP,550232,0,0,125,125,
Oklahoma,Superintendent of Public Instruction,Brian Kelly,REP,550232,0,0,35,35,
Oklahoma,Superintendent of Public Instruction,Janet Costello Barresi,REP,550232,0,0,38,38,
Oklahoma,Superintendent of Public Instruction,Joy Hofmeister,REP,550232,0,0,84,84,
Oklahoma,Insurance Commissioner,Bill Viner,REP,550232,0,0,28,28,
Oklahoma,Insurance Commissioner,John Doak,REP,550232,0,0,122,122,
Oklahoma,Corporation Commissioner,Todd Hiett,REP,550232,0,0,69,69,
Oklahoma,Corporation Commissioner,Cliff Branan,REP,550232,0,0,72,72,
Oklahoma,U.S. Senate,Evelyn Rogers,REP,550232,0,0,8,8,
Oklahoma,U.S. Senate,Rob Moye,REP,550232,0,0,1,1,
Oklahoma,U.S. Senate,D. Jean Mcbride-Samuels,REP,550232,0,0,0,0,
Oklahoma,U.S. Senate,Jim Inhofe,REP,550232,0,0,145,145,
Oklahoma,U.S. Senate,Erick Paul Wyatt,REP,550232,0,0,4,4,
Oklahoma,U.S. Senate,Andy Craig,REP,550232,0,0,0,0,
Oklahoma,U.S. Senate,T. Shannon,REP,550232,0,0,35,35,
Oklahoma,U.S. Senate,Randy Brogdon,REP,550232,0,0,3,3,
Oklahoma,U.S. Senate,Eric Mccray,REP,550232,0,0,0,0,
Oklahoma,U.S. Senate,Kevin Crow,REP,550232,0,0,0,0,
Oklahoma,U.S. Senate,James Lankford,REP,550232,0,0,120,120,
Oklahoma,U.S. Senate,Jason Weger,REP,550232,0,0,2,2,
Oklahoma,U.S. House,Shane David Jett,REP,550232,0,0,14,14,05
Oklahoma,U.S. House,Patrice Douglas,REP,550232,0,0,33,33,05
Oklahoma,U.S. House,Mike Turner,REP,550232,0,0,25,25,05
Oklahoma,U.S. House,Steve Russell,REP,550232,0,0,48,48,05
Oklahoma,U.S. House,Harvey Sparks,REP,550232,0,0,10,10,05
Oklahoma,U.S. House,Clark Jolley,REP,550232,0,0,19,19,05
Oklahoma,State House,Paul Wesselhoft,REP,550232,0,0,123,123,54
Oklahoma,State House,Adam Graham,REP,550232,0,0,27,27,54
Oklahoma,Superintendent of Public Instruction,John Cox,DEM,550233,0,0,6,6,
Oklahoma,Superintendent of Public Instruction,Jack Jr.,DEM,550233,0,0,4,4,
Oklahoma,Superintendent of Public Instruction,Ivan Holmes,DEM,550233,0,0,0,0,
Oklahoma,Superintendent of Public Instruction,Freda Deskin,DEM,550233,0,0,12,12,
Oklahoma,U.S. Senate,Patrick Michael Hayes,DEM,550233,0,0,4,4,
Oklahoma,U.S. Senate,Jim Rogers,DEM,550233,0,0,11,11,
Oklahoma,U.S. Senate,Connie Johnson,DEM,550233,0,0,6,6,
Oklahoma,U.S. House,Tom Guild,DEM,550233,0,0,10,10,05
Oklahoma,U.S. House,Al Mcaffrey,DEM,550233,0,0,6,6,05
Oklahoma,U.S. House,Leona Leonard,DEM,550233,0,0,6,6,05
Oklahoma,Governor,Dax Ewbank,REP,550233,0,0,2,2,
Oklahoma,Governor,Chad Moody,REP,550233,0,0,6,6,
Oklahoma,Governor,Mary Fallin,REP,550233,0,0,19,19,
Oklahoma,Superintendent of Public Instruction,Brian Kelly,REP,550233,0,0,10,10,
Oklahoma,Superintendent of Public Instruction,Janet Costello Barresi,REP,550233,0,0,9,9,
Oklahoma,Superintendent of Public Instruction,Joy Hofmeister,REP,550233,0,0,7,7,
Oklahoma,Insurance Commissioner,Bill Viner,REP,550233,0,0,6,6,
Oklahoma,Insurance Commissioner,John Doak,REP,550233,0,0,20,20,
Oklahoma,Corporation Commissioner,Todd Hiett,REP,550233,0,0,10,10,
Oklahoma,Corporation Commissioner,Cliff Branan,REP,550233,0,0,15,15,
Oklahoma,U.S. Senate,Evelyn Rogers,REP,550233,0,0,0,0,
Oklahoma,U.S. Senate,Rob Moye,REP,550233,0,0,2,2,
Oklahoma,U.S. Senate,D. Jean Mcbride-Samuels,REP,550233,0,0,0,0,
Oklahoma,U.S. Senate,Jim Inhofe,REP,550233,0,0,24,24,
Oklahoma,U.S. Senate,Erick Paul Wyatt,REP,550233,0,0,0,0,
Oklahoma,U.S. Senate,Andy Craig,REP,550233,0,0,0,0,
Oklahoma,U.S. Senate,T. Shannon,REP,550233,0,0,7,7,
Oklahoma,U.S. Senate,Randy Brogdon,REP,550233,0,0,1,1,
Oklahoma,U.S. Senate,Eric Mccray,REP,550233,0,0,0,0,
Oklahoma,U.S. Senate,Kevin Crow,REP,550233,0,0,0,0,
Oklahoma,U.S. Senate,James Lankford,REP,550233,0,0,19,19,
Oklahoma,U.S. Senate,Jason Weger,REP,550233,0,0,1,1,
Oklahoma,U.S. House,Shane David Jett,REP,550233,0,0,4,4,05
Oklahoma,U.S. House,Patrice Douglas,REP,550233,0,0,5,5,05
Oklahoma,U.S. House,Mike Turner,REP,550233,0,0,8,8,05
Oklahoma,U.S. House,Steve Russell,REP,550233,0,0,2,2,05
Oklahoma,U.S. House,Harvey Sparks,REP,550233,0,0,2,2,05
Oklahoma,U.S. House,Clark Jolley,REP,550233,0,0,6,6,05
Oklahoma,State House,Paul Wesselhoft,REP,550233,0,0,19,19,54
Oklahoma,State House,Adam Graham,REP,550233,0,0,5,5,54
Oklahoma,Superintendent of Public Instruction,John Cox,DEM,550234,0,0,12,12,
Oklahoma,Superintendent of Public Instruction,Jack Jr.,DEM,550234,0,0,16,16,
Oklahoma,Superintendent of Public Instruction,Ivan Holmes,DEM,550234,0,0,4,4,
Oklahoma,Superintendent of Public Instruction,Freda Deskin,DEM,550234,0,0,29,29,
Oklahoma,U.S. Senate,Patrick Michael Hayes,DEM,550234,0,0,11,11,
Oklahoma,U.S. Senate,Jim Rogers,DEM,550234,0,0,18,18,
Oklahoma,U.S. Senate,Connie Johnson,DEM,550234,0,0,28,28,
Oklahoma,U.S. House,Tom Guild,DEM,550234,0,0,19,19,05
Oklahoma,U.S. House,Al Mcaffrey,DEM,550234,0,0,18,18,05
Oklahoma,U.S. House,Leona Leonard,DEM,550234,0,0,22,22,05
Oklahoma,Governor,Dax Ewbank,REP,550234,0,0,3,3,
Oklahoma,Governor,Chad Moody,REP,550234,0,0,10,10,
Oklahoma,Governor,Mary Fallin,REP,550234,0,0,68,68,
Oklahoma,Superintendent of Public Instruction,Brian Kelly,REP,550234,0,0,27,27,
Oklahoma,Superintendent of Public Instruction,Janet Costello Barresi,REP,550234,0,0,17,17,
Oklahoma,Superintendent of Public Instruction,Joy Hofmeister,REP,550234,0,0,37,37,
Oklahoma,Insurance Commissioner,Bill Viner,REP,550234,0,0,12,12,
Oklahoma,Insurance Commissioner,John Doak,REP,550234,0,0,65,65,
Oklahoma,Corporation Commissioner,Todd Hiett,REP,550234,0,0,40,40,
Oklahoma,Corporation Commissioner,Cliff Branan,REP,550234,0,0,38,38,
Oklahoma,U.S. Senate,Evelyn Rogers,REP,550234,0,0,4,4,
Oklahoma,U.S. Senate,Rob Moye,REP,550234,0,0,2,2,
Oklahoma,U.S. Senate,D. Jean Mcbride-Samuels,REP,550234,0,0,2,2,
Oklahoma,U.S. Senate,Jim Inhofe,REP,550234,0,0,70,70,
Oklahoma,U.S. Senate,Erick Paul Wyatt,REP,550234,0,0,3,3,
Oklahoma,U.S. Senate,Andy Craig,REP,550234,0,0,1,1,
Oklahoma,U.S. Senate,T. Shannon,REP,550234,0,0,18,18,
Oklahoma,U.S. Senate,Randy Brogdon,REP,550234,0,0,6,6,
Oklahoma,U.S. Senate,Eric Mccray,REP,550234,0,0,1,1,
Oklahoma,U.S. Senate,Kevin Crow,REP,550234,0,0,1,1,
Oklahoma,U.S. Senate,James Lankford,REP,550234,0,0,54,54,
Oklahoma,U.S. Senate,Jason Weger,REP,550234,0,0,1,1,
Oklahoma,U.S. House,Shane David Jett,REP,550234,0,0,5,5,05
Oklahoma,U.S. House,Patrice Douglas,REP,550234,0,0,13,13,05
Oklahoma,U.S. House,Mike Turner,REP,550234,0,0,18,18,05
Oklahoma,U.S. House,Steve Russell,REP,550234,0,0,30,30,05
Oklahoma,U.S. House,Harvey Sparks,REP,550234,0,0,5,5,05
Oklahoma,U.S. House,Clark Jolley,REP,550234,0,0,10,10,05
Oklahoma,Superintendent of Public Instruction,John Cox,DEM,550235,0,0,15,15,
Oklahoma,Superintendent of Public Instruction,Jack Jr.,DEM,550235,0,0,7,7,
Oklahoma,Superintendent of Public Instruction,Ivan Holmes,DEM,550235,0,0,7,7,
Oklahoma,Superintendent of Public Instruction,Freda Deskin,DEM,550235,0,0,29,29,
Oklahoma,U.S. Senate,Patrick Michael Hayes,DEM,550235,0,0,13,13,
Oklahoma,U.S. Senate,Jim Rogers,DEM,550235,0,0,21,21,
Oklahoma,U.S. Senate,Connie Johnson,DEM,550235,0,0,30,30,
Oklahoma,U.S. House,Tom Guild,DEM,550235,0,0,24,24,05
Oklahoma,U.S. House,Al Mcaffrey,DEM,550235,0,0,16,16,05
Oklahoma,U.S. House,Leona Leonard,DEM,550235,0,0,21,21,05
Oklahoma,State Senate,Wilfredo Santos Rivera,DEM,550235,0,0,18,18,46
Oklahoma,State Senate,Kay Floyd,DEM,550235,0,0,45,45,46
Oklahoma,Governor,Dax Ewbank,REP,550235,0,0,2,2,
Oklahoma,Governor,Chad Moody,REP,550235,0,0,4,4,
Oklahoma,Governor,Mary Fallin,REP,550235,0,0,40,40,
Oklahoma,Superintendent of Public Instruction,Brian Kelly,REP,550235,0,0,11,11,
Oklahoma,Superintendent of Public Instruction,Janet Costello Barresi,REP,550235,0,0,10,10,
Oklahoma,Superintendent of Public Instruction,Joy Hofmeister,REP,550235,0,0,24,24,
Oklahoma,Insurance Commissioner,Bill Viner,REP,550235,0,0,5,5,
Oklahoma,Insurance Commissioner,John Doak,REP,550235,0,0,37,37,
Oklahoma,Corporation Commissioner,Todd Hiett,REP,550235,0,0,18,18,
Oklahoma,Corporation Commissioner,Cliff Branan,REP,550235,0,0,25,25,
Oklahoma,U.S. Senate,Evelyn Rogers,REP,550235,0,0,0,0,
Oklahoma,U.S. Senate,Rob Moye,REP,550235,0,0,1,1,
Oklahoma,U.S. Senate,D. Jean Mcbride-Samuels,REP,550235,0,0,0,0,
Oklahoma,U.S. Senate,Jim Inhofe,REP,550235,0,0,44,44,
Oklahoma,U.S. Senate,Erick Paul Wyatt,REP,550235,0,0,0,0,
Oklahoma,U.S. Senate,Andy Craig,REP,550235,0,0,0,0,
Oklahoma,U.S. Senate,T. Shannon,REP,550235,0,0,14,14,
Oklahoma,U.S. Senate,Randy Brogdon,REP,550235,0,0,2,2,
Oklahoma,U.S. Senate,Eric Mccray,REP,550235,0,0,0,0,
Oklahoma,U.S. Senate,Kevin Crow,REP,550235,0,0,0,0,
Oklahoma,U.S. Senate,James Lankford,REP,550235,0,0,30,30,
Oklahoma,U.S. Senate,Jason Weger,REP,550235,0,0,0,0,
Oklahoma,U.S. House,Shane David Jett,REP,550235,0,0,3,3,05
Oklahoma,U.S. House,Patrice Douglas,REP,550235,0,0,12,12,05
Oklahoma,U.S. House,Mike Turner,REP,550235,0,0,12,12,05
Oklahoma,U.S. House,Steve Russell,REP,550235,0,0,11,11,05
Oklahoma,U.S. House,Harvey Sparks,REP,550235,0,0,2,2,05
Oklahoma,U.S. House,Clark Jolley,REP,550235,0,0,4,4,05
Oklahoma,Superintendent of Public Instruction,John Cox,DEM,550236,0,0,0,0,
Oklahoma,Superintendent of Public Instruction,Jack Jr.,DEM,550236,0,0,0,0,
Oklahoma,Superintendent of Public Instruction,Ivan Holmes,DEM,550236,0,0,0,0,
Oklahoma,Superintendent of Public Instruction,Freda Deskin,DEM,550236,0,0,0,0,
Oklahoma,U.S. Senate,Patrick Michael Hayes,DEM,550236,0,0,0,0,
Oklahoma,U.S. Senate,Jim Rogers,DEM,550236,0,0,0,0,
Oklahoma,U.S. Senate,Connie Johnson,DEM,550236,0,0,0,0,
Oklahoma,U.S. House,Tom Guild,DEM,550236,0,0,0,0,05
Oklahoma,U.S. House,Al Mcaffrey,DEM,550236,0,0,0,0,05
Oklahoma,U.S. House,Leona Leonard,DEM,550236,0,0,0,0,05
Oklahoma,State Senate,Wilfredo Santos Rivera,DEM,550236,0,0,0,0,46
Oklahoma,State Senate,Kay Floyd,DEM,550236,0,0,0,0,46
Oklahoma,State House,Steve Davis,DEM,550236,0,0,0,0,99
Oklahoma,State House,Eleanor Darden Thompson,DEM,550236,0,0,0,0,99
Oklahoma,State House,George Young,DEM,550236,0,0,0,0,99
Oklahoma,Governor,Dax Ewbank,REP,550236,0,0,0,0,
Oklahoma,Governor,Chad Moody,REP,550236,0,0,0,0,
Oklahoma,Governor,Mary Fallin,REP,550236,0,0,0,0,
Oklahoma,Superintendent of Public Instruction,Brian Kelly,REP,550236,0,0,0,0,
Oklahoma,Superintendent of Public Instruction,Janet Costello Barresi,REP,550236,0,0,0,0,
Oklahoma,Superintendent of Public Instruction,Joy Hofmeister,REP,550236,0,0,0,0,
Oklahoma,Insurance Commissioner,Bill Viner,REP,550236,0,0,0,0,
Oklahoma,Insurance Commissioner,John Doak,REP,550236,0,0,0,0,
Oklahoma,Corporation Commissioner,Todd Hiett,REP,550236,0,0,0,0,
Oklahoma,Corporation Commissioner,Cliff Branan,REP,550236,0,0,0,0,
Oklahoma,U.S. Senate,Evelyn Rogers,REP,550236,0,0,0,0,
Oklahoma,U.S. Senate,Rob Moye,REP,550236,0,0,0,0,
Oklahoma,U.S. Senate,D. Jean Mcbride-Samuels,REP,550236,0,0,0,0,
Oklahoma,U.S. Senate,Jim Inhofe,REP,550236,0,0,0,0,
Oklahoma,U.S. Senate,Erick Paul Wyatt,REP,550236,0,0,0,0,
Oklahoma,U.S. Senate,Andy Craig,REP,550236,0,0,0,0,
Oklahoma,U.S. Senate,T. Shannon,REP,550236,0,0,0,0,
Oklahoma,U.S. Senate,Randy Brogdon,REP,550236,0,0,0,0,
Oklahoma,U.S. Senate,Eric Mccray,REP,550236,0,0,0,0,
Oklahoma,U.S. Senate,Kevin Crow,REP,550236,0,0,0,0,
Oklahoma,U.S. Senate,James Lankford,REP,550236,0,0,0,0,
Oklahoma,U.S. Senate,Jason Weger,REP,550236,0,0,0,0,
Oklahoma,U.S. House,Shane David Jett,REP,550236,0,0,0,0,05
Oklahoma,U.S. House,Patrice Douglas,REP,550236,0,0,0,0,05
Oklahoma,U.S. House,Mike Turner,REP,550236,0,0,0,0,05
Oklahoma,U.S. House,Steve Russell,REP,550236,0,0,0,0,05
Oklahoma,U.S. House,Harvey Sparks,REP,550236,0,0,0,0,05
Oklahoma,U.S. House,Clark Jolley,REP,550236,0,0,0,0,05
Oklahoma,Superintendent of Public Instruction,John Cox,DEM,550237,0,0,0,0,
Oklahoma,Superintendent of Public Instruction,Jack Jr.,DEM,550237,0,0,0,0,
Oklahoma,Superintendent of Public Instruction,Ivan Holmes,DEM,550237,0,0,0,0,
Oklahoma,Superintendent of Public Instruction,Freda Deskin,DEM,550237,0,0,0,0,
Oklahoma,U.S. Senate,Patrick Michael Hayes,DEM,550237,0,0,0,0,
Oklahoma,U.S. Senate,Jim Rogers,DEM,550237,0,0,0,0,
Oklahoma,U.S. Senate,Connie Johnson,DEM,550237,0,0,0,0,
Oklahoma,U.S. House,Tom Guild,DEM,550237,0,0,0,0,05
Oklahoma,U.S. House,Al Mcaffrey,DEM,550237,0,0,0,0,05
Oklahoma,U.S. House,Leona Leonard,DEM,550237,0,0,0,0,05
Oklahoma,State Senate,Wilfredo Santos Rivera,DEM,550237,0,0,0,0,46
Oklahoma,State Senate,Kay Floyd,DEM,550237,0,0,0,0,46
Oklahoma,State House,Steve Davis,DEM,550237,0,0,0,0,99
Oklahoma,State House,Eleanor Darden Thompson,DEM,550237,0,0,0,0,99
Oklahoma,State House,George Young,DEM,550237,0,0,0,0,99
Oklahoma,Governor,Dax Ewbank,REP,550237,0,0,0,0,
Oklahoma,Governor,Chad Moody,REP,550237,0,0,0,0,
Oklahoma,Governor,Mary Fallin,REP,550237,0,0,0,0,
Oklahoma,Superintendent of Public Instruction,Brian Kelly,REP,550237,0,0,0,0,
Oklahoma,Superintendent of Public Instruction,Janet Costello Barresi,REP,550237,0,0,0,0,
Oklahoma,Superintendent of Public Instruction,Joy Hofmeister,REP,550237,0,0,0,0,
Oklahoma,Insurance Commissioner,Bill Viner,REP,550237,0,0,0,0,
Oklahoma,Insurance Commissioner,John Doak,REP,550237,0,0,0,0,
Oklahoma,Corporation Commissioner,Todd Hiett,REP,550237,0,0,0,0,
Oklahoma,Corporation Commissioner,Cliff Branan,REP,550237,0,0,0,0,
Oklahoma,U.S. Senate,Evelyn Rogers,REP,550237,0,0,0,0,
Oklahoma,U.S. Senate,Rob Moye,REP,550237,0,0,0,0,
Oklahoma,U.S. Senate,D. Jean Mcbride-Samuels,REP,550237,0,0,0,0,
Oklahoma,U.S. Senate,Jim Inhofe,REP,550237,0,0,0,0,
Oklahoma,U.S. Senate,Erick Paul Wyatt,REP,550237,0,0,0,0,
Oklahoma,U.S. Senate,Andy Craig,REP,550237,0,0,0,0,
Oklahoma,U.S. Senate,T. Shannon,REP,550237,0,0,0,0,
Oklahoma,U.S. Senate,Randy Brogdon,REP,550237,0,0,0,0,
Oklahoma,U.S. Senate,Eric Mccray,REP,550237,0,0,0,0,
Oklahoma,U.S. Senate,Kevin Crow,REP,550237,0,0,0,0,
Oklahoma,U.S. Senate,James Lankford,REP,550237,0,0,0,0,
Oklahoma,U.S. Senate,Jason Weger,REP,550237,0,0,0,0,
Oklahoma,U.S. House,Shane David Jett,REP,550237,0,0,0,0,05
Oklahoma,U.S. House,Patrice Douglas,REP,550237,0,0,0,0,05
Oklahoma,U.S. House,Mike Turner,REP,550237,0,0,0,0,05
Oklahoma,U.S. House,Steve Russell,REP,550237,0,0,0,0,05
Oklahoma,U.S. House,Harvey Sparks,REP,550237,0,0,0,0,05
Oklahoma,U.S. House,Clark Jolley,REP,550237,0,0,0,0,05
Oklahoma,Superintendent of Public Instruction,John Cox,DEM,550238,0,0,0,0,
Oklahoma,Superintendent of Public Instruction,Jack Jr.,DEM,550238,0,0,0,0,
Oklahoma,Superintendent of Public Instruction,Ivan Holmes,DEM,550238,0,0,0,0,
Oklahoma,Superintendent of Public Instruction,Freda Deskin,DEM,550238,0,0,0,0,
Oklahoma,U.S. Senate,Patrick Michael Hayes,DEM,550238,0,0,0,0,
Oklahoma,U.S. Senate,Jim Rogers,DEM,550238,0,0,0,0,
Oklahoma,U.S. Senate,Connie Johnson,DEM,550238,0,0,0,0,
Oklahoma,U.S. House,Tom Guild,DEM,550238,0,0,0,0,05
Oklahoma,U.S. House,Al Mcaffrey,DEM,550238,0,0,0,0,05
Oklahoma,U.S. House,Leona Leonard,DEM,550238,0,0,0,0,05
Oklahoma,State House,Steve Davis,DEM,550238,0,0,0,0,99
Oklahoma,State House,Eleanor Darden Thompson,DEM,550238,0,0,0,0,99
Oklahoma,State House,George Young,DEM,550238,0,0,0,0,99
Oklahoma,Governor,Dax Ewbank,REP,550238,0,0,0,0,
Oklahoma,Governor,Chad Moody,REP,550238,0,0,0,0,
Oklahoma,Governor,Mary Fallin,REP,550238,0,0,0,0,
Oklahoma,Superintendent of Public Instruction,Brian Kelly,REP,550238,0,0,0,0,
Oklahoma,Superintendent of Public Instruction,Janet Costello Barresi,REP,550238,0,0,0,0,
Oklahoma,Superintendent of Public Instruction,Joy Hofmeister,REP,550238,0,0,0,0,
Oklahoma,Insurance Commissioner,Bill Viner,REP,550238,0,0,0,0,
Oklahoma,Insurance Commissioner,John Doak,REP,550238,0,0,0,0,
Oklahoma,Corporation Commissioner,Todd Hiett,REP,550238,0,0,0,0,
Oklahoma,Corporation Commissioner,Cliff Branan,REP,550238,0,0,0,0,
Oklahoma,U.S. Senate,Evelyn Rogers,REP,550238,0,0,0,0,
Oklahoma,U.S. Senate,Rob Moye,REP,550238,0,0,0,0,
Oklahoma,U.S. Senate,D. Jean Mcbride-Samuels,REP,550238,0,0,0,0,
Oklahoma,U.S. Senate,Jim Inhofe,REP,550238,0,0,0,0,
Oklahoma,U.S. Senate,Erick Paul Wyatt,REP,550238,0,0,0,0,
Oklahoma,U.S. Senate,Andy Craig,REP,550238,0,0,0,0,
Oklahoma,U.S. Senate,T. Shannon,REP,550238,0,0,0,0,
Oklahoma,U.S. Senate,Randy Brogdon,REP,550238,0,0,0,0,
Oklahoma,U.S. Senate,Eric Mccray,REP,550238,0,0,0,0,
Oklahoma,U.S. Senate,Kevin Crow,REP,550238,0,0,0,0,
Oklahoma,U.S. Senate,James Lankford,REP,550238,0,0,0,0,
Oklahoma,U.S. Senate,Jason Weger,REP,550238,0,0,0,0,
Oklahoma,U.S. House,Shane David Jett,REP,550238,0,0,0,0,05
Oklahoma,U.S. House,Patrice Douglas,REP,550238,0,0,0,0,05
Oklahoma,U.S. House,Mike Turner,REP,550238,0,0,0,0,05
Oklahoma,U.S. House,Steve Russell,REP,550238,0,0,0,0,05
Oklahoma,U.S. House,Harvey Sparks,REP,550238,0,0,0,0,05
Oklahoma,U.S. House,Clark Jolley,REP,550238,0,0,0,0,05
Oklahoma,Superintendent of Public Instruction,John Cox,DEM,550239,0,0,36,36,
Oklahoma,Superintendent of Public Instruction,Jack Jr.,DEM,550239,0,0,20,20,
Oklahoma,Superintendent of Public Instruction,Ivan Holmes,DEM,550239,0,0,21,21,
Oklahoma,Superintendent of Public Instruction,Freda Deskin,DEM,550239,0,0,71,71,
Oklahoma,U.S. Senate,Patrick Michael Hayes,DEM,550239,0,0,4,4,
Oklahoma,U.S. Senate,Jim Rogers,DEM,550239,0,0,7,7,
Oklahoma,U.S. Senate,Connie Johnson,DEM,550239,0,0,144,144,
Oklahoma,U.S. House,Tom Guild,DEM,550239,0,0,45,45,05
Oklahoma,U.S. House,Al Mcaffrey,DEM,550239,0,0,41,41,05
Oklahoma,U.S. House,Leona Leonard,DEM,550239,0,0,60,60,05
Oklahoma,State Senate,Christine Byrd,DEM,550239,0,0,26,26,48
Oklahoma,State Senate,Anastasia Pittman,DEM,550239,0,0,130,130,48
Oklahoma,State House,Steve Davis,DEM,550239,0,0,39,39,99
Oklahoma,State House,Eleanor Darden Thompson,DEM,550239,0,0,51,51,99
Oklahoma,State House,George Young,DEM,550239,0,0,65,65,99
Oklahoma,Governor,Dax Ewbank,REP,550239,0,0,6,6,
Oklahoma,Governor,Chad Moody,REP,550239,0,0,8,8,
Oklahoma,Governor,Mary Fallin,REP,550239,0,0,15,15,
Oklahoma,Superintendent of Public Instruction,Brian Kelly,REP,550239,0,0,5,5,
Oklahoma,Superintendent of Public Instruction,Janet Costello Barresi,REP,550239,0,0,10,10,
Oklahoma,Superintendent of Public Instruction,Joy Hofmeister,REP,550239,0,0,12,12,
Oklahoma,Insurance Commissioner,Bill Viner,REP,550239,0,0,7,7,
Oklahoma,Insurance Commissioner,John Doak,REP,550239,0,0,20,20,
Oklahoma,Corporation Commissioner,Todd Hiett,REP,550239,0,0,16,16,
Oklahoma,Corporation Commissioner,Cliff Branan,REP,550239,0,0,10,10,
Oklahoma,U.S. Senate,Evelyn Rogers,REP,550239,0,0,3,3,
Oklahoma,U.S. Senate,Rob Moye,REP,550239,0,0,1,1,
Oklahoma,U.S. Senate,D. Jean Mcbride-Samuels,REP,550239,0,0,0,0,
Oklahoma,U.S. Senate,Jim Inhofe,REP,550239,0,0,25,25,
Oklahoma,U.S. Senate,Erick Paul Wyatt,REP,550239,0,0,0,0,
Oklahoma,U.S. Senate,Andy Craig,REP,550239,0,0,0,0,
Oklahoma,U.S. Senate,T. Shannon,REP,550239,0,0,10,10,
Oklahoma,U.S. Senate,Randy Brogdon,REP,550239,0,0,3,3,
Oklahoma,U.S. Senate,Eric Mccray,REP,550239,0,0,0,0,
Oklahoma,U.S. Senate,Kevin Crow,REP,550239,0,0,1,1,
Oklahoma,U.S. Senate,James Lankford,REP,550239,0,0,15,15,
Oklahoma,U.S. Senate,Jason Weger,REP,550239,0,0,1,1,
Oklahoma,U.S. House,Shane David Jett,REP,550239,0,0,2,2,05
Oklahoma,U.S. House,Patrice Douglas,REP,550239,0,0,8,8,05
Oklahoma,U.S. House,Mike Turner,REP,550239,0,0,6,6,05
Oklahoma,U.S. House,Steve Russell,REP,550239,0,0,3,3,05
Oklahoma,U.S. House,Harvey Sparks,REP,550239,0,0,2,2,05
Oklahoma,U.S. House,Clark Jolley,REP,550239,0,0,7,7,05
Oklahoma,Superintendent of Public Instruction,John Cox,DEM,550240,0,0,75,75,
Oklahoma,Superintendent of Public Instruction,Jack Jr.,DEM,550240,0,0,23,23,
Oklahoma,Superintendent of Public Instruction,Ivan Holmes,DEM,550240,0,0,22,22,
Oklahoma,Superintendent of Public Instruction,Freda Deskin,DEM,550240,0,0,123,123,
Oklahoma,U.S. Senate,Patrick Michael Hayes,DEM,550240,0,0,14,14,
Oklahoma,U.S. Senate,Jim Rogers,DEM,550240,0,0,11,11,
Oklahoma,U.S. Senate,Connie Johnson,DEM,550240,0,0,228,228,
Oklahoma,U.S. House,Tom Guild,DEM,550240,0,0,71,71,05
Oklahoma,U.S. House,Al Mcaffrey,DEM,550240,0,0,38,38,05
Oklahoma,U.S. House,Leona Leonard,DEM,550240,0,0,125,125,05
Oklahoma,State Senate,Christine Byrd,DEM,550240,0,0,27,27,48
Oklahoma,State Senate,Anastasia Pittman,DEM,550240,0,0,224,224,48
Oklahoma,State House,Steve Davis,DEM,550240,0,0,79,79,99
Oklahoma,State House,Eleanor Darden Thompson,DEM,550240,0,0,68,68,99
Oklahoma,State House,George Young,DEM,550240,0,0,100,100,99
Oklahoma,Governor,Dax Ewbank,REP,550240,0,0,2,2,
Oklahoma,Governor,Chad Moody,REP,550240,0,0,3,3,
Oklahoma,Governor,Mary Fallin,REP,550240,0,0,10,10,
Oklahoma,Superintendent of Public Instruction,Brian Kelly,REP,550240,0,0,5,5,
Oklahoma,Superintendent of Public Instruction,Janet Costello Barresi,REP,550240,0,0,7,7,
Oklahoma,Superintendent of Public Instruction,Joy Hofmeister,REP,550240,0,0,3,3,
Oklahoma,Insurance Commissioner,Bill Viner,REP,550240,0,0,5,5,
Oklahoma,Insurance Commissioner,John Doak,REP,550240,0,0,10,10,
Oklahoma,Corporation Commissioner,Todd Hiett,REP,550240,0,0,8,8,
Oklahoma,Corporation Commissioner,Cliff Branan,REP,550240,0,0,5,5,
Oklahoma,U.S. Senate,Evelyn Rogers,REP,550240,0,0,0,0,
Oklahoma,U.S. Senate,Rob Moye,REP,550240,0,0,1,1,
Oklahoma,U.S. Senate,D. Jean Mcbride-Samuels,REP,550240,0,0,1,1,
Oklahoma,U.S. Senate,Jim Inhofe,REP,550240,0,0,10,10,
Oklahoma,U.S. Senate,Erick Paul Wyatt,REP,550240,0,0,2,2,
Oklahoma,U.S. Senate,Andy Craig,REP,550240,0,0,0,0,
Oklahoma,U.S. Senate,T. Shannon,REP,550240,0,0,8,8,
Oklahoma,U.S. Senate,Randy Brogdon,REP,550240,0,0,1,1,
Oklahoma,U.S. Senate,Eric Mccray,REP,550240,0,0,1,1,
Oklahoma,U.S. Senate,Kevin Crow,REP,550240,0,0,0,0,
Oklahoma,U.S. Senate,James Lankford,REP,550240,0,0,3,3,
Oklahoma,U.S. Senate,Jason Weger,REP,550240,0,0,1,1,
Oklahoma,U.S. House,Shane David Jett,REP,550240,0,0,4,4,05
Oklahoma,U.S. House,Patrice Douglas,REP,550240,0,0,2,2,05
Oklahoma,U.S. House,Mike Turner,REP,550240,0,0,5,5,05
Oklahoma,U.S. House,Steve Russell,REP,550240,0,0,2,2,05
Oklahoma,U.S. House,Harvey Sparks,REP,550240,0,0,1,1,05
Oklahoma,U.S. House,Clark Jolley,REP,550240,0,0,1,1,05
Oklahoma,Superintendent of Public Instruction,John Cox,DEM,550241,0,0,36,36,
Oklahoma,Superintendent of Public Instruction,Jack Jr.,DEM,550241,0,0,14,14,
Oklahoma,Superintendent of Public Instruction,Ivan Holmes,DEM,550241,0,0,11,11,
Oklahoma,Superintendent of Public Instruction,Freda Deskin,DEM,550241,0,0,74,74,
Oklahoma,U.S. Senate,Patrick Michael Hayes,DEM,550241,0,0,3,3,
Oklahoma,U.S. Senate,Jim Rogers,DEM,550241,0,0,6,6,
Oklahoma,U.S. Senate,Connie Johnson,DEM,550241,0,0,135,135,
Oklahoma,U.S. House,Tom Guild,DEM,550241,0,0,44,44,05
Oklahoma,U.S. House,Al Mcaffrey,DEM,550241,0,0,42,42,05
Oklahoma,U.S. House,Leona Leonard,DEM,550241,0,0,50,50,05
Oklahoma,State Senate,Christine Byrd,DEM,550241,0,0,10,10,48
Oklahoma,State Senate,Anastasia Pittman,DEM,550241,0,0,135,135,48
Oklahoma,State House,Steve Davis,DEM,550241,0,0,24,24,99
Oklahoma,State House,Eleanor Darden Thompson,DEM,550241,0,0,71,71,99
Oklahoma,State House,George Young,DEM,550241,0,0,48,48,99
Oklahoma,Governor,Dax Ewbank,REP,550241,0,0,2,2,
Oklahoma,Governor,Chad Moody,REP,550241,0,0,10,10,
Oklahoma,Governor,Mary Fallin,REP,550241,0,0,14,14,
Oklahoma,Superintendent of Public Instruction,Brian Kelly,REP,550241,0,0,7,7,
Oklahoma,Superintendent of Public Instruction,Janet Costello Barresi,REP,550241,0,0,7,7,
Oklahoma,Superintendent of Public Instruction,Joy Hofmeister,REP,550241,0,0,13,13,
Oklahoma,Insurance Commissioner,Bill Viner,REP,550241,0,0,5,5,
Oklahoma,Insurance Commissioner,John Doak,REP,550241,0,0,21,21,
Oklahoma,Corporation Commissioner,Todd Hiett,REP,550241,0,0,5,5,
Oklahoma,Corporation Commissioner,Cliff Branan,REP,550241,0,0,21,21,
Oklahoma,U.S. Senate,Evelyn Rogers,REP,550241,0,0,5,5,
Oklahoma,U.S. Senate,Rob Moye,REP,550241,0,0,1,1,
Oklahoma,U.S. Senate,D. Jean Mcbride-Samuels,REP,550241,0,0,0,0,
Oklahoma,U.S. Senate,Jim Inhofe,REP,550241,0,0,19,19,
Oklahoma,U.S. Senate,Erick Paul Wyatt,REP,550241,0,0,1,1,
Oklahoma,U.S. Senate,Andy Craig,REP,550241,0,0,0,0,
Oklahoma,U.S. Senate,T. Shannon,REP,550241,0,0,8,8,
Oklahoma,U.S. Senate,Randy Brogdon,REP,550241,0,0,3,3,
Oklahoma,U.S. Senate,Eric Mccray,REP,550241,0,0,1,1,
Oklahoma,U.S. Senate,Kevin Crow,REP,550241,0,0,1,1,
Oklahoma,U.S. Senate,James Lankford,REP,550241,0,0,12,12,
Oklahoma,U.S. Senate,Jason Weger,REP,550241,0,0,2,2,
Oklahoma,U.S. House,Shane David Jett,REP,550241,0,0,6,6,05
Oklahoma,U.S. House,Patrice Douglas,REP,550241,0,0,9,9,05
Oklahoma,U.S. House,Mike Turner,REP,550241,0,0,4,4,05
Oklahoma,U.S. House,Steve Russell,REP,550241,0,0,3,3,05
Oklahoma,U.S. House,Harvey Sparks,REP,550241,0,0,1,1,05
Oklahoma,U.S. House,Clark Jolley,REP,550241,0,0,3,3,05
Oklahoma,Superintendent of Public Instruction,John Cox,DEM,550242,0,0,53,53,
Oklahoma,Superintendent of Public Instruction,Jack Jr.,DEM,550242,0,0,19,19,
Oklahoma,Superintendent of Public Instruction,Ivan Holmes,DEM,550242,0,0,21,21,
Oklahoma,Superintendent of Public Instruction,Freda Deskin,DEM,550242,0,0,100,100,
Oklahoma,U.S. Senate,Patrick Michael Hayes,DEM,550242,0,0,14,14,
Oklahoma,U.S. Senate,Jim Rogers,DEM,550242,0,0,5,5,
Oklahoma,U.S. Senate,Connie Johnson,DEM,550242,0,0,186,186,
Oklahoma,U.S. House,Tom Guild,DEM,550242,0,0,65,65,05
Oklahoma,U.S. House,Al Mcaffrey,DEM,550242,0,0,39,39,05
Oklahoma,U.S. House,Leona Leonard,DEM,550242,0,0,85,85,05
Oklahoma,State Senate,Christine Byrd,DEM,550242,0,0,24,24,48
Oklahoma,State Senate,Anastasia Pittman,DEM,550242,0,0,179,179,48
Oklahoma,State House,Mike Shelton,DEM,550242,0,0,174,174,97
Oklahoma,State House,Bruce Fisher,DEM,550242,0,0,30,30,97
Oklahoma,Governor,Dax Ewbank,REP,550242,0,0,1,1,
Oklahoma,Governor,Chad Moody,REP,550242,0,0,2,2,
Oklahoma,Governor,Mary Fallin,REP,550242,0,0,2,2,
Oklahoma,Superintendent of Public Instruction,Brian Kelly,REP,550242,0,0,4,4,
Oklahoma,Superintendent of Public Instruction,Janet Costello Barresi,REP,550242,0,0,0,0,
Oklahoma,Superintendent of Public Instruction,Joy Hofmeister,REP,550242,0,0,1,1,
Oklahoma,Insurance Commissioner,Bill Viner,REP,550242,0,0,3,3,
Oklahoma,Insurance Commissioner,John Doak,REP,550242,0,0,1,1,
Oklahoma,Corporation Commissioner,Todd Hiett,REP,550242,0,0,2,2,
Oklahoma,Corporation Commissioner,Cliff Branan,REP,550242,0,0,2,2,
Oklahoma,U.S. Senate,Evelyn Rogers,REP,550242,0,0,1,1,
Oklahoma,U.S. Senate,Rob Moye,REP,550242,0,0,0,0,
Oklahoma,U.S. Senate,D. Jean Mcbride-Samuels,REP,550242,0,0,0,0,
Oklahoma,U.S. Senate,Jim Inhofe,REP,550242,0,0,4,4,
Oklahoma,U.S. Senate,Erick Paul Wyatt,REP,550242,0,0,0,0,
Oklahoma,U.S. Senate,Andy Craig,REP,550242,0,0,0,0,
Oklahoma,U.S. Senate,T. Shannon,REP,550242,0,0,4,4,
Oklahoma,U.S. Senate,Randy Brogdon,REP,550242,0,0,0,0,
Oklahoma,U.S. Senate,Eric Mccray,REP,550242,0,0,0,0,
Oklahoma,U.S. Senate,Kevin Crow,REP,550242,0,0,0,0,
Oklahoma,U.S. Senate,James Lankford,REP,550242,0,0,1,1,
Oklahoma,U.S. Senate,Jason Weger,REP,550242,0,0,0,0,
Oklahoma,U.S. House,Shane David Jett,REP,550242,0,0,1,1,05
Oklahoma,U.S. House,Patrice Douglas,REP,550242,0,0,1,1,05
Oklahoma,U.S. House,Mike Turner,REP,550242,0,0,1,1,05
Oklahoma,U.S. House,Steve Russell,REP,550242,0,0,0,0,05
Oklahoma,U.S. House,Harvey Sparks,REP,550242,0,0,1,1,05
Oklahoma,U.S. House,Clark Jolley,REP,550242,0,0,1,1,05
Oklahoma,Superintendent of Public Instruction,John Cox,DEM,550243,0,0,82,82,
Oklahoma,Superintendent of Public Instruction,Jack Jr.,DEM,550243,0,0,16,16,
Oklahoma,Superintendent of Public Instruction,Ivan Holmes,DEM,550243,0,0,37,37,
Oklahoma,Superintendent of Public Instruction,Freda Deskin,DEM,550243,0,0,124,124,
Oklahoma,U.S. Senate,Patrick Michael Hayes,DEM,550243,0,0,7,7,
Oklahoma,U.S. Senate,Jim Rogers,DEM,550243,0,0,6,6,
Oklahoma,U.S. Senate,Connie Johnson,DEM,550243,0,0,259,259,
Oklahoma,U.S. House,Tom Guild,DEM,550243,0,0,95,95,05
Oklahoma,U.S. House,Al Mcaffrey,DEM,550243,0,0,48,48,05
Oklahoma,U.S. House,Leona Leonard,DEM,550243,0,0,110,110,05
Oklahoma,State Senate,Christine Byrd,DEM,550243,0,0,32,32,48
Oklahoma,State Senate,Anastasia Pittman,DEM,550243,0,0,238,238,48
Oklahoma,State House,Mike Shelton,DEM,550243,0,0,213,213,97
Oklahoma,State House,Bruce Fisher,DEM,550243,0,0,55,55,97
Oklahoma,Governor,Dax Ewbank,REP,550243,0,0,2,2,
Oklahoma,Governor,Chad Moody,REP,550243,0,0,1,1,
Oklahoma,Governor,Mary Fallin,REP,550243,0,0,4,4,
Oklahoma,Superintendent of Public Instruction,Brian Kelly,REP,550243,0,0,1,1,
Oklahoma,Superintendent of Public Instruction,Janet Costello Barresi,REP,550243,0,0,1,1,
Oklahoma,Superintendent of Public Instruction,Joy Hofmeister,REP,550243,0,0,5,5,
Oklahoma,Insurance Commissioner,Bill Viner,REP,550243,0,0,2,2,
Oklahoma,Insurance Commissioner,John Doak,REP,550243,0,0,5,5,
Oklahoma,Corporation Commissioner,Todd Hiett,REP,550243,0,0,4,4,
Oklahoma,Corporation Commissioner,Cliff Branan,REP,550243,0,0,2,2,
Oklahoma,U.S. Senate,Evelyn Rogers,REP,550243,0,0,1,1,
Oklahoma,U.S. Senate,Rob Moye,REP,550243,0,0,0,0,
Oklahoma,U.S. Senate,D. Jean Mcbride-Samuels,REP,550243,0,0,0,0,
Oklahoma,U.S. Senate,Jim Inhofe,REP,550243,0,0,3,3,
Oklahoma,U.S. Senate,Erick Paul Wyatt,REP,550243,0,0,2,2,
Oklahoma,U.S. Senate,Andy Craig,REP,550243,0,0,0,0,
Oklahoma,U.S. Senate,T. Shannon,REP,550243,0,0,3,3,
Oklahoma,U.S. Senate,Randy Brogdon,REP,550243,0,0,2,2,
Oklahoma,U.S. Senate,Eric Mccray,REP,550243,0,0,0,0,
Oklahoma,U.S. Senate,Kevin Crow,REP,550243,0,0,0,0,
Oklahoma,U.S. Senate,James Lankford,REP,550243,0,0,1,1,
Oklahoma,U.S. Senate,Jason Weger,REP,550243,0,0,0,0,
Oklahoma,U.S. House,Shane David Jett,REP,550243,0,0,0,0,05
Oklahoma,U.S. House,Patrice Douglas,REP,550243,0,0,1,1,05
Oklahoma,U.S. House,Mike Turner,REP,550243,0,0,1,1,05
Oklahoma,U.S. House,Steve Russell,REP,550243,0,0,1,1,05
Oklahoma,U.S. House,Harvey Sparks,REP,550243,0,0,1,1,05
Oklahoma,U.S. House,Clark Jolley,REP,550243,0,0,1,1,05
Oklahoma,Superintendent of Public Instruction,John Cox,DEM,550244,0,0,59,59,
Oklahoma,Superintendent of Public Instruction,Jack Jr.,DEM,550244,0,0,28,28,
Oklahoma,Superintendent of Public Instruction,Ivan Holmes,DEM,550244,0,0,36,36,
Oklahoma,Superintendent of Public Instruction,Freda Deskin,DEM,550244,0,0,117,117,
Oklahoma,U.S. Senate,Patrick Michael Hayes,DEM,550244,0,0,7,7,
Oklahoma,U.S. Senate,Jim Rogers,DEM,550244,0,0,1,1,
Oklahoma,U.S. Senate,Connie Johnson,DEM,550244,0,0,262,262,
Oklahoma,U.S. House,Tom Guild,DEM,550244,0,0,81,81,05
Oklahoma,U.S. House,Al Mcaffrey,DEM,550244,0,0,45,45,05
Oklahoma,U.S. House,Leona Leonard,DEM,550244,0,0,111,111,05
Oklahoma,State Senate,Christine Byrd,DEM,550244,0,0,27,27,48
Oklahoma,State Senate,Anastasia Pittman,DEM,550244,0,0,248,248,48
Oklahoma,State House,Steve Davis,DEM,550244,0,0,60,60,99
Oklahoma,State House,Eleanor Darden Thompson,DEM,550244,0,0,78,78,99
Oklahoma,State House,George Young,DEM,550244,0,0,125,125,99
Oklahoma,Governor,Dax Ewbank,REP,550244,0,0,1,1,
Oklahoma,Governor,Chad Moody,REP,550244,0,0,3,3,
Oklahoma,Governor,Mary Fallin,REP,550244,0,0,6,6,
Oklahoma,Superintendent of Public Instruction,Brian Kelly,REP,550244,0,0,4,4,
Oklahoma,Superintendent of Public Instruction,Janet Costello Barresi,REP,550244,0,0,4,4,
Oklahoma,Superintendent of Public Instruction,Joy Hofmeister,REP,550244,0,0,3,3,
Oklahoma,Insurance Commissioner,Bill Viner,REP,550244,0,0,4,4,
Oklahoma,Insurance Commissioner,John Doak,REP,550244,0,0,7,7,
Oklahoma,Corporation Commissioner,Todd Hiett,REP,550244,0,0,3,3,
Oklahoma,Corporation Commissioner,Cliff Branan,REP,550244,0,0,8,8,
Oklahoma,U.S. Senate,Evelyn Rogers,REP,550244,0,0,2,2,
Oklahoma,U.S. Senate,Rob Moye,REP,550244,0,0,0,0,
Oklahoma,U.S. Senate,D. Jean Mcbride-Samuels,REP,550244,0,0,1,1,
Oklahoma,U.S. Senate,Jim Inhofe,REP,550244,0,0,6,6,
Oklahoma,U.S. Senate,Erick Paul Wyatt,REP,550244,0,0,1,1,
Oklahoma,U.S. Senate,Andy Craig,REP,550244,0,0,0,0,
Oklahoma,U.S. Senate,T. Shannon,REP,550244,0,0,6,6,
Oklahoma,U.S. Senate,Randy Brogdon,REP,550244,0,0,0,0,
Oklahoma,U.S. Senate,Eric Mccray,REP,550244,0,0,0,0,
Oklahoma,U.S. Senate,Kevin Crow,REP,550244,0,0,1,1,
Oklahoma,U.S. Senate,James Lankford,REP,550244,0,0,4,4,
Oklahoma,U.S. Senate,Jason Weger,REP,550244,0,0,0,0,
Oklahoma,U.S. House,Shane David Jett,REP,550244,0,0,0,0,05
Oklahoma,U.S. House,Patrice Douglas,REP,550244,0,0,2,2,05
Oklahoma,U.S. House,Mike Turner,REP,550244,0,0,2,2,05
Oklahoma,U.S. House,Steve Russell,REP,550244,0,0,2,2,05
Oklahoma,U.S. House,Harvey Sparks,REP,550244,0,0,0,0,05
Oklahoma,U.S. House,Clark Jolley,REP,550244,0,0,5,5,05
Oklahoma,Superintendent of Public Instruction,John Cox,DEM,550245,0,0,74,74,
Oklahoma,Superintendent of Public Instruction,Jack Jr.,DEM,550245,0,0,36,36,
Oklahoma,Superintendent of Public Instruction,Ivan Holmes,DEM,550245,0,0,56,56,
Oklahoma,Superintendent of Public Instruction,Freda Deskin,DEM,550245,0,0,143,143,
Oklahoma,U.S. Senate,Patrick Michael Hayes,DEM,550245,0,0,7,7,
Oklahoma,U.S. Senate,Jim Rogers,DEM,550245,0,0,10,10,
Oklahoma,U.S. Senate,Connie Johnson,DEM,550245,0,0,313,313,
Oklahoma,U.S. House,Tom Guild,DEM,550245,0,0,100,100,05
Oklahoma,U.S. House,Al Mcaffrey,DEM,550245,0,0,57,57,05
Oklahoma,U.S. House,Leona Leonard,DEM,550245,0,0,145,145,05
Oklahoma,State Senate,Christine Byrd,DEM,550245,0,0,29,29,48
Oklahoma,State Senate,Anastasia Pittman,DEM,550245,0,0,300,300,48
Oklahoma,State House,Steve Davis,DEM,550245,0,0,82,82,99
Oklahoma,State House,Eleanor Darden Thompson,DEM,550245,0,0,96,96,99
Oklahoma,State House,George Young,DEM,550245,0,0,142,142,99
Oklahoma,Governor,Dax Ewbank,REP,550245,0,0,1,1,
Oklahoma,Governor,Chad Moody,REP,550245,0,0,1,1,
Oklahoma,Governor,Mary Fallin,REP,550245,0,0,3,3,
Oklahoma,Superintendent of Public Instruction,Brian Kelly,REP,550245,0,0,4,4,
Oklahoma,Superintendent of Public Instruction,Janet Costello Barresi,REP,550245,0,0,0,0,
Oklahoma,Superintendent of Public Instruction,Joy Hofmeister,REP,550245,0,0,1,1,
Oklahoma,Insurance Commissioner,Bill Viner,REP,550245,0,0,1,1,
Oklahoma,Insurance Commissioner,John Doak,REP,550245,0,0,4,4,
Oklahoma,Corporation Commissioner,Todd Hiett,REP,550245,0,0,2,2,
Oklahoma,Corporation Commissioner,Cliff Branan,REP,550245,0,0,3,3,
Oklahoma,U.S. Senate,Evelyn Rogers,REP,550245,0,0,0,0,
Oklahoma,U.S. Senate,Rob Moye,REP,550245,0,0,0,0,
Oklahoma,U.S. Senate,D. Jean Mcbride-Samuels,REP,550245,0,0,0,0,
Oklahoma,U.S. Senate,Jim Inhofe,REP,550245,0,0,4,4,
Oklahoma,U.S. Senate,Erick Paul Wyatt,REP,550245,0,0,1,1,
Oklahoma,U.S. Senate,Andy Craig,REP,550245,0,0,0,0,
Oklahoma,U.S. Senate,T. Shannon,REP,550245,0,0,1,1,
Oklahoma,U.S. Senate,Randy Brogdon,REP,550245,0,0,0,0,
Oklahoma,U.S. Senate,Eric Mccray,REP,550245,0,0,0,0,
Oklahoma,U.S. Senate,Kevin Crow,REP,550245,0,0,0,0,
Oklahoma,U.S. Senate,James Lankford,REP,550245,0,0,4,4,
Oklahoma,U.S. Senate,Jason Weger,REP,550245,0,0,0,0,
Oklahoma,U.S. House,Shane David Jett,REP,550245,0,0,1,1,05
Oklahoma,U.S. House,Patrice Douglas,REP,550245,0,0,0,0,05
Oklahoma,U.S. House,Mike Turner,REP,550245,0,0,1,1,05
Oklahoma,U.S. House,Steve Russell,REP,550245,0,0,2,2,05
Oklahoma,U.S. House,Harvey Sparks,REP,550245,0,0,0,0,05
Oklahoma,U.S. House,Clark Jolley,REP,550245,0,0,1,1,05
Oklahoma,Superintendent of Public Instruction,John Cox,DEM,550246,0,0,5,5,
Oklahoma,Superintendent of Public Instruction,Jack Jr.,DEM,550246,0,0,0,0,
Oklahoma,Superintendent of Public Instruction,Ivan Holmes,DEM,550246,0,0,1,1,
Oklahoma,Superintendent of Public Instruction,Freda Deskin,DEM,550246,0,0,9,9,
Oklahoma,U.S. Senate,Patrick Michael Hayes,DEM,550246,0,0,1,1,
Oklahoma,U.S. Senate,Jim Rogers,DEM,550246,0,0,8,8,
Oklahoma,U.S. Senate,Connie Johnson,DEM,550246,0,0,6,6,
Oklahoma,U.S. House,Tom Guild,DEM,550246,0,0,7,7,05
Oklahoma,U.S. House,Al Mcaffrey,DEM,550246,0,0,4,4,05
Oklahoma,U.S. House,Leona Leonard,DEM,550246,0,0,3,3,05
Oklahoma,Governor,Dax Ewbank,REP,550246,0,0,3,3,
Oklahoma,Governor,Chad Moody,REP,550246,0,0,8,8,
Oklahoma,Governor,Mary Fallin,REP,550246,0,0,15,15,
Oklahoma,Superintendent of Public Instruction,Brian Kelly,REP,550246,0,0,11,11,
Oklahoma,Superintendent of Public Instruction,Janet Costello Barresi,REP,550246,0,0,6,6,
Oklahoma,Superintendent of Public Instruction,Joy Hofmeister,REP,550246,0,0,9,9,
Oklahoma,Insurance Commissioner,Bill Viner,REP,550246,0,0,8,8,
Oklahoma,Insurance Commissioner,John Doak,REP,550246,0,0,18,18,
Oklahoma,Corporation Commissioner,Todd Hiett,REP,550246,0,0,8,8,
Oklahoma,Corporation Commissioner,Cliff Branan,REP,550246,0,0,17,17,
Oklahoma,U.S. Senate,Evelyn Rogers,REP,550246,0,0,3,3,
Oklahoma,U.S. Senate,Rob Moye,REP,550246,0,0,2,2,
Oklahoma,U.S. Senate,D. Jean Mcbride-Samuels,REP,550246,0,0,1,1,
Oklahoma,U.S. Senate,Jim Inhofe,REP,550246,0,0,19,19,
Oklahoma,U.S. Senate,Erick Paul Wyatt,REP,550246,0,0,1,1,
Oklahoma,U.S. Senate,Andy Craig,REP,550246,0,0,0,0,
Oklahoma,U.S. Senate,T. Shannon,REP,550246,0,0,9,9,
Oklahoma,U.S. Senate,Randy Brogdon,REP,550246,0,0,0,0,
Oklahoma,U.S. Senate,Eric Mccray,REP,550246,0,0,0,0,
Oklahoma,U.S. Senate,Kevin Crow,REP,550246,0,0,0,0,
Oklahoma,U.S. Senate,James Lankford,REP,550246,0,0,17,17,
Oklahoma,U.S. Senate,Jason Weger,REP,550246,0,0,0,0,
Oklahoma,U.S. House,Shane David Jett,REP,550246,0,0,4,4,05
Oklahoma,U.S. House,Patrice Douglas,REP,550246,0,0,5,5,05
Oklahoma,U.S. House,Mike Turner,REP,550246,0,0,2,2,05
Oklahoma,U.S. House,Steve Russell,REP,550246,0,0,10,10,05
Oklahoma,U.S. House,Harvey Sparks,REP,550246,0,0,1,1,05
Oklahoma,U.S. House,Clark Jolley,REP,550246,0,0,4,4,05
Oklahoma,Superintendent of Public Instruction,John Cox,DEM,550247,0,0,12,12,
Oklahoma,Superintendent of Public Instruction,Jack Jr.,DEM,550247,0,0,5,5,
Oklahoma,Superintendent of Public Instruction,Ivan Holmes,DEM,550247,0,0,3,3,
Oklahoma,Superintendent of Public Instruction,Freda Deskin,DEM,550247,0,0,22,22,
Oklahoma,U.S. Senate,Patrick Michael Hayes,DEM,550247,0,0,10,10,
Oklahoma,U.S. Senate,Jim Rogers,DEM,550247,0,0,7,7,
Oklahoma,U.S. Senate,Connie Johnson,DEM,550247,0,0,25,25,
Oklahoma,U.S. House,Tom Guild,DEM,550247,0,0,21,21,05
Oklahoma,U.S. House,Al Mcaffrey,DEM,550247,0,0,7,7,05
Oklahoma,U.S. House,Leona Leonard,DEM,550247,0,0,14,14,05
Oklahoma,Governor,Dax Ewbank,REP,550247,0,0,5,5,
Oklahoma,Governor,Chad Moody,REP,550247,0,0,3,3,
Oklahoma,Governor,Mary Fallin,REP,550247,0,0,34,34,
Oklahoma,Superintendent of Public Instruction,Brian Kelly,REP,550247,0,0,12,12,
Oklahoma,Superintendent of Public Instruction,Janet Costello Barresi,REP,550247,0,0,12,12,
Oklahoma,Superintendent of Public Instruction,Joy Hofmeister,REP,550247,0,0,16,16,
Oklahoma,Insurance Commissioner,Bill Viner,REP,550247,0,0,7,7,
Oklahoma,Insurance Commissioner,John Doak,REP,550247,0,0,32,32,
Oklahoma,Corporation Commissioner,Todd Hiett,REP,550247,0,0,24,24,
Oklahoma,Corporation Commissioner,Cliff Branan,REP,550247,0,0,14,14,
Oklahoma,U.S. Senate,Evelyn Rogers,REP,550247,0,0,4,4,
Oklahoma,U.S. Senate,Rob Moye,REP,550247,0,0,2,2,
Oklahoma,U.S. Senate,D. Jean Mcbride-Samuels,REP,550247,0,0,2,2,
Oklahoma,U.S. Senate,Jim Inhofe,REP,550247,0,0,33,33,
Oklahoma,U.S. Senate,Erick Paul Wyatt,REP,550247,0,0,0,0,
Oklahoma,U.S. Senate,Andy Craig,REP,550247,0,0,1,1,
Oklahoma,U.S. Senate,T. Shannon,REP,550247,0,0,11,11,
Oklahoma,U.S. Senate,Randy Brogdon,REP,550247,0,0,3,3,
Oklahoma,U.S. Senate,Eric Mccray,REP,550247,0,0,0,0,
Oklahoma,U.S. Senate,Kevin Crow,REP,550247,0,0,1,1,
Oklahoma,U.S. Senate,James Lankford,REP,550247,0,0,26,26,
Oklahoma,U.S. Senate,Jason Weger,REP,550247,0,0,0,0,
Oklahoma,U.S. House,Shane David Jett,REP,550247,0,0,5,5,05
Oklahoma,U.S. House,Patrice Douglas,REP,550247,0,0,10,10,05
Oklahoma,U.S. House,Mike Turner,REP,550247,0,0,6,6,05
Oklahoma,U.S. House,Steve Russell,REP,550247,0,0,16,16,05
Oklahoma,U.S. House,Harvey Sparks,REP,550247,0,0,1,1,05
Oklahoma,U.S. House,Clark Jolley,REP,550247,0,0,3,3,05
Oklahoma,Superintendent of Public Instruction,John Cox,DEM,550248,0,0,49,49,
Oklahoma,Superintendent of Public Instruction,Jack Jr.,DEM,550248,0,0,16,16,
Oklahoma,Superintendent of Public Instruction,Ivan Holmes,DEM,550248,0,0,19,19,
Oklahoma,Superintendent of Public Instruction,Freda Deskin,DEM,550248,0,0,83,83,
Oklahoma,U.S. Senate,Patrick Michael Hayes,DEM,550248,0,0,16,16,
Oklahoma,U.S. Senate,Jim Rogers,DEM,550248,0,0,23,23,
Oklahoma,U.S. Senate,Connie Johnson,DEM,550248,0,0,128,128,
Oklahoma,U.S. House,Tom Guild,DEM,550248,0,0,86,86,05
Oklahoma,U.S. House,Al Mcaffrey,DEM,550248,0,0,22,22,05
Oklahoma,U.S. House,Leona Leonard,DEM,550248,0,0,58,58,05
Oklahoma,Governor,Dax Ewbank,REP,550248,0,0,8,8,
Oklahoma,Governor,Chad Moody,REP,550248,0,0,22,22,
Oklahoma,Governor,Mary Fallin,REP,550248,0,0,118,118,
Oklahoma,Superintendent of Public Instruction,Brian Kelly,REP,550248,0,0,31,31,
Oklahoma,Superintendent of Public Instruction,Janet Costello Barresi,REP,550248,0,0,40,40,
Oklahoma,Superintendent of Public Instruction,Joy Hofmeister,REP,550248,0,0,72,72,
Oklahoma,Insurance Commissioner,Bill Viner,REP,550248,0,0,30,30,
Oklahoma,Insurance Commissioner,John Doak,REP,550248,0,0,114,114,
Oklahoma,Corporation Commissioner,Todd Hiett,REP,550248,0,0,69,69,
Oklahoma,Corporation Commissioner,Cliff Branan,REP,550248,0,0,76,76,
Oklahoma,U.S. Senate,Evelyn Rogers,REP,550248,0,0,5,5,
Oklahoma,U.S. Senate,Rob Moye,REP,550248,0,0,5,5,
Oklahoma,U.S. Senate,D. Jean Mcbride-Samuels,REP,550248,0,0,0,0,
Oklahoma,U.S. Senate,Jim Inhofe,REP,550248,0,0,128,128,
Oklahoma,U.S. Senate,Erick Paul Wyatt,REP,550248,0,0,7,7,
Oklahoma,U.S. Senate,Andy Craig,REP,550248,0,0,0,0,
Oklahoma,U.S. Senate,T. Shannon,REP,550248,0,0,42,42,
Oklahoma,U.S. Senate,Randy Brogdon,REP,550248,0,0,4,4,
Oklahoma,U.S. Senate,Eric Mccray,REP,550248,0,0,3,3,
Oklahoma,U.S. Senate,Kevin Crow,REP,550248,0,0,0,0,
Oklahoma,U.S. Senate,James Lankford,REP,550248,0,0,101,101,
Oklahoma,U.S. Senate,Jason Weger,REP,550248,0,0,0,0,
Oklahoma,U.S. House,Shane David Jett,REP,550248,0,0,12,12,05
Oklahoma,U.S. House,Patrice Douglas,REP,550248,0,0,24,24,05
Oklahoma,U.S. House,Mike Turner,REP,550248,0,0,26,26,05
Oklahoma,U.S. House,Steve Russell,REP,550248,0,0,73,73,05
Oklahoma,U.S. House,Harvey Sparks,REP,550248,0,0,5,5,05
Oklahoma,U.S. House,Clark Jolley,REP,550248,0,0,8,8,05
Oklahoma,Superintendent of Public Instruction,John Cox,DEM,550249,0,0,49,49,
Oklahoma,Superintendent of Public Instruction,Jack Jr.,DEM,550249,0,0,21,21,
Oklahoma,Superintendent of Public Instruction,Ivan Holmes,DEM,550249,0,0,14,14,
Oklahoma,Superintendent of Public Instruction,Freda Deskin,DEM,550249,0,0,80,80,
Oklahoma,U.S. Senate,Patrick Michael Hayes,DEM,550249,0,0,21,21,
Oklahoma,U.S. Senate,Jim Rogers,DEM,550249,0,0,28,28,
Oklahoma,U.S. Senate,Connie Johnson,DEM,550249,0,0,122,122,
Oklahoma,U.S. House,Tom Guild,DEM,550249,0,0,108,108,05
Oklahoma,U.S. House,Al Mcaffrey,DEM,550249,0,0,16,16,05
Oklahoma,U.S. House,Leona Leonard,DEM,550249,0,0,42,42,05
Oklahoma,Governor,Dax Ewbank,REP,550249,0,0,19,19,
Oklahoma,Governor,Chad Moody,REP,550249,0,0,40,40,
Oklahoma,Governor,Mary Fallin,REP,550249,0,0,257,257,
Oklahoma,Superintendent of Public Instruction,Brian Kelly,REP,550249,0,0,83,83,
Oklahoma,Superintendent of Public Instruction,Janet Costello Barresi,REP,550249,0,0,82,82,
Oklahoma,Superintendent of Public Instruction,Joy Hofmeister,REP,550249,0,0,144,144,
Oklahoma,Insurance Commissioner,Bill Viner,REP,550249,0,0,68,68,
Oklahoma,Insurance Commissioner,John Doak,REP,550249,0,0,227,227,
Oklahoma,Corporation Commissioner,Todd Hiett,REP,550249,0,0,141,141,
Oklahoma,Corporation Commissioner,Cliff Branan,REP,550249,0,0,149,149,
Oklahoma,U.S. Senate,Evelyn Rogers,REP,550249,0,0,11,11,
Oklahoma,U.S. Senate,Rob Moye,REP,550249,0,0,5,5,
Oklahoma,U.S. Senate,D. Jean Mcbride-Samuels,REP,550249,0,0,2,2,
Oklahoma,U.S. Senate,Jim Inhofe,REP,550249,0,0,286,286,
Oklahoma,U.S. Senate,Erick Paul Wyatt,REP,550249,0,0,10,10,
Oklahoma,U.S. Senate,Andy Craig,REP,550249,0,0,2,2,
Oklahoma,U.S. Senate,T. Shannon,REP,550249,0,0,69,69,
Oklahoma,U.S. Senate,Randy Brogdon,REP,550249,0,0,6,6,
Oklahoma,U.S. Senate,Eric Mccray,REP,550249,0,0,2,2,
Oklahoma,U.S. Senate,Kevin Crow,REP,550249,0,0,1,1,
Oklahoma,U.S. Senate,James Lankford,REP,550249,0,0,238,238,
Oklahoma,U.S. Senate,Jason Weger,REP,550249,0,0,1,1,
Oklahoma,U.S. House,Shane David Jett,REP,550249,0,0,23,23,05
Oklahoma,U.S. House,Patrice Douglas,REP,550249,0,0,27,27,05
Oklahoma,U.S. House,Mike Turner,REP,550249,0,0,61,61,05
Oklahoma,U.S. House,Steve Russell,REP,550249,0,0,159,159,05
Oklahoma,U.S. House,Harvey Sparks,REP,550249,0,0,14,14,05
Oklahoma,U.S. House,Clark Jolley,REP,550249,0,0,26,26,05
Oklahoma,Superintendent of Public Instruction,John Cox,DEM,550250,0,0,19,19,
Oklahoma,Superintendent of Public Instruction,Jack Jr.,DEM,550250,0,0,7,7,
Oklahoma,Superintendent of Public Instruction,Ivan Holmes,DEM,550250,0,0,9,9,
Oklahoma,Superintendent of Public Instruction,Freda Deskin,DEM,550250,0,0,35,35,
Oklahoma,U.S. Senate,Patrick Michael Hayes,DEM,550250,0,0,8,8,
Oklahoma,U.S. Senate,Jim Rogers,DEM,550250,0,0,9,9,
Oklahoma,U.S. Senate,Connie Johnson,DEM,550250,0,0,51,51,
Oklahoma,U.S. House,Tom Guild,DEM,550250,0,0,29,29,05
Oklahoma,U.S. House,Al Mcaffrey,DEM,550250,0,0,18,18,05
Oklahoma,U.S. House,Leona Leonard,DEM,550250,0,0,20,20,05
Oklahoma,Governor,Dax Ewbank,REP,550250,0,0,21,21,
Oklahoma,Governor,Chad Moody,REP,550250,0,0,23,23,
Oklahoma,Governor,Mary Fallin,REP,550250,0,0,146,146,
Oklahoma,Superintendent of Public Instruction,Brian Kelly,REP,550250,0,0,44,44,
Oklahoma,Superintendent of Public Instruction,Janet Costello Barresi,REP,550250,0,0,50,50,
Oklahoma,Superintendent of Public Instruction,Joy Hofmeister,REP,550250,0,0,92,92,
Oklahoma,Insurance Commissioner,Bill Viner,REP,550250,0,0,41,41,
Oklahoma,Insurance Commissioner,John Doak,REP,550250,0,0,139,139,
Oklahoma,Corporation Commissioner,Todd Hiett,REP,550250,0,0,104,104,
Oklahoma,Corporation Commissioner,Cliff Branan,REP,550250,0,0,67,67,
Oklahoma,U.S. Senate,Evelyn Rogers,REP,550250,0,0,7,7,
Oklahoma,U.S. Senate,Rob Moye,REP,550250,0,0,3,3,
Oklahoma,U.S. Senate,D. Jean Mcbride-Samuels,REP,550250,0,0,3,3,
Oklahoma,U.S. Senate,Jim Inhofe,REP,550250,0,0,165,165,
Oklahoma,U.S. Senate,Erick Paul Wyatt,REP,550250,0,0,10,10,
Oklahoma,U.S. Senate,Andy Craig,REP,550250,0,0,2,2,
Oklahoma,U.S. Senate,T. Shannon,REP,550250,0,0,56,56,
Oklahoma,U.S. Senate,Randy Brogdon,REP,550250,0,0,3,3,
Oklahoma,U.S. Senate,Eric Mccray,REP,550250,0,0,2,2,
Oklahoma,U.S. Senate,Kevin Crow,REP,550250,0,0,1,1,
Oklahoma,U.S. Senate,James Lankford,REP,550250,0,0,125,125,
Oklahoma,U.S. Senate,Jason Weger,REP,550250,0,0,1,1,
Oklahoma,U.S. House,Shane David Jett,REP,550250,0,0,17,17,05
Oklahoma,U.S. House,Patrice Douglas,REP,550250,0,0,34,34,05
Oklahoma,U.S. House,Mike Turner,REP,550250,0,0,16,16,05
Oklahoma,U.S. House,Steve Russell,REP,550250,0,0,87,87,05
Oklahoma,U.S. House,Harvey Sparks,REP,550250,0,0,9,9,05
Oklahoma,U.S. House,Clark Jolley,REP,550250,0,0,21,21,05
Oklahoma,Superintendent of Public Instruction,John Cox,DEM,550251,0,0,39,39,
Oklahoma,Superintendent of Public Instruction,Jack Jr.,DEM,550251,0,0,16,16,
Oklahoma,Superintendent of Public Instruction,Ivan Holmes,DEM,550251,0,0,10,10,
Oklahoma,Superintendent of Public Instruction,Freda Deskin,DEM,550251,0,0,52,52,
Oklahoma,U.S. Senate,Patrick Michael Hayes,DEM,550251,0,0,16,16,
Oklahoma,U.S. Senate,Jim Rogers,DEM,550251,0,0,23,23,
Oklahoma,U.S. Senate,Connie Johnson,DEM,550251,0,0,78,78,
Oklahoma,U.S. House,Bert Smith,DEM,550251,0,0,74,74,04
Oklahoma,U.S. House,Tae Si,DEM,550251,0,0,35,35,04
Oklahoma,Governor,Dax Ewbank,REP,550251,0,0,14,14,
Oklahoma,Governor,Chad Moody,REP,550251,0,0,29,29,
Oklahoma,Governor,Mary Fallin,REP,550251,0,0,198,198,
Oklahoma,Superintendent of Public Instruction,Brian Kelly,REP,550251,0,0,63,63,
Oklahoma,Superintendent of Public Instruction,Janet Costello Barresi,REP,550251,0,0,66,66,
Oklahoma,Superintendent of Public Instruction,Joy Hofmeister,REP,550251,0,0,110,110,
Oklahoma,Insurance Commissioner,Bill Viner,REP,550251,0,0,56,56,
Oklahoma,Insurance Commissioner,John Doak,REP,550251,0,0,172,172,
Oklahoma,Corporation Commissioner,Todd Hiett,REP,550251,0,0,114,114,
Oklahoma,Corporation Commissioner,Cliff Branan,REP,550251,0,0,108,108,
Oklahoma,U.S. Senate,Evelyn Rogers,REP,550251,0,0,9,9,
Oklahoma,U.S. Senate,Rob Moye,REP,550251,0,0,11,11,
Oklahoma,U.S. Senate,D. Jean Mcbride-Samuels,REP,550251,0,0,3,3,
Oklahoma,U.S. Senate,Jim Inhofe,REP,550251,0,0,214,214,
Oklahoma,U.S. Senate,Erick Paul Wyatt,REP,550251,0,0,5,5,
Oklahoma,U.S. Senate,Andy Craig,REP,550251,0,0,1,1,
Oklahoma,U.S. Senate,T. Shannon,REP,550251,0,0,82,82,
Oklahoma,U.S. Senate,Randy Brogdon,REP,550251,0,0,6,6,
Oklahoma,U.S. Senate,Eric Mccray,REP,550251,0,0,3,3,
Oklahoma,U.S. Senate,Kevin Crow,REP,550251,0,0,1,1,
Oklahoma,U.S. Senate,James Lankford,REP,550251,0,0,148,148,
Oklahoma,U.S. Senate,Jason Weger,REP,550251,0,0,2,2,
Oklahoma,U.S. House,Anna Flatt,REP,550251,0,0,42,42,04
Oklahoma,U.S. House,Tom Cole,REP,550251,0,0,200,200,04
Oklahoma,State Senate,Greg Childers,REP,550251,0,0,136,136,42
Oklahoma,State Senate,Jack Fry,REP,550251,0,0,89,89,42
Oklahoma,State House,Charlie Joyner,REP,550251,0,0,136,136,95
Oklahoma,State House,Max Wolfley,REP,550251,0,0,52,52,95
Oklahoma,State House,Brent Rinehart,REP,550251,0,0,51,51,95
Oklahoma,Superintendent of Public Instruction,John Cox,DEM,550252,0,0,50,50,
Oklahoma,Superintendent of Public Instruction,Jack Jr.,DEM,550252,0,0,14,14,
Oklahoma,Superintendent of Public Instruction,Ivan Holmes,DEM,550252,0,0,3,3,
Oklahoma,Superintendent of Public Instruction,Freda Deskin,DEM,550252,0,0,60,60,
Oklahoma,U.S. Senate,Patrick Michael Hayes,DEM,550252,0,0,24,24,
Oklahoma,U.S. Senate,Jim Rogers,DEM,550252,0,0,41,41,
Oklahoma,U.S. Senate,Connie Johnson,DEM,550252,0,0,61,61,
Oklahoma,U.S. House,Bert Smith,DEM,550252,0,0,97,97,04
Oklahoma,U.S. House,Tae Si,DEM,550252,0,0,22,22,04
Oklahoma,Governor,Dax Ewbank,REP,550252,0,0,36,36,
Oklahoma,Governor,Chad Moody,REP,550252,0,0,48,48,
Oklahoma,Governor,Mary Fallin,REP,550252,0,0,321,321,
Oklahoma,Superintendent of Public Instruction,Brian Kelly,REP,550252,0,0,104,104,
Oklahoma,Superintendent of Public Instruction,Janet Costello Barresi,REP,550252,0,0,101,101,
Oklahoma,Superintendent of Public Instruction,Joy Hofmeister,REP,550252,0,0,191,191,
Oklahoma,Insurance Commissioner,Bill Viner,REP,550252,0,0,86,86,
Oklahoma,Insurance Commissioner,John Doak,REP,550252,0,0,286,286,
Oklahoma,Corporation Commissioner,Todd Hiett,REP,550252,0,0,183,183,
Oklahoma,Corporation Commissioner,Cliff Branan,REP,550252,0,0,178,178,
Oklahoma,U.S. Senate,Evelyn Rogers,REP,550252,0,0,15,15,
Oklahoma,U.S. Senate,Rob Moye,REP,550252,0,0,8,8,
Oklahoma,U.S. Senate,D. Jean Mcbride-Samuels,REP,550252,0,0,3,3,
Oklahoma,U.S. Senate,Jim Inhofe,REP,550252,0,0,364,364,
Oklahoma,U.S. Senate,Erick Paul Wyatt,REP,550252,0,0,12,12,
Oklahoma,U.S. Senate,Andy Craig,REP,550252,0,0,2,2,
Oklahoma,U.S. Senate,T. Shannon,REP,550252,0,0,97,97,
Oklahoma,U.S. Senate,Randy Brogdon,REP,550252,0,0,15,15,
Oklahoma,U.S. Senate,Eric Mccray,REP,550252,0,0,3,3,
Oklahoma,U.S. Senate,Kevin Crow,REP,550252,0,0,1,1,
Oklahoma,U.S. Senate,James Lankford,REP,550252,0,0,289,289,
Oklahoma,U.S. Senate,Jason Weger,REP,550252,0,0,1,1,
Oklahoma,U.S. House,Anna Flatt,REP,550252,0,0,62,62,04
Oklahoma,U.S. House,Tom Cole,REP,550252,0,0,344,344,04
Oklahoma,State Senate,Greg Childers,REP,550252,0,0,122,122,42
Oklahoma,State Senate,Jack Fry,REP,550252,0,0,266,266,42
Oklahoma,State House,Charlie Joyner,REP,550252,0,0,197,197,95
Oklahoma,State House,Max Wolfley,REP,550252,0,0,96,96,95
Oklahoma,State House,Brent Rinehart,REP,550252,0,0,106,106,95
Oklahoma,Superintendent of Public Instruction,John Cox,DEM,550253,0,0,14,14,
Oklahoma,Superintendent of Public Instruction,Jack Jr.,DEM,550253,0,0,2,2,
Oklahoma,Superintendent of Public Instruction,Ivan Holmes,DEM,550253,0,0,1,1,
Oklahoma,Superintendent of Public Instruction,Freda Deskin,DEM,550253,0,0,8,8,
Oklahoma,U.S. Senate,Patrick Michael Hayes,DEM,550253,0,0,4,4,
Oklahoma,U.S. Senate,Jim Rogers,DEM,550253,0,0,9,9,
Oklahoma,U.S. Senate,Connie Johnson,DEM,550253,0,0,9,9,
Oklahoma,U.S. House,Tom Guild,DEM,550253,0,0,11,11,05
Oklahoma,U.S. House,Al Mcaffrey,DEM,550253,0,0,6,6,05
Oklahoma,U.S. House,Leona Leonard,DEM,550253,0,0,6,6,05
Oklahoma,Governor,Dax Ewbank,REP,550253,0,0,11,11,
Oklahoma,Governor,Chad Moody,REP,550253,0,0,15,15,
Oklahoma,Governor,Mary Fallin,REP,550253,0,0,100,100,
Oklahoma,Superintendent of Public Instruction,Brian Kelly,REP,550253,0,0,34,34,
Oklahoma,Superintendent of Public Instruction,Janet Costello Barresi,REP,550253,0,0,22,22,
Oklahoma,Superintendent of Public Instruction,Joy Hofmeister,REP,550253,0,0,68,68,
Oklahoma,Insurance Commissioner,Bill Viner,REP,550253,0,0,23,23,
Oklahoma,Insurance Commissioner,John Doak,REP,550253,0,0,98,98,
Oklahoma,Corporation Commissioner,Todd Hiett,REP,550253,0,0,52,52,
Oklahoma,Corporation Commissioner,Cliff Branan,REP,550253,0,0,64,64,
Oklahoma,U.S. Senate,Evelyn Rogers,REP,550253,0,0,8,8,
Oklahoma,U.S. Senate,Rob Moye,REP,550253,0,0,0,0,
Oklahoma,U.S. Senate,D. Jean Mcbride-Samuels,REP,550253,0,0,2,2,
Oklahoma,U.S. Senate,Jim Inhofe,REP,550253,0,0,112,112,
Oklahoma,U.S. Senate,Erick Paul Wyatt,REP,550253,0,0,5,5,
Oklahoma,U.S. Senate,Andy Craig,REP,550253,0,0,2,2,
Oklahoma,U.S. Senate,T. Shannon,REP,550253,0,0,26,26,
Oklahoma,U.S. Senate,Randy Brogdon,REP,550253,0,0,6,6,
Oklahoma,U.S. Senate,Eric Mccray,REP,550253,0,0,0,0,
Oklahoma,U.S. Senate,Kevin Crow,REP,550253,0,0,3,3,
Oklahoma,U.S. Senate,James Lankford,REP,550253,0,0,92,92,
Oklahoma,U.S. Senate,Jason Weger,REP,550253,0,0,0,0,
Oklahoma,U.S. House,Shane David Jett,REP,550253,0,0,14,14,05
Oklahoma,U.S. House,Patrice Douglas,REP,550253,0,0,14,14,05
Oklahoma,U.S. House,Mike Turner,REP,550253,0,0,21,21,05
Oklahoma,U.S. House,Steve Russell,REP,550253,0,0,49,49,05
Oklahoma,U.S. House,Harvey Sparks,REP,550253,0,0,5,5,05
Oklahoma,U.S. House,Clark Jolley,REP,550253,0,0,19,19,05
Oklahoma,State Senate,Greg Childers,REP,550253,0,0,39,39,42
Oklahoma,State Senate,Jack Fry,REP,550253,0,0,87,87,42
Oklahoma,State House,A. Bailey,REP,550253,0,0,24,24,10
Oklahoma,State House,Gary Banz,REP,550253,0,0,102,102,10
Oklahoma,Superintendent of Public Instruction,John Cox,DEM,550254,0,0,30,30,
Oklahoma,Superintendent of Public Instruction,Jack Jr.,DEM,550254,0,0,7,7,
Oklahoma,Superintendent of Public Instruction,Ivan Holmes,DEM,550254,0,0,4,4,
Oklahoma,Superintendent of Public Instruction,Freda Deskin,DEM,550254,0,0,33,33,
Oklahoma,U.S. Senate,Patrick Michael Hayes,DEM,550254,0,0,9,9,
Oklahoma,U.S. Senate,Jim Rogers,DEM,550254,0,0,26,26,
Oklahoma,U.S. Senate,Connie Johnson,DEM,550254,0,0,37,37,
Oklahoma,U.S. House,Tom Guild,DEM,550254,0,0,35,35,05
Oklahoma,U.S. House,Al Mcaffrey,DEM,550254,0,0,23,23,05
Oklahoma,U.S. House,Leona Leonard,DEM,550254,0,0,16,16,05
Oklahoma,Governor,Dax Ewbank,REP,550254,0,0,30,30,
Oklahoma,Governor,Chad Moody,REP,550254,0,0,49,49,
Oklahoma,Governor,Mary Fallin,REP,550254,0,0,278,278,
Oklahoma,Superintendent of Public Instruction,Brian Kelly,REP,550254,0,0,94,94,
Oklahoma,Superintendent of Public Instruction,Janet Costello Barresi,REP,550254,0,0,105,105,
Oklahoma,Superintendent of Public Instruction,Joy Hofmeister,REP,550254,0,0,143,143,
Oklahoma,Insurance Commissioner,Bill Viner,REP,550254,0,0,71,71,
Oklahoma,Insurance Commissioner,John Doak,REP,550254,0,0,254,254,
Oklahoma,Corporation Commissioner,Todd Hiett,REP,550254,0,0,172,172,
Oklahoma,Corporation Commissioner,Cliff Branan,REP,550254,0,0,157,157,
Oklahoma,U.S. Senate,Evelyn Rogers,REP,550254,0,0,13,13,
Oklahoma,U.S. Senate,Rob Moye,REP,550254,0,0,10,10,
Oklahoma,U.S. Senate,D. Jean Mcbride-Samuels,REP,550254,0,0,8,8,
Oklahoma,U.S. Senate,Jim Inhofe,REP,550254,0,0,298,298,
Oklahoma,U.S. Senate,Erick Paul Wyatt,REP,550254,0,0,19,19,
Oklahoma,U.S. Senate,Andy Craig,REP,550254,0,0,2,2,
Oklahoma,U.S. Senate,T. Shannon,REP,550254,0,0,98,98,
Oklahoma,U.S. Senate,Randy Brogdon,REP,550254,0,0,6,6,
Oklahoma,U.S. Senate,Eric Mccray,REP,550254,0,0,2,2,
Oklahoma,U.S. Senate,Kevin Crow,REP,550254,0,0,1,1,
Oklahoma,U.S. Senate,James Lankford,REP,550254,0,0,249,249,
Oklahoma,U.S. Senate,Jason Weger,REP,550254,0,0,0,0,
Oklahoma,U.S. House,Shane David Jett,REP,550254,0,0,51,51,05
Oklahoma,U.S. House,Patrice Douglas,REP,550254,0,0,55,55,05
Oklahoma,U.S. House,Mike Turner,REP,550254,0,0,42,42,05
Oklahoma,U.S. House,Steve Russell,REP,550254,0,0,139,139,05
Oklahoma,U.S. House,Harvey Sparks,REP,550254,0,0,9,9,05
Oklahoma,U.S. House,Clark Jolley,REP,550254,0,0,40,40,05
Oklahoma,State House,A. Bailey,REP,550254,0,0,65,65,10
Oklahoma,State House,Gary Banz,REP,550254,0,0,264,264,10
Oklahoma,Superintendent of Public Instruction,John Cox,DEM,550255,0,0,0,0,
Oklahoma,Superintendent of Public Instruction,Jack Jr.,DEM,550255,0,0,0,0,
Oklahoma,Superintendent of Public Instruction,Ivan Holmes,DEM,550255,0,0,0,0,
Oklahoma,Superintendent of Public Instruction,Freda Deskin,DEM,550255,0,0,0,0,
Oklahoma,U.S. Senate,Patrick Michael Hayes,DEM,550255,0,0,0,0,
Oklahoma,U.S. Senate,Jim Rogers,DEM,550255,0,0,0,0,
Oklahoma,U.S. Senate,Connie Johnson,DEM,550255,0,0,0,0,
Oklahoma,U.S. House,Bert Smith,DEM,550255,0,0,0,0,04
Oklahoma,U.S. House,Tae Si,DEM,550255,0,0,0,0,04
Oklahoma,Governor,Dax Ewbank,REP,550255,0,0,0,0,
Oklahoma,Governor,Chad Moody,REP,550255,0,0,0,0,
Oklahoma,Governor,Mary Fallin,REP,550255,0,0,0,0,
Oklahoma,Superintendent of Public Instruction,Brian Kelly,REP,550255,0,0,0,0,
Oklahoma,Superintendent of Public Instruction,Janet Costello Barresi,REP,550255,0,0,0,0,
Oklahoma,Superintendent of Public Instruction,Joy Hofmeister,REP,550255,0,0,0,0,
Oklahoma,Insurance Commissioner,Bill Viner,REP,550255,0,0,0,0,
Oklahoma,Insurance Commissioner,John Doak,REP,550255,0,0,0,0,
Oklahoma,Corporation Commissioner,Todd Hiett,REP,550255,0,0,0,0,
Oklahoma,Corporation Commissioner,Cliff Branan,REP,550255,0,0,0,0,
Oklahoma,U.S. Senate,Evelyn Rogers,REP,550255,0,0,0,0,
Oklahoma,U.S. Senate,Rob Moye,REP,550255,0,0,0,0,
Oklahoma,U.S. Senate,D. Jean Mcbride-Samuels,REP,550255,0,0,0,0,
Oklahoma,U.S. Senate,Jim Inhofe,REP,550255,0,0,0,0,
Oklahoma,U.S. Senate,Erick Paul Wyatt,REP,550255,0,0,0,0,
Oklahoma,U.S. Senate,Andy Craig,REP,550255,0,0,0,0,
Oklahoma,U.S. Senate,T. Shannon,REP,550255,0,0,0,0,
Oklahoma,U.S. Senate,Randy Brogdon,REP,550255,0,0,0,0,
Oklahoma,U.S. Senate,Eric Mccray,REP,550255,0,0,0,0,
Oklahoma,U.S. Senate,Kevin Crow,REP,550255,0,0,0,0,
Oklahoma,U.S. Senate,James Lankford,REP,550255,0,0,0,0,
Oklahoma,U.S. Senate,Jason Weger,REP,550255,0,0,0,0,
Oklahoma,U.S. House,Anna Flatt,REP,550255,0,0,0,0,04
Oklahoma,U.S. House,Tom Cole,REP,550255,0,0,0,0,04
Oklahoma,State Senate,Greg Childers,REP,550255,0,0,0,0,42
Oklahoma,State Senate,Jack Fry,REP,550255,0,0,0,0,42
Oklahoma,State House,Charlie Joyner,REP,550255,0,0,0,0,95
Oklahoma,State House,Max Wolfley,REP,550255,0,0,0,0,95
Oklahoma,State House,Brent Rinehart,REP,550255,0,0,0,0,95
Oklahoma,Superintendent of Public Instruction,John Cox,DEM,550256,0,0,0,0,
Oklahoma,Superintendent of Public Instruction,Jack Jr.,DEM,550256,0,0,0,0,
Oklahoma,Superintendent of Public Instruction,Ivan Holmes,DEM,550256,0,0,0,0,
Oklahoma,Superintendent of Public Instruction,Freda Deskin,DEM,550256,0,0,0,0,
Oklahoma,U.S. Senate,Patrick Michael Hayes,DEM,550256,0,0,0,0,
Oklahoma,U.S. Senate,Jim Rogers,DEM,550256,0,0,0,0,
Oklahoma,U.S. Senate,Connie Johnson,DEM,550256,0,0,0,0,
Oklahoma,U.S. House,Tom Guild,DEM,550256,0,0,0,0,05
Oklahoma,U.S. House,Al Mcaffrey,DEM,550256,0,0,0,0,05
Oklahoma,U.S. House,Leona Leonard,DEM,550256,0,0,0,0,05
Oklahoma,Governor,Dax Ewbank,REP,550256,0,0,0,0,
Oklahoma,Governor,Chad Moody,REP,550256,0,0,0,0,
Oklahoma,Governor,Mary Fallin,REP,550256,0,0,0,0,
Oklahoma,Superintendent of Public Instruction,Brian Kelly,REP,550256,0,0,0,0,
Oklahoma,Superintendent of Public Instruction,Janet Costello Barresi,REP,550256,0,0,0,0,
Oklahoma,Superintendent of Public Instruction,Joy Hofmeister,REP,550256,0,0,0,0,
Oklahoma,Insurance Commissioner,Bill Viner,REP,550256,0,0,0,0,
Oklahoma,Insurance Commissioner,John Doak,REP,550256,0,0,0,0,
Oklahoma,Corporation Commissioner,Todd Hiett,REP,550256,0,0,0,0,
Oklahoma,Corporation Commissioner,Cliff Branan,REP,550256,0,0,0,0,
Oklahoma,U.S. Senate,Evelyn Rogers,REP,550256,0,0,0,0,
Oklahoma,U.S. Senate,Rob Moye,REP,550256,0,0,0,0,
Oklahoma,U.S. Senate,D. Jean Mcbride-Samuels,REP,550256,0,0,0,0,
Oklahoma,U.S. Senate,Jim Inhofe,REP,550256,0,0,0,0,
Oklahoma,U.S. Senate,Erick Paul Wyatt,REP,550256,0,0,0,0,
Oklahoma,U.S. Senate,Andy Craig,REP,550256,0,0,0,0,
Oklahoma,U.S. Senate,T. Shannon,REP,550256,0,0,0,0,
Oklahoma,U.S. Senate,Randy Brogdon,REP,550256,0,0,0,0,
Oklahoma,U.S. Senate,Eric Mccray,REP,550256,0,0,0,0,
Oklahoma,U.S. Senate,Kevin Crow,REP,550256,0,0,0,0,
Oklahoma,U.S. Senate,James Lankford,REP,550256,0,0,0,0,
Oklahoma,U.S. Senate,Jason Weger,REP,550256,0,0,0,0,
Oklahoma,U.S. House,Shane David Jett,REP,550256,0,0,0,0,05
Oklahoma,U.S. House,Patrice Douglas,REP,550256,0,0,0,0,05
Oklahoma,U.S. House,Mike Turner,REP,550256,0,0,0,0,05
Oklahoma,U.S. House,Steve Russell,REP,550256,0,0,0,0,05
Oklahoma,U.S. House,Harvey Sparks,REP,550256,0,0,0,0,05
Oklahoma,U.S. House,Clark Jolley,REP,550256,0,0,0,0,05
Oklahoma,State Senate,Mark Thomas,REP,550256,0,0,0,0,22
Oklahoma,State Senate,Leif Francel,REP,550256,0,0,0,0,22
Oklahoma,State Senate,Stephanie Bice,REP,550256,0,0,0,0,22
Oklahoma,State House,Jason Murphey,REP,550256,0,0,0,0,31
Oklahoma,State House,Andrew Muchmore,REP,550256,0,0,0,0,31
Oklahoma,Superintendent of Public Instruction,John Cox,DEM,550257,0,0,5,5,
Oklahoma,Superintendent of Public Instruction,Jack Jr.,DEM,550257,0,0,0,0,
Oklahoma,Superintendent of Public Instruction,Ivan Holmes,DEM,550257,0,0,2,2,
Oklahoma,Superintendent of Public Instruction,Freda Deskin,DEM,550257,0,0,10,10,
Oklahoma,U.S. Senate,Patrick Michael Hayes,DEM,550257,0,0,1,1,
Oklahoma,U.S. Senate,Jim Rogers,DEM,550257,0,0,0,0,
Oklahoma,U.S. Senate,Connie Johnson,DEM,550257,0,0,15,15,
Oklahoma,U.S. House,Tom Guild,DEM,550257,0,0,5,5,05
Oklahoma,U.S. House,Al Mcaffrey,DEM,550257,0,0,4,4,05
Oklahoma,U.S. House,Leona Leonard,DEM,550257,0,0,8,8,05
Oklahoma,State Senate,Christine Byrd,DEM,550257,0,0,0,0,48
Oklahoma,State Senate,Anastasia Pittman,DEM,550257,0,0,15,15,48
Oklahoma,State House,Steve Davis,DEM,550257,0,0,2,2,99
Oklahoma,State House,Eleanor Darden Thompson,DEM,550257,0,0,7,7,99
Oklahoma,State House,George Young,DEM,550257,0,0,8,8,99
Oklahoma,Governor,Dax Ewbank,REP,550257,0,0,0,0,
Oklahoma,Governor,Chad Moody,REP,550257,0,0,2,2,
Oklahoma,Governor,Mary Fallin,REP,550257,0,0,10,10,
Oklahoma,Superintendent of Public Instruction,Brian Kelly,REP,550257,0,0,3,3,
Oklahoma,Superintendent of Public Instruction,Janet Costello Barresi,REP,550257,0,0,3,3,
Oklahoma,Superintendent of Public Instruction,Joy Hofmeister,REP,550257,0,0,5,5,
Oklahoma,Insurance Commissioner,Bill Viner,REP,550257,0,0,3,3,
Oklahoma,Insurance Commissioner,John Doak,REP,550257,0,0,8,8,
Oklahoma,Corporation Commissioner,Todd Hiett,REP,550257,0,0,1,1,
Oklahoma,Corporation Commissioner,Cliff Branan,REP,550257,0,0,11,11,
Oklahoma,U.S. Senate,Evelyn Rogers,REP,550257,0,0,2,2,
Oklahoma,U.S. Senate,Rob Moye,REP,550257,0,0,0,0,
Oklahoma,U.S. Senate,D. Jean Mcbride-Samuels,REP,550257,0,0,0,0,
Oklahoma,U.S. Senate,Jim Inhofe,REP,550257,0,0,10,10,
Oklahoma,U.S. Senate,Erick Paul Wyatt,REP,550257,0,0,0,0,
Oklahoma,U.S. Senate,Andy Craig,REP,550257,0,0,0,0,
Oklahoma,U.S. Senate,T. Shannon,REP,550257,0,0,1,1,
Oklahoma,U.S. Senate,Randy Brogdon,REP,550257,0,0,0,0,
Oklahoma,U.S. Senate,Eric Mccray,REP,550257,0,0,0,0,
Oklahoma,U.S. Senate,Kevin Crow,REP,550257,0,0,0,0,
Oklahoma,U.S. Senate,James Lankford,REP,550257,0,0,11,11,
Oklahoma,U.S. Senate,Jason Weger,REP,550257,0,0,0,0,
Oklahoma,U.S. House,Shane David Jett,REP,550257,0,0,0,0,05
Oklahoma,U.S. House,Patrice Douglas,REP,550257,0,0,2,2,05
Oklahoma,U.S. House,Mike Turner,REP,550257,0,0,3,3,05
Oklahoma,U.S. House,Steve Russell,REP,550257,0,0,6,6,05
Oklahoma,U.S. House,Harvey Sparks,REP,550257,0,0,0,0,05
Oklahoma,U.S. House,Clark Jolley,REP,550257,0,0,1,1,05
Oklahoma,Superintendent of Public Instruction,John Cox,DEM,559999,202,261,0,463,
Oklahoma,Superintendent of Public Instruction,Jack Jr.,DEM,559999,192,104,0,296,
Oklahoma,Superintendent of Public Instruction,Ivan Holmes,DEM,559999,181,115,0,296,
Oklahoma,Superintendent of Public Instruction,Freda Deskin,DEM,559999,496,507,0,1003,
Oklahoma,U.S. Senate,Patrick Michael Hayes,DEM,559999,139,57,0,196,
Oklahoma,U.S. Senate,Jim Rogers,DEM,559999,177,95,0,272,
Oklahoma,U.S. Senate,Connie Johnson,DEM,559999,769,862,0,1631,
Oklahoma,U.S. House,Bert Smith,DEM,559999,84,31,0,115,04
Oklahoma,U.S. House,Tae Si,DEM,559999,29,13,0,42,04
Oklahoma,U.S. House,Tom Guild,DEM,559999,352,367,0,719,05
Oklahoma,U.S. House,Al Mcaffrey,DEM,559999,360,306,0,666,05
Oklahoma,U.S. House,Leona Leonard,DEM,559999,242,258,0,500,05
Oklahoma,State Senate,Wilfredo Santos Rivera,DEM,559999,14,21,0,35,46
Oklahoma,State Senate,Kay Floyd,DEM,559999,62,61,0,123,46
Oklahoma,State Senate,Christine Byrd,DEM,559999,37,73,0,110,48
Oklahoma,State Senate,Anastasia Pittman,DEM,559999,137,415,0,552,48
Oklahoma,State House,John Gibbons,DEM,559999,10,15,0,25,88
Oklahoma,State House,Mark Faulk,DEM,559999,13,15,0,28,88
Oklahoma,State House,Paula Sophia,DEM,559999,10,30,0,40,88
Oklahoma,State House,Jason Dunnington,DEM,559999,27,35,0,62,88
Oklahoma,State House,Virginia Poindexter,DEM,559999,6,3,0,9,89
Oklahoma,State House,Shane Stone,DEM,559999,4,1,0,5,89
Oklahoma,State House,Chris Bryant,DEM,559999,6,0,0,6,89
Oklahoma,State House,Mary Sosa,DEM,559999,10,10,0,20,89
Oklahoma,State House,Mike Shelton,DEM,559999,92,254,0,346,97
Oklahoma,State House,Bruce Fisher,DEM,559999,21,48,0,69,97
Oklahoma,State House,Steve Davis,DEM,559999,12,34,0,46,99
Oklahoma,State House,Eleanor Darden Thompson,DEM,559999,16,62,0,78,99
Oklahoma,State House,George Young,DEM,559999,28,87,0,115,99
Oklahoma,Governor,Dax Ewbank,REP,559999,174,103,0,277,
Oklahoma,Governor,Chad Moody,REP,559999,203,198,0,401,
Oklahoma,Governor,Mary Fallin,REP,559999,2392,1031,0,3423,
Oklahoma,Superintendent of Public Instruction,Brian Kelly,REP,559999,564,216,0,780,
Oklahoma,Superintendent of Public Instruction,Janet Costello Barresi,REP,559999,1063,513,0,1576,
Oklahoma,Superintendent of Public Instruction,Joy Hofmeister,REP,559999,1040,588,0,1628,
Oklahoma,Insurance Commissioner,Bill Viner,REP,559999,411,207,0,618,
Oklahoma,Insurance Commissioner,John Doak,REP,559999,2174,1048,0,3222,
Oklahoma,Corporation Commissioner,Todd Hiett,REP,559999,1182,571,0,1753,
Oklahoma,Corporation Commissioner,Cliff Branan,REP,559999,1292,688,0,1980,
Oklahoma,U.S. Senate,Evelyn Rogers,REP,559999,75,58,0,133,
Oklahoma,U.S. Senate,Rob Moye,REP,559999,36,16,0,52,
Oklahoma,U.S. Senate,D. Jean Mcbride-Samuels,REP,559999,37,9,0,46,
Oklahoma,U.S. Senate,Jim Inhofe,REP,559999,2522,1185,0,3707,
Oklahoma,U.S. Senate,Erick Paul Wyatt,REP,559999,80,59,0,139,
Oklahoma,U.S. Senate,Andy Craig,REP,559999,19,8,0,27,
Oklahoma,U.S. Senate,T. Shannon,REP,559999,488,266,0,754,
Oklahoma,U.S. Senate,Randy Brogdon,REP,559999,67,53,0,120,
Oklahoma,U.S. Senate,Eric Mccray,REP,559999,13,4,0,17,
Oklahoma,U.S. Senate,Kevin Crow,REP,559999,19,11,0,30,
Oklahoma,U.S. Senate,James Lankford,REP,559999,2177,997,0,3174,
Oklahoma,U.S. Senate,Jason Weger,REP,559999,22,11,0,33,
Oklahoma,U.S. House,Anna Flatt,REP,559999,20,11,0,31,04
Oklahoma,U.S. House,Tom Cole,REP,559999,193,76,0,269,04
Oklahoma,U.S. House,Shane David Jett,REP,559999,140,70,0,210,05
Oklahoma,U.S. House,Patrice Douglas,REP,559999,896,337,0,1233,05
Oklahoma,U.S. House,Mike Turner,REP,559999,414,167,0,581,05
Oklahoma,U.S. House,Steve Russell,REP,559999,513,381,0,894,05
Oklahoma,U.S. House,Harvey Sparks,REP,559999,102,65,0,167,05
Oklahoma,U.S. House,Clark Jolley,REP,559999,437,216,0,653,05
Oklahoma,State Senate,Mark Thomas,REP,559999,74,27,0,101,22
Oklahoma,State Senate,Leif Francel,REP,559999,43,16,0,59,22
Oklahoma,State Senate,Stephanie Bice,REP,559999,72,33,0,105,22
Oklahoma,State Senate,Ervin Yen,REP,559999,120,89,0,209,40
Oklahoma,State Senate,Joe Howell,REP,559999,48,25,0,73,40
Oklahoma,State Senate,Michael Taylor,REP,559999,33,15,0,48,40
Oklahoma,State Senate,Brian Winslow,REP,559999,66,27,0,93,40
Oklahoma,State Senate,Steve Kern,REP,559999,77,34,0,111,40
Oklahoma,State Senate,David Hooten,REP,559999,49,25,0,74,40
Oklahoma,State Senate,Greg Childers,REP,559999,112,50,0,162,42
Oklahoma,State Senate,Jack Fry,REP,559999,115,51,0,166,42
Oklahoma,State House,Jason Murphey,REP,559999,30,15,0,45,31
Oklahoma,State House,Andrew Muchmore,REP,559999,9,3,0,12,31
Oklahoma,State House,Ross Vanhooser,REP,559999,9,8,0,17,41
Oklahoma,State House,John Enns,REP,559999,17,8,0,25,41
Oklahoma,State House,Paul Wesselhoft,REP,559999,4,2,0,6,54
Oklahoma,State House,Adam Graham,REP,559999,1,0,0,1,54
Oklahoma,State House,Gregory Duke Brown,REP,559999,5,3,0,8,82
Oklahoma,State House,Dustin Hopson,REP,559999,21,14,0,35,82
Oklahoma,State House,Adam Pugh,REP,559999,85,44,0,129,82
Oklahoma,State House,Kevin Calvey,REP,559999,135,55,0,190,82
Oklahoma,State House,Paul Ruckel,REP,559999,3,1,0,4,82
Oklahoma,State House,Charlie Joyner,REP,559999,65,17,0,82,95
Oklahoma,State House,Max Wolfley,REP,559999,15,8,0,23,95
Oklahoma,State House,Brent Rinehart,REP,559999,13,8,0,21,95
Oklahoma,State House,A. Bailey,REP,559999,22,9,0,31,10
Oklahoma,State House,Gary Banz,REP,559999,123,72,0,195,10
Okmulgee,Superintendent of Public Instruction,John Cox,DEM,560001,0,0,7,7,
Okmulgee,Superintendent of Public Instruction,Jack Jr.,DEM,560001,0,0,6,6,
Okmulgee,Superintendent of Public Instruction,Ivan Holmes,DEM,560001,0,1,2,3,
Okmulgee,Superintendent of Public Instruction,Freda Deskin,DEM,560001,0,2,18,20,
Okmulgee,U.S. Senate,Patrick Michael Hayes,DEM,560001,0,0,9,9,
Okmulgee,U.S. Senate,Jim Rogers,DEM,560001,0,1,7,8,
Okmulgee,U.S. Senate,Connie Johnson,DEM,560001,0,2,17,19,
Okmulgee,U.S. House,Earl Everett,DEM,560001,0,2,15,17,02
Okmulgee,U.S. House,Joshua Harris-Till,DEM,560001,0,1,18,19,02
Okmulgee,State Senate,Chad Bonds,DEM,560001,0,1,10,11,8
Okmulgee,State Senate,Gary Clason,DEM,560001,0,1,10,11,8
Okmulgee,State Senate,Selina Jayne-Dornan,DEM,560001,0,1,15,16,8
Okmulgee,Governor,Dax Ewbank,REP,560001,0,0,1,1,
Okmulgee,Governor,Chad Moody,REP,560001,0,0,1,1,
Okmulgee,Governor,Mary Fallin,REP,560001,0,5,5,10,
Okmulgee,Superintendent of Public Instruction,Brian Kelly,REP,560001,0,0,0,0,
Okmulgee,Superintendent of Public Instruction,Janet Costello Barresi,REP,560001,0,2,0,2,
Okmulgee,Superintendent of Public Instruction,Joy Hofmeister,REP,560001,0,3,7,10,
Okmulgee,Insurance Commissioner,Bill Viner,REP,560001,0,1,3,4,
Okmulgee,Insurance Commissioner,John Doak,REP,560001,0,4,4,8,
Okmulgee,Corporation Commissioner,Todd Hiett,REP,560001,0,2,4,6,
Okmulgee,Corporation Commissioner,Cliff Branan,REP,560001,0,3,3,6,
Okmulgee,U.S. Senate,Evelyn Rogers,REP,560001,0,0,0,0,
Okmulgee,U.S. Senate,Rob Moye,REP,560001,0,0,1,1,
Okmulgee,U.S. Senate,D. Jean Mcbride-Samuels,REP,560001,0,0,0,0,
Okmulgee,U.S. Senate,Jim Inhofe,REP,560001,0,5,6,11,
Okmulgee,U.S. Senate,Erick Paul Wyatt,REP,560001,0,0,0,0,
Okmulgee,U.S. Senate,Andy Craig,REP,560001,0,0,0,0,
Okmulgee,U.S. Senate,T. Shannon,REP,560001,0,0,2,2,
Okmulgee,U.S. Senate,Randy Brogdon,REP,560001,0,0,0,0,
Okmulgee,U.S. Senate,Eric Mccray,REP,560001,0,0,0,0,
Okmulgee,U.S. Senate,Kevin Crow,REP,560001,0,0,0,0,
Okmulgee,U.S. Senate,James Lankford,REP,560001,0,5,5,10,
Okmulgee,U.S. Senate,Jason Weger,REP,560001,0,0,0,0,
Okmulgee,U.S. House,Darrel Robertson,REP,560001,0,2,3,5,02
Okmulgee,U.S. House,Markwayne Mullin,REP,560001,0,3,4,7,02
Okmulgee,State Senate,J. Hill,REP,560001,0,0,2,2,8
Okmulgee,State Senate,Roger Thompson,REP,560001,0,2,2,4,8
Okmulgee,State Senate,Malcolm Branch,REP,560001,0,2,3,5,8
Okmulgee,Superintendent of Public Instruction,John Cox,DEM,560002,0,0,18,18,
Okmulgee,Superintendent of Public Instruction,Jack Jr.,DEM,560002,1,0,15,16,
Okmulgee,Superintendent of Public Instruction,Ivan Holmes,DEM,560002,2,1,15,18,
Okmulgee,Superintendent of Public Instruction,Freda Deskin,DEM,560002,1,3,23,27,
Okmulgee,U.S. Senate,Patrick Michael Hayes,DEM,560002,0,2,13,15,
Okmulgee,U.S. Senate,Jim Rogers,DEM,560002,0,0,20,20,
Okmulgee,U.S. Senate,Connie Johnson,DEM,560002,4,2,41,47,
Okmulgee,U.S. House,Earl Everett,DEM,560002,3,1,43,47,02
Okmulgee,U.S. House,Joshua Harris-Till,DEM,560002,1,3,25,29,02
Okmulgee,State Senate,Chad Bonds,DEM,560002,1,2,22,25,8
Okmulgee,State Senate,Gary Clason,DEM,560002,1,0,25,26,8
Okmulgee,State Senate,Selina Jayne-Dornan,DEM,560002,2,2,26,30,8
Okmulgee,Governor,Dax Ewbank,REP,560002,0,0,0,0,
Okmulgee,Governor,Chad Moody,REP,560002,0,0,1,1,
Okmulgee,Governor,Mary Fallin,REP,560002,0,2,4,6,
Okmulgee,Superintendent of Public Instruction,Brian Kelly,REP,560002,0,1,1,2,
Okmulgee,Superintendent of Public Instruction,Janet Costello Barresi,REP,560002,0,1,2,3,
Okmulgee,Superintendent of Public Instruction,Joy Hofmeister,REP,560002,0,0,2,2,
Okmulgee,Insurance Commissioner,Bill Viner,REP,560002,0,1,1,2,
Okmulgee,Insurance Commissioner,John Doak,REP,560002,0,1,4,5,
Okmulgee,Corporation Commissioner,Todd Hiett,REP,560002,0,2,2,4,
Okmulgee,Corporation Commissioner,Cliff Branan,REP,560002,0,0,3,3,
Okmulgee,U.S. Senate,Evelyn Rogers,REP,560002,0,0,1,1,
Okmulgee,U.S. Senate,Rob Moye,REP,560002,0,0,0,0,
Okmulgee,U.S. Senate,D. Jean Mcbride-Samuels,REP,560002,0,0,0,0,
Okmulgee,U.S. Senate,Jim Inhofe,REP,560002,0,2,3,5,
Okmulgee,U.S. Senate,Erick Paul Wyatt,REP,560002,0,0,1,1,
Okmulgee,U.S. Senate,Andy Craig,REP,560002,0,0,0,0,
Okmulgee,U.S. Senate,T. Shannon,REP,560002,0,1,3,4,
Okmulgee,U.S. Senate,Randy Brogdon,REP,560002,0,0,0,0,
Okmulgee,U.S. Senate,Eric Mccray,REP,560002,0,0,0,0,
Okmulgee,U.S. Senate,Kevin Crow,REP,560002,0,0,0,0,
Okmulgee,U.S. Senate,James Lankford,REP,560002,0,1,2,3,
Okmulgee,U.S. Senate,Jason Weger,REP,560002,0,0,0,0,
Okmulgee,U.S. House,Darrel Robertson,REP,560002,0,0,0,0,02
Okmulgee,U.S. House,Markwayne Mullin,REP,560002,0,2,5,7,02
Okmulgee,State Senate,J. Hill,REP,560002,0,1,1,2,8
Okmulgee,State Senate,Roger Thompson,REP,560002,0,1,3,4,8
Okmulgee,State Senate,Malcolm Branch,REP,560002,0,0,1,1,8
Okmulgee,Superintendent of Public Instruction,John Cox,DEM,560004,0,0,8,8,
Okmulgee,Superintendent of Public Instruction,Jack Jr.,DEM,560004,0,0,4,4,
Okmulgee,Superintendent of Public Instruction,Ivan Holmes,DEM,560004,0,0,1,1,
Okmulgee,Superintendent of Public Instruction,Freda Deskin,DEM,560004,1,1,5,7,
Okmulgee,U.S. Senate,Patrick Michael Hayes,DEM,560004,0,0,1,1,
Okmulgee,U.S. Senate,Jim Rogers,DEM,560004,0,1,11,12,
Okmulgee,U.S. Senate,Connie Johnson,DEM,560004,1,0,5,6,
Okmulgee,U.S. House,Earl Everett,DEM,560004,0,1,13,14,02
Okmulgee,U.S. House,Joshua Harris-Till,DEM,560004,1,0,4,5,02
Okmulgee,State Senate,Chad Bonds,DEM,560004,1,0,8,9,8
Okmulgee,State Senate,Gary Clason,DEM,560004,0,0,4,4,8
Okmulgee,State Senate,Selina Jayne-Dornan,DEM,560004,0,1,6,7,8
Okmulgee,Governor,Dax Ewbank,REP,560004,0,0,0,0,
Okmulgee,Governor,Chad Moody,REP,560004,0,0,0,0,
Okmulgee,Governor,Mary Fallin,REP,560004,0,0,7,7,
Okmulgee,Superintendent of Public Instruction,Brian Kelly,REP,560004,0,0,1,1,
Okmulgee,Superintendent of Public Instruction,Janet Costello Barresi,REP,560004,0,0,1,1,
Okmulgee,Superintendent of Public Instruction,Joy Hofmeister,REP,560004,0,0,5,5,
Okmulgee,Insurance Commissioner,Bill Viner,REP,560004,0,0,2,2,
Okmulgee,Insurance Commissioner,John Doak,REP,560004,0,0,3,3,
Okmulgee,Corporation Commissioner,Todd Hiett,REP,560004,0,0,3,3,
Okmulgee,Corporation Commissioner,Cliff Branan,REP,560004,0,0,3,3,
Okmulgee,U.S. Senate,Evelyn Rogers,REP,560004,0,0,1,1,
Okmulgee,U.S. Senate,Rob Moye,REP,560004,0,0,1,1,
Okmulgee,U.S. Senate,D. Jean Mcbride-Samuels,REP,560004,0,0,0,0,
Okmulgee,U.S. Senate,Jim Inhofe,REP,560004,0,0,5,5,
Okmulgee,U.S. Senate,Erick Paul Wyatt,REP,560004,0,0,0,0,
Okmulgee,U.S. Senate,Andy Craig,REP,560004,0,0,0,0,
Okmulgee,U.S. Senate,T. Shannon,REP,560004,0,0,4,4,
Okmulgee,U.S. Senate,Randy Brogdon,REP,560004,0,0,1,1,
Okmulgee,U.S. Senate,Eric Mccray,REP,560004,0,0,0,0,
Okmulgee,U.S. Senate,Kevin Crow,REP,560004,0,0,0,0,
Okmulgee,U.S. Senate,James Lankford,REP,560004,0,0,2,2,
Okmulgee,U.S. Senate,Jason Weger,REP,560004,0,0,0,0,
Okmulgee,U.S. House,Darrel Robertson,REP,560004,0,0,0,0,02
Okmulgee,U.S. House,Markwayne Mullin,REP,560004,0,0,7,7,02
Okmulgee,State Senate,J. Hill,REP,560004,0,0,2,2,8
Okmulgee,State Senate,Roger Thompson,REP,560004,0,0,3,3,8
Okmulgee,State Senate,Malcolm Branch,REP,560004,0,0,1,1,8
Okmulgee,Superintendent of Public Instruction,John Cox,DEM,560005,0,1,23,24,
Okmulgee,Superintendent of Public Instruction,Jack Jr.,DEM,560005,0,0,10,10,
Okmulgee,Superintendent of Public Instruction,Ivan Holmes,DEM,560005,0,1,3,4,
Okmulgee,Superintendent of Public Instruction,Freda Deskin,DEM,560005,0,0,26,26,
Okmulgee,U.S. Senate,Patrick Michael Hayes,DEM,560005,0,0,9,9,
Okmulgee,U.S. Senate,Jim Rogers,DEM,560005,0,1,34,35,
Okmulgee,U.S. Senate,Connie Johnson,DEM,560005,0,1,19,20,
Okmulgee,U.S. House,Earl Everett,DEM,560005,0,1,40,41,02
Okmulgee,U.S. House,Joshua Harris-Till,DEM,560005,0,1,24,25,02
Okmulgee,State Senate,Chad Bonds,DEM,560005,0,1,9,10,8
Okmulgee,State Senate,Gary Clason,DEM,560005,0,1,17,18,8
Okmulgee,State Senate,Selina Jayne-Dornan,DEM,560005,0,0,38,38,8
Okmulgee,Governor,Dax Ewbank,REP,560005,0,0,3,3,
Okmulgee,Governor,Chad Moody,REP,560005,0,1,6,7,
Okmulgee,Governor,Mary Fallin,REP,560005,0,4,21,25,
Okmulgee,Superintendent of Public Instruction,Brian Kelly,REP,560005,0,0,12,12,
Okmulgee,Superintendent of Public Instruction,Janet Costello Barresi,REP,560005,0,3,5,8,
Okmulgee,Superintendent of Public Instruction,Joy Hofmeister,REP,560005,0,2,13,15,
Okmulgee,Insurance Commissioner,Bill Viner,REP,560005,0,1,11,12,
Okmulgee,Insurance Commissioner,John Doak,REP,560005,0,3,17,20,
Okmulgee,Corporation Commissioner,Todd Hiett,REP,560005,0,1,16,17,
Okmulgee,Corporation Commissioner,Cliff Branan,REP,560005,0,3,12,15,
Okmulgee,U.S. Senate,Evelyn Rogers,REP,560005,0,0,2,2,
Okmulgee,U.S. Senate,Rob Moye,REP,560005,0,0,1,1,
Okmulgee,U.S. Senate,D. Jean Mcbride-Samuels,REP,560005,0,0,0,0,
Okmulgee,U.S. Senate,Jim Inhofe,REP,560005,0,5,22,27,
Okmulgee,U.S. Senate,Erick Paul Wyatt,REP,560005,0,0,4,4,
Okmulgee,U.S. Senate,Andy Craig,REP,560005,0,0,0,0,
Okmulgee,U.S. Senate,T. Shannon,REP,560005,0,1,14,15,
Okmulgee,U.S. Senate,Randy Brogdon,REP,560005,0,0,2,2,
Okmulgee,U.S. Senate,Eric Mccray,REP,560005,0,0,1,1,
Okmulgee,U.S. Senate,Kevin Crow,REP,560005,0,0,0,0,
Okmulgee,U.S. Senate,James Lankford,REP,560005,0,4,13,17,
Okmulgee,U.S. Senate,Jason Weger,REP,560005,0,0,0,0,
Okmulgee,U.S. House,Darrel Robertson,REP,560005,0,0,6,6,02
Okmulgee,U.S. House,Markwayne Mullin,REP,560005,0,5,23,28,02
Okmulgee,State Senate,J. Hill,REP,560005,0,0,11,11,8
Okmulgee,State Senate,Roger Thompson,REP,560005,0,5,14,19,8
Okmulgee,State Senate,Malcolm Branch,REP,560005,0,0,4,4,8
Okmulgee,Superintendent of Public Instruction,John Cox,DEM,560006,0,0,10,10,
Okmulgee,Superintendent of Public Instruction,Jack Jr.,DEM,560006,0,0,4,4,
Okmulgee,Superintendent of Public Instruction,Ivan Holmes,DEM,560006,0,0,5,5,
Okmulgee,Superintendent of Public Instruction,Freda Deskin,DEM,560006,0,0,9,9,
Okmulgee,U.S. Senate,Patrick Michael Hayes,DEM,560006,0,0,8,8,
Okmulgee,U.S. Senate,Jim Rogers,DEM,560006,0,0,9,9,
Okmulgee,U.S. Senate,Connie Johnson,DEM,560006,0,0,7,7,
Okmulgee,U.S. House,Earl Everett,DEM,560006,0,0,16,16,02
Okmulgee,U.S. House,Joshua Harris-Till,DEM,560006,0,0,8,8,02
Okmulgee,State Senate,Chad Bonds,DEM,560006,0,0,9,9,8
Okmulgee,State Senate,Gary Clason,DEM,560006,0,0,5,5,8
Okmulgee,State Senate,Selina Jayne-Dornan,DEM,560006,0,0,11,11,8
Okmulgee,Governor,Dax Ewbank,REP,560006,0,0,1,1,
Okmulgee,Governor,Chad Moody,REP,560006,0,1,0,1,
Okmulgee,Governor,Mary Fallin,REP,560006,0,1,25,26,
Okmulgee,Superintendent of Public Instruction,Brian Kelly,REP,560006,0,0,7,7,
Okmulgee,Superintendent of Public Instruction,Janet Costello Barresi,REP,560006,0,1,6,7,
Okmulgee,Superintendent of Public Instruction,Joy Hofmeister,REP,560006,0,1,12,13,
Okmulgee,Insurance Commissioner,Bill Viner,REP,560006,0,2,6,8,
Okmulgee,Insurance Commissioner,John Doak,REP,560006,0,0,19,19,
Okmulgee,Corporation Commissioner,Todd Hiett,REP,560006,0,1,9,10,
Okmulgee,Corporation Commissioner,Cliff Branan,REP,560006,0,1,16,17,
Okmulgee,U.S. Senate,Evelyn Rogers,REP,560006,0,0,2,2,
Okmulgee,U.S. Senate,Rob Moye,REP,560006,0,0,0,0,
Okmulgee,U.S. Senate,D. Jean Mcbride-Samuels,REP,560006,0,0,0,0,
Okmulgee,U.S. Senate,Jim Inhofe,REP,560006,0,1,24,25,
Okmulgee,U.S. Senate,Erick Paul Wyatt,REP,560006,0,1,0,1,
Okmulgee,U.S. Senate,Andy Craig,REP,560006,0,0,1,1,
Okmulgee,U.S. Senate,T. Shannon,REP,560006,0,0,11,11,
Okmulgee,U.S. Senate,Randy Brogdon,REP,560006,0,0,2,2,
Okmulgee,U.S. Senate,Eric Mccray,REP,560006,0,0,0,0,
Okmulgee,U.S. Senate,Kevin Crow,REP,560006,0,0,0,0,
Okmulgee,U.S. Senate,James Lankford,REP,560006,0,2,12,14,
Okmulgee,U.S. Senate,Jason Weger,REP,560006,0,0,0,0,
Okmulgee,U.S. House,Darrel Robertson,REP,560006,0,1,4,5,02
Okmulgee,U.S. House,Markwayne Mullin,REP,560006,0,1,21,22,02
Okmulgee,State Senate,J. Hill,REP,560006,0,0,10,10,8
Okmulgee,State Senate,Roger Thompson,REP,560006,0,2,13,15,8
Okmulgee,State Senate,Malcolm Branch,REP,560006,0,0,2,2,8
Okmulgee,Superintendent of Public Instruction,John Cox,DEM,560007,0,0,15,15,
Okmulgee,Superintendent of Public Instruction,Jack Jr.,DEM,560007,0,3,8,11,
Okmulgee,Superintendent of Public Instruction,Ivan Holmes,DEM,560007,0,0,8,8,
Okmulgee,Superintendent of Public Instruction,Freda Deskin,DEM,560007,2,1,26,29,
Okmulgee,U.S. Senate,Patrick Michael Hayes,DEM,560007,1,2,12,15,
Okmulgee,U.S. Senate,Jim Rogers,DEM,560007,0,1,15,16,
Okmulgee,U.S. Senate,Connie Johnson,DEM,560007,1,1,29,31,
Okmulgee,U.S. House,Earl Everett,DEM,560007,2,2,34,38,02
Okmulgee,U.S. House,Joshua Harris-Till,DEM,560007,0,2,22,24,02
Okmulgee,State Senate,Chad Bonds,DEM,560007,0,2,10,12,8
Okmulgee,State Senate,Gary Clason,DEM,560007,0,1,11,12,8
Okmulgee,State Senate,Selina Jayne-Dornan,DEM,560007,2,1,36,39,8
Okmulgee,Governor,Dax Ewbank,REP,560007,0,0,3,3,
Okmulgee,Governor,Chad Moody,REP,560007,0,0,5,5,
Okmulgee,Governor,Mary Fallin,REP,560007,4,3,35,42,
Okmulgee,Superintendent of Public Instruction,Brian Kelly,REP,560007,1,1,7,9,
Okmulgee,Superintendent of Public Instruction,Janet Costello Barresi,REP,560007,0,2,6,8,
Okmulgee,Superintendent of Public Instruction,Joy Hofmeister,REP,560007,3,0,30,33,
Okmulgee,Insurance Commissioner,Bill Viner,REP,560007,0,0,9,9,
Okmulgee,Insurance Commissioner,John Doak,REP,560007,4,3,33,40,
Okmulgee,Corporation Commissioner,Todd Hiett,REP,560007,2,1,22,25,
Okmulgee,Corporation Commissioner,Cliff Branan,REP,560007,2,2,18,22,
Okmulgee,U.S. Senate,Evelyn Rogers,REP,560007,1,0,1,2,
Okmulgee,U.S. Senate,Rob Moye,REP,560007,0,0,1,1,
Okmulgee,U.S. Senate,D. Jean Mcbride-Samuels,REP,560007,0,0,2,2,
Okmulgee,U.S. Senate,Jim Inhofe,REP,560007,3,3,36,42,
Okmulgee,U.S. Senate,Erick Paul Wyatt,REP,560007,0,0,3,3,
Okmulgee,U.S. Senate,Andy Craig,REP,560007,0,0,1,1,
Okmulgee,U.S. Senate,T. Shannon,REP,560007,3,1,19,23,
Okmulgee,U.S. Senate,Randy Brogdon,REP,560007,0,0,3,3,
Okmulgee,U.S. Senate,Eric Mccray,REP,560007,0,0,0,0,
Okmulgee,U.S. Senate,Kevin Crow,REP,560007,0,0,0,0,
Okmulgee,U.S. Senate,James Lankford,REP,560007,1,2,20,23,
Okmulgee,U.S. Senate,Jason Weger,REP,560007,0,0,0,0,
Okmulgee,U.S. House,Darrel Robertson,REP,560007,0,0,4,4,02
Okmulgee,U.S. House,Markwayne Mullin,REP,560007,4,3,39,46,02
Okmulgee,State Senate,J. Hill,REP,560007,0,1,23,24,8
Okmulgee,State Senate,Roger Thompson,REP,560007,3,2,16,21,8
Okmulgee,State Senate,Malcolm Branch,REP,560007,1,0,2,3,8
Okmulgee,Superintendent of Public Instruction,John Cox,DEM,560008,1,1,11,13,
Okmulgee,Superintendent of Public Instruction,Jack Jr.,DEM,560008,0,2,4,6,
Okmulgee,Superintendent of Public Instruction,Ivan Holmes,DEM,560008,0,0,2,2,
Okmulgee,Superintendent of Public Instruction,Freda Deskin,DEM,560008,0,0,13,13,
Okmulgee,U.S. Senate,Patrick Michael Hayes,DEM,560008,1,1,7,9,
Okmulgee,U.S. Senate,Jim Rogers,DEM,560008,0,2,11,13,
Okmulgee,U.S. Senate,Connie Johnson,DEM,560008,0,0,11,11,
Okmulgee,U.S. House,Earl Everett,DEM,560008,0,3,17,20,02
Okmulgee,U.S. House,Joshua Harris-Till,DEM,560008,1,0,10,11,02
Okmulgee,State Senate,Chad Bonds,DEM,560008,1,3,5,9,8
Okmulgee,State Senate,Gary Clason,DEM,560008,0,0,8,8,8
Okmulgee,State Senate,Selina Jayne-Dornan,DEM,560008,0,0,18,18,8
Okmulgee,Governor,Dax Ewbank,REP,560008,0,0,0,0,
Okmulgee,Governor,Chad Moody,REP,560008,0,0,3,3,
Okmulgee,Governor,Mary Fallin,REP,560008,0,2,19,21,
Okmulgee,Superintendent of Public Instruction,Brian Kelly,REP,560008,0,1,2,3,
Okmulgee,Superintendent of Public Instruction,Janet Costello Barresi,REP,560008,0,0,6,6,
Okmulgee,Superintendent of Public Instruction,Joy Hofmeister,REP,560008,0,1,13,14,
Okmulgee,Insurance Commissioner,Bill Viner,REP,560008,0,0,3,3,
Okmulgee,Insurance Commissioner,John Doak,REP,560008,0,2,17,19,
Okmulgee,Corporation Commissioner,Todd Hiett,REP,560008,0,0,12,12,
Okmulgee,Corporation Commissioner,Cliff Branan,REP,560008,0,1,7,8,
Okmulgee,U.S. Senate,Evelyn Rogers,REP,560008,0,0,0,0,
Okmulgee,U.S. Senate,Rob Moye,REP,560008,0,0,0,0,
Okmulgee,U.S. Senate,D. Jean Mcbride-Samuels,REP,560008,0,0,0,0,
Okmulgee,U.S. Senate,Jim Inhofe,REP,560008,0,2,20,22,
Okmulgee,U.S. Senate,Erick Paul Wyatt,REP,560008,0,0,1,1,
Okmulgee,U.S. Senate,Andy Craig,REP,560008,0,0,0,0,
Okmulgee,U.S. Senate,T. Shannon,REP,560008,0,2,4,6,
Okmulgee,U.S. Senate,Randy Brogdon,REP,560008,0,0,0,0,
Okmulgee,U.S. Senate,Eric Mccray,REP,560008,0,0,1,1,
Okmulgee,U.S. Senate,Kevin Crow,REP,560008,0,0,2,2,
Okmulgee,U.S. Senate,James Lankford,REP,560008,0,0,16,16,
Okmulgee,U.S. Senate,Jason Weger,REP,560008,0,0,0,0,
Okmulgee,U.S. House,Darrel Robertson,REP,560008,0,0,2,2,02
Okmulgee,U.S. House,Markwayne Mullin,REP,560008,0,2,21,23,02
Okmulgee,State Senate,J. Hill,REP,560008,0,1,2,3,8
Okmulgee,State Senate,Roger Thompson,REP,560008,0,1,18,19,8
Okmulgee,State Senate,Malcolm Branch,REP,560008,0,0,1,1,8
Okmulgee,Superintendent of Public Instruction,John Cox,DEM,560009,3,1,9,13,
Okmulgee,Superintendent of Public Instruction,Jack Jr.,DEM,560009,1,0,6,7,
Okmulgee,Superintendent of Public Instruction,Ivan Holmes,DEM,560009,1,2,0,3,
Okmulgee,Superintendent of Public Instruction,Freda Deskin,DEM,560009,1,2,15,18,
Okmulgee,U.S. Senate,Patrick Michael Hayes,DEM,560009,2,2,9,13,
Okmulgee,U.S. Senate,Jim Rogers,DEM,560009,3,0,8,11,
Okmulgee,U.S. Senate,Connie Johnson,DEM,560009,1,2,13,16,
Okmulgee,U.S. House,Earl Everett,DEM,560009,4,3,12,19,02
Okmulgee,U.S. House,Joshua Harris-Till,DEM,560009,2,1,13,16,02
Okmulgee,State Senate,Chad Bonds,DEM,560009,1,5,9,15,8
Okmulgee,State Senate,Gary Clason,DEM,560009,2,0,9,11,8
Okmulgee,State Senate,Selina Jayne-Dornan,DEM,560009,3,1,11,15,8
Okmulgee,Governor,Dax Ewbank,REP,560009,0,0,2,2,
Okmulgee,Governor,Chad Moody,REP,560009,0,0,3,3,
Okmulgee,Governor,Mary Fallin,REP,560009,2,2,24,28,
Okmulgee,Superintendent of Public Instruction,Brian Kelly,REP,560009,0,0,10,10,
Okmulgee,Superintendent of Public Instruction,Janet Costello Barresi,REP,560009,1,1,10,12,
Okmulgee,Superintendent of Public Instruction,Joy Hofmeister,REP,560009,1,1,9,11,
Okmulgee,Insurance Commissioner,Bill Viner,REP,560009,1,0,9,10,
Okmulgee,Insurance Commissioner,John Doak,REP,560009,0,1,20,21,
Okmulgee,Corporation Commissioner,Todd Hiett,REP,560009,2,1,8,11,
Okmulgee,Corporation Commissioner,Cliff Branan,REP,560009,0,1,19,20,
Okmulgee,U.S. Senate,Evelyn Rogers,REP,560009,0,0,0,0,
Okmulgee,U.S. Senate,Rob Moye,REP,560009,0,0,1,1,
Okmulgee,U.S. Senate,D. Jean Mcbride-Samuels,REP,560009,0,0,0,0,
Okmulgee,U.S. Senate,Jim Inhofe,REP,560009,1,2,26,29,
Okmulgee,U.S. Senate,Erick Paul Wyatt,REP,560009,0,0,2,2,
Okmulgee,U.S. Senate,Andy Craig,REP,560009,0,0,0,0,
Okmulgee,U.S. Senate,T. Shannon,REP,560009,2,2,13,17,
Okmulgee,U.S. Senate,Randy Brogdon,REP,560009,0,0,1,1,
Okmulgee,U.S. Senate,Eric Mccray,REP,560009,0,0,0,0,
Okmulgee,U.S. Senate,Kevin Crow,REP,560009,0,0,0,0,
Okmulgee,U.S. Senate,James Lankford,REP,560009,0,0,14,14,
Okmulgee,U.S. Senate,Jason Weger,REP,560009,0,0,0,0,
Okmulgee,U.S. House,Darrel Robertson,REP,560009,1,0,1,2,02
Okmulgee,U.S. House,Markwayne Mullin,REP,560009,1,2,28,31,02
Okmulgee,State Senate,J. Hill,REP,560009,0,1,8,9,8
Okmulgee,State Senate,Roger Thompson,REP,560009,1,0,16,17,8
Okmulgee,State Senate,Malcolm Branch,REP,560009,0,0,3,3,8
Okmulgee,Superintendent of Public Instruction,John Cox,DEM,560010,0,1,17,18,
Okmulgee,Superintendent of Public Instruction,Jack Jr.,DEM,560010,0,2,4,6,
Okmulgee,Superintendent of Public Instruction,Ivan Holmes,DEM,560010,0,1,3,4,
Okmulgee,Superintendent of Public Instruction,Freda Deskin,DEM,560010,0,3,14,17,
Okmulgee,U.S. Senate,Patrick Michael Hayes,DEM,560010,0,2,9,11,
Okmulgee,U.S. Senate,Jim Rogers,DEM,560010,0,3,17,20,
Okmulgee,U.S. Senate,Connie Johnson,DEM,560010,0,2,11,13,
Okmulgee,U.S. House,Earl Everett,DEM,560010,0,5,25,30,02
Okmulgee,U.S. House,Joshua Harris-Till,DEM,560010,0,1,11,12,02
Okmulgee,State Senate,Chad Bonds,DEM,560010,0,6,17,23,8
Okmulgee,State Senate,Gary Clason,DEM,560010,0,0,8,8,8
Okmulgee,State Senate,Selina Jayne-Dornan,DEM,560010,0,1,13,14,8
Okmulgee,Governor,Dax Ewbank,REP,560010,0,0,5,5,
Okmulgee,Governor,Chad Moody,REP,560010,0,0,2,2,
Okmulgee,Governor,Mary Fallin,REP,560010,0,2,36,38,
Okmulgee,Superintendent of Public Instruction,Brian Kelly,REP,560010,0,0,8,8,
Okmulgee,Superintendent of Public Instruction,Janet Costello Barresi,REP,560010,0,1,9,10,
Okmulgee,Superintendent of Public Instruction,Joy Hofmeister,REP,560010,0,1,23,24,
Okmulgee,Insurance Commissioner,Bill Viner,REP,560010,0,0,9,9,
Okmulgee,Insurance Commissioner,John Doak,REP,560010,0,2,27,29,
Okmulgee,Corporation Commissioner,Todd Hiett,REP,560010,0,2,24,26,
Okmulgee,Corporation Commissioner,Cliff Branan,REP,560010,0,0,15,15,
Okmulgee,U.S. Senate,Evelyn Rogers,REP,560010,0,0,1,1,
Okmulgee,U.S. Senate,Rob Moye,REP,560010,0,0,2,2,
Okmulgee,U.S. Senate,D. Jean Mcbride-Samuels,REP,560010,0,0,1,1,
Okmulgee,U.S. Senate,Jim Inhofe,REP,560010,0,1,33,34,
Okmulgee,U.S. Senate,Erick Paul Wyatt,REP,560010,0,1,4,5,
Okmulgee,U.S. Senate,Andy Craig,REP,560010,0,0,0,0,
Okmulgee,U.S. Senate,T. Shannon,REP,560010,0,0,18,18,
Okmulgee,U.S. Senate,Randy Brogdon,REP,560010,0,0,2,2,
Okmulgee,U.S. Senate,Eric Mccray,REP,560010,0,0,0,0,
Okmulgee,U.S. Senate,Kevin Crow,REP,560010,0,0,0,0,
Okmulgee,U.S. Senate,James Lankford,REP,560010,0,2,23,25,
Okmulgee,U.S. Senate,Jason Weger,REP,560010,0,0,0,0,
Okmulgee,U.S. House,Darrel Robertson,REP,560010,0,0,5,5,02
Okmulgee,U.S. House,Markwayne Mullin,REP,560010,0,2,36,38,02
Okmulgee,State Senate,J. Hill,REP,560010,0,0,22,22,8
Okmulgee,State Senate,Roger Thompson,REP,560010,0,2,18,20,8
Okmulgee,State Senate,Malcolm Branch,REP,560010,0,0,1,1,8
Okmulgee,Superintendent of Public Instruction,John Cox,DEM,560011,0,1,20,21,
Okmulgee,Superintendent of Public Instruction,Jack Jr.,DEM,560011,0,1,12,13,
Okmulgee,Superintendent of Public Instruction,Ivan Holmes,DEM,560011,1,1,1,3,
Okmulgee,Superintendent of Public Instruction,Freda Deskin,DEM,560011,2,0,22,24,
Okmulgee,U.S. Senate,Patrick Michael Hayes,DEM,560011,2,0,15,17,
Okmulgee,U.S. Senate,Jim Rogers,DEM,560011,1,4,18,23,
Okmulgee,U.S. Senate,Connie Johnson,DEM,560011,0,0,21,21,
Okmulgee,U.S. House,Earl Everett,DEM,560011,2,2,32,36,02
Okmulgee,U.S. House,Joshua Harris-Till,DEM,560011,1,1,20,22,02
Okmulgee,State Senate,Chad Bonds,DEM,560011,1,0,18,19,8
Okmulgee,State Senate,Gary Clason,DEM,560011,1,2,12,15,8
Okmulgee,State Senate,Selina Jayne-Dornan,DEM,560011,1,2,23,26,8
Okmulgee,Governor,Dax Ewbank,REP,560011,2,0,4,6,
Okmulgee,Governor,Chad Moody,REP,560011,0,0,7,7,
Okmulgee,Governor,Mary Fallin,REP,560011,2,3,30,35,
Okmulgee,Superintendent of Public Instruction,Brian Kelly,REP,560011,0,0,12,12,
Okmulgee,Superintendent of Public Instruction,Janet Costello Barresi,REP,560011,2,2,9,13,
Okmulgee,Superintendent of Public Instruction,Joy Hofmeister,REP,560011,2,0,20,22,
Okmulgee,Insurance Commissioner,Bill Viner,REP,560011,2,0,11,13,
Okmulgee,Insurance Commissioner,John Doak,REP,560011,2,1,29,32,
Okmulgee,Corporation Commissioner,Todd Hiett,REP,560011,2,2,20,24,
Okmulgee,Corporation Commissioner,Cliff Branan,REP,560011,2,1,21,24,
Okmulgee,U.S. Senate,Evelyn Rogers,REP,560011,0,0,1,1,
Okmulgee,U.S. Senate,Rob Moye,REP,560011,0,0,0,0,
Okmulgee,U.S. Senate,D. Jean Mcbride-Samuels,REP,560011,0,0,3,3,
Okmulgee,U.S. Senate,Jim Inhofe,REP,560011,2,3,31,36,
Okmulgee,U.S. Senate,Erick Paul Wyatt,REP,560011,2,0,6,8,
Okmulgee,U.S. Senate,Andy Craig,REP,560011,0,0,0,0,
Okmulgee,U.S. Senate,T. Shannon,REP,560011,0,2,19,21,
Okmulgee,U.S. Senate,Randy Brogdon,REP,560011,2,0,1,3,
Okmulgee,U.S. Senate,Eric Mccray,REP,560011,0,0,0,0,
Okmulgee,U.S. Senate,Kevin Crow,REP,560011,0,0,1,1,
Okmulgee,U.S. Senate,James Lankford,REP,560011,1,1,19,21,
Okmulgee,U.S. Senate,Jason Weger,REP,560011,1,0,1,2,
Okmulgee,U.S. House,Darrel Robertson,REP,560011,2,0,10,12,02
Okmulgee,U.S. House,Markwayne Mullin,REP,560011,2,3,31,36,02
Okmulgee,State Senate,J. Hill,REP,560011,2,1,18,21,8
Okmulgee,State Senate,Roger Thompson,REP,560011,0,1,17,18,8
Okmulgee,State Senate,Malcolm Branch,REP,560011,2,0,5,7,8
Okmulgee,Superintendent of Public Instruction,John Cox,DEM,560012,1,2,48,51,
Okmulgee,Superintendent of Public Instruction,Jack Jr.,DEM,560012,0,2,21,23,
Okmulgee,Superintendent of Public Instruction,Ivan Holmes,DEM,560012,0,2,8,10,
Okmulgee,Superintendent of Public Instruction,Freda Deskin,DEM,560012,4,1,55,60,
Okmulgee,U.S. Senate,Patrick Michael Hayes,DEM,560012,0,2,26,28,
Okmulgee,U.S. Senate,Jim Rogers,DEM,560012,0,1,56,57,
Okmulgee,U.S. Senate,Connie Johnson,DEM,560012,5,3,46,54,
Okmulgee,U.S. House,Earl Everett,DEM,560012,2,4,80,86,02
Okmulgee,U.S. House,Joshua Harris-Till,DEM,560012,3,2,38,43,02
Okmulgee,State Senate,Chad Bonds,DEM,560012,0,2,29,31,8
Okmulgee,State Senate,Gary Clason,DEM,560012,0,2,43,45,8
Okmulgee,State Senate,Selina Jayne-Dornan,DEM,560012,5,3,58,66,8
Okmulgee,Governor,Dax Ewbank,REP,560012,0,0,6,6,
Okmulgee,Governor,Chad Moody,REP,560012,0,0,19,19,
Okmulgee,Governor,Mary Fallin,REP,560012,2,7,82,91,
Okmulgee,Superintendent of Public Instruction,Brian Kelly,REP,560012,1,0,23,24,
Okmulgee,Superintendent of Public Instruction,Janet Costello Barresi,REP,560012,1,2,19,22,
Okmulgee,Superintendent of Public Instruction,Joy Hofmeister,REP,560012,0,5,66,71,
Okmulgee,Insurance Commissioner,Bill Viner,REP,560012,1,0,19,20,
Okmulgee,Insurance Commissioner,John Doak,REP,560012,1,7,82,90,
Okmulgee,Corporation Commissioner,Todd Hiett,REP,560012,0,4,53,57,
Okmulgee,Corporation Commissioner,Cliff Branan,REP,560012,2,3,52,57,
Okmulgee,U.S. Senate,Evelyn Rogers,REP,560012,0,0,7,7,
Okmulgee,U.S. Senate,Rob Moye,REP,560012,0,0,3,3,
Okmulgee,U.S. Senate,D. Jean Mcbride-Samuels,REP,560012,0,0,2,2,
Okmulgee,U.S. Senate,Jim Inhofe,REP,560012,2,7,89,98,
Okmulgee,U.S. Senate,Erick Paul Wyatt,REP,560012,0,0,6,6,
Okmulgee,U.S. Senate,Andy Craig,REP,560012,1,0,2,3,
Okmulgee,U.S. Senate,T. Shannon,REP,560012,0,2,49,51,
Okmulgee,U.S. Senate,Randy Brogdon,REP,560012,0,0,3,3,
Okmulgee,U.S. Senate,Eric Mccray,REP,560012,0,0,1,1,
Okmulgee,U.S. Senate,Kevin Crow,REP,560012,0,0,1,1,
Okmulgee,U.S. Senate,James Lankford,REP,560012,1,5,52,58,
Okmulgee,U.S. Senate,Jason Weger,REP,560012,0,0,0,0,
Okmulgee,U.S. House,Darrel Robertson,REP,560012,1,2,20,23,02
Okmulgee,U.S. House,Markwayne Mullin,REP,560012,1,5,86,92,02
Okmulgee,State Senate,J. Hill,REP,560012,0,3,51,54,8
Okmulgee,State Senate,Roger Thompson,REP,560012,2,4,50,56,8
Okmulgee,State Senate,Malcolm Branch,REP,560012,0,0,6,6,8
Okmulgee,Superintendent of Public Instruction,John Cox,DEM,560013,0,1,64,65,
Okmulgee,Superintendent of Public Instruction,Jack Jr.,DEM,560013,0,2,9,11,
Okmulgee,Superintendent of Public Instruction,Ivan Holmes,DEM,560013,0,0,8,8,
Okmulgee,Superintendent of Public Instruction,Freda Deskin,DEM,560013,1,0,53,54,
Okmulgee,U.S. Senate,Patrick Michael Hayes,DEM,560013,0,1,15,16,
Okmulgee,U.S. Senate,Jim Rogers,DEM,560013,1,1,56,58,
Okmulgee,U.S. Senate,Connie Johnson,DEM,560013,0,1,57,58,
Okmulgee,U.S. House,Earl Everett,DEM,560013,1,2,72,75,02
Okmulgee,U.S. House,Joshua Harris-Till,DEM,560013,0,1,51,52,02
Okmulgee,State Senate,Chad Bonds,DEM,560013,0,0,21,21,8
Okmulgee,State Senate,Gary Clason,DEM,560013,1,3,83,87,8
Okmulgee,State Senate,Selina Jayne-Dornan,DEM,560013,0,0,27,27,8
Okmulgee,Governor,Dax Ewbank,REP,560013,0,0,5,5,
Okmulgee,Governor,Chad Moody,REP,560013,0,0,2,2,
Okmulgee,Governor,Mary Fallin,REP,560013,0,0,22,22,
Okmulgee,Superintendent of Public Instruction,Brian Kelly,REP,560013,0,0,6,6,
Okmulgee,Superintendent of Public Instruction,Janet Costello Barresi,REP,560013,0,0,5,5,
Okmulgee,Superintendent of Public Instruction,Joy Hofmeister,REP,560013,0,0,17,17,
Okmulgee,Insurance Commissioner,Bill Viner,REP,560013,0,0,8,8,
Okmulgee,Insurance Commissioner,John Doak,REP,560013,0,0,20,20,
Okmulgee,Corporation Commissioner,Todd Hiett,REP,560013,0,0,16,16,
Okmulgee,Corporation Commissioner,Cliff Branan,REP,560013,0,0,10,10,
Okmulgee,U.S. Senate,Evelyn Rogers,REP,560013,0,0,0,0,
Okmulgee,U.S. Senate,Rob Moye,REP,560013,0,0,2,2,
Okmulgee,U.S. Senate,D. Jean Mcbride-Samuels,REP,560013,0,0,0,0,
Okmulgee,U.S. Senate,Jim Inhofe,REP,560013,0,0,27,27,
Okmulgee,U.S. Senate,Erick Paul Wyatt,REP,560013,0,0,0,0,
Okmulgee,U.S. Senate,Andy Craig,REP,560013,0,0,2,2,
Okmulgee,U.S. Senate,T. Shannon,REP,560013,0,0,12,12,
Okmulgee,U.S. Senate,Randy Brogdon,REP,560013,0,0,2,2,
Okmulgee,U.S. Senate,Eric Mccray,REP,560013,0,0,0,0,
Okmulgee,U.S. Senate,Kevin Crow,REP,560013,0,0,0,0,
Okmulgee,U.S. Senate,James Lankford,REP,560013,0,0,13,13,
Okmulgee,U.S. Senate,Jason Weger,REP,560013,0,0,0,0,
Okmulgee,U.S. House,Darrel Robertson,REP,560013,0,0,6,6,02
Okmulgee,U.S. House,Markwayne Mullin,REP,560013,0,0,22,22,02
Okmulgee,State Senate,J. Hill,REP,560013,0,0,12,12,8
Okmulgee,State Senate,Roger Thompson,REP,560013,0,0,14,14,8
Okmulgee,State Senate,Malcolm Branch,REP,560013,0,0,2,2,8
Okmulgee,Superintendent of Public Instruction,John Cox,DEM,560014,0,2,45,47,
Okmulgee,Superintendent of Public Instruction,Jack Jr.,DEM,560014,0,0,6,6,
Okmulgee,Superintendent of Public Instruction,Ivan Holmes,DEM,560014,0,0,2,2,
Okmulgee,Superintendent of Public Instruction,Freda Deskin,DEM,560014,3,0,21,24,
Okmulgee,U.S. Senate,Patrick Michael Hayes,DEM,560014,1,0,13,14,
Okmulgee,U.S. Senate,Jim Rogers,DEM,560014,1,2,30,33,
Okmulgee,U.S. Senate,Connie Johnson,DEM,560014,1,0,29,30,
Okmulgee,U.S. House,Earl Everett,DEM,560014,2,1,46,49,02
Okmulgee,U.S. House,Joshua Harris-Till,DEM,560014,0,0,19,19,02
Okmulgee,State Senate,Chad Bonds,DEM,560014,0,0,14,14,8
Okmulgee,State Senate,Gary Clason,DEM,560014,0,1,39,40,8
Okmulgee,State Senate,Selina Jayne-Dornan,DEM,560014,2,0,23,25,8
Okmulgee,Governor,Dax Ewbank,REP,560014,0,0,1,1,
Okmulgee,Governor,Chad Moody,REP,560014,0,0,2,2,
Okmulgee,Governor,Mary Fallin,REP,560014,0,0,21,21,
Okmulgee,Superintendent of Public Instruction,Brian Kelly,REP,560014,0,0,3,3,
Okmulgee,Superintendent of Public Instruction,Janet Costello Barresi,REP,560014,0,0,6,6,
Okmulgee,Superintendent of Public Instruction,Joy Hofmeister,REP,560014,0,0,14,14,
Okmulgee,Insurance Commissioner,Bill Viner,REP,560014,0,0,1,1,
Okmulgee,Insurance Commissioner,John Doak,REP,560014,0,0,19,19,
Okmulgee,Corporation Commissioner,Todd Hiett,REP,560014,0,0,15,15,
Okmulgee,Corporation Commissioner,Cliff Branan,REP,560014,0,0,7,7,
Okmulgee,U.S. Senate,Evelyn Rogers,REP,560014,0,0,1,1,
Okmulgee,U.S. Senate,Rob Moye,REP,560014,0,0,1,1,
Okmulgee,U.S. Senate,D. Jean Mcbride-Samuels,REP,560014,0,0,1,1,
Okmulgee,U.S. Senate,Jim Inhofe,REP,560014,0,0,21,21,
Okmulgee,U.S. Senate,Erick Paul Wyatt,REP,560014,0,0,0,0,
Okmulgee,U.S. Senate,Andy Craig,REP,560014,0,0,1,1,
Okmulgee,U.S. Senate,T. Shannon,REP,560014,0,0,12,12,
Okmulgee,U.S. Senate,Randy Brogdon,REP,560014,0,0,0,0,
Okmulgee,U.S. Senate,Eric Mccray,REP,560014,0,0,0,0,
Okmulgee,U.S. Senate,Kevin Crow,REP,560014,0,0,0,0,
Okmulgee,U.S. Senate,James Lankford,REP,560014,0,0,11,11,
Okmulgee,U.S. Senate,Jason Weger,REP,560014,0,0,0,0,
Okmulgee,U.S. House,Darrel Robertson,REP,560014,0,0,2,2,02
Okmulgee,U.S. House,Markwayne Mullin,REP,560014,0,0,21,21,02
Okmulgee,State Senate,J. Hill,REP,560014,0,0,8,8,8
Okmulgee,State Senate,Roger Thompson,REP,560014,0,0,11,11,8
Okmulgee,State Senate,Malcolm Branch,REP,560014,0,0,1,1,8
Okmulgee,Superintendent of Public Instruction,John Cox,DEM,560015,2,7,85,94,
Okmulgee,Superintendent of Public Instruction,Jack Jr.,DEM,560015,2,1,29,32,
Okmulgee,Superintendent of Public Instruction,Ivan Holmes,DEM,560015,2,1,7,10,
Okmulgee,Superintendent of Public Instruction,Freda Deskin,DEM,560015,2,1,67,70,
Okmulgee,U.S. Senate,Patrick Michael Hayes,DEM,560015,2,2,30,34,
Okmulgee,U.S. Senate,Jim Rogers,DEM,560015,3,6,80,89,
Okmulgee,U.S. Senate,Connie Johnson,DEM,560015,3,2,71,76,
Okmulgee,U.S. House,Earl Everett,DEM,560015,2,8,114,124,02
Okmulgee,U.S. House,Joshua Harris-Till,DEM,560015,5,2,63,70,02
Okmulgee,State Senate,Chad Bonds,DEM,560015,1,0,39,40,8
Okmulgee,State Senate,Gary Clason,DEM,560015,7,9,103,119,8
Okmulgee,State Senate,Selina Jayne-Dornan,DEM,560015,1,1,48,50,8
Okmulgee,Governor,Dax Ewbank,REP,560015,1,3,6,10,
Okmulgee,Governor,Chad Moody,REP,560015,0,0,16,16,
Okmulgee,Governor,Mary Fallin,REP,560015,3,3,60,66,
Okmulgee,Superintendent of Public Instruction,Brian Kelly,REP,560015,0,1,19,20,
Okmulgee,Superintendent of Public Instruction,Janet Costello Barresi,REP,560015,1,0,10,11,
Okmulgee,Superintendent of Public Instruction,Joy Hofmeister,REP,560015,4,5,53,62,
Okmulgee,Insurance Commissioner,Bill Viner,REP,560015,1,1,14,16,
Okmulgee,Insurance Commissioner,John Doak,REP,560015,3,5,62,70,
Okmulgee,Corporation Commissioner,Todd Hiett,REP,560015,1,4,44,49,
Okmulgee,Corporation Commissioner,Cliff Branan,REP,560015,3,2,30,35,
Okmulgee,U.S. Senate,Evelyn Rogers,REP,560015,1,0,3,4,
Okmulgee,U.S. Senate,Rob Moye,REP,560015,0,0,4,4,
Okmulgee,U.S. Senate,D. Jean Mcbride-Samuels,REP,560015,0,0,1,1,
Okmulgee,U.S. Senate,Jim Inhofe,REP,560015,3,6,69,78,
Okmulgee,U.S. Senate,Erick Paul Wyatt,REP,560015,0,0,4,4,
Okmulgee,U.S. Senate,Andy Craig,REP,560015,0,0,0,0,
Okmulgee,U.S. Senate,T. Shannon,REP,560015,2,3,40,45,
Okmulgee,U.S. Senate,Randy Brogdon,REP,560015,2,0,4,6,
Okmulgee,U.S. Senate,Eric Mccray,REP,560015,0,0,0,0,
Okmulgee,U.S. Senate,Kevin Crow,REP,560015,0,0,2,2,
Okmulgee,U.S. Senate,James Lankford,REP,560015,1,3,37,41,
Okmulgee,U.S. Senate,Jason Weger,REP,560015,0,0,0,0,
Okmulgee,U.S. House,Darrel Robertson,REP,560015,1,1,14,16,02
Okmulgee,U.S. House,Markwayne Mullin,REP,560015,4,5,70,79,02
Okmulgee,State Senate,J. Hill,REP,560015,3,1,23,27,8
Okmulgee,State Senate,Roger Thompson,REP,560015,2,4,42,48,8
Okmulgee,State Senate,Malcolm Branch,REP,560015,0,1,8,9,8
Okmulgee,Superintendent of Public Instruction,John Cox,DEM,560016,0,0,55,55,
Okmulgee,Superintendent of Public Instruction,Jack Jr.,DEM,560016,0,0,11,11,
Okmulgee,Superintendent of Public Instruction,Ivan Holmes,DEM,560016,0,0,8,8,
Okmulgee,Superintendent of Public Instruction,Freda Deskin,DEM,560016,3,2,35,40,
Okmulgee,U.S. Senate,Patrick Michael Hayes,DEM,560016,1,0,16,17,
Okmulgee,U.S. Senate,Jim Rogers,DEM,560016,0,0,49,49,
Okmulgee,U.S. Senate,Connie Johnson,DEM,560016,2,2,38,42,
Okmulgee,U.S. House,Earl Everett,DEM,560016,1,0,63,64,02
Okmulgee,U.S. House,Joshua Harris-Till,DEM,560016,2,2,36,40,02
Okmulgee,State Senate,Chad Bonds,DEM,560016,0,1,16,17,8
Okmulgee,State Senate,Gary Clason,DEM,560016,3,1,65,69,8
Okmulgee,State Senate,Selina Jayne-Dornan,DEM,560016,0,0,27,27,8
Okmulgee,Governor,Dax Ewbank,REP,560016,0,0,3,3,
Okmulgee,Governor,Chad Moody,REP,560016,0,0,9,9,
Okmulgee,Governor,Mary Fallin,REP,560016,2,0,38,40,
Okmulgee,Superintendent of Public Instruction,Brian Kelly,REP,560016,0,0,16,16,
Okmulgee,Superintendent of Public Instruction,Janet Costello Barresi,REP,560016,0,0,10,10,
Okmulgee,Superintendent of Public Instruction,Joy Hofmeister,REP,560016,2,0,24,26,
Okmulgee,Insurance Commissioner,Bill Viner,REP,560016,0,0,8,8,
Okmulgee,Insurance Commissioner,John Doak,REP,560016,2,0,41,43,
Okmulgee,Corporation Commissioner,Todd Hiett,REP,560016,0,0,24,24,
Okmulgee,Corporation Commissioner,Cliff Branan,REP,560016,2,0,23,25,
Okmulgee,U.S. Senate,Evelyn Rogers,REP,560016,0,0,1,1,
Okmulgee,U.S. Senate,Rob Moye,REP,560016,0,0,0,0,
Okmulgee,U.S. Senate,D. Jean Mcbride-Samuels,REP,560016,0,0,0,0,
Okmulgee,U.S. Senate,Jim Inhofe,REP,560016,2,0,49,51,
Okmulgee,U.S. Senate,Erick Paul Wyatt,REP,560016,0,0,0,0,
Okmulgee,U.S. Senate,Andy Craig,REP,560016,0,0,0,0,
Okmulgee,U.S. Senate,T. Shannon,REP,560016,1,0,17,18,
Okmulgee,U.S. Senate,Randy Brogdon,REP,560016,1,0,3,4,
Okmulgee,U.S. Senate,Eric Mccray,REP,560016,0,0,0,0,
Okmulgee,U.S. Senate,Kevin Crow,REP,560016,0,0,0,0,
Okmulgee,U.S. Senate,James Lankford,REP,560016,0,0,30,30,
Okmulgee,U.S. Senate,Jason Weger,REP,560016,0,0,0,0,
Okmulgee,U.S. House,Darrel Robertson,REP,560016,0,0,7,7,02
Okmulgee,U.S. House,Markwayne Mullin,REP,560016,2,0,43,45,02
Okmulgee,State Senate,J. Hill,REP,560016,0,0,15,15,8
Okmulgee,State Senate,Roger Thompson,REP,560016,2,0,27,29,8
Okmulgee,State Senate,Malcolm Branch,REP,560016,0,0,8,8,8
Okmulgee,Superintendent of Public Instruction,John Cox,DEM,560018,3,1,54,58,
Okmulgee,Superintendent of Public Instruction,Jack Jr.,DEM,560018,0,0,8,8,
Okmulgee,Superintendent of Public Instruction,Ivan Holmes,DEM,560018,1,0,12,13,
Okmulgee,Superintendent of Public Instruction,Freda Deskin,DEM,560018,4,0,41,45,
Okmulgee,U.S. Senate,Patrick Michael Hayes,DEM,560018,1,0,24,25,
Okmulgee,U.S. Senate,Jim Rogers,DEM,560018,2,0,50,52,
Okmulgee,U.S. Senate,Connie Johnson,DEM,560018,3,1,37,41,
Okmulgee,U.S. House,Earl Everett,DEM,560018,3,0,64,67,02
Okmulgee,U.S. House,Joshua Harris-Till,DEM,560018,2,1,44,47,02
Okmulgee,State Senate,Chad Bonds,DEM,560018,1,0,26,27,8
Okmulgee,State Senate,Gary Clason,DEM,560018,4,1,63,68,8
Okmulgee,State Senate,Selina Jayne-Dornan,DEM,560018,4,0,24,28,8
Okmulgee,Governor,Dax Ewbank,REP,560018,0,0,6,6,
Okmulgee,Governor,Chad Moody,REP,560018,0,0,5,5,
Okmulgee,Governor,Mary Fallin,REP,560018,0,1,36,37,
Okmulgee,Superintendent of Public Instruction,Brian Kelly,REP,560018,0,0,11,11,
Okmulgee,Superintendent of Public Instruction,Janet Costello Barresi,REP,560018,0,0,3,3,
Okmulgee,Superintendent of Public Instruction,Joy Hofmeister,REP,560018,0,1,30,31,
Okmulgee,Insurance Commissioner,Bill Viner,REP,560018,0,0,7,7,
Okmulgee,Insurance Commissioner,John Doak,REP,560018,0,1,37,38,
Okmulgee,Corporation Commissioner,Todd Hiett,REP,560018,0,0,24,24,
Okmulgee,Corporation Commissioner,Cliff Branan,REP,560018,0,1,22,23,
Okmulgee,U.S. Senate,Evelyn Rogers,REP,560018,0,0,2,2,
Okmulgee,U.S. Senate,Rob Moye,REP,560018,0,0,1,1,
Okmulgee,U.S. Senate,D. Jean Mcbride-Samuels,REP,560018,0,0,0,0,
Okmulgee,U.S. Senate,Jim Inhofe,REP,560018,0,1,42,43,
Okmulgee,U.S. Senate,Erick Paul Wyatt,REP,560018,0,0,2,2,
Okmulgee,U.S. Senate,Andy Craig,REP,560018,0,0,1,1,
Okmulgee,U.S. Senate,T. Shannon,REP,560018,0,1,26,27,
Okmulgee,U.S. Senate,Randy Brogdon,REP,560018,0,0,0,0,
Okmulgee,U.S. Senate,Eric Mccray,REP,560018,0,0,0,0,
Okmulgee,U.S. Senate,Kevin Crow,REP,560018,0,0,0,0,
Okmulgee,U.S. Senate,James Lankford,REP,560018,0,0,16,16,
Okmulgee,U.S. Senate,Jason Weger,REP,560018,0,0,2,2,
Okmulgee,U.S. House,Darrel Robertson,REP,560018,0,0,10,10,02
Okmulgee,U.S. House,Markwayne Mullin,REP,560018,0,1,36,37,02
Okmulgee,State Senate,J. Hill,REP,560018,0,1,21,22,8
Okmulgee,State Senate,Roger Thompson,REP,560018,0,0,17,17,8
Okmulgee,State Senate,Malcolm Branch,REP,560018,0,0,7,7,8
Okmulgee,Superintendent of Public Instruction,John Cox,DEM,560019,0,4,67,71,
Okmulgee,Superintendent of Public Instruction,Jack Jr.,DEM,560019,0,0,6,6,
Okmulgee,Superintendent of Public Instruction,Ivan Holmes,DEM,560019,0,1,8,9,
Okmulgee,Superintendent of Public Instruction,Freda Deskin,DEM,560019,0,0,34,34,
Okmulgee,U.S. Senate,Patrick Michael Hayes,DEM,560019,0,1,35,36,
Okmulgee,U.S. Senate,Jim Rogers,DEM,560019,0,1,33,34,
Okmulgee,U.S. Senate,Connie Johnson,DEM,560019,0,2,45,47,
Okmulgee,U.S. House,Earl Everett,DEM,560019,0,1,62,63,02
Okmulgee,U.S. House,Joshua Harris-Till,DEM,560019,0,3,47,50,02
Okmulgee,State Senate,Chad Bonds,DEM,560019,0,1,26,27,8
Okmulgee,State Senate,Gary Clason,DEM,560019,0,3,72,75,8
Okmulgee,State Senate,Selina Jayne-Dornan,DEM,560019,0,2,22,24,8
Okmulgee,Governor,Dax Ewbank,REP,560019,0,0,0,0,
Okmulgee,Governor,Chad Moody,REP,560019,0,0,9,9,
Okmulgee,Governor,Mary Fallin,REP,560019,2,1,38,41,
Okmulgee,Superintendent of Public Instruction,Brian Kelly,REP,560019,0,1,8,9,
Okmulgee,Superintendent of Public Instruction,Janet Costello Barresi,REP,560019,1,0,8,9,
Okmulgee,Superintendent of Public Instruction,Joy Hofmeister,REP,560019,1,0,30,31,
Okmulgee,Insurance Commissioner,Bill Viner,REP,560019,2,0,12,14,
Okmulgee,Insurance Commissioner,John Doak,REP,560019,0,1,31,32,
Okmulgee,Corporation Commissioner,Todd Hiett,REP,560019,1,0,19,20,
Okmulgee,Corporation Commissioner,Cliff Branan,REP,560019,1,1,24,26,
Okmulgee,U.S. Senate,Evelyn Rogers,REP,560019,0,0,3,3,
Okmulgee,U.S. Senate,Rob Moye,REP,560019,0,0,2,2,
Okmulgee,U.S. Senate,D. Jean Mcbride-Samuels,REP,560019,0,0,1,1,
Okmulgee,U.S. Senate,Jim Inhofe,REP,560019,2,1,37,40,
Okmulgee,U.S. Senate,Erick Paul Wyatt,REP,560019,0,0,4,4,
Okmulgee,U.S. Senate,Andy Craig,REP,560019,0,0,1,1,
Okmulgee,U.S. Senate,T. Shannon,REP,560019,0,0,20,20,
Okmulgee,U.S. Senate,Randy Brogdon,REP,560019,0,0,3,3,
Okmulgee,U.S. Senate,Eric Mccray,REP,560019,0,0,0,0,
Okmulgee,U.S. Senate,Kevin Crow,REP,560019,0,0,2,2,
Okmulgee,U.S. Senate,James Lankford,REP,560019,2,1,21,24,
Okmulgee,U.S. Senate,Jason Weger,REP,560019,0,0,1,1,
Okmulgee,U.S. House,Darrel Robertson,REP,560019,0,0,7,7,02
Okmulgee,U.S. House,Markwayne Mullin,REP,560019,2,1,39,42,02
Okmulgee,State Senate,J. Hill,REP,560019,0,0,14,14,8
Okmulgee,State Senate,Roger Thompson,REP,560019,2,1,20,23,8
Okmulgee,State Senate,Malcolm Branch,REP,560019,0,0,8,8,8
Okmulgee,Superintendent of Public Instruction,John Cox,DEM,560020,0,3,128,131,
Okmulgee,Superintendent of Public Instruction,Jack Jr.,DEM,560020,0,0,35,35,
Okmulgee,Superintendent of Public Instruction,Ivan Holmes,DEM,560020,0,0,13,13,
Okmulgee,Superintendent of Public Instruction,Freda Deskin,DEM,560020,0,1,99,100,
Okmulgee,U.S. Senate,Patrick Michael Hayes,DEM,560020,0,0,53,53,
Okmulgee,U.S. Senate,Jim Rogers,DEM,560020,0,3,105,108,
Okmulgee,U.S. Senate,Connie Johnson,DEM,560020,0,1,115,116,
Okmulgee,U.S. House,Earl Everett,DEM,560020,0,2,190,192,02
Okmulgee,U.S. House,Joshua Harris-Till,DEM,560020,0,2,77,79,02
Okmulgee,State Senate,Chad Bonds,DEM,560020,0,1,110,111,8
Okmulgee,State Senate,Gary Clason,DEM,560020,0,1,46,47,8
Okmulgee,State Senate,Selina Jayne-Dornan,DEM,560020,0,2,111,113,8
Okmulgee,Governor,Dax Ewbank,REP,560020,1,0,20,21,
Okmulgee,Governor,Chad Moody,REP,560020,0,2,34,36,
Okmulgee,Governor,Mary Fallin,REP,560020,5,2,170,177,
Okmulgee,Superintendent of Public Instruction,Brian Kelly,REP,560020,0,2,54,56,
Okmulgee,Superintendent of Public Instruction,Janet Costello Barresi,REP,560020,3,0,34,37,
Okmulgee,Superintendent of Public Instruction,Joy Hofmeister,REP,560020,3,2,136,141,
Okmulgee,Insurance Commissioner,Bill Viner,REP,560020,3,0,45,48,
Okmulgee,Insurance Commissioner,John Doak,REP,560020,3,4,167,174,
Okmulgee,Corporation Commissioner,Todd Hiett,REP,560020,4,3,127,134,
Okmulgee,Corporation Commissioner,Cliff Branan,REP,560020,2,1,81,84,
Okmulgee,U.S. Senate,Evelyn Rogers,REP,560020,0,1,6,7,
Okmulgee,U.S. Senate,Rob Moye,REP,560020,2,0,4,6,
Okmulgee,U.S. Senate,D. Jean Mcbride-Samuels,REP,560020,0,1,4,5,
Okmulgee,U.S. Senate,Jim Inhofe,REP,560020,4,2,207,213,
Okmulgee,U.S. Senate,Erick Paul Wyatt,REP,560020,0,0,2,2,
Okmulgee,U.S. Senate,Andy Craig,REP,560020,0,0,0,0,
Okmulgee,U.S. Senate,T. Shannon,REP,560020,2,3,104,109,
Okmulgee,U.S. Senate,Randy Brogdon,REP,560020,0,0,34,34,
Okmulgee,U.S. Senate,Eric Mccray,REP,560020,0,0,2,2,
Okmulgee,U.S. Senate,Kevin Crow,REP,560020,0,0,1,1,
Okmulgee,U.S. Senate,James Lankford,REP,560020,4,1,80,85,
Okmulgee,U.S. Senate,Jason Weger,REP,560020,0,0,4,4,
Okmulgee,U.S. House,Darrel Robertson,REP,560020,0,1,23,24,02
Okmulgee,U.S. House,Markwayne Mullin,REP,560020,6,3,199,208,02
Okmulgee,State Senate,J. Hill,REP,560020,0,0,78,78,8
Okmulgee,State Senate,Roger Thompson,REP,560020,5,4,85,94,8
Okmulgee,State Senate,Malcolm Branch,REP,560020,1,0,50,51,8
Okmulgee,Superintendent of Public Instruction,John Cox,DEM,560021,0,2,41,43,
Okmulgee,Superintendent of Public Instruction,Jack Jr.,DEM,560021,0,0,9,9,
Okmulgee,Superintendent of Public Instruction,Ivan Holmes,DEM,560021,0,1,5,6,
Okmulgee,Superintendent of Public Instruction,Freda Deskin,DEM,560021,1,1,26,28,
Okmulgee,U.S. Senate,Patrick Michael Hayes,DEM,560021,0,1,20,21,
Okmulgee,U.S. Senate,Jim Rogers,DEM,560021,0,0,28,28,
Okmulgee,U.S. Senate,Connie Johnson,DEM,560021,1,3,32,36,
Okmulgee,U.S. House,Earl Everett,DEM,560021,1,1,50,52,02
Okmulgee,U.S. House,Joshua Harris-Till,DEM,560021,0,2,29,31,02
Okmulgee,State Senate,Chad Bonds,DEM,560021,0,2,17,19,8
Okmulgee,State Senate,Gary Clason,DEM,560021,0,1,32,33,8
Okmulgee,State Senate,Selina Jayne-Dornan,DEM,560021,1,1,32,34,8
Okmulgee,Governor,Dax Ewbank,REP,560021,0,0,2,2,
Okmulgee,Governor,Chad Moody,REP,560021,0,0,6,6,
Okmulgee,Governor,Mary Fallin,REP,560021,0,0,13,13,
Okmulgee,Superintendent of Public Instruction,Brian Kelly,REP,560021,0,0,3,3,
Okmulgee,Superintendent of Public Instruction,Janet Costello Barresi,REP,560021,0,0,5,5,
Okmulgee,Superintendent of Public Instruction,Joy Hofmeister,REP,560021,0,0,11,11,
Okmulgee,Insurance Commissioner,Bill Viner,REP,560021,0,0,7,7,
Okmulgee,Insurance Commissioner,John Doak,REP,560021,0,0,14,14,
Okmulgee,Corporation Commissioner,Todd Hiett,REP,560021,0,0,15,15,
Okmulgee,Corporation Commissioner,Cliff Branan,REP,560021,0,0,6,6,
Okmulgee,U.S. Senate,Evelyn Rogers,REP,560021,0,0,0,0,
Okmulgee,U.S. Senate,Rob Moye,REP,560021,0,0,3,3,
Okmulgee,U.S. Senate,D. Jean Mcbride-Samuels,REP,560021,0,0,1,1,
Okmulgee,U.S. Senate,Jim Inhofe,REP,560021,0,0,17,17,
Okmulgee,U.S. Senate,Erick Paul Wyatt,REP,560021,0,0,0,0,
Okmulgee,U.S. Senate,Andy Craig,REP,560021,0,0,2,2,
Okmulgee,U.S. Senate,T. Shannon,REP,560021,0,0,12,12,
Okmulgee,U.S. Senate,Randy Brogdon,REP,560021,0,0,1,1,
Okmulgee,U.S. Senate,Eric Mccray,REP,560021,0,0,0,0,
Okmulgee,U.S. Senate,Kevin Crow,REP,560021,0,0,1,1,
Okmulgee,U.S. Senate,James Lankford,REP,560021,0,0,5,5,
Okmulgee,U.S. Senate,Jason Weger,REP,560021,0,0,0,0,
Okmulgee,U.S. House,Darrel Robertson,REP,560021,0,0,5,5,02
Okmulgee,U.S. House,Markwayne Mullin,REP,560021,0,0,16,16,02
Okmulgee,State Senate,J. Hill,REP,560021,0,0,9,9,8
Okmulgee,State Senate,Roger Thompson,REP,560021,0,0,11,11,8
Okmulgee,State Senate,Malcolm Branch,REP,560021,0,0,1,1,8
Okmulgee,Superintendent of Public Instruction,John Cox,DEM,560026,0,3,87,90,
Okmulgee,Superintendent of Public Instruction,Jack Jr.,DEM,560026,0,0,26,26,
Okmulgee,Superintendent of Public Instruction,Ivan Holmes,DEM,560026,0,0,7,7,
Okmulgee,Superintendent of Public Instruction,Freda Deskin,DEM,560026,0,0,50,50,
Okmulgee,U.S. Senate,Patrick Michael Hayes,DEM,560026,0,0,27,27,
Okmulgee,U.S. Senate,Jim Rogers,DEM,560026,0,2,89,91,
Okmulgee,U.S. Senate,Connie Johnson,DEM,560026,0,1,41,42,
Okmulgee,U.S. House,Earl Everett,DEM,560026,0,2,112,114,02
Okmulgee,U.S. House,Joshua Harris-Till,DEM,560026,0,1,43,44,02
Okmulgee,State Senate,Chad Bonds,DEM,560026,0,3,49,52,8
Okmulgee,State Senate,Gary Clason,DEM,560026,0,0,72,72,8
Okmulgee,State Senate,Selina Jayne-Dornan,DEM,560026,0,1,44,45,8
Okmulgee,Governor,Dax Ewbank,REP,560026,0,0,4,4,
Okmulgee,Governor,Chad Moody,REP,560026,0,0,19,19,
Okmulgee,Governor,Mary Fallin,REP,560026,1,7,107,115,
Okmulgee,Superintendent of Public Instruction,Brian Kelly,REP,560026,0,2,18,20,
Okmulgee,Superintendent of Public Instruction,Janet Costello Barresi,REP,560026,0,3,21,24,
Okmulgee,Superintendent of Public Instruction,Joy Hofmeister,REP,560026,1,2,92,95,
Okmulgee,Insurance Commissioner,Bill Viner,REP,560026,0,1,29,30,
Okmulgee,Insurance Commissioner,John Doak,REP,560026,1,6,97,104,
Okmulgee,Corporation Commissioner,Todd Hiett,REP,560026,0,5,70,75,
Okmulgee,Corporation Commissioner,Cliff Branan,REP,560026,1,2,56,59,
Okmulgee,U.S. Senate,Evelyn Rogers,REP,560026,0,0,7,7,
Okmulgee,U.S. Senate,Rob Moye,REP,560026,0,0,1,1,
Okmulgee,U.S. Senate,D. Jean Mcbride-Samuels,REP,560026,0,0,3,3,
Okmulgee,U.S. Senate,Jim Inhofe,REP,560026,1,7,113,121,
Okmulgee,U.S. Senate,Erick Paul Wyatt,REP,560026,0,0,8,8,
Okmulgee,U.S. Senate,Andy Craig,REP,560026,0,1,0,1,
Okmulgee,U.S. Senate,T. Shannon,REP,560026,0,0,68,68,
Okmulgee,U.S. Senate,Randy Brogdon,REP,560026,0,1,9,10,
Okmulgee,U.S. Senate,Eric Mccray,REP,560026,0,0,0,0,
Okmulgee,U.S. Senate,Kevin Crow,REP,560026,0,0,0,0,
Okmulgee,U.S. Senate,James Lankford,REP,560026,1,5,53,59,
Okmulgee,U.S. Senate,Jason Weger,REP,560026,0,0,1,1,
Okmulgee,U.S. House,Darrel Robertson,REP,560026,0,0,15,15,02
Okmulgee,U.S. House,Markwayne Mullin,REP,560026,1,7,114,122,02
Okmulgee,State Senate,J. Hill,REP,560026,0,2,63,65,8
Okmulgee,State Senate,Roger Thompson,REP,560026,1,4,52,57,8
Okmulgee,State Senate,Malcolm Branch,REP,560026,0,0,11,11,8
Okmulgee,Superintendent of Public Instruction,John Cox,DEM,560027,1,0,59,60,
Okmulgee,Superintendent of Public Instruction,Jack Jr.,DEM,560027,1,0,3,4,
Okmulgee,Superintendent of Public Instruction,Ivan Holmes,DEM,560027,0,0,10,10,
Okmulgee,Superintendent of Public Instruction,Freda Deskin,DEM,560027,2,0,13,15,
Okmulgee,U.S. Senate,Patrick Michael Hayes,DEM,560027,1,0,18,19,
Okmulgee,U.S. Senate,Jim Rogers,DEM,560027,2,0,35,37,
Okmulgee,U.S. Senate,Connie Johnson,DEM,560027,1,0,27,28,
Okmulgee,U.S. House,Earl Everett,DEM,560027,2,0,46,48,02
Okmulgee,U.S. House,Joshua Harris-Till,DEM,560027,2,0,34,36,02
Okmulgee,State Senate,Chad Bonds,DEM,560027,1,0,28,29,8
Okmulgee,State Senate,Gary Clason,DEM,560027,1,0,27,28,8
Okmulgee,State Senate,Selina Jayne-Dornan,DEM,560027,2,0,27,29,8
Okmulgee,Governor,Dax Ewbank,REP,560027,0,0,4,4,
Okmulgee,Governor,Chad Moody,REP,560027,0,0,12,12,
Okmulgee,Governor,Mary Fallin,REP,560027,6,0,59,65,
Okmulgee,Superintendent of Public Instruction,Brian Kelly,REP,560027,2,0,23,25,
Okmulgee,Superintendent of Public Instruction,Janet Costello Barresi,REP,560027,2,0,18,20,
Okmulgee,Superintendent of Public Instruction,Joy Hofmeister,REP,560027,2,0,30,32,
Okmulgee,Insurance Commissioner,Bill Viner,REP,560027,1,0,15,16,
Okmulgee,Insurance Commissioner,John Doak,REP,560027,5,0,58,63,
Okmulgee,Corporation Commissioner,Todd Hiett,REP,560027,4,0,36,40,
Okmulgee,Corporation Commissioner,Cliff Branan,REP,560027,1,0,36,37,
Okmulgee,U.S. Senate,Evelyn Rogers,REP,560027,1,0,2,3,
Okmulgee,U.S. Senate,Rob Moye,REP,560027,0,0,1,1,
Okmulgee,U.S. Senate,D. Jean Mcbride-Samuels,REP,560027,0,0,3,3,
Okmulgee,U.S. Senate,Jim Inhofe,REP,560027,5,0,66,71,
Okmulgee,U.S. Senate,Erick Paul Wyatt,REP,560027,0,0,2,2,
Okmulgee,U.S. Senate,Andy Craig,REP,560027,0,0,0,0,
Okmulgee,U.S. Senate,T. Shannon,REP,560027,4,0,33,37,
Okmulgee,U.S. Senate,Randy Brogdon,REP,560027,1,0,12,13,
Okmulgee,U.S. Senate,Eric Mccray,REP,560027,0,0,0,0,
Okmulgee,U.S. Senate,Kevin Crow,REP,560027,0,0,1,1,
Okmulgee,U.S. Senate,James Lankford,REP,560027,1,0,27,28,
Okmulgee,U.S. Senate,Jason Weger,REP,560027,0,0,2,2,
Okmulgee,U.S. House,Darrel Robertson,REP,560027,0,0,9,9,02
Okmulgee,U.S. House,Markwayne Mullin,REP,560027,6,0,66,72,02
Okmulgee,State Senate,J. Hill,REP,560027,3,0,32,35,8
Okmulgee,State Senate,Roger Thompson,REP,560027,1,0,28,29,8
Okmulgee,State Senate,Malcolm Branch,REP,560027,2,0,8,10,8
Okmulgee,Superintendent of Public Instruction,John Cox,DEM,560029,0,0,56,56,
Okmulgee,Superintendent of Public Instruction,Jack Jr.,DEM,560029,0,0,12,12,
Okmulgee,Superintendent of Public Instruction,Ivan Holmes,DEM,560029,0,1,10,11,
Okmulgee,Superintendent of Public Instruction,Freda Deskin,DEM,560029,1,0,47,48,
Okmulgee,U.S. Senate,Patrick Michael Hayes,DEM,560029,0,0,28,28,
Okmulgee,U.S. Senate,Jim Rogers,DEM,560029,1,1,44,46,
Okmulgee,U.S. Senate,Connie Johnson,DEM,560029,0,0,46,46,
Okmulgee,U.S. House,Earl Everett,DEM,560029,0,1,77,78,02
Okmulgee,U.S. House,Joshua Harris-Till,DEM,560029,1,0,38,39,02
Okmulgee,State Senate,Chad Bonds,DEM,560029,0,0,48,48,8
Okmulgee,State Senate,Gary Clason,DEM,560029,0,1,27,28,8
Okmulgee,State Senate,Selina Jayne-Dornan,DEM,560029,1,0,45,46,8
Okmulgee,Governor,Dax Ewbank,REP,560029,2,0,21,23,
Okmulgee,Governor,Chad Moody,REP,560029,0,0,24,24,
Okmulgee,Governor,Mary Fallin,REP,560029,5,3,126,134,
Okmulgee,Superintendent of Public Instruction,Brian Kelly,REP,560029,0,0,45,45,
Okmulgee,Superintendent of Public Instruction,Janet Costello Barresi,REP,560029,3,2,26,31,
Okmulgee,Superintendent of Public Instruction,Joy Hofmeister,REP,560029,4,1,98,103,
Okmulgee,Insurance Commissioner,Bill Viner,REP,560029,2,0,38,40,
Okmulgee,Insurance Commissioner,John Doak,REP,560029,3,3,120,126,
Okmulgee,Corporation Commissioner,Todd Hiett,REP,560029,4,2,91,97,
Okmulgee,Corporation Commissioner,Cliff Branan,REP,560029,1,1,72,74,
Okmulgee,U.S. Senate,Evelyn Rogers,REP,560029,0,0,3,3,
Okmulgee,U.S. Senate,Rob Moye,REP,560029,0,0,4,4,
Okmulgee,U.S. Senate,D. Jean Mcbride-Samuels,REP,560029,1,0,2,3,
Okmulgee,U.S. Senate,Jim Inhofe,REP,560029,6,3,157,166,
Okmulgee,U.S. Senate,Erick Paul Wyatt,REP,560029,0,0,7,7,
Okmulgee,U.S. Senate,Andy Craig,REP,560029,0,0,1,1,
Okmulgee,U.S. Senate,T. Shannon,REP,560029,1,0,68,69,
Okmulgee,U.S. Senate,Randy Brogdon,REP,560029,5,1,29,35,
Okmulgee,U.S. Senate,Eric Mccray,REP,560029,0,0,1,1,
Okmulgee,U.S. Senate,Kevin Crow,REP,560029,0,0,3,3,
Okmulgee,U.S. Senate,James Lankford,REP,560029,1,2,68,71,
Okmulgee,U.S. Senate,Jason Weger,REP,560029,0,0,0,0,
Okmulgee,U.S. House,Darrel Robertson,REP,560029,0,0,19,19,02
Okmulgee,U.S. House,Markwayne Mullin,REP,560029,7,3,152,162,02
Okmulgee,State Senate,J. Hill,REP,560029,5,3,59,67,8
Okmulgee,State Senate,Roger Thompson,REP,560029,1,0,76,77,8
Okmulgee,State Senate,Malcolm Branch,REP,560029,1,0,25,26,8
Okmulgee,Superintendent of Public Instruction,John Cox,DEM,560031,0,0,23,23,
Okmulgee,Superintendent of Public Instruction,Jack Jr.,DEM,560031,0,1,13,14,
Okmulgee,Superintendent of Public Instruction,Ivan Holmes,DEM,560031,0,0,2,2,
Okmulgee,Superintendent of Public Instruction,Freda Deskin,DEM,560031,0,1,25,26,
Okmulgee,U.S. Senate,Patrick Michael Hayes,DEM,560031,0,1,9,10,
Okmulgee,U.S. Senate,Jim Rogers,DEM,560031,0,0,29,29,
Okmulgee,U.S. Senate,Connie Johnson,DEM,560031,0,1,25,26,
Okmulgee,U.S. House,Earl Everett,DEM,560031,0,1,38,39,02
Okmulgee,U.S. House,Joshua Harris-Till,DEM,560031,0,1,24,25,02
Okmulgee,State Senate,Chad Bonds,DEM,560031,0,2,50,52,8
Okmulgee,State Senate,Gary Clason,DEM,560031,0,0,3,3,8
Okmulgee,State Senate,Selina Jayne-Dornan,DEM,560031,0,0,10,10,8
Okmulgee,Governor,Dax Ewbank,REP,560031,0,0,1,1,
Okmulgee,Governor,Chad Moody,REP,560031,0,0,4,4,
Okmulgee,Governor,Mary Fallin,REP,560031,1,2,29,32,
Okmulgee,Superintendent of Public Instruction,Brian Kelly,REP,560031,0,1,6,7,
Okmulgee,Superintendent of Public Instruction,Janet Costello Barresi,REP,560031,0,1,10,11,
Okmulgee,Superintendent of Public Instruction,Joy Hofmeister,REP,560031,1,0,17,18,
Okmulgee,Insurance Commissioner,Bill Viner,REP,560031,1,0,8,9,
Okmulgee,Insurance Commissioner,John Doak,REP,560031,0,2,22,24,
Okmulgee,Corporation Commissioner,Todd Hiett,REP,560031,1,0,15,16,
Okmulgee,Corporation Commissioner,Cliff Branan,REP,560031,0,2,17,19,
Okmulgee,U.S. Senate,Evelyn Rogers,REP,560031,0,0,2,2,
Okmulgee,U.S. Senate,Rob Moye,REP,560031,0,0,0,0,
Okmulgee,U.S. Senate,D. Jean Mcbride-Samuels,REP,560031,0,0,1,1,
Okmulgee,U.S. Senate,Jim Inhofe,REP,560031,1,2,31,34,
Okmulgee,U.S. Senate,Erick Paul Wyatt,REP,560031,0,0,1,1,
Okmulgee,U.S. Senate,Andy Craig,REP,560031,0,0,1,1,
Okmulgee,U.S. Senate,T. Shannon,REP,560031,0,0,17,17,
Okmulgee,U.S. Senate,Randy Brogdon,REP,560031,0,0,1,1,
Okmulgee,U.S. Senate,Eric Mccray,REP,560031,0,0,0,0,
Okmulgee,U.S. Senate,Kevin Crow,REP,560031,0,0,0,0,
Okmulgee,U.S. Senate,James Lankford,REP,560031,1,2,15,18,
Okmulgee,U.S. Senate,Jason Weger,REP,560031,0,0,0,0,
Okmulgee,U.S. House,Darrel Robertson,REP,560031,0,0,3,3,02
Okmulgee,U.S. House,Markwayne Mullin,REP,560031,1,2,30,33,02
Okmulgee,State Senate,J. Hill,REP,560031,1,0,9,10,8
Okmulgee,State Senate,Roger Thompson,REP,560031,0,2,12,14,8
Okmulgee,State Senate,Malcolm Branch,REP,560031,0,0,12,12,8
Okmulgee,Superintendent of Public Instruction,John Cox,DEM,560032,0,0,13,13,
Okmulgee,Superintendent of Public Instruction,Jack Jr.,DEM,560032,0,0,8,8,
Okmulgee,Superintendent of Public Instruction,Ivan Holmes,DEM,560032,0,0,7,7,
Okmulgee,Superintendent of Public Instruction,Freda Deskin,DEM,560032,1,1,21,23,
Okmulgee,U.S. Senate,Patrick Michael Hayes,DEM,560032,0,0,12,12,
Okmulgee,U.S. Senate,Jim Rogers,DEM,560032,1,0,17,18,
Okmulgee,U.S. Senate,Connie Johnson,DEM,560032,0,1,22,23,
Okmulgee,U.S. House,Earl Everett,DEM,560032,1,1,29,31,02
Okmulgee,U.S. House,Joshua Harris-Till,DEM,560032,0,0,21,21,02
Okmulgee,State Senate,Chad Bonds,DEM,560032,0,1,12,13,8
Okmulgee,State Senate,Gary Clason,DEM,560032,0,0,10,10,8
Okmulgee,State Senate,Selina Jayne-Dornan,DEM,560032,1,1,28,30,8
Okmulgee,Governor,Dax Ewbank,REP,560032,0,0,1,1,
Okmulgee,Governor,Chad Moody,REP,560032,0,0,4,4,
Okmulgee,Governor,Mary Fallin,REP,560032,0,4,29,33,
Okmulgee,Superintendent of Public Instruction,Brian Kelly,REP,560032,0,2,11,13,
Okmulgee,Superintendent of Public Instruction,Janet Costello Barresi,REP,560032,0,0,6,6,
Okmulgee,Superintendent of Public Instruction,Joy Hofmeister,REP,560032,0,1,16,17,
Okmulgee,Insurance Commissioner,Bill Viner,REP,560032,0,1,4,5,
Okmulgee,Insurance Commissioner,John Doak,REP,560032,0,3,28,31,
Okmulgee,Corporation Commissioner,Todd Hiett,REP,560032,0,0,17,17,
Okmulgee,Corporation Commissioner,Cliff Branan,REP,560032,0,3,14,17,
Okmulgee,U.S. Senate,Evelyn Rogers,REP,560032,0,0,0,0,
Okmulgee,U.S. Senate,Rob Moye,REP,560032,0,0,0,0,
Okmulgee,U.S. Senate,D. Jean Mcbride-Samuels,REP,560032,0,0,1,1,
Okmulgee,U.S. Senate,Jim Inhofe,REP,560032,0,4,31,35,
Okmulgee,U.S. Senate,Erick Paul Wyatt,REP,560032,0,0,1,1,
Okmulgee,U.S. Senate,Andy Craig,REP,560032,0,0,0,0,
Okmulgee,U.S. Senate,T. Shannon,REP,560032,0,4,17,21,
Okmulgee,U.S. Senate,Randy Brogdon,REP,560032,0,0,1,1,
Okmulgee,U.S. Senate,Eric Mccray,REP,560032,0,0,0,0,
Okmulgee,U.S. Senate,Kevin Crow,REP,560032,0,0,0,0,
Okmulgee,U.S. Senate,James Lankford,REP,560032,0,0,16,16,
Okmulgee,U.S. Senate,Jason Weger,REP,560032,0,0,0,0,
Okmulgee,U.S. House,Darrel Robertson,REP,560032,0,0,5,5,02
Okmulgee,U.S. House,Markwayne Mullin,REP,560032,0,4,29,33,02
Okmulgee,State Senate,J. Hill,REP,560032,0,1,12,13,8
Okmulgee,State Senate,Roger Thompson,REP,560032,0,2,20,22,8
Okmulgee,State Senate,Malcolm Branch,REP,560032,0,0,2,2,8
Okmulgee,Superintendent of Public Instruction,John Cox,DEM,560033,0,1,37,38,
Okmulgee,Superintendent of Public Instruction,Jack Jr.,DEM,560033,0,1,4,5,
Okmulgee,Superintendent of Public Instruction,Ivan Holmes,DEM,560033,0,0,4,4,
Okmulgee,Superintendent of Public Instruction,Freda Deskin,DEM,560033,0,1,27,28,
Okmulgee,U.S. Senate,Patrick Michael Hayes,DEM,560033,0,0,15,15,
Okmulgee,U.S. Senate,Jim Rogers,DEM,560033,0,1,25,26,
Okmulgee,U.S. Senate,Connie Johnson,DEM,560033,0,2,29,31,
Okmulgee,U.S. House,Earl Everett,DEM,560033,0,1,33,34,02
Okmulgee,U.S. House,Joshua Harris-Till,DEM,560033,0,2,31,33,02
Okmulgee,State Senate,Chad Bonds,DEM,560033,0,1,24,25,8
Okmulgee,State Senate,Gary Clason,DEM,560033,0,0,15,15,8
Okmulgee,State Senate,Selina Jayne-Dornan,DEM,560033,0,2,29,31,8
Okmulgee,Governor,Dax Ewbank,REP,560033,0,0,5,5,
Okmulgee,Governor,Chad Moody,REP,560033,0,0,10,10,
Okmulgee,Governor,Mary Fallin,REP,560033,1,1,39,41,
Okmulgee,Superintendent of Public Instruction,Brian Kelly,REP,560033,0,0,12,12,
Okmulgee,Superintendent of Public Instruction,Janet Costello Barresi,REP,560033,0,1,8,9,
Okmulgee,Superintendent of Public Instruction,Joy Hofmeister,REP,560033,1,0,30,31,
Okmulgee,Insurance Commissioner,Bill Viner,REP,560033,0,0,11,11,
Okmulgee,Insurance Commissioner,John Doak,REP,560033,1,0,40,41,
Okmulgee,Corporation Commissioner,Todd Hiett,REP,560033,1,0,30,31,
Okmulgee,Corporation Commissioner,Cliff Branan,REP,560033,0,1,19,20,
Okmulgee,U.S. Senate,Evelyn Rogers,REP,560033,0,0,3,3,
Okmulgee,U.S. Senate,Rob Moye,REP,560033,0,0,1,1,
Okmulgee,U.S. Senate,D. Jean Mcbride-Samuels,REP,560033,0,0,0,0,
Okmulgee,U.S. Senate,Jim Inhofe,REP,560033,1,0,47,48,
Okmulgee,U.S. Senate,Erick Paul Wyatt,REP,560033,0,0,4,4,
Okmulgee,U.S. Senate,Andy Craig,REP,560033,0,0,1,1,
Okmulgee,U.S. Senate,T. Shannon,REP,560033,1,0,31,32,
Okmulgee,U.S. Senate,Randy Brogdon,REP,560033,0,0,3,3,
Okmulgee,U.S. Senate,Eric Mccray,REP,560033,0,0,1,1,
Okmulgee,U.S. Senate,Kevin Crow,REP,560033,0,0,1,1,
Okmulgee,U.S. Senate,James Lankford,REP,560033,0,0,16,16,
Okmulgee,U.S. Senate,Jason Weger,REP,560033,0,0,1,1,
Okmulgee,U.S. House,Darrel Robertson,REP,560033,0,0,9,9,02
Okmulgee,U.S. House,Markwayne Mullin,REP,560033,1,1,44,46,02
Okmulgee,State Senate,J. Hill,REP,560033,0,0,20,20,8
Okmulgee,State Senate,Roger Thompson,REP,560033,1,1,17,19,8
Okmulgee,State Senate,Malcolm Branch,REP,560033,0,0,13,13,8
Okmulgee,Superintendent of Public Instruction,John Cox,DEM,560034,1,1,28,30,
Okmulgee,Superintendent of Public Instruction,Jack Jr.,DEM,560034,0,0,2,2,
Okmulgee,Superintendent of Public Instruction,Ivan Holmes,DEM,560034,0,0,5,5,
Okmulgee,Superintendent of Public Instruction,Freda Deskin,DEM,560034,0,0,10,10,
Okmulgee,U.S. Senate,Patrick Michael Hayes,DEM,560034,0,0,10,10,
Okmulgee,U.S. Senate,Jim Rogers,DEM,560034,0,1,21,22,
Okmulgee,U.S. Senate,Connie Johnson,DEM,560034,1,0,10,11,
Okmulgee,U.S. House,Earl Everett,DEM,560034,1,1,28,30,02
Okmulgee,U.S. House,Joshua Harris-Till,DEM,560034,0,0,14,14,02
Okmulgee,State Senate,Chad Bonds,DEM,560034,1,0,27,28,8
Okmulgee,State Senate,Gary Clason,DEM,560034,0,1,6,7,8
Okmulgee,State Senate,Selina Jayne-Dornan,DEM,560034,0,0,11,11,8
Okmulgee,Governor,Dax Ewbank,REP,560034,0,0,5,5,
Okmulgee,Governor,Chad Moody,REP,560034,0,2,4,6,
Okmulgee,Governor,Mary Fallin,REP,560034,0,0,40,40,
Okmulgee,Superintendent of Public Instruction,Brian Kelly,REP,560034,0,0,10,10,
Okmulgee,Superintendent of Public Instruction,Janet Costello Barresi,REP,560034,0,1,11,12,
Okmulgee,Superintendent of Public Instruction,Joy Hofmeister,REP,560034,0,1,27,28,
Okmulgee,Insurance Commissioner,Bill Viner,REP,560034,0,1,13,14,
Okmulgee,Insurance Commissioner,John Doak,REP,560034,0,1,35,36,
Okmulgee,Corporation Commissioner,Todd Hiett,REP,560034,0,2,29,31,
Okmulgee,Corporation Commissioner,Cliff Branan,REP,560034,0,0,17,17,
Okmulgee,U.S. Senate,Evelyn Rogers,REP,560034,0,0,3,3,
Okmulgee,U.S. Senate,Rob Moye,REP,560034,0,0,0,0,
Okmulgee,U.S. Senate,D. Jean Mcbride-Samuels,REP,560034,0,0,0,0,
Okmulgee,U.S. Senate,Jim Inhofe,REP,560034,0,1,40,41,
Okmulgee,U.S. Senate,Erick Paul Wyatt,REP,560034,0,1,6,7,
Okmulgee,U.S. Senate,Andy Craig,REP,560034,0,0,1,1,
Okmulgee,U.S. Senate,T. Shannon,REP,560034,0,1,27,28,
Okmulgee,U.S. Senate,Randy Brogdon,REP,560034,0,0,1,1,
Okmulgee,U.S. Senate,Eric Mccray,REP,560034,0,0,0,0,
Okmulgee,U.S. Senate,Kevin Crow,REP,560034,0,0,0,0,
Okmulgee,U.S. Senate,James Lankford,REP,560034,0,1,19,20,
Okmulgee,U.S. Senate,Jason Weger,REP,560034,0,0,1,1,
Okmulgee,U.S. House,Darrel Robertson,REP,560034,0,0,5,5,02
Okmulgee,U.S. House,Markwayne Mullin,REP,560034,0,2,44,46,02
Okmulgee,State Senate,J. Hill,REP,560034,0,0,14,14,8
Okmulgee,State Senate,Roger Thompson,REP,560034,0,2,26,28,8
Okmulgee,State Senate,Malcolm Branch,REP,560034,0,0,4,4,8
Okmulgee,Superintendent of Public Instruction,John Cox,DEM,560035,0,1,32,33,
Okmulgee,Superintendent of Public Instruction,Jack Jr.,DEM,560035,0,0,5,5,
Okmulgee,Superintendent of Public Instruction,Ivan Holmes,DEM,560035,0,0,7,7,
Okmulgee,Superintendent of Public Instruction,Freda Deskin,DEM,560035,0,0,49,49,
Okmulgee,U.S. Senate,Patrick Michael Hayes,DEM,560035,0,0,20,20,
Okmulgee,U.S. Senate,Jim Rogers,DEM,560035,0,1,42,43,
Okmulgee,U.S. Senate,Connie Johnson,DEM,560035,0,0,27,27,
Okmulgee,U.S. House,Earl Everett,DEM,560035,0,0,52,52,02
Okmulgee,U.S. House,Joshua Harris-Till,DEM,560035,0,1,33,34,02
Okmulgee,State Senate,Chad Bonds,DEM,560035,0,0,8,8,8
Okmulgee,State Senate,Gary Clason,DEM,560035,0,1,62,63,8
Okmulgee,State Senate,Selina Jayne-Dornan,DEM,560035,0,0,21,21,8
Okmulgee,Governor,Dax Ewbank,REP,560035,0,0,0,0,
Okmulgee,Governor,Chad Moody,REP,560035,0,0,3,3,
Okmulgee,Governor,Mary Fallin,REP,560035,0,0,16,16,
Okmulgee,Superintendent of Public Instruction,Brian Kelly,REP,560035,0,0,6,6,
Okmulgee,Superintendent of Public Instruction,Janet Costello Barresi,REP,560035,0,0,5,5,
Okmulgee,Superintendent of Public Instruction,Joy Hofmeister,REP,560035,0,0,9,9,
Okmulgee,Insurance Commissioner,Bill Viner,REP,560035,0,0,5,5,
Okmulgee,Insurance Commissioner,John Doak,REP,560035,0,0,14,14,
Okmulgee,Corporation Commissioner,Todd Hiett,REP,560035,0,0,11,11,
Okmulgee,Corporation Commissioner,Cliff Branan,REP,560035,0,0,7,7,
Okmulgee,U.S. Senate,Evelyn Rogers,REP,560035,0,0,1,1,
Okmulgee,U.S. Senate,Rob Moye,REP,560035,0,0,0,0,
Okmulgee,U.S. Senate,D. Jean Mcbride-Samuels,REP,560035,0,0,0,0,
Okmulgee,U.S. Senate,Jim Inhofe,REP,560035,0,0,18,18,
Okmulgee,U.S. Senate,Erick Paul Wyatt,REP,560035,0,0,1,1,
Okmulgee,U.S. Senate,Andy Craig,REP,560035,0,0,0,0,
Okmulgee,U.S. Senate,T. Shannon,REP,560035,0,0,8,8,
Okmulgee,U.S. Senate,Randy Brogdon,REP,560035,0,0,3,3,
Okmulgee,U.S. Senate,Eric Mccray,REP,560035,0,0,0,0,
Okmulgee,U.S. Senate,Kevin Crow,REP,560035,0,0,1,1,
Okmulgee,U.S. Senate,James Lankford,REP,560035,0,0,8,8,
Okmulgee,U.S. Senate,Jason Weger,REP,560035,0,0,0,0,
Okmulgee,U.S. House,Darrel Robertson,REP,560035,0,0,7,7,02
Okmulgee,U.S. House,Markwayne Mullin,REP,560035,0,0,13,13,02
Okmulgee,State Senate,J. Hill,REP,560035,0,0,9,9,8
Okmulgee,State Senate,Roger Thompson,REP,560035,0,0,8,8,8
Okmulgee,State Senate,Malcolm Branch,REP,560035,0,0,1,1,8
Okmulgee,Superintendent of Public Instruction,John Cox,DEM,560036,1,2,46,49,
Okmulgee,Superintendent of Public Instruction,Jack Jr.,DEM,560036,0,1,19,20,
Okmulgee,Superintendent of Public Instruction,Ivan Holmes,DEM,560036,0,0,5,5,
Okmulgee,Superintendent of Public Instruction,Freda Deskin,DEM,560036,2,3,38,43,
Okmulgee,U.S. Senate,Patrick Michael Hayes,DEM,560036,0,1,25,26,
Okmulgee,U.S. Senate,Jim Rogers,DEM,560036,1,3,38,42,
Okmulgee,U.S. Senate,Connie Johnson,DEM,560036,2,2,41,45,
Okmulgee,U.S. House,Earl Everett,DEM,560036,3,2,69,74,02
Okmulgee,U.S. House,Joshua Harris-Till,DEM,560036,0,4,33,37,02
Okmulgee,State Senate,Chad Bonds,DEM,560036,2,1,30,33,8
Okmulgee,State Senate,Gary Clason,DEM,560036,1,3,36,40,8
Okmulgee,State Senate,Selina Jayne-Dornan,DEM,560036,0,2,40,42,8
Okmulgee,Governor,Dax Ewbank,REP,560036,0,0,6,6,
Okmulgee,Governor,Chad Moody,REP,560036,1,1,7,9,
Okmulgee,Governor,Mary Fallin,REP,560036,0,6,69,75,
Okmulgee,Superintendent of Public Instruction,Brian Kelly,REP,560036,1,1,10,12,
Okmulgee,Superintendent of Public Instruction,Janet Costello Barresi,REP,560036,0,2,9,11,
Okmulgee,Superintendent of Public Instruction,Joy Hofmeister,REP,560036,0,4,64,68,
Okmulgee,Insurance Commissioner,Bill Viner,REP,560036,0,0,15,15,
Okmulgee,Insurance Commissioner,John Doak,REP,560036,1,7,64,72,
Okmulgee,Corporation Commissioner,Todd Hiett,REP,560036,0,5,42,47,
Okmulgee,Corporation Commissioner,Cliff Branan,REP,560036,1,2,37,40,
Okmulgee,U.S. Senate,Evelyn Rogers,REP,560036,0,0,1,1,
Okmulgee,U.S. Senate,Rob Moye,REP,560036,1,0,1,2,
Okmulgee,U.S. Senate,D. Jean Mcbride-Samuels,REP,560036,0,0,2,2,
Okmulgee,U.S. Senate,Jim Inhofe,REP,560036,0,6,73,79,
Okmulgee,U.S. Senate,Erick Paul Wyatt,REP,560036,0,1,4,5,
Okmulgee,U.S. Senate,Andy Craig,REP,560036,0,0,0,0,
Okmulgee,U.S. Senate,T. Shannon,REP,560036,1,4,36,41,
Okmulgee,U.S. Senate,Randy Brogdon,REP,560036,0,2,2,4,
Okmulgee,U.S. Senate,Eric Mccray,REP,560036,0,0,0,0,
Okmulgee,U.S. Senate,Kevin Crow,REP,560036,0,0,1,1,
Okmulgee,U.S. Senate,James Lankford,REP,560036,0,1,44,45,
Okmulgee,U.S. Senate,Jason Weger,REP,560036,0,0,0,0,
Okmulgee,U.S. House,Darrel Robertson,REP,560036,1,0,9,10,02
Okmulgee,U.S. House,Markwayne Mullin,REP,560036,0,7,73,80,02
Okmulgee,State Senate,J. Hill,REP,560036,1,5,30,36,8
Okmulgee,State Senate,Roger Thompson,REP,560036,0,1,43,44,8
Okmulgee,State Senate,Malcolm Branch,REP,560036,0,0,5,5,8
Okmulgee,Superintendent of Public Instruction,John Cox,DEM,560038,0,0,33,33,
Okmulgee,Superintendent of Public Instruction,Jack Jr.,DEM,560038,0,1,4,5,
Okmulgee,Superintendent of Public Instruction,Ivan Holmes,DEM,560038,0,0,1,1,
Okmulgee,Superintendent of Public Instruction,Freda Deskin,DEM,560038,0,0,29,29,
Okmulgee,U.S. Senate,Patrick Michael Hayes,DEM,560038,0,0,15,15,
Okmulgee,U.S. Senate,Jim Rogers,DEM,560038,0,1,20,21,
Okmulgee,U.S. Senate,Connie Johnson,DEM,560038,0,0,26,26,
Okmulgee,U.S. House,Earl Everett,DEM,560038,0,0,38,38,02
Okmulgee,U.S. House,Joshua Harris-Till,DEM,560038,0,1,22,23,02
Okmulgee,State Senate,Chad Bonds,DEM,560038,0,0,21,21,8
Okmulgee,State Senate,Gary Clason,DEM,560038,0,1,30,31,8
Okmulgee,State Senate,Selina Jayne-Dornan,DEM,560038,0,0,14,14,8
Okmulgee,Governor,Dax Ewbank,REP,560038,0,0,3,3,
Okmulgee,Governor,Chad Moody,REP,560038,0,1,2,3,
Okmulgee,Governor,Mary Fallin,REP,560038,0,2,19,21,
Okmulgee,Superintendent of Public Instruction,Brian Kelly,REP,560038,0,2,4,6,
Okmulgee,Superintendent of Public Instruction,Janet Costello Barresi,REP,560038,0,0,2,2,
Okmulgee,Superintendent of Public Instruction,Joy Hofmeister,REP,560038,0,1,18,19,
Okmulgee,Insurance Commissioner,Bill Viner,REP,560038,0,1,2,3,
Okmulgee,Insurance Commissioner,John Doak,REP,560038,0,2,19,21,
Okmulgee,Corporation Commissioner,Todd Hiett,REP,560038,0,1,12,13,
Okmulgee,Corporation Commissioner,Cliff Branan,REP,560038,0,2,10,12,
Okmulgee,U.S. Senate,Evelyn Rogers,REP,560038,0,0,2,2,
Okmulgee,U.S. Senate,Rob Moye,REP,560038,0,0,0,0,
Okmulgee,U.S. Senate,D. Jean Mcbride-Samuels,REP,560038,0,0,0,0,
Okmulgee,U.S. Senate,Jim Inhofe,REP,560038,0,3,19,22,
Okmulgee,U.S. Senate,Erick Paul Wyatt,REP,560038,0,0,2,2,
Okmulgee,U.S. Senate,Andy Craig,REP,560038,0,0,1,1,
Okmulgee,U.S. Senate,T. Shannon,REP,560038,0,2,11,13,
Okmulgee,U.S. Senate,Randy Brogdon,REP,560038,0,0,1,1,
Okmulgee,U.S. Senate,Eric Mccray,REP,560038,0,0,0,0,
Okmulgee,U.S. Senate,Kevin Crow,REP,560038,0,0,1,1,
Okmulgee,U.S. Senate,James Lankford,REP,560038,0,1,10,11,
Okmulgee,U.S. Senate,Jason Weger,REP,560038,0,0,0,0,
Okmulgee,U.S. House,Darrel Robertson,REP,560038,0,0,2,2,02
Okmulgee,U.S. House,Markwayne Mullin,REP,560038,0,3,22,25,02
Okmulgee,State Senate,J. Hill,REP,560038,0,0,7,7,8
Okmulgee,State Senate,Roger Thompson,REP,560038,0,2,15,17,8
Okmulgee,State Senate,Malcolm Branch,REP,560038,0,1,1,2,8
Osage,Superintendent of Public Instruction,John Cox,DEM,570101,0,0,9,9,
Osage,Superintendent of Public Instruction,Jack Jr.,DEM,570101,0,0,2,2,
Osage,Superintendent of Public Instruction,Ivan Holmes,DEM,570101,0,0,2,2,
Osage,Superintendent of Public Instruction,Freda Deskin,DEM,570101,0,0,5,5,
Osage,U.S. Senate,Patrick Michael Hayes,DEM,570101,0,0,4,4,
Osage,U.S. Senate,Jim Rogers,DEM,570101,0,0,5,5,
Osage,U.S. Senate,Connie Johnson,DEM,570101,0,0,3,3,
Osage,Governor,Dax Ewbank,REP,570101,0,0,0,0,
Osage,Governor,Chad Moody,REP,570101,0,0,2,2,
Osage,Governor,Mary Fallin,REP,570101,0,0,10,10,
Osage,Superintendent of Public Instruction,Brian Kelly,REP,570101,0,0,3,3,
Osage,Superintendent of Public Instruction,Janet Costello Barresi,REP,570101,0,0,3,3,
Osage,Superintendent of Public Instruction,Joy Hofmeister,REP,570101,0,0,6,6,
Osage,Insurance Commissioner,Bill Viner,REP,570101,0,0,2,2,
Osage,Insurance Commissioner,John Doak,REP,570101,0,0,9,9,
Osage,Corporation Commissioner,Todd Hiett,REP,570101,0,0,7,7,
Osage,Corporation Commissioner,Cliff Branan,REP,570101,0,0,5,5,
Osage,U.S. Senate,Evelyn Rogers,REP,570101,0,0,0,0,
Osage,U.S. Senate,Rob Moye,REP,570101,0,0,0,0,
Osage,U.S. Senate,D. Jean Mcbride-Samuels,REP,570101,0,0,0,0,
Osage,U.S. Senate,Jim Inhofe,REP,570101,0,0,11,11,
Osage,U.S. Senate,Erick Paul Wyatt,REP,570101,0,0,1,1,
Osage,U.S. Senate,Andy Craig,REP,570101,0,0,0,0,
Osage,U.S. Senate,T. Shannon,REP,570101,0,0,11,11,
Osage,U.S. Senate,Randy Brogdon,REP,570101,0,0,0,0,
Osage,U.S. Senate,Eric Mccray,REP,570101,0,0,0,0,
Osage,U.S. Senate,Kevin Crow,REP,570101,0,0,0,0,
Osage,U.S. Senate,James Lankford,REP,570101,0,0,1,1,
Osage,U.S. Senate,Jason Weger,REP,570101,0,0,0,0,
Osage,U.S. House,Timothy Ray Murray,REP,570101,0,0,1,1,03
Osage,U.S. House,Robert Hubbard,REP,570101,0,0,0,0,03
Osage,U.S. House,Frank Lucas,REP,570101,0,0,11,11,03
Osage,State House,Randy Barnett,REP,570101,0,0,6,6,10
Osage,State House,Travis Dunlap,REP,570101,0,0,6,6,10
Osage,Superintendent of Public Instruction,John Cox,DEM,570102,2,0,2,4,
Osage,Superintendent of Public Instruction,Jack Jr.,DEM,570102,0,0,2,2,
Osage,Superintendent of Public Instruction,Ivan Holmes,DEM,570102,1,0,1,2,
Osage,Superintendent of Public Instruction,Freda Deskin,DEM,570102,0,0,8,8,
Osage,U.S. Senate,Patrick Michael Hayes,DEM,570102,0,0,1,1,
Osage,U.S. Senate,Jim Rogers,DEM,570102,0,0,5,5,
Osage,U.S. Senate,Connie Johnson,DEM,570102,3,0,7,10,
Osage,Governor,Dax Ewbank,REP,570102,0,3,0,3,
Osage,Governor,Chad Moody,REP,570102,0,0,0,0,
Osage,Governor,Mary Fallin,REP,570102,0,0,34,34,
Osage,Superintendent of Public Instruction,Brian Kelly,REP,570102,0,1,9,10,
Osage,Superintendent of Public Instruction,Janet Costello Barresi,REP,570102,0,0,9,9,
Osage,Superintendent of Public Instruction,Joy Hofmeister,REP,570102,0,2,16,18,
Osage,Insurance Commissioner,Bill Viner,REP,570102,0,3,11,14,
Osage,Insurance Commissioner,John Doak,REP,570102,0,0,21,21,
Osage,Corporation Commissioner,Todd Hiett,REP,570102,0,1,22,23,
Osage,Corporation Commissioner,Cliff Branan,REP,570102,0,2,10,12,
Osage,U.S. Senate,Evelyn Rogers,REP,570102,0,1,0,1,
Osage,U.S. Senate,Rob Moye,REP,570102,0,0,0,0,
Osage,U.S. Senate,D. Jean Mcbride-Samuels,REP,570102,0,0,0,0,
Osage,U.S. Senate,Jim Inhofe,REP,570102,0,1,33,34,
Osage,U.S. Senate,Erick Paul Wyatt,REP,570102,0,1,1,2,
Osage,U.S. Senate,Andy Craig,REP,570102,0,0,1,1,
Osage,U.S. Senate,T. Shannon,REP,570102,0,0,14,14,
Osage,U.S. Senate,Randy Brogdon,REP,570102,0,2,4,6,
Osage,U.S. Senate,Eric Mccray,REP,570102,0,0,0,0,
Osage,U.S. Senate,Kevin Crow,REP,570102,0,0,0,0,
Osage,U.S. Senate,James Lankford,REP,570102,0,1,15,16,
Osage,U.S. Senate,Jason Weger,REP,570102,0,0,0,0,
Osage,U.S. House,Timothy Ray Murray,REP,570102,0,2,4,6,03
Osage,U.S. House,Robert Hubbard,REP,570102,0,1,5,6,03
Osage,U.S. House,Frank Lucas,REP,570102,0,0,24,24,03
Osage,Superintendent of Public Instruction,John Cox,DEM,570103,0,0,20,20,
Osage,Superintendent of Public Instruction,Jack Jr.,DEM,570103,0,0,7,7,
Osage,Superintendent of Public Instruction,Ivan Holmes,DEM,570103,0,0,1,1,
Osage,Superintendent of Public Instruction,Freda Deskin,DEM,570103,0,0,20,20,
Osage,U.S. Senate,Patrick Michael Hayes,DEM,570103,0,0,14,14,
Osage,U.S. Senate,Jim Rogers,DEM,570103,0,0,14,14,
Osage,U.S. Senate,Connie Johnson,DEM,570103,0,0,21,21,
Osage,Governor,Dax Ewbank,REP,570103,0,0,3,3,
Osage,Governor,Chad Moody,REP,570103,0,0,4,4,
Osage,Governor,Mary Fallin,REP,570103,0,0,27,27,
Osage,Superintendent of Public Instruction,Brian Kelly,REP,570103,0,0,5,5,
Osage,Superintendent of Public Instruction,Janet Costello Barresi,REP,570103,0,0,13,13,
Osage,Superintendent of Public Instruction,Joy Hofmeister,REP,570103,0,0,17,17,
Osage,Insurance Commissioner,Bill Viner,REP,570103,0,0,8,8,
Osage,Insurance Commissioner,John Doak,REP,570103,0,0,24,24,
Osage,Corporation Commissioner,Todd Hiett,REP,570103,0,0,15,15,
Osage,Corporation Commissioner,Cliff Branan,REP,570103,0,0,20,20,
Osage,U.S. Senate,Evelyn Rogers,REP,570103,0,0,0,0,
Osage,U.S. Senate,Rob Moye,REP,570103,0,0,0,0,
Osage,U.S. Senate,D. Jean Mcbride-Samuels,REP,570103,0,0,1,1,
Osage,U.S. Senate,Jim Inhofe,REP,570103,0,0,30,30,
Osage,U.S. Senate,Erick Paul Wyatt,REP,570103,0,0,3,3,
Osage,U.S. Senate,Andy Craig,REP,570103,0,0,0,0,
Osage,U.S. Senate,T. Shannon,REP,570103,0,0,23,23,
Osage,U.S. Senate,Randy Brogdon,REP,570103,0,0,0,0,
Osage,U.S. Senate,Eric Mccray,REP,570103,0,0,0,0,
Osage,U.S. Senate,Kevin Crow,REP,570103,0,0,0,0,
Osage,U.S. Senate,James Lankford,REP,570103,0,0,12,12,
Osage,U.S. Senate,Jason Weger,REP,570103,0,0,0,0,
Osage,U.S. House,Timothy Ray Murray,REP,570103,0,0,3,3,03
Osage,U.S. House,Robert Hubbard,REP,570103,0,0,6,6,03
Osage,U.S. House,Frank Lucas,REP,570103,0,0,26,26,03
Osage,Superintendent of Public Instruction,John Cox,DEM,570105,1,0,16,17,
Osage,Superintendent of Public Instruction,Jack Jr.,DEM,570105,2,0,13,15,
Osage,Superintendent of Public Instruction,Ivan Holmes,DEM,570105,0,0,5,5,
Osage,Superintendent of Public Instruction,Freda Deskin,DEM,570105,3,0,23,26,
Osage,U.S. Senate,Patrick Michael Hayes,DEM,570105,2,0,10,12,
Osage,U.S. Senate,Jim Rogers,DEM,570105,2,0,21,23,
Osage,U.S. Senate,Connie Johnson,DEM,570105,2,0,23,25,
Osage,Governor,Dax Ewbank,REP,570105,0,0,3,3,
Osage,Governor,Chad Moody,REP,570105,0,0,9,9,
Osage,Governor,Mary Fallin,REP,570105,6,0,97,103,
Osage,Superintendent of Public Instruction,Brian Kelly,REP,570105,4,0,36,40,
Osage,Superintendent of Public Instruction,Janet Costello Barresi,REP,570105,0,0,16,16,
Osage,Superintendent of Public Instruction,Joy Hofmeister,REP,570105,2,0,55,57,
Osage,Insurance Commissioner,Bill Viner,REP,570105,2,0,27,29,
Osage,Insurance Commissioner,John Doak,REP,570105,4,0,73,77,
Osage,Corporation Commissioner,Todd Hiett,REP,570105,2,0,45,47,
Osage,Corporation Commissioner,Cliff Branan,REP,570105,4,0,53,57,
Osage,U.S. Senate,Evelyn Rogers,REP,570105,0,0,6,6,
Osage,U.S. Senate,Rob Moye,REP,570105,0,0,4,4,
Osage,U.S. Senate,D. Jean Mcbride-Samuels,REP,570105,0,0,1,1,
Osage,U.S. Senate,Jim Inhofe,REP,570105,6,0,97,103,
Osage,U.S. Senate,Erick Paul Wyatt,REP,570105,0,0,1,1,
Osage,U.S. Senate,Andy Craig,REP,570105,0,0,1,1,
Osage,U.S. Senate,T. Shannon,REP,570105,2,0,43,45,
Osage,U.S. Senate,Randy Brogdon,REP,570105,0,0,1,1,
Osage,U.S. Senate,Eric Mccray,REP,570105,1,0,0,1,
Osage,U.S. Senate,Kevin Crow,REP,570105,0,0,1,1,
Osage,U.S. Senate,James Lankford,REP,570105,3,0,60,63,
Osage,U.S. Senate,Jason Weger,REP,570105,0,0,1,1,
Osage,U.S. House,Timothy Ray Murray,REP,570105,0,0,5,5,03
Osage,U.S. House,Robert Hubbard,REP,570105,1,0,15,16,03
Osage,U.S. House,Frank Lucas,REP,570105,5,0,87,92,03
Osage,Superintendent of Public Instruction,John Cox,DEM,570106,0,0,4,4,
Osage,Superintendent of Public Instruction,Jack Jr.,DEM,570106,0,0,0,0,
Osage,Superintendent of Public Instruction,Ivan Holmes,DEM,570106,0,0,0,0,
Osage,Superintendent of Public Instruction,Freda Deskin,DEM,570106,0,0,7,7,
Osage,U.S. Senate,Patrick Michael Hayes,DEM,570106,0,0,0,0,
Osage,U.S. Senate,Jim Rogers,DEM,570106,0,0,4,4,
Osage,U.S. Senate,Connie Johnson,DEM,570106,0,0,7,7,
Osage,Governor,Dax Ewbank,REP,570106,0,0,0,0,
Osage,Governor,Chad Moody,REP,570106,0,0,1,1,
Osage,Governor,Mary Fallin,REP,570106,0,0,3,3,
Osage,Superintendent of Public Instruction,Brian Kelly,REP,570106,0,0,1,1,
Osage,Superintendent of Public Instruction,Janet Costello Barresi,REP,570106,0,0,1,1,
Osage,Superintendent of Public Instruction,Joy Hofmeister,REP,570106,0,0,2,2,
Osage,Insurance Commissioner,Bill Viner,REP,570106,0,0,2,2,
Osage,Insurance Commissioner,John Doak,REP,570106,0,0,1,1,
Osage,Corporation Commissioner,Todd Hiett,REP,570106,0,0,1,1,
Osage,Corporation Commissioner,Cliff Branan,REP,570106,0,0,2,2,
Osage,U.S. Senate,Evelyn Rogers,REP,570106,0,0,0,0,
Osage,U.S. Senate,Rob Moye,REP,570106,0,0,0,0,
Osage,U.S. Senate,D. Jean Mcbride-Samuels,REP,570106,0,0,0,0,
Osage,U.S. Senate,Jim Inhofe,REP,570106,0,0,4,4,
Osage,U.S. Senate,Erick Paul Wyatt,REP,570106,0,0,0,0,
Osage,U.S. Senate,Andy Craig,REP,570106,0,0,0,0,
Osage,U.S. Senate,T. Shannon,REP,570106,0,0,4,4,
Osage,U.S. Senate,Randy Brogdon,REP,570106,0,0,0,0,
Osage,U.S. Senate,Eric Mccray,REP,570106,0,0,0,0,
Osage,U.S. Senate,Kevin Crow,REP,570106,0,0,0,0,
Osage,U.S. Senate,James Lankford,REP,570106,0,0,0,0,
Osage,U.S. Senate,Jason Weger,REP,570106,0,0,0,0,
Osage,U.S. House,Timothy Ray Murray,REP,570106,0,0,0,0,03
Osage,U.S. House,Robert Hubbard,REP,570106,0,0,0,0,03
Osage,U.S. House,Frank Lucas,REP,570106,0,0,3,3,03
Osage,Superintendent of Public Instruction,John Cox,DEM,570107,2,7,75,84,
Osage,Superintendent of Public Instruction,Jack Jr.,DEM,570107,0,6,22,28,
Osage,Superintendent of Public Instruction,Ivan Holmes,DEM,570107,1,1,14,16,
Osage,Superintendent of Public Instruction,Freda Deskin,DEM,570107,2,5,56,63,
Osage,U.S. Senate,Patrick Michael Hayes,DEM,570107,3,5,45,53,
Osage,U.S. Senate,Jim Rogers,DEM,570107,2,5,72,79,
Osage,U.S. Senate,Connie Johnson,DEM,570107,0,9,46,55,
Osage,Governor,Dax Ewbank,REP,570107,0,2,18,20,
Osage,Governor,Chad Moody,REP,570107,1,4,18,23,
Osage,Governor,Mary Fallin,REP,570107,1,12,70,83,
Osage,Superintendent of Public Instruction,Brian Kelly,REP,570107,2,2,17,21,
Osage,Superintendent of Public Instruction,Janet Costello Barresi,REP,570107,0,1,11,12,
Osage,Superintendent of Public Instruction,Joy Hofmeister,REP,570107,0,15,77,92,
Osage,Insurance Commissioner,Bill Viner,REP,570107,0,4,23,27,
Osage,Insurance Commissioner,John Doak,REP,570107,1,12,73,86,
Osage,Corporation Commissioner,Todd Hiett,REP,570107,1,8,53,62,
Osage,Corporation Commissioner,Cliff Branan,REP,570107,1,9,44,54,
Osage,U.S. Senate,Evelyn Rogers,REP,570107,0,0,10,10,
Osage,U.S. Senate,Rob Moye,REP,570107,0,0,1,1,
Osage,U.S. Senate,D. Jean Mcbride-Samuels,REP,570107,0,0,0,0,
Osage,U.S. Senate,Jim Inhofe,REP,570107,2,17,88,107,
Osage,U.S. Senate,Erick Paul Wyatt,REP,570107,0,1,11,12,
Osage,U.S. Senate,Andy Craig,REP,570107,0,0,1,1,
Osage,U.S. Senate,T. Shannon,REP,570107,0,4,39,43,
Osage,U.S. Senate,Randy Brogdon,REP,570107,0,0,2,2,
Osage,U.S. Senate,Eric Mccray,REP,570107,0,0,0,0,
Osage,U.S. Senate,Kevin Crow,REP,570107,0,0,0,0,
Osage,U.S. Senate,James Lankford,REP,570107,2,14,64,80,
Osage,U.S. Senate,Jason Weger,REP,570107,0,0,2,2,
Osage,U.S. House,Timothy Ray Murray,REP,570107,0,0,5,5,03
Osage,U.S. House,Robert Hubbard,REP,570107,1,0,11,12,03
Osage,U.S. House,Frank Lucas,REP,570107,1,18,84,103,03
Osage,Superintendent of Public Instruction,John Cox,DEM,570108,0,1,24,25,
Osage,Superintendent of Public Instruction,Jack Jr.,DEM,570108,0,1,11,12,
Osage,Superintendent of Public Instruction,Ivan Holmes,DEM,570108,0,0,9,9,
Osage,Superintendent of Public Instruction,Freda Deskin,DEM,570108,2,1,31,34,
Osage,U.S. Senate,Patrick Michael Hayes,DEM,570108,0,2,11,13,
Osage,U.S. Senate,Jim Rogers,DEM,570108,0,1,25,26,
Osage,U.S. Senate,Connie Johnson,DEM,570108,2,0,38,40,
Osage,Governor,Dax Ewbank,REP,570108,0,0,6,6,
Osage,Governor,Chad Moody,REP,570108,0,1,5,6,
Osage,Governor,Mary Fallin,REP,570108,1,0,31,32,
Osage,Superintendent of Public Instruction,Brian Kelly,REP,570108,1,0,11,12,
Osage,Superintendent of Public Instruction,Janet Costello Barresi,REP,570108,0,0,9,9,
Osage,Superintendent of Public Instruction,Joy Hofmeister,REP,570108,0,1,22,23,
Osage,Insurance Commissioner,Bill Viner,REP,570108,0,1,9,10,
Osage,Insurance Commissioner,John Doak,REP,570108,0,0,27,27,
Osage,Corporation Commissioner,Todd Hiett,REP,570108,0,0,15,15,
Osage,Corporation Commissioner,Cliff Branan,REP,570108,0,1,25,26,
Osage,U.S. Senate,Evelyn Rogers,REP,570108,0,0,2,2,
Osage,U.S. Senate,Rob Moye,REP,570108,0,0,0,0,
Osage,U.S. Senate,D. Jean Mcbride-Samuels,REP,570108,0,0,0,0,
Osage,U.S. Senate,Jim Inhofe,REP,570108,1,1,38,40,
Osage,U.S. Senate,Erick Paul Wyatt,REP,570108,0,0,2,2,
Osage,U.S. Senate,Andy Craig,REP,570108,0,0,0,0,
Osage,U.S. Senate,T. Shannon,REP,570108,0,1,12,13,
Osage,U.S. Senate,Randy Brogdon,REP,570108,0,0,4,4,
Osage,U.S. Senate,Eric Mccray,REP,570108,0,0,0,0,
Osage,U.S. Senate,Kevin Crow,REP,570108,0,0,0,0,
Osage,U.S. Senate,James Lankford,REP,570108,1,0,25,26,
Osage,U.S. Senate,Jason Weger,REP,570108,0,0,1,1,
Osage,U.S. House,Timothy Ray Murray,REP,570108,0,1,3,4,03
Osage,U.S. House,Robert Hubbard,REP,570108,0,0,3,3,03
Osage,U.S. House,Frank Lucas,REP,570108,1,0,33,34,03
Osage,Superintendent of Public Instruction,John Cox,DEM,570109,2,0,20,22,
Osage,Superintendent of Public Instruction,Jack Jr.,DEM,570109,0,0,4,4,
Osage,Superintendent of Public Instruction,Ivan Holmes,DEM,570109,0,1,0,1,
Osage,Superintendent of Public Instruction,Freda Deskin,DEM,570109,1,0,22,23,
Osage,U.S. Senate,Patrick Michael Hayes,DEM,570109,1,1,7,9,
Osage,U.S. Senate,Jim Rogers,DEM,570109,2,0,14,16,
Osage,U.S. Senate,Connie Johnson,DEM,570109,0,0,24,24,
Osage,Governor,Dax Ewbank,REP,570109,0,0,12,12,
Osage,Governor,Chad Moody,REP,570109,0,0,23,23,
Osage,Governor,Mary Fallin,REP,570109,3,0,123,126,
Osage,Superintendent of Public Instruction,Brian Kelly,REP,570109,0,0,28,28,
Osage,Superintendent of Public Instruction,Janet Costello Barresi,REP,570109,0,0,34,34,
Osage,Superintendent of Public Instruction,Joy Hofmeister,REP,570109,3,0,95,98,
Osage,Insurance Commissioner,Bill Viner,REP,570109,1,0,34,35,
Osage,Insurance Commissioner,John Doak,REP,570109,1,0,105,106,
Osage,Corporation Commissioner,Todd Hiett,REP,570109,1,0,79,80,
Osage,Corporation Commissioner,Cliff Branan,REP,570109,1,0,67,68,
Osage,U.S. Senate,Evelyn Rogers,REP,570109,1,0,10,11,
Osage,U.S. Senate,Rob Moye,REP,570109,0,0,4,4,
Osage,U.S. Senate,D. Jean Mcbride-Samuels,REP,570109,0,0,3,3,
Osage,U.S. Senate,Jim Inhofe,REP,570109,2,0,136,138,
Osage,U.S. Senate,Erick Paul Wyatt,REP,570109,0,0,4,4,
Osage,U.S. Senate,Andy Craig,REP,570109,1,0,0,1,
Osage,U.S. Senate,T. Shannon,REP,570109,1,0,87,88,
Osage,U.S. Senate,Randy Brogdon,REP,570109,1,0,7,8,
Osage,U.S. Senate,Eric Mccray,REP,570109,0,0,3,3,
Osage,U.S. Senate,Kevin Crow,REP,570109,0,0,2,2,
Osage,U.S. Senate,James Lankford,REP,570109,0,0,60,60,
Osage,U.S. Senate,Jason Weger,REP,570109,0,0,0,0,
Osage,U.S. House,Timothy Ray Murray,REP,570109,0,0,13,13,03
Osage,U.S. House,Robert Hubbard,REP,570109,1,0,26,27,03
Osage,U.S. House,Frank Lucas,REP,570109,2,0,112,114,03
Osage,State House,Randy Barnett,REP,570109,1,0,49,50,10
Osage,State House,Travis Dunlap,REP,570109,2,0,104,106,10
Osage,Superintendent of Public Instruction,John Cox,DEM,570110,1,0,66,67,
Osage,Superintendent of Public Instruction,Jack Jr.,DEM,570110,0,1,7,8,
Osage,Superintendent of Public Instruction,Ivan Holmes,DEM,570110,0,0,3,3,
Osage,Superintendent of Public Instruction,Freda Deskin,DEM,570110,5,0,23,28,
Osage,U.S. Senate,Patrick Michael Hayes,DEM,570110,2,0,17,19,
Osage,U.S. Senate,Jim Rogers,DEM,570110,1,0,55,56,
Osage,U.S. Senate,Connie Johnson,DEM,570110,1,1,26,28,
Osage,Governor,Dax Ewbank,REP,570110,0,0,10,10,
Osage,Governor,Chad Moody,REP,570110,1,0,11,12,
Osage,Governor,Mary Fallin,REP,570110,3,0,94,97,
Osage,Superintendent of Public Instruction,Brian Kelly,REP,570110,3,0,22,25,
Osage,Superintendent of Public Instruction,Janet Costello Barresi,REP,570110,0,0,12,12,
Osage,Superintendent of Public Instruction,Joy Hofmeister,REP,570110,1,0,80,81,
Osage,Insurance Commissioner,Bill Viner,REP,570110,1,0,32,33,
Osage,Insurance Commissioner,John Doak,REP,570110,3,0,77,80,
Osage,Corporation Commissioner,Todd Hiett,REP,570110,1,0,60,61,
Osage,Corporation Commissioner,Cliff Branan,REP,570110,3,0,52,55,
Osage,U.S. Senate,Evelyn Rogers,REP,570110,0,0,3,3,
Osage,U.S. Senate,Rob Moye,REP,570110,0,0,1,1,
Osage,U.S. Senate,D. Jean Mcbride-Samuels,REP,570110,0,0,2,2,
Osage,U.S. Senate,Jim Inhofe,REP,570110,4,0,105,109,
Osage,U.S. Senate,Erick Paul Wyatt,REP,570110,0,0,4,4,
Osage,U.S. Senate,Andy Craig,REP,570110,1,0,1,2,
Osage,U.S. Senate,T. Shannon,REP,570110,2,0,54,56,
Osage,U.S. Senate,Randy Brogdon,REP,570110,0,0,3,3,
Osage,U.S. Senate,Eric Mccray,REP,570110,0,0,1,1,
Osage,U.S. Senate,Kevin Crow,REP,570110,0,0,0,0,
Osage,U.S. Senate,James Lankford,REP,570110,1,0,54,55,
Osage,U.S. Senate,Jason Weger,REP,570110,0,0,1,1,
Osage,U.S. House,Timothy Ray Murray,REP,570110,1,0,6,7,03
Osage,U.S. House,Robert Hubbard,REP,570110,0,0,15,15,03
Osage,U.S. House,Frank Lucas,REP,570110,3,0,94,97,03
Osage,Superintendent of Public Instruction,John Cox,DEM,570111,0,0,17,17,
Osage,Superintendent of Public Instruction,Jack Jr.,DEM,570111,0,1,2,3,
Osage,Superintendent of Public Instruction,Ivan Holmes,DEM,570111,0,0,1,1,
Osage,Superintendent of Public Instruction,Freda Deskin,DEM,570111,0,0,9,9,
Osage,U.S. Senate,Patrick Michael Hayes,DEM,570111,0,0,8,8,
Osage,U.S. Senate,Jim Rogers,DEM,570111,0,1,6,7,
Osage,U.S. Senate,Connie Johnson,DEM,570111,0,0,13,13,
Osage,Governor,Dax Ewbank,REP,570111,0,1,2,3,
Osage,Governor,Chad Moody,REP,570111,0,0,5,5,
Osage,Governor,Mary Fallin,REP,570111,3,0,27,30,
Osage,Superintendent of Public Instruction,Brian Kelly,REP,570111,0,0,11,11,
Osage,Superintendent of Public Instruction,Janet Costello Barresi,REP,570111,0,0,7,7,
Osage,Superintendent of Public Instruction,Joy Hofmeister,REP,570111,3,1,17,21,
Osage,Insurance Commissioner,Bill Viner,REP,570111,0,0,13,13,
Osage,Insurance Commissioner,John Doak,REP,570111,3,1,19,23,
Osage,Corporation Commissioner,Todd Hiett,REP,570111,2,0,14,16,
Osage,Corporation Commissioner,Cliff Branan,REP,570111,1,1,18,20,
Osage,U.S. Senate,Evelyn Rogers,REP,570111,0,0,2,2,
Osage,U.S. Senate,Rob Moye,REP,570111,0,0,0,0,
Osage,U.S. Senate,D. Jean Mcbride-Samuels,REP,570111,0,0,1,1,
Osage,U.S. Senate,Jim Inhofe,REP,570111,3,1,31,35,
Osage,U.S. Senate,Erick Paul Wyatt,REP,570111,0,0,1,1,
Osage,U.S. Senate,Andy Craig,REP,570111,0,0,0,0,
Osage,U.S. Senate,T. Shannon,REP,570111,0,0,16,16,
Osage,U.S. Senate,Randy Brogdon,REP,570111,0,1,1,2,
Osage,U.S. Senate,Eric Mccray,REP,570111,0,0,0,0,
Osage,U.S. Senate,Kevin Crow,REP,570111,0,0,0,0,
Osage,U.S. Senate,James Lankford,REP,570111,3,0,16,19,
Osage,U.S. Senate,Jason Weger,REP,570111,0,0,1,1,
Osage,U.S. House,Timothy Ray Murray,REP,570111,0,0,5,5,03
Osage,U.S. House,Robert Hubbard,REP,570111,0,0,2,2,03
Osage,U.S. House,Frank Lucas,REP,570111,3,1,28,32,03
Osage,Superintendent of Public Instruction,John Cox,DEM,570112,3,0,25,28,
Osage,Superintendent of Public Instruction,Jack Jr.,DEM,570112,0,0,7,7,
Osage,Superintendent of Public Instruction,Ivan Holmes,DEM,570112,0,0,1,1,
Osage,Superintendent of Public Instruction,Freda Deskin,DEM,570112,0,0,12,12,
Osage,U.S. Senate,Patrick Michael Hayes,DEM,570112,3,0,12,15,
Osage,U.S. Senate,Jim Rogers,DEM,570112,0,0,25,25,
Osage,U.S. Senate,Connie Johnson,DEM,570112,0,0,7,7,
Osage,Governor,Dax Ewbank,REP,570112,0,0,12,12,
Osage,Governor,Chad Moody,REP,570112,2,0,10,12,
Osage,Governor,Mary Fallin,REP,570112,4,0,34,38,
Osage,Superintendent of Public Instruction,Brian Kelly,REP,570112,0,0,9,9,
Osage,Superintendent of Public Instruction,Janet Costello Barresi,REP,570112,4,0,6,10,
Osage,Superintendent of Public Instruction,Joy Hofmeister,REP,570112,2,0,42,44,
Osage,Insurance Commissioner,Bill Viner,REP,570112,1,0,12,13,
Osage,Insurance Commissioner,John Doak,REP,570112,5,0,43,48,
Osage,Corporation Commissioner,Todd Hiett,REP,570112,6,0,34,40,
Osage,Corporation Commissioner,Cliff Branan,REP,570112,0,0,20,20,
Osage,U.S. Senate,Evelyn Rogers,REP,570112,1,0,0,1,
Osage,U.S. Senate,Rob Moye,REP,570112,0,0,0,0,
Osage,U.S. Senate,D. Jean Mcbride-Samuels,REP,570112,0,0,1,1,
Osage,U.S. Senate,Jim Inhofe,REP,570112,4,0,51,55,
Osage,U.S. Senate,Erick Paul Wyatt,REP,570112,1,0,4,5,
Osage,U.S. Senate,Andy Craig,REP,570112,0,0,1,1,
Osage,U.S. Senate,T. Shannon,REP,570112,6,0,29,35,
Osage,U.S. Senate,Randy Brogdon,REP,570112,0,0,9,9,
Osage,U.S. Senate,Eric Mccray,REP,570112,0,0,0,0,
Osage,U.S. Senate,Kevin Crow,REP,570112,0,0,0,0,
Osage,U.S. Senate,James Lankford,REP,570112,0,0,18,18,
Osage,U.S. Senate,Jason Weger,REP,570112,0,0,1,1,
Osage,U.S. House,Timothy Ray Murray,REP,570112,0,0,6,6,03
Osage,U.S. House,Robert Hubbard,REP,570112,0,0,9,9,03
Osage,U.S. House,Frank Lucas,REP,570112,6,0,39,45,03
Osage,Superintendent of Public Instruction,John Cox,DEM,570113,0,1,6,7,
Osage,Superintendent of Public Instruction,Jack Jr.,DEM,570113,0,0,2,2,
Osage,Superintendent of Public Instruction,Ivan Holmes,DEM,570113,0,0,0,0,
Osage,Superintendent of Public Instruction,Freda Deskin,DEM,570113,0,0,8,8,
Osage,U.S. Senate,Patrick Michael Hayes,DEM,570113,0,0,2,2,
Osage,U.S. Senate,Jim Rogers,DEM,570113,0,1,9,10,
Osage,U.S. Senate,Connie Johnson,DEM,570113,0,0,6,6,
Osage,Governor,Dax Ewbank,REP,570113,0,0,1,1,
Osage,Governor,Chad Moody,REP,570113,0,0,2,2,
Osage,Governor,Mary Fallin,REP,570113,0,0,4,4,
Osage,Superintendent of Public Instruction,Brian Kelly,REP,570113,0,0,2,2,
Osage,Superintendent of Public Instruction,Janet Costello Barresi,REP,570113,0,0,1,1,
Osage,Superintendent of Public Instruction,Joy Hofmeister,REP,570113,0,0,4,4,
Osage,Insurance Commissioner,Bill Viner,REP,570113,0,0,3,3,
Osage,Insurance Commissioner,John Doak,REP,570113,0,0,4,4,
Osage,Corporation Commissioner,Todd Hiett,REP,570113,0,0,3,3,
Osage,Corporation Commissioner,Cliff Branan,REP,570113,0,0,4,4,
Osage,U.S. Senate,Evelyn Rogers,REP,570113,0,0,0,0,
Osage,U.S. Senate,Rob Moye,REP,570113,0,0,0,0,
Osage,U.S. Senate,D. Jean Mcbride-Samuels,REP,570113,0,0,0,0,
Osage,U.S. Senate,Jim Inhofe,REP,570113,0,0,7,7,
Osage,U.S. Senate,Erick Paul Wyatt,REP,570113,0,0,0,0,
Osage,U.S. Senate,Andy Craig,REP,570113,0,0,1,1,
Osage,U.S. Senate,T. Shannon,REP,570113,0,0,5,5,
Osage,U.S. Senate,Randy Brogdon,REP,570113,0,0,0,0,
Osage,U.S. Senate,Eric Mccray,REP,570113,0,0,0,0,
Osage,U.S. Senate,Kevin Crow,REP,570113,0,0,0,0,
Osage,U.S. Senate,James Lankford,REP,570113,0,0,1,1,
Osage,U.S. Senate,Jason Weger,REP,570113,0,0,0,0,
Osage,U.S. House,Timothy Ray Murray,REP,570113,0,0,0,0,03
Osage,U.S. House,Robert Hubbard,REP,570113,0,0,1,1,03
Osage,U.S. House,Frank Lucas,REP,570113,0,0,6,6,03
Osage,Superintendent of Public Instruction,John Cox,DEM,570201,2,1,94,97,
Osage,Superintendent of Public Instruction,Jack Jr.,DEM,570201,1,0,22,23,
Osage,Superintendent of Public Instruction,Ivan Holmes,DEM,570201,0,0,8,8,
Osage,Superintendent of Public Instruction,Freda Deskin,DEM,570201,5,0,53,58,
Osage,U.S. Senate,Patrick Michael Hayes,DEM,570201,1,0,36,37,
Osage,U.S. Senate,Jim Rogers,DEM,570201,2,1,63,66,
Osage,U.S. Senate,Connie Johnson,DEM,570201,5,0,70,75,
Osage,Governor,Dax Ewbank,REP,570201,5,0,43,48,
Osage,Governor,Chad Moody,REP,570201,1,2,63,66,
Osage,Governor,Mary Fallin,REP,570201,7,2,284,293,
Osage,Superintendent of Public Instruction,Brian Kelly,REP,570201,4,0,84,88,
Osage,Superintendent of Public Instruction,Janet Costello Barresi,REP,570201,2,0,53,55,
Osage,Superintendent of Public Instruction,Joy Hofmeister,REP,570201,7,4,258,269,
Osage,Insurance Commissioner,Bill Viner,REP,570201,4,2,110,116,
Osage,Insurance Commissioner,John Doak,REP,570201,9,2,252,263,
Osage,Corporation Commissioner,Todd Hiett,REP,570201,11,2,186,199,
Osage,Corporation Commissioner,Cliff Branan,REP,570201,2,2,176,180,
Osage,U.S. Senate,Evelyn Rogers,REP,570201,4,0,20,24,
Osage,U.S. Senate,Rob Moye,REP,570201,0,0,12,12,
Osage,U.S. Senate,D. Jean Mcbride-Samuels,REP,570201,0,0,6,6,
Osage,U.S. Senate,Jim Inhofe,REP,570201,8,4,341,353,
Osage,U.S. Senate,Erick Paul Wyatt,REP,570201,1,0,18,19,
Osage,U.S. Senate,Andy Craig,REP,570201,0,0,4,4,
Osage,U.S. Senate,T. Shannon,REP,570201,9,4,163,176,
Osage,U.S. Senate,Randy Brogdon,REP,570201,2,0,39,41,
Osage,U.S. Senate,Eric Mccray,REP,570201,0,0,5,5,
Osage,U.S. Senate,Kevin Crow,REP,570201,0,0,6,6,
Osage,U.S. Senate,James Lankford,REP,570201,3,0,178,181,
Osage,U.S. Senate,Jason Weger,REP,570201,0,0,3,3,
Osage,U.S. House,Timothy Ray Murray,REP,570201,0,1,28,29,03
Osage,U.S. House,Robert Hubbard,REP,570201,5,0,78,83,03
Osage,U.S. House,Frank Lucas,REP,570201,8,3,275,286,03
Osage,Superintendent of Public Instruction,John Cox,DEM,570202,6,0,143,149,
Osage,Superintendent of Public Instruction,Jack Jr.,DEM,570202,6,0,58,64,
Osage,Superintendent of Public Instruction,Ivan Holmes,DEM,570202,4,0,38,42,
Osage,Superintendent of Public Instruction,Freda Deskin,DEM,570202,16,0,219,235,
Osage,U.S. Senate,Patrick Michael Hayes,DEM,570202,1,0,68,69,
Osage,U.S. Senate,Jim Rogers,DEM,570202,6,0,42,48,
Osage,U.S. Senate,Connie Johnson,DEM,570202,26,0,348,374,
Osage,Governor,Dax Ewbank,REP,570202,0,0,5,5,
Osage,Governor,Chad Moody,REP,570202,2,0,6,8,
Osage,Governor,Mary Fallin,REP,570202,9,0,40,49,
Osage,Superintendent of Public Instruction,Brian Kelly,REP,570202,3,0,4,7,
Osage,Superintendent of Public Instruction,Janet Costello Barresi,REP,570202,3,0,11,14,
Osage,Superintendent of Public Instruction,Joy Hofmeister,REP,570202,7,0,39,46,
Osage,Insurance Commissioner,Bill Viner,REP,570202,3,0,12,15,
Osage,Insurance Commissioner,John Doak,REP,570202,8,0,36,44,
Osage,Corporation Commissioner,Todd Hiett,REP,570202,7,0,24,31,
Osage,Corporation Commissioner,Cliff Branan,REP,570202,5,0,21,26,
Osage,U.S. Senate,Evelyn Rogers,REP,570202,0,0,5,5,
Osage,U.S. Senate,Rob Moye,REP,570202,1,0,0,1,
Osage,U.S. Senate,D. Jean Mcbride-Samuels,REP,570202,2,0,1,3,
Osage,U.S. Senate,Jim Inhofe,REP,570202,9,0,42,51,
Osage,U.S. Senate,Erick Paul Wyatt,REP,570202,0,0,3,3,
Osage,U.S. Senate,Andy Craig,REP,570202,1,0,0,1,
Osage,U.S. Senate,T. Shannon,REP,570202,5,0,31,36,
Osage,U.S. Senate,Randy Brogdon,REP,570202,0,0,3,3,
Osage,U.S. Senate,Eric Mccray,REP,570202,0,0,0,0,
Osage,U.S. Senate,Kevin Crow,REP,570202,0,0,2,2,
Osage,U.S. Senate,James Lankford,REP,570202,6,0,17,23,
Osage,U.S. Senate,Jason Weger,REP,570202,0,0,0,0,
Osage,U.S. House,Timothy Ray Murray,REP,570202,1,0,5,6,03
Osage,U.S. House,Robert Hubbard,REP,570202,0,0,6,6,03
Osage,U.S. House,Frank Lucas,REP,570202,12,0,35,47,03
Osage,Superintendent of Public Instruction,John Cox,DEM,570203,4,0,86,90,
Osage,Superintendent of Public Instruction,Jack Jr.,DEM,570203,1,0,19,20,
Osage,Superintendent of Public Instruction,Ivan Holmes,DEM,570203,0,0,3,3,
Osage,Superintendent of Public Instruction,Freda Deskin,DEM,570203,0,0,91,91,
Osage,U.S. Senate,Patrick Michael Hayes,DEM,570203,0,0,51,51,
Osage,U.S. Senate,Jim Rogers,DEM,570203,3,0,81,84,
Osage,U.S. Senate,Connie Johnson,DEM,570203,2,0,60,62,
Osage,Governor,Dax Ewbank,REP,570203,1,0,44,45,
Osage,Governor,Chad Moody,REP,570203,0,0,68,68,
Osage,Governor,Mary Fallin,REP,570203,9,1,332,342,
Osage,Superintendent of Public Instruction,Brian Kelly,REP,570203,1,0,91,92,
Osage,Superintendent of Public Instruction,Janet Costello Barresi,REP,570203,3,0,67,70,
Osage,Superintendent of Public Instruction,Joy Hofmeister,REP,570203,5,1,291,297,
Osage,Insurance Commissioner,Bill Viner,REP,570203,0,0,104,104,
Osage,Insurance Commissioner,John Doak,REP,570203,8,1,316,325,
Osage,Corporation Commissioner,Todd Hiett,REP,570203,4,1,232,237,
Osage,Corporation Commissioner,Cliff Branan,REP,570203,4,0,193,197,
Osage,U.S. Senate,Evelyn Rogers,REP,570203,0,0,17,17,
Osage,U.S. Senate,Rob Moye,REP,570203,0,0,7,7,
Osage,U.S. Senate,D. Jean Mcbride-Samuels,REP,570203,0,0,5,5,
Osage,U.S. Senate,Jim Inhofe,REP,570203,8,1,401,410,
Osage,U.S. Senate,Erick Paul Wyatt,REP,570203,1,0,16,17,
Osage,U.S. Senate,Andy Craig,REP,570203,0,0,2,2,
Osage,U.S. Senate,T. Shannon,REP,570203,4,1,200,205,
Osage,U.S. Senate,Randy Brogdon,REP,570203,1,0,55,56,
Osage,U.S. Senate,Eric Mccray,REP,570203,0,0,5,5,
Osage,U.S. Senate,Kevin Crow,REP,570203,0,0,2,2,
Osage,U.S. Senate,James Lankford,REP,570203,5,0,183,188,
Osage,U.S. Senate,Jason Weger,REP,570203,0,0,3,3,
Osage,U.S. House,Timothy Ray Murray,REP,570203,2,0,36,38,03
Osage,U.S. House,Robert Hubbard,REP,570203,3,0,75,78,03
Osage,U.S. House,Frank Lucas,REP,570203,4,1,315,320,03
Osage,Superintendent of Public Instruction,John Cox,DEM,570204,2,0,23,25,
Osage,Superintendent of Public Instruction,Jack Jr.,DEM,570204,0,0,4,4,
Osage,Superintendent of Public Instruction,Ivan Holmes,DEM,570204,0,0,3,3,
Osage,Superintendent of Public Instruction,Freda Deskin,DEM,570204,0,1,23,24,
Osage,U.S. Senate,Patrick Michael Hayes,DEM,570204,0,0,9,9,
Osage,U.S. Senate,Jim Rogers,DEM,570204,2,1,21,24,
Osage,U.S. Senate,Connie Johnson,DEM,570204,0,0,22,22,
Osage,Governor,Dax Ewbank,REP,570204,0,1,5,6,
Osage,Governor,Chad Moody,REP,570204,0,0,10,10,
Osage,Governor,Mary Fallin,REP,570204,3,0,71,74,
Osage,Superintendent of Public Instruction,Brian Kelly,REP,570204,0,0,14,14,
Osage,Superintendent of Public Instruction,Janet Costello Barresi,REP,570204,3,0,17,20,
Osage,Superintendent of Public Instruction,Joy Hofmeister,REP,570204,0,1,57,58,
Osage,Insurance Commissioner,Bill Viner,REP,570204,1,0,21,22,
Osage,Insurance Commissioner,John Doak,REP,570204,2,1,58,61,
Osage,Corporation Commissioner,Todd Hiett,REP,570204,3,1,44,48,
Osage,Corporation Commissioner,Cliff Branan,REP,570204,0,0,37,37,
Osage,U.S. Senate,Evelyn Rogers,REP,570204,0,0,5,5,
Osage,U.S. Senate,Rob Moye,REP,570204,0,0,1,1,
Osage,U.S. Senate,D. Jean Mcbride-Samuels,REP,570204,0,0,1,1,
Osage,U.S. Senate,Jim Inhofe,REP,570204,3,1,78,82,
Osage,U.S. Senate,Erick Paul Wyatt,REP,570204,0,0,2,2,
Osage,U.S. Senate,Andy Craig,REP,570204,0,0,1,1,
Osage,U.S. Senate,T. Shannon,REP,570204,2,0,44,46,
Osage,U.S. Senate,Randy Brogdon,REP,570204,0,0,8,8,
Osage,U.S. Senate,Eric Mccray,REP,570204,0,0,0,0,
Osage,U.S. Senate,Kevin Crow,REP,570204,0,0,1,1,
Osage,U.S. Senate,James Lankford,REP,570204,1,1,33,35,
Osage,U.S. Senate,Jason Weger,REP,570204,0,0,0,0,
Osage,U.S. House,Timothy Ray Murray,REP,570204,0,0,6,6,03
Osage,U.S. House,Robert Hubbard,REP,570204,0,0,7,7,03
Osage,U.S. House,Frank Lucas,REP,570204,3,1,69,73,03
Osage,Superintendent of Public Instruction,John Cox,DEM,570205,1,0,2,3,
Osage,Superintendent of Public Instruction,Jack Jr.,DEM,570205,0,0,5,5,
Osage,Superintendent of Public Instruction,Ivan Holmes,DEM,570205,0,0,0,0,
Osage,Superintendent of Public Instruction,Freda Deskin,DEM,570205,0,0,8,8,
Osage,U.S. Senate,Patrick Michael Hayes,DEM,570205,0,0,2,2,
Osage,U.S. Senate,Jim Rogers,DEM,570205,1,0,1,2,
Osage,U.S. Senate,Connie Johnson,DEM,570205,0,0,12,12,
Osage,Governor,Dax Ewbank,REP,570205,0,1,3,4,
Osage,Governor,Chad Moody,REP,570205,0,0,3,3,
Osage,Governor,Mary Fallin,REP,570205,2,0,21,23,
Osage,Superintendent of Public Instruction,Brian Kelly,REP,570205,0,0,6,6,
Osage,Superintendent of Public Instruction,Janet Costello Barresi,REP,570205,0,0,1,1,
Osage,Superintendent of Public Instruction,Joy Hofmeister,REP,570205,2,1,21,24,
Osage,Insurance Commissioner,Bill Viner,REP,570205,0,0,7,7,
Osage,Insurance Commissioner,John Doak,REP,570205,2,1,22,25,
Osage,Corporation Commissioner,Todd Hiett,REP,570205,2,0,18,20,
Osage,Corporation Commissioner,Cliff Branan,REP,570205,0,1,8,9,
Osage,U.S. Senate,Evelyn Rogers,REP,570205,0,0,0,0,
Osage,U.S. Senate,Rob Moye,REP,570205,0,0,0,0,
Osage,U.S. Senate,D. Jean Mcbride-Samuels,REP,570205,0,0,1,1,
Osage,U.S. Senate,Jim Inhofe,REP,570205,2,1,24,27,
Osage,U.S. Senate,Erick Paul Wyatt,REP,570205,0,0,4,4,
Osage,U.S. Senate,Andy Craig,REP,570205,0,0,1,1,
Osage,U.S. Senate,T. Shannon,REP,570205,0,0,10,10,
Osage,U.S. Senate,Randy Brogdon,REP,570205,0,0,4,4,
Osage,U.S. Senate,Eric Mccray,REP,570205,0,0,0,0,
Osage,U.S. Senate,Kevin Crow,REP,570205,0,0,1,1,
Osage,U.S. Senate,James Lankford,REP,570205,2,1,12,15,
Osage,U.S. Senate,Jason Weger,REP,570205,0,0,1,1,
Osage,U.S. House,Timothy Ray Murray,REP,570205,0,0,2,2,03
Osage,U.S. House,Robert Hubbard,REP,570205,0,0,1,1,03
Osage,U.S. House,Frank Lucas,REP,570205,2,1,25,28,03
Osage,Superintendent of Public Instruction,John Cox,DEM,570301,2,0,36,38,
Osage,Superintendent of Public Instruction,Jack Jr.,DEM,570301,3,0,11,14,
Osage,Superintendent of Public Instruction,Ivan Holmes,DEM,570301,0,0,6,6,
Osage,Superintendent of Public Instruction,Freda Deskin,DEM,570301,1,1,45,47,
Osage,U.S. Senate,Patrick Michael Hayes,DEM,570301,1,0,13,14,
Osage,U.S. Senate,Jim Rogers,DEM,570301,0,1,48,49,
Osage,U.S. Senate,Connie Johnson,DEM,570301,4,0,35,39,
Osage,Governor,Dax Ewbank,REP,570301,0,0,9,9,
Osage,Governor,Chad Moody,REP,570301,0,1,7,8,
Osage,Governor,Mary Fallin,REP,570301,2,1,37,40,
Osage,Superintendent of Public Instruction,Brian Kelly,REP,570301,0,1,9,10,
Osage,Superintendent of Public Instruction,Janet Costello Barresi,REP,570301,1,1,9,11,
Osage,Superintendent of Public Instruction,Joy Hofmeister,REP,570301,1,0,33,34,
Osage,Insurance Commissioner,Bill Viner,REP,570301,1,0,14,15,
Osage,Insurance Commissioner,John Doak,REP,570301,1,2,37,40,
Osage,Corporation Commissioner,Todd Hiett,REP,570301,2,2,34,38,
Osage,Corporation Commissioner,Cliff Branan,REP,570301,0,0,15,15,
Osage,U.S. Senate,Evelyn Rogers,REP,570301,0,0,1,1,
Osage,U.S. Senate,Rob Moye,REP,570301,0,0,2,2,
Osage,U.S. Senate,D. Jean Mcbride-Samuels,REP,570301,0,0,1,1,
Osage,U.S. Senate,Jim Inhofe,REP,570301,2,2,41,45,
Osage,U.S. Senate,Erick Paul Wyatt,REP,570301,0,0,8,8,
Osage,U.S. Senate,Andy Craig,REP,570301,0,0,1,1,
Osage,U.S. Senate,T. Shannon,REP,570301,1,1,37,39,
Osage,U.S. Senate,Randy Brogdon,REP,570301,0,0,0,0,
Osage,U.S. Senate,Eric Mccray,REP,570301,0,0,1,1,
Osage,U.S. Senate,Kevin Crow,REP,570301,0,0,0,0,
Osage,U.S. Senate,James Lankford,REP,570301,0,1,14,15,
Osage,U.S. Senate,Jason Weger,REP,570301,1,0,0,1,
Osage,U.S. House,Timothy Ray Murray,REP,570301,0,1,8,9,03
Osage,U.S. House,Robert Hubbard,REP,570301,0,0,7,7,03
Osage,U.S. House,Frank Lucas,REP,570301,2,1,37,40,03
Osage,Superintendent of Public Instruction,John Cox,DEM,570302,1,0,8,9,
Osage,Superintendent of Public Instruction,Jack Jr.,DEM,570302,0,0,3,3,
Osage,Superintendent of Public Instruction,Ivan Holmes,DEM,570302,0,0,2,2,
Osage,Superintendent of Public Instruction,Freda Deskin,DEM,570302,0,0,5,5,
Osage,U.S. Senate,Patrick Michael Hayes,DEM,570302,0,0,5,5,
Osage,U.S. Senate,Jim Rogers,DEM,570302,1,0,9,10,
Osage,U.S. Senate,Connie Johnson,DEM,570302,0,0,3,3,
Osage,Governor,Dax Ewbank,REP,570302,2,0,1,3,
Osage,Governor,Chad Moody,REP,570302,0,0,2,2,
Osage,Governor,Mary Fallin,REP,570302,1,0,14,15,
Osage,Superintendent of Public Instruction,Brian Kelly,REP,570302,0,0,1,1,
Osage,Superintendent of Public Instruction,Janet Costello Barresi,REP,570302,0,0,4,4,
Osage,Superintendent of Public Instruction,Joy Hofmeister,REP,570302,3,0,12,15,
Osage,Insurance Commissioner,Bill Viner,REP,570302,2,0,2,4,
Osage,Insurance Commissioner,John Doak,REP,570302,1,0,14,15,
Osage,Corporation Commissioner,Todd Hiett,REP,570302,1,0,9,10,
Osage,Corporation Commissioner,Cliff Branan,REP,570302,2,0,8,10,
Osage,U.S. Senate,Evelyn Rogers,REP,570302,2,0,0,2,
Osage,U.S. Senate,Rob Moye,REP,570302,0,0,0,0,
Osage,U.S. Senate,D. Jean Mcbride-Samuels,REP,570302,0,0,0,0,
Osage,U.S. Senate,Jim Inhofe,REP,570302,1,0,17,18,
Osage,U.S. Senate,Erick Paul Wyatt,REP,570302,0,0,0,0,
Osage,U.S. Senate,Andy Craig,REP,570302,1,0,0,1,
Osage,U.S. Senate,T. Shannon,REP,570302,0,0,6,6,
Osage,U.S. Senate,Randy Brogdon,REP,570302,0,0,0,0,
Osage,U.S. Senate,Eric Mccray,REP,570302,0,0,0,0,
Osage,U.S. Senate,Kevin Crow,REP,570302,0,0,0,0,
Osage,U.S. Senate,James Lankford,REP,570302,2,0,11,13,
Osage,U.S. Senate,Jason Weger,REP,570302,0,0,0,0,
Osage,U.S. House,Timothy Ray Murray,REP,570302,1,0,0,1,03
Osage,U.S. House,Robert Hubbard,REP,570302,0,0,4,4,03
Osage,U.S. House,Frank Lucas,REP,570302,2,0,13,15,03
Osage,Superintendent of Public Instruction,John Cox,DEM,570303,0,0,9,9,
Osage,Superintendent of Public Instruction,Jack Jr.,DEM,570303,0,0,2,2,
Osage,Superintendent of Public Instruction,Ivan Holmes,DEM,570303,2,0,2,4,
Osage,Superintendent of Public Instruction,Freda Deskin,DEM,570303,0,0,3,3,
Osage,U.S. Senate,Patrick Michael Hayes,DEM,570303,0,0,5,5,
Osage,U.S. Senate,Jim Rogers,DEM,570303,2,0,7,9,
Osage,U.S. Senate,Connie Johnson,DEM,570303,0,0,4,4,
Osage,Governor,Dax Ewbank,REP,570303,0,0,7,7,
Osage,Governor,Chad Moody,REP,570303,1,0,11,12,
Osage,Governor,Mary Fallin,REP,570303,1,0,34,35,
Osage,Superintendent of Public Instruction,Brian Kelly,REP,570303,2,0,22,24,
Osage,Superintendent of Public Instruction,Janet Costello Barresi,REP,570303,0,0,8,8,
Osage,Superintendent of Public Instruction,Joy Hofmeister,REP,570303,0,0,22,22,
Osage,Insurance Commissioner,Bill Viner,REP,570303,2,0,15,17,
Osage,Insurance Commissioner,John Doak,REP,570303,0,0,31,31,
Osage,Corporation Commissioner,Todd Hiett,REP,570303,1,0,26,27,
Osage,Corporation Commissioner,Cliff Branan,REP,570303,1,0,21,22,
Osage,U.S. Senate,Evelyn Rogers,REP,570303,0,0,3,3,
Osage,U.S. Senate,Rob Moye,REP,570303,0,0,2,2,
Osage,U.S. Senate,D. Jean Mcbride-Samuels,REP,570303,0,0,1,1,
Osage,U.S. Senate,Jim Inhofe,REP,570303,2,0,47,49,
Osage,U.S. Senate,Erick Paul Wyatt,REP,570303,0,0,1,1,
Osage,U.S. Senate,Andy Craig,REP,570303,0,0,0,0,
Osage,U.S. Senate,T. Shannon,REP,570303,0,0,30,30,
Osage,U.S. Senate,Randy Brogdon,REP,570303,0,0,1,1,
Osage,U.S. Senate,Eric Mccray,REP,570303,1,0,0,1,
Osage,U.S. Senate,Kevin Crow,REP,570303,0,0,1,1,
Osage,U.S. Senate,James Lankford,REP,570303,1,0,21,22,
Osage,U.S. Senate,Jason Weger,REP,570303,0,0,2,2,
Osage,U.S. House,Timothy Ray Murray,REP,570303,0,0,1,1,03
Osage,U.S. House,Robert Hubbard,REP,570303,0,0,8,8,03
Osage,U.S. House,Frank Lucas,REP,570303,2,0,45,47,03
Osage,Superintendent of Public Instruction,John Cox,DEM,570305,2,0,25,27,
Osage,Superintendent of Public Instruction,Jack Jr.,DEM,570305,0,0,6,6,
Osage,Superintendent of Public Instruction,Ivan Holmes,DEM,570305,2,0,0,2,
Osage,Superintendent of Public Instruction,Freda Deskin,DEM,570305,1,0,17,18,
Osage,U.S. Senate,Patrick Michael Hayes,DEM,570305,2,0,8,10,
Osage,U.S. Senate,Jim Rogers,DEM,570305,2,0,15,17,
Osage,U.S. Senate,Connie Johnson,DEM,570305,0,0,26,26,
Osage,Governor,Dax Ewbank,REP,570305,0,0,1,1,
Osage,Governor,Chad Moody,REP,570305,0,0,12,12,
Osage,Governor,Mary Fallin,REP,570305,0,0,39,39,
Osage,Superintendent of Public Instruction,Brian Kelly,REP,570305,0,0,10,10,
Osage,Superintendent of Public Instruction,Janet Costello Barresi,REP,570305,0,0,8,8,
Osage,Superintendent of Public Instruction,Joy Hofmeister,REP,570305,1,0,35,36,
Osage,Insurance Commissioner,Bill Viner,REP,570305,0,0,6,6,
Osage,Insurance Commissioner,John Doak,REP,570305,0,0,44,44,
Osage,Corporation Commissioner,Todd Hiett,REP,570305,0,0,22,22,
Osage,Corporation Commissioner,Cliff Branan,REP,570305,0,0,26,26,
Osage,U.S. Senate,Evelyn Rogers,REP,570305,0,0,3,3,
Osage,U.S. Senate,Rob Moye,REP,570305,0,0,0,0,
Osage,U.S. Senate,D. Jean Mcbride-Samuels,REP,570305,0,0,2,2,
Osage,U.S. Senate,Jim Inhofe,REP,570305,0,0,41,41,
Osage,U.S. Senate,Erick Paul Wyatt,REP,570305,0,0,4,4,
Osage,U.S. Senate,Andy Craig,REP,570305,0,0,0,0,
Osage,U.S. Senate,T. Shannon,REP,570305,1,0,25,26,
Osage,U.S. Senate,Randy Brogdon,REP,570305,0,0,1,1,
Osage,U.S. Senate,Eric Mccray,REP,570305,0,0,0,0,
Osage,U.S. Senate,Kevin Crow,REP,570305,0,0,1,1,
Osage,U.S. Senate,James Lankford,REP,570305,0,0,26,26,
Osage,U.S. Senate,Jason Weger,REP,570305,0,0,0,0,
Osage,U.S. House,Timothy Ray Murray,REP,570305,0,0,6,6,03
Osage,U.S. House,Robert Hubbard,REP,570305,0,0,8,8,03
Osage,U.S. House,Frank Lucas,REP,570305,0,0,36,36,03
Osage,Superintendent of Public Instruction,John Cox,DEM,570306,0,0,28,28,
Osage,Superintendent of Public Instruction,Jack Jr.,DEM,570306,0,1,3,4,
Osage,Superintendent of Public Instruction,Ivan Holmes,DEM,570306,0,0,3,3,
Osage,Superintendent of Public Instruction,Freda Deskin,DEM,570306,1,0,23,24,
Osage,U.S. Senate,Patrick Michael Hayes,DEM,570306,0,0,16,16,
Osage,U.S. Senate,Jim Rogers,DEM,570306,0,1,28,29,
Osage,U.S. Senate,Connie Johnson,DEM,570306,1,0,11,12,
Osage,Governor,Dax Ewbank,REP,570306,1,0,6,7,
Osage,Governor,Chad Moody,REP,570306,0,0,14,14,
Osage,Governor,Mary Fallin,REP,570306,0,0,38,38,
Osage,Superintendent of Public Instruction,Brian Kelly,REP,570306,0,0,10,10,
Osage,Superintendent of Public Instruction,Janet Costello Barresi,REP,570306,0,0,16,16,
Osage,Superintendent of Public Instruction,Joy Hofmeister,REP,570306,1,0,33,34,
Osage,Insurance Commissioner,Bill Viner,REP,570306,0,0,17,17,
Osage,Insurance Commissioner,John Doak,REP,570306,1,0,36,37,
Osage,Corporation Commissioner,Todd Hiett,REP,570306,1,0,22,23,
Osage,Corporation Commissioner,Cliff Branan,REP,570306,0,0,32,32,
Osage,U.S. Senate,Evelyn Rogers,REP,570306,0,0,4,4,
Osage,U.S. Senate,Rob Moye,REP,570306,0,0,3,3,
Osage,U.S. Senate,D. Jean Mcbride-Samuels,REP,570306,0,0,0,0,
Osage,U.S. Senate,Jim Inhofe,REP,570306,1,0,49,50,
Osage,U.S. Senate,Erick Paul Wyatt,REP,570306,0,0,2,2,
Osage,U.S. Senate,Andy Craig,REP,570306,0,0,1,1,
Osage,U.S. Senate,T. Shannon,REP,570306,1,0,18,19,
Osage,U.S. Senate,Randy Brogdon,REP,570306,0,0,5,5,
Osage,U.S. Senate,Eric Mccray,REP,570306,0,0,0,0,
Osage,U.S. Senate,Kevin Crow,REP,570306,0,0,0,0,
Osage,U.S. Senate,James Lankford,REP,570306,0,0,32,32,
Osage,U.S. Senate,Jason Weger,REP,570306,0,0,2,2,
Osage,U.S. House,Timothy Ray Murray,REP,570306,0,0,7,7,03
Osage,U.S. House,Robert Hubbard,REP,570306,0,0,7,7,03
Osage,U.S. House,Frank Lucas,REP,570306,1,0,44,45,03
Osage,Superintendent of Public Instruction,John Cox,DEM,570307,1,0,38,39,
Osage,Superintendent of Public Instruction,Jack Jr.,DEM,570307,0,0,7,7,
Osage,Superintendent of Public Instruction,Ivan Holmes,DEM,570307,0,0,13,13,
Osage,Superintendent of Public Instruction,Freda Deskin,DEM,570307,3,0,51,54,
Osage,U.S. Senate,Patrick Michael Hayes,DEM,570307,0,0,21,21,
Osage,U.S. Senate,Jim Rogers,DEM,570307,2,0,48,50,
Osage,U.S. Senate,Connie Johnson,DEM,570307,2,0,36,38,
Osage,Governor,Dax Ewbank,REP,570307,0,0,10,10,
Osage,Governor,Chad Moody,REP,570307,2,0,20,22,
Osage,Governor,Mary Fallin,REP,570307,0,0,49,49,
Osage,Superintendent of Public Instruction,Brian Kelly,REP,570307,1,0,19,20,
Osage,Superintendent of Public Instruction,Janet Costello Barresi,REP,570307,0,0,9,9,
Osage,Superintendent of Public Instruction,Joy Hofmeister,REP,570307,1,0,53,54,
Osage,Insurance Commissioner,Bill Viner,REP,570307,1,0,18,19,
Osage,Insurance Commissioner,John Doak,REP,570307,1,0,61,62,
Osage,Corporation Commissioner,Todd Hiett,REP,570307,1,0,47,48,
Osage,Corporation Commissioner,Cliff Branan,REP,570307,0,0,30,30,
Osage,U.S. Senate,Evelyn Rogers,REP,570307,0,0,1,1,
Osage,U.S. Senate,Rob Moye,REP,570307,0,0,2,2,
Osage,U.S. Senate,D. Jean Mcbride-Samuels,REP,570307,0,0,0,0,
Osage,U.S. Senate,Jim Inhofe,REP,570307,2,0,73,75,
Osage,U.S. Senate,Erick Paul Wyatt,REP,570307,0,0,3,3,
Osage,U.S. Senate,Andy Craig,REP,570307,0,0,0,0,
Osage,U.S. Senate,T. Shannon,REP,570307,2,0,29,31,
Osage,U.S. Senate,Randy Brogdon,REP,570307,0,0,2,2,
Osage,U.S. Senate,Eric Mccray,REP,570307,0,0,0,0,
Osage,U.S. Senate,Kevin Crow,REP,570307,0,0,0,0,
Osage,U.S. Senate,James Lankford,REP,570307,0,0,50,50,
Osage,U.S. Senate,Jason Weger,REP,570307,0,0,0,0,
Osage,U.S. House,Timothy Ray Murray,REP,570307,0,0,4,4,03
Osage,U.S. House,Robert Hubbard,REP,570307,1,0,6,7,03
Osage,U.S. House,Frank Lucas,REP,570307,1,0,69,70,03
Osage,Superintendent of Public Instruction,John Cox,DEM,570308,0,0,26,26,
Osage,Superintendent of Public Instruction,Jack Jr.,DEM,570308,1,0,7,8,
Osage,Superintendent of Public Instruction,Ivan Holmes,DEM,570308,1,0,4,5,
Osage,Superintendent of Public Instruction,Freda Deskin,DEM,570308,0,0,40,40,
Osage,U.S. Senate,Patrick Michael Hayes,DEM,570308,0,0,15,15,
Osage,U.S. Senate,Jim Rogers,DEM,570308,0,0,29,29,
Osage,U.S. Senate,Connie Johnson,DEM,570308,2,0,33,35,
Osage,Governor,Dax Ewbank,REP,570308,0,0,17,17,
Osage,Governor,Chad Moody,REP,570308,0,0,27,27,
Osage,Governor,Mary Fallin,REP,570308,1,3,164,168,
Osage,Superintendent of Public Instruction,Brian Kelly,REP,570308,0,0,38,38,
Osage,Superintendent of Public Instruction,Janet Costello Barresi,REP,570308,0,0,27,27,
Osage,Superintendent of Public Instruction,Joy Hofmeister,REP,570308,1,3,138,142,
Osage,Insurance Commissioner,Bill Viner,REP,570308,0,2,53,55,
Osage,Insurance Commissioner,John Doak,REP,570308,1,1,139,141,
Osage,Corporation Commissioner,Todd Hiett,REP,570308,1,3,99,103,
Osage,Corporation Commissioner,Cliff Branan,REP,570308,0,0,90,90,
Osage,U.S. Senate,Evelyn Rogers,REP,570308,0,0,11,11,
Osage,U.S. Senate,Rob Moye,REP,570308,0,0,4,4,
Osage,U.S. Senate,D. Jean Mcbride-Samuels,REP,570308,0,0,2,2,
Osage,U.S. Senate,Jim Inhofe,REP,570308,1,3,185,189,
Osage,U.S. Senate,Erick Paul Wyatt,REP,570308,0,0,8,8,
Osage,U.S. Senate,Andy Craig,REP,570308,0,0,2,2,
Osage,U.S. Senate,T. Shannon,REP,570308,0,1,96,97,
Osage,U.S. Senate,Randy Brogdon,REP,570308,0,0,18,18,
Osage,U.S. Senate,Eric Mccray,REP,570308,0,0,2,2,
Osage,U.S. Senate,Kevin Crow,REP,570308,0,0,1,1,
Osage,U.S. Senate,James Lankford,REP,570308,1,2,92,95,
Osage,U.S. Senate,Jason Weger,REP,570308,0,0,0,0,
Osage,U.S. House,Timothy Ray Murray,REP,570308,0,0,22,22,03
Osage,U.S. House,Robert Hubbard,REP,570308,0,0,31,31,03
Osage,U.S. House,Frank Lucas,REP,570308,1,3,150,154,03
Osage,Superintendent of Public Instruction,John Cox,DEM,570309,0,1,9,10,
Osage,Superintendent of Public Instruction,Jack Jr.,DEM,570309,3,0,2,5,
Osage,Superintendent of Public Instruction,Ivan Holmes,DEM,570309,0,0,2,2,
Osage,Superintendent of Public Instruction,Freda Deskin,DEM,570309,0,0,13,13,
Osage,U.S. Senate,Patrick Michael Hayes,DEM,570309,0,1,4,5,
Osage,U.S. Senate,Jim Rogers,DEM,570309,3,0,14,17,
Osage,U.S. Senate,Connie Johnson,DEM,570309,0,0,8,8,
Osage,Governor,Dax Ewbank,REP,570309,2,0,8,10,
Osage,Governor,Chad Moody,REP,570309,0,0,14,14,
Osage,Governor,Mary Fallin,REP,570309,5,1,97,103,
Osage,Superintendent of Public Instruction,Brian Kelly,REP,570309,1,0,30,31,
Osage,Superintendent of Public Instruction,Janet Costello Barresi,REP,570309,1,0,19,20,
Osage,Superintendent of Public Instruction,Joy Hofmeister,REP,570309,5,1,71,77,
Osage,Insurance Commissioner,Bill Viner,REP,570309,0,0,25,25,
Osage,Insurance Commissioner,John Doak,REP,570309,7,1,89,97,
Osage,Corporation Commissioner,Todd Hiett,REP,570309,4,1,63,68,
Osage,Corporation Commissioner,Cliff Branan,REP,570309,2,0,49,51,
Osage,U.S. Senate,Evelyn Rogers,REP,570309,0,0,1,1,
Osage,U.S. Senate,Rob Moye,REP,570309,0,0,1,1,
Osage,U.S. Senate,D. Jean Mcbride-Samuels,REP,570309,0,0,4,4,
Osage,U.S. Senate,Jim Inhofe,REP,570309,7,1,105,113,
Osage,U.S. Senate,Erick Paul Wyatt,REP,570309,0,0,7,7,
Osage,U.S. Senate,Andy Craig,REP,570309,0,0,0,0,
Osage,U.S. Senate,T. Shannon,REP,570309,5,0,59,64,
Osage,U.S. Senate,Randy Brogdon,REP,570309,0,0,6,6,
Osage,U.S. Senate,Eric Mccray,REP,570309,0,0,2,2,
Osage,U.S. Senate,Kevin Crow,REP,570309,0,0,1,1,
Osage,U.S. Senate,James Lankford,REP,570309,2,1,50,53,
Osage,U.S. Senate,Jason Weger,REP,570309,0,0,2,2,
Osage,U.S. House,Timothy Ray Murray,REP,570309,0,0,4,4,03
Osage,U.S. House,Robert Hubbard,REP,570309,0,0,24,24,03
Osage,U.S. House,Frank Lucas,REP,570309,7,1,89,97,03
Osage,Superintendent of Public Instruction,John Cox,DEM,570310,3,0,48,51,
Osage,Superintendent of Public Instruction,Jack Jr.,DEM,570310,2,0,59,61,
Osage,Superintendent of Public Instruction,Ivan Holmes,DEM,570310,2,0,22,24,
Osage,Superintendent of Public Instruction,Freda Deskin,DEM,570310,4,0,130,134,
Osage,U.S. Senate,Patrick Michael Hayes,DEM,570310,0,0,29,29,
Osage,U.S. Senate,Jim Rogers,DEM,570310,2,0,29,31,
Osage,U.S. Senate,Connie Johnson,DEM,570310,9,0,201,210,
Osage,Governor,Dax Ewbank,REP,570310,0,0,4,4,
Osage,Governor,Chad Moody,REP,570310,1,0,4,5,
Osage,Governor,Mary Fallin,REP,570310,0,0,11,11,
Osage,Superintendent of Public Instruction,Brian Kelly,REP,570310,1,0,1,2,
Osage,Superintendent of Public Instruction,Janet Costello Barresi,REP,570310,0,0,3,3,
Osage,Superintendent of Public Instruction,Joy Hofmeister,REP,570310,0,0,13,13,
Osage,Insurance Commissioner,Bill Viner,REP,570310,0,0,2,2,
Osage,Insurance Commissioner,John Doak,REP,570310,1,0,12,13,
Osage,Corporation Commissioner,Todd Hiett,REP,570310,1,0,7,8,
Osage,Corporation Commissioner,Cliff Branan,REP,570310,0,0,9,9,
Osage,U.S. Senate,Evelyn Rogers,REP,570310,1,0,2,3,
Osage,U.S. Senate,Rob Moye,REP,570310,0,0,0,0,
Osage,U.S. Senate,D. Jean Mcbride-Samuels,REP,570310,0,0,1,1,
Osage,U.S. Senate,Jim Inhofe,REP,570310,0,0,15,15,
Osage,U.S. Senate,Erick Paul Wyatt,REP,570310,0,0,0,0,
Osage,U.S. Senate,Andy Craig,REP,570310,0,0,0,0,
Osage,U.S. Senate,T. Shannon,REP,570310,0,0,5,5,
Osage,U.S. Senate,Randy Brogdon,REP,570310,0,0,0,0,
Osage,U.S. Senate,Eric Mccray,REP,570310,0,0,0,0,
Osage,U.S. Senate,Kevin Crow,REP,570310,1,0,1,2,
Osage,U.S. Senate,James Lankford,REP,570310,0,0,13,13,
Osage,U.S. Senate,Jason Weger,REP,570310,0,0,0,0,
Osage,U.S. House,Timothy Ray Murray,REP,570310,0,0,2,2,03
Osage,U.S. House,Robert Hubbard,REP,570310,0,0,1,1,03
Osage,U.S. House,Frank Lucas,REP,570310,1,0,13,14,03
Osage,Superintendent of Public Instruction,John Cox,DEM,570311,0,0,1,1,
Osage,Superintendent of Public Instruction,Jack Jr.,DEM,570311,0,0,1,1,
Osage,Superintendent of Public Instruction,Ivan Holmes,DEM,570311,0,0,0,0,
Osage,Superintendent of Public Instruction,Freda Deskin,DEM,570311,0,0,2,2,
Osage,U.S. Senate,Patrick Michael Hayes,DEM,570311,0,0,1,1,
Osage,U.S. Senate,Jim Rogers,DEM,570311,0,0,0,0,
Osage,U.S. Senate,Connie Johnson,DEM,570311,0,0,3,3,
Osage,Governor,Dax Ewbank,REP,570311,2,0,0,2,
Osage,Governor,Chad Moody,REP,570311,1,0,2,3,
Osage,Governor,Mary Fallin,REP,570311,0,0,17,17,
Osage,Superintendent of Public Instruction,Brian Kelly,REP,570311,1,0,3,4,
Osage,Superintendent of Public Instruction,Janet Costello Barresi,REP,570311,0,0,1,1,
Osage,Superintendent of Public Instruction,Joy Hofmeister,REP,570311,2,0,13,15,
Osage,Insurance Commissioner,Bill Viner,REP,570311,3,0,4,7,
Osage,Insurance Commissioner,John Doak,REP,570311,0,0,12,12,
Osage,Corporation Commissioner,Todd Hiett,REP,570311,3,0,7,10,
Osage,Corporation Commissioner,Cliff Branan,REP,570311,0,0,9,9,
Osage,U.S. Senate,Evelyn Rogers,REP,570311,2,0,1,3,
Osage,U.S. Senate,Rob Moye,REP,570311,0,0,0,0,
Osage,U.S. Senate,D. Jean Mcbride-Samuels,REP,570311,0,0,0,0,
Osage,U.S. Senate,Jim Inhofe,REP,570311,1,0,17,18,
Osage,U.S. Senate,Erick Paul Wyatt,REP,570311,0,0,0,0,
Osage,U.S. Senate,Andy Craig,REP,570311,0,0,0,0,
Osage,U.S. Senate,T. Shannon,REP,570311,1,0,2,3,
Osage,U.S. Senate,Randy Brogdon,REP,570311,2,0,0,2,
Osage,U.S. Senate,Eric Mccray,REP,570311,0,0,0,0,
Osage,U.S. Senate,Kevin Crow,REP,570311,0,0,0,0,
Osage,U.S. Senate,James Lankford,REP,570311,0,0,17,17,
Osage,U.S. Senate,Jason Weger,REP,570311,0,0,0,0,
Osage,U.S. House,Timothy Ray Murray,REP,570311,0,0,3,3,03
Osage,U.S. House,Robert Hubbard,REP,570311,1,0,3,4,03
Osage,U.S. House,Frank Lucas,REP,570311,2,0,12,14,03
Osage,Superintendent of Public Instruction,John Cox,DEM,570312,0,0,6,6,
Osage,Superintendent of Public Instruction,Jack Jr.,DEM,570312,0,0,6,6,
Osage,Superintendent of Public Instruction,Ivan Holmes,DEM,570312,0,0,3,3,
Osage,Superintendent of Public Instruction,Freda Deskin,DEM,570312,1,0,24,25,
Osage,U.S. Senate,Patrick Michael Hayes,DEM,570312,0,0,7,7,
Osage,U.S. Senate,Jim Rogers,DEM,570312,0,0,16,16,
Osage,U.S. Senate,Connie Johnson,DEM,570312,1,0,16,17,
Osage,Governor,Dax Ewbank,REP,570312,2,0,7,9,
Osage,Governor,Chad Moody,REP,570312,0,0,15,15,
Osage,Governor,Mary Fallin,REP,570312,5,0,95,100,
Osage,Superintendent of Public Instruction,Brian Kelly,REP,570312,2,0,14,16,
Osage,Superintendent of Public Instruction,Janet Costello Barresi,REP,570312,0,0,19,19,
Osage,Superintendent of Public Instruction,Joy Hofmeister,REP,570312,5,0,84,89,
Osage,Insurance Commissioner,Bill Viner,REP,570312,0,0,29,29,
Osage,Insurance Commissioner,John Doak,REP,570312,5,0,82,87,
Osage,Corporation Commissioner,Todd Hiett,REP,570312,3,0,60,63,
Osage,Corporation Commissioner,Cliff Branan,REP,570312,2,0,50,52,
Osage,U.S. Senate,Evelyn Rogers,REP,570312,0,0,5,5,
Osage,U.S. Senate,Rob Moye,REP,570312,0,0,2,2,
Osage,U.S. Senate,D. Jean Mcbride-Samuels,REP,570312,0,0,1,1,
Osage,U.S. Senate,Jim Inhofe,REP,570312,7,0,103,110,
Osage,U.S. Senate,Erick Paul Wyatt,REP,570312,0,0,6,6,
Osage,U.S. Senate,Andy Craig,REP,570312,0,0,2,2,
Osage,U.S. Senate,T. Shannon,REP,570312,4,0,48,52,
Osage,U.S. Senate,Randy Brogdon,REP,570312,1,0,4,5,
Osage,U.S. Senate,Eric Mccray,REP,570312,0,0,0,0,
Osage,U.S. Senate,Kevin Crow,REP,570312,0,0,1,1,
Osage,U.S. Senate,James Lankford,REP,570312,2,0,62,64,
Osage,U.S. Senate,Jason Weger,REP,570312,0,0,1,1,
Osage,U.S. House,Timothy Ray Murray,REP,570312,0,0,8,8,03
Osage,U.S. House,Robert Hubbard,REP,570312,3,0,20,23,03
Osage,U.S. House,Frank Lucas,REP,570312,3,0,88,91,03
Ottawa,Superintendent of Public Instruction,John Cox,DEM,580002,1,2,29,32,
Ottawa,Superintendent of Public Instruction,Jack Jr.,DEM,580002,1,0,16,17,
Ottawa,Superintendent of Public Instruction,Ivan Holmes,DEM,580002,0,3,11,14,
Ottawa,Superintendent of Public Instruction,Freda Deskin,DEM,580002,2,1,21,24,
Ottawa,U.S. Senate,Patrick Michael Hayes,DEM,580002,2,1,18,21,
Ottawa,U.S. Senate,Jim Rogers,DEM,580002,0,1,29,30,
Ottawa,U.S. Senate,Connie Johnson,DEM,580002,2,4,27,33,
Ottawa,U.S. House,Earl Everett,DEM,580002,2,3,47,52,02
Ottawa,U.S. House,Joshua Harris-Till,DEM,580002,2,3,24,29,02
Ottawa,State House,Donnie Howe,DEM,580002,1,1,22,24,7
Ottawa,State House,Ben Loring,DEM,580002,3,5,59,67,7
Ottawa,Governor,Dax Ewbank,REP,580002,0,0,6,6,
Ottawa,Governor,Chad Moody,REP,580002,1,2,9,12,
Ottawa,Governor,Mary Fallin,REP,580002,4,3,37,44,
Ottawa,Superintendent of Public Instruction,Brian Kelly,REP,580002,2,0,11,13,
Ottawa,Superintendent of Public Instruction,Janet Costello Barresi,REP,580002,1,0,15,16,
Ottawa,Superintendent of Public Instruction,Joy Hofmeister,REP,580002,1,5,25,31,
Ottawa,Insurance Commissioner,Bill Viner,REP,580002,2,0,14,16,
Ottawa,Insurance Commissioner,John Doak,REP,580002,2,5,33,40,
Ottawa,Corporation Commissioner,Todd Hiett,REP,580002,3,3,25,31,
Ottawa,Corporation Commissioner,Cliff Branan,REP,580002,1,2,19,22,
Ottawa,U.S. Senate,Evelyn Rogers,REP,580002,1,0,1,2,
Ottawa,U.S. Senate,Rob Moye,REP,580002,0,0,2,2,
Ottawa,U.S. Senate,D. Jean Mcbride-Samuels,REP,580002,0,0,0,0,
Ottawa,U.S. Senate,Jim Inhofe,REP,580002,2,5,46,53,
Ottawa,U.S. Senate,Erick Paul Wyatt,REP,580002,2,0,2,4,
Ottawa,U.S. Senate,Andy Craig,REP,580002,0,0,1,1,
Ottawa,U.S. Senate,T. Shannon,REP,580002,1,3,32,36,
Ottawa,U.S. Senate,Randy Brogdon,REP,580002,0,0,1,1,
Ottawa,U.S. Senate,Eric Mccray,REP,580002,1,0,0,1,
Ottawa,U.S. Senate,Kevin Crow,REP,580002,0,0,0,0,
Ottawa,U.S. Senate,James Lankford,REP,580002,2,2,18,22,
Ottawa,U.S. Senate,Jason Weger,REP,580002,1,0,1,2,
Ottawa,U.S. House,Darrel Robertson,REP,580002,0,0,18,18,02
Ottawa,U.S. House,Markwayne Mullin,REP,580002,4,5,33,42,02
Ottawa,Superintendent of Public Instruction,John Cox,DEM,580003,0,3,56,59,
Ottawa,Superintendent of Public Instruction,Jack Jr.,DEM,580003,0,7,29,36,
Ottawa,Superintendent of Public Instruction,Ivan Holmes,DEM,580003,0,1,20,21,
Ottawa,Superintendent of Public Instruction,Freda Deskin,DEM,580003,1,6,29,36,
Ottawa,U.S. Senate,Patrick Michael Hayes,DEM,580003,0,6,32,38,
Ottawa,U.S. Senate,Jim Rogers,DEM,580003,0,4,60,64,
Ottawa,U.S. Senate,Connie Johnson,DEM,580003,1,7,40,48,
Ottawa,U.S. House,Earl Everett,DEM,580003,0,9,84,93,02
Ottawa,U.S. House,Joshua Harris-Till,DEM,580003,1,8,42,51,02
Ottawa,State House,Donnie Howe,DEM,580003,2,1,63,66,7
Ottawa,State House,Ben Loring,DEM,580003,1,17,84,102,7
Ottawa,Governor,Dax Ewbank,REP,580003,0,0,14,14,
Ottawa,Governor,Chad Moody,REP,580003,0,0,14,14,
Ottawa,Governor,Mary Fallin,REP,580003,3,4,56,63,
Ottawa,Superintendent of Public Instruction,Brian Kelly,REP,580003,0,0,27,27,
Ottawa,Superintendent of Public Instruction,Janet Costello Barresi,REP,580003,0,2,14,16,
Ottawa,Superintendent of Public Instruction,Joy Hofmeister,REP,580003,3,1,43,47,
Ottawa,Insurance Commissioner,Bill Viner,REP,580003,1,0,27,28,
Ottawa,Insurance Commissioner,John Doak,REP,580003,2,3,51,56,
Ottawa,Corporation Commissioner,Todd Hiett,REP,580003,1,1,42,44,
Ottawa,Corporation Commissioner,Cliff Branan,REP,580003,2,1,34,37,
Ottawa,U.S. Senate,Evelyn Rogers,REP,580003,1,0,4,5,
Ottawa,U.S. Senate,Rob Moye,REP,580003,0,0,2,2,
Ottawa,U.S. Senate,D. Jean Mcbride-Samuels,REP,580003,0,0,2,2,
Ottawa,U.S. Senate,Jim Inhofe,REP,580003,2,4,68,74,
Ottawa,U.S. Senate,Erick Paul Wyatt,REP,580003,0,0,8,8,
Ottawa,U.S. Senate,Andy Craig,REP,580003,0,0,1,1,
Ottawa,U.S. Senate,T. Shannon,REP,580003,2,3,35,40,
Ottawa,U.S. Senate,Randy Brogdon,REP,580003,0,1,8,9,
Ottawa,U.S. Senate,Eric Mccray,REP,580003,0,0,1,1,
Ottawa,U.S. Senate,Kevin Crow,REP,580003,0,0,1,1,
Ottawa,U.S. Senate,James Lankford,REP,580003,1,0,33,34,
Ottawa,U.S. Senate,Jason Weger,REP,580003,0,0,2,2,
Ottawa,U.S. House,Darrel Robertson,REP,580003,1,0,22,23,02
Ottawa,U.S. House,Markwayne Mullin,REP,580003,2,4,59,65,02
Ottawa,Superintendent of Public Instruction,John Cox,DEM,580004,1,5,29,35,
Ottawa,Superintendent of Public Instruction,Jack Jr.,DEM,580004,0,0,7,7,
Ottawa,Superintendent of Public Instruction,Ivan Holmes,DEM,580004,0,0,7,7,
Ottawa,Superintendent of Public Instruction,Freda Deskin,DEM,580004,1,5,15,21,
Ottawa,U.S. Senate,Patrick Michael Hayes,DEM,580004,0,2,19,21,
Ottawa,U.S. Senate,Jim Rogers,DEM,580004,2,5,17,24,
Ottawa,U.S. Senate,Connie Johnson,DEM,580004,0,2,17,19,
Ottawa,U.S. House,Earl Everett,DEM,580004,1,7,30,38,02
Ottawa,U.S. House,Joshua Harris-Till,DEM,580004,1,2,22,25,02
Ottawa,State House,Donnie Howe,DEM,580004,0,4,15,19,7
Ottawa,State House,Ben Loring,DEM,580004,6,6,48,60,7
Ottawa,Governor,Dax Ewbank,REP,580004,0,1,10,11,
Ottawa,Governor,Chad Moody,REP,580004,0,0,5,5,
Ottawa,Governor,Mary Fallin,REP,580004,0,3,30,33,
Ottawa,Superintendent of Public Instruction,Brian Kelly,REP,580004,0,1,9,10,
Ottawa,Superintendent of Public Instruction,Janet Costello Barresi,REP,580004,0,0,6,6,
Ottawa,Superintendent of Public Instruction,Joy Hofmeister,REP,580004,0,3,30,33,
Ottawa,Insurance Commissioner,Bill Viner,REP,580004,0,1,8,9,
Ottawa,Insurance Commissioner,John Doak,REP,580004,0,3,30,33,
Ottawa,Corporation Commissioner,Todd Hiett,REP,580004,0,1,20,21,
Ottawa,Corporation Commissioner,Cliff Branan,REP,580004,0,2,18,20,
Ottawa,U.S. Senate,Evelyn Rogers,REP,580004,0,1,4,5,
Ottawa,U.S. Senate,Rob Moye,REP,580004,0,0,2,2,
Ottawa,U.S. Senate,D. Jean Mcbride-Samuels,REP,580004,0,0,2,2,
Ottawa,U.S. Senate,Jim Inhofe,REP,580004,0,3,29,32,
Ottawa,U.S. Senate,Erick Paul Wyatt,REP,580004,0,0,7,7,
Ottawa,U.S. Senate,Andy Craig,REP,580004,0,1,0,1,
Ottawa,U.S. Senate,T. Shannon,REP,580004,0,1,23,24,
Ottawa,U.S. Senate,Randy Brogdon,REP,580004,0,0,3,3,
Ottawa,U.S. Senate,Eric Mccray,REP,580004,0,0,0,0,
Ottawa,U.S. Senate,Kevin Crow,REP,580004,0,0,0,0,
Ottawa,U.S. Senate,James Lankford,REP,580004,0,2,17,19,
Ottawa,U.S. Senate,Jason Weger,REP,580004,0,0,2,2,
Ottawa,U.S. House,Darrel Robertson,REP,580004,0,0,17,17,02
Ottawa,U.S. House,Markwayne Mullin,REP,580004,0,4,27,31,02
Ottawa,Superintendent of Public Instruction,John Cox,DEM,580005,2,0,21,23,
Ottawa,Superintendent of Public Instruction,Jack Jr.,DEM,580005,0,0,10,10,
Ottawa,Superintendent of Public Instruction,Ivan Holmes,DEM,580005,0,1,4,5,
Ottawa,Superintendent of Public Instruction,Freda Deskin,DEM,580005,0,0,12,12,
Ottawa,U.S. Senate,Patrick Michael Hayes,DEM,580005,2,0,14,16,
Ottawa,U.S. Senate,Jim Rogers,DEM,580005,0,0,8,8,
Ottawa,U.S. Senate,Connie Johnson,DEM,580005,0,1,24,25,
Ottawa,U.S. House,Earl Everett,DEM,580005,2,0,25,27,02
Ottawa,U.S. House,Joshua Harris-Till,DEM,580005,0,1,19,20,02
Ottawa,State House,Donnie Howe,DEM,580005,2,0,29,31,7
Ottawa,State House,Ben Loring,DEM,580005,0,1,26,27,7
Ottawa,Governor,Dax Ewbank,REP,580005,0,0,1,1,
Ottawa,Governor,Chad Moody,REP,580005,1,1,5,7,
Ottawa,Governor,Mary Fallin,REP,580005,0,2,9,11,
Ottawa,Superintendent of Public Instruction,Brian Kelly,REP,580005,1,0,5,6,
Ottawa,Superintendent of Public Instruction,Janet Costello Barresi,REP,580005,0,2,2,4,
Ottawa,Superintendent of Public Instruction,Joy Hofmeister,REP,580005,0,1,7,8,
Ottawa,Insurance Commissioner,Bill Viner,REP,580005,1,1,5,7,
Ottawa,Insurance Commissioner,John Doak,REP,580005,0,2,10,12,
Ottawa,Corporation Commissioner,Todd Hiett,REP,580005,1,2,4,7,
Ottawa,Corporation Commissioner,Cliff Branan,REP,580005,0,1,9,10,
Ottawa,U.S. Senate,Evelyn Rogers,REP,580005,0,0,2,2,
Ottawa,U.S. Senate,Rob Moye,REP,580005,1,0,2,3,
Ottawa,U.S. Senate,D. Jean Mcbride-Samuels,REP,580005,0,0,0,0,
Ottawa,U.S. Senate,Jim Inhofe,REP,580005,0,2,10,12,
Ottawa,U.S. Senate,Erick Paul Wyatt,REP,580005,0,1,1,2,
Ottawa,U.S. Senate,Andy Craig,REP,580005,1,0,2,3,
Ottawa,U.S. Senate,T. Shannon,REP,580005,0,1,4,5,
Ottawa,U.S. Senate,Randy Brogdon,REP,580005,0,0,1,1,
Ottawa,U.S. Senate,Eric Mccray,REP,580005,0,0,0,0,
Ottawa,U.S. Senate,Kevin Crow,REP,580005,0,0,2,2,
Ottawa,U.S. Senate,James Lankford,REP,580005,0,2,6,8,
Ottawa,U.S. Senate,Jason Weger,REP,580005,0,0,0,0,
Ottawa,U.S. House,Darrel Robertson,REP,580005,1,1,5,7,02
Ottawa,U.S. House,Markwayne Mullin,REP,580005,0,2,10,12,02
Ottawa,Superintendent of Public Instruction,John Cox,DEM,580007,0,3,68,71,
Ottawa,Superintendent of Public Instruction,Jack Jr.,DEM,580007,0,2,38,40,
Ottawa,Superintendent of Public Instruction,Ivan Holmes,DEM,580007,0,0,25,25,
Ottawa,Superintendent of Public Instruction,Freda Deskin,DEM,580007,1,6,59,66,
Ottawa,U.S. Senate,Patrick Michael Hayes,DEM,580007,0,4,53,57,
Ottawa,U.S. Senate,Jim Rogers,DEM,580007,0,4,63,67,
Ottawa,U.S. Senate,Connie Johnson,DEM,580007,1,3,70,74,
Ottawa,U.S. House,Earl Everett,DEM,580007,0,8,103,111,02
Ottawa,U.S. House,Joshua Harris-Till,DEM,580007,0,3,70,73,02
Ottawa,State House,Donnie Howe,DEM,580007,0,0,63,63,7
Ottawa,State House,Ben Loring,DEM,580007,1,11,137,149,7
Ottawa,Governor,Dax Ewbank,REP,580007,0,0,20,20,
Ottawa,Governor,Chad Moody,REP,580007,0,0,21,21,
Ottawa,Governor,Mary Fallin,REP,580007,1,2,90,93,
Ottawa,Superintendent of Public Instruction,Brian Kelly,REP,580007,0,1,34,35,
Ottawa,Superintendent of Public Instruction,Janet Costello Barresi,REP,580007,1,0,18,19,
Ottawa,Superintendent of Public Instruction,Joy Hofmeister,REP,580007,0,1,74,75,
Ottawa,Insurance Commissioner,Bill Viner,REP,580007,1,0,41,42,
Ottawa,Insurance Commissioner,John Doak,REP,580007,0,2,76,78,
Ottawa,Corporation Commissioner,Todd Hiett,REP,580007,0,1,69,70,
Ottawa,Corporation Commissioner,Cliff Branan,REP,580007,1,1,47,49,
Ottawa,U.S. Senate,Evelyn Rogers,REP,580007,0,0,6,6,
Ottawa,U.S. Senate,Rob Moye,REP,580007,0,0,7,7,
Ottawa,U.S. Senate,D. Jean Mcbride-Samuels,REP,580007,0,0,2,2,
Ottawa,U.S. Senate,Jim Inhofe,REP,580007,1,2,99,102,
Ottawa,U.S. Senate,Erick Paul Wyatt,REP,580007,0,0,13,13,
Ottawa,U.S. Senate,Andy Craig,REP,580007,0,0,4,4,
Ottawa,U.S. Senate,T. Shannon,REP,580007,1,0,43,44,
Ottawa,U.S. Senate,Randy Brogdon,REP,580007,0,0,10,10,
Ottawa,U.S. Senate,Eric Mccray,REP,580007,0,0,0,0,
Ottawa,U.S. Senate,Kevin Crow,REP,580007,0,0,2,2,
Ottawa,U.S. Senate,James Lankford,REP,580007,0,2,67,69,
Ottawa,U.S. Senate,Jason Weger,REP,580007,0,0,1,1,
Ottawa,U.S. House,Darrel Robertson,REP,580007,0,0,36,36,02
Ottawa,U.S. House,Markwayne Mullin,REP,580007,1,2,92,95,02
Ottawa,Superintendent of Public Instruction,John Cox,DEM,580008,1,1,20,22,
Ottawa,Superintendent of Public Instruction,Jack Jr.,DEM,580008,0,0,7,7,
Ottawa,Superintendent of Public Instruction,Ivan Holmes,DEM,580008,0,1,3,4,
Ottawa,Superintendent of Public Instruction,Freda Deskin,DEM,580008,0,0,13,13,
Ottawa,U.S. Senate,Patrick Michael Hayes,DEM,580008,0,2,14,16,
Ottawa,U.S. Senate,Jim Rogers,DEM,580008,1,0,9,10,
Ottawa,U.S. Senate,Connie Johnson,DEM,580008,0,0,19,19,
Ottawa,U.S. House,Earl Everett,DEM,580008,1,1,17,19,02
Ottawa,U.S. House,Joshua Harris-Till,DEM,580008,0,1,24,25,02
Ottawa,State House,Donnie Howe,DEM,580008,0,1,11,12,7
Ottawa,State House,Ben Loring,DEM,580008,1,1,34,36,7
Ottawa,Governor,Dax Ewbank,REP,580008,0,0,3,3,
Ottawa,Governor,Chad Moody,REP,580008,0,0,4,4,
Ottawa,Governor,Mary Fallin,REP,580008,0,0,15,15,
Ottawa,Superintendent of Public Instruction,Brian Kelly,REP,580008,0,0,8,8,
Ottawa,Superintendent of Public Instruction,Janet Costello Barresi,REP,580008,0,0,4,4,
Ottawa,Superintendent of Public Instruction,Joy Hofmeister,REP,580008,0,0,11,11,
Ottawa,Insurance Commissioner,Bill Viner,REP,580008,0,0,10,10,
Ottawa,Insurance Commissioner,John Doak,REP,580008,0,0,9,9,
Ottawa,Corporation Commissioner,Todd Hiett,REP,580008,0,0,12,12,
Ottawa,Corporation Commissioner,Cliff Branan,REP,580008,0,0,6,6,
Ottawa,U.S. Senate,Evelyn Rogers,REP,580008,0,0,1,1,
Ottawa,U.S. Senate,Rob Moye,REP,580008,0,0,1,1,
Ottawa,U.S. Senate,D. Jean Mcbride-Samuels,REP,580008,0,0,1,1,
Ottawa,U.S. Senate,Jim Inhofe,REP,580008,0,0,18,18,
Ottawa,U.S. Senate,Erick Paul Wyatt,REP,580008,0,0,2,2,
Ottawa,U.S. Senate,Andy Craig,REP,580008,0,0,0,0,
Ottawa,U.S. Senate,T. Shannon,REP,580008,0,0,11,11,
Ottawa,U.S. Senate,Randy Brogdon,REP,580008,0,0,3,3,
Ottawa,U.S. Senate,Eric Mccray,REP,580008,0,0,0,0,
Ottawa,U.S. Senate,Kevin Crow,REP,580008,0,0,0,0,
Ottawa,U.S. Senate,James Lankford,REP,580008,0,0,7,7,
Ottawa,U.S. Senate,Jason Weger,REP,580008,0,0,2,2,
Ottawa,U.S. House,Darrel Robertson,REP,580008,0,0,9,9,02
Ottawa,U.S. House,Markwayne Mullin,REP,580008,0,0,14,14,02
Ottawa,Superintendent of Public Instruction,John Cox,DEM,580009,0,2,24,26,
Ottawa,Superintendent of Public Instruction,Jack Jr.,DEM,580009,0,1,12,13,
Ottawa,Superintendent of Public Instruction,Ivan Holmes,DEM,580009,0,0,4,4,
Ottawa,Superintendent of Public Instruction,Freda Deskin,DEM,580009,1,1,12,14,
Ottawa,U.S. Senate,Patrick Michael Hayes,DEM,580009,0,1,16,17,
Ottawa,U.S. Senate,Jim Rogers,DEM,580009,0,0,18,18,
Ottawa,U.S. Senate,Connie Johnson,DEM,580009,1,3,14,18,
Ottawa,U.S. House,Earl Everett,DEM,580009,0,2,27,29,02
Ottawa,U.S. House,Joshua Harris-Till,DEM,580009,1,2,20,23,02
Ottawa,State House,Donnie Howe,DEM,580009,1,0,19,20,7
Ottawa,State House,Ben Loring,DEM,580009,0,4,37,41,7
Ottawa,Governor,Dax Ewbank,REP,580009,0,0,3,3,
Ottawa,Governor,Chad Moody,REP,580009,0,0,5,5,
Ottawa,Governor,Mary Fallin,REP,580009,0,0,28,28,
Ottawa,Superintendent of Public Instruction,Brian Kelly,REP,580009,0,0,4,4,
Ottawa,Superintendent of Public Instruction,Janet Costello Barresi,REP,580009,0,0,2,2,
Ottawa,Superintendent of Public Instruction,Joy Hofmeister,REP,580009,0,0,26,26,
Ottawa,Insurance Commissioner,Bill Viner,REP,580009,0,0,13,13,
Ottawa,Insurance Commissioner,John Doak,REP,580009,0,0,14,14,
Ottawa,Corporation Commissioner,Todd Hiett,REP,580009,0,0,12,12,
Ottawa,Corporation Commissioner,Cliff Branan,REP,580009,0,0,18,18,
Ottawa,U.S. Senate,Evelyn Rogers,REP,580009,0,0,6,6,
Ottawa,U.S. Senate,Rob Moye,REP,580009,0,0,1,1,
Ottawa,U.S. Senate,D. Jean Mcbride-Samuels,REP,580009,0,0,0,0,
Ottawa,U.S. Senate,Jim Inhofe,REP,580009,0,0,25,25,
Ottawa,U.S. Senate,Erick Paul Wyatt,REP,580009,0,0,6,6,
Ottawa,U.S. Senate,Andy Craig,REP,580009,0,0,1,1,
Ottawa,U.S. Senate,T. Shannon,REP,580009,0,0,16,16,
Ottawa,U.S. Senate,Randy Brogdon,REP,580009,0,0,0,0,
Ottawa,U.S. Senate,Eric Mccray,REP,580009,0,0,0,0,
Ottawa,U.S. Senate,Kevin Crow,REP,580009,0,0,1,1,
Ottawa,U.S. Senate,James Lankford,REP,580009,0,0,15,15,
Ottawa,U.S. Senate,Jason Weger,REP,580009,0,0,2,2,
Ottawa,U.S. House,Darrel Robertson,REP,580009,0,0,17,17,02
Ottawa,U.S. House,Markwayne Mullin,REP,580009,0,0,20,20,02
Ottawa,Superintendent of Public Instruction,John Cox,DEM,580011,0,1,26,27,
Ottawa,Superintendent of Public Instruction,Jack Jr.,DEM,580011,1,0,9,10,
Ottawa,Superintendent of Public Instruction,Ivan Holmes,DEM,580011,0,1,13,14,
Ottawa,Superintendent of Public Instruction,Freda Deskin,DEM,580011,4,3,37,44,
Ottawa,U.S. Senate,Patrick Michael Hayes,DEM,580011,1,2,26,29,
Ottawa,U.S. Senate,Jim Rogers,DEM,580011,1,1,23,25,
Ottawa,U.S. Senate,Connie Johnson,DEM,580011,3,2,37,42,
Ottawa,U.S. House,Earl Everett,DEM,580011,0,4,33,37,02
Ottawa,U.S. House,Joshua Harris-Till,DEM,580011,5,1,48,54,02
Ottawa,State House,Donnie Howe,DEM,580011,4,4,33,41,7
Ottawa,State House,Ben Loring,DEM,580011,1,1,60,62,7
Ottawa,Governor,Dax Ewbank,REP,580011,0,2,6,8,
Ottawa,Governor,Chad Moody,REP,580011,0,1,5,6,
Ottawa,Governor,Mary Fallin,REP,580011,1,2,25,28,
Ottawa,Superintendent of Public Instruction,Brian Kelly,REP,580011,0,0,7,7,
Ottawa,Superintendent of Public Instruction,Janet Costello Barresi,REP,580011,0,2,8,10,
Ottawa,Superintendent of Public Instruction,Joy Hofmeister,REP,580011,1,3,21,25,
Ottawa,Insurance Commissioner,Bill Viner,REP,580011,0,0,13,13,
Ottawa,Insurance Commissioner,John Doak,REP,580011,1,5,19,25,
Ottawa,Corporation Commissioner,Todd Hiett,REP,580011,0,2,24,26,
Ottawa,Corporation Commissioner,Cliff Branan,REP,580011,1,3,10,14,
Ottawa,U.S. Senate,Evelyn Rogers,REP,580011,0,0,1,1,
Ottawa,U.S. Senate,Rob Moye,REP,580011,0,0,0,0,
Ottawa,U.S. Senate,D. Jean Mcbride-Samuels,REP,580011,0,0,0,0,
Ottawa,U.S. Senate,Jim Inhofe,REP,580011,1,5,30,36,
Ottawa,U.S. Senate,Erick Paul Wyatt,REP,580011,0,0,4,4,
Ottawa,U.S. Senate,Andy Craig,REP,580011,0,0,1,1,
Ottawa,U.S. Senate,T. Shannon,REP,580011,1,2,16,19,
Ottawa,U.S. Senate,Randy Brogdon,REP,580011,0,0,6,6,
Ottawa,U.S. Senate,Eric Mccray,REP,580011,0,0,2,2,
Ottawa,U.S. Senate,Kevin Crow,REP,580011,0,0,1,1,
Ottawa,U.S. Senate,James Lankford,REP,580011,0,3,10,13,
Ottawa,U.S. Senate,Jason Weger,REP,580011,0,0,0,0,
Ottawa,U.S. House,Darrel Robertson,REP,580011,0,2,13,15,02
Ottawa,U.S. House,Markwayne Mullin,REP,580011,1,3,21,25,02
Ottawa,Superintendent of Public Instruction,John Cox,DEM,580012,0,1,31,32,
Ottawa,Superintendent of Public Instruction,Jack Jr.,DEM,580012,0,1,22,23,
Ottawa,Superintendent of Public Instruction,Ivan Holmes,DEM,580012,0,0,5,5,
Ottawa,Superintendent of Public Instruction,Freda Deskin,DEM,580012,2,0,22,24,
Ottawa,U.S. Senate,Patrick Michael Hayes,DEM,580012,0,1,26,27,
Ottawa,U.S. Senate,Jim Rogers,DEM,580012,2,1,23,26,
Ottawa,U.S. Senate,Connie Johnson,DEM,580012,0,0,30,30,
Ottawa,U.S. House,Earl Everett,DEM,580012,0,0,30,30,02
Ottawa,U.S. House,Joshua Harris-Till,DEM,580012,2,2,43,47,02
Ottawa,State House,Donnie Howe,DEM,580012,0,2,25,27,7
Ottawa,State House,Ben Loring,DEM,580012,2,0,60,62,7
Ottawa,Governor,Dax Ewbank,REP,580012,1,4,1,6,
Ottawa,Governor,Chad Moody,REP,580012,0,0,8,8,
Ottawa,Governor,Mary Fallin,REP,580012,0,2,18,20,
Ottawa,Superintendent of Public Instruction,Brian Kelly,REP,580012,1,1,6,8,
Ottawa,Superintendent of Public Instruction,Janet Costello Barresi,REP,580012,0,0,7,7,
Ottawa,Superintendent of Public Instruction,Joy Hofmeister,REP,580012,0,5,13,18,
Ottawa,Insurance Commissioner,Bill Viner,REP,580012,0,1,7,8,
Ottawa,Insurance Commissioner,John Doak,REP,580012,1,5,17,23,
Ottawa,Corporation Commissioner,Todd Hiett,REP,580012,1,4,15,20,
Ottawa,Corporation Commissioner,Cliff Branan,REP,580012,0,1,10,11,
Ottawa,U.S. Senate,Evelyn Rogers,REP,580012,0,0,4,4,
Ottawa,U.S. Senate,Rob Moye,REP,580012,0,0,2,2,
Ottawa,U.S. Senate,D. Jean Mcbride-Samuels,REP,580012,0,0,1,1,
Ottawa,U.S. Senate,Jim Inhofe,REP,580012,1,6,17,24,
Ottawa,U.S. Senate,Erick Paul Wyatt,REP,580012,0,0,3,3,
Ottawa,U.S. Senate,Andy Craig,REP,580012,0,0,2,2,
Ottawa,U.S. Senate,T. Shannon,REP,580012,0,1,12,13,
Ottawa,U.S. Senate,Randy Brogdon,REP,580012,0,4,2,6,
Ottawa,U.S. Senate,Eric Mccray,REP,580012,0,0,1,1,
Ottawa,U.S. Senate,Kevin Crow,REP,580012,0,1,2,3,
Ottawa,U.S. Senate,James Lankford,REP,580012,1,0,6,7,
Ottawa,U.S. Senate,Jason Weger,REP,580012,0,0,2,2,
Ottawa,U.S. House,Darrel Robertson,REP,580012,0,2,11,13,02
Ottawa,U.S. House,Markwayne Mullin,REP,580012,1,3,16,20,02
Ottawa,Superintendent of Public Instruction,John Cox,DEM,580014,1,1,77,79,
Ottawa,Superintendent of Public Instruction,Jack Jr.,DEM,580014,0,0,26,26,
Ottawa,Superintendent of Public Instruction,Ivan Holmes,DEM,580014,0,0,13,13,
Ottawa,Superintendent of Public Instruction,Freda Deskin,DEM,580014,0,0,23,23,
Ottawa,U.S. Senate,Patrick Michael Hayes,DEM,580014,0,0,42,42,
Ottawa,U.S. Senate,Jim Rogers,DEM,580014,0,1,63,64,
Ottawa,U.S. Senate,Connie Johnson,DEM,580014,1,0,33,34,
Ottawa,U.S. House,Earl Everett,DEM,580014,0,1,77,78,02
Ottawa,U.S. House,Joshua Harris-Till,DEM,580014,1,0,55,56,02
Ottawa,State House,Donnie Howe,DEM,580014,0,0,62,62,7
Ottawa,State House,Ben Loring,DEM,580014,1,1,82,84,7
Ottawa,Governor,Dax Ewbank,REP,580014,0,0,4,4,
Ottawa,Governor,Chad Moody,REP,580014,0,1,9,10,
Ottawa,Governor,Mary Fallin,REP,580014,0,1,34,35,
Ottawa,Superintendent of Public Instruction,Brian Kelly,REP,580014,0,0,20,20,
Ottawa,Superintendent of Public Instruction,Janet Costello Barresi,REP,580014,0,0,3,3,
Ottawa,Superintendent of Public Instruction,Joy Hofmeister,REP,580014,0,2,24,26,
Ottawa,Insurance Commissioner,Bill Viner,REP,580014,0,1,16,17,
Ottawa,Insurance Commissioner,John Doak,REP,580014,0,1,30,31,
Ottawa,Corporation Commissioner,Todd Hiett,REP,580014,0,2,22,24,
Ottawa,Corporation Commissioner,Cliff Branan,REP,580014,0,0,24,24,
Ottawa,U.S. Senate,Evelyn Rogers,REP,580014,0,0,6,6,
Ottawa,U.S. Senate,Rob Moye,REP,580014,0,0,0,0,
Ottawa,U.S. Senate,D. Jean Mcbride-Samuels,REP,580014,0,0,1,1,
Ottawa,U.S. Senate,Jim Inhofe,REP,580014,0,2,38,40,
Ottawa,U.S. Senate,Erick Paul Wyatt,REP,580014,0,0,2,2,
Ottawa,U.S. Senate,Andy Craig,REP,580014,0,0,3,3,
Ottawa,U.S. Senate,T. Shannon,REP,580014,0,1,11,12,
Ottawa,U.S. Senate,Randy Brogdon,REP,580014,0,0,0,0,
Ottawa,U.S. Senate,Eric Mccray,REP,580014,0,0,3,3,
Ottawa,U.S. Senate,Kevin Crow,REP,580014,0,0,2,2,
Ottawa,U.S. Senate,James Lankford,REP,580014,0,1,26,27,
Ottawa,U.S. Senate,Jason Weger,REP,580014,0,0,2,2,
Ottawa,U.S. House,Darrel Robertson,REP,580014,0,1,18,19,02
Ottawa,U.S. House,Markwayne Mullin,REP,580014,0,1,29,30,02
Ottawa,Superintendent of Public Instruction,John Cox,DEM,580023,0,0,38,38,
Ottawa,Superintendent of Public Instruction,Jack Jr.,DEM,580023,0,0,13,13,
Ottawa,Superintendent of Public Instruction,Ivan Holmes,DEM,580023,0,0,11,11,
Ottawa,Superintendent of Public Instruction,Freda Deskin,DEM,580023,0,0,13,13,
Ottawa,U.S. Senate,Patrick Michael Hayes,DEM,580023,0,0,16,16,
Ottawa,U.S. Senate,Jim Rogers,DEM,580023,0,0,42,42,
Ottawa,U.S. Senate,Connie Johnson,DEM,580023,0,0,14,14,
Ottawa,U.S. House,Earl Everett,DEM,580023,0,0,50,50,02
Ottawa,U.S. House,Joshua Harris-Till,DEM,580023,0,0,23,23,02
Ottawa,State House,Donnie Howe,DEM,580023,0,0,33,33,7
Ottawa,State House,Ben Loring,DEM,580023,0,0,46,46,7
Ottawa,Governor,Dax Ewbank,REP,580023,0,0,2,2,
Ottawa,Governor,Chad Moody,REP,580023,0,0,7,7,
Ottawa,Governor,Mary Fallin,REP,580023,0,2,13,15,
Ottawa,Superintendent of Public Instruction,Brian Kelly,REP,580023,0,2,5,7,
Ottawa,Superintendent of Public Instruction,Janet Costello Barresi,REP,580023,0,0,2,2,
Ottawa,Superintendent of Public Instruction,Joy Hofmeister,REP,580023,0,0,11,11,
Ottawa,Insurance Commissioner,Bill Viner,REP,580023,0,2,8,10,
Ottawa,Insurance Commissioner,John Doak,REP,580023,0,0,10,10,
Ottawa,Corporation Commissioner,Todd Hiett,REP,580023,0,2,9,11,
Ottawa,Corporation Commissioner,Cliff Branan,REP,580023,0,0,8,8,
Ottawa,U.S. Senate,Evelyn Rogers,REP,580023,0,0,0,0,
Ottawa,U.S. Senate,Rob Moye,REP,580023,0,0,2,2,
Ottawa,U.S. Senate,D. Jean Mcbride-Samuels,REP,580023,0,0,0,0,
Ottawa,U.S. Senate,Jim Inhofe,REP,580023,0,2,16,18,
Ottawa,U.S. Senate,Erick Paul Wyatt,REP,580023,0,0,4,4,
Ottawa,U.S. Senate,Andy Craig,REP,580023,0,2,2,4,
Ottawa,U.S. Senate,T. Shannon,REP,580023,0,0,10,10,
Ottawa,U.S. Senate,Randy Brogdon,REP,580023,0,0,0,0,
Ottawa,U.S. Senate,Eric Mccray,REP,580023,0,0,0,0,
Ottawa,U.S. Senate,Kevin Crow,REP,580023,0,0,3,3,
Ottawa,U.S. Senate,James Lankford,REP,580023,0,0,5,5,
Ottawa,U.S. Senate,Jason Weger,REP,580023,0,0,1,1,
Ottawa,U.S. House,Darrel Robertson,REP,580023,0,2,9,11,02
Ottawa,U.S. House,Markwayne Mullin,REP,580023,0,0,12,12,02
Ottawa,Superintendent of Public Instruction,John Cox,DEM,580024,0,0,15,15,
Ottawa,Superintendent of Public Instruction,Jack Jr.,DEM,580024,0,1,8,9,
Ottawa,Superintendent of Public Instruction,Ivan Holmes,DEM,580024,0,0,2,2,
Ottawa,Superintendent of Public Instruction,Freda Deskin,DEM,580024,0,0,6,6,
Ottawa,U.S. Senate,Patrick Michael Hayes,DEM,580024,0,0,6,6,
Ottawa,U.S. Senate,Jim Rogers,DEM,580024,0,1,12,13,
Ottawa,U.S. Senate,Connie Johnson,DEM,580024,0,0,13,13,
Ottawa,U.S. House,Earl Everett,DEM,580024,0,0,17,17,02
Ottawa,U.S. House,Joshua Harris-Till,DEM,580024,0,1,14,15,02
Ottawa,State House,Donnie Howe,DEM,580024,0,0,13,13,7
Ottawa,State House,Ben Loring,DEM,580024,0,1,21,22,7
Ottawa,Governor,Dax Ewbank,REP,580024,0,0,1,1,
Ottawa,Governor,Chad Moody,REP,580024,0,0,0,0,
Ottawa,Governor,Mary Fallin,REP,580024,0,0,10,10,
Ottawa,Superintendent of Public Instruction,Brian Kelly,REP,580024,0,0,5,5,
Ottawa,Superintendent of Public Instruction,Janet Costello Barresi,REP,580024,0,0,2,2,
Ottawa,Superintendent of Public Instruction,Joy Hofmeister,REP,580024,0,0,4,4,
Ottawa,Insurance Commissioner,Bill Viner,REP,580024,0,0,4,4,
Ottawa,Insurance Commissioner,John Doak,REP,580024,0,0,7,7,
Ottawa,Corporation Commissioner,Todd Hiett,REP,580024,0,0,6,6,
Ottawa,Corporation Commissioner,Cliff Branan,REP,580024,0,0,4,4,
Ottawa,U.S. Senate,Evelyn Rogers,REP,580024,0,0,0,0,
Ottawa,U.S. Senate,Rob Moye,REP,580024,0,0,1,1,
Ottawa,U.S. Senate,D. Jean Mcbride-Samuels,REP,580024,0,0,0,0,
Ottawa,U.S. Senate,Jim Inhofe,REP,580024,0,0,7,7,
Ottawa,U.S. Senate,Erick Paul Wyatt,REP,580024,0,0,3,3,
Ottawa,U.S. Senate,Andy Craig,REP,580024,0,0,0,0,
Ottawa,U.S. Senate,T. Shannon,REP,580024,0,0,5,5,
Ottawa,U.S. Senate,Randy Brogdon,REP,580024,0,0,2,2,
Ottawa,U.S. Senate,Eric Mccray,REP,580024,0,0,0,0,
Ottawa,U.S. Senate,Kevin Crow,REP,580024,0,0,0,0,
Ottawa,U.S. Senate,James Lankford,REP,580024,0,0,4,4,
Ottawa,U.S. Senate,Jason Weger,REP,580024,0,0,0,0,
Ottawa,U.S. House,Darrel Robertson,REP,580024,0,0,4,4,02
Ottawa,U.S. House,Markwayne Mullin,REP,580024,0,0,7,7,02
Ottawa,Superintendent of Public Instruction,John Cox,DEM,580025,2,1,44,47,
Ottawa,Superintendent of Public Instruction,Jack Jr.,DEM,580025,0,0,14,14,
Ottawa,Superintendent of Public Instruction,Ivan Holmes,DEM,580025,0,0,6,6,
Ottawa,Superintendent of Public Instruction,Freda Deskin,DEM,580025,0,1,13,14,
Ottawa,U.S. Senate,Patrick Michael Hayes,DEM,580025,1,0,21,22,
Ottawa,U.S. Senate,Jim Rogers,DEM,580025,1,1,31,33,
Ottawa,U.S. Senate,Connie Johnson,DEM,580025,0,1,24,25,
Ottawa,U.S. House,Earl Everett,DEM,580025,2,2,39,43,02
Ottawa,U.S. House,Joshua Harris-Till,DEM,580025,0,0,33,33,02
Ottawa,State House,Donnie Howe,DEM,580025,0,1,26,27,7
Ottawa,State House,Ben Loring,DEM,580025,2,1,53,56,7
Ottawa,Governor,Dax Ewbank,REP,580025,0,2,6,8,
Ottawa,Governor,Chad Moody,REP,580025,0,0,4,4,
Ottawa,Governor,Mary Fallin,REP,580025,0,0,43,43,
Ottawa,Superintendent of Public Instruction,Brian Kelly,REP,580025,0,0,18,18,
Ottawa,Superintendent of Public Instruction,Janet Costello Barresi,REP,580025,0,0,6,6,
Ottawa,Superintendent of Public Instruction,Joy Hofmeister,REP,580025,0,2,27,29,
Ottawa,Insurance Commissioner,Bill Viner,REP,580025,0,1,25,26,
Ottawa,Insurance Commissioner,John Doak,REP,580025,0,1,25,26,
Ottawa,Corporation Commissioner,Todd Hiett,REP,580025,0,2,23,25,
Ottawa,Corporation Commissioner,Cliff Branan,REP,580025,0,0,26,26,
Ottawa,U.S. Senate,Evelyn Rogers,REP,580025,0,0,2,2,
Ottawa,U.S. Senate,Rob Moye,REP,580025,0,0,2,2,
Ottawa,U.S. Senate,D. Jean Mcbride-Samuels,REP,580025,0,0,2,2,
Ottawa,U.S. Senate,Jim Inhofe,REP,580025,0,0,42,42,
Ottawa,U.S. Senate,Erick Paul Wyatt,REP,580025,0,2,4,6,
Ottawa,U.S. Senate,Andy Craig,REP,580025,0,0,1,1,
Ottawa,U.S. Senate,T. Shannon,REP,580025,0,0,28,28,
Ottawa,U.S. Senate,Randy Brogdon,REP,580025,0,0,6,6,
Ottawa,U.S. Senate,Eric Mccray,REP,580025,0,0,1,1,
Ottawa,U.S. Senate,Kevin Crow,REP,580025,0,0,1,1,
Ottawa,U.S. Senate,James Lankford,REP,580025,0,2,17,19,
Ottawa,U.S. Senate,Jason Weger,REP,580025,0,0,0,0,
Ottawa,U.S. House,Darrel Robertson,REP,580025,0,0,22,22,02
Ottawa,U.S. House,Markwayne Mullin,REP,580025,0,2,33,35,02
Ottawa,Superintendent of Public Instruction,John Cox,DEM,580026,0,0,28,28,
Ottawa,Superintendent of Public Instruction,Jack Jr.,DEM,580026,0,0,6,6,
Ottawa,Superintendent of Public Instruction,Ivan Holmes,DEM,580026,0,0,8,8,
Ottawa,Superintendent of Public Instruction,Freda Deskin,DEM,580026,0,0,16,16,
Ottawa,U.S. Senate,Patrick Michael Hayes,DEM,580026,0,0,8,8,
Ottawa,U.S. Senate,Jim Rogers,DEM,580026,0,0,21,21,
Ottawa,U.S. Senate,Connie Johnson,DEM,580026,0,0,25,25,
Ottawa,U.S. House,Earl Everett,DEM,580026,0,0,31,31,02
Ottawa,U.S. House,Joshua Harris-Till,DEM,580026,0,0,23,23,02
Ottawa,State House,Donnie Howe,DEM,580026,0,0,19,19,7
Ottawa,State House,Ben Loring,DEM,580026,0,0,41,41,7
Ottawa,Governor,Dax Ewbank,REP,580026,0,0,6,6,
Ottawa,Governor,Chad Moody,REP,580026,0,0,8,8,
Ottawa,Governor,Mary Fallin,REP,580026,2,0,55,57,
Ottawa,Superintendent of Public Instruction,Brian Kelly,REP,580026,1,0,21,22,
Ottawa,Superintendent of Public Instruction,Janet Costello Barresi,REP,580026,0,0,8,8,
Ottawa,Superintendent of Public Instruction,Joy Hofmeister,REP,580026,1,0,39,40,
Ottawa,Insurance Commissioner,Bill Viner,REP,580026,1,0,21,22,
Ottawa,Insurance Commissioner,John Doak,REP,580026,1,0,43,44,
Ottawa,Corporation Commissioner,Todd Hiett,REP,580026,1,0,30,31,
Ottawa,Corporation Commissioner,Cliff Branan,REP,580026,1,0,34,35,
Ottawa,U.S. Senate,Evelyn Rogers,REP,580026,0,0,1,1,
Ottawa,U.S. Senate,Rob Moye,REP,580026,0,0,3,3,
Ottawa,U.S. Senate,D. Jean Mcbride-Samuels,REP,580026,0,0,1,1,
Ottawa,U.S. Senate,Jim Inhofe,REP,580026,2,0,58,60,
Ottawa,U.S. Senate,Erick Paul Wyatt,REP,580026,0,0,5,5,
Ottawa,U.S. Senate,Andy Craig,REP,580026,0,0,1,1,
Ottawa,U.S. Senate,T. Shannon,REP,580026,1,0,36,37,
Ottawa,U.S. Senate,Randy Brogdon,REP,580026,0,0,1,1,
Ottawa,U.S. Senate,Eric Mccray,REP,580026,0,0,4,4,
Ottawa,U.S. Senate,Kevin Crow,REP,580026,1,0,3,4,
Ottawa,U.S. Senate,James Lankford,REP,580026,0,0,22,22,
Ottawa,U.S. Senate,Jason Weger,REP,580026,0,0,1,1,
Ottawa,U.S. House,Darrel Robertson,REP,580026,1,0,33,34,02
Ottawa,U.S. House,Markwayne Mullin,REP,580026,1,0,35,36,02
Ottawa,Superintendent of Public Instruction,John Cox,DEM,580028,3,0,69,72,
Ottawa,Superintendent of Public Instruction,Jack Jr.,DEM,580028,1,0,18,19,
Ottawa,Superintendent of Public Instruction,Ivan Holmes,DEM,580028,0,2,11,13,
Ottawa,Superintendent of Public Instruction,Freda Deskin,DEM,580028,1,2,24,27,
Ottawa,U.S. Senate,Patrick Michael Hayes,DEM,580028,1,1,27,29,
Ottawa,U.S. Senate,Jim Rogers,DEM,580028,3,0,52,55,
Ottawa,U.S. Senate,Connie Johnson,DEM,580028,0,3,38,41,
Ottawa,U.S. House,Earl Everett,DEM,580028,2,2,81,85,02
Ottawa,U.S. House,Joshua Harris-Till,DEM,580028,3,1,36,40,02
Ottawa,State House,Donnie Howe,DEM,580028,1,1,42,44,7
Ottawa,State House,Ben Loring,DEM,580028,4,4,86,94,7
Ottawa,Governor,Dax Ewbank,REP,580028,0,0,10,10,
Ottawa,Governor,Chad Moody,REP,580028,1,1,11,13,
Ottawa,Governor,Mary Fallin,REP,580028,0,1,83,84,
Ottawa,Superintendent of Public Instruction,Brian Kelly,REP,580028,0,1,27,28,
Ottawa,Superintendent of Public Instruction,Janet Costello Barresi,REP,580028,0,1,20,21,
Ottawa,Superintendent of Public Instruction,Joy Hofmeister,REP,580028,1,0,57,58,
Ottawa,Insurance Commissioner,Bill Viner,REP,580028,0,1,28,29,
Ottawa,Insurance Commissioner,John Doak,REP,580028,1,1,66,68,
Ottawa,Corporation Commissioner,Todd Hiett,REP,580028,1,0,62,63,
Ottawa,Corporation Commissioner,Cliff Branan,REP,580028,0,2,34,36,
Ottawa,U.S. Senate,Evelyn Rogers,REP,580028,0,0,7,7,
Ottawa,U.S. Senate,Rob Moye,REP,580028,0,0,0,0,
Ottawa,U.S. Senate,D. Jean Mcbride-Samuels,REP,580028,0,0,2,2,
Ottawa,U.S. Senate,Jim Inhofe,REP,580028,1,2,82,85,
Ottawa,U.S. Senate,Erick Paul Wyatt,REP,580028,0,0,13,13,
Ottawa,U.S. Senate,Andy Craig,REP,580028,0,0,0,0,
Ottawa,U.S. Senate,T. Shannon,REP,580028,0,2,47,49,
Ottawa,U.S. Senate,Randy Brogdon,REP,580028,1,0,7,8,
Ottawa,U.S. Senate,Eric Mccray,REP,580028,0,0,0,0,
Ottawa,U.S. Senate,Kevin Crow,REP,580028,0,0,3,3,
Ottawa,U.S. Senate,James Lankford,REP,580028,0,0,43,43,
Ottawa,U.S. Senate,Jason Weger,REP,580028,0,0,4,4,
Ottawa,U.S. House,Darrel Robertson,REP,580028,1,0,33,34,02
Ottawa,U.S. House,Markwayne Mullin,REP,580028,0,2,70,72,02
Ottawa,Superintendent of Public Instruction,John Cox,DEM,580031,3,5,76,84,
Ottawa,Superintendent of Public Instruction,Jack Jr.,DEM,580031,0,0,29,29,
Ottawa,Superintendent of Public Instruction,Ivan Holmes,DEM,580031,0,0,12,12,
Ottawa,Superintendent of Public Instruction,Freda Deskin,DEM,580031,0,2,31,33,
Ottawa,U.S. Senate,Patrick Michael Hayes,DEM,580031,2,5,37,44,
Ottawa,U.S. Senate,Jim Rogers,DEM,580031,1,2,52,55,
Ottawa,U.S. Senate,Connie Johnson,DEM,580031,0,0,55,55,
Ottawa,U.S. House,Earl Everett,DEM,580031,1,5,89,95,02
Ottawa,U.S. House,Joshua Harris-Till,DEM,580031,2,2,51,55,02
Ottawa,State House,Donnie Howe,DEM,580031,2,1,51,54,7
Ottawa,State House,Ben Loring,DEM,580031,1,8,106,115,7
Ottawa,Governor,Dax Ewbank,REP,580031,0,2,5,7,
Ottawa,Governor,Chad Moody,REP,580031,0,0,7,7,
Ottawa,Governor,Mary Fallin,REP,580031,0,2,53,55,
Ottawa,Superintendent of Public Instruction,Brian Kelly,REP,580031,0,1,12,13,
Ottawa,Superintendent of Public Instruction,Janet Costello Barresi,REP,580031,0,0,12,12,
Ottawa,Superintendent of Public Instruction,Joy Hofmeister,REP,580031,0,3,43,46,
Ottawa,Insurance Commissioner,Bill Viner,REP,580031,0,0,12,12,
Ottawa,Insurance Commissioner,John Doak,REP,580031,0,3,48,51,
Ottawa,Corporation Commissioner,Todd Hiett,REP,580031,0,4,35,39,
Ottawa,Corporation Commissioner,Cliff Branan,REP,580031,0,0,27,27,
Ottawa,U.S. Senate,Evelyn Rogers,REP,580031,0,1,0,1,
Ottawa,U.S. Senate,Rob Moye,REP,580031,0,0,1,1,
Ottawa,U.S. Senate,D. Jean Mcbride-Samuels,REP,580031,0,0,1,1,
Ottawa,U.S. Senate,Jim Inhofe,REP,580031,0,2,51,53,
Ottawa,U.S. Senate,Erick Paul Wyatt,REP,580031,0,1,12,13,
Ottawa,U.S. Senate,Andy Craig,REP,580031,0,0,1,1,
Ottawa,U.S. Senate,T. Shannon,REP,580031,0,0,35,35,
Ottawa,U.S. Senate,Randy Brogdon,REP,580031,0,0,6,6,
Ottawa,U.S. Senate,Eric Mccray,REP,580031,0,0,0,0,
Ottawa,U.S. Senate,Kevin Crow,REP,580031,0,0,3,3,
Ottawa,U.S. Senate,James Lankford,REP,580031,0,4,19,23,
Ottawa,U.S. Senate,Jason Weger,REP,580031,0,0,1,1,
Ottawa,U.S. House,Darrel Robertson,REP,580031,0,0,26,26,02
Ottawa,U.S. House,Markwayne Mullin,REP,580031,0,4,40,44,02
Ottawa,Superintendent of Public Instruction,John Cox,DEM,580034,0,3,29,32,
Ottawa,Superintendent of Public Instruction,Jack Jr.,DEM,580034,0,0,8,8,
Ottawa,Superintendent of Public Instruction,Ivan Holmes,DEM,580034,0,1,12,13,
Ottawa,Superintendent of Public Instruction,Freda Deskin,DEM,580034,0,0,32,32,
Ottawa,U.S. Senate,Patrick Michael Hayes,DEM,580034,0,1,19,20,
Ottawa,U.S. Senate,Jim Rogers,DEM,580034,0,1,29,30,
Ottawa,U.S. Senate,Connie Johnson,DEM,580034,0,2,32,34,
Ottawa,U.S. House,Earl Everett,DEM,580034,0,2,43,45,02
Ottawa,U.S. House,Joshua Harris-Till,DEM,580034,0,2,35,37,02
Ottawa,State House,Donnie Howe,DEM,580034,0,2,32,34,7
Ottawa,State House,Ben Loring,DEM,580034,0,2,53,55,7
Ottawa,Governor,Dax Ewbank,REP,580034,0,0,2,2,
Ottawa,Governor,Chad Moody,REP,580034,0,1,8,9,
Ottawa,Governor,Mary Fallin,REP,580034,1,2,30,33,
Ottawa,Superintendent of Public Instruction,Brian Kelly,REP,580034,0,1,12,13,
Ottawa,Superintendent of Public Instruction,Janet Costello Barresi,REP,580034,0,0,3,3,
Ottawa,Superintendent of Public Instruction,Joy Hofmeister,REP,580034,1,2,23,26,
Ottawa,Insurance Commissioner,Bill Viner,REP,580034,1,1,10,12,
Ottawa,Insurance Commissioner,John Doak,REP,580034,0,2,26,28,
Ottawa,Corporation Commissioner,Todd Hiett,REP,580034,1,2,24,27,
Ottawa,Corporation Commissioner,Cliff Branan,REP,580034,0,1,7,8,
Ottawa,U.S. Senate,Evelyn Rogers,REP,580034,0,0,2,2,
Ottawa,U.S. Senate,Rob Moye,REP,580034,0,0,2,2,
Ottawa,U.S. Senate,D. Jean Mcbride-Samuels,REP,580034,0,0,1,1,
Ottawa,U.S. Senate,Jim Inhofe,REP,580034,0,3,30,33,
Ottawa,U.S. Senate,Erick Paul Wyatt,REP,580034,1,0,4,5,
Ottawa,U.S. Senate,Andy Craig,REP,580034,1,0,1,2,
Ottawa,U.S. Senate,T. Shannon,REP,580034,0,0,17,17,
Ottawa,U.S. Senate,Randy Brogdon,REP,580034,0,1,2,3,
Ottawa,U.S. Senate,Eric Mccray,REP,580034,0,0,0,0,
Ottawa,U.S. Senate,Kevin Crow,REP,580034,0,0,0,0,
Ottawa,U.S. Senate,James Lankford,REP,580034,0,2,20,22,
Ottawa,U.S. Senate,Jason Weger,REP,580034,0,0,0,0,
Ottawa,U.S. House,Darrel Robertson,REP,580034,0,1,16,17,02
Ottawa,U.S. House,Markwayne Mullin,REP,580034,1,2,23,26,02
Pawnee,Superintendent of Public Instruction,John Cox,DEM,590104,1,13,60,74,
Pawnee,Superintendent of Public Instruction,Jack Jr.,DEM,590104,0,1,17,18,
Pawnee,Superintendent of Public Instruction,Ivan Holmes,DEM,590104,0,2,15,17,
Pawnee,Superintendent of Public Instruction,Freda Deskin,DEM,590104,0,6,57,63,
Pawnee,U.S. Senate,Patrick Michael Hayes,DEM,590104,0,5,29,34,
Pawnee,U.S. Senate,Jim Rogers,DEM,590104,1,8,76,85,
Pawnee,U.S. Senate,Connie Johnson,DEM,590104,0,8,40,48,
Pawnee,Governor,Dax Ewbank,REP,590104,0,1,13,14,
Pawnee,Governor,Chad Moody,REP,590104,0,0,25,25,
Pawnee,Governor,Mary Fallin,REP,590104,0,6,80,86,
Pawnee,Superintendent of Public Instruction,Brian Kelly,REP,590104,0,2,35,37,
Pawnee,Superintendent of Public Instruction,Janet Costello Barresi,REP,590104,0,1,16,17,
Pawnee,Superintendent of Public Instruction,Joy Hofmeister,REP,590104,0,4,68,72,
Pawnee,Insurance Commissioner,Bill Viner,REP,590104,0,0,22,22,
Pawnee,Insurance Commissioner,John Doak,REP,590104,0,7,92,99,
Pawnee,Corporation Commissioner,Todd Hiett,REP,590104,0,5,65,70,
Pawnee,Corporation Commissioner,Cliff Branan,REP,590104,0,2,50,52,
Pawnee,U.S. Senate,Evelyn Rogers,REP,590104,0,1,8,9,
Pawnee,U.S. Senate,Rob Moye,REP,590104,0,1,4,5,
Pawnee,U.S. Senate,D. Jean Mcbride-Samuels,REP,590104,0,0,1,1,
Pawnee,U.S. Senate,Jim Inhofe,REP,590104,0,5,98,103,
Pawnee,U.S. Senate,Erick Paul Wyatt,REP,590104,0,0,7,7,
Pawnee,U.S. Senate,Andy Craig,REP,590104,0,0,1,1,
Pawnee,U.S. Senate,T. Shannon,REP,590104,0,4,60,64,
Pawnee,U.S. Senate,Randy Brogdon,REP,590104,0,0,9,9,
Pawnee,U.S. Senate,Eric Mccray,REP,590104,0,0,2,2,
Pawnee,U.S. Senate,Kevin Crow,REP,590104,0,0,1,1,
Pawnee,U.S. Senate,James Lankford,REP,590104,0,3,45,48,
Pawnee,U.S. Senate,Jason Weger,REP,590104,0,0,1,1,
Pawnee,U.S. House,Timothy Ray Murray,REP,590104,0,0,12,12,03
Pawnee,U.S. House,Robert Hubbard,REP,590104,0,2,17,19,03
Pawnee,U.S. House,Frank Lucas,REP,590104,0,5,90,95,03
Pawnee,State Senate,Dan Ladd,REP,590104,0,1,47,48,20
Pawnee,State Senate,A Griffin,REP,590104,0,6,68,74,20
Pawnee,Superintendent of Public Instruction,John Cox,DEM,590111,0,2,26,28,
Pawnee,Superintendent of Public Instruction,Jack Jr.,DEM,590111,0,0,7,7,
Pawnee,Superintendent of Public Instruction,Ivan Holmes,DEM,590111,0,0,8,8,
Pawnee,Superintendent of Public Instruction,Freda Deskin,DEM,590111,0,0,29,29,
Pawnee,U.S. Senate,Patrick Michael Hayes,DEM,590111,0,1,7,8,
Pawnee,U.S. Senate,Jim Rogers,DEM,590111,0,0,22,22,
Pawnee,U.S. Senate,Connie Johnson,DEM,590111,0,1,37,38,
Pawnee,Governor,Dax Ewbank,REP,590111,0,0,4,4,
Pawnee,Governor,Chad Moody,REP,590111,0,0,9,9,
Pawnee,Governor,Mary Fallin,REP,590111,0,0,53,53,
Pawnee,Superintendent of Public Instruction,Brian Kelly,REP,590111,0,0,20,20,
Pawnee,Superintendent of Public Instruction,Janet Costello Barresi,REP,590111,0,0,9,9,
Pawnee,Superintendent of Public Instruction,Joy Hofmeister,REP,590111,0,0,36,36,
Pawnee,Insurance Commissioner,Bill Viner,REP,590111,0,0,12,12,
Pawnee,Insurance Commissioner,John Doak,REP,590111,0,0,49,49,
Pawnee,Corporation Commissioner,Todd Hiett,REP,590111,0,0,38,38,
Pawnee,Corporation Commissioner,Cliff Branan,REP,590111,0,0,27,27,
Pawnee,U.S. Senate,Evelyn Rogers,REP,590111,0,0,4,4,
Pawnee,U.S. Senate,Rob Moye,REP,590111,0,0,2,2,
Pawnee,U.S. Senate,D. Jean Mcbride-Samuels,REP,590111,0,0,0,0,
Pawnee,U.S. Senate,Jim Inhofe,REP,590111,0,0,53,53,
Pawnee,U.S. Senate,Erick Paul Wyatt,REP,590111,0,0,6,6,
Pawnee,U.S. Senate,Andy Craig,REP,590111,0,0,2,2,
Pawnee,U.S. Senate,T. Shannon,REP,590111,0,0,31,31,
Pawnee,U.S. Senate,Randy Brogdon,REP,590111,0,0,3,3,
Pawnee,U.S. Senate,Eric Mccray,REP,590111,0,0,1,1,
Pawnee,U.S. Senate,Kevin Crow,REP,590111,0,0,0,0,
Pawnee,U.S. Senate,James Lankford,REP,590111,0,0,27,27,
Pawnee,U.S. Senate,Jason Weger,REP,590111,0,0,2,2,
Pawnee,U.S. House,Timothy Ray Murray,REP,590111,0,0,5,5,03
Pawnee,U.S. House,Robert Hubbard,REP,590111,0,0,7,7,03
Pawnee,U.S. House,Frank Lucas,REP,590111,0,0,53,53,03
Pawnee,State Senate,Dan Ladd,REP,590111,0,0,20,20,20
Pawnee,State Senate,A Griffin,REP,590111,0,0,43,43,20
Pawnee,Superintendent of Public Instruction,John Cox,DEM,590112,0,0,27,27,
Pawnee,Superintendent of Public Instruction,Jack Jr.,DEM,590112,0,0,7,7,
Pawnee,Superintendent of Public Instruction,Ivan Holmes,DEM,590112,0,0,3,3,
Pawnee,Superintendent of Public Instruction,Freda Deskin,DEM,590112,0,0,12,12,
Pawnee,U.S. Senate,Patrick Michael Hayes,DEM,590112,0,0,15,15,
Pawnee,U.S. Senate,Jim Rogers,DEM,590112,0,0,19,19,
Pawnee,U.S. Senate,Connie Johnson,DEM,590112,0,0,15,15,
Pawnee,Governor,Dax Ewbank,REP,590112,0,0,7,7,
Pawnee,Governor,Chad Moody,REP,590112,0,0,4,4,
Pawnee,Governor,Mary Fallin,REP,590112,0,0,39,39,
Pawnee,Superintendent of Public Instruction,Brian Kelly,REP,590112,0,0,15,15,
Pawnee,Superintendent of Public Instruction,Janet Costello Barresi,REP,590112,0,0,11,11,
Pawnee,Superintendent of Public Instruction,Joy Hofmeister,REP,590112,0,0,24,24,
Pawnee,Insurance Commissioner,Bill Viner,REP,590112,0,0,19,19,
Pawnee,Insurance Commissioner,John Doak,REP,590112,0,0,28,28,
Pawnee,Corporation Commissioner,Todd Hiett,REP,590112,0,0,31,31,
Pawnee,Corporation Commissioner,Cliff Branan,REP,590112,0,0,17,17,
Pawnee,U.S. Senate,Evelyn Rogers,REP,590112,0,0,0,0,
Pawnee,U.S. Senate,Rob Moye,REP,590112,0,0,1,1,
Pawnee,U.S. Senate,D. Jean Mcbride-Samuels,REP,590112,0,0,0,0,
Pawnee,U.S. Senate,Jim Inhofe,REP,590112,0,0,43,43,
Pawnee,U.S. Senate,Erick Paul Wyatt,REP,590112,0,0,5,5,
Pawnee,U.S. Senate,Andy Craig,REP,590112,0,0,1,1,
Pawnee,U.S. Senate,T. Shannon,REP,590112,0,0,11,11,
Pawnee,U.S. Senate,Randy Brogdon,REP,590112,0,0,10,10,
Pawnee,U.S. Senate,Eric Mccray,REP,590112,0,0,1,1,
Pawnee,U.S. Senate,Kevin Crow,REP,590112,0,0,0,0,
Pawnee,U.S. Senate,James Lankford,REP,590112,0,0,27,27,
Pawnee,U.S. Senate,Jason Weger,REP,590112,0,0,0,0,
Pawnee,U.S. House,Timothy Ray Murray,REP,590112,0,0,4,4,03
Pawnee,U.S. House,Robert Hubbard,REP,590112,0,0,6,6,03
Pawnee,U.S. House,Frank Lucas,REP,590112,0,0,39,39,03
Pawnee,State Senate,Dan Ladd,REP,590112,0,0,15,15,20
Pawnee,State Senate,A Griffin,REP,590112,0,0,32,32,20
Pawnee,Superintendent of Public Instruction,John Cox,DEM,590118,0,0,47,47,
Pawnee,Superintendent of Public Instruction,Jack Jr.,DEM,590118,0,0,15,15,
Pawnee,Superintendent of Public Instruction,Ivan Holmes,DEM,590118,0,0,6,6,
Pawnee,Superintendent of Public Instruction,Freda Deskin,DEM,590118,1,2,38,41,
Pawnee,U.S. Senate,Patrick Michael Hayes,DEM,590118,0,0,18,18,
Pawnee,U.S. Senate,Jim Rogers,DEM,590118,1,0,43,44,
Pawnee,U.S. Senate,Connie Johnson,DEM,590118,0,2,45,47,
Pawnee,Governor,Dax Ewbank,REP,590118,0,0,11,11,
Pawnee,Governor,Chad Moody,REP,590118,0,0,29,29,
Pawnee,Governor,Mary Fallin,REP,590118,4,7,113,124,
Pawnee,Superintendent of Public Instruction,Brian Kelly,REP,590118,0,4,30,34,
Pawnee,Superintendent of Public Instruction,Janet Costello Barresi,REP,590118,0,0,22,22,
Pawnee,Superintendent of Public Instruction,Joy Hofmeister,REP,590118,4,3,96,103,
Pawnee,Insurance Commissioner,Bill Viner,REP,590118,1,4,34,39,
Pawnee,Insurance Commissioner,John Doak,REP,590118,3,3,107,113,
Pawnee,Corporation Commissioner,Todd Hiett,REP,590118,1,2,71,74,
Pawnee,Corporation Commissioner,Cliff Branan,REP,590118,3,5,70,78,
Pawnee,U.S. Senate,Evelyn Rogers,REP,590118,0,0,6,6,
Pawnee,U.S. Senate,Rob Moye,REP,590118,0,0,3,3,
Pawnee,U.S. Senate,D. Jean Mcbride-Samuels,REP,590118,0,0,4,4,
Pawnee,U.S. Senate,Jim Inhofe,REP,590118,3,7,129,139,
Pawnee,U.S. Senate,Erick Paul Wyatt,REP,590118,1,0,9,10,
Pawnee,U.S. Senate,Andy Craig,REP,590118,0,0,1,1,
Pawnee,U.S. Senate,T. Shannon,REP,590118,2,2,62,66,
Pawnee,U.S. Senate,Randy Brogdon,REP,590118,0,0,13,13,
Pawnee,U.S. Senate,Eric Mccray,REP,590118,0,1,2,3,
Pawnee,U.S. Senate,Kevin Crow,REP,590118,0,0,4,4,
Pawnee,U.S. Senate,James Lankford,REP,590118,2,4,71,77,
Pawnee,U.S. Senate,Jason Weger,REP,590118,0,0,0,0,
Pawnee,U.S. House,Timothy Ray Murray,REP,590118,0,0,11,11,03
Pawnee,U.S. House,Robert Hubbard,REP,590118,0,2,9,11,03
Pawnee,U.S. House,Frank Lucas,REP,590118,4,5,129,138,03
Pawnee,State Senate,Dan Ladd,REP,590118,0,1,61,62,20
Pawnee,State Senate,A Griffin,REP,590118,4,6,83,93,20
Pawnee,Superintendent of Public Instruction,John Cox,DEM,590202,2,11,61,74,
Pawnee,Superintendent of Public Instruction,Jack Jr.,DEM,590202,0,4,32,36,
Pawnee,Superintendent of Public Instruction,Ivan Holmes,DEM,590202,1,3,11,15,
Pawnee,Superintendent of Public Instruction,Freda Deskin,DEM,590202,2,6,69,77,
Pawnee,U.S. Senate,Patrick Michael Hayes,DEM,590202,1,8,38,47,
Pawnee,U.S. Senate,Jim Rogers,DEM,590202,1,10,71,82,
Pawnee,U.S. Senate,Connie Johnson,DEM,590202,3,5,60,68,
Pawnee,Governor,Dax Ewbank,REP,590202,0,1,10,11,
Pawnee,Governor,Chad Moody,REP,590202,0,3,26,29,
Pawnee,Governor,Mary Fallin,REP,590202,2,14,97,113,
Pawnee,Superintendent of Public Instruction,Brian Kelly,REP,590202,0,4,33,37,
Pawnee,Superintendent of Public Instruction,Janet Costello Barresi,REP,590202,0,2,18,20,
Pawnee,Superintendent of Public Instruction,Joy Hofmeister,REP,590202,2,11,85,98,
Pawnee,Insurance Commissioner,Bill Viner,REP,590202,0,5,28,33,
Pawnee,Insurance Commissioner,John Doak,REP,590202,2,11,95,108,
Pawnee,Corporation Commissioner,Todd Hiett,REP,590202,1,12,81,94,
Pawnee,Corporation Commissioner,Cliff Branan,REP,590202,1,5,49,55,
Pawnee,U.S. Senate,Evelyn Rogers,REP,590202,0,0,9,9,
Pawnee,U.S. Senate,Rob Moye,REP,590202,0,0,2,2,
Pawnee,U.S. Senate,D. Jean Mcbride-Samuels,REP,590202,0,0,2,2,
Pawnee,U.S. Senate,Jim Inhofe,REP,590202,2,18,117,137,
Pawnee,U.S. Senate,Erick Paul Wyatt,REP,590202,0,0,4,4,
Pawnee,U.S. Senate,Andy Craig,REP,590202,0,0,2,2,
Pawnee,U.S. Senate,T. Shannon,REP,590202,1,12,62,75,
Pawnee,U.S. Senate,Randy Brogdon,REP,590202,0,0,2,2,
Pawnee,U.S. Senate,Eric Mccray,REP,590202,0,0,4,4,
Pawnee,U.S. Senate,Kevin Crow,REP,590202,0,0,4,4,
Pawnee,U.S. Senate,James Lankford,REP,590202,1,6,61,68,
Pawnee,U.S. Senate,Jason Weger,REP,590202,0,0,3,3,
Pawnee,U.S. House,Timothy Ray Murray,REP,590202,0,1,6,7,03
Pawnee,U.S. House,Robert Hubbard,REP,590202,0,1,14,15,03
Pawnee,U.S. House,Frank Lucas,REP,590202,2,16,113,131,03
Pawnee,State Senate,Dan Ladd,REP,590202,0,5,45,50,20
Pawnee,State Senate,A Griffin,REP,590202,2,13,86,101,20
Pawnee,Superintendent of Public Instruction,John Cox,DEM,590215,0,1,7,8,
Pawnee,Superintendent of Public Instruction,Jack Jr.,DEM,590215,0,1,2,3,
Pawnee,Superintendent of Public Instruction,Ivan Holmes,DEM,590215,0,0,1,1,
Pawnee,Superintendent of Public Instruction,Freda Deskin,DEM,590215,0,0,10,10,
Pawnee,U.S. Senate,Patrick Michael Hayes,DEM,590215,0,0,5,5,
Pawnee,U.S. Senate,Jim Rogers,DEM,590215,0,1,10,11,
Pawnee,U.S. Senate,Connie Johnson,DEM,590215,0,1,5,6,
Pawnee,Governor,Dax Ewbank,REP,590215,0,0,2,2,
Pawnee,Governor,Chad Moody,REP,590215,0,0,4,4,
Pawnee,Governor,Mary Fallin,REP,590215,0,0,14,14,
Pawnee,Superintendent of Public Instruction,Brian Kelly,REP,590215,0,0,6,6,
Pawnee,Superintendent of Public Instruction,Janet Costello Barresi,REP,590215,0,0,2,2,
Pawnee,Superintendent of Public Instruction,Joy Hofmeister,REP,590215,0,0,10,10,
Pawnee,Insurance Commissioner,Bill Viner,REP,590215,0,0,2,2,
Pawnee,Insurance Commissioner,John Doak,REP,590215,0,0,15,15,
Pawnee,Corporation Commissioner,Todd Hiett,REP,590215,0,0,11,11,
Pawnee,Corporation Commissioner,Cliff Branan,REP,590215,0,0,9,9,
Pawnee,U.S. Senate,Evelyn Rogers,REP,590215,0,0,1,1,
Pawnee,U.S. Senate,Rob Moye,REP,590215,0,0,1,1,
Pawnee,U.S. Senate,D. Jean Mcbride-Samuels,REP,590215,0,0,0,0,
Pawnee,U.S. Senate,Jim Inhofe,REP,590215,0,0,17,17,
Pawnee,U.S. Senate,Erick Paul Wyatt,REP,590215,0,0,1,1,
Pawnee,U.S. Senate,Andy Craig,REP,590215,0,0,0,0,
Pawnee,U.S. Senate,T. Shannon,REP,590215,0,0,11,11,
Pawnee,U.S. Senate,Randy Brogdon,REP,590215,0,0,0,0,
Pawnee,U.S. Senate,Eric Mccray,REP,590215,0,0,0,0,
Pawnee,U.S. Senate,Kevin Crow,REP,590215,0,0,1,1,
Pawnee,U.S. Senate,James Lankford,REP,590215,0,0,8,8,
Pawnee,U.S. Senate,Jason Weger,REP,590215,0,0,0,0,
Pawnee,U.S. House,Timothy Ray Murray,REP,590215,0,0,0,0,03
Pawnee,U.S. House,Robert Hubbard,REP,590215,0,0,6,6,03
Pawnee,U.S. House,Frank Lucas,REP,590215,0,0,14,14,03
Pawnee,State Senate,Dan Ladd,REP,590215,0,0,7,7,20
Pawnee,State Senate,A Griffin,REP,590215,0,0,12,12,20
Pawnee,Superintendent of Public Instruction,John Cox,DEM,590217,0,2,42,44,
Pawnee,Superintendent of Public Instruction,Jack Jr.,DEM,590217,0,0,20,20,
Pawnee,Superintendent of Public Instruction,Ivan Holmes,DEM,590217,0,0,7,7,
Pawnee,Superintendent of Public Instruction,Freda Deskin,DEM,590217,0,1,29,30,
Pawnee,U.S. Senate,Patrick Michael Hayes,DEM,590217,0,2,18,20,
Pawnee,U.S. Senate,Jim Rogers,DEM,590217,0,1,39,40,
Pawnee,U.S. Senate,Connie Johnson,DEM,590217,0,0,33,33,
Pawnee,Governor,Dax Ewbank,REP,590217,2,0,18,20,
Pawnee,Governor,Chad Moody,REP,590217,1,0,19,20,
Pawnee,Governor,Mary Fallin,REP,590217,1,4,78,83,
Pawnee,Superintendent of Public Instruction,Brian Kelly,REP,590217,0,1,16,17,
Pawnee,Superintendent of Public Instruction,Janet Costello Barresi,REP,590217,0,1,8,9,
Pawnee,Superintendent of Public Instruction,Joy Hofmeister,REP,590217,4,2,91,97,
Pawnee,Insurance Commissioner,Bill Viner,REP,590217,1,0,23,24,
Pawnee,Insurance Commissioner,John Doak,REP,590217,3,2,87,92,
Pawnee,Corporation Commissioner,Todd Hiett,REP,590217,4,3,55,62,
Pawnee,Corporation Commissioner,Cliff Branan,REP,590217,0,1,53,54,
Pawnee,U.S. Senate,Evelyn Rogers,REP,590217,1,0,6,7,
Pawnee,U.S. Senate,Rob Moye,REP,590217,0,1,1,2,
Pawnee,U.S. Senate,D. Jean Mcbride-Samuels,REP,590217,0,0,0,0,
Pawnee,U.S. Senate,Jim Inhofe,REP,590217,3,3,105,111,
Pawnee,U.S. Senate,Erick Paul Wyatt,REP,590217,0,0,2,2,
Pawnee,U.S. Senate,Andy Craig,REP,590217,0,0,2,2,
Pawnee,U.S. Senate,T. Shannon,REP,590217,1,1,41,43,
Pawnee,U.S. Senate,Randy Brogdon,REP,590217,0,0,4,4,
Pawnee,U.S. Senate,Eric Mccray,REP,590217,0,0,0,0,
Pawnee,U.S. Senate,Kevin Crow,REP,590217,0,0,2,2,
Pawnee,U.S. Senate,James Lankford,REP,590217,3,3,63,69,
Pawnee,U.S. Senate,Jason Weger,REP,590217,0,0,2,2,
Pawnee,U.S. House,Timothy Ray Murray,REP,590217,0,0,4,4,03
Pawnee,U.S. House,Robert Hubbard,REP,590217,0,0,20,20,03
Pawnee,U.S. House,Frank Lucas,REP,590217,4,4,88,96,03
Pawnee,State Senate,Dan Ladd,REP,590217,1,0,20,21,20
Pawnee,State Senate,A Griffin,REP,590217,2,4,92,98,20
Pawnee,Superintendent of Public Instruction,John Cox,DEM,590307,0,0,34,34,
Pawnee,Superintendent of Public Instruction,Jack Jr.,DEM,590307,1,0,12,13,
Pawnee,Superintendent of Public Instruction,Ivan Holmes,DEM,590307,0,1,8,9,
Pawnee,Superintendent of Public Instruction,Freda Deskin,DEM,590307,3,1,41,45,
Pawnee,U.S. Senate,Patrick Michael Hayes,DEM,590307,0,1,18,19,
Pawnee,U.S. Senate,Jim Rogers,DEM,590307,0,0,43,43,
Pawnee,U.S. Senate,Connie Johnson,DEM,590307,4,1,29,34,
Pawnee,Governor,Dax Ewbank,REP,590307,0,0,8,8,
Pawnee,Governor,Chad Moody,REP,590307,2,0,18,20,
Pawnee,Governor,Mary Fallin,REP,590307,1,2,144,147,
Pawnee,Superintendent of Public Instruction,Brian Kelly,REP,590307,1,2,30,33,
Pawnee,Superintendent of Public Instruction,Janet Costello Barresi,REP,590307,1,0,29,30,
Pawnee,Superintendent of Public Instruction,Joy Hofmeister,REP,590307,1,1,109,111,
Pawnee,Insurance Commissioner,Bill Viner,REP,590307,0,0,37,37,
Pawnee,Insurance Commissioner,John Doak,REP,590307,3,2,118,123,
Pawnee,Corporation Commissioner,Todd Hiett,REP,590307,1,2,94,97,
Pawnee,Corporation Commissioner,Cliff Branan,REP,590307,2,0,66,68,
Pawnee,U.S. Senate,Evelyn Rogers,REP,590307,1,0,5,6,
Pawnee,U.S. Senate,Rob Moye,REP,590307,0,0,3,3,
Pawnee,U.S. Senate,D. Jean Mcbride-Samuels,REP,590307,0,0,6,6,
Pawnee,U.S. Senate,Jim Inhofe,REP,590307,2,2,151,155,
Pawnee,U.S. Senate,Erick Paul Wyatt,REP,590307,0,0,4,4,
Pawnee,U.S. Senate,Andy Craig,REP,590307,0,0,0,0,
Pawnee,U.S. Senate,T. Shannon,REP,590307,0,2,73,75,
Pawnee,U.S. Senate,Randy Brogdon,REP,590307,0,1,5,6,
Pawnee,U.S. Senate,Eric Mccray,REP,590307,0,0,1,1,
Pawnee,U.S. Senate,Kevin Crow,REP,590307,1,0,3,4,
Pawnee,U.S. Senate,James Lankford,REP,590307,2,0,87,89,
Pawnee,U.S. Senate,Jason Weger,REP,590307,0,0,0,0,
Pawnee,U.S. House,Timothy Ray Murray,REP,590307,0,0,7,7,03
Pawnee,U.S. House,Robert Hubbard,REP,590307,0,0,13,13,03
Pawnee,U.S. House,Frank Lucas,REP,590307,3,2,142,147,03
Pawnee,State Senate,Dan Ladd,REP,590307,1,2,49,52,20
Pawnee,State Senate,A Griffin,REP,590307,2,0,110,112,20
Pawnee,Superintendent of Public Instruction,John Cox,DEM,590309,1,0,7,8,
Pawnee,Superintendent of Public Instruction,Jack Jr.,DEM,590309,0,0,5,5,
Pawnee,Superintendent of Public Instruction,Ivan Holmes,DEM,590309,0,0,2,2,
Pawnee,Superintendent of Public Instruction,Freda Deskin,DEM,590309,0,0,14,14,
Pawnee,U.S. Senate,Patrick Michael Hayes,DEM,590309,1,0,7,8,
Pawnee,U.S. Senate,Jim Rogers,DEM,590309,0,0,7,7,
Pawnee,U.S. Senate,Connie Johnson,DEM,590309,0,0,13,13,
Pawnee,Governor,Dax Ewbank,REP,590309,0,0,6,6,
Pawnee,Governor,Chad Moody,REP,590309,0,0,7,7,
Pawnee,Governor,Mary Fallin,REP,590309,2,0,40,42,
Pawnee,Superintendent of Public Instruction,Brian Kelly,REP,590309,0,0,8,8,
Pawnee,Superintendent of Public Instruction,Janet Costello Barresi,REP,590309,0,0,6,6,
Pawnee,Superintendent of Public Instruction,Joy Hofmeister,REP,590309,2,0,37,39,
Pawnee,Insurance Commissioner,Bill Viner,REP,590309,0,0,11,11,
Pawnee,Insurance Commissioner,John Doak,REP,590309,2,0,39,41,
Pawnee,Corporation Commissioner,Todd Hiett,REP,590309,2,0,34,36,
Pawnee,Corporation Commissioner,Cliff Branan,REP,590309,0,0,16,16,
Pawnee,U.S. Senate,Evelyn Rogers,REP,590309,1,0,2,3,
Pawnee,U.S. Senate,Rob Moye,REP,590309,0,0,1,1,
Pawnee,U.S. Senate,D. Jean Mcbride-Samuels,REP,590309,0,0,0,0,
Pawnee,U.S. Senate,Jim Inhofe,REP,590309,1,0,48,49,
Pawnee,U.S. Senate,Erick Paul Wyatt,REP,590309,0,0,2,2,
Pawnee,U.S. Senate,Andy Craig,REP,590309,0,0,0,0,
Pawnee,U.S. Senate,T. Shannon,REP,590309,1,0,27,28,
Pawnee,U.S. Senate,Randy Brogdon,REP,590309,0,0,7,7,
Pawnee,U.S. Senate,Eric Mccray,REP,590309,0,0,0,0,
Pawnee,U.S. Senate,Kevin Crow,REP,590309,1,0,2,3,
Pawnee,U.S. Senate,James Lankford,REP,590309,0,0,17,17,
Pawnee,U.S. Senate,Jason Weger,REP,590309,0,0,0,0,
Pawnee,U.S. House,Timothy Ray Murray,REP,590309,1,0,3,4,03
Pawnee,U.S. House,Robert Hubbard,REP,590309,0,0,12,12,03
Pawnee,U.S. House,Frank Lucas,REP,590309,1,0,36,37,03
Pawnee,State Senate,Dan Ladd,REP,590309,0,0,16,16,20
Pawnee,State Senate,A Griffin,REP,590309,2,0,33,35,20
Pawnee,Superintendent of Public Instruction,John Cox,DEM,590314,0,1,30,31,
Pawnee,Superintendent of Public Instruction,Jack Jr.,DEM,590314,0,0,12,12,
Pawnee,Superintendent of Public Instruction,Ivan Holmes,DEM,590314,0,0,10,10,
Pawnee,Superintendent of Public Instruction,Freda Deskin,DEM,590314,0,1,46,47,
Pawnee,U.S. Senate,Patrick Michael Hayes,DEM,590314,0,0,20,20,
Pawnee,U.S. Senate,Jim Rogers,DEM,590314,0,0,37,37,
Pawnee,U.S. Senate,Connie Johnson,DEM,590314,0,2,39,41,
Pawnee,Governor,Dax Ewbank,REP,590314,1,0,21,22,
Pawnee,Governor,Chad Moody,REP,590314,0,0,12,12,
Pawnee,Governor,Mary Fallin,REP,590314,2,0,88,90,
Pawnee,Superintendent of Public Instruction,Brian Kelly,REP,590314,0,0,30,30,
Pawnee,Superintendent of Public Instruction,Janet Costello Barresi,REP,590314,2,0,11,13,
Pawnee,Superintendent of Public Instruction,Joy Hofmeister,REP,590314,1,0,82,83,
Pawnee,Insurance Commissioner,Bill Viner,REP,590314,0,0,42,42,
Pawnee,Insurance Commissioner,John Doak,REP,590314,2,0,78,80,
Pawnee,Corporation Commissioner,Todd Hiett,REP,590314,2,0,69,71,
Pawnee,Corporation Commissioner,Cliff Branan,REP,590314,1,0,48,49,
Pawnee,U.S. Senate,Evelyn Rogers,REP,590314,0,0,6,6,
Pawnee,U.S. Senate,Rob Moye,REP,590314,0,0,3,3,
Pawnee,U.S. Senate,D. Jean Mcbride-Samuels,REP,590314,0,0,2,2,
Pawnee,U.S. Senate,Jim Inhofe,REP,590314,2,0,105,107,
Pawnee,U.S. Senate,Erick Paul Wyatt,REP,590314,1,0,8,9,
Pawnee,U.S. Senate,Andy Craig,REP,590314,0,0,1,1,
Pawnee,U.S. Senate,T. Shannon,REP,590314,0,0,68,68,
Pawnee,U.S. Senate,Randy Brogdon,REP,590314,2,0,6,8,
Pawnee,U.S. Senate,Eric Mccray,REP,590314,0,0,1,1,
Pawnee,U.S. Senate,Kevin Crow,REP,590314,0,0,1,1,
Pawnee,U.S. Senate,James Lankford,REP,590314,0,0,45,45,
Pawnee,U.S. Senate,Jason Weger,REP,590314,1,0,0,1,
Pawnee,U.S. House,Timothy Ray Murray,REP,590314,0,0,11,11,03
Pawnee,U.S. House,Robert Hubbard,REP,590314,0,0,15,15,03
Pawnee,U.S. House,Frank Lucas,REP,590314,3,0,94,97,03
Pawnee,State Senate,Dan Ladd,REP,590314,0,0,40,40,20
Pawnee,State Senate,A Griffin,REP,590314,3,0,78,81,20
Payne,Superintendent of Public Instruction,John Cox,DEM,600001,0,1,12,13,
Payne,Superintendent of Public Instruction,Jack Jr.,DEM,600001,0,0,5,5,
Payne,Superintendent of Public Instruction,Ivan Holmes,DEM,600001,1,0,2,3,
Payne,Superintendent of Public Instruction,Freda Deskin,DEM,600001,0,0,24,24,
Payne,U.S. Senate,Patrick Michael Hayes,DEM,600001,0,1,10,11,
Payne,U.S. Senate,Jim Rogers,DEM,600001,0,0,12,12,
Payne,U.S. Senate,Connie Johnson,DEM,600001,1,0,21,22,
Payne,Governor,Dax Ewbank,REP,600001,0,0,3,3,
Payne,Governor,Chad Moody,REP,600001,0,0,10,10,
Payne,Governor,Mary Fallin,REP,600001,0,1,32,33,
Payne,Superintendent of Public Instruction,Brian Kelly,REP,600001,0,1,21,22,
Payne,Superintendent of Public Instruction,Janet Costello Barresi,REP,600001,0,0,5,5,
Payne,Superintendent of Public Instruction,Joy Hofmeister,REP,600001,0,0,19,19,
Payne,Insurance Commissioner,Bill Viner,REP,600001,0,0,11,11,
Payne,Insurance Commissioner,John Doak,REP,600001,0,1,31,32,
Payne,Corporation Commissioner,Todd Hiett,REP,600001,0,0,17,17,
Payne,Corporation Commissioner,Cliff Branan,REP,600001,0,1,24,25,
Payne,U.S. Senate,Evelyn Rogers,REP,600001,0,0,7,7,
Payne,U.S. Senate,Rob Moye,REP,600001,0,0,0,0,
Payne,U.S. Senate,D. Jean Mcbride-Samuels,REP,600001,0,0,1,1,
Payne,U.S. Senate,Jim Inhofe,REP,600001,0,1,36,37,
Payne,U.S. Senate,Erick Paul Wyatt,REP,600001,0,0,4,4,
Payne,U.S. Senate,Andy Craig,REP,600001,0,0,2,2,
Payne,U.S. Senate,T. Shannon,REP,600001,0,1,22,23,
Payne,U.S. Senate,Randy Brogdon,REP,600001,0,0,3,3,
Payne,U.S. Senate,Eric Mccray,REP,600001,0,0,1,1,
Payne,U.S. Senate,Kevin Crow,REP,600001,0,0,1,1,
Payne,U.S. Senate,James Lankford,REP,600001,0,0,19,19,
Payne,U.S. Senate,Jason Weger,REP,600001,0,0,0,0,
Payne,U.S. House,Timothy Ray Murray,REP,600001,0,0,4,4,03
Payne,U.S. House,Robert Hubbard,REP,600001,0,0,8,8,03
Payne,U.S. House,Frank Lucas,REP,600001,0,1,36,37,03
Payne,Superintendent of Public Instruction,John Cox,DEM,600002,0,0,27,27,
Payne,Superintendent of Public Instruction,Jack Jr.,DEM,600002,0,0,12,12,
Payne,Superintendent of Public Instruction,Ivan Holmes,DEM,600002,0,0,5,5,
Payne,Superintendent of Public Instruction,Freda Deskin,DEM,600002,0,3,37,40,
Payne,U.S. Senate,Patrick Michael Hayes,DEM,600002,0,1,13,14,
Payne,U.S. Senate,Jim Rogers,DEM,600002,0,2,31,33,
Payne,U.S. Senate,Connie Johnson,DEM,600002,0,0,34,34,
Payne,Governor,Dax Ewbank,REP,600002,0,1,16,17,
Payne,Governor,Chad Moody,REP,600002,0,3,19,22,
Payne,Governor,Mary Fallin,REP,600002,0,1,85,86,
Payne,Superintendent of Public Instruction,Brian Kelly,REP,600002,0,2,28,30,
Payne,Superintendent of Public Instruction,Janet Costello Barresi,REP,600002,0,2,18,20,
Payne,Superintendent of Public Instruction,Joy Hofmeister,REP,600002,0,1,71,72,
Payne,Insurance Commissioner,Bill Viner,REP,600002,0,0,20,20,
Payne,Insurance Commissioner,John Doak,REP,600002,0,5,88,93,
Payne,Corporation Commissioner,Todd Hiett,REP,600002,0,2,66,68,
Payne,Corporation Commissioner,Cliff Branan,REP,600002,0,3,45,48,
Payne,U.S. Senate,Evelyn Rogers,REP,600002,0,2,7,9,
Payne,U.S. Senate,Rob Moye,REP,600002,0,0,3,3,
Payne,U.S. Senate,D. Jean Mcbride-Samuels,REP,600002,0,0,2,2,
Payne,U.S. Senate,Jim Inhofe,REP,600002,0,3,101,104,
Payne,U.S. Senate,Erick Paul Wyatt,REP,600002,0,0,6,6,
Payne,U.S. Senate,Andy Craig,REP,600002,0,0,2,2,
Payne,U.S. Senate,T. Shannon,REP,600002,0,0,45,45,
Payne,U.S. Senate,Randy Brogdon,REP,600002,0,1,10,11,
Payne,U.S. Senate,Eric Mccray,REP,600002,0,2,2,4,
Payne,U.S. Senate,Kevin Crow,REP,600002,0,0,2,2,
Payne,U.S. Senate,James Lankford,REP,600002,0,2,59,61,
Payne,U.S. Senate,Jason Weger,REP,600002,0,0,0,0,
Payne,U.S. House,Timothy Ray Murray,REP,600002,0,0,3,3,03
Payne,U.S. House,Robert Hubbard,REP,600002,0,2,12,14,03
Payne,U.S. House,Frank Lucas,REP,600002,0,3,105,108,03
Payne,Superintendent of Public Instruction,John Cox,DEM,600003,0,2,9,11,
Payne,Superintendent of Public Instruction,Jack Jr.,DEM,600003,0,0,3,3,
Payne,Superintendent of Public Instruction,Ivan Holmes,DEM,600003,0,0,6,6,
Payne,Superintendent of Public Instruction,Freda Deskin,DEM,600003,1,2,16,19,
Payne,U.S. Senate,Patrick Michael Hayes,DEM,600003,0,2,6,8,
Payne,U.S. Senate,Jim Rogers,DEM,600003,0,0,11,11,
Payne,U.S. Senate,Connie Johnson,DEM,600003,1,2,17,20,
Payne,Governor,Dax Ewbank,REP,600003,0,0,11,11,
Payne,Governor,Chad Moody,REP,600003,0,1,17,18,
Payne,Governor,Mary Fallin,REP,600003,1,4,36,41,
Payne,Superintendent of Public Instruction,Brian Kelly,REP,600003,0,0,21,21,
Payne,Superintendent of Public Instruction,Janet Costello Barresi,REP,600003,1,2,6,9,
Payne,Superintendent of Public Instruction,Joy Hofmeister,REP,600003,0,3,35,38,
Payne,Insurance Commissioner,Bill Viner,REP,600003,0,1,14,15,
Payne,Insurance Commissioner,John Doak,REP,600003,1,4,49,54,
Payne,Corporation Commissioner,Todd Hiett,REP,600003,0,2,24,26,
Payne,Corporation Commissioner,Cliff Branan,REP,600003,1,3,39,43,
Payne,U.S. Senate,Evelyn Rogers,REP,600003,0,0,7,7,
Payne,U.S. Senate,Rob Moye,REP,600003,0,0,4,4,
Payne,U.S. Senate,D. Jean Mcbride-Samuels,REP,600003,0,0,5,5,
Payne,U.S. Senate,Jim Inhofe,REP,600003,1,3,45,49,
Payne,U.S. Senate,Erick Paul Wyatt,REP,600003,0,2,4,6,
Payne,U.S. Senate,Andy Craig,REP,600003,0,0,3,3,
Payne,U.S. Senate,T. Shannon,REP,600003,0,3,21,24,
Payne,U.S. Senate,Randy Brogdon,REP,600003,0,0,2,2,
Payne,U.S. Senate,Eric Mccray,REP,600003,0,0,5,5,
Payne,U.S. Senate,Kevin Crow,REP,600003,0,0,1,1,
Payne,U.S. Senate,James Lankford,REP,600003,1,2,33,36,
Payne,U.S. Senate,Jason Weger,REP,600003,0,0,0,0,
Payne,U.S. House,Timothy Ray Murray,REP,600003,0,1,13,14,03
Payne,U.S. House,Robert Hubbard,REP,600003,0,0,10,10,03
Payne,U.S. House,Frank Lucas,REP,600003,1,4,42,47,03
Payne,Superintendent of Public Instruction,John Cox,DEM,600004,0,2,37,39,
Payne,Superintendent of Public Instruction,Jack Jr.,DEM,600004,0,1,24,25,
Payne,Superintendent of Public Instruction,Ivan Holmes,DEM,600004,0,1,7,8,
Payne,Superintendent of Public Instruction,Freda Deskin,DEM,600004,0,3,60,63,
Payne,U.S. Senate,Patrick Michael Hayes,DEM,600004,0,1,19,20,
Payne,U.S. Senate,Jim Rogers,DEM,600004,0,2,30,32,
Payne,U.S. Senate,Connie Johnson,DEM,600004,0,4,73,77,
Payne,Governor,Dax Ewbank,REP,600004,2,0,14,16,
Payne,Governor,Chad Moody,REP,600004,1,2,32,35,
Payne,Governor,Mary Fallin,REP,600004,0,13,166,179,
Payne,Superintendent of Public Instruction,Brian Kelly,REP,600004,0,4,44,48,
Payne,Superintendent of Public Instruction,Janet Costello Barresi,REP,600004,0,3,31,34,
Payne,Superintendent of Public Instruction,Joy Hofmeister,REP,600004,3,8,138,149,
Payne,Insurance Commissioner,Bill Viner,REP,600004,0,2,35,37,
Payne,Insurance Commissioner,John Doak,REP,600004,1,10,162,173,
Payne,Corporation Commissioner,Todd Hiett,REP,600004,3,5,103,111,
Payne,Corporation Commissioner,Cliff Branan,REP,600004,0,7,95,102,
Payne,U.S. Senate,Evelyn Rogers,REP,600004,1,1,19,21,
Payne,U.S. Senate,Rob Moye,REP,600004,0,0,4,4,
Payne,U.S. Senate,D. Jean Mcbride-Samuels,REP,600004,0,0,6,6,
Payne,U.S. Senate,Jim Inhofe,REP,600004,0,14,171,185,
Payne,U.S. Senate,Erick Paul Wyatt,REP,600004,2,0,11,13,
Payne,U.S. Senate,Andy Craig,REP,600004,0,0,2,2,
Payne,U.S. Senate,T. Shannon,REP,600004,2,4,67,73,
Payne,U.S. Senate,Randy Brogdon,REP,600004,0,0,7,7,
Payne,U.S. Senate,Eric Mccray,REP,600004,0,0,3,3,
Payne,U.S. Senate,Kevin Crow,REP,600004,0,0,2,2,
Payne,U.S. Senate,James Lankford,REP,600004,1,10,131,142,
Payne,U.S. Senate,Jason Weger,REP,600004,0,1,0,1,
Payne,U.S. House,Timothy Ray Murray,REP,600004,0,0,15,15,03
Payne,U.S. House,Robert Hubbard,REP,600004,1,5,19,25,03
Payne,U.S. House,Frank Lucas,REP,600004,2,10,178,190,03
Payne,Superintendent of Public Instruction,John Cox,DEM,600005,0,0,4,4,
Payne,Superintendent of Public Instruction,Jack Jr.,DEM,600005,0,0,5,5,
Payne,Superintendent of Public Instruction,Ivan Holmes,DEM,600005,1,0,0,1,
Payne,Superintendent of Public Instruction,Freda Deskin,DEM,600005,0,1,4,5,
Payne,U.S. Senate,Patrick Michael Hayes,DEM,600005,0,0,0,0,
Payne,U.S. Senate,Jim Rogers,DEM,600005,1,0,4,5,
Payne,U.S. Senate,Connie Johnson,DEM,600005,0,1,8,9,
Payne,Governor,Dax Ewbank,REP,600005,1,0,6,7,
Payne,Governor,Chad Moody,REP,600005,0,1,7,8,
Payne,Governor,Mary Fallin,REP,600005,0,1,39,40,
Payne,Superintendent of Public Instruction,Brian Kelly,REP,600005,1,0,15,16,
Payne,Superintendent of Public Instruction,Janet Costello Barresi,REP,600005,0,0,6,6,
Payne,Superintendent of Public Instruction,Joy Hofmeister,REP,600005,0,2,31,33,
Payne,Insurance Commissioner,Bill Viner,REP,600005,1,1,6,8,
Payne,Insurance Commissioner,John Doak,REP,600005,0,1,42,43,
Payne,Corporation Commissioner,Todd Hiett,REP,600005,0,0,16,16,
Payne,Corporation Commissioner,Cliff Branan,REP,600005,1,2,32,35,
Payne,U.S. Senate,Evelyn Rogers,REP,600005,0,0,1,1,
Payne,U.S. Senate,Rob Moye,REP,600005,0,0,2,2,
Payne,U.S. Senate,D. Jean Mcbride-Samuels,REP,600005,0,0,0,0,
Payne,U.S. Senate,Jim Inhofe,REP,600005,1,2,47,50,
Payne,U.S. Senate,Erick Paul Wyatt,REP,600005,0,0,3,3,
Payne,U.S. Senate,Andy Craig,REP,600005,0,0,0,0,
Payne,U.S. Senate,T. Shannon,REP,600005,0,0,20,20,
Payne,U.S. Senate,Randy Brogdon,REP,600005,0,0,1,1,
Payne,U.S. Senate,Eric Mccray,REP,600005,0,0,0,0,
Payne,U.S. Senate,Kevin Crow,REP,600005,0,0,0,0,
Payne,U.S. Senate,James Lankford,REP,600005,1,2,31,34,
Payne,U.S. Senate,Jason Weger,REP,600005,0,0,0,0,
Payne,U.S. House,Timothy Ray Murray,REP,600005,0,0,4,4,03
Payne,U.S. House,Robert Hubbard,REP,600005,0,0,2,2,03
Payne,U.S. House,Frank Lucas,REP,600005,1,2,47,50,03
Payne,Superintendent of Public Instruction,John Cox,DEM,600006,0,1,23,24,
Payne,Superintendent of Public Instruction,Jack Jr.,DEM,600006,0,2,20,22,
Payne,Superintendent of Public Instruction,Ivan Holmes,DEM,600006,0,0,7,7,
Payne,Superintendent of Public Instruction,Freda Deskin,DEM,600006,2,3,51,56,
Payne,U.S. Senate,Patrick Michael Hayes,DEM,600006,0,1,7,8,
Payne,U.S. Senate,Jim Rogers,DEM,600006,1,3,31,35,
Payne,U.S. Senate,Connie Johnson,DEM,600006,1,2,62,65,
Payne,Governor,Dax Ewbank,REP,600006,0,4,20,24,
Payne,Governor,Chad Moody,REP,600006,0,4,36,40,
Payne,Governor,Mary Fallin,REP,600006,1,12,156,169,
Payne,Superintendent of Public Instruction,Brian Kelly,REP,600006,0,2,36,38,
Payne,Superintendent of Public Instruction,Janet Costello Barresi,REP,600006,1,3,44,48,
Payne,Superintendent of Public Instruction,Joy Hofmeister,REP,600006,0,16,130,146,
Payne,Insurance Commissioner,Bill Viner,REP,600006,1,5,47,53,
Payne,Insurance Commissioner,John Doak,REP,600006,0,16,151,167,
Payne,Corporation Commissioner,Todd Hiett,REP,600006,1,9,105,115,
Payne,Corporation Commissioner,Cliff Branan,REP,600006,0,12,86,98,
Payne,U.S. Senate,Evelyn Rogers,REP,600006,0,1,8,9,
Payne,U.S. Senate,Rob Moye,REP,600006,0,0,10,10,
Payne,U.S. Senate,D. Jean Mcbride-Samuels,REP,600006,0,0,3,3,
Payne,U.S. Senate,Jim Inhofe,REP,600006,1,19,180,200,
Payne,U.S. Senate,Erick Paul Wyatt,REP,600006,0,1,6,7,
Payne,U.S. Senate,Andy Craig,REP,600006,0,1,4,5,
Payne,U.S. Senate,T. Shannon,REP,600006,0,7,68,75,
Payne,U.S. Senate,Randy Brogdon,REP,600006,1,1,2,4,
Payne,U.S. Senate,Eric Mccray,REP,600006,0,1,2,3,
Payne,U.S. Senate,Kevin Crow,REP,600006,0,0,0,0,
Payne,U.S. Senate,James Lankford,REP,600006,0,11,131,142,
Payne,U.S. Senate,Jason Weger,REP,600006,0,0,0,0,
Payne,U.S. House,Timothy Ray Murray,REP,600006,0,1,4,5,03
Payne,U.S. House,Robert Hubbard,REP,600006,1,0,19,20,03
Payne,U.S. House,Frank Lucas,REP,600006,0,20,185,205,03
Payne,Superintendent of Public Instruction,John Cox,DEM,600007,0,1,6,7,
Payne,Superintendent of Public Instruction,Jack Jr.,DEM,600007,2,1,2,5,
Payne,Superintendent of Public Instruction,Ivan Holmes,DEM,600007,0,0,3,3,
Payne,Superintendent of Public Instruction,Freda Deskin,DEM,600007,0,1,9,10,
Payne,U.S. Senate,Patrick Michael Hayes,DEM,600007,1,1,3,5,
Payne,U.S. Senate,Jim Rogers,DEM,600007,0,0,3,3,
Payne,U.S. Senate,Connie Johnson,DEM,600007,1,2,14,17,
Payne,Governor,Dax Ewbank,REP,600007,0,0,5,5,
Payne,Governor,Chad Moody,REP,600007,0,1,7,8,
Payne,Governor,Mary Fallin,REP,600007,2,4,24,30,
Payne,Superintendent of Public Instruction,Brian Kelly,REP,600007,1,1,8,10,
Payne,Superintendent of Public Instruction,Janet Costello Barresi,REP,600007,1,1,11,13,
Payne,Superintendent of Public Instruction,Joy Hofmeister,REP,600007,0,3,15,18,
Payne,Insurance Commissioner,Bill Viner,REP,600007,0,0,5,5,
Payne,Insurance Commissioner,John Doak,REP,600007,2,4,28,34,
Payne,Corporation Commissioner,Todd Hiett,REP,600007,0,2,12,14,
Payne,Corporation Commissioner,Cliff Branan,REP,600007,2,1,20,23,
Payne,U.S. Senate,Evelyn Rogers,REP,600007,0,0,2,2,
Payne,U.S. Senate,Rob Moye,REP,600007,0,0,1,1,
Payne,U.S. Senate,D. Jean Mcbride-Samuels,REP,600007,0,0,2,2,
Payne,U.S. Senate,Jim Inhofe,REP,600007,2,5,28,35,
Payne,U.S. Senate,Erick Paul Wyatt,REP,600007,0,0,2,2,
Payne,U.S. Senate,Andy Craig,REP,600007,0,0,1,1,
Payne,U.S. Senate,T. Shannon,REP,600007,0,2,16,18,
Payne,U.S. Senate,Randy Brogdon,REP,600007,0,0,2,2,
Payne,U.S. Senate,Eric Mccray,REP,600007,0,0,3,3,
Payne,U.S. Senate,Kevin Crow,REP,600007,0,0,0,0,
Payne,U.S. Senate,James Lankford,REP,600007,2,3,15,20,
Payne,U.S. Senate,Jason Weger,REP,600007,0,0,0,0,
Payne,U.S. House,Timothy Ray Murray,REP,600007,0,0,4,4,03
Payne,U.S. House,Robert Hubbard,REP,600007,0,0,3,3,03
Payne,U.S. House,Frank Lucas,REP,600007,2,5,29,36,03
Payne,Superintendent of Public Instruction,John Cox,DEM,600008,0,1,23,24,
Payne,Superintendent of Public Instruction,Jack Jr.,DEM,600008,0,0,14,14,
Payne,Superintendent of Public Instruction,Ivan Holmes,DEM,600008,0,0,7,7,
Payne,Superintendent of Public Instruction,Freda Deskin,DEM,600008,0,0,43,43,
Payne,U.S. Senate,Patrick Michael Hayes,DEM,600008,0,0,11,11,
Payne,U.S. Senate,Jim Rogers,DEM,600008,0,0,21,21,
Payne,U.S. Senate,Connie Johnson,DEM,600008,0,1,56,57,
Payne,Governor,Dax Ewbank,REP,600008,0,1,14,15,
Payne,Governor,Chad Moody,REP,600008,0,2,21,23,
Payne,Governor,Mary Fallin,REP,600008,1,3,56,60,
Payne,Superintendent of Public Instruction,Brian Kelly,REP,600008,1,2,26,29,
Payne,Superintendent of Public Instruction,Janet Costello Barresi,REP,600008,0,1,16,17,
Payne,Superintendent of Public Instruction,Joy Hofmeister,REP,600008,0,3,50,53,
Payne,Insurance Commissioner,Bill Viner,REP,600008,1,1,22,24,
Payne,Insurance Commissioner,John Doak,REP,600008,0,5,63,68,
Payne,Corporation Commissioner,Todd Hiett,REP,600008,1,2,35,38,
Payne,Corporation Commissioner,Cliff Branan,REP,600008,0,4,52,56,
Payne,U.S. Senate,Evelyn Rogers,REP,600008,0,2,6,8,
Payne,U.S. Senate,Rob Moye,REP,600008,0,0,2,2,
Payne,U.S. Senate,D. Jean Mcbride-Samuels,REP,600008,0,0,6,6,
Payne,U.S. Senate,Jim Inhofe,REP,600008,1,4,70,75,
Payne,U.S. Senate,Erick Paul Wyatt,REP,600008,0,0,6,6,
Payne,U.S. Senate,Andy Craig,REP,600008,0,2,1,3,
Payne,U.S. Senate,T. Shannon,REP,600008,0,0,40,40,
Payne,U.S. Senate,Randy Brogdon,REP,600008,0,1,2,3,
Payne,U.S. Senate,Eric Mccray,REP,600008,0,0,5,5,
Payne,U.S. Senate,Kevin Crow,REP,600008,0,0,5,5,
Payne,U.S. Senate,James Lankford,REP,600008,1,3,36,40,
Payne,U.S. Senate,Jason Weger,REP,600008,0,0,2,2,
Payne,U.S. House,Timothy Ray Murray,REP,600008,0,1,7,8,03
Payne,U.S. House,Robert Hubbard,REP,600008,0,1,14,15,03
Payne,U.S. House,Frank Lucas,REP,600008,1,4,69,74,03
Payne,Superintendent of Public Instruction,John Cox,DEM,600009,0,3,32,35,
Payne,Superintendent of Public Instruction,Jack Jr.,DEM,600009,2,1,25,28,
Payne,Superintendent of Public Instruction,Ivan Holmes,DEM,600009,0,2,6,8,
Payne,Superintendent of Public Instruction,Freda Deskin,DEM,600009,0,0,51,51,
Payne,U.S. Senate,Patrick Michael Hayes,DEM,600009,1,1,11,13,
Payne,U.S. Senate,Jim Rogers,DEM,600009,1,1,31,33,
Payne,U.S. Senate,Connie Johnson,DEM,600009,1,5,71,77,
Payne,Governor,Dax Ewbank,REP,600009,1,4,24,29,
Payne,Governor,Chad Moody,REP,600009,1,1,29,31,
Payne,Governor,Mary Fallin,REP,600009,8,13,182,203,
Payne,Superintendent of Public Instruction,Brian Kelly,REP,600009,0,2,48,50,
Payne,Superintendent of Public Instruction,Janet Costello Barresi,REP,600009,2,6,52,60,
Payne,Superintendent of Public Instruction,Joy Hofmeister,REP,600009,8,11,137,156,
Payne,Insurance Commissioner,Bill Viner,REP,600009,0,3,47,50,
Payne,Insurance Commissioner,John Doak,REP,600009,10,14,163,187,
Payne,Corporation Commissioner,Todd Hiett,REP,600009,4,6,108,118,
Payne,Corporation Commissioner,Cliff Branan,REP,600009,2,10,106,118,
Payne,U.S. Senate,Evelyn Rogers,REP,600009,0,1,10,11,
Payne,U.S. Senate,Rob Moye,REP,600009,0,0,9,9,
Payne,U.S. Senate,D. Jean Mcbride-Samuels,REP,600009,0,2,4,6,
Payne,U.S. Senate,Jim Inhofe,REP,600009,10,15,209,234,
Payne,U.S. Senate,Erick Paul Wyatt,REP,600009,0,0,6,6,
Payne,U.S. Senate,Andy Craig,REP,600009,0,0,0,0,
Payne,U.S. Senate,T. Shannon,REP,600009,6,4,95,105,
Payne,U.S. Senate,Randy Brogdon,REP,600009,0,0,9,9,
Payne,U.S. Senate,Eric Mccray,REP,600009,0,0,2,2,
Payne,U.S. Senate,Kevin Crow,REP,600009,0,0,5,5,
Payne,U.S. Senate,James Lankford,REP,600009,4,15,129,148,
Payne,U.S. Senate,Jason Weger,REP,600009,0,0,2,2,
Payne,U.S. House,Timothy Ray Murray,REP,600009,0,1,9,10,03
Payne,U.S. House,Robert Hubbard,REP,600009,0,1,25,26,03
Payne,U.S. House,Frank Lucas,REP,600009,10,17,203,230,03
Payne,Superintendent of Public Instruction,John Cox,DEM,600010,0,0,11,11,
Payne,Superintendent of Public Instruction,Jack Jr.,DEM,600010,0,3,8,11,
Payne,Superintendent of Public Instruction,Ivan Holmes,DEM,600010,0,0,2,2,
Payne,Superintendent of Public Instruction,Freda Deskin,DEM,600010,1,2,15,18,
Payne,U.S. Senate,Patrick Michael Hayes,DEM,600010,0,2,2,4,
Payne,U.S. Senate,Jim Rogers,DEM,600010,0,1,11,12,
Payne,U.S. Senate,Connie Johnson,DEM,600010,0,2,23,25,
Payne,Governor,Dax Ewbank,REP,600010,0,0,7,7,
Payne,Governor,Chad Moody,REP,600010,1,1,16,18,
Payne,Governor,Mary Fallin,REP,600010,1,5,52,58,
Payne,Superintendent of Public Instruction,Brian Kelly,REP,600010,0,1,21,22,
Payne,Superintendent of Public Instruction,Janet Costello Barresi,REP,600010,0,0,11,11,
Payne,Superintendent of Public Instruction,Joy Hofmeister,REP,600010,2,4,40,46,
Payne,Insurance Commissioner,Bill Viner,REP,600010,0,2,18,20,
Payne,Insurance Commissioner,John Doak,REP,600010,2,4,43,49,
Payne,Corporation Commissioner,Todd Hiett,REP,600010,1,5,29,35,
Payne,Corporation Commissioner,Cliff Branan,REP,600010,0,0,36,36,
Payne,U.S. Senate,Evelyn Rogers,REP,600010,0,0,8,8,
Payne,U.S. Senate,Rob Moye,REP,600010,0,0,3,3,
Payne,U.S. Senate,D. Jean Mcbride-Samuels,REP,600010,0,0,1,1,
Payne,U.S. Senate,Jim Inhofe,REP,600010,2,5,55,62,
Payne,U.S. Senate,Erick Paul Wyatt,REP,600010,0,0,6,6,
Payne,U.S. Senate,Andy Craig,REP,600010,0,0,0,0,
Payne,U.S. Senate,T. Shannon,REP,600010,0,1,20,21,
Payne,U.S. Senate,Randy Brogdon,REP,600010,0,0,1,1,
Payne,U.S. Senate,Eric Mccray,REP,600010,0,0,1,1,
Payne,U.S. Senate,Kevin Crow,REP,600010,0,0,4,4,
Payne,U.S. Senate,James Lankford,REP,600010,2,5,47,54,
Payne,U.S. Senate,Jason Weger,REP,600010,0,0,1,1,
Payne,U.S. House,Timothy Ray Murray,REP,600010,0,0,5,5,03
Payne,U.S. House,Robert Hubbard,REP,600010,0,0,10,10,03
Payne,U.S. House,Frank Lucas,REP,600010,2,5,58,65,03
Payne,Superintendent of Public Instruction,John Cox,DEM,600011,0,1,13,14,
Payne,Superintendent of Public Instruction,Jack Jr.,DEM,600011,0,1,11,12,
Payne,Superintendent of Public Instruction,Ivan Holmes,DEM,600011,0,0,1,1,
Payne,Superintendent of Public Instruction,Freda Deskin,DEM,600011,0,0,8,8,
Payne,U.S. Senate,Patrick Michael Hayes,DEM,600011,0,0,3,3,
Payne,U.S. Senate,Jim Rogers,DEM,600011,0,1,6,7,
Payne,U.S. Senate,Connie Johnson,DEM,600011,0,1,23,24,
Payne,Governor,Dax Ewbank,REP,600011,0,0,7,7,
Payne,Governor,Chad Moody,REP,600011,0,0,8,8,
Payne,Governor,Mary Fallin,REP,600011,1,5,38,44,
Payne,Superintendent of Public Instruction,Brian Kelly,REP,600011,0,1,14,15,
Payne,Superintendent of Public Instruction,Janet Costello Barresi,REP,600011,1,1,11,13,
Payne,Superintendent of Public Instruction,Joy Hofmeister,REP,600011,0,3,27,30,
Payne,Insurance Commissioner,Bill Viner,REP,600011,0,0,10,10,
Payne,Insurance Commissioner,John Doak,REP,600011,1,5,40,46,
Payne,Corporation Commissioner,Todd Hiett,REP,600011,1,5,24,30,
Payne,Corporation Commissioner,Cliff Branan,REP,600011,0,0,21,21,
Payne,U.S. Senate,Evelyn Rogers,REP,600011,0,1,2,3,
Payne,U.S. Senate,Rob Moye,REP,600011,0,0,1,1,
Payne,U.S. Senate,D. Jean Mcbride-Samuels,REP,600011,0,0,1,1,
Payne,U.S. Senate,Jim Inhofe,REP,600011,1,3,46,50,
Payne,U.S. Senate,Erick Paul Wyatt,REP,600011,0,1,4,5,
Payne,U.S. Senate,Andy Craig,REP,600011,0,0,1,1,
Payne,U.S. Senate,T. Shannon,REP,600011,0,0,22,22,
Payne,U.S. Senate,Randy Brogdon,REP,600011,0,0,4,4,
Payne,U.S. Senate,Eric Mccray,REP,600011,0,0,0,0,
Payne,U.S. Senate,Kevin Crow,REP,600011,0,0,0,0,
Payne,U.S. Senate,James Lankford,REP,600011,1,5,27,33,
Payne,U.S. Senate,Jason Weger,REP,600011,0,0,0,0,
Payne,U.S. House,Timothy Ray Murray,REP,600011,0,1,3,4,03
Payne,U.S. House,Robert Hubbard,REP,600011,0,0,6,6,03
Payne,U.S. House,Frank Lucas,REP,600011,1,4,44,49,03
Payne,Superintendent of Public Instruction,John Cox,DEM,600012,0,0,9,9,
Payne,Superintendent of Public Instruction,Jack Jr.,DEM,600012,0,0,8,8,
Payne,Superintendent of Public Instruction,Ivan Holmes,DEM,600012,0,0,1,1,
Payne,Superintendent of Public Instruction,Freda Deskin,DEM,600012,0,1,10,11,
Payne,U.S. Senate,Patrick Michael Hayes,DEM,600012,0,0,3,3,
Payne,U.S. Senate,Jim Rogers,DEM,600012,0,1,6,7,
Payne,U.S. Senate,Connie Johnson,DEM,600012,0,0,19,19,
Payne,Governor,Dax Ewbank,REP,600012,0,2,4,6,
Payne,Governor,Chad Moody,REP,600012,0,0,4,4,
Payne,Governor,Mary Fallin,REP,600012,0,0,18,18,
Payne,Superintendent of Public Instruction,Brian Kelly,REP,600012,0,0,5,5,
Payne,Superintendent of Public Instruction,Janet Costello Barresi,REP,600012,0,0,3,3,
Payne,Superintendent of Public Instruction,Joy Hofmeister,REP,600012,0,2,18,20,
Payne,Insurance Commissioner,Bill Viner,REP,600012,0,2,6,8,
Payne,Insurance Commissioner,John Doak,REP,600012,0,0,13,13,
Payne,Corporation Commissioner,Todd Hiett,REP,600012,0,2,13,15,
Payne,Corporation Commissioner,Cliff Branan,REP,600012,0,0,7,7,
Payne,U.S. Senate,Evelyn Rogers,REP,600012,0,0,1,1,
Payne,U.S. Senate,Rob Moye,REP,600012,0,0,0,0,
Payne,U.S. Senate,D. Jean Mcbride-Samuels,REP,600012,0,0,0,0,
Payne,U.S. Senate,Jim Inhofe,REP,600012,0,2,23,25,
Payne,U.S. Senate,Erick Paul Wyatt,REP,600012,0,0,1,1,
Payne,U.S. Senate,Andy Craig,REP,600012,0,0,0,0,
Payne,U.S. Senate,T. Shannon,REP,600012,0,0,7,7,
Payne,U.S. Senate,Randy Brogdon,REP,600012,0,0,3,3,
Payne,U.S. Senate,Eric Mccray,REP,600012,0,0,0,0,
Payne,U.S. Senate,Kevin Crow,REP,600012,0,0,0,0,
Payne,U.S. Senate,James Lankford,REP,600012,0,2,15,17,
Payne,U.S. Senate,Jason Weger,REP,600012,0,0,0,0,
Payne,U.S. House,Timothy Ray Murray,REP,600012,0,0,1,1,03
Payne,U.S. House,Robert Hubbard,REP,600012,0,0,4,4,03
Payne,U.S. House,Frank Lucas,REP,600012,0,2,19,21,03
Payne,Superintendent of Public Instruction,John Cox,DEM,600013,1,9,47,57,
Payne,Superintendent of Public Instruction,Jack Jr.,DEM,600013,2,2,22,26,
Payne,Superintendent of Public Instruction,Ivan Holmes,DEM,600013,0,1,10,11,
Payne,Superintendent of Public Instruction,Freda Deskin,DEM,600013,1,7,53,61,
Payne,U.S. Senate,Patrick Michael Hayes,DEM,600013,1,0,24,25,
Payne,U.S. Senate,Jim Rogers,DEM,600013,1,8,26,35,
Payne,U.S. Senate,Connie Johnson,DEM,600013,2,11,77,90,
Payne,Governor,Dax Ewbank,REP,600013,1,4,22,27,
Payne,Governor,Chad Moody,REP,600013,0,1,40,41,
Payne,Governor,Mary Fallin,REP,600013,5,16,203,224,
Payne,Superintendent of Public Instruction,Brian Kelly,REP,600013,1,1,58,60,
Payne,Superintendent of Public Instruction,Janet Costello Barresi,REP,600013,0,6,58,64,
Payne,Superintendent of Public Instruction,Joy Hofmeister,REP,600013,5,14,151,170,
Payne,Insurance Commissioner,Bill Viner,REP,600013,1,1,63,65,
Payne,Insurance Commissioner,John Doak,REP,600013,5,20,183,208,
Payne,Corporation Commissioner,Todd Hiett,REP,600013,3,12,132,147,
Payne,Corporation Commissioner,Cliff Branan,REP,600013,3,9,117,129,
Payne,U.S. Senate,Evelyn Rogers,REP,600013,0,1,16,17,
Payne,U.S. Senate,Rob Moye,REP,600013,0,0,9,9,
Payne,U.S. Senate,D. Jean Mcbride-Samuels,REP,600013,0,0,2,2,
Payne,U.S. Senate,Jim Inhofe,REP,600013,5,19,230,254,
Payne,U.S. Senate,Erick Paul Wyatt,REP,600013,1,1,8,10,
Payne,U.S. Senate,Andy Craig,REP,600013,0,0,4,4,
Payne,U.S. Senate,T. Shannon,REP,600013,6,6,91,103,
Payne,U.S. Senate,Randy Brogdon,REP,600013,0,2,7,9,
Payne,U.S. Senate,Eric Mccray,REP,600013,0,0,6,6,
Payne,U.S. Senate,Kevin Crow,REP,600013,0,0,2,2,
Payne,U.S. Senate,James Lankford,REP,600013,0,13,152,165,
Payne,U.S. Senate,Jason Weger,REP,600013,0,0,3,3,
Payne,U.S. House,Timothy Ray Murray,REP,600013,0,0,15,15,03
Payne,U.S. House,Robert Hubbard,REP,600013,0,3,33,36,03
Payne,U.S. House,Frank Lucas,REP,600013,6,18,216,240,03
Payne,Superintendent of Public Instruction,John Cox,DEM,600014,0,0,0,0,
Payne,Superintendent of Public Instruction,Jack Jr.,DEM,600014,0,0,0,0,
Payne,Superintendent of Public Instruction,Ivan Holmes,DEM,600014,0,0,0,0,
Payne,Superintendent of Public Instruction,Freda Deskin,DEM,600014,0,0,0,0,
Payne,U.S. Senate,Patrick Michael Hayes,DEM,600014,0,0,0,0,
Payne,U.S. Senate,Jim Rogers,DEM,600014,0,0,0,0,
Payne,U.S. Senate,Connie Johnson,DEM,600014,0,0,0,0,
Payne,Governor,Dax Ewbank,REP,600014,0,0,1,1,
Payne,Governor,Chad Moody,REP,600014,0,0,0,0,
Payne,Governor,Mary Fallin,REP,600014,0,0,0,0,
Payne,Superintendent of Public Instruction,Brian Kelly,REP,600014,0,0,0,0,
Payne,Superintendent of Public Instruction,Janet Costello Barresi,REP,600014,0,0,0,0,
Payne,Superintendent of Public Instruction,Joy Hofmeister,REP,600014,0,0,1,1,
Payne,Insurance Commissioner,Bill Viner,REP,600014,0,0,0,0,
Payne,Insurance Commissioner,John Doak,REP,600014,0,0,1,1,
Payne,Corporation Commissioner,Todd Hiett,REP,600014,0,0,1,1,
Payne,Corporation Commissioner,Cliff Branan,REP,600014,0,0,0,0,
Payne,U.S. Senate,Evelyn Rogers,REP,600014,0,0,0,0,
Payne,U.S. Senate,Rob Moye,REP,600014,0,0,0,0,
Payne,U.S. Senate,D. Jean Mcbride-Samuels,REP,600014,0,0,0,0,
Payne,U.S. Senate,Jim Inhofe,REP,600014,0,0,1,1,
Payne,U.S. Senate,Erick Paul Wyatt,REP,600014,0,0,0,0,
Payne,U.S. Senate,Andy Craig,REP,600014,0,0,0,0,
Payne,U.S. Senate,T. Shannon,REP,600014,0,0,0,0,
Payne,U.S. Senate,Randy Brogdon,REP,600014,0,0,0,0,
Payne,U.S. Senate,Eric Mccray,REP,600014,0,0,0,0,
Payne,U.S. Senate,Kevin Crow,REP,600014,0,0,0,0,
Payne,U.S. Senate,James Lankford,REP,600014,0,0,1,1,
Payne,U.S. Senate,Jason Weger,REP,600014,0,0,0,0,
Payne,U.S. House,Timothy Ray Murray,REP,600014,0,0,0,0,03
Payne,U.S. House,Robert Hubbard,REP,600014,0,0,0,0,03
Payne,U.S. House,Frank Lucas,REP,600014,0,0,1,1,03
Payne,Superintendent of Public Instruction,John Cox,DEM,600015,0,2,31,33,
Payne,Superintendent of Public Instruction,Jack Jr.,DEM,600015,0,0,16,16,
Payne,Superintendent of Public Instruction,Ivan Holmes,DEM,600015,0,0,4,4,
Payne,Superintendent of Public Instruction,Freda Deskin,DEM,600015,0,2,44,46,
Payne,U.S. Senate,Patrick Michael Hayes,DEM,600015,0,0,8,8,
Payne,U.S. Senate,Jim Rogers,DEM,600015,0,0,28,28,
Payne,U.S. Senate,Connie Johnson,DEM,600015,0,4,58,62,
Payne,Governor,Dax Ewbank,REP,600015,1,2,5,8,
Payne,Governor,Chad Moody,REP,600015,0,1,13,14,
Payne,Governor,Mary Fallin,REP,600015,1,9,83,93,
Payne,Superintendent of Public Instruction,Brian Kelly,REP,600015,0,5,25,30,
Payne,Superintendent of Public Instruction,Janet Costello Barresi,REP,600015,0,3,28,31,
Payne,Superintendent of Public Instruction,Joy Hofmeister,REP,600015,1,5,48,54,
Payne,Insurance Commissioner,Bill Viner,REP,600015,0,2,16,18,
Payne,Insurance Commissioner,John Doak,REP,600015,1,9,82,92,
Payne,Corporation Commissioner,Todd Hiett,REP,600015,1,5,50,56,
Payne,Corporation Commissioner,Cliff Branan,REP,600015,0,7,50,57,
Payne,U.S. Senate,Evelyn Rogers,REP,600015,0,1,7,8,
Payne,U.S. Senate,Rob Moye,REP,600015,0,0,1,1,
Payne,U.S. Senate,D. Jean Mcbride-Samuels,REP,600015,0,1,4,5,
Payne,U.S. Senate,Jim Inhofe,REP,600015,2,8,83,93,
Payne,U.S. Senate,Erick Paul Wyatt,REP,600015,0,1,6,7,
Payne,U.S. Senate,Andy Craig,REP,600015,0,1,1,2,
Payne,U.S. Senate,T. Shannon,REP,600015,2,1,35,38,
Payne,U.S. Senate,Randy Brogdon,REP,600015,0,0,3,3,
Payne,U.S. Senate,Eric Mccray,REP,600015,0,0,0,0,
Payne,U.S. Senate,Kevin Crow,REP,600015,0,1,1,2,
Payne,U.S. Senate,James Lankford,REP,600015,0,9,62,71,
Payne,U.S. Senate,Jason Weger,REP,600015,0,0,1,1,
Payne,U.S. House,Timothy Ray Murray,REP,600015,0,1,6,7,03
Payne,U.S. House,Robert Hubbard,REP,600015,0,1,11,12,03
Payne,U.S. House,Frank Lucas,REP,600015,2,10,86,98,03
Payne,Superintendent of Public Instruction,John Cox,DEM,600016,2,4,48,54,
Payne,Superintendent of Public Instruction,Jack Jr.,DEM,600016,2,5,33,40,
Payne,Superintendent of Public Instruction,Ivan Holmes,DEM,600016,0,0,6,6,
Payne,Superintendent of Public Instruction,Freda Deskin,DEM,600016,0,8,82,90,
Payne,U.S. Senate,Patrick Michael Hayes,DEM,600016,1,3,24,28,
Payne,U.S. Senate,Jim Rogers,DEM,600016,1,4,46,51,
Payne,U.S. Senate,Connie Johnson,DEM,600016,2,9,93,104,
Payne,Governor,Dax Ewbank,REP,600016,0,0,31,31,
Payne,Governor,Chad Moody,REP,600016,2,4,56,62,
Payne,Governor,Mary Fallin,REP,600016,10,49,282,341,
Payne,Superintendent of Public Instruction,Brian Kelly,REP,600016,3,7,64,74,
Payne,Superintendent of Public Instruction,Janet Costello Barresi,REP,600016,2,17,65,84,
Payne,Superintendent of Public Instruction,Joy Hofmeister,REP,600016,7,25,238,270,
Payne,Insurance Commissioner,Bill Viner,REP,600016,2,5,70,77,
Payne,Insurance Commissioner,John Doak,REP,600016,9,39,261,309,
Payne,Corporation Commissioner,Todd Hiett,REP,600016,7,20,185,212,
Payne,Corporation Commissioner,Cliff Branan,REP,600016,2,20,143,165,
Payne,U.S. Senate,Evelyn Rogers,REP,600016,0,2,23,25,
Payne,U.S. Senate,Rob Moye,REP,600016,0,0,8,8,
Payne,U.S. Senate,D. Jean Mcbride-Samuels,REP,600016,0,0,6,6,
Payne,U.S. Senate,Jim Inhofe,REP,600016,11,47,311,369,
Payne,U.S. Senate,Erick Paul Wyatt,REP,600016,1,0,19,20,
Payne,U.S. Senate,Andy Craig,REP,600016,0,0,5,5,
Payne,U.S. Senate,T. Shannon,REP,600016,3,6,115,124,
Payne,U.S. Senate,Randy Brogdon,REP,600016,0,0,7,7,
Payne,U.S. Senate,Eric Mccray,REP,600016,1,0,2,3,
Payne,U.S. Senate,Kevin Crow,REP,600016,0,0,4,4,
Payne,U.S. Senate,James Lankford,REP,600016,8,46,233,287,
Payne,U.S. Senate,Jason Weger,REP,600016,1,0,2,3,
Payne,U.S. House,Timothy Ray Murray,REP,600016,0,1,20,21,03
Payne,U.S. House,Robert Hubbard,REP,600016,1,3,31,35,03
Payne,U.S. House,Frank Lucas,REP,600016,11,49,315,375,03
Payne,Superintendent of Public Instruction,John Cox,DEM,600101,2,0,39,41,
Payne,Superintendent of Public Instruction,Jack Jr.,DEM,600101,2,1,5,8,
Payne,Superintendent of Public Instruction,Ivan Holmes,DEM,600101,0,0,3,3,
Payne,Superintendent of Public Instruction,Freda Deskin,DEM,600101,0,0,20,20,
Payne,U.S. Senate,Patrick Michael Hayes,DEM,600101,3,0,12,15,
Payne,U.S. Senate,Jim Rogers,DEM,600101,0,1,25,26,
Payne,U.S. Senate,Connie Johnson,DEM,600101,1,0,28,29,
Payne,Governor,Dax Ewbank,REP,600101,3,0,12,15,
Payne,Governor,Chad Moody,REP,600101,1,1,26,28,
Payne,Governor,Mary Fallin,REP,600101,3,6,104,113,
Payne,Superintendent of Public Instruction,Brian Kelly,REP,600101,2,0,34,36,
Payne,Superintendent of Public Instruction,Janet Costello Barresi,REP,600101,2,2,16,20,
Payne,Superintendent of Public Instruction,Joy Hofmeister,REP,600101,2,5,90,97,
Payne,Insurance Commissioner,Bill Viner,REP,600101,0,2,24,26,
Payne,Insurance Commissioner,John Doak,REP,600101,6,5,113,124,
Payne,Corporation Commissioner,Todd Hiett,REP,600101,3,4,66,73,
Payne,Corporation Commissioner,Cliff Branan,REP,600101,4,3,72,79,
Payne,U.S. Senate,Evelyn Rogers,REP,600101,1,1,3,5,
Payne,U.S. Senate,Rob Moye,REP,600101,0,0,3,3,
Payne,U.S. Senate,D. Jean Mcbride-Samuels,REP,600101,0,0,0,0,
Payne,U.S. Senate,Jim Inhofe,REP,600101,5,6,122,133,
Payne,U.S. Senate,Erick Paul Wyatt,REP,600101,1,0,13,14,
Payne,U.S. Senate,Andy Craig,REP,600101,0,0,0,0,
Payne,U.S. Senate,T. Shannon,REP,600101,1,2,34,37,
Payne,U.S. Senate,Randy Brogdon,REP,600101,0,0,4,4,
Payne,U.S. Senate,Eric Mccray,REP,600101,1,0,2,3,
Payne,U.S. Senate,Kevin Crow,REP,600101,0,0,2,2,
Payne,U.S. Senate,James Lankford,REP,600101,5,5,99,109,
Payne,U.S. Senate,Jason Weger,REP,600101,0,0,1,1,
Payne,U.S. House,Timothy Ray Murray,REP,600101,1,0,13,14,03
Payne,U.S. House,Robert Hubbard,REP,600101,1,1,17,19,03
Payne,U.S. House,Frank Lucas,REP,600101,5,6,109,120,03
Payne,Superintendent of Public Instruction,John Cox,DEM,600102,2,0,36,38,
Payne,Superintendent of Public Instruction,Jack Jr.,DEM,600102,0,0,12,12,
Payne,Superintendent of Public Instruction,Ivan Holmes,DEM,600102,0,0,9,9,
Payne,Superintendent of Public Instruction,Freda Deskin,DEM,600102,0,2,29,31,
Payne,U.S. Senate,Patrick Michael Hayes,DEM,600102,0,0,15,15,
Payne,U.S. Senate,Jim Rogers,DEM,600102,0,2,35,37,
Payne,U.S. Senate,Connie Johnson,DEM,600102,2,0,35,37,
Payne,Governor,Dax Ewbank,REP,600102,0,0,8,8,
Payne,Governor,Chad Moody,REP,600102,0,0,41,41,
Payne,Governor,Mary Fallin,REP,600102,3,1,162,166,
Payne,Superintendent of Public Instruction,Brian Kelly,REP,600102,2,0,28,30,
Payne,Superintendent of Public Instruction,Janet Costello Barresi,REP,600102,0,0,25,25,
Payne,Superintendent of Public Instruction,Joy Hofmeister,REP,600102,1,1,157,159,
Payne,Insurance Commissioner,Bill Viner,REP,600102,0,1,48,49,
Payne,Insurance Commissioner,John Doak,REP,600102,3,0,148,151,
Payne,Corporation Commissioner,Todd Hiett,REP,600102,1,1,115,117,
Payne,Corporation Commissioner,Cliff Branan,REP,600102,2,0,81,83,
Payne,U.S. Senate,Evelyn Rogers,REP,600102,0,0,7,7,
Payne,U.S. Senate,Rob Moye,REP,600102,0,0,9,9,
Payne,U.S. Senate,D. Jean Mcbride-Samuels,REP,600102,0,0,3,3,
Payne,U.S. Senate,Jim Inhofe,REP,600102,3,1,181,185,
Payne,U.S. Senate,Erick Paul Wyatt,REP,600102,0,0,10,10,
Payne,U.S. Senate,Andy Craig,REP,600102,0,0,2,2,
Payne,U.S. Senate,T. Shannon,REP,600102,1,0,75,76,
Payne,U.S. Senate,Randy Brogdon,REP,600102,0,0,6,6,
Payne,U.S. Senate,Eric Mccray,REP,600102,0,0,1,1,
Payne,U.S. Senate,Kevin Crow,REP,600102,0,0,0,0,
Payne,U.S. Senate,James Lankford,REP,600102,2,1,126,129,
Payne,U.S. Senate,Jason Weger,REP,600102,0,0,2,2,
Payne,U.S. House,Timothy Ray Murray,REP,600102,0,0,12,12,03
Payne,U.S. House,Robert Hubbard,REP,600102,0,0,23,23,03
Payne,U.S. House,Frank Lucas,REP,600102,3,1,171,175,03
Payne,Superintendent of Public Instruction,John Cox,DEM,600103,0,0,34,34,
Payne,Superintendent of Public Instruction,Jack Jr.,DEM,600103,0,0,10,10,
Payne,Superintendent of Public Instruction,Ivan Holmes,DEM,600103,0,0,5,5,
Payne,Superintendent of Public Instruction,Freda Deskin,DEM,600103,2,0,19,21,
Payne,U.S. Senate,Patrick Michael Hayes,DEM,600103,0,0,18,18,
Payne,U.S. Senate,Jim Rogers,DEM,600103,1,0,26,27,
Payne,U.S. Senate,Connie Johnson,DEM,600103,1,0,24,25,
Payne,Governor,Dax Ewbank,REP,600103,1,0,10,11,
Payne,Governor,Chad Moody,REP,600103,0,0,39,39,
Payne,Governor,Mary Fallin,REP,600103,3,1,119,123,
Payne,Superintendent of Public Instruction,Brian Kelly,REP,600103,0,0,31,31,
Payne,Superintendent of Public Instruction,Janet Costello Barresi,REP,600103,1,0,30,31,
Payne,Superintendent of Public Instruction,Joy Hofmeister,REP,600103,3,1,106,110,
Payne,Insurance Commissioner,Bill Viner,REP,600103,1,0,33,34,
Payne,Insurance Commissioner,John Doak,REP,600103,2,1,127,130,
Payne,Corporation Commissioner,Todd Hiett,REP,600103,1,1,88,90,
Payne,Corporation Commissioner,Cliff Branan,REP,600103,2,0,72,74,
Payne,U.S. Senate,Evelyn Rogers,REP,600103,1,0,12,13,
Payne,U.S. Senate,Rob Moye,REP,600103,0,0,6,6,
Payne,U.S. Senate,D. Jean Mcbride-Samuels,REP,600103,0,0,4,4,
Payne,U.S. Senate,Jim Inhofe,REP,600103,3,1,140,144,
Payne,U.S. Senate,Erick Paul Wyatt,REP,600103,0,0,7,7,
Payne,U.S. Senate,Andy Craig,REP,600103,0,0,2,2,
Payne,U.S. Senate,T. Shannon,REP,600103,3,0,48,51,
Payne,U.S. Senate,Randy Brogdon,REP,600103,0,0,5,5,
Payne,U.S. Senate,Eric Mccray,REP,600103,0,0,0,0,
Payne,U.S. Senate,Kevin Crow,REP,600103,0,0,3,3,
Payne,U.S. Senate,James Lankford,REP,600103,1,1,109,111,
Payne,U.S. Senate,Jason Weger,REP,600103,0,0,1,1,
Payne,U.S. House,Timothy Ray Murray,REP,600103,0,0,9,9,03
Payne,U.S. House,Robert Hubbard,REP,600103,2,0,19,21,03
Payne,U.S. House,Frank Lucas,REP,600103,2,1,138,141,03
Payne,Superintendent of Public Instruction,John Cox,DEM,600104,0,0,42,42,
Payne,Superintendent of Public Instruction,Jack Jr.,DEM,600104,0,0,10,10,
Payne,Superintendent of Public Instruction,Ivan Holmes,DEM,600104,1,0,3,4,
Payne,Superintendent of Public Instruction,Freda Deskin,DEM,600104,0,0,26,26,
Payne,U.S. Senate,Patrick Michael Hayes,DEM,600104,0,0,20,20,
Payne,U.S. Senate,Jim Rogers,DEM,600104,0,0,24,24,
Payne,U.S. Senate,Connie Johnson,DEM,600104,1,0,34,35,
Payne,Governor,Dax Ewbank,REP,600104,0,4,3,7,
Payne,Governor,Chad Moody,REP,600104,0,2,28,30,
Payne,Governor,Mary Fallin,REP,600104,6,2,153,161,
Payne,Superintendent of Public Instruction,Brian Kelly,REP,600104,1,0,28,29,
Payne,Superintendent of Public Instruction,Janet Costello Barresi,REP,600104,1,1,21,23,
Payne,Superintendent of Public Instruction,Joy Hofmeister,REP,600104,4,7,135,146,
Payne,Insurance Commissioner,Bill Viner,REP,600104,0,1,39,40,
Payne,Insurance Commissioner,John Doak,REP,600104,6,7,138,151,
Payne,Corporation Commissioner,Todd Hiett,REP,600104,5,5,110,120,
Payne,Corporation Commissioner,Cliff Branan,REP,600104,1,3,66,70,
Payne,U.S. Senate,Evelyn Rogers,REP,600104,0,0,6,6,
Payne,U.S. Senate,Rob Moye,REP,600104,0,0,1,1,
Payne,U.S. Senate,D. Jean Mcbride-Samuels,REP,600104,0,0,2,2,
Payne,U.S. Senate,Jim Inhofe,REP,600104,6,7,168,181,
Payne,U.S. Senate,Erick Paul Wyatt,REP,600104,0,1,7,8,
Payne,U.S. Senate,Andy Craig,REP,600104,0,0,2,2,
Payne,U.S. Senate,T. Shannon,REP,600104,1,3,51,55,
Payne,U.S. Senate,Randy Brogdon,REP,600104,0,0,2,2,
Payne,U.S. Senate,Eric Mccray,REP,600104,0,0,1,1,
Payne,U.S. Senate,Kevin Crow,REP,600104,0,0,1,1,
Payne,U.S. Senate,James Lankford,REP,600104,5,5,127,137,
Payne,U.S. Senate,Jason Weger,REP,600104,0,0,1,1,
Payne,U.S. House,Timothy Ray Murray,REP,600104,0,0,5,5,03
Payne,U.S. House,Robert Hubbard,REP,600104,0,1,13,14,03
Payne,U.S. House,Frank Lucas,REP,600104,6,7,164,177,03
Payne,Superintendent of Public Instruction,John Cox,DEM,600201,1,0,27,28,
Payne,Superintendent of Public Instruction,Jack Jr.,DEM,600201,1,0,15,16,
Payne,Superintendent of Public Instruction,Ivan Holmes,DEM,600201,0,0,6,6,
Payne,Superintendent of Public Instruction,Freda Deskin,DEM,600201,2,0,44,46,
Payne,U.S. Senate,Patrick Michael Hayes,DEM,600201,0,0,15,15,
Payne,U.S. Senate,Jim Rogers,DEM,600201,2,0,43,45,
Payne,U.S. Senate,Connie Johnson,DEM,600201,2,0,33,35,
Payne,Governor,Dax Ewbank,REP,600201,0,0,13,13,
Payne,Governor,Chad Moody,REP,600201,0,0,14,14,
Payne,Governor,Mary Fallin,REP,600201,3,1,105,109,
Payne,Superintendent of Public Instruction,Brian Kelly,REP,600201,0,0,37,37,
Payne,Superintendent of Public Instruction,Janet Costello Barresi,REP,600201,2,0,17,19,
Payne,Superintendent of Public Instruction,Joy Hofmeister,REP,600201,1,1,76,78,
Payne,Insurance Commissioner,Bill Viner,REP,600201,0,0,24,24,
Payne,Insurance Commissioner,John Doak,REP,600201,3,1,102,106,
Payne,Corporation Commissioner,Todd Hiett,REP,600201,2,1,68,71,
Payne,Corporation Commissioner,Cliff Branan,REP,600201,1,0,60,61,
Payne,U.S. Senate,Evelyn Rogers,REP,600201,0,0,9,9,
Payne,U.S. Senate,Rob Moye,REP,600201,0,0,2,2,
Payne,U.S. Senate,D. Jean Mcbride-Samuels,REP,600201,0,0,1,1,
Payne,U.S. Senate,Jim Inhofe,REP,600201,3,1,113,117,
Payne,U.S. Senate,Erick Paul Wyatt,REP,600201,0,0,7,7,
Payne,U.S. Senate,Andy Craig,REP,600201,0,0,0,0,
Payne,U.S. Senate,T. Shannon,REP,600201,0,0,56,56,
Payne,U.S. Senate,Randy Brogdon,REP,600201,0,0,5,5,
Payne,U.S. Senate,Eric Mccray,REP,600201,0,0,0,0,
Payne,U.S. Senate,Kevin Crow,REP,600201,0,0,2,2,
Payne,U.S. Senate,James Lankford,REP,600201,3,1,70,74,
Payne,U.S. Senate,Jason Weger,REP,600201,0,0,0,0,
Payne,U.S. House,Timothy Ray Murray,REP,600201,0,0,4,4,03
Payne,U.S. House,Robert Hubbard,REP,600201,0,0,21,21,03
Payne,U.S. House,Frank Lucas,REP,600201,3,1,108,112,03
Payne,Superintendent of Public Instruction,John Cox,DEM,600301,2,2,69,73,
Payne,Superintendent of Public Instruction,Jack Jr.,DEM,600301,0,0,29,29,
Payne,Superintendent of Public Instruction,Ivan Holmes,DEM,600301,0,0,9,9,
Payne,Superintendent of Public Instruction,Freda Deskin,DEM,600301,0,1,65,66,
Payne,U.S. Senate,Patrick Michael Hayes,DEM,600301,0,0,31,31,
Payne,U.S. Senate,Jim Rogers,DEM,600301,0,2,57,59,
Payne,U.S. Senate,Connie Johnson,DEM,600301,2,1,84,87,
Payne,Governor,Dax Ewbank,REP,600301,3,4,39,46,
Payne,Governor,Chad Moody,REP,600301,0,4,81,85,
Payne,Governor,Mary Fallin,REP,600301,4,24,285,313,
Payne,Superintendent of Public Instruction,Brian Kelly,REP,600301,2,9,83,94,
Payne,Superintendent of Public Instruction,Janet Costello Barresi,REP,600301,4,5,58,67,
Payne,Superintendent of Public Instruction,Joy Hofmeister,REP,600301,2,18,265,285,
Payne,Insurance Commissioner,Bill Viner,REP,600301,2,9,107,118,
Payne,Insurance Commissioner,John Doak,REP,600301,6,22,265,293,
Payne,Corporation Commissioner,Todd Hiett,REP,600301,6,18,203,227,
Payne,Corporation Commissioner,Cliff Branan,REP,600301,2,14,184,200,
Payne,U.S. Senate,Evelyn Rogers,REP,600301,0,2,22,24,
Payne,U.S. Senate,Rob Moye,REP,600301,0,0,9,9,
Payne,U.S. Senate,D. Jean Mcbride-Samuels,REP,600301,0,1,9,10,
Payne,U.S. Senate,Jim Inhofe,REP,600301,6,29,347,382,
Payne,U.S. Senate,Erick Paul Wyatt,REP,600301,2,0,20,22,
Payne,U.S. Senate,Andy Craig,REP,600301,0,1,1,2,
Payne,U.S. Senate,T. Shannon,REP,600301,4,5,161,170,
Payne,U.S. Senate,Randy Brogdon,REP,600301,0,0,14,14,
Payne,U.S. Senate,Eric Mccray,REP,600301,0,0,4,4,
Payne,U.S. Senate,Kevin Crow,REP,600301,0,0,7,7,
Payne,U.S. Senate,James Lankford,REP,600301,3,26,225,254,
Payne,U.S. Senate,Jason Weger,REP,600301,0,0,2,2,
Payne,U.S. House,Timothy Ray Murray,REP,600301,0,0,19,19,03
Payne,U.S. House,Robert Hubbard,REP,600301,0,2,57,59,03
Payne,U.S. House,Frank Lucas,REP,600301,8,30,324,362,03
Payne,Superintendent of Public Instruction,John Cox,DEM,600401,2,7,38,47,
Payne,Superintendent of Public Instruction,Jack Jr.,DEM,600401,0,3,19,22,
Payne,Superintendent of Public Instruction,Ivan Holmes,DEM,600401,3,2,8,13,
Payne,Superintendent of Public Instruction,Freda Deskin,DEM,600401,2,10,40,52,
Payne,U.S. Senate,Patrick Michael Hayes,DEM,600401,0,3,12,15,
Payne,U.S. Senate,Jim Rogers,DEM,600401,1,8,39,48,
Payne,U.S. Senate,Connie Johnson,DEM,600401,7,10,52,69,
Payne,Governor,Dax Ewbank,REP,600401,3,2,36,41,
Payne,Governor,Chad Moody,REP,600401,0,5,53,58,
Payne,Governor,Mary Fallin,REP,600401,8,29,271,308,
Payne,Superintendent of Public Instruction,Brian Kelly,REP,600401,2,6,63,71,
Payne,Superintendent of Public Instruction,Janet Costello Barresi,REP,600401,2,13,58,73,
Payne,Superintendent of Public Instruction,Joy Hofmeister,REP,600401,7,18,234,259,
Payne,Insurance Commissioner,Bill Viner,REP,600401,2,7,64,73,
Payne,Insurance Commissioner,John Doak,REP,600401,8,25,260,293,
Payne,Corporation Commissioner,Todd Hiett,REP,600401,2,21,188,211,
Payne,Corporation Commissioner,Cliff Branan,REP,600401,8,12,151,171,
Payne,U.S. Senate,Evelyn Rogers,REP,600401,0,2,24,26,
Payne,U.S. Senate,Rob Moye,REP,600401,0,0,7,7,
Payne,U.S. Senate,D. Jean Mcbride-Samuels,REP,600401,0,1,3,4,
Payne,U.S. Senate,Jim Inhofe,REP,600401,10,30,309,349,
Payne,U.S. Senate,Erick Paul Wyatt,REP,600401,0,2,19,21,
Payne,U.S. Senate,Andy Craig,REP,600401,0,0,1,1,
Payne,U.S. Senate,T. Shannon,REP,600401,4,7,107,118,
Payne,U.S. Senate,Randy Brogdon,REP,600401,0,1,16,17,
Payne,U.S. Senate,Eric Mccray,REP,600401,0,0,4,4,
Payne,U.S. Senate,Kevin Crow,REP,600401,0,0,3,3,
Payne,U.S. Senate,James Lankford,REP,600401,6,27,233,266,
Payne,U.S. Senate,Jason Weger,REP,600401,0,0,0,0,
Payne,U.S. House,Timothy Ray Murray,REP,600401,0,3,16,19,03
Payne,U.S. House,Robert Hubbard,REP,600401,2,3,42,47,03
Payne,U.S. House,Frank Lucas,REP,600401,9,29,305,343,03
Payne,Superintendent of Public Instruction,John Cox,DEM,600402,0,2,18,20,
Payne,Superintendent of Public Instruction,Jack Jr.,DEM,600402,0,0,13,13,
Payne,Superintendent of Public Instruction,Ivan Holmes,DEM,600402,1,0,2,3,
Payne,Superintendent of Public Instruction,Freda Deskin,DEM,600402,1,0,31,32,
Payne,U.S. Senate,Patrick Michael Hayes,DEM,600402,1,0,12,13,
Payne,U.S. Senate,Jim Rogers,DEM,600402,0,1,21,22,
Payne,U.S. Senate,Connie Johnson,DEM,600402,1,1,30,32,
Payne,Governor,Dax Ewbank,REP,600402,0,1,7,8,
Payne,Governor,Chad Moody,REP,600402,0,2,15,17,
Payne,Governor,Mary Fallin,REP,600402,5,5,114,124,
Payne,Superintendent of Public Instruction,Brian Kelly,REP,600402,1,3,31,35,
Payne,Superintendent of Public Instruction,Janet Costello Barresi,REP,600402,0,3,22,25,
Payne,Superintendent of Public Instruction,Joy Hofmeister,REP,600402,4,2,75,81,
Payne,Insurance Commissioner,Bill Viner,REP,600402,1,1,24,26,
Payne,Insurance Commissioner,John Doak,REP,600402,3,7,98,108,
Payne,Corporation Commissioner,Todd Hiett,REP,600402,4,4,52,60,
Payne,Corporation Commissioner,Cliff Branan,REP,600402,0,4,64,68,
Payne,U.S. Senate,Evelyn Rogers,REP,600402,0,0,7,7,
Payne,U.S. Senate,Rob Moye,REP,600402,0,0,3,3,
Payne,U.S. Senate,D. Jean Mcbride-Samuels,REP,600402,0,0,3,3,
Payne,U.S. Senate,Jim Inhofe,REP,600402,5,6,113,124,
Payne,U.S. Senate,Erick Paul Wyatt,REP,600402,0,2,6,8,
Payne,U.S. Senate,Andy Craig,REP,600402,0,0,2,2,
Payne,U.S. Senate,T. Shannon,REP,600402,2,4,52,58,
Payne,U.S. Senate,Randy Brogdon,REP,600402,0,0,3,3,
Payne,U.S. Senate,Eric Mccray,REP,600402,0,0,1,1,
Payne,U.S. Senate,Kevin Crow,REP,600402,0,0,1,1,
Payne,U.S. Senate,James Lankford,REP,600402,3,4,73,80,
Payne,U.S. Senate,Jason Weger,REP,600402,0,0,1,1,
Payne,U.S. House,Timothy Ray Murray,REP,600402,2,1,8,11,03
Payne,U.S. House,Robert Hubbard,REP,600402,0,1,16,17,03
Payne,U.S. House,Frank Lucas,REP,600402,3,6,109,118,03
Payne,Superintendent of Public Instruction,John Cox,DEM,600403,0,2,20,22,
Payne,Superintendent of Public Instruction,Jack Jr.,DEM,600403,0,1,5,6,
Payne,Superintendent of Public Instruction,Ivan Holmes,DEM,600403,0,2,2,4,
Payne,Superintendent of Public Instruction,Freda Deskin,DEM,600403,1,2,19,22,
Payne,U.S. Senate,Patrick Michael Hayes,DEM,600403,0,1,7,8,
Payne,U.S. Senate,Jim Rogers,DEM,600403,0,3,11,14,
Payne,U.S. Senate,Connie Johnson,DEM,600403,1,3,28,32,
Payne,Governor,Dax Ewbank,REP,600403,0,0,12,12,
Payne,Governor,Chad Moody,REP,600403,0,0,23,23,
Payne,Governor,Mary Fallin,REP,600403,2,16,123,141,
Payne,Superintendent of Public Instruction,Brian Kelly,REP,600403,0,1,42,43,
Payne,Superintendent of Public Instruction,Janet Costello Barresi,REP,600403,2,5,19,26,
Payne,Superintendent of Public Instruction,Joy Hofmeister,REP,600403,0,10,96,106,
Payne,Insurance Commissioner,Bill Viner,REP,600403,0,2,27,29,
Payne,Insurance Commissioner,John Doak,REP,600403,2,11,115,128,
Payne,Corporation Commissioner,Todd Hiett,REP,600403,1,8,85,94,
Payne,Corporation Commissioner,Cliff Branan,REP,600403,0,4,60,64,
Payne,U.S. Senate,Evelyn Rogers,REP,600403,0,1,10,11,
Payne,U.S. Senate,Rob Moye,REP,600403,0,0,0,0,
Payne,U.S. Senate,D. Jean Mcbride-Samuels,REP,600403,0,0,2,2,
Payne,U.S. Senate,Jim Inhofe,REP,600403,2,14,140,156,
Payne,U.S. Senate,Erick Paul Wyatt,REP,600403,0,0,6,6,
Payne,U.S. Senate,Andy Craig,REP,600403,0,0,1,1,
Payne,U.S. Senate,T. Shannon,REP,600403,0,4,58,62,
Payne,U.S. Senate,Randy Brogdon,REP,600403,0,0,7,7,
Payne,U.S. Senate,Eric Mccray,REP,600403,0,0,1,1,
Payne,U.S. Senate,Kevin Crow,REP,600403,0,0,5,5,
Payne,U.S. Senate,James Lankford,REP,600403,2,12,86,100,
Payne,U.S. Senate,Jason Weger,REP,600403,0,0,0,0,
Payne,U.S. House,Timothy Ray Murray,REP,600403,0,1,3,4,03
Payne,U.S. House,Robert Hubbard,REP,600403,0,0,14,14,03
Payne,U.S. House,Frank Lucas,REP,600403,2,15,141,158,03
Payne,Superintendent of Public Instruction,John Cox,DEM,600404,0,0,2,2,
Payne,Superintendent of Public Instruction,Jack Jr.,DEM,600404,0,1,2,3,
Payne,Superintendent of Public Instruction,Ivan Holmes,DEM,600404,0,0,0,0,
Payne,Superintendent of Public Instruction,Freda Deskin,DEM,600404,0,0,7,7,
Payne,U.S. Senate,Patrick Michael Hayes,DEM,600404,0,0,2,2,
Payne,U.S. Senate,Jim Rogers,DEM,600404,0,1,3,4,
Payne,U.S. Senate,Connie Johnson,DEM,600404,0,0,5,5,
Payne,Governor,Dax Ewbank,REP,600404,0,0,3,3,
Payne,Governor,Chad Moody,REP,600404,0,0,3,3,
Payne,Governor,Mary Fallin,REP,600404,0,2,18,20,
Payne,Superintendent of Public Instruction,Brian Kelly,REP,600404,0,0,8,8,
Payne,Superintendent of Public Instruction,Janet Costello Barresi,REP,600404,0,1,2,3,
Payne,Superintendent of Public Instruction,Joy Hofmeister,REP,600404,0,1,14,15,
Payne,Insurance Commissioner,Bill Viner,REP,600404,0,0,6,6,
Payne,Insurance Commissioner,John Doak,REP,600404,0,2,18,20,
Payne,Corporation Commissioner,Todd Hiett,REP,600404,0,2,15,17,
Payne,Corporation Commissioner,Cliff Branan,REP,600404,0,0,9,9,
Payne,U.S. Senate,Evelyn Rogers,REP,600404,0,0,0,0,
Payne,U.S. Senate,Rob Moye,REP,600404,0,0,0,0,
Payne,U.S. Senate,D. Jean Mcbride-Samuels,REP,600404,0,0,2,2,
Payne,U.S. Senate,Jim Inhofe,REP,600404,0,2,22,24,
Payne,U.S. Senate,Erick Paul Wyatt,REP,600404,0,0,0,0,
Payne,U.S. Senate,Andy Craig,REP,600404,0,0,0,0,
Payne,U.S. Senate,T. Shannon,REP,600404,0,1,9,10,
Payne,U.S. Senate,Randy Brogdon,REP,600404,0,0,0,0,
Payne,U.S. Senate,Eric Mccray,REP,600404,0,0,1,1,
Payne,U.S. Senate,Kevin Crow,REP,600404,0,0,0,0,
Payne,U.S. Senate,James Lankford,REP,600404,0,1,14,15,
Payne,U.S. Senate,Jason Weger,REP,600404,0,0,0,0,
Payne,U.S. House,Timothy Ray Murray,REP,600404,0,0,2,2,03
Payne,U.S. House,Robert Hubbard,REP,600404,0,0,1,1,03
Payne,U.S. House,Frank Lucas,REP,600404,0,2,21,23,03
Payne,Superintendent of Public Instruction,John Cox,DEM,600405,1,3,23,27,
Payne,Superintendent of Public Instruction,Jack Jr.,DEM,600405,2,1,13,16,
Payne,Superintendent of Public Instruction,Ivan Holmes,DEM,600405,0,1,2,3,
Payne,Superintendent of Public Instruction,Freda Deskin,DEM,600405,0,2,34,36,
Payne,U.S. Senate,Patrick Michael Hayes,DEM,600405,2,0,11,13,
Payne,U.S. Senate,Jim Rogers,DEM,600405,1,3,28,32,
Payne,U.S. Senate,Connie Johnson,DEM,600405,0,4,33,37,
Payne,Governor,Dax Ewbank,REP,600405,0,1,17,18,
Payne,Governor,Chad Moody,REP,600405,1,7,38,46,
Payne,Governor,Mary Fallin,REP,600405,5,16,159,180,
Payne,Superintendent of Public Instruction,Brian Kelly,REP,600405,0,8,46,54,
Payne,Superintendent of Public Instruction,Janet Costello Barresi,REP,600405,4,5,34,43,
Payne,Superintendent of Public Instruction,Joy Hofmeister,REP,600405,2,11,133,146,
Payne,Insurance Commissioner,Bill Viner,REP,600405,2,6,42,50,
Payne,Insurance Commissioner,John Doak,REP,600405,4,17,159,180,
Payne,Corporation Commissioner,Todd Hiett,REP,600405,5,12,118,135,
Payne,Corporation Commissioner,Cliff Branan,REP,600405,1,12,82,95,
Payne,U.S. Senate,Evelyn Rogers,REP,600405,0,0,17,17,
Payne,U.S. Senate,Rob Moye,REP,600405,0,1,3,4,
Payne,U.S. Senate,D. Jean Mcbride-Samuels,REP,600405,0,1,5,6,
Payne,U.S. Senate,Jim Inhofe,REP,600405,5,19,177,201,
Payne,U.S. Senate,Erick Paul Wyatt,REP,600405,1,3,12,16,
Payne,U.S. Senate,Andy Craig,REP,600405,0,1,1,2,
Payne,U.S. Senate,T. Shannon,REP,600405,3,10,78,91,
Payne,U.S. Senate,Randy Brogdon,REP,600405,0,0,7,7,
Payne,U.S. Senate,Eric Mccray,REP,600405,0,0,3,3,
Payne,U.S. Senate,Kevin Crow,REP,600405,0,1,1,2,
Payne,U.S. Senate,James Lankford,REP,600405,2,11,122,135,
Payne,U.S. Senate,Jason Weger,REP,600405,1,1,1,3,
Payne,U.S. House,Timothy Ray Murray,REP,600405,0,3,10,13,03
Payne,U.S. House,Robert Hubbard,REP,600405,1,3,25,29,03
Payne,U.S. House,Frank Lucas,REP,600405,5,18,176,199,03
Payne,Superintendent of Public Instruction,John Cox,DEM,600406,0,2,23,25,
Payne,Superintendent of Public Instruction,Jack Jr.,DEM,600406,0,0,10,10,
Payne,Superintendent of Public Instruction,Ivan Holmes,DEM,600406,0,0,3,3,
Payne,Superintendent of Public Instruction,Freda Deskin,DEM,600406,0,1,21,22,
Payne,U.S. Senate,Patrick Michael Hayes,DEM,600406,0,0,10,10,
Payne,U.S. Senate,Jim Rogers,DEM,600406,0,3,24,27,
Payne,U.S. Senate,Connie Johnson,DEM,600406,0,0,22,22,
Payne,Governor,Dax Ewbank,REP,600406,0,0,26,26,
Payne,Governor,Chad Moody,REP,600406,0,2,22,24,
Payne,Governor,Mary Fallin,REP,600406,3,4,127,134,
Payne,Superintendent of Public Instruction,Brian Kelly,REP,600406,0,1,31,32,
Payne,Superintendent of Public Instruction,Janet Costello Barresi,REP,600406,3,1,25,29,
Payne,Superintendent of Public Instruction,Joy Hofmeister,REP,600406,0,4,118,122,
Payne,Insurance Commissioner,Bill Viner,REP,600406,0,0,49,49,
Payne,Insurance Commissioner,John Doak,REP,600406,3,6,122,131,
Payne,Corporation Commissioner,Todd Hiett,REP,600406,3,1,95,99,
Payne,Corporation Commissioner,Cliff Branan,REP,600406,0,5,73,78,
Payne,U.S. Senate,Evelyn Rogers,REP,600406,0,0,2,2,
Payne,U.S. Senate,Rob Moye,REP,600406,0,0,5,5,
Payne,U.S. Senate,D. Jean Mcbride-Samuels,REP,600406,0,0,1,1,
Payne,U.S. Senate,Jim Inhofe,REP,600406,3,6,155,164,
Payne,U.S. Senate,Erick Paul Wyatt,REP,600406,0,0,8,8,
Payne,U.S. Senate,Andy Craig,REP,600406,0,0,2,2,
Payne,U.S. Senate,T. Shannon,REP,600406,0,4,70,74,
Payne,U.S. Senate,Randy Brogdon,REP,600406,0,0,3,3,
Payne,U.S. Senate,Eric Mccray,REP,600406,0,0,2,2,
Payne,U.S. Senate,Kevin Crow,REP,600406,0,0,2,2,
Payne,U.S. Senate,James Lankford,REP,600406,3,2,95,100,
Payne,U.S. Senate,Jason Weger,REP,600406,0,0,0,0,
Payne,U.S. House,Timothy Ray Murray,REP,600406,0,0,10,10,03
Payne,U.S. House,Robert Hubbard,REP,600406,0,0,15,15,03
Payne,U.S. House,Frank Lucas,REP,600406,3,6,149,158,03
Payne,Superintendent of Public Instruction,John Cox,DEM,600407,1,1,28,30,
Payne,Superintendent of Public Instruction,Jack Jr.,DEM,600407,0,3,15,18,
Payne,Superintendent of Public Instruction,Ivan Holmes,DEM,600407,0,0,4,4,
Payne,Superintendent of Public Instruction,Freda Deskin,DEM,600407,0,0,37,37,
Payne,U.S. Senate,Patrick Michael Hayes,DEM,600407,1,1,12,14,
Payne,U.S. Senate,Jim Rogers,DEM,600407,0,0,34,34,
Payne,U.S. Senate,Connie Johnson,DEM,600407,0,3,38,41,
Payne,Governor,Dax Ewbank,REP,600407,1,0,27,28,
Payne,Governor,Chad Moody,REP,600407,0,1,34,35,
Payne,Governor,Mary Fallin,REP,600407,3,9,148,160,
Payne,Superintendent of Public Instruction,Brian Kelly,REP,600407,1,5,50,56,
Payne,Superintendent of Public Instruction,Janet Costello Barresi,REP,600407,0,1,27,28,
Payne,Superintendent of Public Instruction,Joy Hofmeister,REP,600407,2,4,130,136,
Payne,Insurance Commissioner,Bill Viner,REP,600407,0,3,51,54,
Payne,Insurance Commissioner,John Doak,REP,600407,4,7,142,153,
Payne,Corporation Commissioner,Todd Hiett,REP,600407,2,5,113,120,
Payne,Corporation Commissioner,Cliff Branan,REP,600407,1,4,82,87,
Payne,U.S. Senate,Evelyn Rogers,REP,600407,0,1,15,16,
Payne,U.S. Senate,Rob Moye,REP,600407,0,0,5,5,
Payne,U.S. Senate,D. Jean Mcbride-Samuels,REP,600407,0,0,7,7,
Payne,U.S. Senate,Jim Inhofe,REP,600407,3,8,168,179,
Payne,U.S. Senate,Erick Paul Wyatt,REP,600407,1,1,10,12,
Payne,U.S. Senate,Andy Craig,REP,600407,0,0,1,1,
Payne,U.S. Senate,T. Shannon,REP,600407,1,3,90,94,
Payne,U.S. Senate,Randy Brogdon,REP,600407,0,1,4,5,
Payne,U.S. Senate,Eric Mccray,REP,600407,0,0,1,1,
Payne,U.S. Senate,Kevin Crow,REP,600407,0,0,1,1,
Payne,U.S. Senate,James Lankford,REP,600407,3,6,111,120,
Payne,U.S. Senate,Jason Weger,REP,600407,0,0,0,0,
Payne,U.S. House,Timothy Ray Murray,REP,600407,0,1,8,9,03
Payne,U.S. House,Robert Hubbard,REP,600407,1,0,30,31,03
Payne,U.S. House,Frank Lucas,REP,600407,3,9,167,179,03
Payne,Superintendent of Public Instruction,John Cox,DEM,600408,0,0,10,10,
Payne,Superintendent of Public Instruction,Jack Jr.,DEM,600408,0,0,7,7,
Payne,Superintendent of Public Instruction,Ivan Holmes,DEM,600408,0,0,4,4,
Payne,Superintendent of Public Instruction,Freda Deskin,DEM,600408,0,0,7,7,
Payne,U.S. Senate,Patrick Michael Hayes,DEM,600408,0,0,2,2,
Payne,U.S. Senate,Jim Rogers,DEM,600408,0,0,13,13,
Payne,U.S. Senate,Connie Johnson,DEM,600408,0,0,12,12,
Payne,Governor,Dax Ewbank,REP,600408,0,0,6,6,
Payne,Governor,Chad Moody,REP,600408,0,1,6,7,
Payne,Governor,Mary Fallin,REP,600408,0,2,48,50,
Payne,Superintendent of Public Instruction,Brian Kelly,REP,600408,0,1,17,18,
Payne,Superintendent of Public Instruction,Janet Costello Barresi,REP,600408,0,0,6,6,
Payne,Superintendent of Public Instruction,Joy Hofmeister,REP,600408,0,2,36,38,
Payne,Insurance Commissioner,Bill Viner,REP,600408,0,0,16,16,
Payne,Insurance Commissioner,John Doak,REP,600408,0,2,40,42,
Payne,Corporation Commissioner,Todd Hiett,REP,600408,0,0,30,30,
Payne,Corporation Commissioner,Cliff Branan,REP,600408,0,2,27,29,
Payne,U.S. Senate,Evelyn Rogers,REP,600408,0,0,4,4,
Payne,U.S. Senate,Rob Moye,REP,600408,0,0,1,1,
Payne,U.S. Senate,D. Jean Mcbride-Samuels,REP,600408,0,0,0,0,
Payne,U.S. Senate,Jim Inhofe,REP,600408,0,2,48,50,
Payne,U.S. Senate,Erick Paul Wyatt,REP,600408,0,1,7,8,
Payne,U.S. Senate,Andy Craig,REP,600408,0,0,1,1,
Payne,U.S. Senate,T. Shannon,REP,600408,0,0,27,27,
Payne,U.S. Senate,Randy Brogdon,REP,600408,0,1,0,1,
Payne,U.S. Senate,Eric Mccray,REP,600408,0,0,0,0,
Payne,U.S. Senate,Kevin Crow,REP,600408,0,0,0,0,
Payne,U.S. Senate,James Lankford,REP,600408,0,1,31,32,
Payne,U.S. Senate,Jason Weger,REP,600408,0,0,0,0,
Payne,U.S. House,Timothy Ray Murray,REP,600408,0,0,2,2,03
Payne,U.S. House,Robert Hubbard,REP,600408,0,2,5,7,03
Payne,U.S. House,Frank Lucas,REP,600408,0,1,53,54,03
Payne,Superintendent of Public Instruction,John Cox,DEM,600409,0,0,31,31,
Payne,Superintendent of Public Instruction,Jack Jr.,DEM,600409,1,1,10,12,
Payne,Superintendent of Public Instruction,Ivan Holmes,DEM,600409,0,0,4,4,
Payne,Superintendent of Public Instruction,Freda Deskin,DEM,600409,0,1,27,28,
Payne,U.S. Senate,Patrick Michael Hayes,DEM,600409,0,0,11,11,
Payne,U.S. Senate,Jim Rogers,DEM,600409,0,1,34,35,
Payne,U.S. Senate,Connie Johnson,DEM,600409,1,0,27,28,
Payne,Governor,Dax Ewbank,REP,600409,0,1,13,14,
Payne,Governor,Chad Moody,REP,600409,0,0,27,27,
Payne,Governor,Mary Fallin,REP,600409,4,4,101,109,
Payne,Superintendent of Public Instruction,Brian Kelly,REP,600409,1,0,25,26,
Payne,Superintendent of Public Instruction,Janet Costello Barresi,REP,600409,2,1,26,29,
Payne,Superintendent of Public Instruction,Joy Hofmeister,REP,600409,1,5,87,93,
Payne,Insurance Commissioner,Bill Viner,REP,600409,0,1,36,37,
Payne,Insurance Commissioner,John Doak,REP,600409,3,5,93,101,
Payne,Corporation Commissioner,Todd Hiett,REP,600409,3,3,66,72,
Payne,Corporation Commissioner,Cliff Branan,REP,600409,0,1,68,69,
Payne,U.S. Senate,Evelyn Rogers,REP,600409,0,1,10,11,
Payne,U.S. Senate,Rob Moye,REP,600409,0,0,3,3,
Payne,U.S. Senate,D. Jean Mcbride-Samuels,REP,600409,0,0,4,4,
Payne,U.S. Senate,Jim Inhofe,REP,600409,4,4,111,119,
Payne,U.S. Senate,Erick Paul Wyatt,REP,600409,0,0,14,14,
Payne,U.S. Senate,Andy Craig,REP,600409,0,0,0,0,
Payne,U.S. Senate,T. Shannon,REP,600409,1,4,53,58,
Payne,U.S. Senate,Randy Brogdon,REP,600409,0,0,7,7,
Payne,U.S. Senate,Eric Mccray,REP,600409,1,0,2,3,
Payne,U.S. Senate,Kevin Crow,REP,600409,0,0,1,1,
Payne,U.S. Senate,James Lankford,REP,600409,2,2,76,80,
Payne,U.S. Senate,Jason Weger,REP,600409,0,0,2,2,
Payne,U.S. House,Timothy Ray Murray,REP,600409,0,1,8,9,03
Payne,U.S. House,Robert Hubbard,REP,600409,0,0,23,23,03
Payne,U.S. House,Frank Lucas,REP,600409,4,5,111,120,03
Pittsburg,Superintendent of Public Instruction,John Cox,DEM,610001,0,0,8,8,
Pittsburg,Superintendent of Public Instruction,Jack Jr.,DEM,610001,0,1,1,2,
Pittsburg,Superintendent of Public Instruction,Ivan Holmes,DEM,610001,0,0,0,0,
Pittsburg,Superintendent of Public Instruction,Freda Deskin,DEM,610001,0,0,6,6,
Pittsburg,U.S. Senate,Patrick Michael Hayes,DEM,610001,0,0,6,6,
Pittsburg,U.S. Senate,Jim Rogers,DEM,610001,0,1,3,4,
Pittsburg,U.S. Senate,Connie Johnson,DEM,610001,0,0,6,6,
Pittsburg,U.S. House,Earl Everett,DEM,610001,0,0,7,7,02
Pittsburg,U.S. House,Joshua Harris-Till,DEM,610001,0,0,8,8,02
Pittsburg,Governor,Dax Ewbank,REP,610001,0,0,2,2,
Pittsburg,Governor,Chad Moody,REP,610001,0,0,2,2,
Pittsburg,Governor,Mary Fallin,REP,610001,0,0,2,2,
Pittsburg,Superintendent of Public Instruction,Brian Kelly,REP,610001,0,0,0,0,
Pittsburg,Superintendent of Public Instruction,Janet Costello Barresi,REP,610001,0,0,2,2,
Pittsburg,Superintendent of Public Instruction,Joy Hofmeister,REP,610001,0,0,4,4,
Pittsburg,Insurance Commissioner,Bill Viner,REP,610001,0,0,0,0,
Pittsburg,Insurance Commissioner,John Doak,REP,610001,0,0,6,6,
Pittsburg,Corporation Commissioner,Todd Hiett,REP,610001,0,0,4,4,
Pittsburg,Corporation Commissioner,Cliff Branan,REP,610001,0,0,2,2,
Pittsburg,U.S. Senate,Evelyn Rogers,REP,610001,0,0,0,0,
Pittsburg,U.S. Senate,Rob Moye,REP,610001,0,0,0,0,
Pittsburg,U.S. Senate,D. Jean Mcbride-Samuels,REP,610001,0,0,0,0,
Pittsburg,U.S. Senate,Jim Inhofe,REP,610001,0,0,6,6,
Pittsburg,U.S. Senate,Erick Paul Wyatt,REP,610001,0,0,0,0,
Pittsburg,U.S. Senate,Andy Craig,REP,610001,0,0,0,0,
Pittsburg,U.S. Senate,T. Shannon,REP,610001,0,0,2,2,
Pittsburg,U.S. Senate,Randy Brogdon,REP,610001,0,0,3,3,
Pittsburg,U.S. Senate,Eric Mccray,REP,610001,0,0,0,0,
Pittsburg,U.S. Senate,Kevin Crow,REP,610001,0,0,0,0,
Pittsburg,U.S. Senate,James Lankford,REP,610001,0,0,1,1,
Pittsburg,U.S. Senate,Jason Weger,REP,610001,0,0,0,0,
Pittsburg,U.S. House,Darrel Robertson,REP,610001,0,0,0,0,02
Pittsburg,U.S. House,Markwayne Mullin,REP,610001,0,0,6,6,02
Pittsburg,State House,Paul Marean,REP,610001,0,0,2,2,17
Pittsburg,State House,Micah Thompson,REP,610001,0,0,4,4,17
Pittsburg,Superintendent of Public Instruction,John Cox,DEM,610003,0,6,43,49,
Pittsburg,Superintendent of Public Instruction,Jack Jr.,DEM,610003,0,1,11,12,
Pittsburg,Superintendent of Public Instruction,Ivan Holmes,DEM,610003,0,0,3,3,
Pittsburg,Superintendent of Public Instruction,Freda Deskin,DEM,610003,0,2,36,38,
Pittsburg,U.S. Senate,Patrick Michael Hayes,DEM,610003,0,3,14,17,
Pittsburg,U.S. Senate,Jim Rogers,DEM,610003,0,5,49,54,
Pittsburg,U.S. Senate,Connie Johnson,DEM,610003,0,1,27,28,
Pittsburg,U.S. House,Earl Everett,DEM,610003,0,4,63,67,02
Pittsburg,U.S. House,Joshua Harris-Till,DEM,610003,0,5,28,33,02
Pittsburg,Governor,Dax Ewbank,REP,610003,0,0,1,1,
Pittsburg,Governor,Chad Moody,REP,610003,0,2,9,11,
Pittsburg,Governor,Mary Fallin,REP,610003,0,1,24,25,
Pittsburg,Superintendent of Public Instruction,Brian Kelly,REP,610003,0,0,7,7,
Pittsburg,Superintendent of Public Instruction,Janet Costello Barresi,REP,610003,0,0,8,8,
Pittsburg,Superintendent of Public Instruction,Joy Hofmeister,REP,610003,0,3,18,21,
Pittsburg,Insurance Commissioner,Bill Viner,REP,610003,0,1,7,8,
Pittsburg,Insurance Commissioner,John Doak,REP,610003,0,2,26,28,
Pittsburg,Corporation Commissioner,Todd Hiett,REP,610003,0,3,16,19,
Pittsburg,Corporation Commissioner,Cliff Branan,REP,610003,0,0,17,17,
Pittsburg,U.S. Senate,Evelyn Rogers,REP,610003,0,0,3,3,
Pittsburg,U.S. Senate,Rob Moye,REP,610003,0,0,1,1,
Pittsburg,U.S. Senate,D. Jean Mcbride-Samuels,REP,610003,0,0,0,0,
Pittsburg,U.S. Senate,Jim Inhofe,REP,610003,0,3,30,33,
Pittsburg,U.S. Senate,Erick Paul Wyatt,REP,610003,0,0,1,1,
Pittsburg,U.S. Senate,Andy Craig,REP,610003,0,0,2,2,
Pittsburg,U.S. Senate,T. Shannon,REP,610003,0,0,15,15,
Pittsburg,U.S. Senate,Randy Brogdon,REP,610003,0,0,2,2,
Pittsburg,U.S. Senate,Eric Mccray,REP,610003,0,0,0,0,
Pittsburg,U.S. Senate,Kevin Crow,REP,610003,0,0,1,1,
Pittsburg,U.S. Senate,James Lankford,REP,610003,0,3,15,18,
Pittsburg,U.S. Senate,Jason Weger,REP,610003,0,0,0,0,
Pittsburg,U.S. House,Darrel Robertson,REP,610003,0,1,8,9,02
Pittsburg,U.S. House,Markwayne Mullin,REP,610003,0,2,27,29,02
Pittsburg,State House,Paul Marean,REP,610003,0,0,13,13,17
Pittsburg,State House,Micah Thompson,REP,610003,0,3,19,22,17
Pittsburg,Superintendent of Public Instruction,John Cox,DEM,610004,0,3,98,101,
Pittsburg,Superintendent of Public Instruction,Jack Jr.,DEM,610004,0,0,11,11,
Pittsburg,Superintendent of Public Instruction,Ivan Holmes,DEM,610004,0,2,8,10,
Pittsburg,Superintendent of Public Instruction,Freda Deskin,DEM,610004,0,1,45,46,
Pittsburg,U.S. Senate,Patrick Michael Hayes,DEM,610004,0,2,54,56,
Pittsburg,U.S. Senate,Jim Rogers,DEM,610004,0,3,43,46,
Pittsburg,U.S. Senate,Connie Johnson,DEM,610004,0,1,54,55,
Pittsburg,U.S. House,Earl Everett,DEM,610004,0,3,93,96,02
Pittsburg,U.S. House,Joshua Harris-Till,DEM,610004,0,3,54,57,02
Pittsburg,Governor,Dax Ewbank,REP,610004,0,0,11,11,
Pittsburg,Governor,Chad Moody,REP,610004,0,2,13,15,
Pittsburg,Governor,Mary Fallin,REP,610004,2,7,71,80,
Pittsburg,Superintendent of Public Instruction,Brian Kelly,REP,610004,0,0,16,16,
Pittsburg,Superintendent of Public Instruction,Janet Costello Barresi,REP,610004,0,3,16,19,
Pittsburg,Superintendent of Public Instruction,Joy Hofmeister,REP,610004,2,6,61,69,
Pittsburg,Insurance Commissioner,Bill Viner,REP,610004,0,1,24,25,
Pittsburg,Insurance Commissioner,John Doak,REP,610004,2,8,61,71,
Pittsburg,Corporation Commissioner,Todd Hiett,REP,610004,0,7,43,50,
Pittsburg,Corporation Commissioner,Cliff Branan,REP,610004,2,2,42,46,
Pittsburg,U.S. Senate,Evelyn Rogers,REP,610004,0,0,6,6,
Pittsburg,U.S. Senate,Rob Moye,REP,610004,0,0,1,1,
Pittsburg,U.S. Senate,D. Jean Mcbride-Samuels,REP,610004,0,0,2,2,
Pittsburg,U.S. Senate,Jim Inhofe,REP,610004,2,9,79,90,
Pittsburg,U.S. Senate,Erick Paul Wyatt,REP,610004,0,0,7,7,
Pittsburg,U.S. Senate,Andy Craig,REP,610004,0,0,2,2,
Pittsburg,U.S. Senate,T. Shannon,REP,610004,0,5,42,47,
Pittsburg,U.S. Senate,Randy Brogdon,REP,610004,0,0,4,4,
Pittsburg,U.S. Senate,Eric Mccray,REP,610004,0,0,3,3,
Pittsburg,U.S. Senate,Kevin Crow,REP,610004,0,0,0,0,
Pittsburg,U.S. Senate,James Lankford,REP,610004,2,4,46,52,
Pittsburg,U.S. Senate,Jason Weger,REP,610004,0,0,0,0,
Pittsburg,U.S. House,Darrel Robertson,REP,610004,0,0,26,26,02
Pittsburg,U.S. House,Markwayne Mullin,REP,610004,2,9,69,80,02
Pittsburg,Superintendent of Public Instruction,John Cox,DEM,610005,0,1,33,34,
Pittsburg,Superintendent of Public Instruction,Jack Jr.,DEM,610005,0,0,13,13,
Pittsburg,Superintendent of Public Instruction,Ivan Holmes,DEM,610005,0,0,8,8,
Pittsburg,Superintendent of Public Instruction,Freda Deskin,DEM,610005,0,1,25,26,
Pittsburg,U.S. Senate,Patrick Michael Hayes,DEM,610005,0,0,19,19,
Pittsburg,U.S. Senate,Jim Rogers,DEM,610005,0,2,27,29,
Pittsburg,U.S. Senate,Connie Johnson,DEM,610005,0,0,33,33,
Pittsburg,U.S. House,Earl Everett,DEM,610005,0,2,41,43,02
Pittsburg,U.S. House,Joshua Harris-Till,DEM,610005,0,0,39,39,02
Pittsburg,Governor,Dax Ewbank,REP,610005,0,0,2,2,
Pittsburg,Governor,Chad Moody,REP,610005,0,0,8,8,
Pittsburg,Governor,Mary Fallin,REP,610005,1,1,19,21,
Pittsburg,Superintendent of Public Instruction,Brian Kelly,REP,610005,0,0,6,6,
Pittsburg,Superintendent of Public Instruction,Janet Costello Barresi,REP,610005,1,1,8,10,
Pittsburg,Superintendent of Public Instruction,Joy Hofmeister,REP,610005,0,0,14,14,
Pittsburg,Insurance Commissioner,Bill Viner,REP,610005,0,0,12,12,
Pittsburg,Insurance Commissioner,John Doak,REP,610005,1,1,14,16,
Pittsburg,Corporation Commissioner,Todd Hiett,REP,610005,1,0,16,17,
Pittsburg,Corporation Commissioner,Cliff Branan,REP,610005,0,1,12,13,
Pittsburg,U.S. Senate,Evelyn Rogers,REP,610005,0,0,2,2,
Pittsburg,U.S. Senate,Rob Moye,REP,610005,0,0,0,0,
Pittsburg,U.S. Senate,D. Jean Mcbride-Samuels,REP,610005,0,0,0,0,
Pittsburg,U.S. Senate,Jim Inhofe,REP,610005,1,1,24,26,
Pittsburg,U.S. Senate,Erick Paul Wyatt,REP,610005,0,0,3,3,
Pittsburg,U.S. Senate,Andy Craig,REP,610005,0,0,0,0,
Pittsburg,U.S. Senate,T. Shannon,REP,610005,0,1,12,13,
Pittsburg,U.S. Senate,Randy Brogdon,REP,610005,1,0,0,1,
Pittsburg,U.S. Senate,Eric Mccray,REP,610005,0,0,0,0,
Pittsburg,U.S. Senate,Kevin Crow,REP,610005,0,0,1,1,
Pittsburg,U.S. Senate,James Lankford,REP,610005,0,0,16,16,
Pittsburg,U.S. Senate,Jason Weger,REP,610005,0,0,0,0,
Pittsburg,U.S. House,Darrel Robertson,REP,610005,0,0,6,6,02
Pittsburg,U.S. House,Markwayne Mullin,REP,610005,1,1,22,24,02
Pittsburg,Superintendent of Public Instruction,John Cox,DEM,610006,0,4,41,45,
Pittsburg,Superintendent of Public Instruction,Jack Jr.,DEM,610006,1,0,4,5,
Pittsburg,Superintendent of Public Instruction,Ivan Holmes,DEM,610006,0,0,2,2,
Pittsburg,Superintendent of Public Instruction,Freda Deskin,DEM,610006,1,2,21,24,
Pittsburg,U.S. Senate,Patrick Michael Hayes,DEM,610006,1,1,19,21,
Pittsburg,U.S. Senate,Jim Rogers,DEM,610006,0,1,20,21,
Pittsburg,U.S. Senate,Connie Johnson,DEM,610006,1,4,28,33,
Pittsburg,U.S. House,Earl Everett,DEM,610006,1,2,38,41,02
Pittsburg,U.S. House,Joshua Harris-Till,DEM,610006,1,4,26,31,02
Pittsburg,Governor,Dax Ewbank,REP,610006,2,0,3,5,
Pittsburg,Governor,Chad Moody,REP,610006,0,0,6,6,
Pittsburg,Governor,Mary Fallin,REP,610006,1,2,35,38,
Pittsburg,Superintendent of Public Instruction,Brian Kelly,REP,610006,0,1,10,11,
Pittsburg,Superintendent of Public Instruction,Janet Costello Barresi,REP,610006,2,1,8,11,
Pittsburg,Superintendent of Public Instruction,Joy Hofmeister,REP,610006,1,0,26,27,
Pittsburg,Insurance Commissioner,Bill Viner,REP,610006,0,0,6,6,
Pittsburg,Insurance Commissioner,John Doak,REP,610006,3,1,33,37,
Pittsburg,Corporation Commissioner,Todd Hiett,REP,610006,2,0,19,21,
Pittsburg,Corporation Commissioner,Cliff Branan,REP,610006,1,0,19,20,
Pittsburg,U.S. Senate,Evelyn Rogers,REP,610006,0,0,3,3,
Pittsburg,U.S. Senate,Rob Moye,REP,610006,0,0,0,0,
Pittsburg,U.S. Senate,D. Jean Mcbride-Samuels,REP,610006,0,0,0,0,
Pittsburg,U.S. Senate,Jim Inhofe,REP,610006,3,0,40,43,
Pittsburg,U.S. Senate,Erick Paul Wyatt,REP,610006,0,1,1,2,
Pittsburg,U.S. Senate,Andy Craig,REP,610006,0,0,0,0,
Pittsburg,U.S. Senate,T. Shannon,REP,610006,2,0,16,18,
Pittsburg,U.S. Senate,Randy Brogdon,REP,610006,0,1,0,1,
Pittsburg,U.S. Senate,Eric Mccray,REP,610006,0,0,0,0,
Pittsburg,U.S. Senate,Kevin Crow,REP,610006,1,0,0,1,
Pittsburg,U.S. Senate,James Lankford,REP,610006,0,1,27,28,
Pittsburg,U.S. Senate,Jason Weger,REP,610006,0,0,2,2,
Pittsburg,U.S. House,Darrel Robertson,REP,610006,0,1,12,13,02
Pittsburg,U.S. House,Markwayne Mullin,REP,610006,3,1,33,37,02
Pittsburg,Superintendent of Public Instruction,John Cox,DEM,610007,0,1,60,61,
Pittsburg,Superintendent of Public Instruction,Jack Jr.,DEM,610007,0,0,9,9,
Pittsburg,Superintendent of Public Instruction,Ivan Holmes,DEM,610007,0,0,9,9,
Pittsburg,Superintendent of Public Instruction,Freda Deskin,DEM,610007,0,3,16,19,
Pittsburg,U.S. Senate,Patrick Michael Hayes,DEM,610007,0,1,13,14,
Pittsburg,U.S. Senate,Jim Rogers,DEM,610007,0,0,37,37,
Pittsburg,U.S. Senate,Connie Johnson,DEM,610007,0,3,36,39,
Pittsburg,U.S. House,Earl Everett,DEM,610007,0,1,56,57,02
Pittsburg,U.S. House,Joshua Harris-Till,DEM,610007,0,3,30,33,02
Pittsburg,Governor,Dax Ewbank,REP,610007,0,0,0,0,
Pittsburg,Governor,Chad Moody,REP,610007,0,0,4,4,
Pittsburg,Governor,Mary Fallin,REP,610007,0,3,43,46,
Pittsburg,Superintendent of Public Instruction,Brian Kelly,REP,610007,0,1,7,8,
Pittsburg,Superintendent of Public Instruction,Janet Costello Barresi,REP,610007,0,1,8,9,
Pittsburg,Superintendent of Public Instruction,Joy Hofmeister,REP,610007,0,1,33,34,
Pittsburg,Insurance Commissioner,Bill Viner,REP,610007,0,1,10,11,
Pittsburg,Insurance Commissioner,John Doak,REP,610007,0,2,33,35,
Pittsburg,Corporation Commissioner,Todd Hiett,REP,610007,0,1,17,18,
Pittsburg,Corporation Commissioner,Cliff Branan,REP,610007,0,2,28,30,
Pittsburg,U.S. Senate,Evelyn Rogers,REP,610007,0,0,1,1,
Pittsburg,U.S. Senate,Rob Moye,REP,610007,0,0,3,3,
Pittsburg,U.S. Senate,D. Jean Mcbride-Samuels,REP,610007,0,0,1,1,
Pittsburg,U.S. Senate,Jim Inhofe,REP,610007,0,3,41,44,
Pittsburg,U.S. Senate,Erick Paul Wyatt,REP,610007,0,0,2,2,
Pittsburg,U.S. Senate,Andy Craig,REP,610007,0,0,0,0,
Pittsburg,U.S. Senate,T. Shannon,REP,610007,0,1,18,19,
Pittsburg,U.S. Senate,Randy Brogdon,REP,610007,0,0,1,1,
Pittsburg,U.S. Senate,Eric Mccray,REP,610007,0,0,1,1,
Pittsburg,U.S. Senate,Kevin Crow,REP,610007,0,0,1,1,
Pittsburg,U.S. Senate,James Lankford,REP,610007,0,2,26,28,
Pittsburg,U.S. Senate,Jason Weger,REP,610007,0,0,0,0,
Pittsburg,U.S. House,Darrel Robertson,REP,610007,0,1,4,5,02
Pittsburg,U.S. House,Markwayne Mullin,REP,610007,0,2,44,46,02
Pittsburg,State House,Paul Marean,REP,610007,0,2,24,26,17
Pittsburg,State House,Micah Thompson,REP,610007,0,1,19,20,17
Pittsburg,Superintendent of Public Instruction,John Cox,DEM,610008,0,1,27,28,
Pittsburg,Superintendent of Public Instruction,Jack Jr.,DEM,610008,0,3,8,11,
Pittsburg,Superintendent of Public Instruction,Ivan Holmes,DEM,610008,0,0,2,2,
Pittsburg,Superintendent of Public Instruction,Freda Deskin,DEM,610008,0,1,10,11,
Pittsburg,U.S. Senate,Patrick Michael Hayes,DEM,610008,0,1,11,12,
Pittsburg,U.S. Senate,Jim Rogers,DEM,610008,0,1,15,16,
Pittsburg,U.S. Senate,Connie Johnson,DEM,610008,0,3,20,23,
Pittsburg,U.S. House,Earl Everett,DEM,610008,0,3,29,32,02
Pittsburg,U.S. House,Joshua Harris-Till,DEM,610008,0,2,17,19,02
Pittsburg,Governor,Dax Ewbank,REP,610008,0,0,2,2,
Pittsburg,Governor,Chad Moody,REP,610008,0,0,2,2,
Pittsburg,Governor,Mary Fallin,REP,610008,1,0,7,8,
Pittsburg,Superintendent of Public Instruction,Brian Kelly,REP,610008,0,0,2,2,
Pittsburg,Superintendent of Public Instruction,Janet Costello Barresi,REP,610008,0,0,2,2,
Pittsburg,Superintendent of Public Instruction,Joy Hofmeister,REP,610008,1,0,7,8,
Pittsburg,Insurance Commissioner,Bill Viner,REP,610008,0,0,2,2,
Pittsburg,Insurance Commissioner,John Doak,REP,610008,1,0,9,10,
Pittsburg,Corporation Commissioner,Todd Hiett,REP,610008,0,0,5,5,
Pittsburg,Corporation Commissioner,Cliff Branan,REP,610008,1,0,6,7,
Pittsburg,U.S. Senate,Evelyn Rogers,REP,610008,1,0,1,2,
Pittsburg,U.S. Senate,Rob Moye,REP,610008,0,0,0,0,
Pittsburg,U.S. Senate,D. Jean Mcbride-Samuels,REP,610008,0,0,1,1,
Pittsburg,U.S. Senate,Jim Inhofe,REP,610008,0,0,8,8,
Pittsburg,U.S. Senate,Erick Paul Wyatt,REP,610008,0,0,1,1,
Pittsburg,U.S. Senate,Andy Craig,REP,610008,0,0,0,0,
Pittsburg,U.S. Senate,T. Shannon,REP,610008,0,0,7,7,
Pittsburg,U.S. Senate,Randy Brogdon,REP,610008,0,0,1,1,
Pittsburg,U.S. Senate,Eric Mccray,REP,610008,0,0,0,0,
Pittsburg,U.S. Senate,Kevin Crow,REP,610008,0,0,0,0,
Pittsburg,U.S. Senate,James Lankford,REP,610008,1,0,3,4,
Pittsburg,U.S. Senate,Jason Weger,REP,610008,0,0,0,0,
Pittsburg,U.S. House,Darrel Robertson,REP,610008,0,0,2,2,02
Pittsburg,U.S. House,Markwayne Mullin,REP,610008,1,0,9,10,02
Pittsburg,Superintendent of Public Instruction,John Cox,DEM,610011,0,7,59,66,
Pittsburg,Superintendent of Public Instruction,Jack Jr.,DEM,610011,0,2,15,17,
Pittsburg,Superintendent of Public Instruction,Ivan Holmes,DEM,610011,3,0,5,8,
Pittsburg,Superintendent of Public Instruction,Freda Deskin,DEM,610011,3,2,43,48,
Pittsburg,U.S. Senate,Patrick Michael Hayes,DEM,610011,0,2,35,37,
Pittsburg,U.S. Senate,Jim Rogers,DEM,610011,4,5,56,65,
Pittsburg,U.S. Senate,Connie Johnson,DEM,610011,3,4,30,37,
Pittsburg,U.S. House,Earl Everett,DEM,610011,5,8,74,87,02
Pittsburg,U.S. House,Joshua Harris-Till,DEM,610011,2,3,45,50,02
Pittsburg,Governor,Dax Ewbank,REP,610011,0,0,3,3,
Pittsburg,Governor,Chad Moody,REP,610011,2,0,9,11,
Pittsburg,Governor,Mary Fallin,REP,610011,1,0,31,32,
Pittsburg,Superintendent of Public Instruction,Brian Kelly,REP,610011,3,0,13,16,
Pittsburg,Superintendent of Public Instruction,Janet Costello Barresi,REP,610011,0,0,7,7,
Pittsburg,Superintendent of Public Instruction,Joy Hofmeister,REP,610011,0,0,23,23,
Pittsburg,Insurance Commissioner,Bill Viner,REP,610011,3,0,16,19,
Pittsburg,Insurance Commissioner,John Doak,REP,610011,0,0,24,24,
Pittsburg,Corporation Commissioner,Todd Hiett,REP,610011,2,0,17,19,
Pittsburg,Corporation Commissioner,Cliff Branan,REP,610011,1,0,25,26,
Pittsburg,U.S. Senate,Evelyn Rogers,REP,610011,0,0,2,2,
Pittsburg,U.S. Senate,Rob Moye,REP,610011,0,0,0,0,
Pittsburg,U.S. Senate,D. Jean Mcbride-Samuels,REP,610011,0,0,1,1,
Pittsburg,U.S. Senate,Jim Inhofe,REP,610011,2,0,37,39,
Pittsburg,U.S. Senate,Erick Paul Wyatt,REP,610011,1,0,3,4,
Pittsburg,U.S. Senate,Andy Craig,REP,610011,1,0,0,1,
Pittsburg,U.S. Senate,T. Shannon,REP,610011,0,0,12,12,
Pittsburg,U.S. Senate,Randy Brogdon,REP,610011,2,0,0,2,
Pittsburg,U.S. Senate,Eric Mccray,REP,610011,0,0,2,2,
Pittsburg,U.S. Senate,Kevin Crow,REP,610011,0,0,0,0,
Pittsburg,U.S. Senate,James Lankford,REP,610011,0,0,29,29,
Pittsburg,U.S. Senate,Jason Weger,REP,610011,0,0,0,0,
Pittsburg,U.S. House,Darrel Robertson,REP,610011,1,0,6,7,02
Pittsburg,U.S. House,Markwayne Mullin,REP,610011,2,0,37,39,02
Pittsburg,Superintendent of Public Instruction,John Cox,DEM,610014,0,9,74,83,
Pittsburg,Superintendent of Public Instruction,Jack Jr.,DEM,610014,0,2,13,15,
Pittsburg,Superintendent of Public Instruction,Ivan Holmes,DEM,610014,0,3,9,12,
Pittsburg,Superintendent of Public Instruction,Freda Deskin,DEM,610014,0,3,33,36,
Pittsburg,U.S. Senate,Patrick Michael Hayes,DEM,610014,0,3,32,35,
Pittsburg,U.S. Senate,Jim Rogers,DEM,610014,0,8,62,70,
Pittsburg,U.S. Senate,Connie Johnson,DEM,610014,0,5,31,36,
Pittsburg,U.S. House,Earl Everett,DEM,610014,0,13,88,101,02
Pittsburg,U.S. House,Joshua Harris-Till,DEM,610014,0,3,35,38,02
Pittsburg,Governor,Dax Ewbank,REP,610014,0,1,5,6,
Pittsburg,Governor,Chad Moody,REP,610014,0,2,8,10,
Pittsburg,Governor,Mary Fallin,REP,610014,0,0,40,40,
Pittsburg,Superintendent of Public Instruction,Brian Kelly,REP,610014,0,0,19,19,
Pittsburg,Superintendent of Public Instruction,Janet Costello Barresi,REP,610014,0,1,14,15,
Pittsburg,Superintendent of Public Instruction,Joy Hofmeister,REP,610014,0,2,20,22,
Pittsburg,Insurance Commissioner,Bill Viner,REP,610014,0,0,7,7,
Pittsburg,Insurance Commissioner,John Doak,REP,610014,0,3,44,47,
Pittsburg,Corporation Commissioner,Todd Hiett,REP,610014,0,3,24,27,
Pittsburg,Corporation Commissioner,Cliff Branan,REP,610014,0,0,28,28,
Pittsburg,U.S. Senate,Evelyn Rogers,REP,610014,0,0,2,2,
Pittsburg,U.S. Senate,Rob Moye,REP,610014,0,0,1,1,
Pittsburg,U.S. Senate,D. Jean Mcbride-Samuels,REP,610014,0,0,1,1,
Pittsburg,U.S. Senate,Jim Inhofe,REP,610014,0,3,43,46,
Pittsburg,U.S. Senate,Erick Paul Wyatt,REP,610014,0,0,6,6,
Pittsburg,U.S. Senate,Andy Craig,REP,610014,0,0,1,1,
Pittsburg,U.S. Senate,T. Shannon,REP,610014,0,3,21,24,
Pittsburg,U.S. Senate,Randy Brogdon,REP,610014,0,0,2,2,
Pittsburg,U.S. Senate,Eric Mccray,REP,610014,0,0,0,0,
Pittsburg,U.S. Senate,Kevin Crow,REP,610014,0,0,2,2,
Pittsburg,U.S. Senate,James Lankford,REP,610014,0,0,27,27,
Pittsburg,U.S. Senate,Jason Weger,REP,610014,0,0,0,0,
Pittsburg,U.S. House,Darrel Robertson,REP,610014,0,0,5,5,02
Pittsburg,U.S. House,Markwayne Mullin,REP,610014,0,3,47,50,02
Pittsburg,State House,Paul Marean,REP,610014,0,3,22,25,17
Pittsburg,State House,Micah Thompson,REP,610014,0,0,30,30,17
Pittsburg,Superintendent of Public Instruction,John Cox,DEM,610015,0,1,10,11,
Pittsburg,Superintendent of Public Instruction,Jack Jr.,DEM,610015,0,1,5,6,
Pittsburg,Superintendent of Public Instruction,Ivan Holmes,DEM,610015,0,0,1,1,
Pittsburg,Superintendent of Public Instruction,Freda Deskin,DEM,610015,0,0,11,11,
Pittsburg,U.S. Senate,Patrick Michael Hayes,DEM,610015,0,0,5,5,
Pittsburg,U.S. Senate,Jim Rogers,DEM,610015,0,0,6,6,
Pittsburg,U.S. Senate,Connie Johnson,DEM,610015,0,2,14,16,
Pittsburg,U.S. House,Earl Everett,DEM,610015,0,0,7,7,02
Pittsburg,U.S. House,Joshua Harris-Till,DEM,610015,0,2,18,20,02
Pittsburg,Governor,Dax Ewbank,REP,610015,0,0,1,1,
Pittsburg,Governor,Chad Moody,REP,610015,0,0,2,2,
Pittsburg,Governor,Mary Fallin,REP,610015,0,0,2,2,
Pittsburg,Superintendent of Public Instruction,Brian Kelly,REP,610015,0,0,0,0,
Pittsburg,Superintendent of Public Instruction,Janet Costello Barresi,REP,610015,0,0,2,2,
Pittsburg,Superintendent of Public Instruction,Joy Hofmeister,REP,610015,0,0,3,3,
Pittsburg,Insurance Commissioner,Bill Viner,REP,610015,0,0,2,2,
Pittsburg,Insurance Commissioner,John Doak,REP,610015,0,0,3,3,
Pittsburg,Corporation Commissioner,Todd Hiett,REP,610015,0,0,2,2,
Pittsburg,Corporation Commissioner,Cliff Branan,REP,610015,0,0,3,3,
Pittsburg,U.S. Senate,Evelyn Rogers,REP,610015,0,0,0,0,
Pittsburg,U.S. Senate,Rob Moye,REP,610015,0,0,0,0,
Pittsburg,U.S. Senate,D. Jean Mcbride-Samuels,REP,610015,0,0,0,0,
Pittsburg,U.S. Senate,Jim Inhofe,REP,610015,0,0,4,4,
Pittsburg,U.S. Senate,Erick Paul Wyatt,REP,610015,0,0,1,1,
Pittsburg,U.S. Senate,Andy Craig,REP,610015,0,0,0,0,
Pittsburg,U.S. Senate,T. Shannon,REP,610015,0,0,4,4,
Pittsburg,U.S. Senate,Randy Brogdon,REP,610015,0,0,0,0,
Pittsburg,U.S. Senate,Eric Mccray,REP,610015,0,0,0,0,
Pittsburg,U.S. Senate,Kevin Crow,REP,610015,0,0,0,0,
Pittsburg,U.S. Senate,James Lankford,REP,610015,0,0,1,1,
Pittsburg,U.S. Senate,Jason Weger,REP,610015,0,0,0,0,
Pittsburg,U.S. House,Darrel Robertson,REP,610015,0,0,1,1,02
Pittsburg,U.S. House,Markwayne Mullin,REP,610015,0,0,4,4,02
Pittsburg,Superintendent of Public Instruction,John Cox,DEM,610019,0,0,19,19,
Pittsburg,Superintendent of Public Instruction,Jack Jr.,DEM,610019,0,0,6,6,
Pittsburg,Superintendent of Public Instruction,Ivan Holmes,DEM,610019,0,0,3,3,
Pittsburg,Superintendent of Public Instruction,Freda Deskin,DEM,610019,0,0,9,9,
Pittsburg,U.S. Senate,Patrick Michael Hayes,DEM,610019,0,0,7,7,
Pittsburg,U.S. Senate,Jim Rogers,DEM,610019,0,0,19,19,
Pittsburg,U.S. Senate,Connie Johnson,DEM,610019,0,0,8,8,
Pittsburg,U.S. House,Earl Everett,DEM,610019,0,0,22,22,02
Pittsburg,U.S. House,Joshua Harris-Till,DEM,610019,0,0,12,12,02
Pittsburg,Governor,Dax Ewbank,REP,610019,0,0,0,0,
Pittsburg,Governor,Chad Moody,REP,610019,0,0,4,4,
Pittsburg,Governor,Mary Fallin,REP,610019,0,2,12,14,
Pittsburg,Superintendent of Public Instruction,Brian Kelly,REP,610019,0,0,3,3,
Pittsburg,Superintendent of Public Instruction,Janet Costello Barresi,REP,610019,0,0,4,4,
Pittsburg,Superintendent of Public Instruction,Joy Hofmeister,REP,610019,0,2,9,11,
Pittsburg,Insurance Commissioner,Bill Viner,REP,610019,0,0,5,5,
Pittsburg,Insurance Commissioner,John Doak,REP,610019,0,1,10,11,
Pittsburg,Corporation Commissioner,Todd Hiett,REP,610019,0,1,9,10,
Pittsburg,Corporation Commissioner,Cliff Branan,REP,610019,0,1,7,8,
Pittsburg,U.S. Senate,Evelyn Rogers,REP,610019,0,0,0,0,
Pittsburg,U.S. Senate,Rob Moye,REP,610019,0,1,1,2,
Pittsburg,U.S. Senate,D. Jean Mcbride-Samuels,REP,610019,0,0,0,0,
Pittsburg,U.S. Senate,Jim Inhofe,REP,610019,0,1,13,14,
Pittsburg,U.S. Senate,Erick Paul Wyatt,REP,610019,0,0,2,2,
Pittsburg,U.S. Senate,Andy Craig,REP,610019,0,0,0,0,
Pittsburg,U.S. Senate,T. Shannon,REP,610019,0,2,7,9,
Pittsburg,U.S. Senate,Randy Brogdon,REP,610019,0,0,0,0,
Pittsburg,U.S. Senate,Eric Mccray,REP,610019,0,0,0,0,
Pittsburg,U.S. Senate,Kevin Crow,REP,610019,0,0,0,0,
Pittsburg,U.S. Senate,James Lankford,REP,610019,0,0,9,9,
Pittsburg,U.S. Senate,Jason Weger,REP,610019,0,0,0,0,
Pittsburg,U.S. House,Darrel Robertson,REP,610019,0,1,4,5,02
Pittsburg,U.S. House,Markwayne Mullin,REP,610019,0,1,12,13,02
Pittsburg,State House,Paul Marean,REP,610019,0,2,8,10,17
Pittsburg,State House,Micah Thompson,REP,610019,0,0,8,8,17
Pittsburg,Superintendent of Public Instruction,John Cox,DEM,610020,0,2,18,20,
Pittsburg,Superintendent of Public Instruction,Jack Jr.,DEM,610020,0,0,1,1,
Pittsburg,Superintendent of Public Instruction,Ivan Holmes,DEM,610020,0,0,1,1,
Pittsburg,Superintendent of Public Instruction,Freda Deskin,DEM,610020,0,0,3,3,
Pittsburg,U.S. Senate,Patrick Michael Hayes,DEM,610020,0,1,9,10,
Pittsburg,U.S. Senate,Jim Rogers,DEM,610020,0,0,10,10,
Pittsburg,U.S. Senate,Connie Johnson,DEM,610020,0,1,4,5,
Pittsburg,U.S. House,Earl Everett,DEM,610020,0,0,12,12,02
Pittsburg,U.S. House,Joshua Harris-Till,DEM,610020,0,2,11,13,02
Pittsburg,Governor,Dax Ewbank,REP,610020,0,0,0,0,
Pittsburg,Governor,Chad Moody,REP,610020,0,0,3,3,
Pittsburg,Governor,Mary Fallin,REP,610020,0,0,0,0,
Pittsburg,Superintendent of Public Instruction,Brian Kelly,REP,610020,0,0,1,1,
Pittsburg,Superintendent of Public Instruction,Janet Costello Barresi,REP,610020,0,0,0,0,
Pittsburg,Superintendent of Public Instruction,Joy Hofmeister,REP,610020,0,0,2,2,
Pittsburg,Insurance Commissioner,Bill Viner,REP,610020,0,0,0,0,
Pittsburg,Insurance Commissioner,John Doak,REP,610020,0,0,2,2,
Pittsburg,Corporation Commissioner,Todd Hiett,REP,610020,0,0,1,1,
Pittsburg,Corporation Commissioner,Cliff Branan,REP,610020,0,0,2,2,
Pittsburg,U.S. Senate,Evelyn Rogers,REP,610020,0,0,0,0,
Pittsburg,U.S. Senate,Rob Moye,REP,610020,0,0,0,0,
Pittsburg,U.S. Senate,D. Jean Mcbride-Samuels,REP,610020,0,0,0,0,
Pittsburg,U.S. Senate,Jim Inhofe,REP,610020,0,0,3,3,
Pittsburg,U.S. Senate,Erick Paul Wyatt,REP,610020,0,0,0,0,
Pittsburg,U.S. Senate,Andy Craig,REP,610020,0,0,0,0,
Pittsburg,U.S. Senate,T. Shannon,REP,610020,0,0,0,0,
Pittsburg,U.S. Senate,Randy Brogdon,REP,610020,0,0,0,0,
Pittsburg,U.S. Senate,Eric Mccray,REP,610020,0,0,0,0,
Pittsburg,U.S. Senate,Kevin Crow,REP,610020,0,0,0,0,
Pittsburg,U.S. Senate,James Lankford,REP,610020,0,0,2,2,
Pittsburg,U.S. Senate,Jason Weger,REP,610020,0,0,0,0,
Pittsburg,U.S. House,Darrel Robertson,REP,610020,0,0,0,0,02
Pittsburg,U.S. House,Markwayne Mullin,REP,610020,0,0,3,3,02
Pittsburg,State House,Paul Marean,REP,610020,0,0,1,1,17
Pittsburg,State House,Micah Thompson,REP,610020,0,0,2,2,17
Pittsburg,Superintendent of Public Instruction,John Cox,DEM,610021,0,7,96,103,
Pittsburg,Superintendent of Public Instruction,Jack Jr.,DEM,610021,2,1,16,19,
Pittsburg,Superintendent of Public Instruction,Ivan Holmes,DEM,610021,0,7,10,17,
Pittsburg,Superintendent of Public Instruction,Freda Deskin,DEM,610021,0,2,69,71,
Pittsburg,U.S. Senate,Patrick Michael Hayes,DEM,610021,0,2,40,42,
Pittsburg,U.S. Senate,Jim Rogers,DEM,610021,0,10,84,94,
Pittsburg,U.S. Senate,Connie Johnson,DEM,610021,2,4,63,69,
Pittsburg,U.S. House,Earl Everett,DEM,610021,2,13,134,149,02
Pittsburg,U.S. House,Joshua Harris-Till,DEM,610021,0,3,50,53,02
Pittsburg,Governor,Dax Ewbank,REP,610021,1,0,2,3,
Pittsburg,Governor,Chad Moody,REP,610021,1,0,0,1,
Pittsburg,Governor,Mary Fallin,REP,610021,0,5,27,32,
Pittsburg,Superintendent of Public Instruction,Brian Kelly,REP,610021,0,1,6,7,
Pittsburg,Superintendent of Public Instruction,Janet Costello Barresi,REP,610021,0,2,9,11,
Pittsburg,Superintendent of Public Instruction,Joy Hofmeister,REP,610021,2,2,13,17,
Pittsburg,Insurance Commissioner,Bill Viner,REP,610021,0,1,9,10,
Pittsburg,Insurance Commissioner,John Doak,REP,610021,2,3,17,22,
Pittsburg,Corporation Commissioner,Todd Hiett,REP,610021,1,1,14,16,
Pittsburg,Corporation Commissioner,Cliff Branan,REP,610021,1,4,15,20,
Pittsburg,U.S. Senate,Evelyn Rogers,REP,610021,0,0,0,0,
Pittsburg,U.S. Senate,Rob Moye,REP,610021,0,0,2,2,
Pittsburg,U.S. Senate,D. Jean Mcbride-Samuels,REP,610021,0,0,1,1,
Pittsburg,U.S. Senate,Jim Inhofe,REP,610021,1,5,26,32,
Pittsburg,U.S. Senate,Erick Paul Wyatt,REP,610021,1,0,1,2,
Pittsburg,U.S. Senate,Andy Craig,REP,610021,0,0,0,0,
Pittsburg,U.S. Senate,T. Shannon,REP,610021,0,3,13,16,
Pittsburg,U.S. Senate,Randy Brogdon,REP,610021,1,0,2,3,
Pittsburg,U.S. Senate,Eric Mccray,REP,610021,0,0,1,1,
Pittsburg,U.S. Senate,Kevin Crow,REP,610021,0,0,1,1,
Pittsburg,U.S. Senate,James Lankford,REP,610021,1,2,12,15,
Pittsburg,U.S. Senate,Jason Weger,REP,610021,0,0,1,1,
Pittsburg,U.S. House,Darrel Robertson,REP,610021,1,0,5,6,02
Pittsburg,U.S. House,Markwayne Mullin,REP,610021,1,5,23,29,02
Pittsburg,Superintendent of Public Instruction,John Cox,DEM,610023,0,0,23,23,
Pittsburg,Superintendent of Public Instruction,Jack Jr.,DEM,610023,0,0,2,2,
Pittsburg,Superintendent of Public Instruction,Ivan Holmes,DEM,610023,0,0,3,3,
Pittsburg,Superintendent of Public Instruction,Freda Deskin,DEM,610023,0,0,5,5,
Pittsburg,U.S. Senate,Patrick Michael Hayes,DEM,610023,0,0,7,7,
Pittsburg,U.S. Senate,Jim Rogers,DEM,610023,0,0,17,17,
Pittsburg,U.S. Senate,Connie Johnson,DEM,610023,0,0,6,6,
Pittsburg,U.S. House,Earl Everett,DEM,610023,0,0,21,21,02
Pittsburg,U.S. House,Joshua Harris-Till,DEM,610023,0,0,9,9,02
Pittsburg,Governor,Dax Ewbank,REP,610023,0,0,1,1,
Pittsburg,Governor,Chad Moody,REP,610023,0,0,3,3,
Pittsburg,Governor,Mary Fallin,REP,610023,0,0,3,3,
Pittsburg,Superintendent of Public Instruction,Brian Kelly,REP,610023,0,0,3,3,
Pittsburg,Superintendent of Public Instruction,Janet Costello Barresi,REP,610023,0,0,1,1,
Pittsburg,Superintendent of Public Instruction,Joy Hofmeister,REP,610023,0,0,3,3,
Pittsburg,Insurance Commissioner,Bill Viner,REP,610023,0,0,1,1,
Pittsburg,Insurance Commissioner,John Doak,REP,610023,0,0,6,6,
Pittsburg,Corporation Commissioner,Todd Hiett,REP,610023,0,0,5,5,
Pittsburg,Corporation Commissioner,Cliff Branan,REP,610023,0,0,2,2,
Pittsburg,U.S. Senate,Evelyn Rogers,REP,610023,0,0,0,0,
Pittsburg,U.S. Senate,Rob Moye,REP,610023,0,0,0,0,
Pittsburg,U.S. Senate,D. Jean Mcbride-Samuels,REP,610023,0,0,0,0,
Pittsburg,U.S. Senate,Jim Inhofe,REP,610023,0,0,7,7,
Pittsburg,U.S. Senate,Erick Paul Wyatt,REP,610023,0,0,0,0,
Pittsburg,U.S. Senate,Andy Craig,REP,610023,0,0,0,0,
Pittsburg,U.S. Senate,T. Shannon,REP,610023,0,0,6,6,
Pittsburg,U.S. Senate,Randy Brogdon,REP,610023,0,0,0,0,
Pittsburg,U.S. Senate,Eric Mccray,REP,610023,0,0,0,0,
Pittsburg,U.S. Senate,Kevin Crow,REP,610023,0,0,0,0,
Pittsburg,U.S. Senate,James Lankford,REP,610023,0,0,1,1,
Pittsburg,U.S. Senate,Jason Weger,REP,610023,0,0,0,0,
Pittsburg,U.S. House,Darrel Robertson,REP,610023,0,0,1,1,02
Pittsburg,U.S. House,Markwayne Mullin,REP,610023,0,0,6,6,02
Pittsburg,Superintendent of Public Instruction,John Cox,DEM,610026,0,2,28,30,
Pittsburg,Superintendent of Public Instruction,Jack Jr.,DEM,610026,0,0,4,4,
Pittsburg,Superintendent of Public Instruction,Ivan Holmes,DEM,610026,0,0,2,2,
Pittsburg,Superintendent of Public Instruction,Freda Deskin,DEM,610026,0,0,17,17,
Pittsburg,U.S. Senate,Patrick Michael Hayes,DEM,610026,0,0,17,17,
Pittsburg,U.S. Senate,Jim Rogers,DEM,610026,0,2,18,20,
Pittsburg,U.S. Senate,Connie Johnson,DEM,610026,0,0,15,15,
Pittsburg,U.S. House,Earl Everett,DEM,610026,0,2,28,30,02
Pittsburg,U.S. House,Joshua Harris-Till,DEM,610026,0,0,22,22,02
Pittsburg,Governor,Dax Ewbank,REP,610026,0,0,1,1,
Pittsburg,Governor,Chad Moody,REP,610026,0,0,1,1,
Pittsburg,Governor,Mary Fallin,REP,610026,0,0,23,23,
Pittsburg,Superintendent of Public Instruction,Brian Kelly,REP,610026,0,0,4,4,
Pittsburg,Superintendent of Public Instruction,Janet Costello Barresi,REP,610026,0,0,3,3,
Pittsburg,Superintendent of Public Instruction,Joy Hofmeister,REP,610026,0,0,19,19,
Pittsburg,Insurance Commissioner,Bill Viner,REP,610026,0,0,10,10,
Pittsburg,Insurance Commissioner,John Doak,REP,610026,0,0,16,16,
Pittsburg,Corporation Commissioner,Todd Hiett,REP,610026,0,0,8,8,
Pittsburg,Corporation Commissioner,Cliff Branan,REP,610026,0,0,18,18,
Pittsburg,U.S. Senate,Evelyn Rogers,REP,610026,0,0,0,0,
Pittsburg,U.S. Senate,Rob Moye,REP,610026,0,0,0,0,
Pittsburg,U.S. Senate,D. Jean Mcbride-Samuels,REP,610026,0,0,0,0,
Pittsburg,U.S. Senate,Jim Inhofe,REP,610026,0,0,25,25,
Pittsburg,U.S. Senate,Erick Paul Wyatt,REP,610026,0,0,1,1,
Pittsburg,U.S. Senate,Andy Craig,REP,610026,0,0,0,0,
Pittsburg,U.S. Senate,T. Shannon,REP,610026,0,0,16,16,
Pittsburg,U.S. Senate,Randy Brogdon,REP,610026,0,0,0,0,
Pittsburg,U.S. Senate,Eric Mccray,REP,610026,0,0,1,1,
Pittsburg,U.S. Senate,Kevin Crow,REP,610026,0,0,0,0,
Pittsburg,U.S. Senate,James Lankford,REP,610026,0,0,8,8,
Pittsburg,U.S. Senate,Jason Weger,REP,610026,0,0,1,1,
Pittsburg,U.S. House,Darrel Robertson,REP,610026,0,0,1,1,02
Pittsburg,U.S. House,Markwayne Mullin,REP,610026,0,0,25,25,02
Pittsburg,State House,Paul Marean,REP,610026,0,0,7,7,17
Pittsburg,State House,Micah Thompson,REP,610026,0,0,17,17,17
Pittsburg,Superintendent of Public Instruction,John Cox,DEM,610027,0,1,42,43,
Pittsburg,Superintendent of Public Instruction,Jack Jr.,DEM,610027,0,1,18,19,
Pittsburg,Superintendent of Public Instruction,Ivan Holmes,DEM,610027,0,0,4,4,
Pittsburg,Superintendent of Public Instruction,Freda Deskin,DEM,610027,0,0,49,49,
Pittsburg,U.S. Senate,Patrick Michael Hayes,DEM,610027,0,0,28,28,
Pittsburg,U.S. Senate,Jim Rogers,DEM,610027,0,1,44,45,
Pittsburg,U.S. Senate,Connie Johnson,DEM,610027,0,1,36,37,
Pittsburg,U.S. House,Earl Everett,DEM,610027,0,2,75,77,02
Pittsburg,U.S. House,Joshua Harris-Till,DEM,610027,0,0,33,33,02
Pittsburg,Governor,Dax Ewbank,REP,610027,0,0,5,5,
Pittsburg,Governor,Chad Moody,REP,610027,0,0,14,14,
Pittsburg,Governor,Mary Fallin,REP,610027,1,4,102,107,
Pittsburg,Superintendent of Public Instruction,Brian Kelly,REP,610027,0,1,27,28,
Pittsburg,Superintendent of Public Instruction,Janet Costello Barresi,REP,610027,0,2,32,34,
Pittsburg,Superintendent of Public Instruction,Joy Hofmeister,REP,610027,1,1,62,64,
Pittsburg,Insurance Commissioner,Bill Viner,REP,610027,0,0,40,40,
Pittsburg,Insurance Commissioner,John Doak,REP,610027,1,4,68,73,
Pittsburg,Corporation Commissioner,Todd Hiett,REP,610027,0,2,46,48,
Pittsburg,Corporation Commissioner,Cliff Branan,REP,610027,1,2,69,72,
Pittsburg,U.S. Senate,Evelyn Rogers,REP,610027,0,0,9,9,
Pittsburg,U.S. Senate,Rob Moye,REP,610027,0,0,0,0,
Pittsburg,U.S. Senate,D. Jean Mcbride-Samuels,REP,610027,0,0,1,1,
Pittsburg,U.S. Senate,Jim Inhofe,REP,610027,1,4,108,113,
Pittsburg,U.S. Senate,Erick Paul Wyatt,REP,610027,0,0,4,4,
Pittsburg,U.S. Senate,Andy Craig,REP,610027,0,0,1,1,
Pittsburg,U.S. Senate,T. Shannon,REP,610027,0,0,62,62,
Pittsburg,U.S. Senate,Randy Brogdon,REP,610027,0,2,5,7,
Pittsburg,U.S. Senate,Eric Mccray,REP,610027,0,0,2,2,
Pittsburg,U.S. Senate,Kevin Crow,REP,610027,0,0,2,2,
Pittsburg,U.S. Senate,James Lankford,REP,610027,1,2,51,54,
Pittsburg,U.S. Senate,Jason Weger,REP,610027,0,0,0,0,
Pittsburg,U.S. House,Darrel Robertson,REP,610027,1,0,25,26,02
Pittsburg,U.S. House,Markwayne Mullin,REP,610027,0,4,96,100,02
Pittsburg,Superintendent of Public Instruction,John Cox,DEM,610028,0,1,17,18,
Pittsburg,Superintendent of Public Instruction,Jack Jr.,DEM,610028,1,0,4,5,
Pittsburg,Superintendent of Public Instruction,Ivan Holmes,DEM,610028,0,0,2,2,
Pittsburg,Superintendent of Public Instruction,Freda Deskin,DEM,610028,1,0,11,12,
Pittsburg,U.S. Senate,Patrick Michael Hayes,DEM,610028,0,1,14,15,
Pittsburg,U.S. Senate,Jim Rogers,DEM,610028,2,0,15,17,
Pittsburg,U.S. Senate,Connie Johnson,DEM,610028,0,0,3,3,
Pittsburg,U.S. House,Earl Everett,DEM,610028,1,1,19,21,02
Pittsburg,U.S. House,Joshua Harris-Till,DEM,610028,1,0,13,14,02
Pittsburg,Governor,Dax Ewbank,REP,610028,0,0,1,1,
Pittsburg,Governor,Chad Moody,REP,610028,0,0,6,6,
Pittsburg,Governor,Mary Fallin,REP,610028,0,0,6,6,
Pittsburg,Superintendent of Public Instruction,Brian Kelly,REP,610028,0,0,4,4,
Pittsburg,Superintendent of Public Instruction,Janet Costello Barresi,REP,610028,0,0,1,1,
Pittsburg,Superintendent of Public Instruction,Joy Hofmeister,REP,610028,0,0,8,8,
Pittsburg,Insurance Commissioner,Bill Viner,REP,610028,0,0,3,3,
Pittsburg,Insurance Commissioner,John Doak,REP,610028,0,0,10,10,
Pittsburg,Corporation Commissioner,Todd Hiett,REP,610028,0,0,6,6,
Pittsburg,Corporation Commissioner,Cliff Branan,REP,610028,0,0,7,7,
Pittsburg,U.S. Senate,Evelyn Rogers,REP,610028,0,0,2,2,
Pittsburg,U.S. Senate,Rob Moye,REP,610028,0,0,0,0,
Pittsburg,U.S. Senate,D. Jean Mcbride-Samuels,REP,610028,0,0,0,0,
Pittsburg,U.S. Senate,Jim Inhofe,REP,610028,0,0,10,10,
Pittsburg,U.S. Senate,Erick Paul Wyatt,REP,610028,0,0,1,1,
Pittsburg,U.S. Senate,Andy Craig,REP,610028,0,0,0,0,
Pittsburg,U.S. Senate,T. Shannon,REP,610028,0,0,7,7,
Pittsburg,U.S. Senate,Randy Brogdon,REP,610028,0,0,2,2,
Pittsburg,U.S. Senate,Eric Mccray,REP,610028,0,0,1,1,
Pittsburg,U.S. Senate,Kevin Crow,REP,610028,0,0,1,1,
Pittsburg,U.S. Senate,James Lankford,REP,610028,0,0,2,2,
Pittsburg,U.S. Senate,Jason Weger,REP,610028,0,0,0,0,
Pittsburg,U.S. House,Darrel Robertson,REP,610028,0,0,3,3,02
Pittsburg,U.S. House,Markwayne Mullin,REP,610028,0,0,10,10,02
Pittsburg,Superintendent of Public Instruction,John Cox,DEM,610029,0,0,27,27,
Pittsburg,Superintendent of Public Instruction,Jack Jr.,DEM,610029,0,0,4,4,
Pittsburg,Superintendent of Public Instruction,Ivan Holmes,DEM,610029,0,1,7,8,
Pittsburg,Superintendent of Public Instruction,Freda Deskin,DEM,610029,0,0,12,12,
Pittsburg,U.S. Senate,Patrick Michael Hayes,DEM,610029,0,1,16,17,
Pittsburg,U.S. Senate,Jim Rogers,DEM,610029,0,0,19,19,
Pittsburg,U.S. Senate,Connie Johnson,DEM,610029,0,0,13,13,
Pittsburg,U.S. House,Earl Everett,DEM,610029,0,1,36,37,02
Pittsburg,U.S. House,Joshua Harris-Till,DEM,610029,0,0,11,11,02
Pittsburg,Governor,Dax Ewbank,REP,610029,0,0,4,4,
Pittsburg,Governor,Chad Moody,REP,610029,0,0,3,3,
Pittsburg,Governor,Mary Fallin,REP,610029,0,2,15,17,
Pittsburg,Superintendent of Public Instruction,Brian Kelly,REP,610029,0,0,4,4,
Pittsburg,Superintendent of Public Instruction,Janet Costello Barresi,REP,610029,0,1,6,7,
Pittsburg,Superintendent of Public Instruction,Joy Hofmeister,REP,610029,0,1,11,12,
Pittsburg,Insurance Commissioner,Bill Viner,REP,610029,0,0,3,3,
Pittsburg,Insurance Commissioner,John Doak,REP,610029,0,2,18,20,
Pittsburg,Corporation Commissioner,Todd Hiett,REP,610029,0,1,8,9,
Pittsburg,Corporation Commissioner,Cliff Branan,REP,610029,0,1,13,14,
Pittsburg,U.S. Senate,Evelyn Rogers,REP,610029,0,0,1,1,
Pittsburg,U.S. Senate,Rob Moye,REP,610029,0,0,0,0,
Pittsburg,U.S. Senate,D. Jean Mcbride-Samuels,REP,610029,0,0,1,1,
Pittsburg,U.S. Senate,Jim Inhofe,REP,610029,0,2,20,22,
Pittsburg,U.S. Senate,Erick Paul Wyatt,REP,610029,0,0,0,0,
Pittsburg,U.S. Senate,Andy Craig,REP,610029,0,0,0,0,
Pittsburg,U.S. Senate,T. Shannon,REP,610029,0,2,13,15,
Pittsburg,U.S. Senate,Randy Brogdon,REP,610029,0,0,2,2,
Pittsburg,U.S. Senate,Eric Mccray,REP,610029,0,0,0,0,
Pittsburg,U.S. Senate,Kevin Crow,REP,610029,0,0,0,0,
Pittsburg,U.S. Senate,James Lankford,REP,610029,0,0,6,6,
Pittsburg,U.S. Senate,Jason Weger,REP,610029,0,0,0,0,
Pittsburg,U.S. House,Darrel Robertson,REP,610029,0,0,8,8,02
Pittsburg,U.S. House,Markwayne Mullin,REP,610029,0,2,13,15,02
Pittsburg,State House,Paul Marean,REP,610029,0,0,10,10,17
Pittsburg,State House,Micah Thompson,REP,610029,0,2,11,13,17
Pittsburg,Superintendent of Public Instruction,John Cox,DEM,610030,0,1,20,21,
Pittsburg,Superintendent of Public Instruction,Jack Jr.,DEM,610030,0,0,3,3,
Pittsburg,Superintendent of Public Instruction,Ivan Holmes,DEM,610030,0,0,0,0,
Pittsburg,Superintendent of Public Instruction,Freda Deskin,DEM,610030,0,0,14,14,
Pittsburg,U.S. Senate,Patrick Michael Hayes,DEM,610030,0,0,12,12,
Pittsburg,U.S. Senate,Jim Rogers,DEM,610030,0,1,13,14,
Pittsburg,U.S. Senate,Connie Johnson,DEM,610030,0,0,11,11,
Pittsburg,U.S. House,Earl Everett,DEM,610030,0,1,19,20,02
Pittsburg,U.S. House,Joshua Harris-Till,DEM,610030,0,0,17,17,02
Pittsburg,Governor,Dax Ewbank,REP,610030,0,0,0,0,
Pittsburg,Governor,Chad Moody,REP,610030,0,0,0,0,
Pittsburg,Governor,Mary Fallin,REP,610030,0,3,15,18,
Pittsburg,Superintendent of Public Instruction,Brian Kelly,REP,610030,0,2,4,6,
Pittsburg,Superintendent of Public Instruction,Janet Costello Barresi,REP,610030,0,1,4,5,
Pittsburg,Superintendent of Public Instruction,Joy Hofmeister,REP,610030,0,0,7,7,
Pittsburg,Insurance Commissioner,Bill Viner,REP,610030,0,0,2,2,
Pittsburg,Insurance Commissioner,John Doak,REP,610030,0,3,13,16,
Pittsburg,Corporation Commissioner,Todd Hiett,REP,610030,0,1,7,8,
Pittsburg,Corporation Commissioner,Cliff Branan,REP,610030,0,2,8,10,
Pittsburg,U.S. Senate,Evelyn Rogers,REP,610030,0,0,0,0,
Pittsburg,U.S. Senate,Rob Moye,REP,610030,0,0,0,0,
Pittsburg,U.S. Senate,D. Jean Mcbride-Samuels,REP,610030,0,0,0,0,
Pittsburg,U.S. Senate,Jim Inhofe,REP,610030,0,3,15,18,
Pittsburg,U.S. Senate,Erick Paul Wyatt,REP,610030,0,0,0,0,
Pittsburg,U.S. Senate,Andy Craig,REP,610030,0,0,0,0,
Pittsburg,U.S. Senate,T. Shannon,REP,610030,0,2,6,8,
Pittsburg,U.S. Senate,Randy Brogdon,REP,610030,0,1,0,1,
Pittsburg,U.S. Senate,Eric Mccray,REP,610030,0,0,0,0,
Pittsburg,U.S. Senate,Kevin Crow,REP,610030,0,0,1,1,
Pittsburg,U.S. Senate,James Lankford,REP,610030,0,0,8,8,
Pittsburg,U.S. Senate,Jason Weger,REP,610030,0,0,0,0,
Pittsburg,U.S. House,Darrel Robertson,REP,610030,0,0,1,1,02
Pittsburg,U.S. House,Markwayne Mullin,REP,610030,0,3,14,17,02
Pittsburg,State House,Paul Marean,REP,610030,0,2,5,7,17
Pittsburg,State House,Micah Thompson,REP,610030,0,1,9,10,17
Pittsburg,Superintendent of Public Instruction,John Cox,DEM,610031,0,0,21,21,
Pittsburg,Superintendent of Public Instruction,Jack Jr.,DEM,610031,0,0,5,5,
Pittsburg,Superintendent of Public Instruction,Ivan Holmes,DEM,610031,0,1,1,2,
Pittsburg,Superintendent of Public Instruction,Freda Deskin,DEM,610031,0,0,22,22,
Pittsburg,U.S. Senate,Patrick Michael Hayes,DEM,610031,0,0,9,9,
Pittsburg,U.S. Senate,Jim Rogers,DEM,610031,0,1,22,23,
Pittsburg,U.S. Senate,Connie Johnson,DEM,610031,0,0,17,17,
Pittsburg,U.S. House,Earl Everett,DEM,610031,0,1,28,29,02
Pittsburg,U.S. House,Joshua Harris-Till,DEM,610031,0,0,20,20,02
Pittsburg,Governor,Dax Ewbank,REP,610031,0,0,3,3,
Pittsburg,Governor,Chad Moody,REP,610031,0,0,6,6,
Pittsburg,Governor,Mary Fallin,REP,610031,2,0,57,59,
Pittsburg,Superintendent of Public Instruction,Brian Kelly,REP,610031,0,0,20,20,
Pittsburg,Superintendent of Public Instruction,Janet Costello Barresi,REP,610031,0,0,12,12,
Pittsburg,Superintendent of Public Instruction,Joy Hofmeister,REP,610031,2,0,34,36,
Pittsburg,Insurance Commissioner,Bill Viner,REP,610031,0,0,19,19,
Pittsburg,Insurance Commissioner,John Doak,REP,610031,2,0,38,40,
Pittsburg,Corporation Commissioner,Todd Hiett,REP,610031,2,0,27,29,
Pittsburg,Corporation Commissioner,Cliff Branan,REP,610031,0,0,31,31,
Pittsburg,U.S. Senate,Evelyn Rogers,REP,610031,0,0,2,2,
Pittsburg,U.S. Senate,Rob Moye,REP,610031,0,0,0,0,
Pittsburg,U.S. Senate,D. Jean Mcbride-Samuels,REP,610031,0,0,1,1,
Pittsburg,U.S. Senate,Jim Inhofe,REP,610031,2,0,59,61,
Pittsburg,U.S. Senate,Erick Paul Wyatt,REP,610031,0,0,4,4,
Pittsburg,U.S. Senate,Andy Craig,REP,610031,0,0,0,0,
Pittsburg,U.S. Senate,T. Shannon,REP,610031,2,0,29,31,
Pittsburg,U.S. Senate,Randy Brogdon,REP,610031,0,0,10,10,
Pittsburg,U.S. Senate,Eric Mccray,REP,610031,0,0,0,0,
Pittsburg,U.S. Senate,Kevin Crow,REP,610031,0,0,0,0,
Pittsburg,U.S. Senate,James Lankford,REP,610031,0,0,23,23,
Pittsburg,U.S. Senate,Jason Weger,REP,610031,0,0,0,0,
Pittsburg,U.S. House,Darrel Robertson,REP,610031,0,0,13,13,02
Pittsburg,U.S. House,Markwayne Mullin,REP,610031,2,0,53,55,02
Pittsburg,State House,Paul Marean,REP,610031,2,0,17,19,17
Pittsburg,State House,Micah Thompson,REP,610031,0,0,49,49,17
Pittsburg,Superintendent of Public Instruction,John Cox,DEM,610032,0,13,87,100,
Pittsburg,Superintendent of Public Instruction,Jack Jr.,DEM,610032,0,1,13,14,
Pittsburg,Superintendent of Public Instruction,Ivan Holmes,DEM,610032,0,1,8,9,
Pittsburg,Superintendent of Public Instruction,Freda Deskin,DEM,610032,0,5,26,31,
Pittsburg,U.S. Senate,Patrick Michael Hayes,DEM,610032,0,6,42,48,
Pittsburg,U.S. Senate,Jim Rogers,DEM,610032,0,5,38,43,
Pittsburg,U.S. Senate,Connie Johnson,DEM,610032,0,9,49,58,
Pittsburg,U.S. House,Earl Everett,DEM,610032,0,10,84,94,02
Pittsburg,U.S. House,Joshua Harris-Till,DEM,610032,0,10,41,51,02
Pittsburg,Governor,Dax Ewbank,REP,610032,0,0,4,4,
Pittsburg,Governor,Chad Moody,REP,610032,0,1,7,8,
Pittsburg,Governor,Mary Fallin,REP,610032,1,4,86,91,
Pittsburg,Superintendent of Public Instruction,Brian Kelly,REP,610032,0,0,19,19,
Pittsburg,Superintendent of Public Instruction,Janet Costello Barresi,REP,610032,1,2,23,26,
Pittsburg,Superintendent of Public Instruction,Joy Hofmeister,REP,610032,0,3,51,54,
Pittsburg,Insurance Commissioner,Bill Viner,REP,610032,0,0,20,20,
Pittsburg,Insurance Commissioner,John Doak,REP,610032,1,4,62,67,
Pittsburg,Corporation Commissioner,Todd Hiett,REP,610032,0,3,44,47,
Pittsburg,Corporation Commissioner,Cliff Branan,REP,610032,1,2,43,46,
Pittsburg,U.S. Senate,Evelyn Rogers,REP,610032,0,0,1,1,
Pittsburg,U.S. Senate,Rob Moye,REP,610032,0,0,2,2,
Pittsburg,U.S. Senate,D. Jean Mcbride-Samuels,REP,610032,0,0,1,1,
Pittsburg,U.S. Senate,Jim Inhofe,REP,610032,1,5,87,93,
Pittsburg,U.S. Senate,Erick Paul Wyatt,REP,610032,0,0,4,4,
Pittsburg,U.S. Senate,Andy Craig,REP,610032,0,0,1,1,
Pittsburg,U.S. Senate,T. Shannon,REP,610032,0,1,37,38,
Pittsburg,U.S. Senate,Randy Brogdon,REP,610032,0,0,3,3,
Pittsburg,U.S. Senate,Eric Mccray,REP,610032,0,0,1,1,
Pittsburg,U.S. Senate,Kevin Crow,REP,610032,0,0,3,3,
Pittsburg,U.S. Senate,James Lankford,REP,610032,1,4,51,56,
Pittsburg,U.S. Senate,Jason Weger,REP,610032,0,0,0,0,
Pittsburg,U.S. House,Darrel Robertson,REP,610032,0,1,21,22,02
Pittsburg,U.S. House,Markwayne Mullin,REP,610032,1,3,73,77,02
Pittsburg,State House,Paul Marean,REP,610032,0,1,41,42,17
Pittsburg,State House,Micah Thompson,REP,610032,1,4,44,49,17
Pittsburg,Superintendent of Public Instruction,John Cox,DEM,610033,0,1,47,48,
Pittsburg,Superintendent of Public Instruction,Jack Jr.,DEM,610033,0,1,7,8,
Pittsburg,Superintendent of Public Instruction,Ivan Holmes,DEM,610033,0,0,3,3,
Pittsburg,Superintendent of Public Instruction,Freda Deskin,DEM,610033,0,0,24,24,
Pittsburg,U.S. Senate,Patrick Michael Hayes,DEM,610033,0,2,14,16,
Pittsburg,U.S. Senate,Jim Rogers,DEM,610033,0,0,48,48,
Pittsburg,U.S. Senate,Connie Johnson,DEM,610033,0,0,19,19,
Pittsburg,U.S. House,Earl Everett,DEM,610033,0,2,41,43,02
Pittsburg,U.S. House,Joshua Harris-Till,DEM,610033,0,0,40,40,02
Pittsburg,Governor,Dax Ewbank,REP,610033,0,0,3,3,
Pittsburg,Governor,Chad Moody,REP,610033,0,0,5,5,
Pittsburg,Governor,Mary Fallin,REP,610033,0,1,13,14,
Pittsburg,Superintendent of Public Instruction,Brian Kelly,REP,610033,0,0,6,6,
Pittsburg,Superintendent of Public Instruction,Janet Costello Barresi,REP,610033,0,1,4,5,
Pittsburg,Superintendent of Public Instruction,Joy Hofmeister,REP,610033,0,0,11,11,
Pittsburg,Insurance Commissioner,Bill Viner,REP,610033,0,1,6,7,
Pittsburg,Insurance Commissioner,John Doak,REP,610033,0,0,14,14,
Pittsburg,Corporation Commissioner,Todd Hiett,REP,610033,0,1,11,12,
Pittsburg,Corporation Commissioner,Cliff Branan,REP,610033,0,0,9,9,
Pittsburg,U.S. Senate,Evelyn Rogers,REP,610033,0,0,1,1,
Pittsburg,U.S. Senate,Rob Moye,REP,610033,0,0,0,0,
Pittsburg,U.S. Senate,D. Jean Mcbride-Samuels,REP,610033,0,0,0,0,
Pittsburg,U.S. Senate,Jim Inhofe,REP,610033,0,1,19,20,
Pittsburg,U.S. Senate,Erick Paul Wyatt,REP,610033,0,0,1,1,
Pittsburg,U.S. Senate,Andy Craig,REP,610033,0,0,0,0,
Pittsburg,U.S. Senate,T. Shannon,REP,610033,0,1,15,16,
Pittsburg,U.S. Senate,Randy Brogdon,REP,610033,0,0,1,1,
Pittsburg,U.S. Senate,Eric Mccray,REP,610033,0,0,0,0,
Pittsburg,U.S. Senate,Kevin Crow,REP,610033,0,0,0,0,
Pittsburg,U.S. Senate,James Lankford,REP,610033,0,0,4,4,
Pittsburg,U.S. Senate,Jason Weger,REP,610033,0,0,0,0,
Pittsburg,U.S. House,Darrel Robertson,REP,610033,0,0,4,4,02
Pittsburg,U.S. House,Markwayne Mullin,REP,610033,0,1,16,17,02
Pittsburg,State House,Paul Marean,REP,610033,0,1,9,10,17
Pittsburg,State House,Micah Thompson,REP,610033,0,0,10,10,17
Pittsburg,Superintendent of Public Instruction,John Cox,DEM,610034,1,3,70,74,
Pittsburg,Superintendent of Public Instruction,Jack Jr.,DEM,610034,0,0,7,7,
Pittsburg,Superintendent of Public Instruction,Ivan Holmes,DEM,610034,2,0,4,6,
Pittsburg,Superintendent of Public Instruction,Freda Deskin,DEM,610034,0,0,34,34,
Pittsburg,U.S. Senate,Patrick Michael Hayes,DEM,610034,0,0,25,25,
Pittsburg,U.S. Senate,Jim Rogers,DEM,610034,3,3,55,61,
Pittsburg,U.S. Senate,Connie Johnson,DEM,610034,0,0,27,27,
Pittsburg,U.S. House,Earl Everett,DEM,610034,3,3,67,73,02
Pittsburg,U.S. House,Joshua Harris-Till,DEM,610034,0,0,40,40,02
Pittsburg,Governor,Dax Ewbank,REP,610034,0,0,3,3,
Pittsburg,Governor,Chad Moody,REP,610034,0,0,12,12,
Pittsburg,Governor,Mary Fallin,REP,610034,0,1,21,22,
Pittsburg,Superintendent of Public Instruction,Brian Kelly,REP,610034,0,1,9,10,
Pittsburg,Superintendent of Public Instruction,Janet Costello Barresi,REP,610034,0,0,5,5,
Pittsburg,Superintendent of Public Instruction,Joy Hofmeister,REP,610034,0,0,22,22,
Pittsburg,Insurance Commissioner,Bill Viner,REP,610034,0,0,8,8,
Pittsburg,Insurance Commissioner,John Doak,REP,610034,0,1,24,25,
Pittsburg,Corporation Commissioner,Todd Hiett,REP,610034,0,1,15,16,
Pittsburg,Corporation Commissioner,Cliff Branan,REP,610034,0,0,19,19,
Pittsburg,U.S. Senate,Evelyn Rogers,REP,610034,0,0,2,2,
Pittsburg,U.S. Senate,Rob Moye,REP,610034,0,0,0,0,
Pittsburg,U.S. Senate,D. Jean Mcbride-Samuels,REP,610034,0,0,0,0,
Pittsburg,U.S. Senate,Jim Inhofe,REP,610034,0,1,28,29,
Pittsburg,U.S. Senate,Erick Paul Wyatt,REP,610034,0,0,6,6,
Pittsburg,U.S. Senate,Andy Craig,REP,610034,0,0,0,0,
Pittsburg,U.S. Senate,T. Shannon,REP,610034,0,0,8,8,
Pittsburg,U.S. Senate,Randy Brogdon,REP,610034,0,0,2,2,
Pittsburg,U.S. Senate,Eric Mccray,REP,610034,0,0,0,0,
Pittsburg,U.S. Senate,Kevin Crow,REP,610034,0,0,0,0,
Pittsburg,U.S. Senate,James Lankford,REP,610034,0,1,24,25,
Pittsburg,U.S. Senate,Jason Weger,REP,610034,0,0,2,2,
Pittsburg,U.S. House,Darrel Robertson,REP,610034,0,0,10,10,02
Pittsburg,U.S. House,Markwayne Mullin,REP,610034,0,1,26,27,02
Pittsburg,State House,Paul Marean,REP,610034,0,0,11,11,17
Pittsburg,State House,Micah Thompson,REP,610034,0,1,24,25,17
Pittsburg,Superintendent of Public Instruction,John Cox,DEM,610035,1,0,65,66,
Pittsburg,Superintendent of Public Instruction,Jack Jr.,DEM,610035,0,0,5,5,
Pittsburg,Superintendent of Public Instruction,Ivan Holmes,DEM,610035,0,0,3,3,
Pittsburg,Superintendent of Public Instruction,Freda Deskin,DEM,610035,0,0,28,28,
Pittsburg,U.S. Senate,Patrick Michael Hayes,DEM,610035,0,0,24,24,
Pittsburg,U.S. Senate,Jim Rogers,DEM,610035,0,0,45,45,
Pittsburg,U.S. Senate,Connie Johnson,DEM,610035,1,0,33,34,
Pittsburg,U.S. House,Earl Everett,DEM,610035,1,0,52,53,02
Pittsburg,U.S. House,Joshua Harris-Till,DEM,610035,0,0,49,49,02
Pittsburg,Governor,Dax Ewbank,REP,610035,0,0,2,2,
Pittsburg,Governor,Chad Moody,REP,610035,0,0,4,4,
Pittsburg,Governor,Mary Fallin,REP,610035,1,0,12,13,
Pittsburg,Superintendent of Public Instruction,Brian Kelly,REP,610035,0,0,2,2,
Pittsburg,Superintendent of Public Instruction,Janet Costello Barresi,REP,610035,0,0,1,1,
Pittsburg,Superintendent of Public Instruction,Joy Hofmeister,REP,610035,1,0,15,16,
Pittsburg,Insurance Commissioner,Bill Viner,REP,610035,0,0,2,2,
Pittsburg,Insurance Commissioner,John Doak,REP,610035,1,0,14,15,
Pittsburg,Corporation Commissioner,Todd Hiett,REP,610035,1,0,7,8,
Pittsburg,Corporation Commissioner,Cliff Branan,REP,610035,0,0,11,11,
Pittsburg,U.S. Senate,Evelyn Rogers,REP,610035,0,0,4,4,
Pittsburg,U.S. Senate,Rob Moye,REP,610035,0,0,0,0,
Pittsburg,U.S. Senate,D. Jean Mcbride-Samuels,REP,610035,0,0,0,0,
Pittsburg,U.S. Senate,Jim Inhofe,REP,610035,1,0,13,14,
Pittsburg,U.S. Senate,Erick Paul Wyatt,REP,610035,0,0,1,1,
Pittsburg,U.S. Senate,Andy Craig,REP,610035,0,0,1,1,
Pittsburg,U.S. Senate,T. Shannon,REP,610035,0,0,8,8,
Pittsburg,U.S. Senate,Randy Brogdon,REP,610035,0,0,0,0,
Pittsburg,U.S. Senate,Eric Mccray,REP,610035,1,0,0,1,
Pittsburg,U.S. Senate,Kevin Crow,REP,610035,0,0,1,1,
Pittsburg,U.S. Senate,James Lankford,REP,610035,0,0,7,7,
Pittsburg,U.S. Senate,Jason Weger,REP,610035,0,0,0,0,
Pittsburg,U.S. House,Darrel Robertson,REP,610035,1,0,3,4,02
Pittsburg,U.S. House,Markwayne Mullin,REP,610035,0,0,15,15,02
Pittsburg,State House,Paul Marean,REP,610035,0,0,11,11,17
Pittsburg,State House,Micah Thompson,REP,610035,1,0,7,8,17
Pittsburg,Superintendent of Public Instruction,John Cox,DEM,610036,0,4,34,38,
Pittsburg,Superintendent of Public Instruction,Jack Jr.,DEM,610036,0,0,1,1,
Pittsburg,Superintendent of Public Instruction,Ivan Holmes,DEM,610036,0,0,2,2,
Pittsburg,Superintendent of Public Instruction,Freda Deskin,DEM,610036,0,3,10,13,
Pittsburg,U.S. Senate,Patrick Michael Hayes,DEM,610036,0,2,13,15,
Pittsburg,U.S. Senate,Jim Rogers,DEM,610036,0,2,21,23,
Pittsburg,U.S. Senate,Connie Johnson,DEM,610036,0,3,13,16,
Pittsburg,U.S. House,Earl Everett,DEM,610036,0,4,34,38,02
Pittsburg,U.S. House,Joshua Harris-Till,DEM,610036,0,2,13,15,02
Pittsburg,Governor,Dax Ewbank,REP,610036,0,0,0,0,
Pittsburg,Governor,Chad Moody,REP,610036,0,1,3,4,
Pittsburg,Governor,Mary Fallin,REP,610036,0,0,8,8,
Pittsburg,Superintendent of Public Instruction,Brian Kelly,REP,610036,0,0,5,5,
Pittsburg,Superintendent of Public Instruction,Janet Costello Barresi,REP,610036,0,0,1,1,
Pittsburg,Superintendent of Public Instruction,Joy Hofmeister,REP,610036,0,0,5,5,
Pittsburg,Insurance Commissioner,Bill Viner,REP,610036,0,0,3,3,
Pittsburg,Insurance Commissioner,John Doak,REP,610036,0,0,6,6,
Pittsburg,Corporation Commissioner,Todd Hiett,REP,610036,0,1,7,8,
Pittsburg,Corporation Commissioner,Cliff Branan,REP,610036,0,0,4,4,
Pittsburg,U.S. Senate,Evelyn Rogers,REP,610036,0,0,0,0,
Pittsburg,U.S. Senate,Rob Moye,REP,610036,0,0,0,0,
Pittsburg,U.S. Senate,D. Jean Mcbride-Samuels,REP,610036,0,0,1,1,
Pittsburg,U.S. Senate,Jim Inhofe,REP,610036,0,0,10,10,
Pittsburg,U.S. Senate,Erick Paul Wyatt,REP,610036,0,0,0,0,
Pittsburg,U.S. Senate,Andy Craig,REP,610036,0,0,0,0,
Pittsburg,U.S. Senate,T. Shannon,REP,610036,0,0,8,8,
Pittsburg,U.S. Senate,Randy Brogdon,REP,610036,0,0,0,0,
Pittsburg,U.S. Senate,Eric Mccray,REP,610036,0,0,1,1,
Pittsburg,U.S. Senate,Kevin Crow,REP,610036,0,0,0,0,
Pittsburg,U.S. Senate,James Lankford,REP,610036,0,0,2,2,
Pittsburg,U.S. Senate,Jason Weger,REP,610036,0,0,0,0,
Pittsburg,U.S. House,Darrel Robertson,REP,610036,0,0,0,0,02
Pittsburg,U.S. House,Markwayne Mullin,REP,610036,0,0,11,11,02
Pittsburg,Superintendent of Public Instruction,John Cox,DEM,610037,0,0,118,118,
Pittsburg,Superintendent of Public Instruction,Jack Jr.,DEM,610037,0,0,20,20,
Pittsburg,Superintendent of Public Instruction,Ivan Holmes,DEM,610037,0,0,8,8,
Pittsburg,Superintendent of Public Instruction,Freda Deskin,DEM,610037,0,3,60,63,
Pittsburg,U.S. Senate,Patrick Michael Hayes,DEM,610037,0,1,52,53,
Pittsburg,U.S. Senate,Jim Rogers,DEM,610037,0,0,97,97,
Pittsburg,U.S. Senate,Connie Johnson,DEM,610037,0,2,49,51,
Pittsburg,U.S. House,Earl Everett,DEM,610037,0,1,143,144,02
Pittsburg,U.S. House,Joshua Harris-Till,DEM,610037,0,2,55,57,02
Pittsburg,Governor,Dax Ewbank,REP,610037,0,0,1,1,
Pittsburg,Governor,Chad Moody,REP,610037,0,0,7,7,
Pittsburg,Governor,Mary Fallin,REP,610037,2,4,29,35,
Pittsburg,Superintendent of Public Instruction,Brian Kelly,REP,610037,1,1,15,17,
Pittsburg,Superintendent of Public Instruction,Janet Costello Barresi,REP,610037,0,3,7,10,
Pittsburg,Superintendent of Public Instruction,Joy Hofmeister,REP,610037,1,0,14,15,
Pittsburg,Insurance Commissioner,Bill Viner,REP,610037,0,0,15,15,
Pittsburg,Insurance Commissioner,John Doak,REP,610037,2,3,20,25,
Pittsburg,Corporation Commissioner,Todd Hiett,REP,610037,1,1,12,14,
Pittsburg,Corporation Commissioner,Cliff Branan,REP,610037,1,3,24,28,
Pittsburg,U.S. Senate,Evelyn Rogers,REP,610037,0,0,2,2,
Pittsburg,U.S. Senate,Rob Moye,REP,610037,0,0,0,0,
Pittsburg,U.S. Senate,D. Jean Mcbride-Samuels,REP,610037,0,0,0,0,
Pittsburg,U.S. Senate,Jim Inhofe,REP,610037,2,4,36,42,
Pittsburg,U.S. Senate,Erick Paul Wyatt,REP,610037,0,0,0,0,
Pittsburg,U.S. Senate,Andy Craig,REP,610037,0,0,1,1,
Pittsburg,U.S. Senate,T. Shannon,REP,610037,2,1,22,25,
Pittsburg,U.S. Senate,Randy Brogdon,REP,610037,0,0,0,0,
Pittsburg,U.S. Senate,Eric Mccray,REP,610037,0,0,1,1,
Pittsburg,U.S. Senate,Kevin Crow,REP,610037,0,0,0,0,
Pittsburg,U.S. Senate,James Lankford,REP,610037,0,3,13,16,
Pittsburg,U.S. Senate,Jason Weger,REP,610037,0,0,0,0,
Pittsburg,U.S. House,Darrel Robertson,REP,610037,0,0,5,5,02
Pittsburg,U.S. House,Markwayne Mullin,REP,610037,2,4,33,39,02
Pittsburg,Superintendent of Public Instruction,John Cox,DEM,610038,0,0,6,6,
Pittsburg,Superintendent of Public Instruction,Jack Jr.,DEM,610038,0,0,0,0,
Pittsburg,Superintendent of Public Instruction,Ivan Holmes,DEM,610038,0,0,0,0,
Pittsburg,Superintendent of Public Instruction,Freda Deskin,DEM,610038,0,0,3,3,
Pittsburg,U.S. Senate,Patrick Michael Hayes,DEM,610038,0,0,1,1,
Pittsburg,U.S. Senate,Jim Rogers,DEM,610038,0,0,5,5,
Pittsburg,U.S. Senate,Connie Johnson,DEM,610038,0,0,1,1,
Pittsburg,U.S. House,Earl Everett,DEM,610038,0,0,5,5,02
Pittsburg,U.S. House,Joshua Harris-Till,DEM,610038,0,0,2,2,02
Pittsburg,Governor,Dax Ewbank,REP,610038,0,0,0,0,
Pittsburg,Governor,Chad Moody,REP,610038,0,0,0,0,
Pittsburg,Governor,Mary Fallin,REP,610038,0,0,2,2,
Pittsburg,Superintendent of Public Instruction,Brian Kelly,REP,610038,0,0,2,2,
Pittsburg,Superintendent of Public Instruction,Janet Costello Barresi,REP,610038,0,0,0,0,
Pittsburg,Superintendent of Public Instruction,Joy Hofmeister,REP,610038,0,0,0,0,
Pittsburg,Insurance Commissioner,Bill Viner,REP,610038,0,0,0,0,
Pittsburg,Insurance Commissioner,John Doak,REP,610038,0,0,2,2,
Pittsburg,Corporation Commissioner,Todd Hiett,REP,610038,0,0,1,1,
Pittsburg,Corporation Commissioner,Cliff Branan,REP,610038,0,0,1,1,
Pittsburg,U.S. Senate,Evelyn Rogers,REP,610038,0,0,0,0,
Pittsburg,U.S. Senate,Rob Moye,REP,610038,0,0,0,0,
Pittsburg,U.S. Senate,D. Jean Mcbride-Samuels,REP,610038,0,0,0,0,
Pittsburg,U.S. Senate,Jim Inhofe,REP,610038,0,0,2,2,
Pittsburg,U.S. Senate,Erick Paul Wyatt,REP,610038,0,0,0,0,
Pittsburg,U.S. Senate,Andy Craig,REP,610038,0,0,0,0,
Pittsburg,U.S. Senate,T. Shannon,REP,610038,0,0,1,1,
Pittsburg,U.S. Senate,Randy Brogdon,REP,610038,0,0,0,0,
Pittsburg,U.S. Senate,Eric Mccray,REP,610038,0,0,0,0,
Pittsburg,U.S. Senate,Kevin Crow,REP,610038,0,0,0,0,
Pittsburg,U.S. Senate,James Lankford,REP,610038,0,0,1,1,
Pittsburg,U.S. Senate,Jason Weger,REP,610038,0,0,0,0,
Pittsburg,U.S. House,Darrel Robertson,REP,610038,0,0,0,0,02
Pittsburg,U.S. House,Markwayne Mullin,REP,610038,0,0,2,2,02
Pittsburg,State House,Paul Marean,REP,610038,0,0,1,1,17
Pittsburg,State House,Micah Thompson,REP,610038,0,0,1,1,17
Pittsburg,Superintendent of Public Instruction,John Cox,DEM,610039,0,0,62,62,
Pittsburg,Superintendent of Public Instruction,Jack Jr.,DEM,610039,0,0,12,12,
Pittsburg,Superintendent of Public Instruction,Ivan Holmes,DEM,610039,0,0,1,1,
Pittsburg,Superintendent of Public Instruction,Freda Deskin,DEM,610039,0,0,26,26,
Pittsburg,U.S. Senate,Patrick Michael Hayes,DEM,610039,0,0,32,32,
Pittsburg,U.S. Senate,Jim Rogers,DEM,610039,0,0,40,40,
Pittsburg,U.S. Senate,Connie Johnson,DEM,610039,0,0,28,28,
Pittsburg,U.S. House,Earl Everett,DEM,610039,0,0,55,55,02
Pittsburg,U.S. House,Joshua Harris-Till,DEM,610039,0,0,46,46,02
Pittsburg,Governor,Dax Ewbank,REP,610039,0,0,0,0,
Pittsburg,Governor,Chad Moody,REP,610039,0,0,6,6,
Pittsburg,Governor,Mary Fallin,REP,610039,0,2,16,18,
Pittsburg,Superintendent of Public Instruction,Brian Kelly,REP,610039,0,2,6,8,
Pittsburg,Superintendent of Public Instruction,Janet Costello Barresi,REP,610039,0,0,3,3,
Pittsburg,Superintendent of Public Instruction,Joy Hofmeister,REP,610039,0,0,12,12,
Pittsburg,Insurance Commissioner,Bill Viner,REP,610039,0,0,8,8,
Pittsburg,Insurance Commissioner,John Doak,REP,610039,0,2,10,12,
Pittsburg,Corporation Commissioner,Todd Hiett,REP,610039,0,0,11,11,
Pittsburg,Corporation Commissioner,Cliff Branan,REP,610039,0,2,6,8,
Pittsburg,U.S. Senate,Evelyn Rogers,REP,610039,0,0,1,1,
Pittsburg,U.S. Senate,Rob Moye,REP,610039,0,0,1,1,
Pittsburg,U.S. Senate,D. Jean Mcbride-Samuels,REP,610039,0,0,1,1,
Pittsburg,U.S. Senate,Jim Inhofe,REP,610039,0,2,18,20,
Pittsburg,U.S. Senate,Erick Paul Wyatt,REP,610039,0,0,0,0,
Pittsburg,U.S. Senate,Andy Craig,REP,610039,0,0,0,0,
Pittsburg,U.S. Senate,T. Shannon,REP,610039,0,0,7,7,
Pittsburg,U.S. Senate,Randy Brogdon,REP,610039,0,0,0,0,
Pittsburg,U.S. Senate,Eric Mccray,REP,610039,0,0,0,0,
Pittsburg,U.S. Senate,Kevin Crow,REP,610039,0,0,1,1,
Pittsburg,U.S. Senate,James Lankford,REP,610039,0,2,14,16,
Pittsburg,U.S. Senate,Jason Weger,REP,610039,0,0,0,0,
Pittsburg,U.S. House,Darrel Robertson,REP,610039,0,0,6,6,02
Pittsburg,U.S. House,Markwayne Mullin,REP,610039,0,2,14,16,02
Pittsburg,Superintendent of Public Instruction,John Cox,DEM,610040,1,1,49,51,
Pittsburg,Superintendent of Public Instruction,Jack Jr.,DEM,610040,0,0,4,4,
Pittsburg,Superintendent of Public Instruction,Ivan Holmes,DEM,610040,0,0,1,1,
Pittsburg,Superintendent of Public Instruction,Freda Deskin,DEM,610040,0,0,8,8,
Pittsburg,U.S. Senate,Patrick Michael Hayes,DEM,610040,0,0,24,24,
Pittsburg,U.S. Senate,Jim Rogers,DEM,610040,1,1,22,24,
Pittsburg,U.S. Senate,Connie Johnson,DEM,610040,0,0,13,13,
Pittsburg,U.S. House,Earl Everett,DEM,610040,1,1,36,38,02
Pittsburg,U.S. House,Joshua Harris-Till,DEM,610040,0,0,19,19,02
Pittsburg,Governor,Dax Ewbank,REP,610040,0,0,3,3,
Pittsburg,Governor,Chad Moody,REP,610040,0,0,6,6,
Pittsburg,Governor,Mary Fallin,REP,610040,0,0,15,15,
Pittsburg,Superintendent of Public Instruction,Brian Kelly,REP,610040,0,0,7,7,
Pittsburg,Superintendent of Public Instruction,Janet Costello Barresi,REP,610040,0,0,2,2,
Pittsburg,Superintendent of Public Instruction,Joy Hofmeister,REP,610040,0,0,15,15,
Pittsburg,Insurance Commissioner,Bill Viner,REP,610040,0,0,5,5,
Pittsburg,Insurance Commissioner,John Doak,REP,610040,0,0,17,17,
Pittsburg,Corporation Commissioner,Todd Hiett,REP,610040,0,0,7,7,
Pittsburg,Corporation Commissioner,Cliff Branan,REP,610040,0,0,15,15,
Pittsburg,U.S. Senate,Evelyn Rogers,REP,610040,0,0,0,0,
Pittsburg,U.S. Senate,Rob Moye,REP,610040,0,0,3,3,
Pittsburg,U.S. Senate,D. Jean Mcbride-Samuels,REP,610040,0,0,0,0,
Pittsburg,U.S. Senate,Jim Inhofe,REP,610040,0,0,20,20,
Pittsburg,U.S. Senate,Erick Paul Wyatt,REP,610040,0,0,1,1,
Pittsburg,U.S. Senate,Andy Craig,REP,610040,0,0,0,0,
Pittsburg,U.S. Senate,T. Shannon,REP,610040,0,0,11,11,
Pittsburg,U.S. Senate,Randy Brogdon,REP,610040,0,0,0,0,
Pittsburg,U.S. Senate,Eric Mccray,REP,610040,0,0,0,0,
Pittsburg,U.S. Senate,Kevin Crow,REP,610040,0,0,0,0,
Pittsburg,U.S. Senate,James Lankford,REP,610040,0,0,13,13,
Pittsburg,U.S. Senate,Jason Weger,REP,610040,0,0,0,0,
Pittsburg,U.S. House,Darrel Robertson,REP,610040,0,0,10,10,02
Pittsburg,U.S. House,Markwayne Mullin,REP,610040,0,0,14,14,02
Pittsburg,State House,Paul Marean,REP,610040,0,0,10,10,17
Pittsburg,State House,Micah Thompson,REP,610040,0,0,15,15,17
Pittsburg,Superintendent of Public Instruction,John Cox,DEM,610041,1,1,57,59,
Pittsburg,Superintendent of Public Instruction,Jack Jr.,DEM,610041,0,0,16,16,
Pittsburg,Superintendent of Public Instruction,Ivan Holmes,DEM,610041,0,0,8,8,
Pittsburg,Superintendent of Public Instruction,Freda Deskin,DEM,610041,0,3,30,33,
Pittsburg,U.S. Senate,Patrick Michael Hayes,DEM,610041,0,1,36,37,
Pittsburg,U.S. Senate,Jim Rogers,DEM,610041,0,0,43,43,
Pittsburg,U.S. Senate,Connie Johnson,DEM,610041,1,2,30,33,
Pittsburg,U.S. House,Earl Everett,DEM,610041,0,2,70,72,02
Pittsburg,U.S. House,Joshua Harris-Till,DEM,610041,1,1,39,41,02
Pittsburg,Governor,Dax Ewbank,REP,610041,0,2,0,2,
Pittsburg,Governor,Chad Moody,REP,610041,0,0,1,1,
Pittsburg,Governor,Mary Fallin,REP,610041,1,3,30,34,
Pittsburg,Superintendent of Public Instruction,Brian Kelly,REP,610041,0,1,7,8,
Pittsburg,Superintendent of Public Instruction,Janet Costello Barresi,REP,610041,1,1,7,9,
Pittsburg,Superintendent of Public Instruction,Joy Hofmeister,REP,610041,0,4,18,22,
Pittsburg,Insurance Commissioner,Bill Viner,REP,610041,0,0,10,10,
Pittsburg,Insurance Commissioner,John Doak,REP,610041,1,5,18,24,
Pittsburg,Corporation Commissioner,Todd Hiett,REP,610041,1,4,16,21,
Pittsburg,Corporation Commissioner,Cliff Branan,REP,610041,0,1,16,17,
Pittsburg,U.S. Senate,Evelyn Rogers,REP,610041,0,1,0,1,
Pittsburg,U.S. Senate,Rob Moye,REP,610041,0,0,2,2,
Pittsburg,U.S. Senate,D. Jean Mcbride-Samuels,REP,610041,0,0,0,0,
Pittsburg,U.S. Senate,Jim Inhofe,REP,610041,1,5,25,31,
Pittsburg,U.S. Senate,Erick Paul Wyatt,REP,610041,0,0,5,5,
Pittsburg,U.S. Senate,Andy Craig,REP,610041,0,0,0,0,
Pittsburg,U.S. Senate,T. Shannon,REP,610041,0,0,16,16,
Pittsburg,U.S. Senate,Randy Brogdon,REP,610041,0,0,1,1,
Pittsburg,U.S. Senate,Eric Mccray,REP,610041,0,0,1,1,
Pittsburg,U.S. Senate,Kevin Crow,REP,610041,0,0,1,1,
Pittsburg,U.S. Senate,James Lankford,REP,610041,1,5,13,19,
Pittsburg,U.S. Senate,Jason Weger,REP,610041,0,0,0,0,
Pittsburg,U.S. House,Darrel Robertson,REP,610041,1,1,6,8,02
Pittsburg,U.S. House,Markwayne Mullin,REP,610041,0,5,26,31,02
Pittsburg,State House,Paul Marean,REP,610041,0,0,8,8,17
Pittsburg,State House,Micah Thompson,REP,610041,1,5,23,29,17
Pittsburg,Superintendent of Public Instruction,John Cox,DEM,610042,0,4,57,61,
Pittsburg,Superintendent of Public Instruction,Jack Jr.,DEM,610042,0,1,7,8,
Pittsburg,Superintendent of Public Instruction,Ivan Holmes,DEM,610042,0,1,4,5,
Pittsburg,Superintendent of Public Instruction,Freda Deskin,DEM,610042,0,2,30,32,
Pittsburg,U.S. Senate,Patrick Michael Hayes,DEM,610042,0,3,21,24,
Pittsburg,U.S. Senate,Jim Rogers,DEM,610042,0,4,38,42,
Pittsburg,U.S. Senate,Connie Johnson,DEM,610042,0,1,34,35,
Pittsburg,U.S. House,Earl Everett,DEM,610042,0,4,54,58,02
Pittsburg,U.S. House,Joshua Harris-Till,DEM,610042,0,4,37,41,02
Pittsburg,Governor,Dax Ewbank,REP,610042,0,0,0,0,
Pittsburg,Governor,Chad Moody,REP,610042,0,1,2,3,
Pittsburg,Governor,Mary Fallin,REP,610042,0,2,22,24,
Pittsburg,Superintendent of Public Instruction,Brian Kelly,REP,610042,0,1,5,6,
Pittsburg,Superintendent of Public Instruction,Janet Costello Barresi,REP,610042,0,2,4,6,
Pittsburg,Superintendent of Public Instruction,Joy Hofmeister,REP,610042,0,0,15,15,
Pittsburg,Insurance Commissioner,Bill Viner,REP,610042,0,1,6,7,
Pittsburg,Insurance Commissioner,John Doak,REP,610042,0,2,14,16,
Pittsburg,Corporation Commissioner,Todd Hiett,REP,610042,0,2,12,14,
Pittsburg,Corporation Commissioner,Cliff Branan,REP,610042,0,1,11,12,
Pittsburg,U.S. Senate,Evelyn Rogers,REP,610042,0,0,0,0,
Pittsburg,U.S. Senate,Rob Moye,REP,610042,0,0,1,1,
Pittsburg,U.S. Senate,D. Jean Mcbride-Samuels,REP,610042,0,0,1,1,
Pittsburg,U.S. Senate,Jim Inhofe,REP,610042,0,3,20,23,
Pittsburg,U.S. Senate,Erick Paul Wyatt,REP,610042,0,0,2,2,
Pittsburg,U.S. Senate,Andy Craig,REP,610042,0,0,0,0,
Pittsburg,U.S. Senate,T. Shannon,REP,610042,0,0,12,12,
Pittsburg,U.S. Senate,Randy Brogdon,REP,610042,0,2,0,2,
Pittsburg,U.S. Senate,Eric Mccray,REP,610042,0,0,1,1,
Pittsburg,U.S. Senate,Kevin Crow,REP,610042,0,0,1,1,
Pittsburg,U.S. Senate,James Lankford,REP,610042,0,1,8,9,
Pittsburg,U.S. Senate,Jason Weger,REP,610042,0,0,1,1,
Pittsburg,U.S. House,Darrel Robertson,REP,610042,0,2,5,7,02
Pittsburg,U.S. House,Markwayne Mullin,REP,610042,0,1,19,20,02
Pittsburg,State House,Paul Marean,REP,610042,0,0,8,8,17
Pittsburg,State House,Micah Thompson,REP,610042,0,3,12,15,17
Pittsburg,Superintendent of Public Instruction,John Cox,DEM,610043,0,0,45,45,
Pittsburg,Superintendent of Public Instruction,Jack Jr.,DEM,610043,0,0,7,7,
Pittsburg,Superintendent of Public Instruction,Ivan Holmes,DEM,610043,0,0,2,2,
Pittsburg,Superintendent of Public Instruction,Freda Deskin,DEM,610043,0,0,8,8,
Pittsburg,U.S. Senate,Patrick Michael Hayes,DEM,610043,0,0,22,22,
Pittsburg,U.S. Senate,Jim Rogers,DEM,610043,0,0,24,24,
Pittsburg,U.S. Senate,Connie Johnson,DEM,610043,0,0,12,12,
Pittsburg,U.S. House,Earl Everett,DEM,610043,0,0,38,38,02
Pittsburg,U.S. House,Joshua Harris-Till,DEM,610043,0,0,20,20,02
Pittsburg,Governor,Dax Ewbank,REP,610043,0,0,1,1,
Pittsburg,Governor,Chad Moody,REP,610043,0,1,5,6,
Pittsburg,Governor,Mary Fallin,REP,610043,0,0,14,14,
Pittsburg,Superintendent of Public Instruction,Brian Kelly,REP,610043,0,0,8,8,
Pittsburg,Superintendent of Public Instruction,Janet Costello Barresi,REP,610043,0,0,3,3,
Pittsburg,Superintendent of Public Instruction,Joy Hofmeister,REP,610043,0,1,10,11,
Pittsburg,Insurance Commissioner,Bill Viner,REP,610043,0,0,7,7,
Pittsburg,Insurance Commissioner,John Doak,REP,610043,0,1,11,12,
Pittsburg,Corporation Commissioner,Todd Hiett,REP,610043,0,0,13,13,
Pittsburg,Corporation Commissioner,Cliff Branan,REP,610043,0,1,7,8,
Pittsburg,U.S. Senate,Evelyn Rogers,REP,610043,0,0,1,1,
Pittsburg,U.S. Senate,Rob Moye,REP,610043,0,0,1,1,
Pittsburg,U.S. Senate,D. Jean Mcbride-Samuels,REP,610043,0,0,0,0,
Pittsburg,U.S. Senate,Jim Inhofe,REP,610043,0,1,17,18,
Pittsburg,U.S. Senate,Erick Paul Wyatt,REP,610043,0,0,1,1,
Pittsburg,U.S. Senate,Andy Craig,REP,610043,0,0,0,0,
Pittsburg,U.S. Senate,T. Shannon,REP,610043,0,0,9,9,
Pittsburg,U.S. Senate,Randy Brogdon,REP,610043,0,0,1,1,
Pittsburg,U.S. Senate,Eric Mccray,REP,610043,0,0,0,0,
Pittsburg,U.S. Senate,Kevin Crow,REP,610043,0,0,0,0,
Pittsburg,U.S. Senate,James Lankford,REP,610043,0,1,9,10,
Pittsburg,U.S. Senate,Jason Weger,REP,610043,0,0,1,1,
Pittsburg,U.S. House,Darrel Robertson,REP,610043,0,0,2,2,02
Pittsburg,U.S. House,Markwayne Mullin,REP,610043,0,1,18,19,02
Pittsburg,State House,Paul Marean,REP,610043,0,0,3,3,17
Pittsburg,State House,Micah Thompson,REP,610043,0,1,17,18,17
Pittsburg,Superintendent of Public Instruction,John Cox,DEM,610044,0,0,77,77,
Pittsburg,Superintendent of Public Instruction,Jack Jr.,DEM,610044,0,0,5,5,
Pittsburg,Superintendent of Public Instruction,Ivan Holmes,DEM,610044,0,0,5,5,
Pittsburg,Superintendent of Public Instruction,Freda Deskin,DEM,610044,0,0,16,16,
Pittsburg,U.S. Senate,Patrick Michael Hayes,DEM,610044,0,0,23,23,
Pittsburg,U.S. Senate,Jim Rogers,DEM,610044,0,0,55,55,
Pittsburg,U.S. Senate,Connie Johnson,DEM,610044,0,0,24,24,
Pittsburg,U.S. House,Earl Everett,DEM,610044,0,0,49,49,02
Pittsburg,U.S. House,Joshua Harris-Till,DEM,610044,0,0,51,51,02
Pittsburg,Governor,Dax Ewbank,REP,610044,0,0,3,3,
Pittsburg,Governor,Chad Moody,REP,610044,0,0,6,6,
Pittsburg,Governor,Mary Fallin,REP,610044,0,0,22,22,
Pittsburg,Superintendent of Public Instruction,Brian Kelly,REP,610044,0,0,9,9,
Pittsburg,Superintendent of Public Instruction,Janet Costello Barresi,REP,610044,0,0,2,2,
Pittsburg,Superintendent of Public Instruction,Joy Hofmeister,REP,610044,0,0,18,18,
Pittsburg,Insurance Commissioner,Bill Viner,REP,610044,0,0,11,11,
Pittsburg,Insurance Commissioner,John Doak,REP,610044,0,0,16,16,
Pittsburg,Corporation Commissioner,Todd Hiett,REP,610044,0,0,16,16,
Pittsburg,Corporation Commissioner,Cliff Branan,REP,610044,0,0,13,13,
Pittsburg,U.S. Senate,Evelyn Rogers,REP,610044,0,0,2,2,
Pittsburg,U.S. Senate,Rob Moye,REP,610044,0,0,1,1,
Pittsburg,U.S. Senate,D. Jean Mcbride-Samuels,REP,610044,0,0,0,0,
Pittsburg,U.S. Senate,Jim Inhofe,REP,610044,0,0,25,25,
Pittsburg,U.S. Senate,Erick Paul Wyatt,REP,610044,0,0,3,3,
Pittsburg,U.S. Senate,Andy Craig,REP,610044,0,0,0,0,
Pittsburg,U.S. Senate,T. Shannon,REP,610044,0,0,16,16,
Pittsburg,U.S. Senate,Randy Brogdon,REP,610044,0,0,1,1,
Pittsburg,U.S. Senate,Eric Mccray,REP,610044,0,0,1,1,
Pittsburg,U.S. Senate,Kevin Crow,REP,610044,0,0,1,1,
Pittsburg,U.S. Senate,James Lankford,REP,610044,0,0,12,12,
Pittsburg,U.S. Senate,Jason Weger,REP,610044,0,0,0,0,
Pittsburg,U.S. House,Darrel Robertson,REP,610044,0,0,4,4,02
Pittsburg,U.S. House,Markwayne Mullin,REP,610044,0,0,27,27,02
Pittsburg,State House,Paul Marean,REP,610044,0,0,16,16,17
Pittsburg,State House,Micah Thompson,REP,610044,0,0,11,11,17
Pittsburg,Superintendent of Public Instruction,John Cox,DEM,610045,0,0,1,1,
Pittsburg,Superintendent of Public Instruction,Jack Jr.,DEM,610045,0,0,0,0,
Pittsburg,Superintendent of Public Instruction,Ivan Holmes,DEM,610045,0,0,0,0,
Pittsburg,Superintendent of Public Instruction,Freda Deskin,DEM,610045,0,0,3,3,
Pittsburg,U.S. Senate,Patrick Michael Hayes,DEM,610045,0,0,2,2,
Pittsburg,U.S. Senate,Jim Rogers,DEM,610045,0,0,1,1,
Pittsburg,U.S. Senate,Connie Johnson,DEM,610045,0,0,1,1,
Pittsburg,U.S. House,Earl Everett,DEM,610045,0,0,2,2,02
Pittsburg,U.S. House,Joshua Harris-Till,DEM,610045,0,0,2,2,02
Pittsburg,Governor,Dax Ewbank,REP,610045,0,0,0,0,
Pittsburg,Governor,Chad Moody,REP,610045,0,0,0,0,
Pittsburg,Governor,Mary Fallin,REP,610045,0,0,0,0,
Pittsburg,Superintendent of Public Instruction,Brian Kelly,REP,610045,0,0,0,0,
Pittsburg,Superintendent of Public Instruction,Janet Costello Barresi,REP,610045,0,0,0,0,
Pittsburg,Superintendent of Public Instruction,Joy Hofmeister,REP,610045,0,0,0,0,
Pittsburg,Insurance Commissioner,Bill Viner,REP,610045,0,0,0,0,
Pittsburg,Insurance Commissioner,John Doak,REP,610045,0,0,0,0,
Pittsburg,Corporation Commissioner,Todd Hiett,REP,610045,0,0,0,0,
Pittsburg,Corporation Commissioner,Cliff Branan,REP,610045,0,0,0,0,
Pittsburg,U.S. Senate,Evelyn Rogers,REP,610045,0,0,0,0,
Pittsburg,U.S. Senate,Rob Moye,REP,610045,0,0,0,0,
Pittsburg,U.S. Senate,D. Jean Mcbride-Samuels,REP,610045,0,0,0,0,
Pittsburg,U.S. Senate,Jim Inhofe,REP,610045,0,0,0,0,
Pittsburg,U.S. Senate,Erick Paul Wyatt,REP,610045,0,0,0,0,
Pittsburg,U.S. Senate,Andy Craig,REP,610045,0,0,0,0,
Pittsburg,U.S. Senate,T. Shannon,REP,610045,0,0,0,0,
Pittsburg,U.S. Senate,Randy Brogdon,REP,610045,0,0,0,0,
Pittsburg,U.S. Senate,Eric Mccray,REP,610045,0,0,0,0,
Pittsburg,U.S. Senate,Kevin Crow,REP,610045,0,0,0,0,
Pittsburg,U.S. Senate,James Lankford,REP,610045,0,0,0,0,
Pittsburg,U.S. Senate,Jason Weger,REP,610045,0,0,0,0,
Pittsburg,U.S. House,Darrel Robertson,REP,610045,0,0,0,0,02
Pittsburg,U.S. House,Markwayne Mullin,REP,610045,0,0,0,0,02
Pittsburg,State House,Paul Marean,REP,610045,0,0,0,0,17
Pittsburg,State House,Micah Thompson,REP,610045,0,0,0,0,17
Pittsburg,Superintendent of Public Instruction,John Cox,DEM,610046,0,2,26,28,
Pittsburg,Superintendent of Public Instruction,Jack Jr.,DEM,610046,0,0,4,4,
Pittsburg,Superintendent of Public Instruction,Ivan Holmes,DEM,610046,0,0,2,2,
Pittsburg,Superintendent of Public Instruction,Freda Deskin,DEM,610046,0,0,19,19,
Pittsburg,U.S. Senate,Patrick Michael Hayes,DEM,610046,0,0,15,15,
Pittsburg,U.S. Senate,Jim Rogers,DEM,610046,0,0,17,17,
Pittsburg,U.S. Senate,Connie Johnson,DEM,610046,0,1,17,18,
Pittsburg,U.S. House,Earl Everett,DEM,610046,0,0,28,28,02
Pittsburg,U.S. House,Joshua Harris-Till,DEM,610046,0,1,19,20,02
Pittsburg,Governor,Dax Ewbank,REP,610046,0,0,0,0,
Pittsburg,Governor,Chad Moody,REP,610046,0,0,7,7,
Pittsburg,Governor,Mary Fallin,REP,610046,1,1,12,14,
Pittsburg,Superintendent of Public Instruction,Brian Kelly,REP,610046,1,0,4,5,
Pittsburg,Superintendent of Public Instruction,Janet Costello Barresi,REP,610046,0,1,3,4,
Pittsburg,Superintendent of Public Instruction,Joy Hofmeister,REP,610046,0,0,11,11,
Pittsburg,Insurance Commissioner,Bill Viner,REP,610046,0,0,5,5,
Pittsburg,Insurance Commissioner,John Doak,REP,610046,0,1,11,12,
Pittsburg,Corporation Commissioner,Todd Hiett,REP,610046,0,0,6,6,
Pittsburg,Corporation Commissioner,Cliff Branan,REP,610046,0,0,12,12,
Pittsburg,U.S. Senate,Evelyn Rogers,REP,610046,0,0,1,1,
Pittsburg,U.S. Senate,Rob Moye,REP,610046,0,0,0,0,
Pittsburg,U.S. Senate,D. Jean Mcbride-Samuels,REP,610046,0,0,0,0,
Pittsburg,U.S. Senate,Jim Inhofe,REP,610046,1,1,17,19,
Pittsburg,U.S. Senate,Erick Paul Wyatt,REP,610046,0,0,0,0,
Pittsburg,U.S. Senate,Andy Craig,REP,610046,0,0,0,0,
Pittsburg,U.S. Senate,T. Shannon,REP,610046,1,0,8,9,
Pittsburg,U.S. Senate,Randy Brogdon,REP,610046,0,0,0,0,
Pittsburg,U.S. Senate,Eric Mccray,REP,610046,0,0,0,0,
Pittsburg,U.S. Senate,Kevin Crow,REP,610046,0,0,0,0,
Pittsburg,U.S. Senate,James Lankford,REP,610046,0,1,10,11,
Pittsburg,U.S. Senate,Jason Weger,REP,610046,0,0,1,1,
Pittsburg,U.S. House,Darrel Robertson,REP,610046,0,0,6,6,02
Pittsburg,U.S. House,Markwayne Mullin,REP,610046,1,1,13,15,02
Pittsburg,Superintendent of Public Instruction,John Cox,DEM,610047,0,3,67,70,
Pittsburg,Superintendent of Public Instruction,Jack Jr.,DEM,610047,0,0,8,8,
Pittsburg,Superintendent of Public Instruction,Ivan Holmes,DEM,610047,0,0,1,1,
Pittsburg,Superintendent of Public Instruction,Freda Deskin,DEM,610047,0,0,19,19,
Pittsburg,U.S. Senate,Patrick Michael Hayes,DEM,610047,0,1,28,29,
Pittsburg,U.S. Senate,Jim Rogers,DEM,610047,0,2,42,44,
Pittsburg,U.S. Senate,Connie Johnson,DEM,610047,0,0,20,20,
Pittsburg,U.S. House,Earl Everett,DEM,610047,0,2,50,52,02
Pittsburg,U.S. House,Joshua Harris-Till,DEM,610047,0,0,39,39,02
Pittsburg,Governor,Dax Ewbank,REP,610047,0,2,2,4,
Pittsburg,Governor,Chad Moody,REP,610047,0,0,5,5,
Pittsburg,Governor,Mary Fallin,REP,610047,0,0,10,10,
Pittsburg,Superintendent of Public Instruction,Brian Kelly,REP,610047,0,1,2,3,
Pittsburg,Superintendent of Public Instruction,Janet Costello Barresi,REP,610047,0,0,2,2,
Pittsburg,Superintendent of Public Instruction,Joy Hofmeister,REP,610047,0,1,13,14,
Pittsburg,Insurance Commissioner,Bill Viner,REP,610047,0,1,3,4,
Pittsburg,Insurance Commissioner,John Doak,REP,610047,0,1,13,14,
Pittsburg,Corporation Commissioner,Todd Hiett,REP,610047,0,0,9,9,
Pittsburg,Corporation Commissioner,Cliff Branan,REP,610047,0,2,7,9,
Pittsburg,U.S. Senate,Evelyn Rogers,REP,610047,0,0,1,1,
Pittsburg,U.S. Senate,Rob Moye,REP,610047,0,0,0,0,
Pittsburg,U.S. Senate,D. Jean Mcbride-Samuels,REP,610047,0,1,0,1,
Pittsburg,U.S. Senate,Jim Inhofe,REP,610047,0,1,15,16,
Pittsburg,U.S. Senate,Erick Paul Wyatt,REP,610047,0,0,1,1,
Pittsburg,U.S. Senate,Andy Craig,REP,610047,0,0,0,0,
Pittsburg,U.S. Senate,T. Shannon,REP,610047,0,0,7,7,
Pittsburg,U.S. Senate,Randy Brogdon,REP,610047,0,1,1,2,
Pittsburg,U.S. Senate,Eric Mccray,REP,610047,0,0,0,0,
Pittsburg,U.S. Senate,Kevin Crow,REP,610047,0,1,0,1,
Pittsburg,U.S. Senate,James Lankford,REP,610047,0,0,8,8,
Pittsburg,U.S. Senate,Jason Weger,REP,610047,0,0,0,0,
Pittsburg,U.S. House,Darrel Robertson,REP,610047,0,1,5,6,02
Pittsburg,U.S. House,Markwayne Mullin,REP,610047,0,1,12,13,02
Pittsburg,State House,Paul Marean,REP,610047,0,2,5,7,17
Pittsburg,State House,Micah Thompson,REP,610047,0,0,11,11,17
Pittsburg,Superintendent of Public Instruction,John Cox,DEM,610048,0,3,26,29,
Pittsburg,Superintendent of Public Instruction,Jack Jr.,DEM,610048,0,1,3,4,
Pittsburg,Superintendent of Public Instruction,Ivan Holmes,DEM,610048,0,0,0,0,
Pittsburg,Superintendent of Public Instruction,Freda Deskin,DEM,610048,0,0,11,11,
Pittsburg,U.S. Senate,Patrick Michael Hayes,DEM,610048,0,0,13,13,
Pittsburg,U.S. Senate,Jim Rogers,DEM,610048,0,3,17,20,
Pittsburg,U.S. Senate,Connie Johnson,DEM,610048,0,1,5,6,
Pittsburg,U.S. House,Earl Everett,DEM,610048,0,3,25,28,02
Pittsburg,U.S. House,Joshua Harris-Till,DEM,610048,0,1,11,12,02
Pittsburg,Governor,Dax Ewbank,REP,610048,0,0,0,0,
Pittsburg,Governor,Chad Moody,REP,610048,0,0,3,3,
Pittsburg,Governor,Mary Fallin,REP,610048,0,1,3,4,
Pittsburg,Superintendent of Public Instruction,Brian Kelly,REP,610048,0,1,1,2,
Pittsburg,Superintendent of Public Instruction,Janet Costello Barresi,REP,610048,0,0,1,1,
Pittsburg,Superintendent of Public Instruction,Joy Hofmeister,REP,610048,0,0,4,4,
Pittsburg,Insurance Commissioner,Bill Viner,REP,610048,0,0,3,3,
Pittsburg,Insurance Commissioner,John Doak,REP,610048,0,0,2,2,
Pittsburg,Corporation Commissioner,Todd Hiett,REP,610048,0,0,5,5,
Pittsburg,Corporation Commissioner,Cliff Branan,REP,610048,0,0,1,1,
Pittsburg,U.S. Senate,Evelyn Rogers,REP,610048,0,0,0,0,
Pittsburg,U.S. Senate,Rob Moye,REP,610048,0,0,0,0,
Pittsburg,U.S. Senate,D. Jean Mcbride-Samuels,REP,610048,0,0,0,0,
Pittsburg,U.S. Senate,Jim Inhofe,REP,610048,0,1,6,7,
Pittsburg,U.S. Senate,Erick Paul Wyatt,REP,610048,0,0,0,0,
Pittsburg,U.S. Senate,Andy Craig,REP,610048,0,0,0,0,
Pittsburg,U.S. Senate,T. Shannon,REP,610048,0,0,4,4,
Pittsburg,U.S. Senate,Randy Brogdon,REP,610048,0,0,1,1,
Pittsburg,U.S. Senate,Eric Mccray,REP,610048,0,0,0,0,
Pittsburg,U.S. Senate,Kevin Crow,REP,610048,0,0,0,0,
Pittsburg,U.S. Senate,James Lankford,REP,610048,0,1,1,2,
Pittsburg,U.S. Senate,Jason Weger,REP,610048,0,0,0,0,
Pittsburg,U.S. House,Darrel Robertson,REP,610048,0,0,1,1,02
Pittsburg,U.S. House,Markwayne Mullin,REP,610048,0,1,5,6,02
Pittsburg,Superintendent of Public Instruction,John Cox,DEM,610049,0,3,95,98,
Pittsburg,Superintendent of Public Instruction,Jack Jr.,DEM,610049,1,1,10,12,
Pittsburg,Superintendent of Public Instruction,Ivan Holmes,DEM,610049,0,0,9,9,
Pittsburg,Superintendent of Public Instruction,Freda Deskin,DEM,610049,0,0,40,40,
Pittsburg,U.S. Senate,Patrick Michael Hayes,DEM,610049,0,0,41,41,
Pittsburg,U.S. Senate,Jim Rogers,DEM,610049,1,3,74,78,
Pittsburg,U.S. Senate,Connie Johnson,DEM,610049,0,0,34,34,
Pittsburg,U.S. House,Earl Everett,DEM,610049,1,2,91,94,02
Pittsburg,U.S. House,Joshua Harris-Till,DEM,610049,0,0,54,54,02
Pittsburg,Governor,Dax Ewbank,REP,610049,0,0,1,1,
Pittsburg,Governor,Chad Moody,REP,610049,0,2,0,2,
Pittsburg,Governor,Mary Fallin,REP,610049,2,2,14,18,
Pittsburg,Superintendent of Public Instruction,Brian Kelly,REP,610049,0,2,4,6,
Pittsburg,Superintendent of Public Instruction,Janet Costello Barresi,REP,610049,0,0,3,3,
Pittsburg,Superintendent of Public Instruction,Joy Hofmeister,REP,610049,2,1,8,11,
Pittsburg,Insurance Commissioner,Bill Viner,REP,610049,0,2,2,4,
Pittsburg,Insurance Commissioner,John Doak,REP,610049,2,1,13,16,
Pittsburg,Corporation Commissioner,Todd Hiett,REP,610049,2,2,6,10,
Pittsburg,Corporation Commissioner,Cliff Branan,REP,610049,0,1,9,10,
Pittsburg,U.S. Senate,Evelyn Rogers,REP,610049,0,0,0,0,
Pittsburg,U.S. Senate,Rob Moye,REP,610049,0,0,0,0,
Pittsburg,U.S. Senate,D. Jean Mcbride-Samuels,REP,610049,0,0,0,0,
Pittsburg,U.S. Senate,Jim Inhofe,REP,610049,2,3,14,19,
Pittsburg,U.S. Senate,Erick Paul Wyatt,REP,610049,0,1,1,2,
Pittsburg,U.S. Senate,Andy Craig,REP,610049,0,0,0,0,
Pittsburg,U.S. Senate,T. Shannon,REP,610049,0,0,7,7,
Pittsburg,U.S. Senate,Randy Brogdon,REP,610049,1,0,0,1,
Pittsburg,U.S. Senate,Eric Mccray,REP,610049,0,0,0,0,
Pittsburg,U.S. Senate,Kevin Crow,REP,610049,0,0,0,0,
Pittsburg,U.S. Senate,James Lankford,REP,610049,1,3,7,11,
Pittsburg,U.S. Senate,Jason Weger,REP,610049,0,0,1,1,
Pittsburg,U.S. House,Darrel Robertson,REP,610049,2,1,0,3,02
Pittsburg,U.S. House,Markwayne Mullin,REP,610049,0,3,15,18,02
Pittsburg,Superintendent of Public Instruction,John Cox,DEM,610051,0,0,21,21,
Pittsburg,Superintendent of Public Instruction,Jack Jr.,DEM,610051,0,0,4,4,
Pittsburg,Superintendent of Public Instruction,Ivan Holmes,DEM,610051,0,0,3,3,
Pittsburg,Superintendent of Public Instruction,Freda Deskin,DEM,610051,0,0,9,9,
Pittsburg,U.S. Senate,Patrick Michael Hayes,DEM,610051,0,0,13,13,
Pittsburg,U.S. Senate,Jim Rogers,DEM,610051,0,0,16,16,
Pittsburg,U.S. Senate,Connie Johnson,DEM,610051,0,0,8,8,
Pittsburg,U.S. House,Earl Everett,DEM,610051,0,0,27,27,02
Pittsburg,U.S. House,Joshua Harris-Till,DEM,610051,0,0,10,10,02
Pittsburg,Governor,Dax Ewbank,REP,610051,0,0,1,1,
Pittsburg,Governor,Chad Moody,REP,610051,0,0,0,0,
Pittsburg,Governor,Mary Fallin,REP,610051,0,1,18,19,
Pittsburg,Superintendent of Public Instruction,Brian Kelly,REP,610051,0,0,6,6,
Pittsburg,Superintendent of Public Instruction,Janet Costello Barresi,REP,610051,0,0,4,4,
Pittsburg,Superintendent of Public Instruction,Joy Hofmeister,REP,610051,0,1,7,8,
Pittsburg,Insurance Commissioner,Bill Viner,REP,610051,0,0,7,7,
Pittsburg,Insurance Commissioner,John Doak,REP,610051,0,1,8,9,
Pittsburg,Corporation Commissioner,Todd Hiett,REP,610051,0,0,3,3,
Pittsburg,Corporation Commissioner,Cliff Branan,REP,610051,0,1,13,14,
Pittsburg,U.S. Senate,Evelyn Rogers,REP,610051,0,0,0,0,
Pittsburg,U.S. Senate,Rob Moye,REP,610051,0,0,0,0,
Pittsburg,U.S. Senate,D. Jean Mcbride-Samuels,REP,610051,0,0,0,0,
Pittsburg,U.S. Senate,Jim Inhofe,REP,610051,0,1,18,19,
Pittsburg,U.S. Senate,Erick Paul Wyatt,REP,610051,0,0,0,0,
Pittsburg,U.S. Senate,Andy Craig,REP,610051,0,0,0,0,
Pittsburg,U.S. Senate,T. Shannon,REP,610051,0,0,11,11,
Pittsburg,U.S. Senate,Randy Brogdon,REP,610051,0,0,0,0,
Pittsburg,U.S. Senate,Eric Mccray,REP,610051,0,0,0,0,
Pittsburg,U.S. Senate,Kevin Crow,REP,610051,0,0,0,0,
Pittsburg,U.S. Senate,James Lankford,REP,610051,0,1,8,9,
Pittsburg,U.S. Senate,Jason Weger,REP,610051,0,0,0,0,
Pittsburg,U.S. House,Darrel Robertson,REP,610051,0,0,3,3,02
Pittsburg,U.S. House,Markwayne Mullin,REP,610051,0,1,14,15,02
Pittsburg,State House,Paul Marean,REP,610051,0,1,8,9,17
Pittsburg,State House,Micah Thompson,REP,610051,0,0,7,7,17
Pittsburg,Superintendent of Public Instruction,John Cox,DEM,610052,0,0,0,0,
Pittsburg,Superintendent of Public Instruction,Jack Jr.,DEM,610052,0,0,0,0,
Pittsburg,Superintendent of Public Instruction,Ivan Holmes,DEM,610052,0,0,0,0,
Pittsburg,Superintendent of Public Instruction,Freda Deskin,DEM,610052,0,0,1,1,
Pittsburg,U.S. Senate,Patrick Michael Hayes,DEM,610052,0,0,1,1,
Pittsburg,U.S. Senate,Jim Rogers,DEM,610052,0,0,0,0,
Pittsburg,U.S. Senate,Connie Johnson,DEM,610052,0,0,0,0,
Pittsburg,U.S. House,Earl Everett,DEM,610052,0,0,1,1,02
Pittsburg,U.S. House,Joshua Harris-Till,DEM,610052,0,0,0,0,02
Pittsburg,Governor,Dax Ewbank,REP,610052,0,0,0,0,
Pittsburg,Governor,Chad Moody,REP,610052,0,0,0,0,
Pittsburg,Governor,Mary Fallin,REP,610052,0,0,0,0,
Pittsburg,Superintendent of Public Instruction,Brian Kelly,REP,610052,0,0,0,0,
Pittsburg,Superintendent of Public Instruction,Janet Costello Barresi,REP,610052,0,0,0,0,
Pittsburg,Superintendent of Public Instruction,Joy Hofmeister,REP,610052,0,0,0,0,
Pittsburg,Insurance Commissioner,Bill Viner,REP,610052,0,0,0,0,
Pittsburg,Insurance Commissioner,John Doak,REP,610052,0,0,0,0,
Pittsburg,Corporation Commissioner,Todd Hiett,REP,610052,0,0,0,0,
Pittsburg,Corporation Commissioner,Cliff Branan,REP,610052,0,0,0,0,
Pittsburg,U.S. Senate,Evelyn Rogers,REP,610052,0,0,0,0,
Pittsburg,U.S. Senate,Rob Moye,REP,610052,0,0,0,0,
Pittsburg,U.S. Senate,D. Jean Mcbride-Samuels,REP,610052,0,0,0,0,
Pittsburg,U.S. Senate,Jim Inhofe,REP,610052,0,0,0,0,
Pittsburg,U.S. Senate,Erick Paul Wyatt,REP,610052,0,0,0,0,
Pittsburg,U.S. Senate,Andy Craig,REP,610052,0,0,0,0,
Pittsburg,U.S. Senate,T. Shannon,REP,610052,0,0,0,0,
Pittsburg,U.S. Senate,Randy Brogdon,REP,610052,0,0,0,0,
Pittsburg,U.S. Senate,Eric Mccray,REP,610052,0,0,0,0,
Pittsburg,U.S. Senate,Kevin Crow,REP,610052,0,0,0,0,
Pittsburg,U.S. Senate,James Lankford,REP,610052,0,0,0,0,
Pittsburg,U.S. Senate,Jason Weger,REP,610052,0,0,0,0,
Pittsburg,U.S. House,Darrel Robertson,REP,610052,0,0,0,0,02
Pittsburg,U.S. House,Markwayne Mullin,REP,610052,0,0,0,0,02
Pittsburg,Superintendent of Public Instruction,John Cox,DEM,610053,0,0,7,7,
Pittsburg,Superintendent of Public Instruction,Jack Jr.,DEM,610053,0,0,2,2,
Pittsburg,Superintendent of Public Instruction,Ivan Holmes,DEM,610053,0,0,1,1,
Pittsburg,Superintendent of Public Instruction,Freda Deskin,DEM,610053,0,0,2,2,
Pittsburg,U.S. Senate,Patrick Michael Hayes,DEM,610053,0,0,5,5,
Pittsburg,U.S. Senate,Jim Rogers,DEM,610053,0,0,5,5,
Pittsburg,U.S. Senate,Connie Johnson,DEM,610053,0,0,2,2,
Pittsburg,U.S. House,Earl Everett,DEM,610053,0,0,7,7,02
Pittsburg,U.S. House,Joshua Harris-Till,DEM,610053,0,0,5,5,02
Pittsburg,Governor,Dax Ewbank,REP,610053,0,0,1,1,
Pittsburg,Governor,Chad Moody,REP,610053,0,0,0,0,
Pittsburg,Governor,Mary Fallin,REP,610053,0,0,1,1,
Pittsburg,Superintendent of Public Instruction,Brian Kelly,REP,610053,0,0,0,0,
Pittsburg,Superintendent of Public Instruction,Janet Costello Barresi,REP,610053,0,0,1,1,
Pittsburg,Superintendent of Public Instruction,Joy Hofmeister,REP,610053,0,0,1,1,
Pittsburg,Insurance Commissioner,Bill Viner,REP,610053,0,0,1,1,
Pittsburg,Insurance Commissioner,John Doak,REP,610053,0,0,1,1,
Pittsburg,Corporation Commissioner,Todd Hiett,REP,610053,0,0,1,1,
Pittsburg,Corporation Commissioner,Cliff Branan,REP,610053,0,0,1,1,
Pittsburg,U.S. Senate,Evelyn Rogers,REP,610053,0,0,1,1,
Pittsburg,U.S. Senate,Rob Moye,REP,610053,0,0,1,1,
Pittsburg,U.S. Senate,D. Jean Mcbride-Samuels,REP,610053,0,0,0,0,
Pittsburg,U.S. Senate,Jim Inhofe,REP,610053,0,0,0,0,
Pittsburg,U.S. Senate,Erick Paul Wyatt,REP,610053,0,0,0,0,
Pittsburg,U.S. Senate,Andy Craig,REP,610053,0,0,0,0,
Pittsburg,U.S. Senate,T. Shannon,REP,610053,0,0,1,1,
Pittsburg,U.S. Senate,Randy Brogdon,REP,610053,0,0,0,0,
Pittsburg,U.S. Senate,Eric Mccray,REP,610053,0,0,0,0,
Pittsburg,U.S. Senate,Kevin Crow,REP,610053,0,0,0,0,
Pittsburg,U.S. Senate,James Lankford,REP,610053,0,0,1,1,
Pittsburg,U.S. Senate,Jason Weger,REP,610053,0,0,0,0,
Pittsburg,U.S. House,Darrel Robertson,REP,610053,0,0,1,1,02
Pittsburg,U.S. House,Markwayne Mullin,REP,610053,0,0,1,1,02
Pontotoc,Superintendent of Public Instruction,John Cox,DEM,620013,1,4,58,63,
Pontotoc,Superintendent of Public Instruction,Jack Jr.,DEM,620013,0,4,39,43,
Pontotoc,Superintendent of Public Instruction,Ivan Holmes,DEM,620013,0,2,14,16,
Pontotoc,Superintendent of Public Instruction,Freda Deskin,DEM,620013,2,13,93,108,
Pontotoc,U.S. Senate,Patrick Michael Hayes,DEM,620013,0,5,35,40,
Pontotoc,U.S. Senate,Jim Rogers,DEM,620013,1,5,94,100,
Pontotoc,U.S. Senate,Connie Johnson,DEM,620013,2,11,66,79,
Pontotoc,U.S. House,Bert Smith,DEM,620013,3,20,171,194,04
Pontotoc,U.S. House,Tae Si,DEM,620013,0,1,24,25,04
Pontotoc,Governor,Dax Ewbank,REP,620013,1,1,18,20,
Pontotoc,Governor,Chad Moody,REP,620013,0,3,34,37,
Pontotoc,Governor,Mary Fallin,REP,620013,2,16,97,115,
Pontotoc,Superintendent of Public Instruction,Brian Kelly,REP,620013,0,2,24,26,
Pontotoc,Superintendent of Public Instruction,Janet Costello Barresi,REP,620013,0,3,23,26,
Pontotoc,Superintendent of Public Instruction,Joy Hofmeister,REP,620013,3,15,99,117,
Pontotoc,Insurance Commissioner,Bill Viner,REP,620013,0,4,31,35,
Pontotoc,Insurance Commissioner,John Doak,REP,620013,3,13,99,115,
Pontotoc,Corporation Commissioner,Todd Hiett,REP,620013,3,8,81,92,
Pontotoc,Corporation Commissioner,Cliff Branan,REP,620013,0,9,47,56,
Pontotoc,U.S. Senate,Evelyn Rogers,REP,620013,0,1,7,8,
Pontotoc,U.S. Senate,Rob Moye,REP,620013,0,0,3,3,
Pontotoc,U.S. Senate,D. Jean Mcbride-Samuels,REP,620013,0,0,3,3,
Pontotoc,U.S. Senate,Jim Inhofe,REP,620013,3,19,125,147,
Pontotoc,U.S. Senate,Erick Paul Wyatt,REP,620013,0,1,5,6,
Pontotoc,U.S. Senate,Andy Craig,REP,620013,0,1,3,4,
Pontotoc,U.S. Senate,T. Shannon,REP,620013,2,10,56,68,
Pontotoc,U.S. Senate,Randy Brogdon,REP,620013,0,0,3,3,
Pontotoc,U.S. Senate,Eric Mccray,REP,620013,0,0,5,5,
Pontotoc,U.S. Senate,Kevin Crow,REP,620013,0,0,3,3,
Pontotoc,U.S. Senate,James Lankford,REP,620013,1,9,74,84,
Pontotoc,U.S. Senate,Jason Weger,REP,620013,0,1,1,2,
Pontotoc,U.S. House,Anna Flatt,REP,620013,0,1,16,17,04
Pontotoc,U.S. House,Tom Cole,REP,620013,3,20,128,151,04
Pontotoc,Superintendent of Public Instruction,John Cox,DEM,620016,5,15,79,99,
Pontotoc,Superintendent of Public Instruction,Jack Jr.,DEM,620016,3,5,31,39,
Pontotoc,Superintendent of Public Instruction,Ivan Holmes,DEM,620016,0,1,12,13,
Pontotoc,Superintendent of Public Instruction,Freda Deskin,DEM,620016,0,12,96,108,
Pontotoc,U.S. Senate,Patrick Michael Hayes,DEM,620016,3,6,53,62,
Pontotoc,U.S. Senate,Jim Rogers,DEM,620016,2,17,90,109,
Pontotoc,U.S. Senate,Connie Johnson,DEM,620016,3,8,66,77,
Pontotoc,U.S. House,Bert Smith,DEM,620016,6,27,179,212,04
Pontotoc,U.S. House,Tae Si,DEM,620016,3,1,28,32,04
Pontotoc,Governor,Dax Ewbank,REP,620016,1,1,14,16,
Pontotoc,Governor,Chad Moody,REP,620016,1,10,49,60,
Pontotoc,Governor,Mary Fallin,REP,620016,8,13,139,160,
Pontotoc,Superintendent of Public Instruction,Brian Kelly,REP,620016,1,3,31,35,
Pontotoc,Superintendent of Public Instruction,Janet Costello Barresi,REP,620016,2,3,23,28,
Pontotoc,Superintendent of Public Instruction,Joy Hofmeister,REP,620016,7,20,149,176,
Pontotoc,Insurance Commissioner,Bill Viner,REP,620016,3,7,41,51,
Pontotoc,Insurance Commissioner,John Doak,REP,620016,5,17,139,161,
Pontotoc,Corporation Commissioner,Todd Hiett,REP,620016,5,11,111,127,
Pontotoc,Corporation Commissioner,Cliff Branan,REP,620016,3,12,74,89,
Pontotoc,U.S. Senate,Evelyn Rogers,REP,620016,1,4,10,15,
Pontotoc,U.S. Senate,Rob Moye,REP,620016,1,0,2,3,
Pontotoc,U.S. Senate,D. Jean Mcbride-Samuels,REP,620016,0,0,7,7,
Pontotoc,U.S. Senate,Jim Inhofe,REP,620016,8,20,174,202,
Pontotoc,U.S. Senate,Erick Paul Wyatt,REP,620016,0,1,9,10,
Pontotoc,U.S. Senate,Andy Craig,REP,620016,0,3,2,5,
Pontotoc,U.S. Senate,T. Shannon,REP,620016,1,14,89,104,
Pontotoc,U.S. Senate,Randy Brogdon,REP,620016,0,0,5,5,
Pontotoc,U.S. Senate,Eric Mccray,REP,620016,0,0,2,2,
Pontotoc,U.S. Senate,Kevin Crow,REP,620016,1,0,0,1,
Pontotoc,U.S. Senate,James Lankford,REP,620016,7,8,103,118,
Pontotoc,U.S. Senate,Jason Weger,REP,620016,0,0,1,1,
Pontotoc,U.S. House,Anna Flatt,REP,620016,2,5,16,23,04
Pontotoc,U.S. House,Tom Cole,REP,620016,8,21,189,218,04
Pontotoc,Superintendent of Public Instruction,John Cox,DEM,620022,1,5,37,43,
Pontotoc,Superintendent of Public Instruction,Jack Jr.,DEM,620022,1,0,17,18,
Pontotoc,Superintendent of Public Instruction,Ivan Holmes,DEM,620022,2,1,5,8,
Pontotoc,Superintendent of Public Instruction,Freda Deskin,DEM,620022,4,5,80,89,
Pontotoc,U.S. Senate,Patrick Michael Hayes,DEM,620022,0,0,27,27,
Pontotoc,U.S. Senate,Jim Rogers,DEM,620022,2,6,51,59,
Pontotoc,U.S. Senate,Connie Johnson,DEM,620022,6,4,54,64,
Pontotoc,U.S. House,Bert Smith,DEM,620022,6,9,109,124,04
Pontotoc,U.S. House,Tae Si,DEM,620022,2,1,21,24,04
Pontotoc,Governor,Dax Ewbank,REP,620022,4,2,16,22,
Pontotoc,Governor,Chad Moody,REP,620022,1,5,19,25,
Pontotoc,Governor,Mary Fallin,REP,620022,3,12,80,95,
Pontotoc,Superintendent of Public Instruction,Brian Kelly,REP,620022,2,3,19,24,
Pontotoc,Superintendent of Public Instruction,Janet Costello Barresi,REP,620022,0,5,18,23,
Pontotoc,Superintendent of Public Instruction,Joy Hofmeister,REP,620022,7,11,79,97,
Pontotoc,Insurance Commissioner,Bill Viner,REP,620022,1,4,24,29,
Pontotoc,Insurance Commissioner,John Doak,REP,620022,7,14,80,101,
Pontotoc,Corporation Commissioner,Todd Hiett,REP,620022,1,8,63,72,
Pontotoc,Corporation Commissioner,Cliff Branan,REP,620022,5,10,41,56,
Pontotoc,U.S. Senate,Evelyn Rogers,REP,620022,1,1,4,6,
Pontotoc,U.S. Senate,Rob Moye,REP,620022,0,0,3,3,
Pontotoc,U.S. Senate,D. Jean Mcbride-Samuels,REP,620022,1,1,4,6,
Pontotoc,U.S. Senate,Jim Inhofe,REP,620022,6,15,93,114,
Pontotoc,U.S. Senate,Erick Paul Wyatt,REP,620022,1,1,8,10,
Pontotoc,U.S. Senate,Andy Craig,REP,620022,0,0,3,3,
Pontotoc,U.S. Senate,T. Shannon,REP,620022,1,5,46,52,
Pontotoc,U.S. Senate,Randy Brogdon,REP,620022,1,1,2,4,
Pontotoc,U.S. Senate,Eric Mccray,REP,620022,0,1,1,2,
Pontotoc,U.S. Senate,Kevin Crow,REP,620022,2,1,5,8,
Pontotoc,U.S. Senate,James Lankford,REP,620022,4,10,58,72,
Pontotoc,U.S. Senate,Jason Weger,REP,620022,1,1,0,2,
Pontotoc,U.S. House,Anna Flatt,REP,620022,2,2,18,22,04
Pontotoc,U.S. House,Tom Cole,REP,620022,7,16,96,119,04
Pontotoc,Superintendent of Public Instruction,John Cox,DEM,620025,0,10,66,76,
Pontotoc,Superintendent of Public Instruction,Jack Jr.,DEM,620025,0,3,29,32,
Pontotoc,Superintendent of Public Instruction,Ivan Holmes,DEM,620025,0,5,6,11,
Pontotoc,Superintendent of Public Instruction,Freda Deskin,DEM,620025,2,16,126,144,
Pontotoc,U.S. Senate,Patrick Michael Hayes,DEM,620025,0,4,69,73,
Pontotoc,U.S. Senate,Jim Rogers,DEM,620025,0,25,90,115,
Pontotoc,U.S. Senate,Connie Johnson,DEM,620025,2,2,62,66,
Pontotoc,U.S. House,Bert Smith,DEM,620025,1,26,196,223,04
Pontotoc,U.S. House,Tae Si,DEM,620025,1,4,22,27,04
Pontotoc,Governor,Dax Ewbank,REP,620025,1,2,29,32,
Pontotoc,Governor,Chad Moody,REP,620025,2,6,29,37,
Pontotoc,Governor,Mary Fallin,REP,620025,1,6,116,123,
Pontotoc,Superintendent of Public Instruction,Brian Kelly,REP,620025,0,3,37,40,
Pontotoc,Superintendent of Public Instruction,Janet Costello Barresi,REP,620025,1,1,21,23,
Pontotoc,Superintendent of Public Instruction,Joy Hofmeister,REP,620025,3,10,117,130,
Pontotoc,Insurance Commissioner,Bill Viner,REP,620025,0,4,39,43,
Pontotoc,Insurance Commissioner,John Doak,REP,620025,4,10,124,138,
Pontotoc,Corporation Commissioner,Todd Hiett,REP,620025,2,6,99,107,
Pontotoc,Corporation Commissioner,Cliff Branan,REP,620025,2,8,65,75,
Pontotoc,U.S. Senate,Evelyn Rogers,REP,620025,0,0,11,11,
Pontotoc,U.S. Senate,Rob Moye,REP,620025,0,1,3,4,
Pontotoc,U.S. Senate,D. Jean Mcbride-Samuels,REP,620025,1,0,1,2,
Pontotoc,U.S. Senate,Jim Inhofe,REP,620025,1,13,151,165,
Pontotoc,U.S. Senate,Erick Paul Wyatt,REP,620025,2,0,9,11,
Pontotoc,U.S. Senate,Andy Craig,REP,620025,0,0,2,2,
Pontotoc,U.S. Senate,T. Shannon,REP,620025,1,6,62,69,
Pontotoc,U.S. Senate,Randy Brogdon,REP,620025,0,1,7,8,
Pontotoc,U.S. Senate,Eric Mccray,REP,620025,0,1,5,6,
Pontotoc,U.S. Senate,Kevin Crow,REP,620025,0,0,1,1,
Pontotoc,U.S. Senate,James Lankford,REP,620025,3,5,94,102,
Pontotoc,U.S. Senate,Jason Weger,REP,620025,0,1,3,4,
Pontotoc,U.S. House,Anna Flatt,REP,620025,2,1,23,26,04
Pontotoc,U.S. House,Tom Cole,REP,620025,2,13,151,166,04
Pontotoc,Superintendent of Public Instruction,John Cox,DEM,620031,2,9,62,73,
Pontotoc,Superintendent of Public Instruction,Jack Jr.,DEM,620031,0,0,26,26,
Pontotoc,Superintendent of Public Instruction,Ivan Holmes,DEM,620031,0,2,11,13,
Pontotoc,Superintendent of Public Instruction,Freda Deskin,DEM,620031,6,6,83,95,
Pontotoc,U.S. Senate,Patrick Michael Hayes,DEM,620031,1,3,44,48,
Pontotoc,U.S. Senate,Jim Rogers,DEM,620031,1,8,68,77,
Pontotoc,U.S. Senate,Connie Johnson,DEM,620031,6,5,64,75,
Pontotoc,U.S. House,Bert Smith,DEM,620031,7,15,137,159,04
Pontotoc,U.S. House,Tae Si,DEM,620031,1,2,35,38,04
Pontotoc,Governor,Dax Ewbank,REP,620031,0,0,17,17,
Pontotoc,Governor,Chad Moody,REP,620031,0,1,20,21,
Pontotoc,Governor,Mary Fallin,REP,620031,3,4,53,60,
Pontotoc,Superintendent of Public Instruction,Brian Kelly,REP,620031,2,1,23,26,
Pontotoc,Superintendent of Public Instruction,Janet Costello Barresi,REP,620031,0,1,12,13,
Pontotoc,Superintendent of Public Instruction,Joy Hofmeister,REP,620031,1,3,55,59,
Pontotoc,Insurance Commissioner,Bill Viner,REP,620031,2,3,19,24,
Pontotoc,Insurance Commissioner,John Doak,REP,620031,1,2,63,66,
Pontotoc,Corporation Commissioner,Todd Hiett,REP,620031,2,4,42,48,
Pontotoc,Corporation Commissioner,Cliff Branan,REP,620031,1,1,41,43,
Pontotoc,U.S. Senate,Evelyn Rogers,REP,620031,0,2,8,10,
Pontotoc,U.S. Senate,Rob Moye,REP,620031,1,0,5,6,
Pontotoc,U.S. Senate,D. Jean Mcbride-Samuels,REP,620031,0,0,0,0,
Pontotoc,U.S. Senate,Jim Inhofe,REP,620031,2,3,69,74,
Pontotoc,U.S. Senate,Erick Paul Wyatt,REP,620031,0,0,6,6,
Pontotoc,U.S. Senate,Andy Craig,REP,620031,0,1,1,2,
Pontotoc,U.S. Senate,T. Shannon,REP,620031,0,1,31,32,
Pontotoc,U.S. Senate,Randy Brogdon,REP,620031,0,1,3,4,
Pontotoc,U.S. Senate,Eric Mccray,REP,620031,0,1,2,3,
Pontotoc,U.S. Senate,Kevin Crow,REP,620031,0,0,4,4,
Pontotoc,U.S. Senate,James Lankford,REP,620031,3,1,49,53,
Pontotoc,U.S. Senate,Jason Weger,REP,620031,0,0,0,0,
Pontotoc,U.S. House,Anna Flatt,REP,620031,2,4,19,25,04
Pontotoc,U.S. House,Tom Cole,REP,620031,1,1,71,73,04
Pontotoc,Superintendent of Public Instruction,John Cox,DEM,620051,4,1,31,36,
Pontotoc,Superintendent of Public Instruction,Jack Jr.,DEM,620051,2,1,12,15,
Pontotoc,Superintendent of Public Instruction,Ivan Holmes,DEM,620051,0,0,4,4,
Pontotoc,Superintendent of Public Instruction,Freda Deskin,DEM,620051,2,1,39,42,
Pontotoc,U.S. Senate,Patrick Michael Hayes,DEM,620051,5,1,19,25,
Pontotoc,U.S. Senate,Jim Rogers,DEM,620051,2,1,41,44,
Pontotoc,U.S. Senate,Connie Johnson,DEM,620051,1,1,25,27,
Pontotoc,U.S. House,Bert Smith,DEM,620051,7,2,71,80,04
Pontotoc,U.S. House,Tae Si,DEM,620051,0,1,4,5,04
Pontotoc,Governor,Dax Ewbank,REP,620051,0,0,2,2,
Pontotoc,Governor,Chad Moody,REP,620051,0,0,8,8,
Pontotoc,Governor,Mary Fallin,REP,620051,0,0,31,31,
Pontotoc,Superintendent of Public Instruction,Brian Kelly,REP,620051,0,0,8,8,
Pontotoc,Superintendent of Public Instruction,Janet Costello Barresi,REP,620051,0,0,5,5,
Pontotoc,Superintendent of Public Instruction,Joy Hofmeister,REP,620051,0,0,26,26,
Pontotoc,Insurance Commissioner,Bill Viner,REP,620051,0,0,10,10,
Pontotoc,Insurance Commissioner,John Doak,REP,620051,0,0,25,25,
Pontotoc,Corporation Commissioner,Todd Hiett,REP,620051,0,0,17,17,
Pontotoc,Corporation Commissioner,Cliff Branan,REP,620051,0,0,20,20,
Pontotoc,U.S. Senate,Evelyn Rogers,REP,620051,0,0,2,2,
Pontotoc,U.S. Senate,Rob Moye,REP,620051,0,0,0,0,
Pontotoc,U.S. Senate,D. Jean Mcbride-Samuels,REP,620051,0,0,0,0,
Pontotoc,U.S. Senate,Jim Inhofe,REP,620051,0,0,33,33,
Pontotoc,U.S. Senate,Erick Paul Wyatt,REP,620051,0,0,3,3,
Pontotoc,U.S. Senate,Andy Craig,REP,620051,0,0,1,1,
Pontotoc,U.S. Senate,T. Shannon,REP,620051,0,0,21,21,
Pontotoc,U.S. Senate,Randy Brogdon,REP,620051,0,0,0,0,
Pontotoc,U.S. Senate,Eric Mccray,REP,620051,0,0,0,0,
Pontotoc,U.S. Senate,Kevin Crow,REP,620051,0,0,0,0,
Pontotoc,U.S. Senate,James Lankford,REP,620051,0,0,17,17,
Pontotoc,U.S. Senate,Jason Weger,REP,620051,0,0,2,2,
Pontotoc,U.S. House,Anna Flatt,REP,620051,0,0,5,5,04
Pontotoc,U.S. House,Tom Cole,REP,620051,0,0,32,32,04
Pontotoc,Superintendent of Public Instruction,John Cox,DEM,620052,0,4,28,32,
Pontotoc,Superintendent of Public Instruction,Jack Jr.,DEM,620052,0,2,12,14,
Pontotoc,Superintendent of Public Instruction,Ivan Holmes,DEM,620052,0,2,6,8,
Pontotoc,Superintendent of Public Instruction,Freda Deskin,DEM,620052,2,5,49,56,
Pontotoc,U.S. Senate,Patrick Michael Hayes,DEM,620052,0,3,21,24,
Pontotoc,U.S. Senate,Jim Rogers,DEM,620052,2,7,35,44,
Pontotoc,U.S. Senate,Connie Johnson,DEM,620052,0,3,32,35,
Pontotoc,U.S. House,Bert Smith,DEM,620052,2,11,77,90,04
Pontotoc,U.S. House,Tae Si,DEM,620052,0,2,10,12,04
Pontotoc,Governor,Dax Ewbank,REP,620052,0,1,8,9,
Pontotoc,Governor,Chad Moody,REP,620052,0,3,11,14,
Pontotoc,Governor,Mary Fallin,REP,620052,4,5,34,43,
Pontotoc,Superintendent of Public Instruction,Brian Kelly,REP,620052,0,1,15,16,
Pontotoc,Superintendent of Public Instruction,Janet Costello Barresi,REP,620052,4,0,3,7,
Pontotoc,Superintendent of Public Instruction,Joy Hofmeister,REP,620052,0,9,36,45,
Pontotoc,Insurance Commissioner,Bill Viner,REP,620052,1,2,15,18,
Pontotoc,Insurance Commissioner,John Doak,REP,620052,3,6,34,43,
Pontotoc,Corporation Commissioner,Todd Hiett,REP,620052,3,4,27,34,
Pontotoc,Corporation Commissioner,Cliff Branan,REP,620052,1,4,22,27,
Pontotoc,U.S. Senate,Evelyn Rogers,REP,620052,0,0,5,5,
Pontotoc,U.S. Senate,Rob Moye,REP,620052,0,0,2,2,
Pontotoc,U.S. Senate,D. Jean Mcbride-Samuels,REP,620052,0,0,0,0,
Pontotoc,U.S. Senate,Jim Inhofe,REP,620052,4,9,42,55,
Pontotoc,U.S. Senate,Erick Paul Wyatt,REP,620052,0,0,3,3,
Pontotoc,U.S. Senate,Andy Craig,REP,620052,0,1,0,1,
Pontotoc,U.S. Senate,T. Shannon,REP,620052,2,5,22,29,
Pontotoc,U.S. Senate,Randy Brogdon,REP,620052,0,0,3,3,
Pontotoc,U.S. Senate,Eric Mccray,REP,620052,0,0,1,1,
Pontotoc,U.S. Senate,Kevin Crow,REP,620052,0,0,3,3,
Pontotoc,U.S. Senate,James Lankford,REP,620052,2,3,20,25,
Pontotoc,U.S. Senate,Jason Weger,REP,620052,0,0,3,3,
Pontotoc,U.S. House,Anna Flatt,REP,620052,0,0,10,10,04
Pontotoc,U.S. House,Tom Cole,REP,620052,4,9,44,57,04
Pontotoc,Superintendent of Public Instruction,John Cox,DEM,620053,1,12,68,81,
Pontotoc,Superintendent of Public Instruction,Jack Jr.,DEM,620053,1,3,26,30,
Pontotoc,Superintendent of Public Instruction,Ivan Holmes,DEM,620053,1,0,11,12,
Pontotoc,Superintendent of Public Instruction,Freda Deskin,DEM,620053,1,10,125,136,
Pontotoc,U.S. Senate,Patrick Michael Hayes,DEM,620053,2,9,49,60,
Pontotoc,U.S. Senate,Jim Rogers,DEM,620053,3,9,80,92,
Pontotoc,U.S. Senate,Connie Johnson,DEM,620053,1,4,86,91,
Pontotoc,U.S. House,Bert Smith,DEM,620053,4,20,174,198,04
Pontotoc,U.S. House,Tae Si,DEM,620053,0,3,41,44,04
Pontotoc,Governor,Dax Ewbank,REP,620053,4,2,24,30,
Pontotoc,Governor,Chad Moody,REP,620053,2,13,49,64,
Pontotoc,Governor,Mary Fallin,REP,620053,3,21,156,180,
Pontotoc,Superintendent of Public Instruction,Brian Kelly,REP,620053,0,2,27,29,
Pontotoc,Superintendent of Public Instruction,Janet Costello Barresi,REP,620053,0,7,34,41,
Pontotoc,Superintendent of Public Instruction,Joy Hofmeister,REP,620053,9,28,168,205,
Pontotoc,Insurance Commissioner,Bill Viner,REP,620053,1,9,60,70,
Pontotoc,Insurance Commissioner,John Doak,REP,620053,8,25,154,187,
Pontotoc,Corporation Commissioner,Todd Hiett,REP,620053,7,18,120,145,
Pontotoc,Corporation Commissioner,Cliff Branan,REP,620053,2,15,91,108,
Pontotoc,U.S. Senate,Evelyn Rogers,REP,620053,0,4,10,14,
Pontotoc,U.S. Senate,Rob Moye,REP,620053,3,0,8,11,
Pontotoc,U.S. Senate,D. Jean Mcbride-Samuels,REP,620053,0,0,2,2,
Pontotoc,U.S. Senate,Jim Inhofe,REP,620053,6,32,200,238,
Pontotoc,U.S. Senate,Erick Paul Wyatt,REP,620053,0,1,6,7,
Pontotoc,U.S. Senate,Andy Craig,REP,620053,0,1,3,4,
Pontotoc,U.S. Senate,T. Shannon,REP,620053,2,14,109,125,
Pontotoc,U.S. Senate,Randy Brogdon,REP,620053,1,3,6,10,
Pontotoc,U.S. Senate,Eric Mccray,REP,620053,1,1,3,5,
Pontotoc,U.S. Senate,Kevin Crow,REP,620053,0,2,2,4,
Pontotoc,U.S. Senate,James Lankford,REP,620053,5,16,106,127,
Pontotoc,U.S. Senate,Jason Weger,REP,620053,0,0,1,1,
Pontotoc,U.S. House,Anna Flatt,REP,620053,3,8,20,31,04
Pontotoc,U.S. House,Tom Cole,REP,620053,6,29,210,245,04
Pontotoc,Superintendent of Public Instruction,John Cox,DEM,620054,0,1,9,10,
Pontotoc,Superintendent of Public Instruction,Jack Jr.,DEM,620054,0,0,3,3,
Pontotoc,Superintendent of Public Instruction,Ivan Holmes,DEM,620054,0,0,2,2,
Pontotoc,Superintendent of Public Instruction,Freda Deskin,DEM,620054,0,0,9,9,
Pontotoc,U.S. Senate,Patrick Michael Hayes,DEM,620054,0,0,4,4,
Pontotoc,U.S. Senate,Jim Rogers,DEM,620054,0,0,14,14,
Pontotoc,U.S. Senate,Connie Johnson,DEM,620054,0,1,4,5,
Pontotoc,U.S. House,Bert Smith,DEM,620054,0,1,20,21,04
Pontotoc,U.S. House,Tae Si,DEM,620054,0,0,2,2,04
Pontotoc,Governor,Dax Ewbank,REP,620054,0,0,2,2,
Pontotoc,Governor,Chad Moody,REP,620054,0,0,2,2,
Pontotoc,Governor,Mary Fallin,REP,620054,0,0,14,14,
Pontotoc,Superintendent of Public Instruction,Brian Kelly,REP,620054,0,0,4,4,
Pontotoc,Superintendent of Public Instruction,Janet Costello Barresi,REP,620054,0,0,3,3,
Pontotoc,Superintendent of Public Instruction,Joy Hofmeister,REP,620054,0,0,10,10,
Pontotoc,Insurance Commissioner,Bill Viner,REP,620054,0,0,1,1,
Pontotoc,Insurance Commissioner,John Doak,REP,620054,0,0,15,15,
Pontotoc,Corporation Commissioner,Todd Hiett,REP,620054,0,0,10,10,
Pontotoc,Corporation Commissioner,Cliff Branan,REP,620054,0,0,5,5,
Pontotoc,U.S. Senate,Evelyn Rogers,REP,620054,0,0,0,0,
Pontotoc,U.S. Senate,Rob Moye,REP,620054,0,0,0,0,
Pontotoc,U.S. Senate,D. Jean Mcbride-Samuels,REP,620054,0,0,0,0,
Pontotoc,U.S. Senate,Jim Inhofe,REP,620054,0,0,18,18,
Pontotoc,U.S. Senate,Erick Paul Wyatt,REP,620054,0,0,0,0,
Pontotoc,U.S. Senate,Andy Craig,REP,620054,0,0,0,0,
Pontotoc,U.S. Senate,T. Shannon,REP,620054,0,0,10,10,
Pontotoc,U.S. Senate,Randy Brogdon,REP,620054,0,0,1,1,
Pontotoc,U.S. Senate,Eric Mccray,REP,620054,0,0,0,0,
Pontotoc,U.S. Senate,Kevin Crow,REP,620054,0,0,0,0,
Pontotoc,U.S. Senate,James Lankford,REP,620054,0,0,6,6,
Pontotoc,U.S. Senate,Jason Weger,REP,620054,0,0,1,1,
Pontotoc,U.S. House,Anna Flatt,REP,620054,0,0,3,3,04
Pontotoc,U.S. House,Tom Cole,REP,620054,0,0,15,15,04
Pontotoc,Superintendent of Public Instruction,John Cox,DEM,620055,2,5,20,27,
Pontotoc,Superintendent of Public Instruction,Jack Jr.,DEM,620055,0,0,9,9,
Pontotoc,Superintendent of Public Instruction,Ivan Holmes,DEM,620055,0,0,0,0,
Pontotoc,Superintendent of Public Instruction,Freda Deskin,DEM,620055,0,1,18,19,
Pontotoc,U.S. Senate,Patrick Michael Hayes,DEM,620055,0,2,10,12,
Pontotoc,U.S. Senate,Jim Rogers,DEM,620055,2,3,22,27,
Pontotoc,U.S. Senate,Connie Johnson,DEM,620055,0,0,13,13,
Pontotoc,U.S. House,Bert Smith,DEM,620055,2,5,39,46,04
Pontotoc,U.S. House,Tae Si,DEM,620055,0,0,5,5,04
Pontotoc,Governor,Dax Ewbank,REP,620055,0,0,1,1,
Pontotoc,Governor,Chad Moody,REP,620055,0,1,4,5,
Pontotoc,Governor,Mary Fallin,REP,620055,1,2,10,13,
Pontotoc,Superintendent of Public Instruction,Brian Kelly,REP,620055,0,0,0,0,
Pontotoc,Superintendent of Public Instruction,Janet Costello Barresi,REP,620055,0,0,0,0,
Pontotoc,Superintendent of Public Instruction,Joy Hofmeister,REP,620055,1,3,16,20,
Pontotoc,Insurance Commissioner,Bill Viner,REP,620055,0,0,2,2,
Pontotoc,Insurance Commissioner,John Doak,REP,620055,1,3,11,15,
Pontotoc,Corporation Commissioner,Todd Hiett,REP,620055,1,3,9,13,
Pontotoc,Corporation Commissioner,Cliff Branan,REP,620055,0,0,6,6,
Pontotoc,U.S. Senate,Evelyn Rogers,REP,620055,0,0,2,2,
Pontotoc,U.S. Senate,Rob Moye,REP,620055,0,0,0,0,
Pontotoc,U.S. Senate,D. Jean Mcbride-Samuels,REP,620055,0,0,0,0,
Pontotoc,U.S. Senate,Jim Inhofe,REP,620055,1,3,12,16,
Pontotoc,U.S. Senate,Erick Paul Wyatt,REP,620055,0,0,1,1,
Pontotoc,U.S. Senate,Andy Craig,REP,620055,0,0,0,0,
Pontotoc,U.S. Senate,T. Shannon,REP,620055,1,0,9,10,
Pontotoc,U.S. Senate,Randy Brogdon,REP,620055,0,0,0,0,
Pontotoc,U.S. Senate,Eric Mccray,REP,620055,0,0,0,0,
Pontotoc,U.S. Senate,Kevin Crow,REP,620055,0,0,0,0,
Pontotoc,U.S. Senate,James Lankford,REP,620055,0,3,6,9,
Pontotoc,U.S. Senate,Jason Weger,REP,620055,0,0,1,1,
Pontotoc,U.S. House,Anna Flatt,REP,620055,0,0,0,0,04
Pontotoc,U.S. House,Tom Cole,REP,620055,1,3,15,19,04
Pontotoc,Superintendent of Public Instruction,John Cox,DEM,620056,0,2,29,31,
Pontotoc,Superintendent of Public Instruction,Jack Jr.,DEM,620056,0,0,4,4,
Pontotoc,Superintendent of Public Instruction,Ivan Holmes,DEM,620056,0,0,4,4,
Pontotoc,Superintendent of Public Instruction,Freda Deskin,DEM,620056,1,0,29,30,
Pontotoc,U.S. Senate,Patrick Michael Hayes,DEM,620056,0,0,15,15,
Pontotoc,U.S. Senate,Jim Rogers,DEM,620056,0,2,35,37,
Pontotoc,U.S. Senate,Connie Johnson,DEM,620056,1,1,15,17,
Pontotoc,U.S. House,Bert Smith,DEM,620056,1,2,57,60,04
Pontotoc,U.S. House,Tae Si,DEM,620056,0,0,5,5,04
Pontotoc,Governor,Dax Ewbank,REP,620056,0,0,2,2,
Pontotoc,Governor,Chad Moody,REP,620056,0,0,4,4,
Pontotoc,Governor,Mary Fallin,REP,620056,0,0,24,24,
Pontotoc,Superintendent of Public Instruction,Brian Kelly,REP,620056,0,0,3,3,
Pontotoc,Superintendent of Public Instruction,Janet Costello Barresi,REP,620056,0,0,5,5,
Pontotoc,Superintendent of Public Instruction,Joy Hofmeister,REP,620056,0,0,21,21,
Pontotoc,Insurance Commissioner,Bill Viner,REP,620056,0,0,8,8,
Pontotoc,Insurance Commissioner,John Doak,REP,620056,0,0,20,20,
Pontotoc,Corporation Commissioner,Todd Hiett,REP,620056,0,0,11,11,
Pontotoc,Corporation Commissioner,Cliff Branan,REP,620056,0,0,16,16,
Pontotoc,U.S. Senate,Evelyn Rogers,REP,620056,0,0,1,1,
Pontotoc,U.S. Senate,Rob Moye,REP,620056,0,0,0,0,
Pontotoc,U.S. Senate,D. Jean Mcbride-Samuels,REP,620056,0,0,1,1,
Pontotoc,U.S. Senate,Jim Inhofe,REP,620056,0,0,25,25,
Pontotoc,U.S. Senate,Erick Paul Wyatt,REP,620056,0,0,3,3,
Pontotoc,U.S. Senate,Andy Craig,REP,620056,0,0,0,0,
Pontotoc,U.S. Senate,T. Shannon,REP,620056,0,0,17,17,
Pontotoc,U.S. Senate,Randy Brogdon,REP,620056,0,0,0,0,
Pontotoc,U.S. Senate,Eric Mccray,REP,620056,0,0,0,0,
Pontotoc,U.S. Senate,Kevin Crow,REP,620056,0,0,1,1,
Pontotoc,U.S. Senate,James Lankford,REP,620056,0,0,12,12,
Pontotoc,U.S. Senate,Jason Weger,REP,620056,0,0,0,0,
Pontotoc,U.S. House,Anna Flatt,REP,620056,0,0,1,1,04
Pontotoc,U.S. House,Tom Cole,REP,620056,0,0,29,29,04
Pontotoc,Superintendent of Public Instruction,John Cox,DEM,620058,3,4,61,68,
Pontotoc,Superintendent of Public Instruction,Jack Jr.,DEM,620058,0,5,29,34,
Pontotoc,Superintendent of Public Instruction,Ivan Holmes,DEM,620058,1,1,7,9,
Pontotoc,Superintendent of Public Instruction,Freda Deskin,DEM,620058,2,4,72,78,
Pontotoc,U.S. Senate,Patrick Michael Hayes,DEM,620058,2,5,33,40,
Pontotoc,U.S. Senate,Jim Rogers,DEM,620058,1,5,77,83,
Pontotoc,U.S. Senate,Connie Johnson,DEM,620058,3,3,46,52,
Pontotoc,U.S. House,Bert Smith,DEM,620058,6,13,137,156,04
Pontotoc,U.S. House,Tae Si,DEM,620058,0,0,23,23,04
Pontotoc,Governor,Dax Ewbank,REP,620058,0,0,10,10,
Pontotoc,Governor,Chad Moody,REP,620058,1,1,19,21,
Pontotoc,Governor,Mary Fallin,REP,620058,1,5,63,69,
Pontotoc,Superintendent of Public Instruction,Brian Kelly,REP,620058,1,0,13,14,
Pontotoc,Superintendent of Public Instruction,Janet Costello Barresi,REP,620058,1,1,11,13,
Pontotoc,Superintendent of Public Instruction,Joy Hofmeister,REP,620058,0,5,67,72,
Pontotoc,Insurance Commissioner,Bill Viner,REP,620058,0,1,15,16,
Pontotoc,Insurance Commissioner,John Doak,REP,620058,2,5,71,78,
Pontotoc,Corporation Commissioner,Todd Hiett,REP,620058,1,3,57,61,
Pontotoc,Corporation Commissioner,Cliff Branan,REP,620058,1,3,29,33,
Pontotoc,U.S. Senate,Evelyn Rogers,REP,620058,0,0,4,4,
Pontotoc,U.S. Senate,Rob Moye,REP,620058,0,0,0,0,
Pontotoc,U.S. Senate,D. Jean Mcbride-Samuels,REP,620058,0,0,0,0,
Pontotoc,U.S. Senate,Jim Inhofe,REP,620058,2,6,82,90,
Pontotoc,U.S. Senate,Erick Paul Wyatt,REP,620058,0,0,4,4,
Pontotoc,U.S. Senate,Andy Craig,REP,620058,0,0,1,1,
Pontotoc,U.S. Senate,T. Shannon,REP,620058,2,3,32,37,
Pontotoc,U.S. Senate,Randy Brogdon,REP,620058,0,1,3,4,
Pontotoc,U.S. Senate,Eric Mccray,REP,620058,0,0,0,0,
Pontotoc,U.S. Senate,Kevin Crow,REP,620058,0,0,0,0,
Pontotoc,U.S. Senate,James Lankford,REP,620058,0,2,53,55,
Pontotoc,U.S. Senate,Jason Weger,REP,620058,0,0,2,2,
Pontotoc,U.S. House,Anna Flatt,REP,620058,0,1,7,8,04
Pontotoc,U.S. House,Tom Cole,REP,620058,2,5,84,91,04
Pontotoc,Superintendent of Public Instruction,John Cox,DEM,620059,0,1,40,41,
Pontotoc,Superintendent of Public Instruction,Jack Jr.,DEM,620059,0,0,14,14,
Pontotoc,Superintendent of Public Instruction,Ivan Holmes,DEM,620059,0,0,6,6,
Pontotoc,Superintendent of Public Instruction,Freda Deskin,DEM,620059,0,1,30,31,
Pontotoc,U.S. Senate,Patrick Michael Hayes,DEM,620059,0,1,20,21,
Pontotoc,U.S. Senate,Jim Rogers,DEM,620059,0,0,48,48,
Pontotoc,U.S. Senate,Connie Johnson,DEM,620059,0,1,17,18,
Pontotoc,U.S. House,Bert Smith,DEM,620059,0,2,76,78,04
Pontotoc,U.S. House,Tae Si,DEM,620059,0,0,7,7,04
Pontotoc,Governor,Dax Ewbank,REP,620059,0,1,5,6,
Pontotoc,Governor,Chad Moody,REP,620059,0,3,7,10,
Pontotoc,Governor,Mary Fallin,REP,620059,3,3,34,40,
Pontotoc,Superintendent of Public Instruction,Brian Kelly,REP,620059,0,1,10,11,
Pontotoc,Superintendent of Public Instruction,Janet Costello Barresi,REP,620059,0,1,9,10,
Pontotoc,Superintendent of Public Instruction,Joy Hofmeister,REP,620059,3,5,27,35,
Pontotoc,Insurance Commissioner,Bill Viner,REP,620059,2,2,6,10,
Pontotoc,Insurance Commissioner,John Doak,REP,620059,1,3,39,43,
Pontotoc,Corporation Commissioner,Todd Hiett,REP,620059,1,1,17,19,
Pontotoc,Corporation Commissioner,Cliff Branan,REP,620059,2,4,27,33,
Pontotoc,U.S. Senate,Evelyn Rogers,REP,620059,0,0,4,4,
Pontotoc,U.S. Senate,Rob Moye,REP,620059,0,0,1,1,
Pontotoc,U.S. Senate,D. Jean Mcbride-Samuels,REP,620059,0,0,0,0,
Pontotoc,U.S. Senate,Jim Inhofe,REP,620059,3,3,39,45,
Pontotoc,U.S. Senate,Erick Paul Wyatt,REP,620059,0,2,2,4,
Pontotoc,U.S. Senate,Andy Craig,REP,620059,0,0,1,1,
Pontotoc,U.S. Senate,T. Shannon,REP,620059,1,0,17,18,
Pontotoc,U.S. Senate,Randy Brogdon,REP,620059,0,0,2,2,
Pontotoc,U.S. Senate,Eric Mccray,REP,620059,0,1,0,1,
Pontotoc,U.S. Senate,Kevin Crow,REP,620059,0,0,2,2,
Pontotoc,U.S. Senate,James Lankford,REP,620059,2,5,24,31,
Pontotoc,U.S. Senate,Jason Weger,REP,620059,0,1,0,1,
Pontotoc,U.S. House,Anna Flatt,REP,620059,0,2,4,6,04
Pontotoc,U.S. House,Tom Cole,REP,620059,3,5,42,50,04
Pontotoc,Superintendent of Public Instruction,John Cox,DEM,620060,0,7,42,49,
Pontotoc,Superintendent of Public Instruction,Jack Jr.,DEM,620060,1,0,34,35,
Pontotoc,Superintendent of Public Instruction,Ivan Holmes,DEM,620060,0,0,14,14,
Pontotoc,Superintendent of Public Instruction,Freda Deskin,DEM,620060,0,3,66,69,
Pontotoc,U.S. Senate,Patrick Michael Hayes,DEM,620060,0,3,26,29,
Pontotoc,U.S. Senate,Jim Rogers,DEM,620060,0,4,79,83,
Pontotoc,U.S. Senate,Connie Johnson,DEM,620060,1,3,41,45,
Pontotoc,U.S. House,Bert Smith,DEM,620060,1,9,122,132,04
Pontotoc,U.S. House,Tae Si,DEM,620060,0,1,18,19,04
Pontotoc,Governor,Dax Ewbank,REP,620060,0,1,8,9,
Pontotoc,Governor,Chad Moody,REP,620060,0,11,17,28,
Pontotoc,Governor,Mary Fallin,REP,620060,1,2,47,50,
Pontotoc,Superintendent of Public Instruction,Brian Kelly,REP,620060,1,1,16,18,
Pontotoc,Superintendent of Public Instruction,Janet Costello Barresi,REP,620060,0,0,12,12,
Pontotoc,Superintendent of Public Instruction,Joy Hofmeister,REP,620060,0,15,44,59,
Pontotoc,Insurance Commissioner,Bill Viner,REP,620060,0,4,19,23,
Pontotoc,Insurance Commissioner,John Doak,REP,620060,1,9,51,61,
Pontotoc,Corporation Commissioner,Todd Hiett,REP,620060,1,10,43,54,
Pontotoc,Corporation Commissioner,Cliff Branan,REP,620060,0,3,25,28,
Pontotoc,U.S. Senate,Evelyn Rogers,REP,620060,0,1,4,5,
Pontotoc,U.S. Senate,Rob Moye,REP,620060,0,0,1,1,
Pontotoc,U.S. Senate,D. Jean Mcbride-Samuels,REP,620060,0,0,0,0,
Pontotoc,U.S. Senate,Jim Inhofe,REP,620060,1,13,62,76,
Pontotoc,U.S. Senate,Erick Paul Wyatt,REP,620060,0,0,5,5,
Pontotoc,U.S. Senate,Andy Craig,REP,620060,0,0,1,1,
Pontotoc,U.S. Senate,T. Shannon,REP,620060,0,4,34,38,
Pontotoc,U.S. Senate,Randy Brogdon,REP,620060,0,0,4,4,
Pontotoc,U.S. Senate,Eric Mccray,REP,620060,0,0,2,2,
Pontotoc,U.S. Senate,Kevin Crow,REP,620060,0,0,0,0,
Pontotoc,U.S. Senate,James Lankford,REP,620060,1,8,29,38,
Pontotoc,U.S. Senate,Jason Weger,REP,620060,0,0,3,3,
Pontotoc,U.S. House,Anna Flatt,REP,620060,0,2,17,19,04
Pontotoc,U.S. House,Tom Cole,REP,620060,1,13,55,69,04
Pontotoc,Superintendent of Public Instruction,John Cox,DEM,620061,0,0,21,21,
Pontotoc,Superintendent of Public Instruction,Jack Jr.,DEM,620061,0,0,8,8,
Pontotoc,Superintendent of Public Instruction,Ivan Holmes,DEM,620061,0,0,4,4,
Pontotoc,Superintendent of Public Instruction,Freda Deskin,DEM,620061,0,1,19,20,
Pontotoc,U.S. Senate,Patrick Michael Hayes,DEM,620061,0,0,14,14,
Pontotoc,U.S. Senate,Jim Rogers,DEM,620061,0,1,25,26,
Pontotoc,U.S. Senate,Connie Johnson,DEM,620061,0,0,9,9,
Pontotoc,U.S. House,Bert Smith,DEM,620061,0,1,46,47,04
Pontotoc,U.S. House,Tae Si,DEM,620061,0,0,3,3,04
Pontotoc,Governor,Dax Ewbank,REP,620061,0,0,0,0,
Pontotoc,Governor,Chad Moody,REP,620061,0,0,7,7,
Pontotoc,Governor,Mary Fallin,REP,620061,0,1,21,22,
Pontotoc,Superintendent of Public Instruction,Brian Kelly,REP,620061,0,0,3,3,
Pontotoc,Superintendent of Public Instruction,Janet Costello Barresi,REP,620061,0,0,7,7,
Pontotoc,Superintendent of Public Instruction,Joy Hofmeister,REP,620061,0,1,18,19,
Pontotoc,Insurance Commissioner,Bill Viner,REP,620061,0,0,7,7,
Pontotoc,Insurance Commissioner,John Doak,REP,620061,0,1,18,19,
Pontotoc,Corporation Commissioner,Todd Hiett,REP,620061,0,1,11,12,
Pontotoc,Corporation Commissioner,Cliff Branan,REP,620061,0,0,14,14,
Pontotoc,U.S. Senate,Evelyn Rogers,REP,620061,0,0,0,0,
Pontotoc,U.S. Senate,Rob Moye,REP,620061,0,0,0,0,
Pontotoc,U.S. Senate,D. Jean Mcbride-Samuels,REP,620061,0,0,0,0,
Pontotoc,U.S. Senate,Jim Inhofe,REP,620061,0,1,23,24,
Pontotoc,U.S. Senate,Erick Paul Wyatt,REP,620061,0,0,4,4,
Pontotoc,U.S. Senate,Andy Craig,REP,620061,0,0,0,0,
Pontotoc,U.S. Senate,T. Shannon,REP,620061,0,1,13,14,
Pontotoc,U.S. Senate,Randy Brogdon,REP,620061,0,0,1,1,
Pontotoc,U.S. Senate,Eric Mccray,REP,620061,0,0,0,0,
Pontotoc,U.S. Senate,Kevin Crow,REP,620061,0,0,0,0,
Pontotoc,U.S. Senate,James Lankford,REP,620061,0,0,13,13,
Pontotoc,U.S. Senate,Jason Weger,REP,620061,0,0,0,0,
Pontotoc,U.S. House,Anna Flatt,REP,620061,0,0,3,3,04
Pontotoc,U.S. House,Tom Cole,REP,620061,0,1,24,25,04
Pontotoc,Superintendent of Public Instruction,John Cox,DEM,620062,1,4,41,46,
Pontotoc,Superintendent of Public Instruction,Jack Jr.,DEM,620062,4,2,2,8,
Pontotoc,Superintendent of Public Instruction,Ivan Holmes,DEM,620062,0,0,11,11,
Pontotoc,Superintendent of Public Instruction,Freda Deskin,DEM,620062,0,3,52,55,
Pontotoc,U.S. Senate,Patrick Michael Hayes,DEM,620062,3,4,14,21,
Pontotoc,U.S. Senate,Jim Rogers,DEM,620062,0,5,58,63,
Pontotoc,U.S. Senate,Connie Johnson,DEM,620062,2,0,30,32,
Pontotoc,U.S. House,Bert Smith,DEM,620062,4,8,90,102,04
Pontotoc,U.S. House,Tae Si,DEM,620062,0,1,11,12,04
Pontotoc,Governor,Dax Ewbank,REP,620062,0,0,10,10,
Pontotoc,Governor,Chad Moody,REP,620062,0,1,19,20,
Pontotoc,Governor,Mary Fallin,REP,620062,1,6,51,58,
Pontotoc,Superintendent of Public Instruction,Brian Kelly,REP,620062,0,1,14,15,
Pontotoc,Superintendent of Public Instruction,Janet Costello Barresi,REP,620062,0,1,11,12,
Pontotoc,Superintendent of Public Instruction,Joy Hofmeister,REP,620062,1,5,54,60,
Pontotoc,Insurance Commissioner,Bill Viner,REP,620062,0,0,21,21,
Pontotoc,Insurance Commissioner,John Doak,REP,620062,1,7,56,64,
Pontotoc,Corporation Commissioner,Todd Hiett,REP,620062,0,4,39,43,
Pontotoc,Corporation Commissioner,Cliff Branan,REP,620062,1,3,37,41,
Pontotoc,U.S. Senate,Evelyn Rogers,REP,620062,0,1,3,4,
Pontotoc,U.S. Senate,Rob Moye,REP,620062,0,0,0,0,
Pontotoc,U.S. Senate,D. Jean Mcbride-Samuels,REP,620062,0,0,0,0,
Pontotoc,U.S. Senate,Jim Inhofe,REP,620062,1,6,73,80,
Pontotoc,U.S. Senate,Erick Paul Wyatt,REP,620062,0,0,3,3,
Pontotoc,U.S. Senate,Andy Craig,REP,620062,0,0,1,1,
Pontotoc,U.S. Senate,T. Shannon,REP,620062,1,2,40,43,
Pontotoc,U.S. Senate,Randy Brogdon,REP,620062,0,0,2,2,
Pontotoc,U.S. Senate,Eric Mccray,REP,620062,0,0,1,1,
Pontotoc,U.S. Senate,Kevin Crow,REP,620062,0,0,0,0,
Pontotoc,U.S. Senate,James Lankford,REP,620062,0,5,32,37,
Pontotoc,U.S. Senate,Jason Weger,REP,620062,0,0,3,3,
Pontotoc,U.S. House,Anna Flatt,REP,620062,0,2,8,10,04
Pontotoc,U.S. House,Tom Cole,REP,620062,1,5,72,78,04
Pontotoc,Superintendent of Public Instruction,John Cox,DEM,620063,0,1,38,39,
Pontotoc,Superintendent of Public Instruction,Jack Jr.,DEM,620063,0,0,16,16,
Pontotoc,Superintendent of Public Instruction,Ivan Holmes,DEM,620063,0,0,4,4,
Pontotoc,Superintendent of Public Instruction,Freda Deskin,DEM,620063,0,2,38,40,
Pontotoc,U.S. Senate,Patrick Michael Hayes,DEM,620063,0,0,21,21,
Pontotoc,U.S. Senate,Jim Rogers,DEM,620063,0,3,38,41,
Pontotoc,U.S. Senate,Connie Johnson,DEM,620063,0,0,33,33,
Pontotoc,U.S. House,Bert Smith,DEM,620063,0,2,78,80,04
Pontotoc,U.S. House,Tae Si,DEM,620063,0,1,14,15,04
Pontotoc,Governor,Dax Ewbank,REP,620063,0,1,4,5,
Pontotoc,Governor,Chad Moody,REP,620063,0,1,8,9,
Pontotoc,Governor,Mary Fallin,REP,620063,0,3,27,30,
Pontotoc,Superintendent of Public Instruction,Brian Kelly,REP,620063,0,0,12,12,
Pontotoc,Superintendent of Public Instruction,Janet Costello Barresi,REP,620063,0,1,8,9,
Pontotoc,Superintendent of Public Instruction,Joy Hofmeister,REP,620063,0,4,18,22,
Pontotoc,Insurance Commissioner,Bill Viner,REP,620063,0,2,8,10,
Pontotoc,Insurance Commissioner,John Doak,REP,620063,0,2,26,28,
Pontotoc,Corporation Commissioner,Todd Hiett,REP,620063,0,2,19,21,
Pontotoc,Corporation Commissioner,Cliff Branan,REP,620063,0,2,17,19,
Pontotoc,U.S. Senate,Evelyn Rogers,REP,620063,0,1,4,5,
Pontotoc,U.S. Senate,Rob Moye,REP,620063,0,0,3,3,
Pontotoc,U.S. Senate,D. Jean Mcbride-Samuels,REP,620063,0,0,0,0,
Pontotoc,U.S. Senate,Jim Inhofe,REP,620063,0,4,29,33,
Pontotoc,U.S. Senate,Erick Paul Wyatt,REP,620063,0,0,3,3,
Pontotoc,U.S. Senate,Andy Craig,REP,620063,0,0,4,4,
Pontotoc,U.S. Senate,T. Shannon,REP,620063,0,1,13,14,
Pontotoc,U.S. Senate,Randy Brogdon,REP,620063,0,1,1,2,
Pontotoc,U.S. Senate,Eric Mccray,REP,620063,0,0,2,2,
Pontotoc,U.S. Senate,Kevin Crow,REP,620063,0,0,2,2,
Pontotoc,U.S. Senate,James Lankford,REP,620063,0,2,17,19,
Pontotoc,U.S. Senate,Jason Weger,REP,620063,0,0,0,0,
Pontotoc,U.S. House,Anna Flatt,REP,620063,0,1,7,8,04
Pontotoc,U.S. House,Tom Cole,REP,620063,0,4,32,36,04
Pontotoc,Superintendent of Public Instruction,John Cox,DEM,620064,2,3,39,44,
Pontotoc,Superintendent of Public Instruction,Jack Jr.,DEM,620064,0,0,11,11,
Pontotoc,Superintendent of Public Instruction,Ivan Holmes,DEM,620064,0,0,7,7,
Pontotoc,Superintendent of Public Instruction,Freda Deskin,DEM,620064,1,2,53,56,
Pontotoc,U.S. Senate,Patrick Michael Hayes,DEM,620064,0,1,20,21,
Pontotoc,U.S. Senate,Jim Rogers,DEM,620064,2,3,54,59,
Pontotoc,U.S. Senate,Connie Johnson,DEM,620064,1,1,32,34,
Pontotoc,U.S. House,Bert Smith,DEM,620064,2,4,98,104,04
Pontotoc,U.S. House,Tae Si,DEM,620064,1,0,8,9,04
Pontotoc,Governor,Dax Ewbank,REP,620064,0,0,10,10,
Pontotoc,Governor,Chad Moody,REP,620064,0,1,17,18,
Pontotoc,Governor,Mary Fallin,REP,620064,1,0,53,54,
Pontotoc,Superintendent of Public Instruction,Brian Kelly,REP,620064,0,0,20,20,
Pontotoc,Superintendent of Public Instruction,Janet Costello Barresi,REP,620064,0,0,9,9,
Pontotoc,Superintendent of Public Instruction,Joy Hofmeister,REP,620064,1,1,51,53,
Pontotoc,Insurance Commissioner,Bill Viner,REP,620064,0,0,22,22,
Pontotoc,Insurance Commissioner,John Doak,REP,620064,1,1,53,55,
Pontotoc,Corporation Commissioner,Todd Hiett,REP,620064,1,0,46,47,
Pontotoc,Corporation Commissioner,Cliff Branan,REP,620064,0,1,30,31,
Pontotoc,U.S. Senate,Evelyn Rogers,REP,620064,0,0,6,6,
Pontotoc,U.S. Senate,Rob Moye,REP,620064,0,0,0,0,
Pontotoc,U.S. Senate,D. Jean Mcbride-Samuels,REP,620064,0,0,0,0,
Pontotoc,U.S. Senate,Jim Inhofe,REP,620064,1,1,66,68,
Pontotoc,U.S. Senate,Erick Paul Wyatt,REP,620064,0,0,6,6,
Pontotoc,U.S. Senate,Andy Craig,REP,620064,0,0,3,3,
Pontotoc,U.S. Senate,T. Shannon,REP,620064,0,0,38,38,
Pontotoc,U.S. Senate,Randy Brogdon,REP,620064,0,0,6,6,
Pontotoc,U.S. Senate,Eric Mccray,REP,620064,0,0,0,0,
Pontotoc,U.S. Senate,Kevin Crow,REP,620064,0,0,2,2,
Pontotoc,U.S. Senate,James Lankford,REP,620064,1,1,26,28,
Pontotoc,U.S. Senate,Jason Weger,REP,620064,0,0,3,3,
Pontotoc,U.S. House,Anna Flatt,REP,620064,0,0,17,17,04
Pontotoc,U.S. House,Tom Cole,REP,620064,1,1,62,64,04
Pontotoc,Superintendent of Public Instruction,John Cox,DEM,620065,2,2,24,28,
Pontotoc,Superintendent of Public Instruction,Jack Jr.,DEM,620065,0,0,7,7,
Pontotoc,Superintendent of Public Instruction,Ivan Holmes,DEM,620065,0,1,8,9,
Pontotoc,Superintendent of Public Instruction,Freda Deskin,DEM,620065,0,1,46,47,
Pontotoc,U.S. Senate,Patrick Michael Hayes,DEM,620065,2,1,18,21,
Pontotoc,U.S. Senate,Jim Rogers,DEM,620065,0,2,43,45,
Pontotoc,U.S. Senate,Connie Johnson,DEM,620065,0,1,20,21,
Pontotoc,U.S. House,Bert Smith,DEM,620065,2,3,71,76,04
Pontotoc,U.S. House,Tae Si,DEM,620065,0,0,6,6,04
Pontotoc,Governor,Dax Ewbank,REP,620065,0,0,4,4,
Pontotoc,Governor,Chad Moody,REP,620065,0,1,5,6,
Pontotoc,Governor,Mary Fallin,REP,620065,1,2,27,30,
Pontotoc,Superintendent of Public Instruction,Brian Kelly,REP,620065,1,0,12,13,
Pontotoc,Superintendent of Public Instruction,Janet Costello Barresi,REP,620065,0,2,2,4,
Pontotoc,Superintendent of Public Instruction,Joy Hofmeister,REP,620065,0,1,22,23,
Pontotoc,Insurance Commissioner,Bill Viner,REP,620065,0,2,14,16,
Pontotoc,Insurance Commissioner,John Doak,REP,620065,1,0,19,20,
Pontotoc,Corporation Commissioner,Todd Hiett,REP,620065,0,2,20,22,
Pontotoc,Corporation Commissioner,Cliff Branan,REP,620065,1,0,13,14,
Pontotoc,U.S. Senate,Evelyn Rogers,REP,620065,0,0,4,4,
Pontotoc,U.S. Senate,Rob Moye,REP,620065,0,0,2,2,
Pontotoc,U.S. Senate,D. Jean Mcbride-Samuels,REP,620065,0,0,0,0,
Pontotoc,U.S. Senate,Jim Inhofe,REP,620065,1,3,27,31,
Pontotoc,U.S. Senate,Erick Paul Wyatt,REP,620065,0,0,4,4,
Pontotoc,U.S. Senate,Andy Craig,REP,620065,0,0,0,0,
Pontotoc,U.S. Senate,T. Shannon,REP,620065,1,1,16,18,
Pontotoc,U.S. Senate,Randy Brogdon,REP,620065,0,0,2,2,
Pontotoc,U.S. Senate,Eric Mccray,REP,620065,0,0,0,0,
Pontotoc,U.S. Senate,Kevin Crow,REP,620065,0,0,1,1,
Pontotoc,U.S. Senate,James Lankford,REP,620065,0,2,17,19,
Pontotoc,U.S. Senate,Jason Weger,REP,620065,0,0,1,1,
Pontotoc,U.S. House,Anna Flatt,REP,620065,1,2,5,8,04
Pontotoc,U.S. House,Tom Cole,REP,620065,0,1,33,34,04
Pontotoc,Superintendent of Public Instruction,John Cox,DEM,620066,1,2,44,47,
Pontotoc,Superintendent of Public Instruction,Jack Jr.,DEM,620066,0,0,8,8,
Pontotoc,Superintendent of Public Instruction,Ivan Holmes,DEM,620066,0,2,7,9,
Pontotoc,Superintendent of Public Instruction,Freda Deskin,DEM,620066,3,2,45,50,
Pontotoc,U.S. Senate,Patrick Michael Hayes,DEM,620066,1,2,18,21,
Pontotoc,U.S. Senate,Jim Rogers,DEM,620066,2,4,57,63,
Pontotoc,U.S. Senate,Connie Johnson,DEM,620066,1,0,28,29,
Pontotoc,U.S. House,Bert Smith,DEM,620066,4,4,91,99,04
Pontotoc,U.S. House,Tae Si,DEM,620066,0,2,10,12,04
Pontotoc,Governor,Dax Ewbank,REP,620066,0,2,3,5,
Pontotoc,Governor,Chad Moody,REP,620066,0,4,15,19,
Pontotoc,Governor,Mary Fallin,REP,620066,1,3,34,38,
Pontotoc,Superintendent of Public Instruction,Brian Kelly,REP,620066,0,1,6,7,
Pontotoc,Superintendent of Public Instruction,Janet Costello Barresi,REP,620066,0,0,5,5,
Pontotoc,Superintendent of Public Instruction,Joy Hofmeister,REP,620066,1,9,41,51,
Pontotoc,Insurance Commissioner,Bill Viner,REP,620066,0,3,8,11,
Pontotoc,Insurance Commissioner,John Doak,REP,620066,1,5,38,44,
Pontotoc,Corporation Commissioner,Todd Hiett,REP,620066,0,1,23,24,
Pontotoc,Corporation Commissioner,Cliff Branan,REP,620066,1,7,22,30,
Pontotoc,U.S. Senate,Evelyn Rogers,REP,620066,0,1,6,7,
Pontotoc,U.S. Senate,Rob Moye,REP,620066,0,0,0,0,
Pontotoc,U.S. Senate,D. Jean Mcbride-Samuels,REP,620066,0,0,1,1,
Pontotoc,U.S. Senate,Jim Inhofe,REP,620066,1,9,44,54,
Pontotoc,U.S. Senate,Erick Paul Wyatt,REP,620066,0,0,2,2,
Pontotoc,U.S. Senate,Andy Craig,REP,620066,0,0,1,1,
Pontotoc,U.S. Senate,T. Shannon,REP,620066,1,4,29,34,
Pontotoc,U.S. Senate,Randy Brogdon,REP,620066,0,0,1,1,
Pontotoc,U.S. Senate,Eric Mccray,REP,620066,0,0,0,0,
Pontotoc,U.S. Senate,Kevin Crow,REP,620066,0,0,0,0,
Pontotoc,U.S. Senate,James Lankford,REP,620066,0,6,21,27,
Pontotoc,U.S. Senate,Jason Weger,REP,620066,0,0,1,1,
Pontotoc,U.S. House,Anna Flatt,REP,620066,0,0,7,7,04
Pontotoc,U.S. House,Tom Cole,REP,620066,1,10,46,57,04
Pontotoc,Superintendent of Public Instruction,John Cox,DEM,620067,0,3,25,28,
Pontotoc,Superintendent of Public Instruction,Jack Jr.,DEM,620067,0,0,9,9,
Pontotoc,Superintendent of Public Instruction,Ivan Holmes,DEM,620067,0,1,3,4,
Pontotoc,Superintendent of Public Instruction,Freda Deskin,DEM,620067,0,1,29,30,
Pontotoc,U.S. Senate,Patrick Michael Hayes,DEM,620067,0,2,21,23,
Pontotoc,U.S. Senate,Jim Rogers,DEM,620067,0,3,31,34,
Pontotoc,U.S. Senate,Connie Johnson,DEM,620067,0,0,11,11,
Pontotoc,U.S. House,Bert Smith,DEM,620067,0,5,55,60,04
Pontotoc,U.S. House,Tae Si,DEM,620067,0,0,7,7,04
Pontotoc,Governor,Dax Ewbank,REP,620067,0,0,10,10,
Pontotoc,Governor,Chad Moody,REP,620067,0,2,1,3,
Pontotoc,Governor,Mary Fallin,REP,620067,3,0,37,40,
Pontotoc,Superintendent of Public Instruction,Brian Kelly,REP,620067,0,0,13,13,
Pontotoc,Superintendent of Public Instruction,Janet Costello Barresi,REP,620067,1,0,6,7,
Pontotoc,Superintendent of Public Instruction,Joy Hofmeister,REP,620067,1,2,27,30,
Pontotoc,Insurance Commissioner,Bill Viner,REP,620067,0,0,11,11,
Pontotoc,Insurance Commissioner,John Doak,REP,620067,3,1,34,38,
Pontotoc,Corporation Commissioner,Todd Hiett,REP,620067,3,0,27,30,
Pontotoc,Corporation Commissioner,Cliff Branan,REP,620067,0,1,19,20,
Pontotoc,U.S. Senate,Evelyn Rogers,REP,620067,0,1,1,2,
Pontotoc,U.S. Senate,Rob Moye,REP,620067,0,0,3,3,
Pontotoc,U.S. Senate,D. Jean Mcbride-Samuels,REP,620067,0,0,1,1,
Pontotoc,U.S. Senate,Jim Inhofe,REP,620067,3,1,41,45,
Pontotoc,U.S. Senate,Erick Paul Wyatt,REP,620067,0,0,0,0,
Pontotoc,U.S. Senate,Andy Craig,REP,620067,0,0,0,0,
Pontotoc,U.S. Senate,T. Shannon,REP,620067,2,1,18,21,
Pontotoc,U.S. Senate,Randy Brogdon,REP,620067,0,0,3,3,
Pontotoc,U.S. Senate,Eric Mccray,REP,620067,0,0,0,0,
Pontotoc,U.S. Senate,Kevin Crow,REP,620067,0,0,0,0,
Pontotoc,U.S. Senate,James Lankford,REP,620067,1,1,25,27,
Pontotoc,U.S. Senate,Jason Weger,REP,620067,0,0,0,0,
Pontotoc,U.S. House,Anna Flatt,REP,620067,1,0,6,7,04
Pontotoc,U.S. House,Tom Cole,REP,620067,2,2,40,44,04
Pottawatomie,Superintendent of Public Instruction,John Cox,DEM,630001,0,1,28,29,
Pottawatomie,Superintendent of Public Instruction,Jack Jr.,DEM,630001,0,1,11,12,
Pottawatomie,Superintendent of Public Instruction,Ivan Holmes,DEM,630001,0,0,1,1,
Pottawatomie,Superintendent of Public Instruction,Freda Deskin,DEM,630001,0,1,18,19,
Pottawatomie,U.S. Senate,Patrick Michael Hayes,DEM,630001,0,0,22,22,
Pottawatomie,U.S. Senate,Jim Rogers,DEM,630001,0,1,18,19,
Pottawatomie,U.S. Senate,Connie Johnson,DEM,630001,0,2,16,18,
Pottawatomie,U.S. House,Tom Guild,DEM,630001,0,2,34,36,05
Pottawatomie,U.S. House,Al Mcaffrey,DEM,630001,0,0,7,7,05
Pottawatomie,U.S. House,Leona Leonard,DEM,630001,0,1,16,17,05
Pottawatomie,State Senate,Marilyn Rainwater,DEM,630001,0,2,22,24,28
Pottawatomie,State Senate,Billy Hinton,DEM,630001,0,1,36,37,28
Pottawatomie,Governor,Dax Ewbank,REP,630001,0,0,5,5,
Pottawatomie,Governor,Chad Moody,REP,630001,1,1,4,6,
Pottawatomie,Governor,Mary Fallin,REP,630001,2,5,54,61,
Pottawatomie,Superintendent of Public Instruction,Brian Kelly,REP,630001,2,3,15,20,
Pottawatomie,Superintendent of Public Instruction,Janet Costello Barresi,REP,630001,0,0,6,6,
Pottawatomie,Superintendent of Public Instruction,Joy Hofmeister,REP,630001,1,3,42,46,
Pottawatomie,Insurance Commissioner,Bill Viner,REP,630001,3,1,19,23,
Pottawatomie,Insurance Commissioner,John Doak,REP,630001,0,3,43,46,
Pottawatomie,Corporation Commissioner,Todd Hiett,REP,630001,1,2,24,27,
Pottawatomie,Corporation Commissioner,Cliff Branan,REP,630001,2,2,38,42,
Pottawatomie,U.S. Senate,Evelyn Rogers,REP,630001,0,0,1,1,
Pottawatomie,U.S. Senate,Rob Moye,REP,630001,0,0,2,2,
Pottawatomie,U.S. Senate,D. Jean Mcbride-Samuels,REP,630001,0,0,2,2,
Pottawatomie,U.S. Senate,Jim Inhofe,REP,630001,2,6,55,63,
Pottawatomie,U.S. Senate,Erick Paul Wyatt,REP,630001,1,0,2,3,
Pottawatomie,U.S. Senate,Andy Craig,REP,630001,0,0,0,0,
Pottawatomie,U.S. Senate,T. Shannon,REP,630001,1,0,21,22,
Pottawatomie,U.S. Senate,Randy Brogdon,REP,630001,0,1,5,6,
Pottawatomie,U.S. Senate,Eric Mccray,REP,630001,0,0,0,0,
Pottawatomie,U.S. Senate,Kevin Crow,REP,630001,0,0,0,0,
Pottawatomie,U.S. Senate,James Lankford,REP,630001,2,5,36,43,
Pottawatomie,U.S. Senate,Jason Weger,REP,630001,0,0,0,0,
Pottawatomie,U.S. House,Shane David Jett,REP,630001,1,2,30,33,05
Pottawatomie,U.S. House,Patrice Douglas,REP,630001,0,0,7,7,05
Pottawatomie,U.S. House,Mike Turner,REP,630001,0,0,2,2,05
Pottawatomie,U.S. House,Steve Russell,REP,630001,0,2,9,11,05
Pottawatomie,U.S. House,Harvey Sparks,REP,630001,1,2,5,8,05
Pottawatomie,U.S. House,Clark Jolley,REP,630001,1,0,8,9,05
Pottawatomie,State Senate,Jason Smalley,REP,630001,0,0,26,26,28
Pottawatomie,State Senate,Danny Williams,REP,630001,0,3,9,12,28
Pottawatomie,State Senate,Charles Mashek,REP,630001,1,0,3,4,28
Pottawatomie,State Senate,Joe Dobry,REP,630001,1,3,13,17,28
Pottawatomie,State Senate,Michael Ballard,REP,630001,1,0,9,10,28
Pottawatomie,Superintendent of Public Instruction,John Cox,DEM,630002,1,3,24,28,
Pottawatomie,Superintendent of Public Instruction,Jack Jr.,DEM,630002,0,0,11,11,
Pottawatomie,Superintendent of Public Instruction,Ivan Holmes,DEM,630002,2,0,13,15,
Pottawatomie,Superintendent of Public Instruction,Freda Deskin,DEM,630002,0,2,27,29,
Pottawatomie,U.S. Senate,Patrick Michael Hayes,DEM,630002,1,1,23,25,
Pottawatomie,U.S. Senate,Jim Rogers,DEM,630002,0,3,30,33,
Pottawatomie,U.S. Senate,Connie Johnson,DEM,630002,2,1,22,25,
Pottawatomie,U.S. House,Tom Guild,DEM,630002,2,2,36,40,05
Pottawatomie,U.S. House,Al Mcaffrey,DEM,630002,1,0,14,15,05
Pottawatomie,U.S. House,Leona Leonard,DEM,630002,0,3,24,27,05
Pottawatomie,Governor,Dax Ewbank,REP,630002,0,0,2,2,
Pottawatomie,Governor,Chad Moody,REP,630002,0,1,13,14,
Pottawatomie,Governor,Mary Fallin,REP,630002,0,1,73,74,
Pottawatomie,Superintendent of Public Instruction,Brian Kelly,REP,630002,0,0,25,25,
Pottawatomie,Superintendent of Public Instruction,Janet Costello Barresi,REP,630002,0,0,22,22,
Pottawatomie,Superintendent of Public Instruction,Joy Hofmeister,REP,630002,1,2,37,40,
Pottawatomie,Insurance Commissioner,Bill Viner,REP,630002,0,0,17,17,
Pottawatomie,Insurance Commissioner,John Doak,REP,630002,1,2,65,68,
Pottawatomie,Corporation Commissioner,Todd Hiett,REP,630002,1,1,40,42,
Pottawatomie,Corporation Commissioner,Cliff Branan,REP,630002,0,1,42,43,
Pottawatomie,U.S. Senate,Evelyn Rogers,REP,630002,0,2,6,8,
Pottawatomie,U.S. Senate,Rob Moye,REP,630002,0,0,0,0,
Pottawatomie,U.S. Senate,D. Jean Mcbride-Samuels,REP,630002,0,0,0,0,
Pottawatomie,U.S. Senate,Jim Inhofe,REP,630002,0,0,78,78,
Pottawatomie,U.S. Senate,Erick Paul Wyatt,REP,630002,0,0,3,3,
Pottawatomie,U.S. Senate,Andy Craig,REP,630002,0,0,0,0,
Pottawatomie,U.S. Senate,T. Shannon,REP,630002,0,1,26,27,
Pottawatomie,U.S. Senate,Randy Brogdon,REP,630002,0,0,4,4,
Pottawatomie,U.S. Senate,Eric Mccray,REP,630002,0,0,1,1,
Pottawatomie,U.S. Senate,Kevin Crow,REP,630002,0,0,2,2,
Pottawatomie,U.S. Senate,James Lankford,REP,630002,0,1,56,57,
Pottawatomie,U.S. Senate,Jason Weger,REP,630002,0,0,0,0,
Pottawatomie,U.S. House,Shane David Jett,REP,630002,0,1,47,48,05
Pottawatomie,U.S. House,Patrice Douglas,REP,630002,0,0,7,7,05
Pottawatomie,U.S. House,Mike Turner,REP,630002,0,0,12,12,05
Pottawatomie,U.S. House,Steve Russell,REP,630002,0,1,16,17,05
Pottawatomie,U.S. House,Harvey Sparks,REP,630002,0,0,2,2,05
Pottawatomie,U.S. House,Clark Jolley,REP,630002,0,0,3,3,05
Pottawatomie,Superintendent of Public Instruction,John Cox,DEM,630003,2,2,58,62,
Pottawatomie,Superintendent of Public Instruction,Jack Jr.,DEM,630003,0,1,21,22,
Pottawatomie,Superintendent of Public Instruction,Ivan Holmes,DEM,630003,2,2,16,20,
Pottawatomie,Superintendent of Public Instruction,Freda Deskin,DEM,630003,2,6,54,62,
Pottawatomie,U.S. Senate,Patrick Michael Hayes,DEM,630003,0,4,31,35,
Pottawatomie,U.S. Senate,Jim Rogers,DEM,630003,1,2,40,43,
Pottawatomie,U.S. Senate,Connie Johnson,DEM,630003,5,5,78,88,
Pottawatomie,U.S. House,Tom Guild,DEM,630003,2,6,70,78,05
Pottawatomie,U.S. House,Al Mcaffrey,DEM,630003,3,1,31,35,05
Pottawatomie,U.S. House,Leona Leonard,DEM,630003,1,3,42,46,05
Pottawatomie,Governor,Dax Ewbank,REP,630003,0,0,15,15,
Pottawatomie,Governor,Chad Moody,REP,630003,0,4,27,31,
Pottawatomie,Governor,Mary Fallin,REP,630003,6,3,90,99,
Pottawatomie,Superintendent of Public Instruction,Brian Kelly,REP,630003,1,2,35,38,
Pottawatomie,Superintendent of Public Instruction,Janet Costello Barresi,REP,630003,2,2,20,24,
Pottawatomie,Superintendent of Public Instruction,Joy Hofmeister,REP,630003,2,3,77,82,
Pottawatomie,Insurance Commissioner,Bill Viner,REP,630003,2,3,28,33,
Pottawatomie,Insurance Commissioner,John Doak,REP,630003,2,4,97,103,
Pottawatomie,Corporation Commissioner,Todd Hiett,REP,630003,5,3,63,71,
Pottawatomie,Corporation Commissioner,Cliff Branan,REP,630003,0,3,61,64,
Pottawatomie,U.S. Senate,Evelyn Rogers,REP,630003,0,0,8,8,
Pottawatomie,U.S. Senate,Rob Moye,REP,630003,0,1,6,7,
Pottawatomie,U.S. Senate,D. Jean Mcbride-Samuels,REP,630003,0,0,4,4,
Pottawatomie,U.S. Senate,Jim Inhofe,REP,630003,5,5,109,119,
Pottawatomie,U.S. Senate,Erick Paul Wyatt,REP,630003,1,0,5,6,
Pottawatomie,U.S. Senate,Andy Craig,REP,630003,0,0,0,0,
Pottawatomie,U.S. Senate,T. Shannon,REP,630003,3,4,42,49,
Pottawatomie,U.S. Senate,Randy Brogdon,REP,630003,0,0,2,2,
Pottawatomie,U.S. Senate,Eric Mccray,REP,630003,0,0,9,9,
Pottawatomie,U.S. Senate,Kevin Crow,REP,630003,0,0,3,3,
Pottawatomie,U.S. Senate,James Lankford,REP,630003,3,2,76,81,
Pottawatomie,U.S. Senate,Jason Weger,REP,630003,0,0,1,1,
Pottawatomie,U.S. House,Shane David Jett,REP,630003,2,2,63,67,05
Pottawatomie,U.S. House,Patrice Douglas,REP,630003,3,1,10,14,05
Pottawatomie,U.S. House,Mike Turner,REP,630003,1,0,14,15,05
Pottawatomie,U.S. House,Steve Russell,REP,630003,0,1,23,24,05
Pottawatomie,U.S. House,Harvey Sparks,REP,630003,0,0,2,2,05
Pottawatomie,U.S. House,Clark Jolley,REP,630003,0,2,19,21,05
Pottawatomie,Superintendent of Public Instruction,John Cox,DEM,630006,1,0,38,39,
Pottawatomie,Superintendent of Public Instruction,Jack Jr.,DEM,630006,1,1,9,11,
Pottawatomie,Superintendent of Public Instruction,Ivan Holmes,DEM,630006,0,1,5,6,
Pottawatomie,Superintendent of Public Instruction,Freda Deskin,DEM,630006,0,4,41,45,
Pottawatomie,U.S. Senate,Patrick Michael Hayes,DEM,630006,0,1,21,22,
Pottawatomie,U.S. Senate,Jim Rogers,DEM,630006,1,3,23,27,
Pottawatomie,U.S. Senate,Connie Johnson,DEM,630006,1,2,47,50,
Pottawatomie,U.S. House,Tom Guild,DEM,630006,2,4,50,56,05
Pottawatomie,U.S. House,Al Mcaffrey,DEM,630006,0,1,22,23,05
Pottawatomie,U.S. House,Leona Leonard,DEM,630006,0,1,19,20,05
Pottawatomie,Governor,Dax Ewbank,REP,630006,1,0,11,12,
Pottawatomie,Governor,Chad Moody,REP,630006,0,1,25,26,
Pottawatomie,Governor,Mary Fallin,REP,630006,5,6,89,100,
Pottawatomie,Superintendent of Public Instruction,Brian Kelly,REP,630006,2,0,36,38,
Pottawatomie,Superintendent of Public Instruction,Janet Costello Barresi,REP,630006,2,5,28,35,
Pottawatomie,Superintendent of Public Instruction,Joy Hofmeister,REP,630006,2,2,59,63,
Pottawatomie,Insurance Commissioner,Bill Viner,REP,630006,0,1,19,20,
Pottawatomie,Insurance Commissioner,John Doak,REP,630006,5,6,90,101,
Pottawatomie,Corporation Commissioner,Todd Hiett,REP,630006,5,4,59,68,
Pottawatomie,Corporation Commissioner,Cliff Branan,REP,630006,0,3,52,55,
Pottawatomie,U.S. Senate,Evelyn Rogers,REP,630006,0,0,3,3,
Pottawatomie,U.S. Senate,Rob Moye,REP,630006,0,0,2,2,
Pottawatomie,U.S. Senate,D. Jean Mcbride-Samuels,REP,630006,0,0,2,2,
Pottawatomie,U.S. Senate,Jim Inhofe,REP,630006,6,7,108,121,
Pottawatomie,U.S. Senate,Erick Paul Wyatt,REP,630006,0,0,8,8,
Pottawatomie,U.S. Senate,Andy Craig,REP,630006,0,0,1,1,
Pottawatomie,U.S. Senate,T. Shannon,REP,630006,0,1,31,32,
Pottawatomie,U.S. Senate,Randy Brogdon,REP,630006,0,0,4,4,
Pottawatomie,U.S. Senate,Eric Mccray,REP,630006,0,0,1,1,
Pottawatomie,U.S. Senate,Kevin Crow,REP,630006,0,0,1,1,
Pottawatomie,U.S. Senate,James Lankford,REP,630006,6,6,86,98,
Pottawatomie,U.S. Senate,Jason Weger,REP,630006,0,0,2,2,
Pottawatomie,U.S. House,Shane David Jett,REP,630006,1,5,47,53,05
Pottawatomie,U.S. House,Patrice Douglas,REP,630006,1,0,7,8,05
Pottawatomie,U.S. House,Mike Turner,REP,630006,0,0,20,20,05
Pottawatomie,U.S. House,Steve Russell,REP,630006,1,2,24,27,05
Pottawatomie,U.S. House,Harvey Sparks,REP,630006,0,0,6,6,05
Pottawatomie,U.S. House,Clark Jolley,REP,630006,2,0,17,19,05
Pottawatomie,Superintendent of Public Instruction,John Cox,DEM,630007,1,1,68,70,
Pottawatomie,Superintendent of Public Instruction,Jack Jr.,DEM,630007,2,4,24,30,
Pottawatomie,Superintendent of Public Instruction,Ivan Holmes,DEM,630007,1,1,7,9,
Pottawatomie,Superintendent of Public Instruction,Freda Deskin,DEM,630007,2,7,56,65,
Pottawatomie,U.S. Senate,Patrick Michael Hayes,DEM,630007,1,1,38,40,
Pottawatomie,U.S. Senate,Jim Rogers,DEM,630007,1,5,51,57,
Pottawatomie,U.S. Senate,Connie Johnson,DEM,630007,4,6,60,70,
Pottawatomie,U.S. House,Tom Guild,DEM,630007,2,6,73,81,05
Pottawatomie,U.S. House,Al Mcaffrey,DEM,630007,1,2,40,43,05
Pottawatomie,U.S. House,Leona Leonard,DEM,630007,3,3,31,37,05
Pottawatomie,Governor,Dax Ewbank,REP,630007,1,1,19,21,
Pottawatomie,Governor,Chad Moody,REP,630007,0,4,36,40,
Pottawatomie,Governor,Mary Fallin,REP,630007,1,10,121,132,
Pottawatomie,Superintendent of Public Instruction,Brian Kelly,REP,630007,0,4,50,54,
Pottawatomie,Superintendent of Public Instruction,Janet Costello Barresi,REP,630007,1,2,39,42,
Pottawatomie,Superintendent of Public Instruction,Joy Hofmeister,REP,630007,1,8,84,93,
Pottawatomie,Insurance Commissioner,Bill Viner,REP,630007,1,3,29,33,
Pottawatomie,Insurance Commissioner,John Doak,REP,630007,1,10,129,140,
Pottawatomie,Corporation Commissioner,Todd Hiett,REP,630007,0,5,87,92,
Pottawatomie,Corporation Commissioner,Cliff Branan,REP,630007,2,8,70,80,
Pottawatomie,U.S. Senate,Evelyn Rogers,REP,630007,0,1,12,13,
Pottawatomie,U.S. Senate,Rob Moye,REP,630007,0,0,1,1,
Pottawatomie,U.S. Senate,D. Jean Mcbride-Samuels,REP,630007,0,0,3,3,
Pottawatomie,U.S. Senate,Jim Inhofe,REP,630007,2,14,148,164,
Pottawatomie,U.S. Senate,Erick Paul Wyatt,REP,630007,0,0,7,7,
Pottawatomie,U.S. Senate,Andy Craig,REP,630007,0,0,0,0,
Pottawatomie,U.S. Senate,T. Shannon,REP,630007,1,1,40,42,
Pottawatomie,U.S. Senate,Randy Brogdon,REP,630007,0,0,7,7,
Pottawatomie,U.S. Senate,Eric Mccray,REP,630007,0,0,2,2,
Pottawatomie,U.S. Senate,Kevin Crow,REP,630007,0,1,2,3,
Pottawatomie,U.S. Senate,James Lankford,REP,630007,1,12,126,139,
Pottawatomie,U.S. Senate,Jason Weger,REP,630007,0,0,1,1,
Pottawatomie,U.S. House,Shane David Jett,REP,630007,0,8,78,86,05
Pottawatomie,U.S. House,Patrice Douglas,REP,630007,0,0,23,23,05
Pottawatomie,U.S. House,Mike Turner,REP,630007,0,1,18,19,05
Pottawatomie,U.S. House,Steve Russell,REP,630007,1,4,31,36,05
Pottawatomie,U.S. House,Harvey Sparks,REP,630007,1,0,10,11,05
Pottawatomie,U.S. House,Clark Jolley,REP,630007,0,1,16,17,05
Pottawatomie,Superintendent of Public Instruction,John Cox,DEM,630009,1,5,67,73,
Pottawatomie,Superintendent of Public Instruction,Jack Jr.,DEM,630009,0,1,22,23,
Pottawatomie,Superintendent of Public Instruction,Ivan Holmes,DEM,630009,0,0,8,8,
Pottawatomie,Superintendent of Public Instruction,Freda Deskin,DEM,630009,1,5,51,57,
Pottawatomie,U.S. Senate,Patrick Michael Hayes,DEM,630009,1,3,37,41,
Pottawatomie,U.S. Senate,Jim Rogers,DEM,630009,1,5,51,57,
Pottawatomie,U.S. Senate,Connie Johnson,DEM,630009,0,3,56,59,
Pottawatomie,U.S. House,Tom Guild,DEM,630009,2,9,81,92,05
Pottawatomie,U.S. House,Al Mcaffrey,DEM,630009,0,2,30,32,05
Pottawatomie,U.S. House,Leona Leonard,DEM,630009,0,0,33,33,05
Pottawatomie,Governor,Dax Ewbank,REP,630009,0,2,7,9,
Pottawatomie,Governor,Chad Moody,REP,630009,0,4,31,35,
Pottawatomie,Governor,Mary Fallin,REP,630009,10,25,157,192,
Pottawatomie,Superintendent of Public Instruction,Brian Kelly,REP,630009,2,12,50,64,
Pottawatomie,Superintendent of Public Instruction,Janet Costello Barresi,REP,630009,2,2,33,37,
Pottawatomie,Superintendent of Public Instruction,Joy Hofmeister,REP,630009,6,17,109,132,
Pottawatomie,Insurance Commissioner,Bill Viner,REP,630009,1,6,49,56,
Pottawatomie,Insurance Commissioner,John Doak,REP,630009,9,25,122,156,
Pottawatomie,Corporation Commissioner,Todd Hiett,REP,630009,7,10,78,95,
Pottawatomie,Corporation Commissioner,Cliff Branan,REP,630009,2,19,94,115,
Pottawatomie,U.S. Senate,Evelyn Rogers,REP,630009,1,0,9,10,
Pottawatomie,U.S. Senate,Rob Moye,REP,630009,0,1,5,6,
Pottawatomie,U.S. Senate,D. Jean Mcbride-Samuels,REP,630009,0,1,1,2,
Pottawatomie,U.S. Senate,Jim Inhofe,REP,630009,9,30,162,201,
Pottawatomie,U.S. Senate,Erick Paul Wyatt,REP,630009,0,0,14,14,
Pottawatomie,U.S. Senate,Andy Craig,REP,630009,0,0,0,0,
Pottawatomie,U.S. Senate,T. Shannon,REP,630009,2,10,53,65,
Pottawatomie,U.S. Senate,Randy Brogdon,REP,630009,0,1,6,7,
Pottawatomie,U.S. Senate,Eric Mccray,REP,630009,0,0,3,3,
Pottawatomie,U.S. Senate,Kevin Crow,REP,630009,0,0,0,0,
Pottawatomie,U.S. Senate,James Lankford,REP,630009,8,21,130,159,
Pottawatomie,U.S. Senate,Jason Weger,REP,630009,0,0,3,3,
Pottawatomie,U.S. House,Shane David Jett,REP,630009,4,16,88,108,05
Pottawatomie,U.S. House,Patrice Douglas,REP,630009,2,2,16,20,05
Pottawatomie,U.S. House,Mike Turner,REP,630009,1,0,26,27,05
Pottawatomie,U.S. House,Steve Russell,REP,630009,2,6,35,43,05
Pottawatomie,U.S. House,Harvey Sparks,REP,630009,0,1,8,9,05
Pottawatomie,U.S. House,Clark Jolley,REP,630009,1,6,12,19,05
Pottawatomie,Superintendent of Public Instruction,John Cox,DEM,630011,3,4,70,77,
Pottawatomie,Superintendent of Public Instruction,Jack Jr.,DEM,630011,0,1,30,31,
Pottawatomie,Superintendent of Public Instruction,Ivan Holmes,DEM,630011,0,0,13,13,
Pottawatomie,Superintendent of Public Instruction,Freda Deskin,DEM,630011,2,5,66,73,
Pottawatomie,U.S. Senate,Patrick Michael Hayes,DEM,630011,2,4,22,28,
Pottawatomie,U.S. Senate,Jim Rogers,DEM,630011,0,1,70,71,
Pottawatomie,U.S. Senate,Connie Johnson,DEM,630011,3,5,85,93,
Pottawatomie,U.S. House,Tom Guild,DEM,630011,1,5,93,99,05
Pottawatomie,U.S. House,Al Mcaffrey,DEM,630011,1,3,47,51,05
Pottawatomie,U.S. House,Leona Leonard,DEM,630011,3,2,39,44,05
Pottawatomie,Governor,Dax Ewbank,REP,630011,0,1,30,31,
Pottawatomie,Governor,Chad Moody,REP,630011,1,1,45,47,
Pottawatomie,Governor,Mary Fallin,REP,630011,6,18,279,303,
Pottawatomie,Superintendent of Public Instruction,Brian Kelly,REP,630011,3,0,83,86,
Pottawatomie,Superintendent of Public Instruction,Janet Costello Barresi,REP,630011,2,7,60,69,
Pottawatomie,Superintendent of Public Instruction,Joy Hofmeister,REP,630011,2,13,204,219,
Pottawatomie,Insurance Commissioner,Bill Viner,REP,630011,0,1,67,68,
Pottawatomie,Insurance Commissioner,John Doak,REP,630011,6,19,249,274,
Pottawatomie,Corporation Commissioner,Todd Hiett,REP,630011,6,14,156,176,
Pottawatomie,Corporation Commissioner,Cliff Branan,REP,630011,0,6,164,170,
Pottawatomie,U.S. Senate,Evelyn Rogers,REP,630011,0,0,11,11,
Pottawatomie,U.S. Senate,Rob Moye,REP,630011,0,1,12,13,
Pottawatomie,U.S. Senate,D. Jean Mcbride-Samuels,REP,630011,0,0,1,1,
Pottawatomie,U.S. Senate,Jim Inhofe,REP,630011,7,19,308,334,
Pottawatomie,U.S. Senate,Erick Paul Wyatt,REP,630011,0,0,12,12,
Pottawatomie,U.S. Senate,Andy Craig,REP,630011,0,0,1,1,
Pottawatomie,U.S. Senate,T. Shannon,REP,630011,2,4,60,66,
Pottawatomie,U.S. Senate,Randy Brogdon,REP,630011,0,0,8,8,
Pottawatomie,U.S. Senate,Eric Mccray,REP,630011,0,0,1,1,
Pottawatomie,U.S. Senate,Kevin Crow,REP,630011,0,0,2,2,
Pottawatomie,U.S. Senate,James Lankford,REP,630011,5,16,287,308,
Pottawatomie,U.S. Senate,Jason Weger,REP,630011,0,0,2,2,
Pottawatomie,U.S. House,Shane David Jett,REP,630011,2,7,165,174,05
Pottawatomie,U.S. House,Patrice Douglas,REP,630011,0,0,35,35,05
Pottawatomie,U.S. House,Mike Turner,REP,630011,2,2,42,46,05
Pottawatomie,U.S. House,Steve Russell,REP,630011,2,8,69,79,05
Pottawatomie,U.S. House,Harvey Sparks,REP,630011,1,0,11,12,05
Pottawatomie,U.S. House,Clark Jolley,REP,630011,0,3,31,34,05
Pottawatomie,Superintendent of Public Instruction,John Cox,DEM,630012,0,1,41,42,
Pottawatomie,Superintendent of Public Instruction,Jack Jr.,DEM,630012,0,0,27,27,
Pottawatomie,Superintendent of Public Instruction,Ivan Holmes,DEM,630012,2,2,9,13,
Pottawatomie,Superintendent of Public Instruction,Freda Deskin,DEM,630012,1,8,69,78,
Pottawatomie,U.S. Senate,Patrick Michael Hayes,DEM,630012,1,2,35,38,
Pottawatomie,U.S. Senate,Jim Rogers,DEM,630012,0,2,41,43,
Pottawatomie,U.S. Senate,Connie Johnson,DEM,630012,2,7,66,75,
Pottawatomie,U.S. House,Tom Guild,DEM,630012,2,7,81,90,05
Pottawatomie,U.S. House,Al Mcaffrey,DEM,630012,0,3,33,36,05
Pottawatomie,U.S. House,Leona Leonard,DEM,630012,0,1,29,30,05
Pottawatomie,Governor,Dax Ewbank,REP,630012,0,0,10,10,
Pottawatomie,Governor,Chad Moody,REP,630012,2,1,32,35,
Pottawatomie,Governor,Mary Fallin,REP,630012,5,8,161,174,
Pottawatomie,Superintendent of Public Instruction,Brian Kelly,REP,630012,5,0,41,46,
Pottawatomie,Superintendent of Public Instruction,Janet Costello Barresi,REP,630012,0,3,58,61,
Pottawatomie,Superintendent of Public Instruction,Joy Hofmeister,REP,630012,0,5,102,107,
Pottawatomie,Insurance Commissioner,Bill Viner,REP,630012,4,0,42,46,
Pottawatomie,Insurance Commissioner,John Doak,REP,630012,1,9,148,158,
Pottawatomie,Corporation Commissioner,Todd Hiett,REP,630012,4,7,99,110,
Pottawatomie,Corporation Commissioner,Cliff Branan,REP,630012,1,1,93,95,
Pottawatomie,U.S. Senate,Evelyn Rogers,REP,630012,1,0,8,9,
Pottawatomie,U.S. Senate,Rob Moye,REP,630012,0,0,5,5,
Pottawatomie,U.S. Senate,D. Jean Mcbride-Samuels,REP,630012,0,0,1,1,
Pottawatomie,U.S. Senate,Jim Inhofe,REP,630012,4,9,183,196,
Pottawatomie,U.S. Senate,Erick Paul Wyatt,REP,630012,2,0,2,4,
Pottawatomie,U.S. Senate,Andy Craig,REP,630012,3,0,2,5,
Pottawatomie,U.S. Senate,T. Shannon,REP,630012,1,0,42,43,
Pottawatomie,U.S. Senate,Randy Brogdon,REP,630012,0,0,5,5,
Pottawatomie,U.S. Senate,Eric Mccray,REP,630012,0,0,3,3,
Pottawatomie,U.S. Senate,Kevin Crow,REP,630012,0,0,1,1,
Pottawatomie,U.S. Senate,James Lankford,REP,630012,3,9,151,163,
Pottawatomie,U.S. Senate,Jason Weger,REP,630012,0,0,0,0,
Pottawatomie,U.S. House,Shane David Jett,REP,630012,2,4,90,96,05
Pottawatomie,U.S. House,Patrice Douglas,REP,630012,1,3,26,30,05
Pottawatomie,U.S. House,Mike Turner,REP,630012,1,0,26,27,05
Pottawatomie,U.S. House,Steve Russell,REP,630012,0,1,22,23,05
Pottawatomie,U.S. House,Harvey Sparks,REP,630012,0,0,8,8,05
Pottawatomie,U.S. House,Clark Jolley,REP,630012,2,1,30,33,05
Pottawatomie,Superintendent of Public Instruction,John Cox,DEM,630013,2,4,66,72,
Pottawatomie,Superintendent of Public Instruction,Jack Jr.,DEM,630013,1,2,38,41,
Pottawatomie,Superintendent of Public Instruction,Ivan Holmes,DEM,630013,0,1,14,15,
Pottawatomie,Superintendent of Public Instruction,Freda Deskin,DEM,630013,0,4,116,120,
Pottawatomie,U.S. Senate,Patrick Michael Hayes,DEM,630013,0,0,57,57,
Pottawatomie,U.S. Senate,Jim Rogers,DEM,630013,1,2,72,75,
Pottawatomie,U.S. Senate,Connie Johnson,DEM,630013,2,8,95,105,
Pottawatomie,U.S. House,Tom Guild,DEM,630013,2,2,126,130,05
Pottawatomie,U.S. House,Al Mcaffrey,DEM,630013,0,5,49,54,05
Pottawatomie,U.S. House,Leona Leonard,DEM,630013,1,3,47,51,05
Pottawatomie,Governor,Dax Ewbank,REP,630013,0,1,13,14,
Pottawatomie,Governor,Chad Moody,REP,630013,0,3,52,55,
Pottawatomie,Governor,Mary Fallin,REP,630013,2,21,271,294,
Pottawatomie,Superintendent of Public Instruction,Brian Kelly,REP,630013,0,4,74,78,
Pottawatomie,Superintendent of Public Instruction,Janet Costello Barresi,REP,630013,2,10,77,89,
Pottawatomie,Superintendent of Public Instruction,Joy Hofmeister,REP,630013,0,11,185,196,
Pottawatomie,Insurance Commissioner,Bill Viner,REP,630013,0,8,73,81,
Pottawatomie,Insurance Commissioner,John Doak,REP,630013,1,14,237,252,
Pottawatomie,Corporation Commissioner,Todd Hiett,REP,630013,1,11,151,163,
Pottawatomie,Corporation Commissioner,Cliff Branan,REP,630013,0,13,160,173,
Pottawatomie,U.S. Senate,Evelyn Rogers,REP,630013,0,2,11,13,
Pottawatomie,U.S. Senate,Rob Moye,REP,630013,0,0,4,4,
Pottawatomie,U.S. Senate,D. Jean Mcbride-Samuels,REP,630013,0,1,2,3,
Pottawatomie,U.S. Senate,Jim Inhofe,REP,630013,2,22,303,327,
Pottawatomie,U.S. Senate,Erick Paul Wyatt,REP,630013,0,1,13,14,
Pottawatomie,U.S. Senate,Andy Craig,REP,630013,0,0,2,2,
Pottawatomie,U.S. Senate,T. Shannon,REP,630013,1,4,52,57,
Pottawatomie,U.S. Senate,Randy Brogdon,REP,630013,0,0,2,2,
Pottawatomie,U.S. Senate,Eric Mccray,REP,630013,0,0,2,2,
Pottawatomie,U.S. Senate,Kevin Crow,REP,630013,0,0,4,4,
Pottawatomie,U.S. Senate,James Lankford,REP,630013,1,21,278,300,
Pottawatomie,U.S. Senate,Jason Weger,REP,630013,0,1,1,2,
Pottawatomie,U.S. House,Shane David Jett,REP,630013,0,13,169,182,05
Pottawatomie,U.S. House,Patrice Douglas,REP,630013,1,2,29,32,05
Pottawatomie,U.S. House,Mike Turner,REP,630013,1,1,20,22,05
Pottawatomie,U.S. House,Steve Russell,REP,630013,0,8,68,76,05
Pottawatomie,U.S. House,Harvey Sparks,REP,630013,0,0,7,7,05
Pottawatomie,U.S. House,Clark Jolley,REP,630013,0,2,40,42,05
Pottawatomie,Superintendent of Public Instruction,John Cox,DEM,630015,0,4,69,73,
Pottawatomie,Superintendent of Public Instruction,Jack Jr.,DEM,630015,1,1,24,26,
Pottawatomie,Superintendent of Public Instruction,Ivan Holmes,DEM,630015,0,0,11,11,
Pottawatomie,Superintendent of Public Instruction,Freda Deskin,DEM,630015,1,4,75,80,
Pottawatomie,U.S. Senate,Patrick Michael Hayes,DEM,630015,0,2,42,44,
Pottawatomie,U.S. Senate,Jim Rogers,DEM,630015,1,3,59,63,
Pottawatomie,U.S. Senate,Connie Johnson,DEM,630015,1,4,80,85,
Pottawatomie,U.S. House,Tom Guild,DEM,630015,1,2,86,89,05
Pottawatomie,U.S. House,Al Mcaffrey,DEM,630015,0,3,41,44,05
Pottawatomie,U.S. House,Leona Leonard,DEM,630015,1,3,44,48,05
Pottawatomie,Governor,Dax Ewbank,REP,630015,0,1,14,15,
Pottawatomie,Governor,Chad Moody,REP,630015,2,5,29,36,
Pottawatomie,Governor,Mary Fallin,REP,630015,2,10,169,181,
Pottawatomie,Superintendent of Public Instruction,Brian Kelly,REP,630015,0,0,66,66,
Pottawatomie,Superintendent of Public Instruction,Janet Costello Barresi,REP,630015,0,7,31,38,
Pottawatomie,Superintendent of Public Instruction,Joy Hofmeister,REP,630015,4,9,112,125,
Pottawatomie,Insurance Commissioner,Bill Viner,REP,630015,3,2,50,55,
Pottawatomie,Insurance Commissioner,John Doak,REP,630015,1,12,145,158,
Pottawatomie,Corporation Commissioner,Todd Hiett,REP,630015,4,11,95,110,
Pottawatomie,Corporation Commissioner,Cliff Branan,REP,630015,0,4,99,103,
Pottawatomie,U.S. Senate,Evelyn Rogers,REP,630015,0,2,11,13,
Pottawatomie,U.S. Senate,Rob Moye,REP,630015,0,0,4,4,
Pottawatomie,U.S. Senate,D. Jean Mcbride-Samuels,REP,630015,0,0,4,4,
Pottawatomie,U.S. Senate,Jim Inhofe,REP,630015,4,13,176,193,
Pottawatomie,U.S. Senate,Erick Paul Wyatt,REP,630015,0,0,13,13,
Pottawatomie,U.S. Senate,Andy Craig,REP,630015,0,0,2,2,
Pottawatomie,U.S. Senate,T. Shannon,REP,630015,0,6,57,63,
Pottawatomie,U.S. Senate,Randy Brogdon,REP,630015,0,1,7,8,
Pottawatomie,U.S. Senate,Eric Mccray,REP,630015,0,1,5,6,
Pottawatomie,U.S. Senate,Kevin Crow,REP,630015,0,0,0,0,
Pottawatomie,U.S. Senate,James Lankford,REP,630015,4,7,141,152,
Pottawatomie,U.S. Senate,Jason Weger,REP,630015,0,0,0,0,
Pottawatomie,U.S. House,Shane David Jett,REP,630015,1,7,91,99,05
Pottawatomie,U.S. House,Patrice Douglas,REP,630015,0,0,19,19,05
Pottawatomie,U.S. House,Mike Turner,REP,630015,0,1,23,24,05
Pottawatomie,U.S. House,Steve Russell,REP,630015,1,2,42,45,05
Pottawatomie,U.S. House,Harvey Sparks,REP,630015,2,2,4,8,05
Pottawatomie,U.S. House,Clark Jolley,REP,630015,0,3,29,32,05
Pottawatomie,Superintendent of Public Instruction,John Cox,DEM,630018,0,1,63,64,
Pottawatomie,Superintendent of Public Instruction,Jack Jr.,DEM,630018,0,0,24,24,
Pottawatomie,Superintendent of Public Instruction,Ivan Holmes,DEM,630018,0,2,13,15,
Pottawatomie,Superintendent of Public Instruction,Freda Deskin,DEM,630018,1,3,75,79,
Pottawatomie,U.S. Senate,Patrick Michael Hayes,DEM,630018,0,1,39,40,
Pottawatomie,U.S. Senate,Jim Rogers,DEM,630018,0,2,55,57,
Pottawatomie,U.S. Senate,Connie Johnson,DEM,630018,1,3,79,83,
Pottawatomie,U.S. House,Tom Guild,DEM,630018,0,2,73,75,05
Pottawatomie,U.S. House,Al Mcaffrey,DEM,630018,0,4,38,42,05
Pottawatomie,U.S. House,Leona Leonard,DEM,630018,1,0,56,57,05
Pottawatomie,Governor,Dax Ewbank,REP,630018,0,0,13,13,
Pottawatomie,Governor,Chad Moody,REP,630018,0,0,28,28,
Pottawatomie,Governor,Mary Fallin,REP,630018,4,10,139,153,
Pottawatomie,Superintendent of Public Instruction,Brian Kelly,REP,630018,1,1,55,57,
Pottawatomie,Superintendent of Public Instruction,Janet Costello Barresi,REP,630018,3,4,43,50,
Pottawatomie,Superintendent of Public Instruction,Joy Hofmeister,REP,630018,0,4,82,86,
Pottawatomie,Insurance Commissioner,Bill Viner,REP,630018,1,0,47,48,
Pottawatomie,Insurance Commissioner,John Doak,REP,630018,3,8,122,133,
Pottawatomie,Corporation Commissioner,Todd Hiett,REP,630018,0,7,83,90,
Pottawatomie,Corporation Commissioner,Cliff Branan,REP,630018,3,0,86,89,
Pottawatomie,U.S. Senate,Evelyn Rogers,REP,630018,0,0,7,7,
Pottawatomie,U.S. Senate,Rob Moye,REP,630018,0,0,2,2,
Pottawatomie,U.S. Senate,D. Jean Mcbride-Samuels,REP,630018,0,0,3,3,
Pottawatomie,U.S. Senate,Jim Inhofe,REP,630018,4,9,156,169,
Pottawatomie,U.S. Senate,Erick Paul Wyatt,REP,630018,0,0,9,9,
Pottawatomie,U.S. Senate,Andy Craig,REP,630018,0,0,0,0,
Pottawatomie,U.S. Senate,T. Shannon,REP,630018,1,0,30,31,
Pottawatomie,U.S. Senate,Randy Brogdon,REP,630018,0,0,2,2,
Pottawatomie,U.S. Senate,Eric Mccray,REP,630018,0,0,3,3,
Pottawatomie,U.S. Senate,Kevin Crow,REP,630018,0,0,6,6,
Pottawatomie,U.S. Senate,James Lankford,REP,630018,3,9,139,151,
Pottawatomie,U.S. Senate,Jason Weger,REP,630018,0,0,0,0,
Pottawatomie,U.S. House,Shane David Jett,REP,630018,1,5,84,90,05
Pottawatomie,U.S. House,Patrice Douglas,REP,630018,0,1,21,22,05
Pottawatomie,U.S. House,Mike Turner,REP,630018,1,0,13,14,05
Pottawatomie,U.S. House,Steve Russell,REP,630018,0,1,23,24,05
Pottawatomie,U.S. House,Harvey Sparks,REP,630018,2,0,6,8,05
Pottawatomie,U.S. House,Clark Jolley,REP,630018,0,1,31,32,05
Pottawatomie,Superintendent of Public Instruction,John Cox,DEM,630021,0,0,23,23,
Pottawatomie,Superintendent of Public Instruction,Jack Jr.,DEM,630021,0,0,13,13,
Pottawatomie,Superintendent of Public Instruction,Ivan Holmes,DEM,630021,0,0,2,2,
Pottawatomie,Superintendent of Public Instruction,Freda Deskin,DEM,630021,0,2,18,20,
Pottawatomie,U.S. Senate,Patrick Michael Hayes,DEM,630021,0,0,12,12,
Pottawatomie,U.S. Senate,Jim Rogers,DEM,630021,0,1,20,21,
Pottawatomie,U.S. Senate,Connie Johnson,DEM,630021,0,2,21,23,
Pottawatomie,U.S. House,Tom Guild,DEM,630021,0,1,31,32,05
Pottawatomie,U.S. House,Al Mcaffrey,DEM,630021,0,0,12,12,05
Pottawatomie,U.S. House,Leona Leonard,DEM,630021,0,2,10,12,05
Pottawatomie,State Senate,Marilyn Rainwater,DEM,630021,0,3,30,33,28
Pottawatomie,State Senate,Billy Hinton,DEM,630021,0,0,22,22,28
Pottawatomie,Governor,Dax Ewbank,REP,630021,0,0,10,10,
Pottawatomie,Governor,Chad Moody,REP,630021,0,1,7,8,
Pottawatomie,Governor,Mary Fallin,REP,630021,1,4,98,103,
Pottawatomie,Superintendent of Public Instruction,Brian Kelly,REP,630021,0,2,31,33,
Pottawatomie,Superintendent of Public Instruction,Janet Costello Barresi,REP,630021,1,1,23,25,
Pottawatomie,Superintendent of Public Instruction,Joy Hofmeister,REP,630021,0,2,57,59,
Pottawatomie,Insurance Commissioner,Bill Viner,REP,630021,0,1,26,27,
Pottawatomie,Insurance Commissioner,John Doak,REP,630021,1,4,83,88,
Pottawatomie,Corporation Commissioner,Todd Hiett,REP,630021,0,3,49,52,
Pottawatomie,Corporation Commissioner,Cliff Branan,REP,630021,1,2,63,66,
Pottawatomie,U.S. Senate,Evelyn Rogers,REP,630021,0,1,1,2,
Pottawatomie,U.S. Senate,Rob Moye,REP,630021,0,0,5,5,
Pottawatomie,U.S. Senate,D. Jean Mcbride-Samuels,REP,630021,0,0,2,2,
Pottawatomie,U.S. Senate,Jim Inhofe,REP,630021,1,4,100,105,
Pottawatomie,U.S. Senate,Erick Paul Wyatt,REP,630021,0,0,6,6,
Pottawatomie,U.S. Senate,Andy Craig,REP,630021,0,1,2,3,
Pottawatomie,U.S. Senate,T. Shannon,REP,630021,1,0,26,27,
Pottawatomie,U.S. Senate,Randy Brogdon,REP,630021,0,0,4,4,
Pottawatomie,U.S. Senate,Eric Mccray,REP,630021,0,0,0,0,
Pottawatomie,U.S. Senate,Kevin Crow,REP,630021,0,0,0,0,
Pottawatomie,U.S. Senate,James Lankford,REP,630021,0,4,82,86,
Pottawatomie,U.S. Senate,Jason Weger,REP,630021,0,0,1,1,
Pottawatomie,U.S. House,Shane David Jett,REP,630021,0,4,68,72,05
Pottawatomie,U.S. House,Patrice Douglas,REP,630021,0,0,16,16,05
Pottawatomie,U.S. House,Mike Turner,REP,630021,0,0,6,6,05
Pottawatomie,U.S. House,Steve Russell,REP,630021,0,1,18,19,05
Pottawatomie,U.S. House,Harvey Sparks,REP,630021,0,0,1,1,05
Pottawatomie,U.S. House,Clark Jolley,REP,630021,1,0,5,6,05
Pottawatomie,State Senate,Jason Smalley,REP,630021,1,0,42,43,28
Pottawatomie,State Senate,Danny Williams,REP,630021,0,1,29,30,28
Pottawatomie,State Senate,Charles Mashek,REP,630021,0,1,14,15,28
Pottawatomie,State Senate,Joe Dobry,REP,630021,0,3,20,23,28
Pottawatomie,State Senate,Michael Ballard,REP,630021,0,0,9,9,28
Pottawatomie,Superintendent of Public Instruction,John Cox,DEM,630022,4,3,55,62,
Pottawatomie,Superintendent of Public Instruction,Jack Jr.,DEM,630022,0,0,18,18,
Pottawatomie,Superintendent of Public Instruction,Ivan Holmes,DEM,630022,0,0,12,12,
Pottawatomie,Superintendent of Public Instruction,Freda Deskin,DEM,630022,1,3,37,41,
Pottawatomie,U.S. Senate,Patrick Michael Hayes,DEM,630022,1,2,26,29,
Pottawatomie,U.S. Senate,Jim Rogers,DEM,630022,3,1,47,51,
Pottawatomie,U.S. Senate,Connie Johnson,DEM,630022,1,3,47,51,
Pottawatomie,U.S. House,Tom Guild,DEM,630022,5,4,58,67,05
Pottawatomie,U.S. House,Al Mcaffrey,DEM,630022,0,1,28,29,05
Pottawatomie,U.S. House,Leona Leonard,DEM,630022,0,0,32,32,05
Pottawatomie,State Senate,Marilyn Rainwater,DEM,630022,2,3,73,78,28
Pottawatomie,State Senate,Billy Hinton,DEM,630022,3,3,46,52,28
Pottawatomie,Governor,Dax Ewbank,REP,630022,1,1,20,22,
Pottawatomie,Governor,Chad Moody,REP,630022,1,1,43,45,
Pottawatomie,Governor,Mary Fallin,REP,630022,3,4,225,232,
Pottawatomie,Superintendent of Public Instruction,Brian Kelly,REP,630022,0,1,70,71,
Pottawatomie,Superintendent of Public Instruction,Janet Costello Barresi,REP,630022,0,4,53,57,
Pottawatomie,Superintendent of Public Instruction,Joy Hofmeister,REP,630022,5,1,165,171,
Pottawatomie,Insurance Commissioner,Bill Viner,REP,630022,2,3,65,70,
Pottawatomie,Insurance Commissioner,John Doak,REP,630022,3,3,202,208,
Pottawatomie,Corporation Commissioner,Todd Hiett,REP,630022,2,1,114,117,
Pottawatomie,Corporation Commissioner,Cliff Branan,REP,630022,2,5,159,166,
Pottawatomie,U.S. Senate,Evelyn Rogers,REP,630022,1,0,14,15,
Pottawatomie,U.S. Senate,Rob Moye,REP,630022,0,0,3,3,
Pottawatomie,U.S. Senate,D. Jean Mcbride-Samuels,REP,630022,0,0,5,5,
Pottawatomie,U.S. Senate,Jim Inhofe,REP,630022,2,6,250,258,
Pottawatomie,U.S. Senate,Erick Paul Wyatt,REP,630022,2,0,15,17,
Pottawatomie,U.S. Senate,Andy Craig,REP,630022,0,0,4,4,
Pottawatomie,U.S. Senate,T. Shannon,REP,630022,0,2,76,78,
Pottawatomie,U.S. Senate,Randy Brogdon,REP,630022,0,0,11,11,
Pottawatomie,U.S. Senate,Eric Mccray,REP,630022,0,0,0,0,
Pottawatomie,U.S. Senate,Kevin Crow,REP,630022,0,0,2,2,
Pottawatomie,U.S. Senate,James Lankford,REP,630022,5,4,195,204,
Pottawatomie,U.S. Senate,Jason Weger,REP,630022,0,0,2,2,
Pottawatomie,U.S. House,Shane David Jett,REP,630022,1,0,154,155,05
Pottawatomie,U.S. House,Patrice Douglas,REP,630022,0,2,25,27,05
Pottawatomie,U.S. House,Mike Turner,REP,630022,0,0,18,18,05
Pottawatomie,U.S. House,Steve Russell,REP,630022,4,4,52,60,05
Pottawatomie,U.S. House,Harvey Sparks,REP,630022,0,0,10,10,05
Pottawatomie,U.S. House,Clark Jolley,REP,630022,0,0,27,27,05
Pottawatomie,State Senate,Jason Smalley,REP,630022,1,4,96,101,28
Pottawatomie,State Senate,Danny Williams,REP,630022,1,1,59,61,28
Pottawatomie,State Senate,Charles Mashek,REP,630022,1,0,24,25,28
Pottawatomie,State Senate,Joe Dobry,REP,630022,0,1,49,50,28
Pottawatomie,State Senate,Michael Ballard,REP,630022,1,0,38,39,28
Pottawatomie,State House,Lani Habrock,REP,630022,1,3,35,39,27
Pottawatomie,State House,Josh Cockroft,REP,630022,4,3,250,257,27
Pottawatomie,Superintendent of Public Instruction,John Cox,DEM,630024,0,0,65,65,
Pottawatomie,Superintendent of Public Instruction,Jack Jr.,DEM,630024,1,1,18,20,
Pottawatomie,Superintendent of Public Instruction,Ivan Holmes,DEM,630024,0,0,8,8,
Pottawatomie,Superintendent of Public Instruction,Freda Deskin,DEM,630024,1,0,40,41,
Pottawatomie,U.S. Senate,Patrick Michael Hayes,DEM,630024,1,0,30,31,
Pottawatomie,U.S. Senate,Jim Rogers,DEM,630024,1,1,47,49,
Pottawatomie,U.S. Senate,Connie Johnson,DEM,630024,0,0,48,48,
Pottawatomie,U.S. House,Tom Guild,DEM,630024,0,1,72,73,05
Pottawatomie,U.S. House,Al Mcaffrey,DEM,630024,2,0,28,30,05
Pottawatomie,U.S. House,Leona Leonard,DEM,630024,0,0,25,25,05
Pottawatomie,State Senate,Marilyn Rainwater,DEM,630024,1,0,70,71,28
Pottawatomie,State Senate,Billy Hinton,DEM,630024,1,1,57,59,28
Pottawatomie,Governor,Dax Ewbank,REP,630024,2,1,17,20,
Pottawatomie,Governor,Chad Moody,REP,630024,0,0,44,44,
Pottawatomie,Governor,Mary Fallin,REP,630024,4,6,186,196,
Pottawatomie,Superintendent of Public Instruction,Brian Kelly,REP,630024,2,1,73,76,
Pottawatomie,Superintendent of Public Instruction,Janet Costello Barresi,REP,630024,0,4,49,53,
Pottawatomie,Superintendent of Public Instruction,Joy Hofmeister,REP,630024,4,2,124,130,
Pottawatomie,Insurance Commissioner,Bill Viner,REP,630024,3,1,55,59,
Pottawatomie,Insurance Commissioner,John Doak,REP,630024,3,5,176,184,
Pottawatomie,Corporation Commissioner,Todd Hiett,REP,630024,3,4,122,129,
Pottawatomie,Corporation Commissioner,Cliff Branan,REP,630024,3,2,113,118,
Pottawatomie,U.S. Senate,Evelyn Rogers,REP,630024,0,0,12,12,
Pottawatomie,U.S. Senate,Rob Moye,REP,630024,0,0,0,0,
Pottawatomie,U.S. Senate,D. Jean Mcbride-Samuels,REP,630024,0,0,2,2,
Pottawatomie,U.S. Senate,Jim Inhofe,REP,630024,6,7,219,232,
Pottawatomie,U.S. Senate,Erick Paul Wyatt,REP,630024,0,0,12,12,
Pottawatomie,U.S. Senate,Andy Craig,REP,630024,0,0,2,2,
Pottawatomie,U.S. Senate,T. Shannon,REP,630024,4,1,67,72,
Pottawatomie,U.S. Senate,Randy Brogdon,REP,630024,0,0,4,4,
Pottawatomie,U.S. Senate,Eric Mccray,REP,630024,0,0,0,0,
Pottawatomie,U.S. Senate,Kevin Crow,REP,630024,0,0,2,2,
Pottawatomie,U.S. Senate,James Lankford,REP,630024,2,6,175,183,
Pottawatomie,U.S. Senate,Jason Weger,REP,630024,0,0,1,1,
Pottawatomie,U.S. House,Shane David Jett,REP,630024,3,3,92,98,05
Pottawatomie,U.S. House,Patrice Douglas,REP,630024,1,3,35,39,05
Pottawatomie,U.S. House,Mike Turner,REP,630024,0,1,36,37,05
Pottawatomie,U.S. House,Steve Russell,REP,630024,2,0,35,37,05
Pottawatomie,U.S. House,Harvey Sparks,REP,630024,0,0,16,16,05
Pottawatomie,U.S. House,Clark Jolley,REP,630024,0,0,32,32,05
Pottawatomie,State Senate,Jason Smalley,REP,630024,3,0,113,116,28
Pottawatomie,State Senate,Danny Williams,REP,630024,0,2,37,39,28
Pottawatomie,State Senate,Charles Mashek,REP,630024,1,2,20,23,28
Pottawatomie,State Senate,Joe Dobry,REP,630024,2,2,45,49,28
Pottawatomie,State Senate,Michael Ballard,REP,630024,0,1,23,24,28
Pottawatomie,Superintendent of Public Instruction,John Cox,DEM,630025,0,1,34,35,
Pottawatomie,Superintendent of Public Instruction,Jack Jr.,DEM,630025,0,0,16,16,
Pottawatomie,Superintendent of Public Instruction,Ivan Holmes,DEM,630025,0,0,2,2,
Pottawatomie,Superintendent of Public Instruction,Freda Deskin,DEM,630025,1,0,32,33,
Pottawatomie,U.S. Senate,Patrick Michael Hayes,DEM,630025,0,1,21,22,
Pottawatomie,U.S. Senate,Jim Rogers,DEM,630025,0,0,30,30,
Pottawatomie,U.S. Senate,Connie Johnson,DEM,630025,1,0,30,31,
Pottawatomie,U.S. House,Tom Guild,DEM,630025,0,0,42,42,05
Pottawatomie,U.S. House,Al Mcaffrey,DEM,630025,1,1,19,21,05
Pottawatomie,U.S. House,Leona Leonard,DEM,630025,0,0,18,18,05
Pottawatomie,State Senate,Marilyn Rainwater,DEM,630025,1,0,53,54,28
Pottawatomie,State Senate,Billy Hinton,DEM,630025,0,1,31,32,28
Pottawatomie,Governor,Dax Ewbank,REP,630025,0,0,10,10,
Pottawatomie,Governor,Chad Moody,REP,630025,0,1,17,18,
Pottawatomie,Governor,Mary Fallin,REP,630025,4,6,112,122,
Pottawatomie,Superintendent of Public Instruction,Brian Kelly,REP,630025,2,3,31,36,
Pottawatomie,Superintendent of Public Instruction,Janet Costello Barresi,REP,630025,0,1,23,24,
Pottawatomie,Superintendent of Public Instruction,Joy Hofmeister,REP,630025,2,3,83,88,
Pottawatomie,Insurance Commissioner,Bill Viner,REP,630025,2,0,24,26,
Pottawatomie,Insurance Commissioner,John Doak,REP,630025,2,7,102,111,
Pottawatomie,Corporation Commissioner,Todd Hiett,REP,630025,2,4,71,77,
Pottawatomie,Corporation Commissioner,Cliff Branan,REP,630025,2,3,55,60,
Pottawatomie,U.S. Senate,Evelyn Rogers,REP,630025,0,0,4,4,
Pottawatomie,U.S. Senate,Rob Moye,REP,630025,0,0,4,4,
Pottawatomie,U.S. Senate,D. Jean Mcbride-Samuels,REP,630025,0,0,2,2,
Pottawatomie,U.S. Senate,Jim Inhofe,REP,630025,4,6,121,131,
Pottawatomie,U.S. Senate,Erick Paul Wyatt,REP,630025,0,1,5,6,
Pottawatomie,U.S. Senate,Andy Craig,REP,630025,0,0,1,1,
Pottawatomie,U.S. Senate,T. Shannon,REP,630025,0,1,36,37,
Pottawatomie,U.S. Senate,Randy Brogdon,REP,630025,0,0,5,5,
Pottawatomie,U.S. Senate,Eric Mccray,REP,630025,0,0,0,0,
Pottawatomie,U.S. Senate,Kevin Crow,REP,630025,0,0,0,0,
Pottawatomie,U.S. Senate,James Lankford,REP,630025,4,6,95,105,
Pottawatomie,U.S. Senate,Jason Weger,REP,630025,0,0,2,2,
Pottawatomie,U.S. House,Shane David Jett,REP,630025,2,3,74,79,05
Pottawatomie,U.S. House,Patrice Douglas,REP,630025,0,0,13,13,05
Pottawatomie,U.S. House,Mike Turner,REP,630025,0,1,15,16,05
Pottawatomie,U.S. House,Steve Russell,REP,630025,2,2,21,25,05
Pottawatomie,U.S. House,Harvey Sparks,REP,630025,0,0,2,2,05
Pottawatomie,U.S. House,Clark Jolley,REP,630025,0,1,11,12,05
Pottawatomie,State Senate,Jason Smalley,REP,630025,0,5,49,54,28
Pottawatomie,State Senate,Danny Williams,REP,630025,2,0,27,29,28
Pottawatomie,State Senate,Charles Mashek,REP,630025,0,0,9,9,28
Pottawatomie,State Senate,Joe Dobry,REP,630025,2,1,32,35,28
Pottawatomie,State Senate,Michael Ballard,REP,630025,0,1,16,17,28
Pottawatomie,Superintendent of Public Instruction,John Cox,DEM,630026,0,2,40,42,
Pottawatomie,Superintendent of Public Instruction,Jack Jr.,DEM,630026,1,0,11,12,
Pottawatomie,Superintendent of Public Instruction,Ivan Holmes,DEM,630026,0,2,3,5,
Pottawatomie,Superintendent of Public Instruction,Freda Deskin,DEM,630026,1,0,38,39,
Pottawatomie,U.S. Senate,Patrick Michael Hayes,DEM,630026,2,1,28,31,
Pottawatomie,U.S. Senate,Jim Rogers,DEM,630026,1,1,29,31,
Pottawatomie,U.S. Senate,Connie Johnson,DEM,630026,0,2,33,35,
Pottawatomie,U.S. House,Tom Guild,DEM,630026,1,4,44,49,05
Pottawatomie,U.S. House,Al Mcaffrey,DEM,630026,2,0,22,24,05
Pottawatomie,U.S. House,Leona Leonard,DEM,630026,0,0,19,19,05
Pottawatomie,State Senate,Marilyn Rainwater,DEM,630026,1,2,49,52,28
Pottawatomie,State Senate,Billy Hinton,DEM,630026,2,2,39,43,28
Pottawatomie,Governor,Dax Ewbank,REP,630026,2,1,9,12,
Pottawatomie,Governor,Chad Moody,REP,630026,0,0,23,23,
Pottawatomie,Governor,Mary Fallin,REP,630026,5,9,145,159,
Pottawatomie,Superintendent of Public Instruction,Brian Kelly,REP,630026,0,2,42,44,
Pottawatomie,Superintendent of Public Instruction,Janet Costello Barresi,REP,630026,2,2,32,36,
Pottawatomie,Superintendent of Public Instruction,Joy Hofmeister,REP,630026,4,5,104,113,
Pottawatomie,Insurance Commissioner,Bill Viner,REP,630026,0,4,27,31,
Pottawatomie,Insurance Commissioner,John Doak,REP,630026,4,4,139,147,
Pottawatomie,Corporation Commissioner,Todd Hiett,REP,630026,6,5,85,96,
Pottawatomie,Corporation Commissioner,Cliff Branan,REP,630026,0,3,82,85,
Pottawatomie,U.S. Senate,Evelyn Rogers,REP,630026,0,1,5,6,
Pottawatomie,U.S. Senate,Rob Moye,REP,630026,0,0,0,0,
Pottawatomie,U.S. Senate,D. Jean Mcbride-Samuels,REP,630026,0,0,2,2,
Pottawatomie,U.S. Senate,Jim Inhofe,REP,630026,7,9,161,177,
Pottawatomie,U.S. Senate,Erick Paul Wyatt,REP,630026,0,0,6,6,
Pottawatomie,U.S. Senate,Andy Craig,REP,630026,0,0,1,1,
Pottawatomie,U.S. Senate,T. Shannon,REP,630026,0,1,35,36,
Pottawatomie,U.S. Senate,Randy Brogdon,REP,630026,0,0,4,4,
Pottawatomie,U.S. Senate,Eric Mccray,REP,630026,0,0,1,1,
Pottawatomie,U.S. Senate,Kevin Crow,REP,630026,0,0,0,0,
Pottawatomie,U.S. Senate,James Lankford,REP,630026,7,8,138,153,
Pottawatomie,U.S. Senate,Jason Weger,REP,630026,0,0,0,0,
Pottawatomie,U.S. House,Shane David Jett,REP,630026,1,7,103,111,05
Pottawatomie,U.S. House,Patrice Douglas,REP,630026,0,1,11,12,05
Pottawatomie,U.S. House,Mike Turner,REP,630026,3,0,15,18,05
Pottawatomie,U.S. House,Steve Russell,REP,630026,0,2,35,37,05
Pottawatomie,U.S. House,Harvey Sparks,REP,630026,1,0,4,5,05
Pottawatomie,U.S. House,Clark Jolley,REP,630026,2,0,8,10,05
Pottawatomie,State Senate,Jason Smalley,REP,630026,5,2,62,69,28
Pottawatomie,State Senate,Danny Williams,REP,630026,0,1,28,29,28
Pottawatomie,State Senate,Charles Mashek,REP,630026,0,0,14,14,28
Pottawatomie,State Senate,Joe Dobry,REP,630026,0,4,43,47,28
Pottawatomie,State Senate,Michael Ballard,REP,630026,0,2,21,23,28
Pottawatomie,Superintendent of Public Instruction,John Cox,DEM,630027,0,0,31,31,
Pottawatomie,Superintendent of Public Instruction,Jack Jr.,DEM,630027,1,0,9,10,
Pottawatomie,Superintendent of Public Instruction,Ivan Holmes,DEM,630027,0,0,8,8,
Pottawatomie,Superintendent of Public Instruction,Freda Deskin,DEM,630027,1,1,32,34,
Pottawatomie,U.S. Senate,Patrick Michael Hayes,DEM,630027,0,0,16,16,
Pottawatomie,U.S. Senate,Jim Rogers,DEM,630027,0,0,20,20,
Pottawatomie,U.S. Senate,Connie Johnson,DEM,630027,2,1,41,44,
Pottawatomie,U.S. House,Tom Guild,DEM,630027,0,1,35,36,05
Pottawatomie,U.S. House,Al Mcaffrey,DEM,630027,1,0,16,17,05
Pottawatomie,U.S. House,Leona Leonard,DEM,630027,1,0,26,27,05
Pottawatomie,State Senate,Marilyn Rainwater,DEM,630027,0,1,46,47,28
Pottawatomie,State Senate,Billy Hinton,DEM,630027,2,0,28,30,28
Pottawatomie,Governor,Dax Ewbank,REP,630027,0,0,17,17,
Pottawatomie,Governor,Chad Moody,REP,630027,0,0,12,12,
Pottawatomie,Governor,Mary Fallin,REP,630027,1,1,122,124,
Pottawatomie,Superintendent of Public Instruction,Brian Kelly,REP,630027,0,0,61,61,
Pottawatomie,Superintendent of Public Instruction,Janet Costello Barresi,REP,630027,0,0,34,34,
Pottawatomie,Superintendent of Public Instruction,Joy Hofmeister,REP,630027,1,1,56,58,
Pottawatomie,Insurance Commissioner,Bill Viner,REP,630027,0,0,32,32,
Pottawatomie,Insurance Commissioner,John Doak,REP,630027,1,1,108,110,
Pottawatomie,Corporation Commissioner,Todd Hiett,REP,630027,0,1,65,66,
Pottawatomie,Corporation Commissioner,Cliff Branan,REP,630027,1,0,78,79,
Pottawatomie,U.S. Senate,Evelyn Rogers,REP,630027,0,0,6,6,
Pottawatomie,U.S. Senate,Rob Moye,REP,630027,0,0,2,2,
Pottawatomie,U.S. Senate,D. Jean Mcbride-Samuels,REP,630027,0,0,2,2,
Pottawatomie,U.S. Senate,Jim Inhofe,REP,630027,1,1,132,134,
Pottawatomie,U.S. Senate,Erick Paul Wyatt,REP,630027,0,0,9,9,
Pottawatomie,U.S. Senate,Andy Craig,REP,630027,0,0,2,2,
Pottawatomie,U.S. Senate,T. Shannon,REP,630027,0,0,36,36,
Pottawatomie,U.S. Senate,Randy Brogdon,REP,630027,0,0,6,6,
Pottawatomie,U.S. Senate,Eric Mccray,REP,630027,0,0,2,2,
Pottawatomie,U.S. Senate,Kevin Crow,REP,630027,0,0,4,4,
Pottawatomie,U.S. Senate,James Lankford,REP,630027,1,1,103,105,
Pottawatomie,U.S. Senate,Jason Weger,REP,630027,0,0,0,0,
Pottawatomie,U.S. House,Shane David Jett,REP,630027,0,0,81,81,05
Pottawatomie,U.S. House,Patrice Douglas,REP,630027,0,0,17,17,05
Pottawatomie,U.S. House,Mike Turner,REP,630027,1,0,11,12,05
Pottawatomie,U.S. House,Steve Russell,REP,630027,0,0,33,33,05
Pottawatomie,U.S. House,Harvey Sparks,REP,630027,0,0,3,3,05
Pottawatomie,U.S. House,Clark Jolley,REP,630027,0,1,7,8,05
Pottawatomie,State Senate,Jason Smalley,REP,630027,1,0,45,46,28
Pottawatomie,State Senate,Danny Williams,REP,630027,0,0,34,34,28
Pottawatomie,State Senate,Charles Mashek,REP,630027,0,0,20,20,28
Pottawatomie,State Senate,Joe Dobry,REP,630027,0,0,24,24,28
Pottawatomie,State Senate,Michael Ballard,REP,630027,0,0,22,22,28
Pottawatomie,State House,Lani Habrock,REP,630027,0,0,32,32,27
Pottawatomie,State House,Josh Cockroft,REP,630027,1,1,121,123,27
Pottawatomie,Superintendent of Public Instruction,John Cox,DEM,630029,3,0,78,81,
Pottawatomie,Superintendent of Public Instruction,Jack Jr.,DEM,630029,0,3,27,30,
Pottawatomie,Superintendent of Public Instruction,Ivan Holmes,DEM,630029,0,0,11,11,
Pottawatomie,Superintendent of Public Instruction,Freda Deskin,DEM,630029,1,4,56,61,
Pottawatomie,U.S. Senate,Patrick Michael Hayes,DEM,630029,1,2,48,51,
Pottawatomie,U.S. Senate,Jim Rogers,DEM,630029,2,4,60,66,
Pottawatomie,U.S. Senate,Connie Johnson,DEM,630029,1,1,63,65,
Pottawatomie,U.S. House,Tom Guild,DEM,630029,3,3,90,96,05
Pottawatomie,U.S. House,Al Mcaffrey,DEM,630029,0,2,43,45,05
Pottawatomie,U.S. House,Leona Leonard,DEM,630029,1,1,34,36,05
Pottawatomie,State Senate,Marilyn Rainwater,DEM,630029,3,4,91,98,28
Pottawatomie,State Senate,Billy Hinton,DEM,630029,1,3,77,81,28
Pottawatomie,Governor,Dax Ewbank,REP,630029,1,1,13,15,
Pottawatomie,Governor,Chad Moody,REP,630029,0,6,33,39,
Pottawatomie,Governor,Mary Fallin,REP,630029,8,12,161,181,
Pottawatomie,Superintendent of Public Instruction,Brian Kelly,REP,630029,3,4,51,58,
Pottawatomie,Superintendent of Public Instruction,Janet Costello Barresi,REP,630029,3,4,37,44,
Pottawatomie,Superintendent of Public Instruction,Joy Hofmeister,REP,630029,3,10,113,126,
Pottawatomie,Insurance Commissioner,Bill Viner,REP,630029,1,1,45,47,
Pottawatomie,Insurance Commissioner,John Doak,REP,630029,8,18,149,175,
Pottawatomie,Corporation Commissioner,Todd Hiett,REP,630029,6,8,105,119,
Pottawatomie,Corporation Commissioner,Cliff Branan,REP,630029,3,10,88,101,
Pottawatomie,U.S. Senate,Evelyn Rogers,REP,630029,0,1,12,13,
Pottawatomie,U.S. Senate,Rob Moye,REP,630029,0,1,3,4,
Pottawatomie,U.S. Senate,D. Jean Mcbride-Samuels,REP,630029,0,0,10,10,
Pottawatomie,U.S. Senate,Jim Inhofe,REP,630029,9,16,175,200,
Pottawatomie,U.S. Senate,Erick Paul Wyatt,REP,630029,0,0,10,10,
Pottawatomie,U.S. Senate,Andy Craig,REP,630029,0,0,1,1,
Pottawatomie,U.S. Senate,T. Shannon,REP,630029,1,6,59,66,
Pottawatomie,U.S. Senate,Randy Brogdon,REP,630029,0,0,6,6,
Pottawatomie,U.S. Senate,Eric Mccray,REP,630029,0,0,0,0,
Pottawatomie,U.S. Senate,Kevin Crow,REP,630029,0,0,1,1,
Pottawatomie,U.S. Senate,James Lankford,REP,630029,8,13,140,161,
Pottawatomie,U.S. Senate,Jason Weger,REP,630029,0,0,1,1,
Pottawatomie,U.S. House,Shane David Jett,REP,630029,5,15,135,155,05
Pottawatomie,U.S. House,Patrice Douglas,REP,630029,0,1,22,23,05
Pottawatomie,U.S. House,Mike Turner,REP,630029,1,2,10,13,05
Pottawatomie,U.S. House,Steve Russell,REP,630029,3,1,34,38,05
Pottawatomie,U.S. House,Harvey Sparks,REP,630029,0,0,2,2,05
Pottawatomie,U.S. House,Clark Jolley,REP,630029,0,0,8,8,05
Pottawatomie,State Senate,Jason Smalley,REP,630029,2,13,70,85,28
Pottawatomie,State Senate,Danny Williams,REP,630029,1,1,36,38,28
Pottawatomie,State Senate,Charles Mashek,REP,630029,2,2,18,22,28
Pottawatomie,State Senate,Joe Dobry,REP,630029,3,1,22,26,28
Pottawatomie,State Senate,Michael Ballard,REP,630029,1,2,54,57,28
Pottawatomie,State House,Lani Habrock,REP,630029,0,3,50,53,27
Pottawatomie,State House,Josh Cockroft,REP,630029,9,16,157,182,27
Pottawatomie,Superintendent of Public Instruction,John Cox,DEM,630030,0,0,92,92,
Pottawatomie,Superintendent of Public Instruction,Jack Jr.,DEM,630030,2,1,27,30,
Pottawatomie,Superintendent of Public Instruction,Ivan Holmes,DEM,630030,0,0,7,7,
Pottawatomie,Superintendent of Public Instruction,Freda Deskin,DEM,630030,5,1,76,82,
Pottawatomie,U.S. Senate,Patrick Michael Hayes,DEM,630030,3,0,38,41,
Pottawatomie,U.S. Senate,Jim Rogers,DEM,630030,0,1,64,65,
Pottawatomie,U.S. Senate,Connie Johnson,DEM,630030,4,1,95,100,
Pottawatomie,U.S. House,Tom Guild,DEM,630030,3,1,114,118,05
Pottawatomie,U.S. House,Al Mcaffrey,DEM,630030,0,1,38,39,05
Pottawatomie,U.S. House,Leona Leonard,DEM,630030,3,0,47,50,05
Pottawatomie,State Senate,Marilyn Rainwater,DEM,630030,4,2,117,123,28
Pottawatomie,State Senate,Billy Hinton,DEM,630030,3,0,80,83,28
Pottawatomie,Governor,Dax Ewbank,REP,630030,0,1,26,27,
Pottawatomie,Governor,Chad Moody,REP,630030,0,3,50,53,
Pottawatomie,Governor,Mary Fallin,REP,630030,13,11,245,269,
Pottawatomie,Superintendent of Public Instruction,Brian Kelly,REP,630030,0,2,76,78,
Pottawatomie,Superintendent of Public Instruction,Janet Costello Barresi,REP,630030,4,3,45,52,
Pottawatomie,Superintendent of Public Instruction,Joy Hofmeister,REP,630030,8,10,198,216,
Pottawatomie,Insurance Commissioner,Bill Viner,REP,630030,2,4,72,78,
Pottawatomie,Insurance Commissioner,John Doak,REP,630030,10,11,229,250,
Pottawatomie,Corporation Commissioner,Todd Hiett,REP,630030,7,11,160,178,
Pottawatomie,Corporation Commissioner,Cliff Branan,REP,630030,5,3,148,156,
Pottawatomie,U.S. Senate,Evelyn Rogers,REP,630030,0,1,12,13,
Pottawatomie,U.S. Senate,Rob Moye,REP,630030,0,0,9,9,
Pottawatomie,U.S. Senate,D. Jean Mcbride-Samuels,REP,630030,0,0,7,7,
Pottawatomie,U.S. Senate,Jim Inhofe,REP,630030,13,14,272,299,
Pottawatomie,U.S. Senate,Erick Paul Wyatt,REP,630030,0,0,19,19,
Pottawatomie,U.S. Senate,Andy Craig,REP,630030,0,1,0,1,
Pottawatomie,U.S. Senate,T. Shannon,REP,630030,1,3,71,75,
Pottawatomie,U.S. Senate,Randy Brogdon,REP,630030,0,0,4,4,
Pottawatomie,U.S. Senate,Eric Mccray,REP,630030,0,0,2,2,
Pottawatomie,U.S. Senate,Kevin Crow,REP,630030,0,0,1,1,
Pottawatomie,U.S. Senate,James Lankford,REP,630030,12,11,245,268,
Pottawatomie,U.S. Senate,Jason Weger,REP,630030,0,0,1,1,
Pottawatomie,U.S. House,Shane David Jett,REP,630030,7,6,197,210,05
Pottawatomie,U.S. House,Patrice Douglas,REP,630030,2,0,12,14,05
Pottawatomie,U.S. House,Mike Turner,REP,630030,0,1,38,39,05
Pottawatomie,U.S. House,Steve Russell,REP,630030,4,4,43,51,05
Pottawatomie,U.S. House,Harvey Sparks,REP,630030,0,0,9,9,05
Pottawatomie,U.S. House,Clark Jolley,REP,630030,0,3,18,21,05
Pottawatomie,State Senate,Jason Smalley,REP,630030,5,8,105,118,28
Pottawatomie,State Senate,Danny Williams,REP,630030,1,3,65,69,28
Pottawatomie,State Senate,Charles Mashek,REP,630030,2,0,37,39,28
Pottawatomie,State Senate,Joe Dobry,REP,630030,2,1,34,37,28
Pottawatomie,State Senate,Michael Ballard,REP,630030,2,3,71,76,28
Pottawatomie,State House,Lani Habrock,REP,630030,0,6,64,70,27
Pottawatomie,State House,Josh Cockroft,REP,630030,13,9,257,279,27
Pottawatomie,Superintendent of Public Instruction,John Cox,DEM,630031,3,6,100,109,
Pottawatomie,Superintendent of Public Instruction,Jack Jr.,DEM,630031,1,5,22,28,
Pottawatomie,Superintendent of Public Instruction,Ivan Holmes,DEM,630031,0,0,11,11,
Pottawatomie,Superintendent of Public Instruction,Freda Deskin,DEM,630031,0,1,81,82,
Pottawatomie,U.S. Senate,Patrick Michael Hayes,DEM,630031,1,2,54,57,
Pottawatomie,U.S. Senate,Jim Rogers,DEM,630031,1,6,72,79,
Pottawatomie,U.S. Senate,Connie Johnson,DEM,630031,2,4,83,89,
Pottawatomie,U.S. House,Tom Guild,DEM,630031,1,9,100,110,05
Pottawatomie,U.S. House,Al Mcaffrey,DEM,630031,3,2,65,70,05
Pottawatomie,U.S. House,Leona Leonard,DEM,630031,0,1,43,44,05
Pottawatomie,Governor,Dax Ewbank,REP,630031,0,0,38,38,
Pottawatomie,Governor,Chad Moody,REP,630031,0,2,59,61,
Pottawatomie,Governor,Mary Fallin,REP,630031,10,5,293,308,
Pottawatomie,Superintendent of Public Instruction,Brian Kelly,REP,630031,3,0,107,110,
Pottawatomie,Superintendent of Public Instruction,Janet Costello Barresi,REP,630031,3,0,73,76,
Pottawatomie,Superintendent of Public Instruction,Joy Hofmeister,REP,630031,2,7,202,211,
Pottawatomie,Insurance Commissioner,Bill Viner,REP,630031,1,2,80,83,
Pottawatomie,Insurance Commissioner,John Doak,REP,630031,7,5,286,298,
Pottawatomie,Corporation Commissioner,Todd Hiett,REP,630031,2,3,182,187,
Pottawatomie,Corporation Commissioner,Cliff Branan,REP,630031,4,4,184,192,
Pottawatomie,U.S. Senate,Evelyn Rogers,REP,630031,0,0,20,20,
Pottawatomie,U.S. Senate,Rob Moye,REP,630031,0,0,8,8,
Pottawatomie,U.S. Senate,D. Jean Mcbride-Samuels,REP,630031,0,0,1,1,
Pottawatomie,U.S. Senate,Jim Inhofe,REP,630031,10,7,330,347,
Pottawatomie,U.S. Senate,Erick Paul Wyatt,REP,630031,0,0,21,21,
Pottawatomie,U.S. Senate,Andy Craig,REP,630031,0,0,5,5,
Pottawatomie,U.S. Senate,T. Shannon,REP,630031,1,2,79,82,
Pottawatomie,U.S. Senate,Randy Brogdon,REP,630031,0,0,11,11,
Pottawatomie,U.S. Senate,Eric Mccray,REP,630031,0,0,3,3,
Pottawatomie,U.S. Senate,Kevin Crow,REP,630031,0,0,1,1,
Pottawatomie,U.S. Senate,James Lankford,REP,630031,9,5,289,303,
Pottawatomie,U.S. Senate,Jason Weger,REP,630031,0,0,2,2,
Pottawatomie,U.S. House,Shane David Jett,REP,630031,2,5,196,203,05
Pottawatomie,U.S. House,Patrice Douglas,REP,630031,1,2,35,38,05
Pottawatomie,U.S. House,Mike Turner,REP,630031,2,0,33,35,05
Pottawatomie,U.S. House,Steve Russell,REP,630031,5,0,76,81,05
Pottawatomie,U.S. House,Harvey Sparks,REP,630031,0,0,10,10,05
Pottawatomie,U.S. House,Clark Jolley,REP,630031,0,0,33,33,05
Pottawatomie,Superintendent of Public Instruction,John Cox,DEM,630033,0,1,26,27,
Pottawatomie,Superintendent of Public Instruction,Jack Jr.,DEM,630033,1,0,10,11,
Pottawatomie,Superintendent of Public Instruction,Ivan Holmes,DEM,630033,0,0,3,3,
Pottawatomie,Superintendent of Public Instruction,Freda Deskin,DEM,630033,1,2,22,25,
Pottawatomie,U.S. Senate,Patrick Michael Hayes,DEM,630033,1,0,16,17,
Pottawatomie,U.S. Senate,Jim Rogers,DEM,630033,0,1,19,20,
Pottawatomie,U.S. Senate,Connie Johnson,DEM,630033,1,2,27,30,
Pottawatomie,U.S. House,Tom Guild,DEM,630033,2,3,34,39,05
Pottawatomie,U.S. House,Al Mcaffrey,DEM,630033,0,0,11,11,05
Pottawatomie,U.S. House,Leona Leonard,DEM,630033,0,0,15,15,05
Pottawatomie,State Senate,Marilyn Rainwater,DEM,630033,2,2,35,39,28
Pottawatomie,State Senate,Billy Hinton,DEM,630033,0,1,24,25,28
Pottawatomie,Governor,Dax Ewbank,REP,630033,0,0,9,9,
Pottawatomie,Governor,Chad Moody,REP,630033,1,0,15,16,
Pottawatomie,Governor,Mary Fallin,REP,630033,0,0,54,54,
Pottawatomie,Superintendent of Public Instruction,Brian Kelly,REP,630033,0,0,18,18,
Pottawatomie,Superintendent of Public Instruction,Janet Costello Barresi,REP,630033,0,0,9,9,
Pottawatomie,Superintendent of Public Instruction,Joy Hofmeister,REP,630033,1,0,48,49,
Pottawatomie,Insurance Commissioner,Bill Viner,REP,630033,1,0,19,20,
Pottawatomie,Insurance Commissioner,John Doak,REP,630033,0,0,54,54,
Pottawatomie,Corporation Commissioner,Todd Hiett,REP,630033,1,0,25,26,
Pottawatomie,Corporation Commissioner,Cliff Branan,REP,630033,0,0,47,47,
Pottawatomie,U.S. Senate,Evelyn Rogers,REP,630033,0,0,3,3,
Pottawatomie,U.S. Senate,Rob Moye,REP,630033,1,0,4,5,
Pottawatomie,U.S. Senate,D. Jean Mcbride-Samuels,REP,630033,0,0,1,1,
Pottawatomie,U.S. Senate,Jim Inhofe,REP,630033,0,0,61,61,
Pottawatomie,U.S. Senate,Erick Paul Wyatt,REP,630033,0,0,5,5,
Pottawatomie,U.S. Senate,Andy Craig,REP,630033,0,0,5,5,
Pottawatomie,U.S. Senate,T. Shannon,REP,630033,0,0,18,18,
Pottawatomie,U.S. Senate,Randy Brogdon,REP,630033,0,0,3,3,
Pottawatomie,U.S. Senate,Eric Mccray,REP,630033,0,0,1,1,
Pottawatomie,U.S. Senate,Kevin Crow,REP,630033,0,0,1,1,
Pottawatomie,U.S. Senate,James Lankford,REP,630033,0,0,49,49,
Pottawatomie,U.S. Senate,Jason Weger,REP,630033,1,0,1,2,
Pottawatomie,U.S. House,Shane David Jett,REP,630033,1,0,49,50,05
Pottawatomie,U.S. House,Patrice Douglas,REP,630033,0,0,7,7,05
Pottawatomie,U.S. House,Mike Turner,REP,630033,0,0,1,1,05
Pottawatomie,U.S. House,Steve Russell,REP,630033,0,0,13,13,05
Pottawatomie,U.S. House,Harvey Sparks,REP,630033,0,0,3,3,05
Pottawatomie,U.S. House,Clark Jolley,REP,630033,0,0,5,5,05
Pottawatomie,State Senate,Jason Smalley,REP,630033,1,0,30,31,28
Pottawatomie,State Senate,Danny Williams,REP,630033,0,0,23,23,28
Pottawatomie,State Senate,Charles Mashek,REP,630033,0,0,3,3,28
Pottawatomie,State Senate,Joe Dobry,REP,630033,0,0,6,6,28
Pottawatomie,State Senate,Michael Ballard,REP,630033,0,0,11,11,28
Pottawatomie,State House,Lani Habrock,REP,630033,1,0,13,14,27
Pottawatomie,State House,Josh Cockroft,REP,630033,0,0,64,64,27
Pottawatomie,Superintendent of Public Instruction,John Cox,DEM,630037,0,0,10,10,
Pottawatomie,Superintendent of Public Instruction,Jack Jr.,DEM,630037,0,0,9,9,
Pottawatomie,Superintendent of Public Instruction,Ivan Holmes,DEM,630037,0,0,4,4,
Pottawatomie,Superintendent of Public Instruction,Freda Deskin,DEM,630037,1,2,17,20,
Pottawatomie,U.S. Senate,Patrick Michael Hayes,DEM,630037,0,0,13,13,
Pottawatomie,U.S. Senate,Jim Rogers,DEM,630037,0,0,13,13,
Pottawatomie,U.S. Senate,Connie Johnson,DEM,630037,1,2,13,16,
Pottawatomie,U.S. House,Tom Guild,DEM,630037,0,1,20,21,05
Pottawatomie,U.S. House,Al Mcaffrey,DEM,630037,0,1,10,11,05
Pottawatomie,U.S. House,Leona Leonard,DEM,630037,1,0,10,11,05
Pottawatomie,Governor,Dax Ewbank,REP,630037,0,0,8,8,
Pottawatomie,Governor,Chad Moody,REP,630037,0,0,11,11,
Pottawatomie,Governor,Mary Fallin,REP,630037,2,1,72,75,
Pottawatomie,Superintendent of Public Instruction,Brian Kelly,REP,630037,0,0,20,20,
Pottawatomie,Superintendent of Public Instruction,Janet Costello Barresi,REP,630037,2,0,25,27,
Pottawatomie,Superintendent of Public Instruction,Joy Hofmeister,REP,630037,0,1,43,44,
Pottawatomie,Insurance Commissioner,Bill Viner,REP,630037,0,0,12,12,
Pottawatomie,Insurance Commissioner,John Doak,REP,630037,2,1,69,72,
Pottawatomie,Corporation Commissioner,Todd Hiett,REP,630037,2,0,34,36,
Pottawatomie,Corporation Commissioner,Cliff Branan,REP,630037,0,1,51,52,
Pottawatomie,U.S. Senate,Evelyn Rogers,REP,630037,0,0,4,4,
Pottawatomie,U.S. Senate,Rob Moye,REP,630037,0,0,2,2,
Pottawatomie,U.S. Senate,D. Jean Mcbride-Samuels,REP,630037,0,0,3,3,
Pottawatomie,U.S. Senate,Jim Inhofe,REP,630037,2,1,79,82,
Pottawatomie,U.S. Senate,Erick Paul Wyatt,REP,630037,0,0,2,2,
Pottawatomie,U.S. Senate,Andy Craig,REP,630037,0,0,0,0,
Pottawatomie,U.S. Senate,T. Shannon,REP,630037,0,0,26,26,
Pottawatomie,U.S. Senate,Randy Brogdon,REP,630037,0,0,2,2,
Pottawatomie,U.S. Senate,Eric Mccray,REP,630037,0,0,0,0,
Pottawatomie,U.S. Senate,Kevin Crow,REP,630037,0,0,1,1,
Pottawatomie,U.S. Senate,James Lankford,REP,630037,2,1,62,65,
Pottawatomie,U.S. Senate,Jason Weger,REP,630037,0,0,1,1,
Pottawatomie,U.S. House,Shane David Jett,REP,630037,2,0,48,50,05
Pottawatomie,U.S. House,Patrice Douglas,REP,630037,0,0,7,7,05
Pottawatomie,U.S. House,Mike Turner,REP,630037,0,0,8,8,05
Pottawatomie,U.S. House,Steve Russell,REP,630037,0,1,13,14,05
Pottawatomie,U.S. House,Harvey Sparks,REP,630037,0,0,2,2,05
Pottawatomie,U.S. House,Clark Jolley,REP,630037,0,0,12,12,05
Pottawatomie,State House,Lani Habrock,REP,630037,0,0,10,10,27
Pottawatomie,State House,Josh Cockroft,REP,630037,2,1,83,86,27
Pottawatomie,Superintendent of Public Instruction,John Cox,DEM,630038,0,0,17,17,
Pottawatomie,Superintendent of Public Instruction,Jack Jr.,DEM,630038,0,1,12,13,
Pottawatomie,Superintendent of Public Instruction,Ivan Holmes,DEM,630038,0,0,9,9,
Pottawatomie,Superintendent of Public Instruction,Freda Deskin,DEM,630038,0,1,16,17,
Pottawatomie,U.S. Senate,Patrick Michael Hayes,DEM,630038,0,0,14,14,
Pottawatomie,U.S. Senate,Jim Rogers,DEM,630038,0,1,14,15,
Pottawatomie,U.S. Senate,Connie Johnson,DEM,630038,0,1,23,24,
Pottawatomie,U.S. House,Tom Guild,DEM,630038,0,0,28,28,05
Pottawatomie,U.S. House,Al Mcaffrey,DEM,630038,0,1,13,14,05
Pottawatomie,U.S. House,Leona Leonard,DEM,630038,0,1,10,11,05
Pottawatomie,Governor,Dax Ewbank,REP,630038,0,0,1,1,
Pottawatomie,Governor,Chad Moody,REP,630038,0,1,15,16,
Pottawatomie,Governor,Mary Fallin,REP,630038,5,2,54,61,
Pottawatomie,Superintendent of Public Instruction,Brian Kelly,REP,630038,1,0,15,16,
Pottawatomie,Superintendent of Public Instruction,Janet Costello Barresi,REP,630038,4,0,16,20,
Pottawatomie,Superintendent of Public Instruction,Joy Hofmeister,REP,630038,0,3,39,42,
Pottawatomie,Insurance Commissioner,Bill Viner,REP,630038,2,3,16,21,
Pottawatomie,Insurance Commissioner,John Doak,REP,630038,3,0,52,55,
Pottawatomie,Corporation Commissioner,Todd Hiett,REP,630038,5,0,37,42,
Pottawatomie,Corporation Commissioner,Cliff Branan,REP,630038,0,3,32,35,
Pottawatomie,U.S. Senate,Evelyn Rogers,REP,630038,1,1,3,5,
Pottawatomie,U.S. Senate,Rob Moye,REP,630038,0,0,2,2,
Pottawatomie,U.S. Senate,D. Jean Mcbride-Samuels,REP,630038,0,0,0,0,
Pottawatomie,U.S. Senate,Jim Inhofe,REP,630038,4,2,60,66,
Pottawatomie,U.S. Senate,Erick Paul Wyatt,REP,630038,0,0,4,4,
Pottawatomie,U.S. Senate,Andy Craig,REP,630038,0,0,0,0,
Pottawatomie,U.S. Senate,T. Shannon,REP,630038,1,0,28,29,
Pottawatomie,U.S. Senate,Randy Brogdon,REP,630038,0,0,1,1,
Pottawatomie,U.S. Senate,Eric Mccray,REP,630038,0,0,0,0,
Pottawatomie,U.S. Senate,Kevin Crow,REP,630038,0,0,1,1,
Pottawatomie,U.S. Senate,James Lankford,REP,630038,4,3,39,46,
Pottawatomie,U.S. Senate,Jason Weger,REP,630038,0,0,0,0,
Pottawatomie,U.S. House,Shane David Jett,REP,630038,3,0,47,50,05
Pottawatomie,U.S. House,Patrice Douglas,REP,630038,0,0,7,7,05
Pottawatomie,U.S. House,Mike Turner,REP,630038,0,0,6,6,05
Pottawatomie,U.S. House,Steve Russell,REP,630038,2,2,7,11,05
Pottawatomie,U.S. House,Harvey Sparks,REP,630038,0,0,3,3,05
Pottawatomie,U.S. House,Clark Jolley,REP,630038,0,1,0,1,05
Pottawatomie,State House,Lani Habrock,REP,630038,0,1,8,9,27
Pottawatomie,State House,Josh Cockroft,REP,630038,5,2,62,69,27
Pottawatomie,Superintendent of Public Instruction,John Cox,DEM,630040,0,1,34,35,
Pottawatomie,Superintendent of Public Instruction,Jack Jr.,DEM,630040,0,0,4,4,
Pottawatomie,Superintendent of Public Instruction,Ivan Holmes,DEM,630040,0,0,3,3,
Pottawatomie,Superintendent of Public Instruction,Freda Deskin,DEM,630040,1,1,28,30,
Pottawatomie,U.S. Senate,Patrick Michael Hayes,DEM,630040,0,0,15,15,
Pottawatomie,U.S. Senate,Jim Rogers,DEM,630040,1,2,33,36,
Pottawatomie,U.S. Senate,Connie Johnson,DEM,630040,0,0,19,19,
Pottawatomie,U.S. House,Tom Guild,DEM,630040,0,1,42,43,05
Pottawatomie,U.S. House,Al Mcaffrey,DEM,630040,1,0,9,10,05
Pottawatomie,U.S. House,Leona Leonard,DEM,630040,0,1,16,17,05
Pottawatomie,Governor,Dax Ewbank,REP,630040,3,0,11,14,
Pottawatomie,Governor,Chad Moody,REP,630040,0,0,7,7,
Pottawatomie,Governor,Mary Fallin,REP,630040,0,0,38,38,
Pottawatomie,Superintendent of Public Instruction,Brian Kelly,REP,630040,0,0,14,14,
Pottawatomie,Superintendent of Public Instruction,Janet Costello Barresi,REP,630040,0,0,7,7,
Pottawatomie,Superintendent of Public Instruction,Joy Hofmeister,REP,630040,3,0,36,39,
Pottawatomie,Insurance Commissioner,Bill Viner,REP,630040,1,0,10,11,
Pottawatomie,Insurance Commissioner,John Doak,REP,630040,2,0,45,47,
Pottawatomie,Corporation Commissioner,Todd Hiett,REP,630040,2,0,29,31,
Pottawatomie,Corporation Commissioner,Cliff Branan,REP,630040,1,0,27,28,
Pottawatomie,U.S. Senate,Evelyn Rogers,REP,630040,0,0,2,2,
Pottawatomie,U.S. Senate,Rob Moye,REP,630040,0,0,1,1,
Pottawatomie,U.S. Senate,D. Jean Mcbride-Samuels,REP,630040,1,0,5,6,
Pottawatomie,U.S. Senate,Jim Inhofe,REP,630040,2,0,45,47,
Pottawatomie,U.S. Senate,Erick Paul Wyatt,REP,630040,0,0,3,3,
Pottawatomie,U.S. Senate,Andy Craig,REP,630040,0,0,0,0,
Pottawatomie,U.S. Senate,T. Shannon,REP,630040,0,0,19,19,
Pottawatomie,U.S. Senate,Randy Brogdon,REP,630040,0,0,12,12,
Pottawatomie,U.S. Senate,Eric Mccray,REP,630040,0,0,0,0,
Pottawatomie,U.S. Senate,Kevin Crow,REP,630040,0,0,1,1,
Pottawatomie,U.S. Senate,James Lankford,REP,630040,3,0,25,28,
Pottawatomie,U.S. Senate,Jason Weger,REP,630040,0,0,0,0,
Pottawatomie,U.S. House,Shane David Jett,REP,630040,3,0,35,38,05
Pottawatomie,U.S. House,Patrice Douglas,REP,630040,0,0,5,5,05
Pottawatomie,U.S. House,Mike Turner,REP,630040,0,0,2,2,05
Pottawatomie,U.S. House,Steve Russell,REP,630040,0,0,12,12,05
Pottawatomie,U.S. House,Harvey Sparks,REP,630040,0,0,1,1,05
Pottawatomie,U.S. House,Clark Jolley,REP,630040,0,0,2,2,05
Pottawatomie,State House,Lani Habrock,REP,630040,1,0,6,7,27
Pottawatomie,State House,Josh Cockroft,REP,630040,2,0,51,53,27
Pottawatomie,Superintendent of Public Instruction,John Cox,DEM,630041,0,0,25,25,
Pottawatomie,Superintendent of Public Instruction,Jack Jr.,DEM,630041,0,0,3,3,
Pottawatomie,Superintendent of Public Instruction,Ivan Holmes,DEM,630041,0,0,2,2,
Pottawatomie,Superintendent of Public Instruction,Freda Deskin,DEM,630041,0,0,33,33,
Pottawatomie,U.S. Senate,Patrick Michael Hayes,DEM,630041,0,0,12,12,
Pottawatomie,U.S. Senate,Jim Rogers,DEM,630041,0,0,28,28,
Pottawatomie,U.S. Senate,Connie Johnson,DEM,630041,0,0,19,19,
Pottawatomie,U.S. House,Tom Guild,DEM,630041,0,0,35,35,05
Pottawatomie,U.S. House,Al Mcaffrey,DEM,630041,0,0,13,13,05
Pottawatomie,U.S. House,Leona Leonard,DEM,630041,0,0,13,13,05
Pottawatomie,Governor,Dax Ewbank,REP,630041,0,1,8,9,
Pottawatomie,Governor,Chad Moody,REP,630041,0,0,17,17,
Pottawatomie,Governor,Mary Fallin,REP,630041,0,4,49,53,
Pottawatomie,Superintendent of Public Instruction,Brian Kelly,REP,630041,0,0,16,16,
Pottawatomie,Superintendent of Public Instruction,Janet Costello Barresi,REP,630041,0,0,6,6,
Pottawatomie,Superintendent of Public Instruction,Joy Hofmeister,REP,630041,0,5,52,57,
Pottawatomie,Insurance Commissioner,Bill Viner,REP,630041,0,0,20,20,
Pottawatomie,Insurance Commissioner,John Doak,REP,630041,0,5,49,54,
Pottawatomie,Corporation Commissioner,Todd Hiett,REP,630041,0,3,41,44,
Pottawatomie,Corporation Commissioner,Cliff Branan,REP,630041,0,2,31,33,
Pottawatomie,U.S. Senate,Evelyn Rogers,REP,630041,0,0,6,6,
Pottawatomie,U.S. Senate,Rob Moye,REP,630041,0,0,1,1,
Pottawatomie,U.S. Senate,D. Jean Mcbride-Samuels,REP,630041,0,0,2,2,
Pottawatomie,U.S. Senate,Jim Inhofe,REP,630041,0,4,63,67,
Pottawatomie,U.S. Senate,Erick Paul Wyatt,REP,630041,0,1,4,5,
Pottawatomie,U.S. Senate,Andy Craig,REP,630041,0,0,2,2,
Pottawatomie,U.S. Senate,T. Shannon,REP,630041,0,0,18,18,
Pottawatomie,U.S. Senate,Randy Brogdon,REP,630041,0,0,1,1,
Pottawatomie,U.S. Senate,Eric Mccray,REP,630041,0,0,0,0,
Pottawatomie,U.S. Senate,Kevin Crow,REP,630041,0,0,1,1,
Pottawatomie,U.S. Senate,James Lankford,REP,630041,0,5,55,60,
Pottawatomie,U.S. Senate,Jason Weger,REP,630041,0,0,0,0,
Pottawatomie,U.S. House,Shane David Jett,REP,630041,0,2,47,49,05
Pottawatomie,U.S. House,Patrice Douglas,REP,630041,0,1,9,10,05
Pottawatomie,U.S. House,Mike Turner,REP,630041,0,1,6,7,05
Pottawatomie,U.S. House,Steve Russell,REP,630041,0,1,9,10,05
Pottawatomie,U.S. House,Harvey Sparks,REP,630041,0,0,2,2,05
Pottawatomie,U.S. House,Clark Jolley,REP,630041,0,0,2,2,05
Pottawatomie,State House,Lani Habrock,REP,630041,0,0,9,9,27
Pottawatomie,State House,Josh Cockroft,REP,630041,0,5,64,69,27
Pottawatomie,Superintendent of Public Instruction,John Cox,DEM,630042,0,0,18,18,
Pottawatomie,Superintendent of Public Instruction,Jack Jr.,DEM,630042,0,0,9,9,
Pottawatomie,Superintendent of Public Instruction,Ivan Holmes,DEM,630042,0,0,10,10,
Pottawatomie,Superintendent of Public Instruction,Freda Deskin,DEM,630042,0,0,29,29,
Pottawatomie,U.S. Senate,Patrick Michael Hayes,DEM,630042,0,0,15,15,
Pottawatomie,U.S. Senate,Jim Rogers,DEM,630042,0,0,27,27,
Pottawatomie,U.S. Senate,Connie Johnson,DEM,630042,0,0,21,21,
Pottawatomie,U.S. House,Tom Guild,DEM,630042,0,0,35,35,05
Pottawatomie,U.S. House,Al Mcaffrey,DEM,630042,0,0,13,13,05
Pottawatomie,U.S. House,Leona Leonard,DEM,630042,0,0,16,16,05
Pottawatomie,Governor,Dax Ewbank,REP,630042,0,0,9,9,
Pottawatomie,Governor,Chad Moody,REP,630042,0,0,7,7,
Pottawatomie,Governor,Mary Fallin,REP,630042,2,0,36,38,
Pottawatomie,Superintendent of Public Instruction,Brian Kelly,REP,630042,2,0,8,10,
Pottawatomie,Superintendent of Public Instruction,Janet Costello Barresi,REP,630042,0,0,9,9,
Pottawatomie,Superintendent of Public Instruction,Joy Hofmeister,REP,630042,0,0,33,33,
Pottawatomie,Insurance Commissioner,Bill Viner,REP,630042,2,0,10,12,
Pottawatomie,Insurance Commissioner,John Doak,REP,630042,0,0,37,37,
Pottawatomie,Corporation Commissioner,Todd Hiett,REP,630042,0,0,21,21,
Pottawatomie,Corporation Commissioner,Cliff Branan,REP,630042,2,0,29,31,
Pottawatomie,U.S. Senate,Evelyn Rogers,REP,630042,0,0,2,2,
Pottawatomie,U.S. Senate,Rob Moye,REP,630042,0,0,0,0,
Pottawatomie,U.S. Senate,D. Jean Mcbride-Samuels,REP,630042,2,0,0,2,
Pottawatomie,U.S. Senate,Jim Inhofe,REP,630042,0,0,47,47,
Pottawatomie,U.S. Senate,Erick Paul Wyatt,REP,630042,0,0,1,1,
Pottawatomie,U.S. Senate,Andy Craig,REP,630042,0,0,0,0,
Pottawatomie,U.S. Senate,T. Shannon,REP,630042,0,0,17,17,
Pottawatomie,U.S. Senate,Randy Brogdon,REP,630042,0,0,4,4,
Pottawatomie,U.S. Senate,Eric Mccray,REP,630042,0,0,0,0,
Pottawatomie,U.S. Senate,Kevin Crow,REP,630042,0,0,1,1,
Pottawatomie,U.S. Senate,James Lankford,REP,630042,2,0,30,32,
Pottawatomie,U.S. Senate,Jason Weger,REP,630042,0,0,0,0,
Pottawatomie,U.S. House,Shane David Jett,REP,630042,2,0,22,24,05
Pottawatomie,U.S. House,Patrice Douglas,REP,630042,0,0,8,8,05
Pottawatomie,U.S. House,Mike Turner,REP,630042,0,0,8,8,05
Pottawatomie,U.S. House,Steve Russell,REP,630042,0,0,8,8,05
Pottawatomie,U.S. House,Harvey Sparks,REP,630042,0,0,0,0,05
Pottawatomie,U.S. House,Clark Jolley,REP,630042,0,0,4,4,05
Pushmataha,Superintendent of Public Instruction,John Cox,DEM,640001,1,7,45,53,
Pushmataha,Superintendent of Public Instruction,Jack Jr.,DEM,640001,0,1,6,7,
Pushmataha,Superintendent of Public Instruction,Ivan Holmes,DEM,640001,0,1,1,2,
Pushmataha,Superintendent of Public Instruction,Freda Deskin,DEM,640001,1,2,29,32,
Pushmataha,U.S. Senate,Patrick Michael Hayes,DEM,640001,0,0,23,23,
Pushmataha,U.S. Senate,Jim Rogers,DEM,640001,1,6,27,34,
Pushmataha,U.S. Senate,Connie Johnson,DEM,640001,1,1,24,26,
Pushmataha,U.S. House,Earl Everett,DEM,640001,1,7,48,56,02
Pushmataha,U.S. House,Joshua Harris-Till,DEM,640001,1,0,24,25,02
Pushmataha,Governor,Dax Ewbank,REP,640001,0,0,2,2,
Pushmataha,Governor,Chad Moody,REP,640001,1,1,6,8,
Pushmataha,Governor,Mary Fallin,REP,640001,0,0,13,13,
Pushmataha,Superintendent of Public Instruction,Brian Kelly,REP,640001,1,0,4,5,
Pushmataha,Superintendent of Public Instruction,Janet Costello Barresi,REP,640001,0,0,3,3,
Pushmataha,Superintendent of Public Instruction,Joy Hofmeister,REP,640001,0,1,14,15,
Pushmataha,Insurance Commissioner,Bill Viner,REP,640001,0,0,3,3,
Pushmataha,Insurance Commissioner,John Doak,REP,640001,1,0,17,18,
Pushmataha,Corporation Commissioner,Todd Hiett,REP,640001,0,0,14,14,
Pushmataha,Corporation Commissioner,Cliff Branan,REP,640001,1,0,4,5,
Pushmataha,U.S. Senate,Evelyn Rogers,REP,640001,0,0,0,0,
Pushmataha,U.S. Senate,Rob Moye,REP,640001,0,0,0,0,
Pushmataha,U.S. Senate,D. Jean Mcbride-Samuels,REP,640001,0,0,0,0,
Pushmataha,U.S. Senate,Jim Inhofe,REP,640001,1,1,19,21,
Pushmataha,U.S. Senate,Erick Paul Wyatt,REP,640001,0,0,2,2,
Pushmataha,U.S. Senate,Andy Craig,REP,640001,0,0,1,1,
Pushmataha,U.S. Senate,T. Shannon,REP,640001,0,1,9,10,
Pushmataha,U.S. Senate,Randy Brogdon,REP,640001,0,0,1,1,
Pushmataha,U.S. Senate,Eric Mccray,REP,640001,0,0,2,2,
Pushmataha,U.S. Senate,Kevin Crow,REP,640001,1,0,0,1,
Pushmataha,U.S. Senate,James Lankford,REP,640001,0,0,7,7,
Pushmataha,U.S. Senate,Jason Weger,REP,640001,0,0,0,0,
Pushmataha,U.S. House,Darrel Robertson,REP,640001,0,0,2,2,02
Pushmataha,U.S. House,Markwayne Mullin,REP,640001,1,1,19,21,02
Pushmataha,State Senate,Joseph Silk,REP,640001,0,0,11,11,5
Pushmataha,State Senate,Brent Shain,REP,640001,1,0,11,12,5
Pushmataha,Superintendent of Public Instruction,John Cox,DEM,640002,1,9,90,100,
Pushmataha,Superintendent of Public Instruction,Jack Jr.,DEM,640002,0,2,17,19,
Pushmataha,Superintendent of Public Instruction,Ivan Holmes,DEM,640002,0,4,8,12,
Pushmataha,Superintendent of Public Instruction,Freda Deskin,DEM,640002,0,3,90,93,
Pushmataha,U.S. Senate,Patrick Michael Hayes,DEM,640002,1,3,47,51,
Pushmataha,U.S. Senate,Jim Rogers,DEM,640002,0,8,86,94,
Pushmataha,U.S. Senate,Connie Johnson,DEM,640002,0,3,53,56,
Pushmataha,U.S. House,Earl Everett,DEM,640002,0,10,144,154,02
Pushmataha,U.S. House,Joshua Harris-Till,DEM,640002,1,4,41,46,02
Pushmataha,Governor,Dax Ewbank,REP,640002,0,0,9,9,
Pushmataha,Governor,Chad Moody,REP,640002,0,2,10,12,
Pushmataha,Governor,Mary Fallin,REP,640002,0,4,15,19,
Pushmataha,Superintendent of Public Instruction,Brian Kelly,REP,640002,0,3,11,14,
Pushmataha,Superintendent of Public Instruction,Janet Costello Barresi,REP,640002,0,0,5,5,
Pushmataha,Superintendent of Public Instruction,Joy Hofmeister,REP,640002,0,3,15,18,
Pushmataha,Insurance Commissioner,Bill Viner,REP,640002,0,3,11,14,
Pushmataha,Insurance Commissioner,John Doak,REP,640002,0,3,19,22,
Pushmataha,Corporation Commissioner,Todd Hiett,REP,640002,0,3,17,20,
Pushmataha,Corporation Commissioner,Cliff Branan,REP,640002,0,3,13,16,
Pushmataha,U.S. Senate,Evelyn Rogers,REP,640002,0,1,0,1,
Pushmataha,U.S. Senate,Rob Moye,REP,640002,0,0,1,1,
Pushmataha,U.S. Senate,D. Jean Mcbride-Samuels,REP,640002,0,0,1,1,
Pushmataha,U.S. Senate,Jim Inhofe,REP,640002,0,5,29,34,
Pushmataha,U.S. Senate,Erick Paul Wyatt,REP,640002,0,0,4,4,
Pushmataha,U.S. Senate,Andy Craig,REP,640002,0,0,1,1,
Pushmataha,U.S. Senate,T. Shannon,REP,640002,0,3,10,13,
Pushmataha,U.S. Senate,Randy Brogdon,REP,640002,0,0,6,6,
Pushmataha,U.S. Senate,Eric Mccray,REP,640002,0,0,1,1,
Pushmataha,U.S. Senate,Kevin Crow,REP,640002,0,1,0,1,
Pushmataha,U.S. Senate,James Lankford,REP,640002,0,1,17,18,
Pushmataha,U.S. Senate,Jason Weger,REP,640002,0,0,0,0,
Pushmataha,U.S. House,Darrel Robertson,REP,640002,0,1,9,10,02
Pushmataha,U.S. House,Markwayne Mullin,REP,640002,0,5,26,31,02
Pushmataha,State Senate,Joseph Silk,REP,640002,0,1,18,19,5
Pushmataha,State Senate,Brent Shain,REP,640002,0,4,16,20,5
Pushmataha,Superintendent of Public Instruction,John Cox,DEM,640003,0,2,28,30,
Pushmataha,Superintendent of Public Instruction,Jack Jr.,DEM,640003,1,0,5,6,
Pushmataha,Superintendent of Public Instruction,Ivan Holmes,DEM,640003,0,0,4,4,
Pushmataha,Superintendent of Public Instruction,Freda Deskin,DEM,640003,0,0,14,14,
Pushmataha,U.S. Senate,Patrick Michael Hayes,DEM,640003,0,0,12,12,
Pushmataha,U.S. Senate,Jim Rogers,DEM,640003,0,1,21,22,
Pushmataha,U.S. Senate,Connie Johnson,DEM,640003,1,1,16,18,
Pushmataha,U.S. House,Earl Everett,DEM,640003,1,1,30,32,02
Pushmataha,U.S. House,Joshua Harris-Till,DEM,640003,0,1,19,20,02
Pushmataha,Governor,Dax Ewbank,REP,640003,0,0,4,4,
Pushmataha,Governor,Chad Moody,REP,640003,0,0,5,5,
Pushmataha,Governor,Mary Fallin,REP,640003,0,0,12,12,
Pushmataha,Superintendent of Public Instruction,Brian Kelly,REP,640003,0,0,4,4,
Pushmataha,Superintendent of Public Instruction,Janet Costello Barresi,REP,640003,0,0,6,6,
Pushmataha,Superintendent of Public Instruction,Joy Hofmeister,REP,640003,0,0,10,10,
Pushmataha,Insurance Commissioner,Bill Viner,REP,640003,0,0,5,5,
Pushmataha,Insurance Commissioner,John Doak,REP,640003,0,0,14,14,
Pushmataha,Corporation Commissioner,Todd Hiett,REP,640003,0,0,14,14,
Pushmataha,Corporation Commissioner,Cliff Branan,REP,640003,0,0,4,4,
Pushmataha,U.S. Senate,Evelyn Rogers,REP,640003,0,0,0,0,
Pushmataha,U.S. Senate,Rob Moye,REP,640003,0,0,0,0,
Pushmataha,U.S. Senate,D. Jean Mcbride-Samuels,REP,640003,0,0,0,0,
Pushmataha,U.S. Senate,Jim Inhofe,REP,640003,0,0,14,14,
Pushmataha,U.S. Senate,Erick Paul Wyatt,REP,640003,0,0,7,7,
Pushmataha,U.S. Senate,Andy Craig,REP,640003,0,0,1,1,
Pushmataha,U.S. Senate,T. Shannon,REP,640003,0,0,10,10,
Pushmataha,U.S. Senate,Randy Brogdon,REP,640003,0,0,0,0,
Pushmataha,U.S. Senate,Eric Mccray,REP,640003,0,0,0,0,
Pushmataha,U.S. Senate,Kevin Crow,REP,640003,0,0,0,0,
Pushmataha,U.S. Senate,James Lankford,REP,640003,0,0,8,8,
Pushmataha,U.S. Senate,Jason Weger,REP,640003,0,0,2,2,
Pushmataha,U.S. House,Darrel Robertson,REP,640003,0,0,1,1,02
Pushmataha,U.S. House,Markwayne Mullin,REP,640003,0,0,20,20,02
Pushmataha,State Senate,Joseph Silk,REP,640003,0,0,13,13,5
Pushmataha,State Senate,Brent Shain,REP,640003,0,0,5,5,5
Pushmataha,Superintendent of Public Instruction,John Cox,DEM,640004,2,7,60,69,
Pushmataha,Superintendent of Public Instruction,Jack Jr.,DEM,640004,0,3,14,17,
Pushmataha,Superintendent of Public Instruction,Ivan Holmes,DEM,640004,0,0,8,8,
Pushmataha,Superintendent of Public Instruction,Freda Deskin,DEM,640004,0,3,48,51,
Pushmataha,U.S. Senate,Patrick Michael Hayes,DEM,640004,0,1,21,22,
Pushmataha,U.S. Senate,Jim Rogers,DEM,640004,1,8,73,82,
Pushmataha,U.S. Senate,Connie Johnson,DEM,640004,0,3,30,33,
Pushmataha,U.S. House,Earl Everett,DEM,640004,1,6,72,79,02
Pushmataha,U.S. House,Joshua Harris-Till,DEM,640004,0,4,43,47,02
Pushmataha,Governor,Dax Ewbank,REP,640004,0,0,2,2,
Pushmataha,Governor,Chad Moody,REP,640004,0,0,4,4,
Pushmataha,Governor,Mary Fallin,REP,640004,1,3,20,24,
Pushmataha,Superintendent of Public Instruction,Brian Kelly,REP,640004,0,0,5,5,
Pushmataha,Superintendent of Public Instruction,Janet Costello Barresi,REP,640004,0,0,8,8,
Pushmataha,Superintendent of Public Instruction,Joy Hofmeister,REP,640004,1,3,14,18,
Pushmataha,Insurance Commissioner,Bill Viner,REP,640004,0,0,6,6,
Pushmataha,Insurance Commissioner,John Doak,REP,640004,1,3,18,22,
Pushmataha,Corporation Commissioner,Todd Hiett,REP,640004,0,1,13,14,
Pushmataha,Corporation Commissioner,Cliff Branan,REP,640004,1,2,11,14,
Pushmataha,U.S. Senate,Evelyn Rogers,REP,640004,0,0,0,0,
Pushmataha,U.S. Senate,Rob Moye,REP,640004,0,0,0,0,
Pushmataha,U.S. Senate,D. Jean Mcbride-Samuels,REP,640004,0,0,0,0,
Pushmataha,U.S. Senate,Jim Inhofe,REP,640004,1,3,26,30,
Pushmataha,U.S. Senate,Erick Paul Wyatt,REP,640004,0,0,1,1,
Pushmataha,U.S. Senate,Andy Craig,REP,640004,0,0,0,0,
Pushmataha,U.S. Senate,T. Shannon,REP,640004,0,3,7,10,
Pushmataha,U.S. Senate,Randy Brogdon,REP,640004,0,0,4,4,
Pushmataha,U.S. Senate,Eric Mccray,REP,640004,0,0,1,1,
Pushmataha,U.S. Senate,Kevin Crow,REP,640004,0,0,0,0,
Pushmataha,U.S. Senate,James Lankford,REP,640004,0,0,12,12,
Pushmataha,U.S. Senate,Jason Weger,REP,640004,0,0,3,3,
Pushmataha,U.S. House,Darrel Robertson,REP,640004,0,0,3,3,02
Pushmataha,U.S. House,Markwayne Mullin,REP,640004,1,3,24,28,02
Pushmataha,State Senate,Joseph Silk,REP,640004,0,3,22,25,5
Pushmataha,State Senate,Brent Shain,REP,640004,1,0,5,6,5
Pushmataha,Superintendent of Public Instruction,John Cox,DEM,640005,0,2,13,15,
Pushmataha,Superintendent of Public Instruction,Jack Jr.,DEM,640005,0,0,5,5,
Pushmataha,Superintendent of Public Instruction,Ivan Holmes,DEM,640005,0,0,3,3,
Pushmataha,Superintendent of Public Instruction,Freda Deskin,DEM,640005,0,0,15,15,
Pushmataha,U.S. Senate,Patrick Michael Hayes,DEM,640005,0,1,10,11,
Pushmataha,U.S. Senate,Jim Rogers,DEM,640005,0,1,12,13,
Pushmataha,U.S. Senate,Connie Johnson,DEM,640005,0,0,10,10,
Pushmataha,U.S. House,Earl Everett,DEM,640005,0,2,22,24,02
Pushmataha,U.S. House,Joshua Harris-Till,DEM,640005,0,0,9,9,02
Pushmataha,Governor,Dax Ewbank,REP,640005,0,0,0,0,
Pushmataha,Governor,Chad Moody,REP,640005,0,0,0,0,
Pushmataha,Governor,Mary Fallin,REP,640005,0,0,5,5,
Pushmataha,Superintendent of Public Instruction,Brian Kelly,REP,640005,0,0,3,3,
Pushmataha,Superintendent of Public Instruction,Janet Costello Barresi,REP,640005,0,0,1,1,
Pushmataha,Superintendent of Public Instruction,Joy Hofmeister,REP,640005,0,0,1,1,
Pushmataha,Insurance Commissioner,Bill Viner,REP,640005,0,0,1,1,
Pushmataha,Insurance Commissioner,John Doak,REP,640005,0,0,4,4,
Pushmataha,Corporation Commissioner,Todd Hiett,REP,640005,0,0,1,1,
Pushmataha,Corporation Commissioner,Cliff Branan,REP,640005,0,0,4,4,
Pushmataha,U.S. Senate,Evelyn Rogers,REP,640005,0,0,1,1,
Pushmataha,U.S. Senate,Rob Moye,REP,640005,0,0,0,0,
Pushmataha,U.S. Senate,D. Jean Mcbride-Samuels,REP,640005,0,0,0,0,
Pushmataha,U.S. Senate,Jim Inhofe,REP,640005,0,0,4,4,
Pushmataha,U.S. Senate,Erick Paul Wyatt,REP,640005,0,0,0,0,
Pushmataha,U.S. Senate,Andy Craig,REP,640005,0,0,0,0,
Pushmataha,U.S. Senate,T. Shannon,REP,640005,0,0,2,2,
Pushmataha,U.S. Senate,Randy Brogdon,REP,640005,0,0,0,0,
Pushmataha,U.S. Senate,Eric Mccray,REP,640005,0,0,0,0,
Pushmataha,U.S. Senate,Kevin Crow,REP,640005,0,0,0,0,
Pushmataha,U.S. Senate,James Lankford,REP,640005,0,0,3,3,
Pushmataha,U.S. Senate,Jason Weger,REP,640005,0,0,0,0,
Pushmataha,U.S. House,Darrel Robertson,REP,640005,0,0,0,0,02
Pushmataha,U.S. House,Markwayne Mullin,REP,640005,0,0,5,5,02
Pushmataha,State Senate,Joseph Silk,REP,640005,0,0,4,4,5
Pushmataha,State Senate,Brent Shain,REP,640005,0,0,1,1,5
Pushmataha,Superintendent of Public Instruction,John Cox,DEM,640007,0,3,38,41,
Pushmataha,Superintendent of Public Instruction,Jack Jr.,DEM,640007,0,0,4,4,
Pushmataha,Superintendent of Public Instruction,Ivan Holmes,DEM,640007,0,0,1,1,
Pushmataha,Superintendent of Public Instruction,Freda Deskin,DEM,640007,0,0,26,26,
Pushmataha,U.S. Senate,Patrick Michael Hayes,DEM,640007,0,0,16,16,
Pushmataha,U.S. Senate,Jim Rogers,DEM,640007,0,0,26,26,
Pushmataha,U.S. Senate,Connie Johnson,DEM,640007,0,1,17,18,
Pushmataha,U.S. House,Earl Everett,DEM,640007,0,0,29,29,02
Pushmataha,U.S. House,Joshua Harris-Till,DEM,640007,0,0,24,24,02
Pushmataha,Governor,Dax Ewbank,REP,640007,0,0,0,0,
Pushmataha,Governor,Chad Moody,REP,640007,0,0,0,0,
Pushmataha,Governor,Mary Fallin,REP,640007,0,0,6,6,
Pushmataha,Superintendent of Public Instruction,Brian Kelly,REP,640007,0,0,1,1,
Pushmataha,Superintendent of Public Instruction,Janet Costello Barresi,REP,640007,0,0,0,0,
Pushmataha,Superintendent of Public Instruction,Joy Hofmeister,REP,640007,0,0,3,3,
Pushmataha,Insurance Commissioner,Bill Viner,REP,640007,0,0,0,0,
Pushmataha,Insurance Commissioner,John Doak,REP,640007,0,0,4,4,
Pushmataha,Corporation Commissioner,Todd Hiett,REP,640007,0,0,3,3,
Pushmataha,Corporation Commissioner,Cliff Branan,REP,640007,0,0,1,1,
Pushmataha,U.S. Senate,Evelyn Rogers,REP,640007,0,0,0,0,
Pushmataha,U.S. Senate,Rob Moye,REP,640007,0,0,0,0,
Pushmataha,U.S. Senate,D. Jean Mcbride-Samuels,REP,640007,0,0,0,0,
Pushmataha,U.S. Senate,Jim Inhofe,REP,640007,0,0,4,4,
Pushmataha,U.S. Senate,Erick Paul Wyatt,REP,640007,0,0,1,1,
Pushmataha,U.S. Senate,Andy Craig,REP,640007,0,0,1,1,
Pushmataha,U.S. Senate,T. Shannon,REP,640007,0,0,1,1,
Pushmataha,U.S. Senate,Randy Brogdon,REP,640007,0,0,0,0,
Pushmataha,U.S. Senate,Eric Mccray,REP,640007,0,0,0,0,
Pushmataha,U.S. Senate,Kevin Crow,REP,640007,0,0,0,0,
Pushmataha,U.S. Senate,James Lankford,REP,640007,0,0,3,3,
Pushmataha,U.S. Senate,Jason Weger,REP,640007,0,0,0,0,
Pushmataha,U.S. House,Darrel Robertson,REP,640007,0,0,0,0,02
Pushmataha,U.S. House,Markwayne Mullin,REP,640007,0,0,6,6,02
Pushmataha,State Senate,Joseph Silk,REP,640007,0,0,6,6,5
Pushmataha,State Senate,Brent Shain,REP,640007,0,0,0,0,5
Pushmataha,Superintendent of Public Instruction,John Cox,DEM,640008,0,0,8,8,
Pushmataha,Superintendent of Public Instruction,Jack Jr.,DEM,640008,0,0,1,1,
Pushmataha,Superintendent of Public Instruction,Ivan Holmes,DEM,640008,0,0,1,1,
Pushmataha,Superintendent of Public Instruction,Freda Deskin,DEM,640008,0,0,7,7,
Pushmataha,U.S. Senate,Patrick Michael Hayes,DEM,640008,0,0,2,2,
Pushmataha,U.S. Senate,Jim Rogers,DEM,640008,0,0,12,12,
Pushmataha,U.S. Senate,Connie Johnson,DEM,640008,0,0,2,2,
Pushmataha,U.S. House,Earl Everett,DEM,640008,0,0,9,9,02
Pushmataha,U.S. House,Joshua Harris-Till,DEM,640008,0,0,5,5,02
Pushmataha,Governor,Dax Ewbank,REP,640008,0,0,0,0,
Pushmataha,Governor,Chad Moody,REP,640008,0,0,0,0,
Pushmataha,Governor,Mary Fallin,REP,640008,0,0,6,6,
Pushmataha,Superintendent of Public Instruction,Brian Kelly,REP,640008,0,0,1,1,
Pushmataha,Superintendent of Public Instruction,Janet Costello Barresi,REP,640008,0,0,1,1,
Pushmataha,Superintendent of Public Instruction,Joy Hofmeister,REP,640008,0,0,3,3,
Pushmataha,Insurance Commissioner,Bill Viner,REP,640008,0,0,0,0,
Pushmataha,Insurance Commissioner,John Doak,REP,640008,0,0,6,6,
Pushmataha,Corporation Commissioner,Todd Hiett,REP,640008,0,0,1,1,
Pushmataha,Corporation Commissioner,Cliff Branan,REP,640008,0,0,5,5,
Pushmataha,U.S. Senate,Evelyn Rogers,REP,640008,0,0,0,0,
Pushmataha,U.S. Senate,Rob Moye,REP,640008,0,0,0,0,
Pushmataha,U.S. Senate,D. Jean Mcbride-Samuels,REP,640008,0,0,0,0,
Pushmataha,U.S. Senate,Jim Inhofe,REP,640008,0,0,6,6,
Pushmataha,U.S. Senate,Erick Paul Wyatt,REP,640008,0,0,0,0,
Pushmataha,U.S. Senate,Andy Craig,REP,640008,0,0,0,0,
Pushmataha,U.S. Senate,T. Shannon,REP,640008,0,0,3,3,
Pushmataha,U.S. Senate,Randy Brogdon,REP,640008,0,0,0,0,
Pushmataha,U.S. Senate,Eric Mccray,REP,640008,0,0,1,1,
Pushmataha,U.S. Senate,Kevin Crow,REP,640008,0,0,0,0,
Pushmataha,U.S. Senate,James Lankford,REP,640008,0,0,2,2,
Pushmataha,U.S. Senate,Jason Weger,REP,640008,0,0,0,0,
Pushmataha,U.S. House,Darrel Robertson,REP,640008,0,0,0,0,02
Pushmataha,U.S. House,Markwayne Mullin,REP,640008,0,0,7,7,02
Pushmataha,State Senate,Joseph Silk,REP,640008,0,0,4,4,5
Pushmataha,State Senate,Brent Shain,REP,640008,0,0,2,2,5
Pushmataha,Superintendent of Public Instruction,John Cox,DEM,640009,2,0,57,59,
Pushmataha,Superintendent of Public Instruction,Jack Jr.,DEM,640009,0,1,10,11,
Pushmataha,Superintendent of Public Instruction,Ivan Holmes,DEM,640009,0,0,6,6,
Pushmataha,Superintendent of Public Instruction,Freda Deskin,DEM,640009,0,1,34,35,
Pushmataha,U.S. Senate,Patrick Michael Hayes,DEM,640009,0,1,34,35,
Pushmataha,U.S. Senate,Jim Rogers,DEM,640009,0,0,43,43,
Pushmataha,U.S. Senate,Connie Johnson,DEM,640009,0,1,23,24,
Pushmataha,U.S. House,Earl Everett,DEM,640009,0,1,51,52,02
Pushmataha,U.S. House,Joshua Harris-Till,DEM,640009,2,1,42,45,02
Pushmataha,Governor,Dax Ewbank,REP,640009,0,0,0,0,
Pushmataha,Governor,Chad Moody,REP,640009,0,0,4,4,
Pushmataha,Governor,Mary Fallin,REP,640009,0,0,5,5,
Pushmataha,Superintendent of Public Instruction,Brian Kelly,REP,640009,0,0,3,3,
Pushmataha,Superintendent of Public Instruction,Janet Costello Barresi,REP,640009,0,0,4,4,
Pushmataha,Superintendent of Public Instruction,Joy Hofmeister,REP,640009,0,0,3,3,
Pushmataha,Insurance Commissioner,Bill Viner,REP,640009,0,0,4,4,
Pushmataha,Insurance Commissioner,John Doak,REP,640009,0,0,4,4,
Pushmataha,Corporation Commissioner,Todd Hiett,REP,640009,0,0,4,4,
Pushmataha,Corporation Commissioner,Cliff Branan,REP,640009,0,0,3,3,
Pushmataha,U.S. Senate,Evelyn Rogers,REP,640009,0,0,2,2,
Pushmataha,U.S. Senate,Rob Moye,REP,640009,0,0,0,0,
Pushmataha,U.S. Senate,D. Jean Mcbride-Samuels,REP,640009,0,0,0,0,
Pushmataha,U.S. Senate,Jim Inhofe,REP,640009,0,0,7,7,
Pushmataha,U.S. Senate,Erick Paul Wyatt,REP,640009,0,0,1,1,
Pushmataha,U.S. Senate,Andy Craig,REP,640009,0,0,1,1,
Pushmataha,U.S. Senate,T. Shannon,REP,640009,0,0,7,7,
Pushmataha,U.S. Senate,Randy Brogdon,REP,640009,0,0,0,0,
Pushmataha,U.S. Senate,Eric Mccray,REP,640009,0,0,0,0,
Pushmataha,U.S. Senate,Kevin Crow,REP,640009,0,0,0,0,
Pushmataha,U.S. Senate,James Lankford,REP,640009,0,0,2,2,
Pushmataha,U.S. Senate,Jason Weger,REP,640009,0,0,0,0,
Pushmataha,U.S. House,Darrel Robertson,REP,640009,0,0,3,3,02
Pushmataha,U.S. House,Markwayne Mullin,REP,640009,0,0,6,6,02
Pushmataha,State Senate,Joseph Silk,REP,640009,0,0,4,4,5
Pushmataha,State Senate,Brent Shain,REP,640009,0,0,4,4,5
Pushmataha,Superintendent of Public Instruction,John Cox,DEM,640010,0,1,8,9,
Pushmataha,Superintendent of Public Instruction,Jack Jr.,DEM,640010,0,0,1,1,
Pushmataha,Superintendent of Public Instruction,Ivan Holmes,DEM,640010,0,0,3,3,
Pushmataha,Superintendent of Public Instruction,Freda Deskin,DEM,640010,0,0,10,10,
Pushmataha,U.S. Senate,Patrick Michael Hayes,DEM,640010,0,0,5,5,
Pushmataha,U.S. Senate,Jim Rogers,DEM,640010,0,1,8,9,
Pushmataha,U.S. Senate,Connie Johnson,DEM,640010,0,0,7,7,
Pushmataha,U.S. House,Earl Everett,DEM,640010,0,0,14,14,02
Pushmataha,U.S. House,Joshua Harris-Till,DEM,640010,0,1,6,7,02
Pushmataha,Governor,Dax Ewbank,REP,640010,0,0,0,0,
Pushmataha,Governor,Chad Moody,REP,640010,0,0,3,3,
Pushmataha,Governor,Mary Fallin,REP,640010,0,0,12,12,
Pushmataha,Superintendent of Public Instruction,Brian Kelly,REP,640010,0,0,7,7,
Pushmataha,Superintendent of Public Instruction,Janet Costello Barresi,REP,640010,0,0,0,0,
Pushmataha,Superintendent of Public Instruction,Joy Hofmeister,REP,640010,0,0,8,8,
Pushmataha,Insurance Commissioner,Bill Viner,REP,640010,0,0,6,6,
Pushmataha,Insurance Commissioner,John Doak,REP,640010,0,0,6,6,
Pushmataha,Corporation Commissioner,Todd Hiett,REP,640010,0,0,4,4,
Pushmataha,Corporation Commissioner,Cliff Branan,REP,640010,0,0,9,9,
Pushmataha,U.S. Senate,Evelyn Rogers,REP,640010,0,0,0,0,
Pushmataha,U.S. Senate,Rob Moye,REP,640010,0,0,1,1,
Pushmataha,U.S. Senate,D. Jean Mcbride-Samuels,REP,640010,0,0,0,0,
Pushmataha,U.S. Senate,Jim Inhofe,REP,640010,0,0,14,14,
Pushmataha,U.S. Senate,Erick Paul Wyatt,REP,640010,0,0,0,0,
Pushmataha,U.S. Senate,Andy Craig,REP,640010,0,0,1,1,
Pushmataha,U.S. Senate,T. Shannon,REP,640010,0,0,9,9,
Pushmataha,U.S. Senate,Randy Brogdon,REP,640010,0,0,0,0,
Pushmataha,U.S. Senate,Eric Mccray,REP,640010,0,0,0,0,
Pushmataha,U.S. Senate,Kevin Crow,REP,640010,0,0,0,0,
Pushmataha,U.S. Senate,James Lankford,REP,640010,0,0,4,4,
Pushmataha,U.S. Senate,Jason Weger,REP,640010,0,0,0,0,
Pushmataha,U.S. House,Darrel Robertson,REP,640010,0,0,1,1,02
Pushmataha,U.S. House,Markwayne Mullin,REP,640010,0,0,14,14,02
Pushmataha,State Senate,Joseph Silk,REP,640010,0,0,8,8,5
Pushmataha,State Senate,Brent Shain,REP,640010,0,0,7,7,5
Pushmataha,Superintendent of Public Instruction,John Cox,DEM,640011,2,0,57,59,
Pushmataha,Superintendent of Public Instruction,Jack Jr.,DEM,640011,0,1,15,16,
Pushmataha,Superintendent of Public Instruction,Ivan Holmes,DEM,640011,0,0,4,4,
Pushmataha,Superintendent of Public Instruction,Freda Deskin,DEM,640011,0,1,28,29,
Pushmataha,U.S. Senate,Patrick Michael Hayes,DEM,640011,0,0,29,29,
Pushmataha,U.S. Senate,Jim Rogers,DEM,640011,0,2,45,47,
Pushmataha,U.S. Senate,Connie Johnson,DEM,640011,2,0,17,19,
Pushmataha,U.S. House,Earl Everett,DEM,640011,0,1,59,60,02
Pushmataha,U.S. House,Joshua Harris-Till,DEM,640011,2,0,29,31,02
Pushmataha,Governor,Dax Ewbank,REP,640011,0,0,0,0,
Pushmataha,Governor,Chad Moody,REP,640011,1,0,3,4,
Pushmataha,Governor,Mary Fallin,REP,640011,0,1,10,11,
Pushmataha,Superintendent of Public Instruction,Brian Kelly,REP,640011,0,0,5,5,
Pushmataha,Superintendent of Public Instruction,Janet Costello Barresi,REP,640011,0,1,4,5,
Pushmataha,Superintendent of Public Instruction,Joy Hofmeister,REP,640011,1,0,4,5,
Pushmataha,Insurance Commissioner,Bill Viner,REP,640011,0,1,6,7,
Pushmataha,Insurance Commissioner,John Doak,REP,640011,1,0,7,8,
Pushmataha,Corporation Commissioner,Todd Hiett,REP,640011,1,0,5,6,
Pushmataha,Corporation Commissioner,Cliff Branan,REP,640011,0,1,8,9,
Pushmataha,U.S. Senate,Evelyn Rogers,REP,640011,0,1,1,2,
Pushmataha,U.S. Senate,Rob Moye,REP,640011,0,0,1,1,
Pushmataha,U.S. Senate,D. Jean Mcbride-Samuels,REP,640011,0,0,0,0,
Pushmataha,U.S. Senate,Jim Inhofe,REP,640011,1,0,9,10,
Pushmataha,U.S. Senate,Erick Paul Wyatt,REP,640011,0,0,2,2,
Pushmataha,U.S. Senate,Andy Craig,REP,640011,0,1,0,1,
Pushmataha,U.S. Senate,T. Shannon,REP,640011,1,0,4,5,
Pushmataha,U.S. Senate,Randy Brogdon,REP,640011,0,0,0,0,
Pushmataha,U.S. Senate,Eric Mccray,REP,640011,0,0,1,1,
Pushmataha,U.S. Senate,Kevin Crow,REP,640011,0,0,0,0,
Pushmataha,U.S. Senate,James Lankford,REP,640011,0,0,8,8,
Pushmataha,U.S. Senate,Jason Weger,REP,640011,0,0,0,0,
Pushmataha,U.S. House,Darrel Robertson,REP,640011,0,0,2,2,02
Pushmataha,U.S. House,Markwayne Mullin,REP,640011,1,1,11,13,02
Pushmataha,State Senate,Joseph Silk,REP,640011,1,0,4,5,5
Pushmataha,State Senate,Brent Shain,REP,640011,0,1,9,10,5
Pushmataha,Superintendent of Public Instruction,John Cox,DEM,640012,0,0,7,7,
Pushmataha,Superintendent of Public Instruction,Jack Jr.,DEM,640012,0,0,4,4,
Pushmataha,Superintendent of Public Instruction,Ivan Holmes,DEM,640012,0,0,3,3,
Pushmataha,Superintendent of Public Instruction,Freda Deskin,DEM,640012,0,0,4,4,
Pushmataha,U.S. Senate,Patrick Michael Hayes,DEM,640012,0,0,4,4,
Pushmataha,U.S. Senate,Jim Rogers,DEM,640012,0,0,9,9,
Pushmataha,U.S. Senate,Connie Johnson,DEM,640012,0,0,5,5,
Pushmataha,U.S. House,Earl Everett,DEM,640012,0,0,9,9,02
Pushmataha,U.S. House,Joshua Harris-Till,DEM,640012,0,0,8,8,02
Pushmataha,Governor,Dax Ewbank,REP,640012,0,0,0,0,
Pushmataha,Governor,Chad Moody,REP,640012,0,0,0,0,
Pushmataha,Governor,Mary Fallin,REP,640012,0,0,5,5,
Pushmataha,Superintendent of Public Instruction,Brian Kelly,REP,640012,0,0,3,3,
Pushmataha,Superintendent of Public Instruction,Janet Costello Barresi,REP,640012,0,0,1,1,
Pushmataha,Superintendent of Public Instruction,Joy Hofmeister,REP,640012,0,0,1,1,
Pushmataha,Insurance Commissioner,Bill Viner,REP,640012,0,0,2,2,
Pushmataha,Insurance Commissioner,John Doak,REP,640012,0,0,3,3,
Pushmataha,Corporation Commissioner,Todd Hiett,REP,640012,0,0,4,4,
Pushmataha,Corporation Commissioner,Cliff Branan,REP,640012,0,0,1,1,
Pushmataha,U.S. Senate,Evelyn Rogers,REP,640012,0,0,1,1,
Pushmataha,U.S. Senate,Rob Moye,REP,640012,0,0,0,0,
Pushmataha,U.S. Senate,D. Jean Mcbride-Samuels,REP,640012,0,0,0,0,
Pushmataha,U.S. Senate,Jim Inhofe,REP,640012,0,0,4,4,
Pushmataha,U.S. Senate,Erick Paul Wyatt,REP,640012,0,0,0,0,
Pushmataha,U.S. Senate,Andy Craig,REP,640012,0,0,1,1,
Pushmataha,U.S. Senate,T. Shannon,REP,640012,0,0,0,0,
Pushmataha,U.S. Senate,Randy Brogdon,REP,640012,0,0,0,0,
Pushmataha,U.S. Senate,Eric Mccray,REP,640012,0,0,0,0,
Pushmataha,U.S. Senate,Kevin Crow,REP,640012,0,0,0,0,
Pushmataha,U.S. Senate,James Lankford,REP,640012,0,0,4,4,
Pushmataha,U.S. Senate,Jason Weger,REP,640012,0,0,0,0,
Pushmataha,U.S. House,Darrel Robertson,REP,640012,0,0,1,1,02
Pushmataha,U.S. House,Markwayne Mullin,REP,640012,0,0,4,4,02
Pushmataha,State Senate,Joseph Silk,REP,640012,0,0,0,0,5
Pushmataha,State Senate,Brent Shain,REP,640012,0,0,5,5,5
Pushmataha,Superintendent of Public Instruction,John Cox,DEM,640013,0,0,6,6,
Pushmataha,Superintendent of Public Instruction,Jack Jr.,DEM,640013,0,0,1,1,
Pushmataha,Superintendent of Public Instruction,Ivan Holmes,DEM,640013,0,0,1,1,
Pushmataha,Superintendent of Public Instruction,Freda Deskin,DEM,640013,0,0,3,3,
Pushmataha,U.S. Senate,Patrick Michael Hayes,DEM,640013,0,0,4,4,
Pushmataha,U.S. Senate,Jim Rogers,DEM,640013,0,0,4,4,
Pushmataha,U.S. Senate,Connie Johnson,DEM,640013,0,0,2,2,
Pushmataha,U.S. House,Earl Everett,DEM,640013,0,0,7,7,02
Pushmataha,U.S. House,Joshua Harris-Till,DEM,640013,0,0,4,4,02
Pushmataha,Governor,Dax Ewbank,REP,640013,0,0,0,0,
Pushmataha,Governor,Chad Moody,REP,640013,0,0,3,3,
Pushmataha,Governor,Mary Fallin,REP,640013,0,0,9,9,
Pushmataha,Superintendent of Public Instruction,Brian Kelly,REP,640013,0,0,8,8,
Pushmataha,Superintendent of Public Instruction,Janet Costello Barresi,REP,640013,0,0,0,0,
Pushmataha,Superintendent of Public Instruction,Joy Hofmeister,REP,640013,0,0,4,4,
Pushmataha,Insurance Commissioner,Bill Viner,REP,640013,0,0,5,5,
Pushmataha,Insurance Commissioner,John Doak,REP,640013,0,0,4,4,
Pushmataha,Corporation Commissioner,Todd Hiett,REP,640013,0,0,7,7,
Pushmataha,Corporation Commissioner,Cliff Branan,REP,640013,0,0,4,4,
Pushmataha,U.S. Senate,Evelyn Rogers,REP,640013,0,0,0,0,
Pushmataha,U.S. Senate,Rob Moye,REP,640013,0,0,0,0,
Pushmataha,U.S. Senate,D. Jean Mcbride-Samuels,REP,640013,0,0,0,0,
Pushmataha,U.S. Senate,Jim Inhofe,REP,640013,0,0,10,10,
Pushmataha,U.S. Senate,Erick Paul Wyatt,REP,640013,0,0,0,0,
Pushmataha,U.S. Senate,Andy Craig,REP,640013,0,0,0,0,
Pushmataha,U.S. Senate,T. Shannon,REP,640013,0,0,2,2,
Pushmataha,U.S. Senate,Randy Brogdon,REP,640013,0,0,2,2,
Pushmataha,U.S. Senate,Eric Mccray,REP,640013,0,0,1,1,
Pushmataha,U.S. Senate,Kevin Crow,REP,640013,0,0,0,0,
Pushmataha,U.S. Senate,James Lankford,REP,640013,0,0,6,6,
Pushmataha,U.S. Senate,Jason Weger,REP,640013,0,0,0,0,
Pushmataha,U.S. House,Darrel Robertson,REP,640013,0,0,4,4,02
Pushmataha,U.S. House,Markwayne Mullin,REP,640013,0,0,8,8,02
Pushmataha,State Senate,Joseph Silk,REP,640013,0,0,6,6,5
Pushmataha,State Senate,Brent Shain,REP,640013,0,0,4,4,5
Pushmataha,Superintendent of Public Instruction,John Cox,DEM,640014,0,1,6,7,
Pushmataha,Superintendent of Public Instruction,Jack Jr.,DEM,640014,0,0,3,3,
Pushmataha,Superintendent of Public Instruction,Ivan Holmes,DEM,640014,0,0,3,3,
Pushmataha,Superintendent of Public Instruction,Freda Deskin,DEM,640014,0,0,5,5,
Pushmataha,U.S. Senate,Patrick Michael Hayes,DEM,640014,0,0,2,2,
Pushmataha,U.S. Senate,Jim Rogers,DEM,640014,0,1,12,13,
Pushmataha,U.S. Senate,Connie Johnson,DEM,640014,0,0,3,3,
Pushmataha,U.S. House,Earl Everett,DEM,640014,0,0,12,12,02
Pushmataha,U.S. House,Joshua Harris-Till,DEM,640014,0,1,5,6,02
Pushmataha,Governor,Dax Ewbank,REP,640014,0,0,0,0,
Pushmataha,Governor,Chad Moody,REP,640014,0,0,0,0,
Pushmataha,Governor,Mary Fallin,REP,640014,0,0,7,7,
Pushmataha,Superintendent of Public Instruction,Brian Kelly,REP,640014,0,0,2,2,
Pushmataha,Superintendent of Public Instruction,Janet Costello Barresi,REP,640014,0,0,3,3,
Pushmataha,Superintendent of Public Instruction,Joy Hofmeister,REP,640014,0,0,2,2,
Pushmataha,Insurance Commissioner,Bill Viner,REP,640014,0,0,0,0,
Pushmataha,Insurance Commissioner,John Doak,REP,640014,0,0,4,4,
Pushmataha,Corporation Commissioner,Todd Hiett,REP,640014,0,0,1,1,
Pushmataha,Corporation Commissioner,Cliff Branan,REP,640014,0,0,4,4,
Pushmataha,U.S. Senate,Evelyn Rogers,REP,640014,0,0,1,1,
Pushmataha,U.S. Senate,Rob Moye,REP,640014,0,0,0,0,
Pushmataha,U.S. Senate,D. Jean Mcbride-Samuels,REP,640014,0,0,0,0,
Pushmataha,U.S. Senate,Jim Inhofe,REP,640014,0,0,6,6,
Pushmataha,U.S. Senate,Erick Paul Wyatt,REP,640014,0,0,0,0,
Pushmataha,U.S. Senate,Andy Craig,REP,640014,0,0,0,0,
Pushmataha,U.S. Senate,T. Shannon,REP,640014,0,0,2,2,
Pushmataha,U.S. Senate,Randy Brogdon,REP,640014,0,0,0,0,
Pushmataha,U.S. Senate,Eric Mccray,REP,640014,0,0,0,0,
Pushmataha,U.S. Senate,Kevin Crow,REP,640014,0,0,1,1,
Pushmataha,U.S. Senate,James Lankford,REP,640014,0,0,4,4,
Pushmataha,U.S. Senate,Jason Weger,REP,640014,0,0,0,0,
Pushmataha,U.S. House,Darrel Robertson,REP,640014,0,0,1,1,02
Pushmataha,U.S. House,Markwayne Mullin,REP,640014,0,0,6,6,02
Pushmataha,State Senate,Joseph Silk,REP,640014,0,0,1,1,5
Pushmataha,State Senate,Brent Shain,REP,640014,0,0,4,4,5
Pushmataha,Superintendent of Public Instruction,John Cox,DEM,640015,6,4,128,138,
Pushmataha,Superintendent of Public Instruction,Jack Jr.,DEM,640015,1,1,46,48,
Pushmataha,Superintendent of Public Instruction,Ivan Holmes,DEM,640015,2,1,18,21,
Pushmataha,Superintendent of Public Instruction,Freda Deskin,DEM,640015,3,1,75,79,
Pushmataha,U.S. Senate,Patrick Michael Hayes,DEM,640015,1,3,76,80,
Pushmataha,U.S. Senate,Jim Rogers,DEM,640015,6,2,112,120,
Pushmataha,U.S. Senate,Connie Johnson,DEM,640015,5,2,57,64,
Pushmataha,U.S. House,Earl Everett,DEM,640015,9,6,152,167,02
Pushmataha,U.S. House,Joshua Harris-Till,DEM,640015,3,1,88,92,02
Pushmataha,Governor,Dax Ewbank,REP,640015,0,0,1,1,
Pushmataha,Governor,Chad Moody,REP,640015,2,0,3,5,
Pushmataha,Governor,Mary Fallin,REP,640015,0,0,17,17,
Pushmataha,Superintendent of Public Instruction,Brian Kelly,REP,640015,2,0,6,8,
Pushmataha,Superintendent of Public Instruction,Janet Costello Barresi,REP,640015,0,0,10,10,
Pushmataha,Superintendent of Public Instruction,Joy Hofmeister,REP,640015,0,0,3,3,
Pushmataha,Insurance Commissioner,Bill Viner,REP,640015,0,0,5,5,
Pushmataha,Insurance Commissioner,John Doak,REP,640015,2,0,9,11,
Pushmataha,Corporation Commissioner,Todd Hiett,REP,640015,0,0,12,12,
Pushmataha,Corporation Commissioner,Cliff Branan,REP,640015,2,0,6,8,
Pushmataha,U.S. Senate,Evelyn Rogers,REP,640015,0,0,2,2,
Pushmataha,U.S. Senate,Rob Moye,REP,640015,1,0,1,2,
Pushmataha,U.S. Senate,D. Jean Mcbride-Samuels,REP,640015,0,0,0,0,
Pushmataha,U.S. Senate,Jim Inhofe,REP,640015,0,0,16,16,
Pushmataha,U.S. Senate,Erick Paul Wyatt,REP,640015,1,0,0,1,
Pushmataha,U.S. Senate,Andy Craig,REP,640015,0,0,1,1,
Pushmataha,U.S. Senate,T. Shannon,REP,640015,0,0,6,6,
Pushmataha,U.S. Senate,Randy Brogdon,REP,640015,0,0,2,2,
Pushmataha,U.S. Senate,Eric Mccray,REP,640015,1,0,0,1,
Pushmataha,U.S. Senate,Kevin Crow,REP,640015,1,0,1,2,
Pushmataha,U.S. Senate,James Lankford,REP,640015,0,0,10,10,
Pushmataha,U.S. Senate,Jason Weger,REP,640015,0,0,0,0,
Pushmataha,U.S. House,Darrel Robertson,REP,640015,0,0,4,4,02
Pushmataha,U.S. House,Markwayne Mullin,REP,640015,2,0,16,18,02
Pushmataha,State Senate,Joseph Silk,REP,640015,1,0,10,11,5
Pushmataha,State Senate,Brent Shain,REP,640015,1,0,7,8,5
Pushmataha,Superintendent of Public Instruction,John Cox,DEM,640016,0,0,31,31,
Pushmataha,Superintendent of Public Instruction,Jack Jr.,DEM,640016,1,0,4,5,
Pushmataha,Superintendent of Public Instruction,Ivan Holmes,DEM,640016,0,0,7,7,
Pushmataha,Superintendent of Public Instruction,Freda Deskin,DEM,640016,0,0,14,14,
Pushmataha,U.S. Senate,Patrick Michael Hayes,DEM,640016,0,0,13,13,
Pushmataha,U.S. Senate,Jim Rogers,DEM,640016,1,0,28,29,
Pushmataha,U.S. Senate,Connie Johnson,DEM,640016,0,0,10,10,
Pushmataha,U.S. House,Earl Everett,DEM,640016,0,0,31,31,02
Pushmataha,U.S. House,Joshua Harris-Till,DEM,640016,1,0,18,19,02
Pushmataha,Governor,Dax Ewbank,REP,640016,0,0,2,2,
Pushmataha,Governor,Chad Moody,REP,640016,0,0,5,5,
Pushmataha,Governor,Mary Fallin,REP,640016,1,0,9,10,
Pushmataha,Superintendent of Public Instruction,Brian Kelly,REP,640016,0,0,3,3,
Pushmataha,Superintendent of Public Instruction,Janet Costello Barresi,REP,640016,0,0,4,4,
Pushmataha,Superintendent of Public Instruction,Joy Hofmeister,REP,640016,1,0,8,9,
Pushmataha,Insurance Commissioner,Bill Viner,REP,640016,0,0,8,8,
Pushmataha,Insurance Commissioner,John Doak,REP,640016,1,0,7,8,
Pushmataha,Corporation Commissioner,Todd Hiett,REP,640016,0,0,9,9,
Pushmataha,Corporation Commissioner,Cliff Branan,REP,640016,1,0,4,5,
Pushmataha,U.S. Senate,Evelyn Rogers,REP,640016,0,0,1,1,
Pushmataha,U.S. Senate,Rob Moye,REP,640016,0,0,1,1,
Pushmataha,U.S. Senate,D. Jean Mcbride-Samuels,REP,640016,0,0,0,0,
Pushmataha,U.S. Senate,Jim Inhofe,REP,640016,1,0,12,13,
Pushmataha,U.S. Senate,Erick Paul Wyatt,REP,640016,0,0,1,1,
Pushmataha,U.S. Senate,Andy Craig,REP,640016,0,0,1,1,
Pushmataha,U.S. Senate,T. Shannon,REP,640016,0,0,6,6,
Pushmataha,U.S. Senate,Randy Brogdon,REP,640016,0,0,0,0,
Pushmataha,U.S. Senate,Eric Mccray,REP,640016,0,0,0,0,
Pushmataha,U.S. Senate,Kevin Crow,REP,640016,0,0,0,0,
Pushmataha,U.S. Senate,James Lankford,REP,640016,1,0,7,8,
Pushmataha,U.S. Senate,Jason Weger,REP,640016,0,0,1,1,
Pushmataha,U.S. House,Darrel Robertson,REP,640016,0,0,5,5,02
Pushmataha,U.S. House,Markwayne Mullin,REP,640016,1,0,10,11,02
Pushmataha,State Senate,Joseph Silk,REP,640016,1,0,5,6,5
Pushmataha,State Senate,Brent Shain,REP,640016,0,0,10,10,5
Pushmataha,Superintendent of Public Instruction,John Cox,DEM,640017,0,0,27,27,
Pushmataha,Superintendent of Public Instruction,Jack Jr.,DEM,640017,0,0,9,9,
Pushmataha,Superintendent of Public Instruction,Ivan Holmes,DEM,640017,0,0,8,8,
Pushmataha,Superintendent of Public Instruction,Freda Deskin,DEM,640017,1,0,31,32,
Pushmataha,U.S. Senate,Patrick Michael Hayes,DEM,640017,0,0,15,15,
Pushmataha,U.S. Senate,Jim Rogers,DEM,640017,0,0,38,38,
Pushmataha,U.S. Senate,Connie Johnson,DEM,640017,1,0,20,21,
Pushmataha,U.S. House,Earl Everett,DEM,640017,1,0,45,46,02
Pushmataha,U.S. House,Joshua Harris-Till,DEM,640017,0,0,26,26,02
Pushmataha,Governor,Dax Ewbank,REP,640017,0,0,0,0,
Pushmataha,Governor,Chad Moody,REP,640017,0,0,2,2,
Pushmataha,Governor,Mary Fallin,REP,640017,0,0,7,7,
Pushmataha,Superintendent of Public Instruction,Brian Kelly,REP,640017,0,0,4,4,
Pushmataha,Superintendent of Public Instruction,Janet Costello Barresi,REP,640017,0,0,1,1,
Pushmataha,Superintendent of Public Instruction,Joy Hofmeister,REP,640017,0,0,4,4,
Pushmataha,Insurance Commissioner,Bill Viner,REP,640017,0,0,1,1,
Pushmataha,Insurance Commissioner,John Doak,REP,640017,0,0,7,7,
Pushmataha,Corporation Commissioner,Todd Hiett,REP,640017,0,0,3,3,
Pushmataha,Corporation Commissioner,Cliff Branan,REP,640017,0,0,6,6,
Pushmataha,U.S. Senate,Evelyn Rogers,REP,640017,0,0,0,0,
Pushmataha,U.S. Senate,Rob Moye,REP,640017,0,0,0,0,
Pushmataha,U.S. Senate,D. Jean Mcbride-Samuels,REP,640017,0,0,0,0,
Pushmataha,U.S. Senate,Jim Inhofe,REP,640017,0,0,9,9,
Pushmataha,U.S. Senate,Erick Paul Wyatt,REP,640017,0,0,0,0,
Pushmataha,U.S. Senate,Andy Craig,REP,640017,0,0,0,0,
Pushmataha,U.S. Senate,T. Shannon,REP,640017,0,0,5,5,
Pushmataha,U.S. Senate,Randy Brogdon,REP,640017,0,0,2,2,
Pushmataha,U.S. Senate,Eric Mccray,REP,640017,0,0,0,0,
Pushmataha,U.S. Senate,Kevin Crow,REP,640017,0,0,1,1,
Pushmataha,U.S. Senate,James Lankford,REP,640017,0,0,1,1,
Pushmataha,U.S. Senate,Jason Weger,REP,640017,0,0,0,0,
Pushmataha,U.S. House,Darrel Robertson,REP,640017,0,0,5,5,02
Pushmataha,U.S. House,Markwayne Mullin,REP,640017,0,0,4,4,02
Pushmataha,State Senate,Joseph Silk,REP,640017,0,0,3,3,5
Pushmataha,State Senate,Brent Shain,REP,640017,0,0,5,5,5
Roger Mills,Superintendent of Public Instruction,John Cox,DEM,650101,0,8,18,26,
Roger Mills,Superintendent of Public Instruction,Jack Jr.,DEM,650101,0,0,7,7,
Roger Mills,Superintendent of Public Instruction,Ivan Holmes,DEM,650101,1,0,10,11,
Roger Mills,Superintendent of Public Instruction,Freda Deskin,DEM,650101,0,2,16,18,
Roger Mills,U.S. Senate,Patrick Michael Hayes,DEM,650101,0,2,21,23,
Roger Mills,U.S. Senate,Jim Rogers,DEM,650101,0,4,17,21,
Roger Mills,U.S. Senate,Connie Johnson,DEM,650101,0,3,12,15,
Roger Mills,Governor,Dax Ewbank,REP,650101,0,0,2,2,
Roger Mills,Governor,Chad Moody,REP,650101,0,0,1,1,
Roger Mills,Governor,Mary Fallin,REP,650101,3,1,30,34,
Roger Mills,Superintendent of Public Instruction,Brian Kelly,REP,650101,0,0,4,4,
Roger Mills,Superintendent of Public Instruction,Janet Costello Barresi,REP,650101,2,0,2,4,
Roger Mills,Superintendent of Public Instruction,Joy Hofmeister,REP,650101,1,1,26,28,
Roger Mills,Insurance Commissioner,Bill Viner,REP,650101,0,0,3,3,
Roger Mills,Insurance Commissioner,John Doak,REP,650101,1,1,28,30,
Roger Mills,Corporation Commissioner,Todd Hiett,REP,650101,0,1,17,18,
Roger Mills,Corporation Commissioner,Cliff Branan,REP,650101,1,0,14,15,
Roger Mills,U.S. Senate,Evelyn Rogers,REP,650101,0,0,1,1,
Roger Mills,U.S. Senate,Rob Moye,REP,650101,0,0,0,0,
Roger Mills,U.S. Senate,D. Jean Mcbride-Samuels,REP,650101,0,0,0,0,
Roger Mills,U.S. Senate,Jim Inhofe,REP,650101,3,1,30,34,
Roger Mills,U.S. Senate,Erick Paul Wyatt,REP,650101,0,0,2,2,
Roger Mills,U.S. Senate,Andy Craig,REP,650101,0,0,0,0,
Roger Mills,U.S. Senate,T. Shannon,REP,650101,2,1,10,13,
Roger Mills,U.S. Senate,Randy Brogdon,REP,650101,0,0,1,1,
Roger Mills,U.S. Senate,Eric Mccray,REP,650101,0,0,0,0,
Roger Mills,U.S. Senate,Kevin Crow,REP,650101,0,0,0,0,
Roger Mills,U.S. Senate,James Lankford,REP,650101,1,0,22,23,
Roger Mills,U.S. Senate,Jason Weger,REP,650101,0,0,0,0,
Roger Mills,U.S. House,Timothy Ray Murray,REP,650101,0,0,0,0,03
Roger Mills,U.S. House,Robert Hubbard,REP,650101,0,0,2,2,03
Roger Mills,U.S. House,Frank Lucas,REP,650101,3,1,30,34,03
Roger Mills,State Senate,Darcy Jech,REP,650101,0,1,11,12,26
Roger Mills,State Senate,Dan Gambill,REP,650101,3,0,20,23,26
Roger Mills,Superintendent of Public Instruction,John Cox,DEM,650102,1,5,23,29,
Roger Mills,Superintendent of Public Instruction,Jack Jr.,DEM,650102,2,2,6,10,
Roger Mills,Superintendent of Public Instruction,Ivan Holmes,DEM,650102,0,0,12,12,
Roger Mills,Superintendent of Public Instruction,Freda Deskin,DEM,650102,0,0,16,16,
Roger Mills,U.S. Senate,Patrick Michael Hayes,DEM,650102,0,3,16,19,
Roger Mills,U.S. Senate,Jim Rogers,DEM,650102,1,3,27,31,
Roger Mills,U.S. Senate,Connie Johnson,DEM,650102,2,1,13,16,
Roger Mills,Governor,Dax Ewbank,REP,650102,0,0,0,0,
Roger Mills,Governor,Chad Moody,REP,650102,1,1,5,7,
Roger Mills,Governor,Mary Fallin,REP,650102,0,5,16,21,
Roger Mills,Superintendent of Public Instruction,Brian Kelly,REP,650102,0,1,8,9,
Roger Mills,Superintendent of Public Instruction,Janet Costello Barresi,REP,650102,0,1,0,1,
Roger Mills,Superintendent of Public Instruction,Joy Hofmeister,REP,650102,1,4,14,19,
Roger Mills,Insurance Commissioner,Bill Viner,REP,650102,0,2,5,7,
Roger Mills,Insurance Commissioner,John Doak,REP,650102,1,4,16,21,
Roger Mills,Corporation Commissioner,Todd Hiett,REP,650102,0,3,14,17,
Roger Mills,Corporation Commissioner,Cliff Branan,REP,650102,1,3,8,12,
Roger Mills,U.S. Senate,Evelyn Rogers,REP,650102,0,1,1,2,
Roger Mills,U.S. Senate,Rob Moye,REP,650102,0,0,0,0,
Roger Mills,U.S. Senate,D. Jean Mcbride-Samuels,REP,650102,0,0,0,0,
Roger Mills,U.S. Senate,Jim Inhofe,REP,650102,1,5,20,26,
Roger Mills,U.S. Senate,Erick Paul Wyatt,REP,650102,0,0,1,1,
Roger Mills,U.S. Senate,Andy Craig,REP,650102,0,0,0,0,
Roger Mills,U.S. Senate,T. Shannon,REP,650102,0,3,10,13,
Roger Mills,U.S. Senate,Randy Brogdon,REP,650102,0,0,0,0,
Roger Mills,U.S. Senate,Eric Mccray,REP,650102,0,0,0,0,
Roger Mills,U.S. Senate,Kevin Crow,REP,650102,0,0,1,1,
Roger Mills,U.S. Senate,James Lankford,REP,650102,1,3,10,14,
Roger Mills,U.S. Senate,Jason Weger,REP,650102,0,0,1,1,
Roger Mills,U.S. House,Timothy Ray Murray,REP,650102,0,2,1,3,03
Roger Mills,U.S. House,Robert Hubbard,REP,650102,0,1,2,3,03
Roger Mills,U.S. House,Frank Lucas,REP,650102,1,3,19,23,03
Roger Mills,State Senate,Darcy Jech,REP,650102,0,3,8,11,26
Roger Mills,State Senate,Dan Gambill,REP,650102,1,3,14,18,26
Roger Mills,Superintendent of Public Instruction,John Cox,DEM,650103,1,4,39,44,
Roger Mills,Superintendent of Public Instruction,Jack Jr.,DEM,650103,0,3,10,13,
Roger Mills,Superintendent of Public Instruction,Ivan Holmes,DEM,650103,0,2,7,9,
Roger Mills,Superintendent of Public Instruction,Freda Deskin,DEM,650103,0,2,24,26,
Roger Mills,U.S. Senate,Patrick Michael Hayes,DEM,650103,0,2,23,25,
Roger Mills,U.S. Senate,Jim Rogers,DEM,650103,1,4,27,32,
Roger Mills,U.S. Senate,Connie Johnson,DEM,650103,0,4,26,30,
Roger Mills,Governor,Dax Ewbank,REP,650103,0,1,2,3,
Roger Mills,Governor,Chad Moody,REP,650103,0,4,7,11,
Roger Mills,Governor,Mary Fallin,REP,650103,3,11,25,39,
Roger Mills,Superintendent of Public Instruction,Brian Kelly,REP,650103,0,2,10,12,
Roger Mills,Superintendent of Public Instruction,Janet Costello Barresi,REP,650103,0,0,2,2,
Roger Mills,Superintendent of Public Instruction,Joy Hofmeister,REP,650103,3,14,21,38,
Roger Mills,Insurance Commissioner,Bill Viner,REP,650103,1,0,11,12,
Roger Mills,Insurance Commissioner,John Doak,REP,650103,2,15,22,39,
Roger Mills,Corporation Commissioner,Todd Hiett,REP,650103,2,8,17,27,
Roger Mills,Corporation Commissioner,Cliff Branan,REP,650103,1,7,17,25,
Roger Mills,U.S. Senate,Evelyn Rogers,REP,650103,0,0,0,0,
Roger Mills,U.S. Senate,Rob Moye,REP,650103,0,1,0,1,
Roger Mills,U.S. Senate,D. Jean Mcbride-Samuels,REP,650103,0,0,1,1,
Roger Mills,U.S. Senate,Jim Inhofe,REP,650103,3,14,31,48,
Roger Mills,U.S. Senate,Erick Paul Wyatt,REP,650103,0,0,2,2,
Roger Mills,U.S. Senate,Andy Craig,REP,650103,0,0,3,3,
Roger Mills,U.S. Senate,T. Shannon,REP,650103,1,3,13,17,
Roger Mills,U.S. Senate,Randy Brogdon,REP,650103,0,0,0,0,
Roger Mills,U.S. Senate,Eric Mccray,REP,650103,0,0,1,1,
Roger Mills,U.S. Senate,Kevin Crow,REP,650103,0,0,0,0,
Roger Mills,U.S. Senate,James Lankford,REP,650103,2,13,16,31,
Roger Mills,U.S. Senate,Jason Weger,REP,650103,0,0,1,1,
Roger Mills,U.S. House,Timothy Ray Murray,REP,650103,0,0,1,1,03
Roger Mills,U.S. House,Robert Hubbard,REP,650103,0,0,4,4,03
Roger Mills,U.S. House,Frank Lucas,REP,650103,3,16,29,48,03
Roger Mills,State Senate,Darcy Jech,REP,650103,2,9,19,30,26
Roger Mills,State Senate,Dan Gambill,REP,650103,1,7,15,23,26
Roger Mills,Superintendent of Public Instruction,John Cox,DEM,650201,1,0,27,28,
Roger Mills,Superintendent of Public Instruction,Jack Jr.,DEM,650201,0,0,13,13,
Roger Mills,Superintendent of Public Instruction,Ivan Holmes,DEM,650201,1,1,8,10,
Roger Mills,Superintendent of Public Instruction,Freda Deskin,DEM,650201,0,0,32,32,
Roger Mills,U.S. Senate,Patrick Michael Hayes,DEM,650201,0,0,15,15,
Roger Mills,U.S. Senate,Jim Rogers,DEM,650201,2,1,34,37,
Roger Mills,U.S. Senate,Connie Johnson,DEM,650201,0,0,30,30,
Roger Mills,Governor,Dax Ewbank,REP,650201,0,0,3,3,
Roger Mills,Governor,Chad Moody,REP,650201,0,0,11,11,
Roger Mills,Governor,Mary Fallin,REP,650201,1,0,37,38,
Roger Mills,Superintendent of Public Instruction,Brian Kelly,REP,650201,0,0,9,9,
Roger Mills,Superintendent of Public Instruction,Janet Costello Barresi,REP,650201,0,0,5,5,
Roger Mills,Superintendent of Public Instruction,Joy Hofmeister,REP,650201,1,0,37,38,
Roger Mills,Insurance Commissioner,Bill Viner,REP,650201,0,0,8,8,
Roger Mills,Insurance Commissioner,John Doak,REP,650201,1,0,36,37,
Roger Mills,Corporation Commissioner,Todd Hiett,REP,650201,1,0,20,21,
Roger Mills,Corporation Commissioner,Cliff Branan,REP,650201,0,0,28,28,
Roger Mills,U.S. Senate,Evelyn Rogers,REP,650201,0,0,0,0,
Roger Mills,U.S. Senate,Rob Moye,REP,650201,0,0,1,1,
Roger Mills,U.S. Senate,D. Jean Mcbride-Samuels,REP,650201,0,0,0,0,
Roger Mills,U.S. Senate,Jim Inhofe,REP,650201,1,0,49,50,
Roger Mills,U.S. Senate,Erick Paul Wyatt,REP,650201,0,0,0,0,
Roger Mills,U.S. Senate,Andy Craig,REP,650201,0,0,0,0,
Roger Mills,U.S. Senate,T. Shannon,REP,650201,0,0,17,17,
Roger Mills,U.S. Senate,Randy Brogdon,REP,650201,0,0,0,0,
Roger Mills,U.S. Senate,Eric Mccray,REP,650201,0,0,0,0,
Roger Mills,U.S. Senate,Kevin Crow,REP,650201,0,0,0,0,
Roger Mills,U.S. Senate,James Lankford,REP,650201,1,0,35,36,
Roger Mills,U.S. Senate,Jason Weger,REP,650201,0,0,0,0,
Roger Mills,U.S. House,Timothy Ray Murray,REP,650201,0,0,2,2,03
Roger Mills,U.S. House,Robert Hubbard,REP,650201,0,0,4,4,03
Roger Mills,U.S. House,Frank Lucas,REP,650201,1,0,45,46,03
Roger Mills,State Senate,Darcy Jech,REP,650201,1,0,23,24,26
Roger Mills,State Senate,Dan Gambill,REP,650201,0,0,26,26,26
Roger Mills,Superintendent of Public Instruction,John Cox,DEM,650202,0,4,15,19,
Roger Mills,Superintendent of Public Instruction,Jack Jr.,DEM,650202,1,0,2,3,
Roger Mills,Superintendent of Public Instruction,Ivan Holmes,DEM,650202,0,4,3,7,
Roger Mills,Superintendent of Public Instruction,Freda Deskin,DEM,650202,0,5,5,10,
Roger Mills,U.S. Senate,Patrick Michael Hayes,DEM,650202,1,3,4,8,
Roger Mills,U.S. Senate,Jim Rogers,DEM,650202,0,7,13,20,
Roger Mills,U.S. Senate,Connie Johnson,DEM,650202,0,2,7,9,
Roger Mills,Governor,Dax Ewbank,REP,650202,0,0,1,1,
Roger Mills,Governor,Chad Moody,REP,650202,0,0,5,5,
Roger Mills,Governor,Mary Fallin,REP,650202,0,3,15,18,
Roger Mills,Superintendent of Public Instruction,Brian Kelly,REP,650202,0,1,6,7,
Roger Mills,Superintendent of Public Instruction,Janet Costello Barresi,REP,650202,0,0,4,4,
Roger Mills,Superintendent of Public Instruction,Joy Hofmeister,REP,650202,0,2,11,13,
Roger Mills,Insurance Commissioner,Bill Viner,REP,650202,0,1,6,7,
Roger Mills,Insurance Commissioner,John Doak,REP,650202,0,1,15,16,
Roger Mills,Corporation Commissioner,Todd Hiett,REP,650202,0,2,11,13,
Roger Mills,Corporation Commissioner,Cliff Branan,REP,650202,0,1,9,10,
Roger Mills,U.S. Senate,Evelyn Rogers,REP,650202,0,0,1,1,
Roger Mills,U.S. Senate,Rob Moye,REP,650202,0,0,1,1,
Roger Mills,U.S. Senate,D. Jean Mcbride-Samuels,REP,650202,0,0,0,0,
Roger Mills,U.S. Senate,Jim Inhofe,REP,650202,0,3,15,18,
Roger Mills,U.S. Senate,Erick Paul Wyatt,REP,650202,0,0,4,4,
Roger Mills,U.S. Senate,Andy Craig,REP,650202,0,0,1,1,
Roger Mills,U.S. Senate,T. Shannon,REP,650202,0,1,10,11,
Roger Mills,U.S. Senate,Randy Brogdon,REP,650202,0,0,0,0,
Roger Mills,U.S. Senate,Eric Mccray,REP,650202,0,0,0,0,
Roger Mills,U.S. Senate,Kevin Crow,REP,650202,0,0,0,0,
Roger Mills,U.S. Senate,James Lankford,REP,650202,0,2,10,12,
Roger Mills,U.S. Senate,Jason Weger,REP,650202,0,0,0,0,
Roger Mills,U.S. House,Timothy Ray Murray,REP,650202,0,0,0,0,03
Roger Mills,U.S. House,Robert Hubbard,REP,650202,0,0,1,1,03
Roger Mills,U.S. House,Frank Lucas,REP,650202,0,3,20,23,03
Roger Mills,State Senate,Darcy Jech,REP,650202,0,1,8,9,26
Roger Mills,State Senate,Dan Gambill,REP,650202,0,2,12,14,26
Roger Mills,Superintendent of Public Instruction,John Cox,DEM,650203,0,2,11,13,
Roger Mills,Superintendent of Public Instruction,Jack Jr.,DEM,650203,0,1,1,2,
Roger Mills,Superintendent of Public Instruction,Ivan Holmes,DEM,650203,0,0,1,1,
Roger Mills,Superintendent of Public Instruction,Freda Deskin,DEM,650203,2,0,8,10,
Roger Mills,U.S. Senate,Patrick Michael Hayes,DEM,650203,0,2,6,8,
Roger Mills,U.S. Senate,Jim Rogers,DEM,650203,1,0,6,7,
Roger Mills,U.S. Senate,Connie Johnson,DEM,650203,1,1,7,9,
Roger Mills,Governor,Dax Ewbank,REP,650203,0,1,3,4,
Roger Mills,Governor,Chad Moody,REP,650203,0,0,7,7,
Roger Mills,Governor,Mary Fallin,REP,650203,0,2,13,15,
Roger Mills,Superintendent of Public Instruction,Brian Kelly,REP,650203,0,1,9,10,
Roger Mills,Superintendent of Public Instruction,Janet Costello Barresi,REP,650203,0,0,1,1,
Roger Mills,Superintendent of Public Instruction,Joy Hofmeister,REP,650203,0,2,13,15,
Roger Mills,Insurance Commissioner,Bill Viner,REP,650203,0,2,10,12,
Roger Mills,Insurance Commissioner,John Doak,REP,650203,0,1,12,13,
Roger Mills,Corporation Commissioner,Todd Hiett,REP,650203,0,2,14,16,
Roger Mills,Corporation Commissioner,Cliff Branan,REP,650203,0,1,9,10,
Roger Mills,U.S. Senate,Evelyn Rogers,REP,650203,0,1,2,3,
Roger Mills,U.S. Senate,Rob Moye,REP,650203,0,0,0,0,
Roger Mills,U.S. Senate,D. Jean Mcbride-Samuels,REP,650203,0,0,0,0,
Roger Mills,U.S. Senate,Jim Inhofe,REP,650203,0,2,20,22,
Roger Mills,U.S. Senate,Erick Paul Wyatt,REP,650203,0,0,1,1,
Roger Mills,U.S. Senate,Andy Craig,REP,650203,0,0,0,0,
Roger Mills,U.S. Senate,T. Shannon,REP,650203,0,0,11,11,
Roger Mills,U.S. Senate,Randy Brogdon,REP,650203,0,0,1,1,
Roger Mills,U.S. Senate,Eric Mccray,REP,650203,0,0,0,0,
Roger Mills,U.S. Senate,Kevin Crow,REP,650203,0,0,0,0,
Roger Mills,U.S. Senate,James Lankford,REP,650203,0,3,9,12,
Roger Mills,U.S. Senate,Jason Weger,REP,650203,0,0,2,2,
Roger Mills,U.S. House,Timothy Ray Murray,REP,650203,0,0,2,2,03
Roger Mills,U.S. House,Robert Hubbard,REP,650203,0,0,5,5,03
Roger Mills,U.S. House,Frank Lucas,REP,650203,0,3,16,19,03
Roger Mills,State Senate,Darcy Jech,REP,650203,0,1,13,14,26
Roger Mills,State Senate,Dan Gambill,REP,650203,0,2,10,12,26
Roger Mills,Superintendent of Public Instruction,John Cox,DEM,650301,0,4,28,32,
Roger Mills,Superintendent of Public Instruction,Jack Jr.,DEM,650301,0,1,8,9,
Roger Mills,Superintendent of Public Instruction,Ivan Holmes,DEM,650301,0,0,8,8,
Roger Mills,Superintendent of Public Instruction,Freda Deskin,DEM,650301,1,2,15,18,
Roger Mills,U.S. Senate,Patrick Michael Hayes,DEM,650301,0,0,16,16,
Roger Mills,U.S. Senate,Jim Rogers,DEM,650301,1,3,27,31,
Roger Mills,U.S. Senate,Connie Johnson,DEM,650301,0,4,12,16,
Roger Mills,Governor,Dax Ewbank,REP,650301,0,0,4,4,
Roger Mills,Governor,Chad Moody,REP,650301,0,2,4,6,
Roger Mills,Governor,Mary Fallin,REP,650301,0,3,35,38,
Roger Mills,Superintendent of Public Instruction,Brian Kelly,REP,650301,0,0,11,11,
Roger Mills,Superintendent of Public Instruction,Janet Costello Barresi,REP,650301,0,0,5,5,
Roger Mills,Superintendent of Public Instruction,Joy Hofmeister,REP,650301,0,5,25,30,
Roger Mills,Insurance Commissioner,Bill Viner,REP,650301,0,1,11,12,
Roger Mills,Insurance Commissioner,John Doak,REP,650301,0,4,31,35,
Roger Mills,Corporation Commissioner,Todd Hiett,REP,650301,0,3,25,28,
Roger Mills,Corporation Commissioner,Cliff Branan,REP,650301,0,1,17,18,
Roger Mills,U.S. Senate,Evelyn Rogers,REP,650301,0,0,1,1,
Roger Mills,U.S. Senate,Rob Moye,REP,650301,0,0,0,0,
Roger Mills,U.S. Senate,D. Jean Mcbride-Samuels,REP,650301,0,0,1,1,
Roger Mills,U.S. Senate,Jim Inhofe,REP,650301,0,5,39,44,
Roger Mills,U.S. Senate,Erick Paul Wyatt,REP,650301,0,0,2,2,
Roger Mills,U.S. Senate,Andy Craig,REP,650301,0,0,0,0,
Roger Mills,U.S. Senate,T. Shannon,REP,650301,0,1,9,10,
Roger Mills,U.S. Senate,Randy Brogdon,REP,650301,0,0,1,1,
Roger Mills,U.S. Senate,Eric Mccray,REP,650301,0,0,0,0,
Roger Mills,U.S. Senate,Kevin Crow,REP,650301,0,0,2,2,
Roger Mills,U.S. Senate,James Lankford,REP,650301,0,4,30,34,
Roger Mills,U.S. Senate,Jason Weger,REP,650301,0,0,0,0,
Roger Mills,U.S. House,Timothy Ray Murray,REP,650301,0,0,0,0,03
Roger Mills,U.S. House,Robert Hubbard,REP,650301,0,0,2,2,03
Roger Mills,U.S. House,Frank Lucas,REP,650301,0,5,41,46,03
Roger Mills,State Senate,Darcy Jech,REP,650301,0,0,14,14,26
Roger Mills,State Senate,Dan Gambill,REP,650301,0,5,28,33,26
Roger Mills,Superintendent of Public Instruction,John Cox,DEM,650302,1,6,38,45,
Roger Mills,Superintendent of Public Instruction,Jack Jr.,DEM,650302,2,0,13,15,
Roger Mills,Superintendent of Public Instruction,Ivan Holmes,DEM,650302,1,0,11,12,
Roger Mills,Superintendent of Public Instruction,Freda Deskin,DEM,650302,1,0,20,21,
Roger Mills,U.S. Senate,Patrick Michael Hayes,DEM,650302,0,1,18,19,
Roger Mills,U.S. Senate,Jim Rogers,DEM,650302,3,5,39,47,
Roger Mills,U.S. Senate,Connie Johnson,DEM,650302,2,0,20,22,
Roger Mills,Governor,Dax Ewbank,REP,650302,0,1,4,5,
Roger Mills,Governor,Chad Moody,REP,650302,0,0,7,7,
Roger Mills,Governor,Mary Fallin,REP,650302,1,6,24,31,
Roger Mills,Superintendent of Public Instruction,Brian Kelly,REP,650302,0,1,13,14,
Roger Mills,Superintendent of Public Instruction,Janet Costello Barresi,REP,650302,0,1,3,4,
Roger Mills,Superintendent of Public Instruction,Joy Hofmeister,REP,650302,0,5,20,25,
Roger Mills,Insurance Commissioner,Bill Viner,REP,650302,0,2,8,10,
Roger Mills,Insurance Commissioner,John Doak,REP,650302,0,5,21,26,
Roger Mills,Corporation Commissioner,Todd Hiett,REP,650302,0,6,19,25,
Roger Mills,Corporation Commissioner,Cliff Branan,REP,650302,0,1,13,14,
Roger Mills,U.S. Senate,Evelyn Rogers,REP,650302,0,1,0,1,
Roger Mills,U.S. Senate,Rob Moye,REP,650302,0,0,1,1,
Roger Mills,U.S. Senate,D. Jean Mcbride-Samuels,REP,650302,0,0,3,3,
Roger Mills,U.S. Senate,Jim Inhofe,REP,650302,1,6,27,34,
Roger Mills,U.S. Senate,Erick Paul Wyatt,REP,650302,0,0,4,4,
Roger Mills,U.S. Senate,Andy Craig,REP,650302,0,1,1,2,
Roger Mills,U.S. Senate,T. Shannon,REP,650302,0,5,12,17,
Roger Mills,U.S. Senate,Randy Brogdon,REP,650302,0,0,0,0,
Roger Mills,U.S. Senate,Eric Mccray,REP,650302,0,0,1,1,
Roger Mills,U.S. Senate,Kevin Crow,REP,650302,0,0,0,0,
Roger Mills,U.S. Senate,James Lankford,REP,650302,0,1,21,22,
Roger Mills,U.S. Senate,Jason Weger,REP,650302,0,0,1,1,
Roger Mills,U.S. House,Timothy Ray Murray,REP,650302,0,0,0,0,03
Roger Mills,U.S. House,Robert Hubbard,REP,650302,0,1,5,6,03
Roger Mills,U.S. House,Frank Lucas,REP,650302,1,6,31,38,03
Roger Mills,State Senate,Darcy Jech,REP,650302,0,2,14,16,26
Roger Mills,State Senate,Dan Gambill,REP,650302,1,5,19,25,26
Roger Mills,Superintendent of Public Instruction,John Cox,DEM,650303,0,3,36,39,
Roger Mills,Superintendent of Public Instruction,Jack Jr.,DEM,650303,0,2,9,11,
Roger Mills,Superintendent of Public Instruction,Ivan Holmes,DEM,650303,0,1,18,19,
Roger Mills,Superintendent of Public Instruction,Freda Deskin,DEM,650303,0,3,33,36,
Roger Mills,U.S. Senate,Patrick Michael Hayes,DEM,650303,0,4,19,23,
Roger Mills,U.S. Senate,Jim Rogers,DEM,650303,0,4,40,44,
Roger Mills,U.S. Senate,Connie Johnson,DEM,650303,0,1,26,27,
Roger Mills,Governor,Dax Ewbank,REP,650303,1,1,6,8,
Roger Mills,Governor,Chad Moody,REP,650303,0,1,2,3,
Roger Mills,Governor,Mary Fallin,REP,650303,1,9,31,41,
Roger Mills,Superintendent of Public Instruction,Brian Kelly,REP,650303,0,3,8,11,
Roger Mills,Superintendent of Public Instruction,Janet Costello Barresi,REP,650303,0,1,7,8,
Roger Mills,Superintendent of Public Instruction,Joy Hofmeister,REP,650303,2,7,26,35,
Roger Mills,Insurance Commissioner,Bill Viner,REP,650303,0,0,3,3,
Roger Mills,Insurance Commissioner,John Doak,REP,650303,2,11,36,49,
Roger Mills,Corporation Commissioner,Todd Hiett,REP,650303,1,8,22,31,
Roger Mills,Corporation Commissioner,Cliff Branan,REP,650303,1,3,17,21,
Roger Mills,U.S. Senate,Evelyn Rogers,REP,650303,0,0,2,2,
Roger Mills,U.S. Senate,Rob Moye,REP,650303,0,0,0,0,
Roger Mills,U.S. Senate,D. Jean Mcbride-Samuels,REP,650303,0,0,0,0,
Roger Mills,U.S. Senate,Jim Inhofe,REP,650303,1,11,38,50,
Roger Mills,U.S. Senate,Erick Paul Wyatt,REP,650303,1,0,1,2,
Roger Mills,U.S. Senate,Andy Craig,REP,650303,0,0,0,0,
Roger Mills,U.S. Senate,T. Shannon,REP,650303,2,6,12,20,
Roger Mills,U.S. Senate,Randy Brogdon,REP,650303,0,0,1,1,
Roger Mills,U.S. Senate,Eric Mccray,REP,650303,0,0,0,0,
Roger Mills,U.S. Senate,Kevin Crow,REP,650303,0,0,0,0,
Roger Mills,U.S. Senate,James Lankford,REP,650303,0,5,27,32,
Roger Mills,U.S. Senate,Jason Weger,REP,650303,0,0,0,0,
Roger Mills,U.S. House,Timothy Ray Murray,REP,650303,0,0,0,0,03
Roger Mills,U.S. House,Robert Hubbard,REP,650303,0,0,2,2,03
Roger Mills,U.S. House,Frank Lucas,REP,650303,2,11,38,51,03
Roger Mills,State Senate,Darcy Jech,REP,650303,1,9,16,26,26
Roger Mills,State Senate,Dan Gambill,REP,650303,1,2,25,28,26
Rogers,Superintendent of Public Instruction,John Cox,DEM,660001,2,13,86,101,
Rogers,Superintendent of Public Instruction,Jack Jr.,DEM,660001,6,2,23,31,
Rogers,Superintendent of Public Instruction,Ivan Holmes,DEM,660001,0,5,11,16,
Rogers,Superintendent of Public Instruction,Freda Deskin,DEM,660001,2,7,70,79,
Rogers,U.S. Senate,Patrick Michael Hayes,DEM,660001,2,8,37,47,
Rogers,U.S. Senate,Jim Rogers,DEM,660001,4,8,84,96,
Rogers,U.S. Senate,Connie Johnson,DEM,660001,4,12,59,75,
Rogers,U.S. House,Earl Everett,DEM,660001,7,15,113,135,02
Rogers,U.S. House,Joshua Harris-Till,DEM,660001,3,12,57,72,02
Rogers,Governor,Dax Ewbank,REP,660001,1,2,12,15,
Rogers,Governor,Chad Moody,REP,660001,0,10,61,71,
Rogers,Governor,Mary Fallin,REP,660001,7,36,200,243,
Rogers,Superintendent of Public Instruction,Brian Kelly,REP,660001,4,14,81,99,
Rogers,Superintendent of Public Instruction,Janet Costello Barresi,REP,660001,0,4,49,53,
Rogers,Superintendent of Public Instruction,Joy Hofmeister,REP,660001,4,32,141,177,
Rogers,Insurance Commissioner,Bill Viner,REP,660001,3,12,68,83,
Rogers,Insurance Commissioner,John Doak,REP,660001,4,34,190,228,
Rogers,Corporation Commissioner,Todd Hiett,REP,660001,4,20,130,154,
Rogers,Corporation Commissioner,Cliff Branan,REP,660001,4,28,132,164,
Rogers,U.S. Senate,Evelyn Rogers,REP,660001,0,2,11,13,
Rogers,U.S. Senate,Rob Moye,REP,660001,0,1,8,9,
Rogers,U.S. Senate,D. Jean Mcbride-Samuels,REP,660001,0,0,3,3,
Rogers,U.S. Senate,Jim Inhofe,REP,660001,6,45,238,289,
Rogers,U.S. Senate,Erick Paul Wyatt,REP,660001,2,2,12,16,
Rogers,U.S. Senate,Andy Craig,REP,660001,0,1,3,4,
Rogers,U.S. Senate,T. Shannon,REP,660001,6,22,123,151,
Rogers,U.S. Senate,Randy Brogdon,REP,660001,0,5,25,30,
Rogers,U.S. Senate,Eric Mccray,REP,660001,0,0,1,1,
Rogers,U.S. Senate,Kevin Crow,REP,660001,0,0,4,4,
Rogers,U.S. Senate,James Lankford,REP,660001,2,21,122,145,
Rogers,U.S. Senate,Jason Weger,REP,660001,0,1,0,1,
Rogers,U.S. House,Darrel Robertson,REP,660001,1,10,61,72,02
Rogers,U.S. House,Markwayne Mullin,REP,660001,7,39,213,259,02
Rogers,Superintendent of Public Instruction,John Cox,DEM,660002,1,5,41,47,
Rogers,Superintendent of Public Instruction,Jack Jr.,DEM,660002,2,3,15,20,
Rogers,Superintendent of Public Instruction,Ivan Holmes,DEM,660002,0,1,9,10,
Rogers,Superintendent of Public Instruction,Freda Deskin,DEM,660002,0,8,32,40,
Rogers,U.S. Senate,Patrick Michael Hayes,DEM,660002,0,3,16,19,
Rogers,U.S. Senate,Jim Rogers,DEM,660002,3,8,43,54,
Rogers,U.S. Senate,Connie Johnson,DEM,660002,0,7,36,43,
Rogers,U.S. House,Earl Everett,DEM,660002,2,8,61,71,02
Rogers,U.S. House,Joshua Harris-Till,DEM,660002,1,7,30,38,02
Rogers,Governor,Dax Ewbank,REP,660002,0,2,18,20,
Rogers,Governor,Chad Moody,REP,660002,0,5,22,27,
Rogers,Governor,Mary Fallin,REP,660002,7,20,81,108,
Rogers,Superintendent of Public Instruction,Brian Kelly,REP,660002,0,8,34,42,
Rogers,Superintendent of Public Instruction,Janet Costello Barresi,REP,660002,4,5,22,31,
Rogers,Superintendent of Public Instruction,Joy Hofmeister,REP,660002,2,13,66,81,
Rogers,Insurance Commissioner,Bill Viner,REP,660002,3,8,32,43,
Rogers,Insurance Commissioner,John Doak,REP,660002,3,14,86,103,
Rogers,Corporation Commissioner,Todd Hiett,REP,660002,4,16,49,69,
Rogers,Corporation Commissioner,Cliff Branan,REP,660002,3,9,70,82,
Rogers,U.S. Senate,Evelyn Rogers,REP,660002,0,4,5,9,
Rogers,U.S. Senate,Rob Moye,REP,660002,1,0,1,2,
Rogers,U.S. Senate,D. Jean Mcbride-Samuels,REP,660002,0,0,2,2,
Rogers,U.S. Senate,Jim Inhofe,REP,660002,6,21,103,130,
Rogers,U.S. Senate,Erick Paul Wyatt,REP,660002,0,2,11,13,
Rogers,U.S. Senate,Andy Craig,REP,660002,0,0,0,0,
Rogers,U.S. Senate,T. Shannon,REP,660002,2,16,58,76,
Rogers,U.S. Senate,Randy Brogdon,REP,660002,0,1,9,10,
Rogers,U.S. Senate,Eric Mccray,REP,660002,0,0,3,3,
Rogers,U.S. Senate,Kevin Crow,REP,660002,0,0,2,2,
Rogers,U.S. Senate,James Lankford,REP,660002,4,10,49,63,
Rogers,U.S. Senate,Jason Weger,REP,660002,0,0,0,0,
Rogers,U.S. House,Darrel Robertson,REP,660002,0,1,31,32,02
Rogers,U.S. House,Markwayne Mullin,REP,660002,7,26,90,123,02
Rogers,Superintendent of Public Instruction,John Cox,DEM,660003,1,15,35,51,
Rogers,Superintendent of Public Instruction,Jack Jr.,DEM,660003,0,0,9,9,
Rogers,Superintendent of Public Instruction,Ivan Holmes,DEM,660003,0,0,5,5,
Rogers,Superintendent of Public Instruction,Freda Deskin,DEM,660003,0,5,31,36,
Rogers,U.S. Senate,Patrick Michael Hayes,DEM,660003,0,8,20,28,
Rogers,U.S. Senate,Jim Rogers,DEM,660003,0,4,42,46,
Rogers,U.S. Senate,Connie Johnson,DEM,660003,1,6,18,25,
Rogers,U.S. House,Earl Everett,DEM,660003,1,10,40,51,02
Rogers,U.S. House,Joshua Harris-Till,DEM,660003,0,6,36,42,02
Rogers,Governor,Dax Ewbank,REP,660003,0,4,17,21,
Rogers,Governor,Chad Moody,REP,660003,2,7,42,51,
Rogers,Governor,Mary Fallin,REP,660003,3,22,130,155,
Rogers,Superintendent of Public Instruction,Brian Kelly,REP,660003,0,7,49,56,
Rogers,Superintendent of Public Instruction,Janet Costello Barresi,REP,660003,1,2,24,27,
Rogers,Superintendent of Public Instruction,Joy Hofmeister,REP,660003,4,27,118,149,
Rogers,Insurance Commissioner,Bill Viner,REP,660003,0,8,45,53,
Rogers,Insurance Commissioner,John Doak,REP,660003,3,25,133,161,
Rogers,Corporation Commissioner,Todd Hiett,REP,660003,2,14,96,112,
Rogers,Corporation Commissioner,Cliff Branan,REP,660003,1,20,84,105,
Rogers,U.S. Senate,Evelyn Rogers,REP,660003,1,3,7,11,
Rogers,U.S. Senate,Rob Moye,REP,660003,0,2,6,8,
Rogers,U.S. Senate,D. Jean Mcbride-Samuels,REP,660003,0,0,4,4,
Rogers,U.S. Senate,Jim Inhofe,REP,660003,4,27,161,192,
Rogers,U.S. Senate,Erick Paul Wyatt,REP,660003,0,3,13,16,
Rogers,U.S. Senate,Andy Craig,REP,660003,0,0,6,6,
Rogers,U.S. Senate,T. Shannon,REP,660003,1,15,73,89,
Rogers,U.S. Senate,Randy Brogdon,REP,660003,0,2,20,22,
Rogers,U.S. Senate,Eric Mccray,REP,660003,0,0,0,0,
Rogers,U.S. Senate,Kevin Crow,REP,660003,0,0,2,2,
Rogers,U.S. Senate,James Lankford,REP,660003,3,16,89,108,
Rogers,U.S. Senate,Jason Weger,REP,660003,0,1,1,2,
Rogers,U.S. House,Darrel Robertson,REP,660003,1,8,48,57,02
Rogers,U.S. House,Markwayne Mullin,REP,660003,4,28,141,173,02
Rogers,Superintendent of Public Instruction,John Cox,DEM,660004,3,5,101,109,
Rogers,Superintendent of Public Instruction,Jack Jr.,DEM,660004,0,4,25,29,
Rogers,Superintendent of Public Instruction,Ivan Holmes,DEM,660004,1,2,23,26,
Rogers,Superintendent of Public Instruction,Freda Deskin,DEM,660004,0,6,95,101,
Rogers,U.S. Senate,Patrick Michael Hayes,DEM,660004,1,4,56,61,
Rogers,U.S. Senate,Jim Rogers,DEM,660004,1,8,105,114,
Rogers,U.S. Senate,Connie Johnson,DEM,660004,2,4,78,84,
Rogers,U.S. House,Earl Everett,DEM,660004,3,11,133,147,02
Rogers,U.S. House,Joshua Harris-Till,DEM,660004,1,4,89,94,02
Rogers,Governor,Dax Ewbank,REP,660004,0,9,19,28,
Rogers,Governor,Chad Moody,REP,660004,0,12,87,99,
Rogers,Governor,Mary Fallin,REP,660004,7,46,254,307,
Rogers,Superintendent of Public Instruction,Brian Kelly,REP,660004,4,21,95,120,
Rogers,Superintendent of Public Instruction,Janet Costello Barresi,REP,660004,1,11,56,68,
Rogers,Superintendent of Public Instruction,Joy Hofmeister,REP,660004,2,34,211,247,
Rogers,Insurance Commissioner,Bill Viner,REP,660004,1,18,99,118,
Rogers,Insurance Commissioner,John Doak,REP,660004,5,46,248,299,
Rogers,Corporation Commissioner,Todd Hiett,REP,660004,2,36,188,226,
Rogers,Corporation Commissioner,Cliff Branan,REP,660004,5,28,160,193,
Rogers,U.S. Senate,Evelyn Rogers,REP,660004,0,5,16,21,
Rogers,U.S. Senate,Rob Moye,REP,660004,0,2,7,9,
Rogers,U.S. Senate,D. Jean Mcbride-Samuels,REP,660004,0,0,7,7,
Rogers,U.S. Senate,Jim Inhofe,REP,660004,6,58,309,373,
Rogers,U.S. Senate,Erick Paul Wyatt,REP,660004,1,2,19,22,
Rogers,U.S. Senate,Andy Craig,REP,660004,0,2,3,5,
Rogers,U.S. Senate,T. Shannon,REP,660004,4,30,131,165,
Rogers,U.S. Senate,Randy Brogdon,REP,660004,1,6,35,42,
Rogers,U.S. Senate,Eric Mccray,REP,660004,0,0,6,6,
Rogers,U.S. Senate,Kevin Crow,REP,660004,0,0,0,0,
Rogers,U.S. Senate,James Lankford,REP,660004,2,28,186,216,
Rogers,U.S. Senate,Jason Weger,REP,660004,0,1,1,2,
Rogers,U.S. House,Darrel Robertson,REP,660004,0,10,66,76,02
Rogers,U.S. House,Markwayne Mullin,REP,660004,7,58,294,359,02
Rogers,Superintendent of Public Instruction,John Cox,DEM,660005,2,5,41,48,
Rogers,Superintendent of Public Instruction,Jack Jr.,DEM,660005,0,6,10,16,
Rogers,Superintendent of Public Instruction,Ivan Holmes,DEM,660005,0,1,7,8,
Rogers,Superintendent of Public Instruction,Freda Deskin,DEM,660005,0,9,24,33,
Rogers,U.S. Senate,Patrick Michael Hayes,DEM,660005,0,5,19,24,
Rogers,U.S. Senate,Jim Rogers,DEM,660005,0,8,29,37,
Rogers,U.S. Senate,Connie Johnson,DEM,660005,0,7,30,37,
Rogers,U.S. House,Earl Everett,DEM,660005,0,9,39,48,02
Rogers,U.S. House,Joshua Harris-Till,DEM,660005,0,9,34,43,02
Rogers,Governor,Dax Ewbank,REP,660005,0,3,12,15,
Rogers,Governor,Chad Moody,REP,660005,0,13,32,45,
Rogers,Governor,Mary Fallin,REP,660005,2,45,157,204,
Rogers,Superintendent of Public Instruction,Brian Kelly,REP,660005,1,11,42,54,
Rogers,Superintendent of Public Instruction,Janet Costello Barresi,REP,660005,0,8,33,41,
Rogers,Superintendent of Public Instruction,Joy Hofmeister,REP,660005,1,43,126,170,
Rogers,Insurance Commissioner,Bill Viner,REP,660005,0,13,48,61,
Rogers,Insurance Commissioner,John Doak,REP,660005,2,47,142,191,
Rogers,Corporation Commissioner,Todd Hiett,REP,660005,1,32,107,140,
Rogers,Corporation Commissioner,Cliff Branan,REP,660005,0,30,82,112,
Rogers,U.S. Senate,Evelyn Rogers,REP,660005,0,3,11,14,
Rogers,U.S. Senate,Rob Moye,REP,660005,0,3,4,7,
Rogers,U.S. Senate,D. Jean Mcbride-Samuels,REP,660005,0,1,3,4,
Rogers,U.S. Senate,Jim Inhofe,REP,660005,2,54,177,233,
Rogers,U.S. Senate,Erick Paul Wyatt,REP,660005,0,2,8,10,
Rogers,U.S. Senate,Andy Craig,REP,660005,0,1,2,3,
Rogers,U.S. Senate,T. Shannon,REP,660005,2,21,94,117,
Rogers,U.S. Senate,Randy Brogdon,REP,660005,0,6,7,13,
Rogers,U.S. Senate,Eric Mccray,REP,660005,0,4,0,4,
Rogers,U.S. Senate,Kevin Crow,REP,660005,0,1,0,1,
Rogers,U.S. Senate,James Lankford,REP,660005,0,29,96,125,
Rogers,U.S. Senate,Jason Weger,REP,660005,0,1,4,5,
Rogers,U.S. House,Darrel Robertson,REP,660005,0,10,26,36,02
Rogers,U.S. House,Markwayne Mullin,REP,660005,2,52,176,230,02
Rogers,Superintendent of Public Instruction,John Cox,DEM,660006,1,0,25,26,
Rogers,Superintendent of Public Instruction,Jack Jr.,DEM,660006,1,0,6,7,
Rogers,Superintendent of Public Instruction,Ivan Holmes,DEM,660006,0,0,0,0,
Rogers,Superintendent of Public Instruction,Freda Deskin,DEM,660006,1,1,20,22,
Rogers,U.S. Senate,Patrick Michael Hayes,DEM,660006,1,1,8,10,
Rogers,U.S. Senate,Jim Rogers,DEM,660006,0,0,16,16,
Rogers,U.S. Senate,Connie Johnson,DEM,660006,1,0,22,23,
Rogers,Governor,Dax Ewbank,REP,660006,1,0,16,17,
Rogers,Governor,Chad Moody,REP,660006,0,1,33,34,
Rogers,Governor,Mary Fallin,REP,660006,11,11,114,136,
Rogers,Superintendent of Public Instruction,Brian Kelly,REP,660006,0,3,29,32,
Rogers,Superintendent of Public Instruction,Janet Costello Barresi,REP,660006,2,2,21,25,
Rogers,Superintendent of Public Instruction,Joy Hofmeister,REP,660006,8,7,116,131,
Rogers,Insurance Commissioner,Bill Viner,REP,660006,3,5,35,43,
Rogers,Insurance Commissioner,John Doak,REP,660006,7,6,121,134,
Rogers,Corporation Commissioner,Todd Hiett,REP,660006,7,1,77,85,
Rogers,Corporation Commissioner,Cliff Branan,REP,660006,3,10,73,86,
Rogers,U.S. Senate,Evelyn Rogers,REP,660006,0,1,5,6,
Rogers,U.S. Senate,Rob Moye,REP,660006,0,0,4,4,
Rogers,U.S. Senate,D. Jean Mcbride-Samuels,REP,660006,0,0,1,1,
Rogers,U.S. Senate,Jim Inhofe,REP,660006,12,11,147,170,
Rogers,U.S. Senate,Erick Paul Wyatt,REP,660006,0,0,7,7,
Rogers,U.S. Senate,Andy Craig,REP,660006,0,0,1,1,
Rogers,U.S. Senate,T. Shannon,REP,660006,6,7,66,79,
Rogers,U.S. Senate,Randy Brogdon,REP,660006,4,1,27,32,
Rogers,U.S. Senate,Eric Mccray,REP,660006,0,0,1,1,
Rogers,U.S. Senate,Kevin Crow,REP,660006,0,0,0,0,
Rogers,U.S. Senate,James Lankford,REP,660006,1,4,70,75,
Rogers,U.S. Senate,Jason Weger,REP,660006,0,0,0,0,
Rogers,Superintendent of Public Instruction,John Cox,DEM,660007,1,11,65,77,
Rogers,Superintendent of Public Instruction,Jack Jr.,DEM,660007,1,3,26,30,
Rogers,Superintendent of Public Instruction,Ivan Holmes,DEM,660007,1,3,7,11,
Rogers,Superintendent of Public Instruction,Freda Deskin,DEM,660007,0,5,44,49,
Rogers,U.S. Senate,Patrick Michael Hayes,DEM,660007,0,7,46,53,
Rogers,U.S. Senate,Jim Rogers,DEM,660007,2,9,46,57,
Rogers,U.S. Senate,Connie Johnson,DEM,660007,1,8,47,56,
Rogers,U.S. House,Earl Everett,DEM,660007,2,11,88,101,02
Rogers,U.S. House,Joshua Harris-Till,DEM,660007,1,12,45,58,02
Rogers,Governor,Dax Ewbank,REP,660007,0,2,22,24,
Rogers,Governor,Chad Moody,REP,660007,2,11,45,58,
Rogers,Governor,Mary Fallin,REP,660007,4,31,192,227,
Rogers,Superintendent of Public Instruction,Brian Kelly,REP,660007,0,12,57,69,
Rogers,Superintendent of Public Instruction,Janet Costello Barresi,REP,660007,3,6,39,48,
Rogers,Superintendent of Public Instruction,Joy Hofmeister,REP,660007,3,24,163,190,
Rogers,Insurance Commissioner,Bill Viner,REP,660007,2,7,68,77,
Rogers,Insurance Commissioner,John Doak,REP,660007,3,32,175,210,
Rogers,Corporation Commissioner,Todd Hiett,REP,660007,1,20,139,160,
Rogers,Corporation Commissioner,Cliff Branan,REP,660007,5,19,117,141,
Rogers,U.S. Senate,Evelyn Rogers,REP,660007,1,0,9,10,
Rogers,U.S. Senate,Rob Moye,REP,660007,0,1,4,5,
Rogers,U.S. Senate,D. Jean Mcbride-Samuels,REP,660007,0,2,8,10,
Rogers,U.S. Senate,Jim Inhofe,REP,660007,5,39,236,280,
Rogers,U.S. Senate,Erick Paul Wyatt,REP,660007,0,2,6,8,
Rogers,U.S. Senate,Andy Craig,REP,660007,0,0,1,1,
Rogers,U.S. Senate,T. Shannon,REP,660007,2,22,120,144,
Rogers,U.S. Senate,Randy Brogdon,REP,660007,1,8,20,29,
Rogers,U.S. Senate,Eric Mccray,REP,660007,0,1,3,4,
Rogers,U.S. Senate,Kevin Crow,REP,660007,0,0,2,2,
Rogers,U.S. Senate,James Lankford,REP,660007,3,14,115,132,
Rogers,U.S. Senate,Jason Weger,REP,660007,0,0,0,0,
Rogers,U.S. House,Darrel Robertson,REP,660007,0,6,47,53,02
Rogers,U.S. House,Markwayne Mullin,REP,660007,5,39,214,258,02
Rogers,Superintendent of Public Instruction,John Cox,DEM,660008,4,10,75,89,
Rogers,Superintendent of Public Instruction,Jack Jr.,DEM,660008,1,0,10,11,
Rogers,Superintendent of Public Instruction,Ivan Holmes,DEM,660008,0,4,7,11,
Rogers,Superintendent of Public Instruction,Freda Deskin,DEM,660008,3,6,42,51,
Rogers,U.S. Senate,Patrick Michael Hayes,DEM,660008,0,7,25,32,
Rogers,U.S. Senate,Jim Rogers,DEM,660008,1,7,54,62,
Rogers,U.S. Senate,Connie Johnson,DEM,660008,6,5,52,63,
Rogers,U.S. House,Earl Everett,DEM,660008,6,11,60,77,02
Rogers,U.S. House,Joshua Harris-Till,DEM,660008,2,5,65,72,02
Rogers,Governor,Dax Ewbank,REP,660008,0,4,15,19,
Rogers,Governor,Chad Moody,REP,660008,2,13,47,62,
Rogers,Governor,Mary Fallin,REP,660008,9,25,168,202,
Rogers,Superintendent of Public Instruction,Brian Kelly,REP,660008,3,6,46,55,
Rogers,Superintendent of Public Instruction,Janet Costello Barresi,REP,660008,3,7,31,41,
Rogers,Superintendent of Public Instruction,Joy Hofmeister,REP,660008,5,29,148,182,
Rogers,Insurance Commissioner,Bill Viner,REP,660008,2,11,59,72,
Rogers,Insurance Commissioner,John Doak,REP,660008,10,29,157,196,
Rogers,Corporation Commissioner,Todd Hiett,REP,660008,7,26,126,159,
Rogers,Corporation Commissioner,Cliff Branan,REP,660008,4,16,89,109,
Rogers,U.S. Senate,Evelyn Rogers,REP,660008,1,4,8,13,
Rogers,U.S. Senate,Rob Moye,REP,660008,0,4,4,8,
Rogers,U.S. Senate,D. Jean Mcbride-Samuels,REP,660008,0,0,9,9,
Rogers,U.S. Senate,Jim Inhofe,REP,660008,9,32,204,245,
Rogers,U.S. Senate,Erick Paul Wyatt,REP,660008,1,1,8,10,
Rogers,U.S. Senate,Andy Craig,REP,660008,0,0,1,1,
Rogers,U.S. Senate,T. Shannon,REP,660008,4,22,98,124,
Rogers,U.S. Senate,Randy Brogdon,REP,660008,0,3,15,18,
Rogers,U.S. Senate,Eric Mccray,REP,660008,0,1,6,7,
Rogers,U.S. Senate,Kevin Crow,REP,660008,1,0,2,3,
Rogers,U.S. Senate,James Lankford,REP,660008,5,15,106,126,
Rogers,U.S. Senate,Jason Weger,REP,660008,1,1,1,3,
Rogers,U.S. House,Darrel Robertson,REP,660008,1,7,44,52,02
Rogers,U.S. House,Markwayne Mullin,REP,660008,11,35,188,234,02
Rogers,Superintendent of Public Instruction,John Cox,DEM,660009,0,5,24,29,
Rogers,Superintendent of Public Instruction,Jack Jr.,DEM,660009,0,1,6,7,
Rogers,Superintendent of Public Instruction,Ivan Holmes,DEM,660009,0,2,5,7,
Rogers,Superintendent of Public Instruction,Freda Deskin,DEM,660009,0,1,26,27,
Rogers,U.S. Senate,Patrick Michael Hayes,DEM,660009,0,5,10,15,
Rogers,U.S. Senate,Jim Rogers,DEM,660009,0,4,32,36,
Rogers,U.S. Senate,Connie Johnson,DEM,660009,0,1,17,18,
Rogers,U.S. House,Earl Everett,DEM,660009,0,4,37,41,02
Rogers,U.S. House,Joshua Harris-Till,DEM,660009,0,4,21,25,02
Rogers,Governor,Dax Ewbank,REP,660009,0,2,14,16,
Rogers,Governor,Chad Moody,REP,660009,0,2,17,19,
Rogers,Governor,Mary Fallin,REP,660009,4,13,117,134,
Rogers,Superintendent of Public Instruction,Brian Kelly,REP,660009,3,5,37,45,
Rogers,Superintendent of Public Instruction,Janet Costello Barresi,REP,660009,1,2,24,27,
Rogers,Superintendent of Public Instruction,Joy Hofmeister,REP,660009,0,10,88,98,
Rogers,Insurance Commissioner,Bill Viner,REP,660009,2,1,35,38,
Rogers,Insurance Commissioner,John Doak,REP,660009,2,15,102,119,
Rogers,Corporation Commissioner,Todd Hiett,REP,660009,3,12,82,97,
Rogers,Corporation Commissioner,Cliff Branan,REP,660009,1,3,61,65,
Rogers,U.S. Senate,Evelyn Rogers,REP,660009,0,0,11,11,
Rogers,U.S. Senate,Rob Moye,REP,660009,0,1,1,2,
Rogers,U.S. Senate,D. Jean Mcbride-Samuels,REP,660009,0,0,1,1,
Rogers,U.S. Senate,Jim Inhofe,REP,660009,3,14,128,145,
Rogers,U.S. Senate,Erick Paul Wyatt,REP,660009,0,2,7,9,
Rogers,U.S. Senate,Andy Craig,REP,660009,0,0,1,1,
Rogers,U.S. Senate,T. Shannon,REP,660009,3,8,48,59,
Rogers,U.S. Senate,Randy Brogdon,REP,660009,0,2,23,25,
Rogers,U.S. Senate,Eric Mccray,REP,660009,0,0,1,1,
Rogers,U.S. Senate,Kevin Crow,REP,660009,0,0,2,2,
Rogers,U.S. Senate,James Lankford,REP,660009,1,7,75,83,
Rogers,U.S. Senate,Jason Weger,REP,660009,0,0,0,0,
Rogers,U.S. House,Darrel Robertson,REP,660009,0,2,29,31,02
Rogers,U.S. House,Markwayne Mullin,REP,660009,4,14,121,139,02
Rogers,Superintendent of Public Instruction,John Cox,DEM,660010,3,0,50,53,
Rogers,Superintendent of Public Instruction,Jack Jr.,DEM,660010,0,0,17,17,
Rogers,Superintendent of Public Instruction,Ivan Holmes,DEM,660010,0,0,5,5,
Rogers,Superintendent of Public Instruction,Freda Deskin,DEM,660010,3,2,74,79,
Rogers,U.S. Senate,Patrick Michael Hayes,DEM,660010,0,1,25,26,
Rogers,U.S. Senate,Jim Rogers,DEM,660010,3,0,57,60,
Rogers,U.S. Senate,Connie Johnson,DEM,660010,3,1,64,68,
Rogers,Governor,Dax Ewbank,REP,660010,3,2,27,32,
Rogers,Governor,Chad Moody,REP,660010,2,3,55,60,
Rogers,Governor,Mary Fallin,REP,660010,10,9,311,330,
Rogers,Superintendent of Public Instruction,Brian Kelly,REP,660010,2,4,71,77,
Rogers,Superintendent of Public Instruction,Janet Costello Barresi,REP,660010,6,3,72,81,
Rogers,Superintendent of Public Instruction,Joy Hofmeister,REP,660010,6,7,244,257,
Rogers,Insurance Commissioner,Bill Viner,REP,660010,3,5,99,107,
Rogers,Insurance Commissioner,John Doak,REP,660010,11,8,254,273,
Rogers,Corporation Commissioner,Todd Hiett,REP,660010,8,8,180,196,
Rogers,Corporation Commissioner,Cliff Branan,REP,660010,4,6,177,187,
Rogers,U.S. Senate,Evelyn Rogers,REP,660010,1,0,19,20,
Rogers,U.S. Senate,Rob Moye,REP,660010,0,1,9,10,
Rogers,U.S. Senate,D. Jean Mcbride-Samuels,REP,660010,1,0,2,3,
Rogers,U.S. Senate,Jim Inhofe,REP,660010,13,11,345,369,
Rogers,U.S. Senate,Erick Paul Wyatt,REP,660010,0,2,18,20,
Rogers,U.S. Senate,Andy Craig,REP,660010,0,0,4,4,
Rogers,U.S. Senate,T. Shannon,REP,660010,6,4,169,179,
Rogers,U.S. Senate,Randy Brogdon,REP,660010,1,0,35,36,
Rogers,U.S. Senate,Eric Mccray,REP,660010,0,0,2,2,
Rogers,U.S. Senate,Kevin Crow,REP,660010,0,0,2,2,
Rogers,U.S. Senate,James Lankford,REP,660010,7,10,180,197,
Rogers,U.S. Senate,Jason Weger,REP,660010,1,0,3,4,
Rogers,Superintendent of Public Instruction,John Cox,DEM,660011,0,8,95,103,
Rogers,Superintendent of Public Instruction,Jack Jr.,DEM,660011,0,2,25,27,
Rogers,Superintendent of Public Instruction,Ivan Holmes,DEM,660011,0,0,21,21,
Rogers,Superintendent of Public Instruction,Freda Deskin,DEM,660011,0,2,79,81,
Rogers,U.S. Senate,Patrick Michael Hayes,DEM,660011,0,3,59,62,
Rogers,U.S. Senate,Jim Rogers,DEM,660011,0,5,97,102,
Rogers,U.S. Senate,Connie Johnson,DEM,660011,0,4,61,65,
Rogers,U.S. House,Earl Everett,DEM,660011,0,10,127,137,02
Rogers,U.S. House,Joshua Harris-Till,DEM,660011,0,2,87,89,02
Rogers,Governor,Dax Ewbank,REP,660011,0,1,30,31,
Rogers,Governor,Chad Moody,REP,660011,1,3,63,67,
Rogers,Governor,Mary Fallin,REP,660011,2,16,212,230,
Rogers,Superintendent of Public Instruction,Brian Kelly,REP,660011,1,3,76,80,
Rogers,Superintendent of Public Instruction,Janet Costello Barresi,REP,660011,1,1,69,71,
Rogers,Superintendent of Public Instruction,Joy Hofmeister,REP,660011,1,17,162,180,
Rogers,Insurance Commissioner,Bill Viner,REP,660011,0,4,103,107,
Rogers,Insurance Commissioner,John Doak,REP,660011,2,16,187,205,
Rogers,Corporation Commissioner,Todd Hiett,REP,660011,1,8,157,166,
Rogers,Corporation Commissioner,Cliff Branan,REP,660011,1,12,137,150,
Rogers,U.S. Senate,Evelyn Rogers,REP,660011,0,1,23,24,
Rogers,U.S. Senate,Rob Moye,REP,660011,0,0,4,4,
Rogers,U.S. Senate,D. Jean Mcbride-Samuels,REP,660011,0,0,5,5,
Rogers,U.S. Senate,Jim Inhofe,REP,660011,3,18,267,288,
Rogers,U.S. Senate,Erick Paul Wyatt,REP,660011,0,2,14,16,
Rogers,U.S. Senate,Andy Craig,REP,660011,0,0,2,2,
Rogers,U.S. Senate,T. Shannon,REP,660011,0,10,152,162,
Rogers,U.S. Senate,Randy Brogdon,REP,660011,1,0,19,20,
Rogers,U.S. Senate,Eric Mccray,REP,660011,0,0,4,4,
Rogers,U.S. Senate,Kevin Crow,REP,660011,0,0,6,6,
Rogers,U.S. Senate,James Lankford,REP,660011,2,10,128,140,
Rogers,U.S. Senate,Jason Weger,REP,660011,0,0,1,1,
Rogers,U.S. House,Darrel Robertson,REP,660011,1,1,72,74,02
Rogers,U.S. House,Markwayne Mullin,REP,660011,2,20,239,261,02
Rogers,Superintendent of Public Instruction,John Cox,DEM,660012,0,0,26,26,
Rogers,Superintendent of Public Instruction,Jack Jr.,DEM,660012,0,0,2,2,
Rogers,Superintendent of Public Instruction,Ivan Holmes,DEM,660012,0,0,3,3,
Rogers,Superintendent of Public Instruction,Freda Deskin,DEM,660012,0,0,15,15,
Rogers,U.S. Senate,Patrick Michael Hayes,DEM,660012,0,0,7,7,
Rogers,U.S. Senate,Jim Rogers,DEM,660012,0,0,19,19,
Rogers,U.S. Senate,Connie Johnson,DEM,660012,0,0,19,19,
Rogers,U.S. House,Earl Everett,DEM,660012,0,0,26,26,02
Rogers,U.S. House,Joshua Harris-Till,DEM,660012,0,0,17,17,02
Rogers,Governor,Dax Ewbank,REP,660012,1,0,4,5,
Rogers,Governor,Chad Moody,REP,660012,0,2,20,22,
Rogers,Governor,Mary Fallin,REP,660012,2,2,58,62,
Rogers,Superintendent of Public Instruction,Brian Kelly,REP,660012,0,0,22,22,
Rogers,Superintendent of Public Instruction,Janet Costello Barresi,REP,660012,1,1,12,14,
Rogers,Superintendent of Public Instruction,Joy Hofmeister,REP,660012,2,2,48,52,
Rogers,Insurance Commissioner,Bill Viner,REP,660012,0,1,21,22,
Rogers,Insurance Commissioner,John Doak,REP,660012,3,2,56,61,
Rogers,Corporation Commissioner,Todd Hiett,REP,660012,1,2,43,46,
Rogers,Corporation Commissioner,Cliff Branan,REP,660012,1,1,38,40,
Rogers,U.S. Senate,Evelyn Rogers,REP,660012,0,0,3,3,
Rogers,U.S. Senate,Rob Moye,REP,660012,0,1,1,2,
Rogers,U.S. Senate,D. Jean Mcbride-Samuels,REP,660012,0,0,1,1,
Rogers,U.S. Senate,Jim Inhofe,REP,660012,3,2,72,77,
Rogers,U.S. Senate,Erick Paul Wyatt,REP,660012,0,0,5,5,
Rogers,U.S. Senate,Andy Craig,REP,660012,0,0,2,2,
Rogers,U.S. Senate,T. Shannon,REP,660012,1,3,36,40,
Rogers,U.S. Senate,Randy Brogdon,REP,660012,0,0,5,5,
Rogers,U.S. Senate,Eric Mccray,REP,660012,0,0,1,1,
Rogers,U.S. Senate,Kevin Crow,REP,660012,0,0,2,2,
Rogers,U.S. Senate,James Lankford,REP,660012,2,0,36,38,
Rogers,U.S. Senate,Jason Weger,REP,660012,0,0,1,1,
Rogers,U.S. House,Darrel Robertson,REP,660012,0,0,9,9,02
Rogers,U.S. House,Markwayne Mullin,REP,660012,3,4,74,81,02
Rogers,Superintendent of Public Instruction,John Cox,DEM,660013,0,11,66,77,
Rogers,Superintendent of Public Instruction,Jack Jr.,DEM,660013,0,2,19,21,
Rogers,Superintendent of Public Instruction,Ivan Holmes,DEM,660013,0,2,12,14,
Rogers,Superintendent of Public Instruction,Freda Deskin,DEM,660013,0,6,31,37,
Rogers,U.S. Senate,Patrick Michael Hayes,DEM,660013,0,3,28,31,
Rogers,U.S. Senate,Jim Rogers,DEM,660013,1,9,55,65,
Rogers,U.S. Senate,Connie Johnson,DEM,660013,0,8,41,49,
Rogers,U.S. House,Earl Everett,DEM,660013,0,12,68,80,02
Rogers,U.S. House,Joshua Harris-Till,DEM,660013,1,8,49,58,02
Rogers,Governor,Dax Ewbank,REP,660013,0,2,12,14,
Rogers,Governor,Chad Moody,REP,660013,0,15,35,50,
Rogers,Governor,Mary Fallin,REP,660013,0,21,162,183,
Rogers,Superintendent of Public Instruction,Brian Kelly,REP,660013,0,9,53,62,
Rogers,Superintendent of Public Instruction,Janet Costello Barresi,REP,660013,0,4,33,37,
Rogers,Superintendent of Public Instruction,Joy Hofmeister,REP,660013,0,26,121,147,
Rogers,Insurance Commissioner,Bill Viner,REP,660013,0,10,44,54,
Rogers,Insurance Commissioner,John Doak,REP,660013,0,27,154,181,
Rogers,Corporation Commissioner,Todd Hiett,REP,660013,0,16,112,128,
Rogers,Corporation Commissioner,Cliff Branan,REP,660013,0,21,91,112,
Rogers,U.S. Senate,Evelyn Rogers,REP,660013,0,1,10,11,
Rogers,U.S. Senate,Rob Moye,REP,660013,0,1,5,6,
Rogers,U.S. Senate,D. Jean Mcbride-Samuels,REP,660013,0,0,1,1,
Rogers,U.S. Senate,Jim Inhofe,REP,660013,0,36,185,221,
Rogers,U.S. Senate,Erick Paul Wyatt,REP,660013,0,1,5,6,
Rogers,U.S. Senate,Andy Craig,REP,660013,0,1,3,4,
Rogers,U.S. Senate,T. Shannon,REP,660013,0,15,82,97,
Rogers,U.S. Senate,Randy Brogdon,REP,660013,0,3,16,19,
Rogers,U.S. Senate,Eric Mccray,REP,660013,0,0,4,4,
Rogers,U.S. Senate,Kevin Crow,REP,660013,0,0,3,3,
Rogers,U.S. Senate,James Lankford,REP,660013,0,19,103,122,
Rogers,U.S. Senate,Jason Weger,REP,660013,0,0,0,0,
Rogers,U.S. House,Darrel Robertson,REP,660013,0,8,38,46,02
Rogers,U.S. House,Markwayne Mullin,REP,660013,0,31,171,202,02
Rogers,Superintendent of Public Instruction,John Cox,DEM,660014,0,4,41,45,
Rogers,Superintendent of Public Instruction,Jack Jr.,DEM,660014,2,4,13,19,
Rogers,Superintendent of Public Instruction,Ivan Holmes,DEM,660014,0,0,9,9,
Rogers,Superintendent of Public Instruction,Freda Deskin,DEM,660014,0,3,38,41,
Rogers,U.S. Senate,Patrick Michael Hayes,DEM,660014,1,2,28,31,
Rogers,U.S. Senate,Jim Rogers,DEM,660014,0,4,35,39,
Rogers,U.S. Senate,Connie Johnson,DEM,660014,1,4,37,42,
Rogers,U.S. House,Earl Everett,DEM,660014,1,5,48,54,02
Rogers,U.S. House,Joshua Harris-Till,DEM,660014,1,4,45,50,02
Rogers,Governor,Dax Ewbank,REP,660014,1,4,12,17,
Rogers,Governor,Chad Moody,REP,660014,3,5,51,59,
Rogers,Governor,Mary Fallin,REP,660014,6,23,192,221,
Rogers,Superintendent of Public Instruction,Brian Kelly,REP,660014,1,5,42,48,
Rogers,Superintendent of Public Instruction,Janet Costello Barresi,REP,660014,1,7,38,46,
Rogers,Superintendent of Public Instruction,Joy Hofmeister,REP,660014,9,20,176,205,
Rogers,Insurance Commissioner,Bill Viner,REP,660014,2,10,57,69,
Rogers,Insurance Commissioner,John Doak,REP,660014,7,21,176,204,
Rogers,Corporation Commissioner,Todd Hiett,REP,660014,9,18,123,150,
Rogers,Corporation Commissioner,Cliff Branan,REP,660014,2,14,118,134,
Rogers,U.S. Senate,Evelyn Rogers,REP,660014,1,4,12,17,
Rogers,U.S. Senate,Rob Moye,REP,660014,0,0,3,3,
Rogers,U.S. Senate,D. Jean Mcbride-Samuels,REP,660014,0,0,3,3,
Rogers,U.S. Senate,Jim Inhofe,REP,660014,9,27,227,263,
Rogers,U.S. Senate,Erick Paul Wyatt,REP,660014,1,1,11,13,
Rogers,U.S. Senate,Andy Craig,REP,660014,0,0,5,5,
Rogers,U.S. Senate,T. Shannon,REP,660014,6,16,111,133,
Rogers,U.S. Senate,Randy Brogdon,REP,660014,0,0,9,9,
Rogers,U.S. Senate,Eric Mccray,REP,660014,0,0,2,2,
Rogers,U.S. Senate,Kevin Crow,REP,660014,0,0,2,2,
Rogers,U.S. Senate,James Lankford,REP,660014,5,17,127,149,
Rogers,U.S. Senate,Jason Weger,REP,660014,0,0,2,2,
Rogers,U.S. House,Darrel Robertson,REP,660014,1,4,48,53,02
Rogers,U.S. House,Markwayne Mullin,REP,660014,10,29,210,249,02
Rogers,Superintendent of Public Instruction,John Cox,DEM,660015,0,1,63,64,
Rogers,Superintendent of Public Instruction,Jack Jr.,DEM,660015,0,0,20,20,
Rogers,Superintendent of Public Instruction,Ivan Holmes,DEM,660015,0,0,8,8,
Rogers,Superintendent of Public Instruction,Freda Deskin,DEM,660015,1,0,69,70,
Rogers,U.S. Senate,Patrick Michael Hayes,DEM,660015,0,0,26,26,
Rogers,U.S. Senate,Jim Rogers,DEM,660015,0,0,83,83,
Rogers,U.S. Senate,Connie Johnson,DEM,660015,1,1,48,50,
Rogers,U.S. House,Earl Everett,DEM,660015,0,0,107,107,02
Rogers,U.S. House,Joshua Harris-Till,DEM,660015,1,1,44,46,02
Rogers,Governor,Dax Ewbank,REP,660015,1,0,21,22,
Rogers,Governor,Chad Moody,REP,660015,0,2,57,59,
Rogers,Governor,Mary Fallin,REP,660015,6,7,194,207,
Rogers,Superintendent of Public Instruction,Brian Kelly,REP,660015,1,2,43,46,
Rogers,Superintendent of Public Instruction,Janet Costello Barresi,REP,660015,1,0,43,44,
Rogers,Superintendent of Public Instruction,Joy Hofmeister,REP,660015,5,7,187,199,
Rogers,Insurance Commissioner,Bill Viner,REP,660015,1,3,80,84,
Rogers,Insurance Commissioner,John Doak,REP,660015,6,5,180,191,
Rogers,Corporation Commissioner,Todd Hiett,REP,660015,4,6,137,147,
Rogers,Corporation Commissioner,Cliff Branan,REP,660015,3,3,126,132,
Rogers,U.S. Senate,Evelyn Rogers,REP,660015,0,0,15,15,
Rogers,U.S. Senate,Rob Moye,REP,660015,0,0,4,4,
Rogers,U.S. Senate,D. Jean Mcbride-Samuels,REP,660015,1,0,5,6,
Rogers,U.S. Senate,Jim Inhofe,REP,660015,3,8,234,245,
Rogers,U.S. Senate,Erick Paul Wyatt,REP,660015,1,1,15,17,
Rogers,U.S. Senate,Andy Craig,REP,660015,0,0,0,0,
Rogers,U.S. Senate,T. Shannon,REP,660015,4,4,124,132,
Rogers,U.S. Senate,Randy Brogdon,REP,660015,0,0,21,21,
Rogers,U.S. Senate,Eric Mccray,REP,660015,0,0,1,1,
Rogers,U.S. Senate,Kevin Crow,REP,660015,0,0,2,2,
Rogers,U.S. Senate,James Lankford,REP,660015,4,5,124,133,
Rogers,U.S. Senate,Jason Weger,REP,660015,0,0,1,1,
Rogers,U.S. House,Darrel Robertson,REP,660015,1,2,44,47,02
Rogers,U.S. House,Markwayne Mullin,REP,660015,6,7,227,240,02
Rogers,Superintendent of Public Instruction,John Cox,DEM,660017,0,1,39,40,
Rogers,Superintendent of Public Instruction,Jack Jr.,DEM,660017,1,0,4,5,
Rogers,Superintendent of Public Instruction,Ivan Holmes,DEM,660017,0,0,6,6,
Rogers,Superintendent of Public Instruction,Freda Deskin,DEM,660017,0,3,31,34,
Rogers,U.S. Senate,Patrick Michael Hayes,DEM,660017,1,1,21,23,
Rogers,U.S. Senate,Jim Rogers,DEM,660017,0,0,37,37,
Rogers,U.S. Senate,Connie Johnson,DEM,660017,0,3,18,21,
Rogers,U.S. House,Earl Everett,DEM,660017,0,2,42,44,02
Rogers,U.S. House,Joshua Harris-Till,DEM,660017,1,2,29,32,02
Rogers,Governor,Dax Ewbank,REP,660017,0,3,8,11,
Rogers,Governor,Chad Moody,REP,660017,0,5,23,28,
Rogers,Governor,Mary Fallin,REP,660017,0,16,116,132,
Rogers,Superintendent of Public Instruction,Brian Kelly,REP,660017,0,7,25,32,
Rogers,Superintendent of Public Instruction,Janet Costello Barresi,REP,660017,0,1,33,34,
Rogers,Superintendent of Public Instruction,Joy Hofmeister,REP,660017,0,15,88,103,
Rogers,Insurance Commissioner,Bill Viner,REP,660017,0,3,40,43,
Rogers,Insurance Commissioner,John Doak,REP,660017,0,19,105,124,
Rogers,Corporation Commissioner,Todd Hiett,REP,660017,0,13,73,86,
Rogers,Corporation Commissioner,Cliff Branan,REP,660017,0,10,66,76,
Rogers,U.S. Senate,Evelyn Rogers,REP,660017,0,2,3,5,
Rogers,U.S. Senate,Rob Moye,REP,660017,0,1,5,6,
Rogers,U.S. Senate,D. Jean Mcbride-Samuels,REP,660017,0,0,2,2,
Rogers,U.S. Senate,Jim Inhofe,REP,660017,0,20,128,148,
Rogers,U.S. Senate,Erick Paul Wyatt,REP,660017,0,1,9,10,
Rogers,U.S. Senate,Andy Craig,REP,660017,0,0,0,0,
Rogers,U.S. Senate,T. Shannon,REP,660017,0,7,73,80,
Rogers,U.S. Senate,Randy Brogdon,REP,660017,0,3,11,14,
Rogers,U.S. Senate,Eric Mccray,REP,660017,0,1,2,3,
Rogers,U.S. Senate,Kevin Crow,REP,660017,0,0,3,3,
Rogers,U.S. Senate,James Lankford,REP,660017,0,13,57,70,
Rogers,U.S. Senate,Jason Weger,REP,660017,0,0,1,1,
Rogers,U.S. House,Darrel Robertson,REP,660017,0,0,27,27,02
Rogers,U.S. House,Markwayne Mullin,REP,660017,0,24,121,145,02
Rogers,Superintendent of Public Instruction,John Cox,DEM,660018,0,7,74,81,
Rogers,Superintendent of Public Instruction,Jack Jr.,DEM,660018,1,1,26,28,
Rogers,Superintendent of Public Instruction,Ivan Holmes,DEM,660018,0,0,11,11,
Rogers,Superintendent of Public Instruction,Freda Deskin,DEM,660018,1,7,63,71,
Rogers,U.S. Senate,Patrick Michael Hayes,DEM,660018,0,3,36,39,
Rogers,U.S. Senate,Jim Rogers,DEM,660018,0,6,75,81,
Rogers,U.S. Senate,Connie Johnson,DEM,660018,2,6,61,69,
Rogers,U.S. House,Earl Everett,DEM,660018,0,7,95,102,02
Rogers,U.S. House,Joshua Harris-Till,DEM,660018,2,8,70,80,02
Rogers,Governor,Dax Ewbank,REP,660018,1,1,26,28,
Rogers,Governor,Chad Moody,REP,660018,3,7,56,66,
Rogers,Governor,Mary Fallin,REP,660018,5,29,263,297,
Rogers,Superintendent of Public Instruction,Brian Kelly,REP,660018,0,5,56,61,
Rogers,Superintendent of Public Instruction,Janet Costello Barresi,REP,660018,1,5,46,52,
Rogers,Superintendent of Public Instruction,Joy Hofmeister,REP,660018,7,28,243,278,
Rogers,Insurance Commissioner,Bill Viner,REP,660018,1,10,87,98,
Rogers,Insurance Commissioner,John Doak,REP,660018,6,26,240,272,
Rogers,Corporation Commissioner,Todd Hiett,REP,660018,2,17,182,201,
Rogers,Corporation Commissioner,Cliff Branan,REP,660018,4,18,157,179,
Rogers,U.S. Senate,Evelyn Rogers,REP,660018,1,2,13,16,
Rogers,U.S. Senate,Rob Moye,REP,660018,0,0,2,2,
Rogers,U.S. Senate,D. Jean Mcbride-Samuels,REP,660018,1,0,6,7,
Rogers,U.S. Senate,Jim Inhofe,REP,660018,7,33,307,347,
Rogers,U.S. Senate,Erick Paul Wyatt,REP,660018,0,2,18,20,
Rogers,U.S. Senate,Andy Craig,REP,660018,1,0,3,4,
Rogers,U.S. Senate,T. Shannon,REP,660018,1,14,161,176,
Rogers,U.S. Senate,Randy Brogdon,REP,660018,0,3,24,27,
Rogers,U.S. Senate,Eric Mccray,REP,660018,0,0,1,1,
Rogers,U.S. Senate,Kevin Crow,REP,660018,1,0,3,4,
Rogers,U.S. Senate,James Lankford,REP,660018,6,20,154,180,
Rogers,U.S. Senate,Jason Weger,REP,660018,0,0,0,0,
Rogers,U.S. House,Darrel Robertson,REP,660018,2,5,60,67,02
Rogers,U.S. House,Markwayne Mullin,REP,660018,6,33,288,327,02
Rogers,Superintendent of Public Instruction,John Cox,DEM,660019,0,2,45,47,
Rogers,Superintendent of Public Instruction,Jack Jr.,DEM,660019,0,1,11,12,
Rogers,Superintendent of Public Instruction,Ivan Holmes,DEM,660019,1,1,6,8,
Rogers,Superintendent of Public Instruction,Freda Deskin,DEM,660019,1,5,41,47,
Rogers,U.S. Senate,Patrick Michael Hayes,DEM,660019,0,1,24,25,
Rogers,U.S. Senate,Jim Rogers,DEM,660019,1,4,35,40,
Rogers,U.S. Senate,Connie Johnson,DEM,660019,1,3,41,45,
Rogers,U.S. House,Earl Everett,DEM,660019,2,5,53,60,02
Rogers,U.S. House,Joshua Harris-Till,DEM,660019,0,2,42,44,02
Rogers,Governor,Dax Ewbank,REP,660019,1,0,16,17,
Rogers,Governor,Chad Moody,REP,660019,1,8,42,51,
Rogers,Governor,Mary Fallin,REP,660019,1,22,161,184,
Rogers,Superintendent of Public Instruction,Brian Kelly,REP,660019,1,7,42,50,
Rogers,Superintendent of Public Instruction,Janet Costello Barresi,REP,660019,0,6,40,46,
Rogers,Superintendent of Public Instruction,Joy Hofmeister,REP,660019,3,16,129,148,
Rogers,Insurance Commissioner,Bill Viner,REP,660019,0,9,56,65,
Rogers,Insurance Commissioner,John Doak,REP,660019,4,19,143,166,
Rogers,Corporation Commissioner,Todd Hiett,REP,660019,4,14,107,125,
Rogers,Corporation Commissioner,Cliff Branan,REP,660019,0,13,93,106,
Rogers,U.S. Senate,Evelyn Rogers,REP,660019,0,0,8,8,
Rogers,U.S. Senate,Rob Moye,REP,660019,0,2,3,5,
Rogers,U.S. Senate,D. Jean Mcbride-Samuels,REP,660019,0,0,6,6,
Rogers,U.S. Senate,Jim Inhofe,REP,660019,4,24,187,215,
Rogers,U.S. Senate,Erick Paul Wyatt,REP,660019,0,1,11,12,
Rogers,U.S. Senate,Andy Craig,REP,660019,0,0,2,2,
Rogers,U.S. Senate,T. Shannon,REP,660019,2,9,102,113,
Rogers,U.S. Senate,Randy Brogdon,REP,660019,0,4,14,18,
Rogers,U.S. Senate,Eric Mccray,REP,660019,0,2,1,3,
Rogers,U.S. Senate,Kevin Crow,REP,660019,0,0,1,1,
Rogers,U.S. Senate,James Lankford,REP,660019,2,15,95,112,
Rogers,U.S. Senate,Jason Weger,REP,660019,0,0,0,0,
Rogers,U.S. House,Darrel Robertson,REP,660019,0,3,36,39,02
Rogers,U.S. House,Markwayne Mullin,REP,660019,4,27,175,206,02
Rogers,Superintendent of Public Instruction,John Cox,DEM,660020,1,9,61,71,
Rogers,Superintendent of Public Instruction,Jack Jr.,DEM,660020,0,2,23,25,
Rogers,Superintendent of Public Instruction,Ivan Holmes,DEM,660020,0,1,18,19,
Rogers,Superintendent of Public Instruction,Freda Deskin,DEM,660020,0,4,87,91,
Rogers,U.S. Senate,Patrick Michael Hayes,DEM,660020,0,3,39,42,
Rogers,U.S. Senate,Jim Rogers,DEM,660020,1,9,69,79,
Rogers,U.S. Senate,Connie Johnson,DEM,660020,0,5,78,83,
Rogers,U.S. House,Earl Everett,DEM,660020,1,13,103,117,02
Rogers,U.S. House,Joshua Harris-Till,DEM,660020,0,4,75,79,02
Rogers,Governor,Dax Ewbank,REP,660020,1,5,38,44,
Rogers,Governor,Chad Moody,REP,660020,2,6,92,100,
Rogers,Governor,Mary Fallin,REP,660020,3,48,256,307,
Rogers,Superintendent of Public Instruction,Brian Kelly,REP,660020,4,17,90,111,
Rogers,Superintendent of Public Instruction,Janet Costello Barresi,REP,660020,1,16,33,50,
Rogers,Superintendent of Public Instruction,Joy Hofmeister,REP,660020,1,27,264,292,
Rogers,Insurance Commissioner,Bill Viner,REP,660020,1,16,125,142,
Rogers,Insurance Commissioner,John Doak,REP,660020,5,37,235,277,
Rogers,Corporation Commissioner,Todd Hiett,REP,660020,4,26,184,214,
Rogers,Corporation Commissioner,Cliff Branan,REP,660020,2,31,183,216,
Rogers,U.S. Senate,Evelyn Rogers,REP,660020,0,7,22,29,
Rogers,U.S. Senate,Rob Moye,REP,660020,0,1,11,12,
Rogers,U.S. Senate,D. Jean Mcbride-Samuels,REP,660020,0,1,1,2,
Rogers,U.S. Senate,Jim Inhofe,REP,660020,5,45,338,388,
Rogers,U.S. Senate,Erick Paul Wyatt,REP,660020,1,2,17,20,
Rogers,U.S. Senate,Andy Craig,REP,660020,0,0,4,4,
Rogers,U.S. Senate,T. Shannon,REP,660020,2,19,166,187,
Rogers,U.S. Senate,Randy Brogdon,REP,660020,2,1,29,32,
Rogers,U.S. Senate,Eric Mccray,REP,660020,0,1,7,8,
Rogers,U.S. Senate,Kevin Crow,REP,660020,0,0,1,1,
Rogers,U.S. Senate,James Lankford,REP,660020,2,38,176,216,
Rogers,U.S. Senate,Jason Weger,REP,660020,0,0,4,4,
Rogers,U.S. House,Darrel Robertson,REP,660020,3,6,66,75,02
Rogers,U.S. House,Markwayne Mullin,REP,660020,3,54,318,375,02
Rogers,Superintendent of Public Instruction,John Cox,DEM,660021,0,1,0,1,
Rogers,Superintendent of Public Instruction,Jack Jr.,DEM,660021,0,0,1,1,
Rogers,Superintendent of Public Instruction,Ivan Holmes,DEM,660021,0,0,2,2,
Rogers,Superintendent of Public Instruction,Freda Deskin,DEM,660021,2,0,3,5,
Rogers,U.S. Senate,Patrick Michael Hayes,DEM,660021,0,0,2,2,
Rogers,U.S. Senate,Jim Rogers,DEM,660021,0,0,3,3,
Rogers,U.S. Senate,Connie Johnson,DEM,660021,2,0,1,3,
Rogers,Governor,Dax Ewbank,REP,660021,0,0,3,3,
Rogers,Governor,Chad Moody,REP,660021,1,0,5,6,
Rogers,Governor,Mary Fallin,REP,660021,5,2,31,38,
Rogers,Superintendent of Public Instruction,Brian Kelly,REP,660021,0,0,5,5,
Rogers,Superintendent of Public Instruction,Janet Costello Barresi,REP,660021,1,0,3,4,
Rogers,Superintendent of Public Instruction,Joy Hofmeister,REP,660021,5,2,31,38,
Rogers,Insurance Commissioner,Bill Viner,REP,660021,2,2,7,11,
Rogers,Insurance Commissioner,John Doak,REP,660021,4,0,26,30,
Rogers,Corporation Commissioner,Todd Hiett,REP,660021,4,0,21,25,
Rogers,Corporation Commissioner,Cliff Branan,REP,660021,2,2,13,17,
Rogers,U.S. Senate,Evelyn Rogers,REP,660021,0,0,0,0,
Rogers,U.S. Senate,Rob Moye,REP,660021,0,0,1,1,
Rogers,U.S. Senate,D. Jean Mcbride-Samuels,REP,660021,0,0,0,0,
Rogers,U.S. Senate,Jim Inhofe,REP,660021,6,2,33,41,
Rogers,U.S. Senate,Erick Paul Wyatt,REP,660021,0,0,5,5,
Rogers,U.S. Senate,Andy Craig,REP,660021,0,0,0,0,
Rogers,U.S. Senate,T. Shannon,REP,660021,4,0,13,17,
Rogers,U.S. Senate,Randy Brogdon,REP,660021,0,0,7,7,
Rogers,U.S. Senate,Eric Mccray,REP,660021,0,0,0,0,
Rogers,U.S. Senate,Kevin Crow,REP,660021,0,0,0,0,
Rogers,U.S. Senate,James Lankford,REP,660021,2,2,19,23,
Rogers,U.S. Senate,Jason Weger,REP,660021,0,0,0,0,
Rogers,Superintendent of Public Instruction,John Cox,DEM,660022,0,5,53,58,
Rogers,Superintendent of Public Instruction,Jack Jr.,DEM,660022,0,2,23,25,
Rogers,Superintendent of Public Instruction,Ivan Holmes,DEM,660022,0,0,7,7,
Rogers,Superintendent of Public Instruction,Freda Deskin,DEM,660022,0,8,56,64,
Rogers,U.S. Senate,Patrick Michael Hayes,DEM,660022,0,6,28,34,
Rogers,U.S. Senate,Jim Rogers,DEM,660022,0,6,61,67,
Rogers,U.S. Senate,Connie Johnson,DEM,660022,0,3,46,49,
Rogers,U.S. House,Earl Everett,DEM,660022,0,7,81,88,02
Rogers,U.S. House,Joshua Harris-Till,DEM,660022,0,7,46,53,02
Rogers,Governor,Dax Ewbank,REP,660022,2,2,21,25,
Rogers,Governor,Chad Moody,REP,660022,3,4,43,50,
Rogers,Governor,Mary Fallin,REP,660022,3,15,221,239,
Rogers,Superintendent of Public Instruction,Brian Kelly,REP,660022,3,4,68,75,
Rogers,Superintendent of Public Instruction,Janet Costello Barresi,REP,660022,2,3,30,35,
Rogers,Superintendent of Public Instruction,Joy Hofmeister,REP,660022,4,15,185,204,
Rogers,Insurance Commissioner,Bill Viner,REP,660022,2,3,91,96,
Rogers,Insurance Commissioner,John Doak,REP,660022,7,16,179,202,
Rogers,Corporation Commissioner,Todd Hiett,REP,660022,4,10,147,161,
Rogers,Corporation Commissioner,Cliff Branan,REP,660022,5,10,121,136,
Rogers,U.S. Senate,Evelyn Rogers,REP,660022,3,0,11,14,
Rogers,U.S. Senate,Rob Moye,REP,660022,0,1,2,3,
Rogers,U.S. Senate,D. Jean Mcbride-Samuels,REP,660022,0,0,8,8,
Rogers,U.S. Senate,Jim Inhofe,REP,660022,6,19,252,277,
Rogers,U.S. Senate,Erick Paul Wyatt,REP,660022,0,1,11,12,
Rogers,U.S. Senate,Andy Craig,REP,660022,0,0,3,3,
Rogers,U.S. Senate,T. Shannon,REP,660022,3,7,138,148,
Rogers,U.S. Senate,Randy Brogdon,REP,660022,0,3,18,21,
Rogers,U.S. Senate,Eric Mccray,REP,660022,1,0,1,2,
Rogers,U.S. Senate,Kevin Crow,REP,660022,0,0,1,1,
Rogers,U.S. Senate,James Lankford,REP,660022,5,12,124,141,
Rogers,U.S. Senate,Jason Weger,REP,660022,0,0,0,0,
Rogers,U.S. House,Darrel Robertson,REP,660022,2,4,47,53,02
Rogers,U.S. House,Markwayne Mullin,REP,660022,7,17,239,263,02
Rogers,Superintendent of Public Instruction,John Cox,DEM,660023,0,0,174,174,
Rogers,Superintendent of Public Instruction,Jack Jr.,DEM,660023,0,5,34,39,
Rogers,Superintendent of Public Instruction,Ivan Holmes,DEM,660023,1,1,15,17,
Rogers,Superintendent of Public Instruction,Freda Deskin,DEM,660023,0,2,108,110,
Rogers,U.S. Senate,Patrick Michael Hayes,DEM,660023,0,2,88,90,
Rogers,U.S. Senate,Jim Rogers,DEM,660023,1,3,147,151,
Rogers,U.S. Senate,Connie Johnson,DEM,660023,0,3,86,89,
Rogers,U.S. House,Earl Everett,DEM,660023,0,4,230,234,02
Rogers,U.S. House,Joshua Harris-Till,DEM,660023,0,4,81,85,02
Rogers,Governor,Dax Ewbank,REP,660023,0,1,13,14,
Rogers,Governor,Chad Moody,REP,660023,1,2,86,89,
Rogers,Governor,Mary Fallin,REP,660023,7,12,265,284,
Rogers,Superintendent of Public Instruction,Brian Kelly,REP,660023,1,5,106,112,
Rogers,Superintendent of Public Instruction,Janet Costello Barresi,REP,660023,2,5,61,68,
Rogers,Superintendent of Public Instruction,Joy Hofmeister,REP,660023,4,5,196,205,
Rogers,Insurance Commissioner,Bill Viner,REP,660023,2,1,106,109,
Rogers,Insurance Commissioner,John Doak,REP,660023,6,13,236,255,
Rogers,Corporation Commissioner,Todd Hiett,REP,660023,5,8,190,203,
Rogers,Corporation Commissioner,Cliff Branan,REP,660023,3,5,162,170,
Rogers,U.S. Senate,Evelyn Rogers,REP,660023,1,0,12,13,
Rogers,U.S. Senate,Rob Moye,REP,660023,0,0,4,4,
Rogers,U.S. Senate,D. Jean Mcbride-Samuels,REP,660023,0,0,2,2,
Rogers,U.S. Senate,Jim Inhofe,REP,660023,7,14,318,339,
Rogers,U.S. Senate,Erick Paul Wyatt,REP,660023,0,1,28,29,
Rogers,U.S. Senate,Andy Craig,REP,660023,0,0,8,8,
Rogers,U.S. Senate,T. Shannon,REP,660023,4,8,195,207,
Rogers,U.S. Senate,Randy Brogdon,REP,660023,2,1,23,26,
Rogers,U.S. Senate,Eric Mccray,REP,660023,0,1,6,7,
Rogers,U.S. Senate,Kevin Crow,REP,660023,1,1,4,6,
Rogers,U.S. Senate,James Lankford,REP,660023,1,3,127,131,
Rogers,U.S. Senate,Jason Weger,REP,660023,0,0,1,1,
Rogers,U.S. House,Darrel Robertson,REP,660023,1,2,51,54,02
Rogers,U.S. House,Markwayne Mullin,REP,660023,7,13,315,335,02
Rogers,Superintendent of Public Instruction,John Cox,DEM,660024,0,1,15,16,
Rogers,Superintendent of Public Instruction,Jack Jr.,DEM,660024,0,0,6,6,
Rogers,Superintendent of Public Instruction,Ivan Holmes,DEM,660024,0,0,1,1,
Rogers,Superintendent of Public Instruction,Freda Deskin,DEM,660024,0,1,25,26,
Rogers,U.S. Senate,Patrick Michael Hayes,DEM,660024,0,2,9,11,
Rogers,U.S. Senate,Jim Rogers,DEM,660024,0,0,23,23,
Rogers,U.S. Senate,Connie Johnson,DEM,660024,0,0,14,14,
Rogers,U.S. House,Earl Everett,DEM,660024,0,2,21,23,02
Rogers,U.S. House,Joshua Harris-Till,DEM,660024,0,0,23,23,02
Rogers,Governor,Dax Ewbank,REP,660024,1,0,5,6,
Rogers,Governor,Chad Moody,REP,660024,0,2,21,23,
Rogers,Governor,Mary Fallin,REP,660024,4,5,83,92,
Rogers,Superintendent of Public Instruction,Brian Kelly,REP,660024,3,1,17,21,
Rogers,Superintendent of Public Instruction,Janet Costello Barresi,REP,660024,0,0,15,15,
Rogers,Superintendent of Public Instruction,Joy Hofmeister,REP,660024,2,6,79,87,
Rogers,Insurance Commissioner,Bill Viner,REP,660024,3,1,29,33,
Rogers,Insurance Commissioner,John Doak,REP,660024,2,6,78,86,
Rogers,Corporation Commissioner,Todd Hiett,REP,660024,3,3,55,61,
Rogers,Corporation Commissioner,Cliff Branan,REP,660024,2,4,53,59,
Rogers,U.S. Senate,Evelyn Rogers,REP,660024,0,0,12,12,
Rogers,U.S. Senate,Rob Moye,REP,660024,0,0,2,2,
Rogers,U.S. Senate,D. Jean Mcbride-Samuels,REP,660024,0,0,0,0,
Rogers,U.S. Senate,Jim Inhofe,REP,660024,5,6,90,101,
Rogers,U.S. Senate,Erick Paul Wyatt,REP,660024,0,0,5,5,
Rogers,U.S. Senate,Andy Craig,REP,660024,0,0,0,0,
Rogers,U.S. Senate,T. Shannon,REP,660024,1,4,51,56,
Rogers,U.S. Senate,Randy Brogdon,REP,660024,3,0,15,18,
Rogers,U.S. Senate,Eric Mccray,REP,660024,0,0,0,0,
Rogers,U.S. Senate,Kevin Crow,REP,660024,0,0,0,0,
Rogers,U.S. Senate,James Lankford,REP,660024,0,3,42,45,
Rogers,U.S. Senate,Jason Weger,REP,660024,1,0,2,3,
Rogers,U.S. House,Darrel Robertson,REP,660024,1,1,11,13,02
Rogers,U.S. House,Markwayne Mullin,REP,660024,4,6,98,108,02
Rogers,Superintendent of Public Instruction,John Cox,DEM,660025,0,0,17,17,
Rogers,Superintendent of Public Instruction,Jack Jr.,DEM,660025,0,0,2,2,
Rogers,Superintendent of Public Instruction,Ivan Holmes,DEM,660025,0,0,1,1,
Rogers,Superintendent of Public Instruction,Freda Deskin,DEM,660025,0,0,11,11,
Rogers,U.S. Senate,Patrick Michael Hayes,DEM,660025,0,0,12,12,
Rogers,U.S. Senate,Jim Rogers,DEM,660025,0,0,8,8,
Rogers,U.S. Senate,Connie Johnson,DEM,660025,0,0,10,10,
Rogers,Governor,Dax Ewbank,REP,660025,0,0,7,7,
Rogers,Governor,Chad Moody,REP,660025,0,0,6,6,
Rogers,Governor,Mary Fallin,REP,660025,0,3,57,60,
Rogers,Superintendent of Public Instruction,Brian Kelly,REP,660025,0,0,9,9,
Rogers,Superintendent of Public Instruction,Janet Costello Barresi,REP,660025,0,0,1,1,
Rogers,Superintendent of Public Instruction,Joy Hofmeister,REP,660025,0,3,60,63,
Rogers,Insurance Commissioner,Bill Viner,REP,660025,0,2,11,13,
Rogers,Insurance Commissioner,John Doak,REP,660025,0,1,55,56,
Rogers,Corporation Commissioner,Todd Hiett,REP,660025,0,0,34,34,
Rogers,Corporation Commissioner,Cliff Branan,REP,660025,0,3,33,36,
Rogers,U.S. Senate,Evelyn Rogers,REP,660025,0,0,1,1,
Rogers,U.S. Senate,Rob Moye,REP,660025,0,0,2,2,
Rogers,U.S. Senate,D. Jean Mcbride-Samuels,REP,660025,0,0,1,1,
Rogers,U.S. Senate,Jim Inhofe,REP,660025,0,2,61,63,
Rogers,U.S. Senate,Erick Paul Wyatt,REP,660025,0,1,5,6,
Rogers,U.S. Senate,Andy Craig,REP,660025,0,0,0,0,
Rogers,U.S. Senate,T. Shannon,REP,660025,0,1,36,37,
Rogers,U.S. Senate,Randy Brogdon,REP,660025,0,0,6,6,
Rogers,U.S. Senate,Eric Mccray,REP,660025,0,0,0,0,
Rogers,U.S. Senate,Kevin Crow,REP,660025,0,0,0,0,
Rogers,U.S. Senate,James Lankford,REP,660025,0,2,28,30,
Rogers,U.S. Senate,Jason Weger,REP,660025,0,0,0,0,
Rogers,Superintendent of Public Instruction,John Cox,DEM,660026,2,1,67,70,
Rogers,Superintendent of Public Instruction,Jack Jr.,DEM,660026,1,0,34,35,
Rogers,Superintendent of Public Instruction,Ivan Holmes,DEM,660026,0,0,14,14,
Rogers,Superintendent of Public Instruction,Freda Deskin,DEM,660026,0,1,79,80,
Rogers,U.S. Senate,Patrick Michael Hayes,DEM,660026,1,0,63,64,
Rogers,U.S. Senate,Jim Rogers,DEM,660026,3,0,70,73,
Rogers,U.S. Senate,Connie Johnson,DEM,660026,0,2,56,58,
Rogers,U.S. House,Earl Everett,DEM,660026,2,1,124,127,02
Rogers,U.S. House,Joshua Harris-Till,DEM,660026,2,1,57,60,02
Rogers,Governor,Dax Ewbank,REP,660026,1,0,39,40,
Rogers,Governor,Chad Moody,REP,660026,6,7,108,121,
Rogers,Governor,Mary Fallin,REP,660026,7,21,335,363,
Rogers,Superintendent of Public Instruction,Brian Kelly,REP,660026,5,5,113,123,
Rogers,Superintendent of Public Instruction,Janet Costello Barresi,REP,660026,1,3,63,67,
Rogers,Superintendent of Public Instruction,Joy Hofmeister,REP,660026,8,20,306,334,
Rogers,Insurance Commissioner,Bill Viner,REP,660026,5,7,119,131,
Rogers,Insurance Commissioner,John Doak,REP,660026,7,21,333,361,
Rogers,Corporation Commissioner,Todd Hiett,REP,660026,1,18,252,271,
Rogers,Corporation Commissioner,Cliff Branan,REP,660026,8,10,197,215,
Rogers,U.S. Senate,Evelyn Rogers,REP,660026,2,0,20,22,
Rogers,U.S. Senate,Rob Moye,REP,660026,0,1,18,19,
Rogers,U.S. Senate,D. Jean Mcbride-Samuels,REP,660026,1,0,3,4,
Rogers,U.S. Senate,Jim Inhofe,REP,660026,10,26,419,455,
Rogers,U.S. Senate,Erick Paul Wyatt,REP,660026,1,1,17,19,
Rogers,U.S. Senate,Andy Craig,REP,660026,0,0,9,9,
Rogers,U.S. Senate,T. Shannon,REP,660026,4,14,225,243,
Rogers,U.S. Senate,Randy Brogdon,REP,660026,2,2,39,43,
Rogers,U.S. Senate,Eric Mccray,REP,660026,0,1,7,8,
Rogers,U.S. Senate,Kevin Crow,REP,660026,1,0,3,4,
Rogers,U.S. Senate,James Lankford,REP,660026,6,12,207,225,
Rogers,U.S. Senate,Jason Weger,REP,660026,1,0,0,1,
Rogers,U.S. House,Darrel Robertson,REP,660026,5,4,52,61,02
Rogers,U.S. House,Markwayne Mullin,REP,660026,9,24,434,467,02
Rogers,Superintendent of Public Instruction,John Cox,DEM,660027,0,1,34,35,
Rogers,Superintendent of Public Instruction,Jack Jr.,DEM,660027,0,2,11,13,
Rogers,Superintendent of Public Instruction,Ivan Holmes,DEM,660027,0,1,6,7,
Rogers,Superintendent of Public Instruction,Freda Deskin,DEM,660027,0,1,46,47,
Rogers,U.S. Senate,Patrick Michael Hayes,DEM,660027,0,3,28,31,
Rogers,U.S. Senate,Jim Rogers,DEM,660027,0,0,29,29,
Rogers,U.S. Senate,Connie Johnson,DEM,660027,0,2,39,41,
Rogers,U.S. House,Earl Everett,DEM,660027,0,1,46,47,02
Rogers,U.S. House,Joshua Harris-Till,DEM,660027,0,4,38,42,02
Rogers,Governor,Dax Ewbank,REP,660027,0,0,10,10,
Rogers,Governor,Chad Moody,REP,660027,0,3,47,50,
Rogers,Governor,Mary Fallin,REP,660027,1,6,132,139,
Rogers,Superintendent of Public Instruction,Brian Kelly,REP,660027,0,1,38,39,
Rogers,Superintendent of Public Instruction,Janet Costello Barresi,REP,660027,0,1,22,23,
Rogers,Superintendent of Public Instruction,Joy Hofmeister,REP,660027,2,7,128,137,
Rogers,Insurance Commissioner,Bill Viner,REP,660027,0,3,40,43,
Rogers,Insurance Commissioner,John Doak,REP,660027,2,6,136,144,
Rogers,Corporation Commissioner,Todd Hiett,REP,660027,1,5,92,98,
Rogers,Corporation Commissioner,Cliff Branan,REP,660027,0,1,89,90,
Rogers,U.S. Senate,Evelyn Rogers,REP,660027,0,0,17,17,
Rogers,U.S. Senate,Rob Moye,REP,660027,0,0,2,2,
Rogers,U.S. Senate,D. Jean Mcbride-Samuels,REP,660027,0,0,2,2,
Rogers,U.S. Senate,Jim Inhofe,REP,660027,2,9,155,166,
Rogers,U.S. Senate,Erick Paul Wyatt,REP,660027,0,0,17,17,
Rogers,U.S. Senate,Andy Craig,REP,660027,0,0,3,3,
Rogers,U.S. Senate,T. Shannon,REP,660027,0,3,96,99,
Rogers,U.S. Senate,Randy Brogdon,REP,660027,0,0,11,11,
Rogers,U.S. Senate,Eric Mccray,REP,660027,0,0,3,3,
Rogers,U.S. Senate,Kevin Crow,REP,660027,0,0,2,2,
Rogers,U.S. Senate,James Lankford,REP,660027,2,6,77,85,
Rogers,U.S. Senate,Jason Weger,REP,660027,0,0,1,1,
Rogers,U.S. House,Darrel Robertson,REP,660027,0,2,28,30,02
Rogers,U.S. House,Markwayne Mullin,REP,660027,2,7,163,172,02
Rogers,Superintendent of Public Instruction,John Cox,DEM,660029,0,0,21,21,
Rogers,Superintendent of Public Instruction,Jack Jr.,DEM,660029,0,0,3,3,
Rogers,Superintendent of Public Instruction,Ivan Holmes,DEM,660029,2,0,4,6,
Rogers,Superintendent of Public Instruction,Freda Deskin,DEM,660029,0,1,21,22,
Rogers,U.S. Senate,Patrick Michael Hayes,DEM,660029,0,0,12,12,
Rogers,U.S. Senate,Jim Rogers,DEM,660029,2,1,18,21,
Rogers,U.S. Senate,Connie Johnson,DEM,660029,0,0,18,18,
Rogers,U.S. House,Earl Everett,DEM,660029,0,0,24,24,02
Rogers,U.S. House,Joshua Harris-Till,DEM,660029,2,1,23,26,02
Rogers,Governor,Dax Ewbank,REP,660029,1,0,12,13,
Rogers,Governor,Chad Moody,REP,660029,0,2,18,20,
Rogers,Governor,Mary Fallin,REP,660029,4,13,119,136,
Rogers,Superintendent of Public Instruction,Brian Kelly,REP,660029,1,0,33,34,
Rogers,Superintendent of Public Instruction,Janet Costello Barresi,REP,660029,1,3,17,21,
Rogers,Superintendent of Public Instruction,Joy Hofmeister,REP,660029,3,12,98,113,
Rogers,Insurance Commissioner,Bill Viner,REP,660029,0,1,35,36,
Rogers,Insurance Commissioner,John Doak,REP,660029,5,14,99,118,
Rogers,Corporation Commissioner,Todd Hiett,REP,660029,3,7,69,79,
Rogers,Corporation Commissioner,Cliff Branan,REP,660029,0,8,67,75,
Rogers,U.S. Senate,Evelyn Rogers,REP,660029,0,0,8,8,
Rogers,U.S. Senate,Rob Moye,REP,660029,0,0,2,2,
Rogers,U.S. Senate,D. Jean Mcbride-Samuels,REP,660029,0,0,1,1,
Rogers,U.S. Senate,Jim Inhofe,REP,660029,5,16,130,151,
Rogers,U.S. Senate,Erick Paul Wyatt,REP,660029,0,0,7,7,
Rogers,U.S. Senate,Andy Craig,REP,660029,0,1,1,2,
Rogers,U.S. Senate,T. Shannon,REP,660029,3,6,56,65,
Rogers,U.S. Senate,Randy Brogdon,REP,660029,0,0,12,12,
Rogers,U.S. Senate,Eric Mccray,REP,660029,0,0,0,0,
Rogers,U.S. Senate,Kevin Crow,REP,660029,0,0,5,5,
Rogers,U.S. Senate,James Lankford,REP,660029,2,9,71,82,
Rogers,U.S. Senate,Jason Weger,REP,660029,0,0,2,2,
Rogers,U.S. House,Darrel Robertson,REP,660029,1,3,20,24,02
Rogers,U.S. House,Markwayne Mullin,REP,660029,4,13,128,145,02
Rogers,Superintendent of Public Instruction,John Cox,DEM,660030,2,2,32,36,
Rogers,Superintendent of Public Instruction,Jack Jr.,DEM,660030,0,0,8,8,
Rogers,Superintendent of Public Instruction,Ivan Holmes,DEM,660030,0,0,9,9,
Rogers,Superintendent of Public Instruction,Freda Deskin,DEM,660030,3,1,27,31,
Rogers,U.S. Senate,Patrick Michael Hayes,DEM,660030,0,2,17,19,
Rogers,U.S. Senate,Jim Rogers,DEM,660030,2,1,27,30,
Rogers,U.S. Senate,Connie Johnson,DEM,660030,3,0,28,31,
Rogers,U.S. House,Earl Everett,DEM,660030,0,1,27,28,02
Rogers,U.S. House,Joshua Harris-Till,DEM,660030,4,2,36,42,02
Rogers,Governor,Dax Ewbank,REP,660030,0,0,27,27,
Rogers,Governor,Chad Moody,REP,660030,0,5,59,64,
Rogers,Governor,Mary Fallin,REP,660030,15,12,340,367,
Rogers,Superintendent of Public Instruction,Brian Kelly,REP,660030,1,3,72,76,
Rogers,Superintendent of Public Instruction,Janet Costello Barresi,REP,660030,2,2,64,68,
Rogers,Superintendent of Public Instruction,Joy Hofmeister,REP,660030,11,13,290,314,
Rogers,Insurance Commissioner,Bill Viner,REP,660030,3,5,81,89,
Rogers,Insurance Commissioner,John Doak,REP,660030,12,13,304,329,
Rogers,Corporation Commissioner,Todd Hiett,REP,660030,8,12,207,227,
Rogers,Corporation Commissioner,Cliff Branan,REP,660030,4,6,190,200,
Rogers,U.S. Senate,Evelyn Rogers,REP,660030,0,0,12,12,
Rogers,U.S. Senate,Rob Moye,REP,660030,1,0,7,8,
Rogers,U.S. Senate,D. Jean Mcbride-Samuels,REP,660030,0,0,3,3,
Rogers,U.S. Senate,Jim Inhofe,REP,660030,12,18,389,419,
Rogers,U.S. Senate,Erick Paul Wyatt,REP,660030,2,0,18,20,
Rogers,U.S. Senate,Andy Craig,REP,660030,0,0,0,0,
Rogers,U.S. Senate,T. Shannon,REP,660030,5,6,170,181,
Rogers,U.S. Senate,Randy Brogdon,REP,660030,1,4,48,53,
Rogers,U.S. Senate,Eric Mccray,REP,660030,0,0,3,3,
Rogers,U.S. Senate,Kevin Crow,REP,660030,0,0,2,2,
Rogers,U.S. Senate,James Lankford,REP,660030,9,8,214,231,
Rogers,U.S. Senate,Jason Weger,REP,660030,0,0,1,1,
Rogers,U.S. House,Darrel Robertson,REP,660030,3,2,56,61,02
Rogers,U.S. House,Markwayne Mullin,REP,660030,12,16,366,394,02
Rogers,Superintendent of Public Instruction,John Cox,DEM,660031,1,0,36,37,
Rogers,Superintendent of Public Instruction,Jack Jr.,DEM,660031,0,2,9,11,
Rogers,Superintendent of Public Instruction,Ivan Holmes,DEM,660031,0,0,10,10,
Rogers,Superintendent of Public Instruction,Freda Deskin,DEM,660031,0,0,38,38,
Rogers,U.S. Senate,Patrick Michael Hayes,DEM,660031,0,1,20,21,
Rogers,U.S. Senate,Jim Rogers,DEM,660031,0,0,26,26,
Rogers,U.S. Senate,Connie Johnson,DEM,660031,1,1,41,43,
Rogers,Governor,Dax Ewbank,REP,660031,0,1,27,28,
Rogers,Governor,Chad Moody,REP,660031,0,1,37,38,
Rogers,Governor,Mary Fallin,REP,660031,7,6,220,233,
Rogers,Superintendent of Public Instruction,Brian Kelly,REP,660031,2,2,40,44,
Rogers,Superintendent of Public Instruction,Janet Costello Barresi,REP,660031,0,0,42,42,
Rogers,Superintendent of Public Instruction,Joy Hofmeister,REP,660031,4,6,203,213,
Rogers,Insurance Commissioner,Bill Viner,REP,660031,1,2,63,66,
Rogers,Insurance Commissioner,John Doak,REP,660031,5,6,198,209,
Rogers,Corporation Commissioner,Todd Hiett,REP,660031,3,1,133,137,
Rogers,Corporation Commissioner,Cliff Branan,REP,660031,1,7,137,145,
Rogers,U.S. Senate,Evelyn Rogers,REP,660031,0,0,18,18,
Rogers,U.S. Senate,Rob Moye,REP,660031,0,0,8,8,
Rogers,U.S. Senate,D. Jean Mcbride-Samuels,REP,660031,0,0,5,5,
Rogers,U.S. Senate,Jim Inhofe,REP,660031,6,8,241,255,
Rogers,U.S. Senate,Erick Paul Wyatt,REP,660031,1,0,11,12,
Rogers,U.S. Senate,Andy Craig,REP,660031,0,0,3,3,
Rogers,U.S. Senate,T. Shannon,REP,660031,0,5,132,137,
Rogers,U.S. Senate,Randy Brogdon,REP,660031,5,0,42,47,
Rogers,U.S. Senate,Eric Mccray,REP,660031,0,0,0,0,
Rogers,U.S. Senate,Kevin Crow,REP,660031,0,0,2,2,
Rogers,U.S. Senate,James Lankford,REP,660031,2,3,108,113,
Rogers,U.S. Senate,Jason Weger,REP,660031,0,0,1,1,
Rogers,Superintendent of Public Instruction,John Cox,DEM,660032,5,1,13,19,
Rogers,Superintendent of Public Instruction,Jack Jr.,DEM,660032,1,0,3,4,
Rogers,Superintendent of Public Instruction,Ivan Holmes,DEM,660032,0,0,1,1,
Rogers,Superintendent of Public Instruction,Freda Deskin,DEM,660032,2,0,13,15,
Rogers,U.S. Senate,Patrick Michael Hayes,DEM,660032,1,0,13,14,
Rogers,U.S. Senate,Jim Rogers,DEM,660032,3,1,9,13,
Rogers,U.S. Senate,Connie Johnson,DEM,660032,4,0,8,12,
Rogers,U.S. House,Earl Everett,DEM,660032,2,1,17,20,02
Rogers,U.S. House,Joshua Harris-Till,DEM,660032,5,0,12,17,02
Rogers,Governor,Dax Ewbank,REP,660032,1,2,15,18,
Rogers,Governor,Chad Moody,REP,660032,3,3,30,36,
Rogers,Governor,Mary Fallin,REP,660032,16,4,93,113,
Rogers,Superintendent of Public Instruction,Brian Kelly,REP,660032,5,0,35,40,
Rogers,Superintendent of Public Instruction,Janet Costello Barresi,REP,660032,5,0,20,25,
Rogers,Superintendent of Public Instruction,Joy Hofmeister,REP,660032,10,9,85,104,
Rogers,Insurance Commissioner,Bill Viner,REP,660032,9,3,40,52,
Rogers,Insurance Commissioner,John Doak,REP,660032,11,6,82,99,
Rogers,Corporation Commissioner,Todd Hiett,REP,660032,12,6,80,98,
Rogers,Corporation Commissioner,Cliff Branan,REP,660032,8,3,49,60,
Rogers,U.S. Senate,Evelyn Rogers,REP,660032,3,0,5,8,
Rogers,U.S. Senate,Rob Moye,REP,660032,0,1,2,3,
Rogers,U.S. Senate,D. Jean Mcbride-Samuels,REP,660032,1,0,1,2,
Rogers,U.S. Senate,Jim Inhofe,REP,660032,16,6,123,145,
Rogers,U.S. Senate,Erick Paul Wyatt,REP,660032,0,2,9,11,
Rogers,U.S. Senate,Andy Craig,REP,660032,0,0,1,1,
Rogers,U.S. Senate,T. Shannon,REP,660032,11,4,55,70,
Rogers,U.S. Senate,Randy Brogdon,REP,660032,1,3,20,24,
Rogers,U.S. Senate,Eric Mccray,REP,660032,1,0,3,4,
Rogers,U.S. Senate,Kevin Crow,REP,660032,0,0,0,0,
Rogers,U.S. Senate,James Lankford,REP,660032,7,2,59,68,
Rogers,U.S. Senate,Jason Weger,REP,660032,0,0,0,0,
Rogers,U.S. House,Darrel Robertson,REP,660032,0,2,33,35,02
Rogers,U.S. House,Markwayne Mullin,REP,660032,20,7,104,131,02
Rogers,Superintendent of Public Instruction,John Cox,DEM,660033,0,0,22,22,
Rogers,Superintendent of Public Instruction,Jack Jr.,DEM,660033,0,0,10,10,
Rogers,Superintendent of Public Instruction,Ivan Holmes,DEM,660033,0,0,1,1,
Rogers,Superintendent of Public Instruction,Freda Deskin,DEM,660033,0,0,11,11,
Rogers,U.S. Senate,Patrick Michael Hayes,DEM,660033,0,0,13,13,
Rogers,U.S. Senate,Jim Rogers,DEM,660033,0,0,14,14,
Rogers,U.S. Senate,Connie Johnson,DEM,660033,0,0,15,15,
Rogers,U.S. House,Earl Everett,DEM,660033,0,0,23,23,02
Rogers,U.S. House,Joshua Harris-Till,DEM,660033,0,0,18,18,02
Rogers,Governor,Dax Ewbank,REP,660033,0,0,8,8,
Rogers,Governor,Chad Moody,REP,660033,0,0,12,12,
Rogers,Governor,Mary Fallin,REP,660033,0,0,69,69,
Rogers,Superintendent of Public Instruction,Brian Kelly,REP,660033,0,0,18,18,
Rogers,Superintendent of Public Instruction,Janet Costello Barresi,REP,660033,0,0,14,14,
Rogers,Superintendent of Public Instruction,Joy Hofmeister,REP,660033,0,0,58,58,
Rogers,Insurance Commissioner,Bill Viner,REP,660033,0,0,25,25,
Rogers,Insurance Commissioner,John Doak,REP,660033,0,0,59,59,
Rogers,Corporation Commissioner,Todd Hiett,REP,660033,0,0,46,46,
Rogers,Corporation Commissioner,Cliff Branan,REP,660033,0,0,40,40,
Rogers,U.S. Senate,Evelyn Rogers,REP,660033,0,0,5,5,
Rogers,U.S. Senate,Rob Moye,REP,660033,0,0,1,1,
Rogers,U.S. Senate,D. Jean Mcbride-Samuels,REP,660033,0,0,0,0,
Rogers,U.S. Senate,Jim Inhofe,REP,660033,0,0,81,81,
Rogers,U.S. Senate,Erick Paul Wyatt,REP,660033,0,0,2,2,
Rogers,U.S. Senate,Andy Craig,REP,660033,0,0,1,1,
Rogers,U.S. Senate,T. Shannon,REP,660033,0,0,39,39,
Rogers,U.S. Senate,Randy Brogdon,REP,660033,0,0,8,8,
Rogers,U.S. Senate,Eric Mccray,REP,660033,0,0,0,0,
Rogers,U.S. Senate,Kevin Crow,REP,660033,0,0,1,1,
Rogers,U.S. Senate,James Lankford,REP,660033,0,0,41,41,
Rogers,U.S. Senate,Jason Weger,REP,660033,0,0,0,0,
Rogers,U.S. House,Darrel Robertson,REP,660033,0,0,11,11,02
Rogers,U.S. House,Markwayne Mullin,REP,660033,0,0,81,81,02
Rogers,Superintendent of Public Instruction,John Cox,DEM,660110,1,0,45,46,
Rogers,Superintendent of Public Instruction,Jack Jr.,DEM,660110,0,0,13,13,
Rogers,Superintendent of Public Instruction,Ivan Holmes,DEM,660110,0,0,8,8,
Rogers,Superintendent of Public Instruction,Freda Deskin,DEM,660110,2,4,28,34,
Rogers,U.S. Senate,Patrick Michael Hayes,DEM,660110,2,2,24,28,
Rogers,U.S. Senate,Jim Rogers,DEM,660110,0,1,36,37,
Rogers,U.S. Senate,Connie Johnson,DEM,660110,1,1,29,31,
Rogers,U.S. House,Earl Everett,DEM,660110,0,3,47,50,02
Rogers,U.S. House,Joshua Harris-Till,DEM,660110,1,1,37,39,02
Rogers,Governor,Dax Ewbank,REP,660110,0,3,8,11,
Rogers,Governor,Chad Moody,REP,660110,0,4,47,51,
Rogers,Governor,Mary Fallin,REP,660110,5,12,184,201,
Rogers,Superintendent of Public Instruction,Brian Kelly,REP,660110,1,7,51,59,
Rogers,Superintendent of Public Instruction,Janet Costello Barresi,REP,660110,3,4,35,42,
Rogers,Superintendent of Public Instruction,Joy Hofmeister,REP,660110,1,8,153,162,
Rogers,Insurance Commissioner,Bill Viner,REP,660110,0,6,60,66,
Rogers,Insurance Commissioner,John Doak,REP,660110,4,13,161,178,
Rogers,Corporation Commissioner,Todd Hiett,REP,660110,1,14,120,135,
Rogers,Corporation Commissioner,Cliff Branan,REP,660110,4,5,105,114,
Rogers,U.S. Senate,Evelyn Rogers,REP,660110,0,2,7,9,
Rogers,U.S. Senate,Rob Moye,REP,660110,0,0,7,7,
Rogers,U.S. Senate,D. Jean Mcbride-Samuels,REP,660110,0,0,4,4,
Rogers,U.S. Senate,Jim Inhofe,REP,660110,5,14,217,236,
Rogers,U.S. Senate,Erick Paul Wyatt,REP,660110,0,2,9,11,
Rogers,U.S. Senate,Andy Craig,REP,660110,0,2,2,4,
Rogers,U.S. Senate,T. Shannon,REP,660110,5,9,108,122,
Rogers,U.S. Senate,Randy Brogdon,REP,660110,0,0,20,20,
Rogers,U.S. Senate,Eric Mccray,REP,660110,0,1,4,5,
Rogers,U.S. Senate,Kevin Crow,REP,660110,0,0,2,2,
Rogers,U.S. Senate,James Lankford,REP,660110,0,7,105,112,
Rogers,U.S. Senate,Jason Weger,REP,660110,0,0,1,1,
Rogers,U.S. House,Darrel Robertson,REP,660110,0,5,31,36,02
Rogers,U.S. House,Markwayne Mullin,REP,660110,5,14,211,230,02
Rogers,Superintendent of Public Instruction,John Cox,DEM,660116,0,1,34,35,
Rogers,Superintendent of Public Instruction,Jack Jr.,DEM,660116,0,1,9,10,
Rogers,Superintendent of Public Instruction,Ivan Holmes,DEM,660116,0,0,2,2,
Rogers,Superintendent of Public Instruction,Freda Deskin,DEM,660116,0,0,27,27,
Rogers,U.S. Senate,Patrick Michael Hayes,DEM,660116,0,1,23,24,
Rogers,U.S. Senate,Jim Rogers,DEM,660116,0,0,24,24,
Rogers,U.S. Senate,Connie Johnson,DEM,660116,0,1,23,24,
Rogers,U.S. House,Earl Everett,DEM,660116,0,2,30,32,02
Rogers,U.S. House,Joshua Harris-Till,DEM,660116,0,0,36,36,02
Rogers,Governor,Dax Ewbank,REP,660116,0,1,21,22,
Rogers,Governor,Chad Moody,REP,660116,0,0,28,28,
Rogers,Governor,Mary Fallin,REP,660116,1,4,121,126,
Rogers,Superintendent of Public Instruction,Brian Kelly,REP,660116,0,1,41,42,
Rogers,Superintendent of Public Instruction,Janet Costello Barresi,REP,660116,0,0,27,27,
Rogers,Superintendent of Public Instruction,Joy Hofmeister,REP,660116,1,4,102,107,
Rogers,Insurance Commissioner,Bill Viner,REP,660116,0,0,52,52,
Rogers,Insurance Commissioner,John Doak,REP,660116,1,5,112,118,
Rogers,Corporation Commissioner,Todd Hiett,REP,660116,0,5,88,93,
Rogers,Corporation Commissioner,Cliff Branan,REP,660116,0,0,75,75,
Rogers,U.S. Senate,Evelyn Rogers,REP,660116,0,0,9,9,
Rogers,U.S. Senate,Rob Moye,REP,660116,0,0,2,2,
Rogers,U.S. Senate,D. Jean Mcbride-Samuels,REP,660116,0,0,2,2,
Rogers,U.S. Senate,Jim Inhofe,REP,660116,1,5,150,156,
Rogers,U.S. Senate,Erick Paul Wyatt,REP,660116,0,0,8,8,
Rogers,U.S. Senate,Andy Craig,REP,660116,0,0,4,4,
Rogers,U.S. Senate,T. Shannon,REP,660116,1,2,53,56,
Rogers,U.S. Senate,Randy Brogdon,REP,660116,0,1,22,23,
Rogers,U.S. Senate,Eric Mccray,REP,660116,0,0,4,4,
Rogers,U.S. Senate,Kevin Crow,REP,660116,0,0,1,1,
Rogers,U.S. Senate,James Lankford,REP,660116,0,2,88,90,
Rogers,U.S. Senate,Jason Weger,REP,660116,0,0,1,1,
Rogers,U.S. House,Darrel Robertson,REP,660116,0,0,25,25,02
Rogers,U.S. House,Markwayne Mullin,REP,660116,1,5,147,153,02
Rogers,Superintendent of Public Instruction,John Cox,DEM,660120,1,1,38,40,
Rogers,Superintendent of Public Instruction,Jack Jr.,DEM,660120,0,0,11,11,
Rogers,Superintendent of Public Instruction,Ivan Holmes,DEM,660120,1,0,5,6,
Rogers,Superintendent of Public Instruction,Freda Deskin,DEM,660120,0,0,34,34,
Rogers,U.S. Senate,Patrick Michael Hayes,DEM,660120,0,1,13,14,
Rogers,U.S. Senate,Jim Rogers,DEM,660120,1,0,32,33,
Rogers,U.S. Senate,Connie Johnson,DEM,660120,2,0,38,40,
Rogers,U.S. House,Earl Everett,DEM,660120,2,0,45,47,02
Rogers,U.S. House,Joshua Harris-Till,DEM,660120,0,0,31,31,02
Rogers,Governor,Dax Ewbank,REP,660120,0,2,9,11,
Rogers,Governor,Chad Moody,REP,660120,1,2,36,39,
Rogers,Governor,Mary Fallin,REP,660120,5,18,208,231,
Rogers,Superintendent of Public Instruction,Brian Kelly,REP,660120,1,2,49,52,
Rogers,Superintendent of Public Instruction,Janet Costello Barresi,REP,660120,2,6,39,47,
Rogers,Superintendent of Public Instruction,Joy Hofmeister,REP,660120,3,14,158,175,
Rogers,Insurance Commissioner,Bill Viner,REP,660120,1,5,75,81,
Rogers,Insurance Commissioner,John Doak,REP,660120,5,15,160,180,
Rogers,Corporation Commissioner,Todd Hiett,REP,660120,2,9,123,134,
Rogers,Corporation Commissioner,Cliff Branan,REP,660120,4,11,114,129,
Rogers,U.S. Senate,Evelyn Rogers,REP,660120,0,2,10,12,
Rogers,U.S. Senate,Rob Moye,REP,660120,0,1,7,8,
Rogers,U.S. Senate,D. Jean Mcbride-Samuels,REP,660120,0,0,3,3,
Rogers,U.S. Senate,Jim Inhofe,REP,660120,6,19,224,249,
Rogers,U.S. Senate,Erick Paul Wyatt,REP,660120,0,0,11,11,
Rogers,U.S. Senate,Andy Craig,REP,660120,0,0,1,1,
Rogers,U.S. Senate,T. Shannon,REP,660120,0,12,118,130,
Rogers,U.S. Senate,Randy Brogdon,REP,660120,2,4,23,29,
Rogers,U.S. Senate,Eric Mccray,REP,660120,0,0,4,4,
Rogers,U.S. Senate,Kevin Crow,REP,660120,0,0,2,2,
Rogers,U.S. Senate,James Lankford,REP,660120,4,6,105,115,
Rogers,U.S. Senate,Jason Weger,REP,660120,0,0,1,1,
Rogers,U.S. House,Darrel Robertson,REP,660120,0,5,41,46,02
Rogers,U.S. House,Markwayne Mullin,REP,660120,6,17,212,235,02
Rogers,Superintendent of Public Instruction,John Cox,DEM,660128,0,0,34,34,
Rogers,Superintendent of Public Instruction,Jack Jr.,DEM,660128,0,2,9,11,
Rogers,Superintendent of Public Instruction,Ivan Holmes,DEM,660128,0,0,10,10,
Rogers,Superintendent of Public Instruction,Freda Deskin,DEM,660128,0,1,42,43,
Rogers,U.S. Senate,Patrick Michael Hayes,DEM,660128,0,1,26,27,
Rogers,U.S. Senate,Jim Rogers,DEM,660128,0,1,24,25,
Rogers,U.S. Senate,Connie Johnson,DEM,660128,0,1,41,42,
Rogers,U.S. House,Earl Everett,DEM,660128,0,1,41,42,02
Rogers,U.S. House,Joshua Harris-Till,DEM,660128,0,2,43,45,02
Rogers,Governor,Dax Ewbank,REP,660128,0,0,6,6,
Rogers,Governor,Chad Moody,REP,660128,1,0,29,30,
Rogers,Governor,Mary Fallin,REP,660128,2,4,129,135,
Rogers,Superintendent of Public Instruction,Brian Kelly,REP,660128,0,1,34,35,
Rogers,Superintendent of Public Instruction,Janet Costello Barresi,REP,660128,0,0,20,20,
Rogers,Superintendent of Public Instruction,Joy Hofmeister,REP,660128,3,3,117,123,
Rogers,Insurance Commissioner,Bill Viner,REP,660128,1,0,41,42,
Rogers,Insurance Commissioner,John Doak,REP,660128,2,2,115,119,
Rogers,Corporation Commissioner,Todd Hiett,REP,660128,1,1,89,91,
Rogers,Corporation Commissioner,Cliff Branan,REP,660128,2,0,70,72,
Rogers,U.S. Senate,Evelyn Rogers,REP,660128,0,0,13,13,
Rogers,U.S. Senate,Rob Moye,REP,660128,0,0,2,2,
Rogers,U.S. Senate,D. Jean Mcbride-Samuels,REP,660128,0,0,2,2,
Rogers,U.S. Senate,Jim Inhofe,REP,660128,3,4,144,151,
Rogers,U.S. Senate,Erick Paul Wyatt,REP,660128,0,0,6,6,
Rogers,U.S. Senate,Andy Craig,REP,660128,0,0,0,0,
Rogers,U.S. Senate,T. Shannon,REP,660128,1,3,65,69,
Rogers,U.S. Senate,Randy Brogdon,REP,660128,1,0,24,25,
Rogers,U.S. Senate,Eric Mccray,REP,660128,0,0,5,5,
Rogers,U.S. Senate,Kevin Crow,REP,660128,0,0,0,0,
Rogers,U.S. Senate,James Lankford,REP,660128,1,1,77,79,
Rogers,U.S. Senate,Jason Weger,REP,660128,0,0,0,0,
Rogers,U.S. House,Darrel Robertson,REP,660128,0,1,35,36,02
Rogers,U.S. House,Markwayne Mullin,REP,660128,3,3,132,138,02
Rogers,Superintendent of Public Instruction,John Cox,DEM,660130,0,1,53,54,
Rogers,Superintendent of Public Instruction,Jack Jr.,DEM,660130,1,0,14,15,
Rogers,Superintendent of Public Instruction,Ivan Holmes,DEM,660130,0,1,5,6,
Rogers,Superintendent of Public Instruction,Freda Deskin,DEM,660130,2,1,37,40,
Rogers,U.S. Senate,Patrick Michael Hayes,DEM,660130,1,0,26,27,
Rogers,U.S. Senate,Jim Rogers,DEM,660130,0,1,29,30,
Rogers,U.S. Senate,Connie Johnson,DEM,660130,2,2,53,57,
Rogers,Governor,Dax Ewbank,REP,660130,1,0,29,30,
Rogers,Governor,Chad Moody,REP,660130,4,6,57,67,
Rogers,Governor,Mary Fallin,REP,660130,4,8,363,375,
Rogers,Superintendent of Public Instruction,Brian Kelly,REP,660130,2,2,81,85,
Rogers,Superintendent of Public Instruction,Janet Costello Barresi,REP,660130,0,0,60,60,
Rogers,Superintendent of Public Instruction,Joy Hofmeister,REP,660130,7,12,312,331,
Rogers,Insurance Commissioner,Bill Viner,REP,660130,3,3,98,104,
Rogers,Insurance Commissioner,John Doak,REP,660130,6,10,321,337,
Rogers,Corporation Commissioner,Todd Hiett,REP,660130,4,9,219,232,
Rogers,Corporation Commissioner,Cliff Branan,REP,660130,5,3,203,211,
Rogers,U.S. Senate,Evelyn Rogers,REP,660130,0,2,23,25,
Rogers,U.S. Senate,Rob Moye,REP,660130,0,0,2,2,
Rogers,U.S. Senate,D. Jean Mcbride-Samuels,REP,660130,0,0,4,4,
Rogers,U.S. Senate,Jim Inhofe,REP,660130,7,12,405,424,
Rogers,U.S. Senate,Erick Paul Wyatt,REP,660130,2,0,18,20,
Rogers,U.S. Senate,Andy Craig,REP,660130,0,0,1,1,
Rogers,U.S. Senate,T. Shannon,REP,660130,1,1,165,167,
Rogers,U.S. Senate,Randy Brogdon,REP,660130,2,3,80,85,
Rogers,U.S. Senate,Eric Mccray,REP,660130,1,0,2,3,
Rogers,U.S. Senate,Kevin Crow,REP,660130,0,1,0,1,
Rogers,U.S. Senate,James Lankford,REP,660130,5,8,209,222,
Rogers,U.S. Senate,Jason Weger,REP,660130,0,0,2,2,
Seminole,Superintendent of Public Instruction,John Cox,DEM,670010,1,2,66,69,
Seminole,Superintendent of Public Instruction,Jack Jr.,DEM,670010,0,1,17,18,
Seminole,Superintendent of Public Instruction,Ivan Holmes,DEM,670010,0,2,9,11,
Seminole,Superintendent of Public Instruction,Freda Deskin,DEM,670010,1,0,68,69,
Seminole,U.S. Senate,Patrick Michael Hayes,DEM,670010,0,2,28,30,
Seminole,U.S. Senate,Jim Rogers,DEM,670010,1,1,52,54,
Seminole,U.S. Senate,Connie Johnson,DEM,670010,1,2,73,76,
Seminole,U.S. House,Tom Guild,DEM,670010,1,3,82,86,05
Seminole,U.S. House,Al Mcaffrey,DEM,670010,0,1,34,35,05
Seminole,U.S. House,Leona Leonard,DEM,670010,1,1,43,45,05
Seminole,State Senate,Marilyn Rainwater,DEM,670010,2,3,114,119,28
Seminole,State Senate,Billy Hinton,DEM,670010,0,2,46,48,28
Seminole,Governor,Dax Ewbank,REP,670010,1,0,10,11,
Seminole,Governor,Chad Moody,REP,670010,0,1,13,14,
Seminole,Governor,Mary Fallin,REP,670010,4,13,85,102,
Seminole,Superintendent of Public Instruction,Brian Kelly,REP,670010,3,1,27,31,
Seminole,Superintendent of Public Instruction,Janet Costello Barresi,REP,670010,2,4,16,22,
Seminole,Superintendent of Public Instruction,Joy Hofmeister,REP,670010,0,9,63,72,
Seminole,Insurance Commissioner,Bill Viner,REP,670010,1,2,24,27,
Seminole,Insurance Commissioner,John Doak,REP,670010,4,12,71,87,
Seminole,Corporation Commissioner,Todd Hiett,REP,670010,2,6,50,58,
Seminole,Corporation Commissioner,Cliff Branan,REP,670010,3,7,48,58,
Seminole,U.S. Senate,Evelyn Rogers,REP,670010,1,1,3,5,
Seminole,U.S. Senate,Rob Moye,REP,670010,0,0,3,3,
Seminole,U.S. Senate,D. Jean Mcbride-Samuels,REP,670010,0,0,0,0,
Seminole,U.S. Senate,Jim Inhofe,REP,670010,4,13,92,109,
Seminole,U.S. Senate,Erick Paul Wyatt,REP,670010,0,0,10,10,
Seminole,U.S. Senate,Andy Craig,REP,670010,0,0,2,2,
Seminole,U.S. Senate,T. Shannon,REP,670010,3,4,34,41,
Seminole,U.S. Senate,Randy Brogdon,REP,670010,0,0,1,1,
Seminole,U.S. Senate,Eric Mccray,REP,670010,0,0,2,2,
Seminole,U.S. Senate,Kevin Crow,REP,670010,0,0,1,1,
Seminole,U.S. Senate,James Lankford,REP,670010,2,10,69,81,
Seminole,U.S. Senate,Jason Weger,REP,670010,0,0,0,0,
Seminole,U.S. House,Shane David Jett,REP,670010,2,3,44,49,05
Seminole,U.S. House,Patrice Douglas,REP,670010,1,5,20,26,05
Seminole,U.S. House,Mike Turner,REP,670010,2,1,13,16,05
Seminole,U.S. House,Steve Russell,REP,670010,0,4,14,18,05
Seminole,U.S. House,Harvey Sparks,REP,670010,0,0,5,5,05
Seminole,U.S. House,Clark Jolley,REP,670010,0,1,10,11,05
Seminole,State Senate,Jason Smalley,REP,670010,1,9,42,52,28
Seminole,State Senate,Danny Williams,REP,670010,1,1,29,31,28
Seminole,State Senate,Charles Mashek,REP,670010,0,4,10,14,28
Seminole,State Senate,Joe Dobry,REP,670010,3,0,14,17,28
Seminole,State Senate,Michael Ballard,REP,670010,0,0,7,7,28
Seminole,Superintendent of Public Instruction,John Cox,DEM,670012,0,0,6,6,
Seminole,Superintendent of Public Instruction,Jack Jr.,DEM,670012,0,0,8,8,
Seminole,Superintendent of Public Instruction,Ivan Holmes,DEM,670012,0,0,0,0,
Seminole,Superintendent of Public Instruction,Freda Deskin,DEM,670012,2,0,13,15,
Seminole,U.S. Senate,Patrick Michael Hayes,DEM,670012,0,0,8,8,
Seminole,U.S. Senate,Jim Rogers,DEM,670012,0,0,10,10,
Seminole,U.S. Senate,Connie Johnson,DEM,670012,2,0,9,11,
Seminole,U.S. House,Tom Guild,DEM,670012,0,0,13,13,05
Seminole,U.S. House,Al Mcaffrey,DEM,670012,2,0,7,9,05
Seminole,U.S. House,Leona Leonard,DEM,670012,0,0,6,6,05
Seminole,Governor,Dax Ewbank,REP,670012,0,0,6,6,
Seminole,Governor,Chad Moody,REP,670012,2,0,4,6,
Seminole,Governor,Mary Fallin,REP,670012,0,0,5,5,
Seminole,Superintendent of Public Instruction,Brian Kelly,REP,670012,0,0,8,8,
Seminole,Superintendent of Public Instruction,Janet Costello Barresi,REP,670012,0,0,0,0,
Seminole,Superintendent of Public Instruction,Joy Hofmeister,REP,670012,2,0,7,9,
Seminole,Insurance Commissioner,Bill Viner,REP,670012,0,0,2,2,
Seminole,Insurance Commissioner,John Doak,REP,670012,2,0,13,15,
Seminole,Corporation Commissioner,Todd Hiett,REP,670012,2,0,8,10,
Seminole,Corporation Commissioner,Cliff Branan,REP,670012,0,0,7,7,
Seminole,U.S. Senate,Evelyn Rogers,REP,670012,0,0,0,0,
Seminole,U.S. Senate,Rob Moye,REP,670012,2,0,0,2,
Seminole,U.S. Senate,D. Jean Mcbride-Samuels,REP,670012,0,0,0,0,
Seminole,U.S. Senate,Jim Inhofe,REP,670012,0,0,13,13,
Seminole,U.S. Senate,Erick Paul Wyatt,REP,670012,0,0,0,0,
Seminole,U.S. Senate,Andy Craig,REP,670012,0,0,0,0,
Seminole,U.S. Senate,T. Shannon,REP,670012,0,0,3,3,
Seminole,U.S. Senate,Randy Brogdon,REP,670012,0,0,5,5,
Seminole,U.S. Senate,Eric Mccray,REP,670012,0,0,0,0,
Seminole,U.S. Senate,Kevin Crow,REP,670012,0,0,0,0,
Seminole,U.S. Senate,James Lankford,REP,670012,2,0,6,8,
Seminole,U.S. Senate,Jason Weger,REP,670012,0,0,1,1,
Seminole,U.S. House,Shane David Jett,REP,670012,0,0,4,4,05
Seminole,U.S. House,Patrice Douglas,REP,670012,2,0,0,2,05
Seminole,U.S. House,Mike Turner,REP,670012,0,0,3,3,05
Seminole,U.S. House,Steve Russell,REP,670012,0,0,4,4,05
Seminole,U.S. House,Harvey Sparks,REP,670012,0,0,3,3,05
Seminole,U.S. House,Clark Jolley,REP,670012,0,0,1,1,05
Seminole,Superintendent of Public Instruction,John Cox,DEM,670014,0,1,79,80,
Seminole,Superintendent of Public Instruction,Jack Jr.,DEM,670014,1,0,42,43,
Seminole,Superintendent of Public Instruction,Ivan Holmes,DEM,670014,0,0,20,20,
Seminole,Superintendent of Public Instruction,Freda Deskin,DEM,670014,0,0,83,83,
Seminole,U.S. Senate,Patrick Michael Hayes,DEM,670014,0,0,57,57,
Seminole,U.S. Senate,Jim Rogers,DEM,670014,1,1,102,104,
Seminole,U.S. Senate,Connie Johnson,DEM,670014,0,0,50,50,
Seminole,U.S. House,Tom Guild,DEM,670014,0,0,120,120,05
Seminole,U.S. House,Al Mcaffrey,DEM,670014,1,0,51,52,05
Seminole,U.S. House,Leona Leonard,DEM,670014,0,0,39,39,05
Seminole,Governor,Dax Ewbank,REP,670014,0,0,16,16,
Seminole,Governor,Chad Moody,REP,670014,2,2,17,21,
Seminole,Governor,Mary Fallin,REP,670014,3,2,77,82,
Seminole,Superintendent of Public Instruction,Brian Kelly,REP,670014,1,0,29,30,
Seminole,Superintendent of Public Instruction,Janet Costello Barresi,REP,670014,4,0,13,17,
Seminole,Superintendent of Public Instruction,Joy Hofmeister,REP,670014,0,4,70,74,
Seminole,Insurance Commissioner,Bill Viner,REP,670014,2,1,34,37,
Seminole,Insurance Commissioner,John Doak,REP,670014,3,3,69,75,
Seminole,Corporation Commissioner,Todd Hiett,REP,670014,2,3,66,71,
Seminole,Corporation Commissioner,Cliff Branan,REP,670014,2,0,40,42,
Seminole,U.S. Senate,Evelyn Rogers,REP,670014,0,0,7,7,
Seminole,U.S. Senate,Rob Moye,REP,670014,0,0,2,2,
Seminole,U.S. Senate,D. Jean Mcbride-Samuels,REP,670014,0,0,4,4,
Seminole,U.S. Senate,Jim Inhofe,REP,670014,3,4,90,97,
Seminole,U.S. Senate,Erick Paul Wyatt,REP,670014,0,0,9,9,
Seminole,U.S. Senate,Andy Craig,REP,670014,1,0,0,1,
Seminole,U.S. Senate,T. Shannon,REP,670014,0,0,38,38,
Seminole,U.S. Senate,Randy Brogdon,REP,670014,0,0,7,7,
Seminole,U.S. Senate,Eric Mccray,REP,670014,0,0,0,0,
Seminole,U.S. Senate,Kevin Crow,REP,670014,0,0,3,3,
Seminole,U.S. Senate,James Lankford,REP,670014,4,4,64,72,
Seminole,U.S. Senate,Jason Weger,REP,670014,0,0,1,1,
Seminole,U.S. House,Shane David Jett,REP,670014,2,3,33,38,05
Seminole,U.S. House,Patrice Douglas,REP,670014,2,0,18,20,05
Seminole,U.S. House,Mike Turner,REP,670014,0,0,20,20,05
Seminole,U.S. House,Steve Russell,REP,670014,1,0,22,23,05
Seminole,U.S. House,Harvey Sparks,REP,670014,0,1,6,7,05
Seminole,U.S. House,Clark Jolley,REP,670014,0,0,10,10,05
Seminole,Superintendent of Public Instruction,John Cox,DEM,670015,0,4,49,53,
Seminole,Superintendent of Public Instruction,Jack Jr.,DEM,670015,0,0,21,21,
Seminole,Superintendent of Public Instruction,Ivan Holmes,DEM,670015,0,0,9,9,
Seminole,Superintendent of Public Instruction,Freda Deskin,DEM,670015,1,2,55,58,
Seminole,U.S. Senate,Patrick Michael Hayes,DEM,670015,0,5,32,37,
Seminole,U.S. Senate,Jim Rogers,DEM,670015,0,0,56,56,
Seminole,U.S. Senate,Connie Johnson,DEM,670015,1,1,42,44,
Seminole,U.S. House,Tom Guild,DEM,670015,0,5,71,76,05
Seminole,U.S. House,Al Mcaffrey,DEM,670015,1,0,31,32,05
Seminole,U.S. House,Leona Leonard,DEM,670015,0,1,27,28,05
Seminole,Governor,Dax Ewbank,REP,670015,0,0,4,4,
Seminole,Governor,Chad Moody,REP,670015,2,0,10,12,
Seminole,Governor,Mary Fallin,REP,670015,0,2,29,31,
Seminole,Superintendent of Public Instruction,Brian Kelly,REP,670015,0,0,11,11,
Seminole,Superintendent of Public Instruction,Janet Costello Barresi,REP,670015,0,0,10,10,
Seminole,Superintendent of Public Instruction,Joy Hofmeister,REP,670015,2,2,23,27,
Seminole,Insurance Commissioner,Bill Viner,REP,670015,0,0,10,10,
Seminole,Insurance Commissioner,John Doak,REP,670015,2,2,28,32,
Seminole,Corporation Commissioner,Todd Hiett,REP,670015,2,1,25,28,
Seminole,Corporation Commissioner,Cliff Branan,REP,670015,0,1,14,15,
Seminole,U.S. Senate,Evelyn Rogers,REP,670015,0,0,3,3,
Seminole,U.S. Senate,Rob Moye,REP,670015,0,0,2,2,
Seminole,U.S. Senate,D. Jean Mcbride-Samuels,REP,670015,0,0,4,4,
Seminole,U.S. Senate,Jim Inhofe,REP,670015,2,2,33,37,
Seminole,U.S. Senate,Erick Paul Wyatt,REP,670015,0,0,3,3,
Seminole,U.S. Senate,Andy Craig,REP,670015,0,0,1,1,
Seminole,U.S. Senate,T. Shannon,REP,670015,0,0,13,13,
Seminole,U.S. Senate,Randy Brogdon,REP,670015,0,0,6,6,
Seminole,U.S. Senate,Eric Mccray,REP,670015,0,0,0,0,
Seminole,U.S. Senate,Kevin Crow,REP,670015,0,0,0,0,
Seminole,U.S. Senate,James Lankford,REP,670015,2,2,25,29,
Seminole,U.S. Senate,Jason Weger,REP,670015,0,0,0,0,
Seminole,U.S. House,Shane David Jett,REP,670015,0,1,2,3,05
Seminole,U.S. House,Patrice Douglas,REP,670015,0,0,9,9,05
Seminole,U.S. House,Mike Turner,REP,670015,0,0,11,11,05
Seminole,U.S. House,Steve Russell,REP,670015,0,1,7,8,05
Seminole,U.S. House,Harvey Sparks,REP,670015,0,0,7,7,05
Seminole,U.S. House,Clark Jolley,REP,670015,2,0,4,6,05
Seminole,Superintendent of Public Instruction,John Cox,DEM,670020,0,1,36,37,
Seminole,Superintendent of Public Instruction,Jack Jr.,DEM,670020,2,0,9,11,
Seminole,Superintendent of Public Instruction,Ivan Holmes,DEM,670020,0,0,7,7,
Seminole,Superintendent of Public Instruction,Freda Deskin,DEM,670020,0,0,52,52,
Seminole,U.S. Senate,Patrick Michael Hayes,DEM,670020,0,0,19,19,
Seminole,U.S. Senate,Jim Rogers,DEM,670020,2,0,56,58,
Seminole,U.S. Senate,Connie Johnson,DEM,670020,0,1,28,29,
Seminole,U.S. House,Tom Guild,DEM,670020,2,0,66,68,05
Seminole,U.S. House,Al Mcaffrey,DEM,670020,0,0,19,19,05
Seminole,U.S. House,Leona Leonard,DEM,670020,0,1,18,19,05
Seminole,State Senate,Marilyn Rainwater,DEM,670020,0,1,62,63,28
Seminole,State Senate,Billy Hinton,DEM,670020,2,0,41,43,28
Seminole,Governor,Dax Ewbank,REP,670020,0,1,7,8,
Seminole,Governor,Chad Moody,REP,670020,0,0,13,13,
Seminole,Governor,Mary Fallin,REP,670020,0,1,88,89,
Seminole,Superintendent of Public Instruction,Brian Kelly,REP,670020,0,1,33,34,
Seminole,Superintendent of Public Instruction,Janet Costello Barresi,REP,670020,0,0,19,19,
Seminole,Superintendent of Public Instruction,Joy Hofmeister,REP,670020,0,1,58,59,
Seminole,Insurance Commissioner,Bill Viner,REP,670020,0,0,26,26,
Seminole,Insurance Commissioner,John Doak,REP,670020,0,1,79,80,
Seminole,Corporation Commissioner,Todd Hiett,REP,670020,0,0,47,47,
Seminole,Corporation Commissioner,Cliff Branan,REP,670020,0,2,55,57,
Seminole,U.S. Senate,Evelyn Rogers,REP,670020,0,0,5,5,
Seminole,U.S. Senate,Rob Moye,REP,670020,0,0,0,0,
Seminole,U.S. Senate,D. Jean Mcbride-Samuels,REP,670020,0,0,2,2,
Seminole,U.S. Senate,Jim Inhofe,REP,670020,0,2,97,99,
Seminole,U.S. Senate,Erick Paul Wyatt,REP,670020,0,0,5,5,
Seminole,U.S. Senate,Andy Craig,REP,670020,0,0,0,0,
Seminole,U.S. Senate,T. Shannon,REP,670020,0,0,28,28,
Seminole,U.S. Senate,Randy Brogdon,REP,670020,0,1,2,3,
Seminole,U.S. Senate,Eric Mccray,REP,670020,0,0,1,1,
Seminole,U.S. Senate,Kevin Crow,REP,670020,0,0,0,0,
Seminole,U.S. Senate,James Lankford,REP,670020,0,1,78,79,
Seminole,U.S. Senate,Jason Weger,REP,670020,0,0,0,0,
Seminole,U.S. House,Shane David Jett,REP,670020,0,0,34,34,05
Seminole,U.S. House,Patrice Douglas,REP,670020,0,1,20,21,05
Seminole,U.S. House,Mike Turner,REP,670020,0,0,15,15,05
Seminole,U.S. House,Steve Russell,REP,670020,0,0,18,18,05
Seminole,U.S. House,Harvey Sparks,REP,670020,0,0,3,3,05
Seminole,U.S. House,Clark Jolley,REP,670020,0,0,18,18,05
Seminole,State Senate,Jason Smalley,REP,670020,0,2,43,45,28
Seminole,State Senate,Danny Williams,REP,670020,0,0,43,43,28
Seminole,State Senate,Charles Mashek,REP,670020,0,0,3,3,28
Seminole,State Senate,Joe Dobry,REP,670020,0,0,9,9,28
Seminole,State Senate,Michael Ballard,REP,670020,0,0,8,8,28
Seminole,Superintendent of Public Instruction,John Cox,DEM,670022,1,1,51,53,
Seminole,Superintendent of Public Instruction,Jack Jr.,DEM,670022,0,0,13,13,
Seminole,Superintendent of Public Instruction,Ivan Holmes,DEM,670022,0,0,3,3,
Seminole,Superintendent of Public Instruction,Freda Deskin,DEM,670022,1,0,42,43,
Seminole,U.S. Senate,Patrick Michael Hayes,DEM,670022,0,0,25,25,
Seminole,U.S. Senate,Jim Rogers,DEM,670022,0,0,55,55,
Seminole,U.S. Senate,Connie Johnson,DEM,670022,2,1,28,31,
Seminole,U.S. House,Tom Guild,DEM,670022,0,0,54,54,05
Seminole,U.S. House,Al Mcaffrey,DEM,670022,1,1,26,28,05
Seminole,U.S. House,Leona Leonard,DEM,670022,1,0,25,26,05
Seminole,State Senate,Marilyn Rainwater,DEM,670022,1,1,73,75,28
Seminole,State Senate,Billy Hinton,DEM,670022,1,0,36,37,28
Seminole,Governor,Dax Ewbank,REP,670022,0,0,14,14,
Seminole,Governor,Chad Moody,REP,670022,1,1,14,16,
Seminole,Governor,Mary Fallin,REP,670022,3,5,82,90,
Seminole,Superintendent of Public Instruction,Brian Kelly,REP,670022,0,2,23,25,
Seminole,Superintendent of Public Instruction,Janet Costello Barresi,REP,670022,1,3,20,24,
Seminole,Superintendent of Public Instruction,Joy Hofmeister,REP,670022,3,1,67,71,
Seminole,Insurance Commissioner,Bill Viner,REP,670022,0,1,22,23,
Seminole,Insurance Commissioner,John Doak,REP,670022,4,5,85,94,
Seminole,Corporation Commissioner,Todd Hiett,REP,670022,1,4,48,53,
Seminole,Corporation Commissioner,Cliff Branan,REP,670022,3,2,59,64,
Seminole,U.S. Senate,Evelyn Rogers,REP,670022,0,0,7,7,
Seminole,U.S. Senate,Rob Moye,REP,670022,0,0,2,2,
Seminole,U.S. Senate,D. Jean Mcbride-Samuels,REP,670022,0,0,3,3,
Seminole,U.S. Senate,Jim Inhofe,REP,670022,3,6,93,102,
Seminole,U.S. Senate,Erick Paul Wyatt,REP,670022,1,0,7,8,
Seminole,U.S. Senate,Andy Craig,REP,670022,0,0,1,1,
Seminole,U.S. Senate,T. Shannon,REP,670022,3,2,25,30,
Seminole,U.S. Senate,Randy Brogdon,REP,670022,0,0,7,7,
Seminole,U.S. Senate,Eric Mccray,REP,670022,0,0,1,1,
Seminole,U.S. Senate,Kevin Crow,REP,670022,0,0,0,0,
Seminole,U.S. Senate,James Lankford,REP,670022,1,4,77,82,
Seminole,U.S. Senate,Jason Weger,REP,670022,0,0,1,1,
Seminole,U.S. House,Shane David Jett,REP,670022,0,0,35,35,05
Seminole,U.S. House,Patrice Douglas,REP,670022,2,2,16,20,05
Seminole,U.S. House,Mike Turner,REP,670022,1,1,13,15,05
Seminole,U.S. House,Steve Russell,REP,670022,1,0,24,25,05
Seminole,U.S. House,Harvey Sparks,REP,670022,0,0,3,3,05
Seminole,U.S. House,Clark Jolley,REP,670022,0,3,19,22,05
Seminole,State Senate,Jason Smalley,REP,670022,2,2,46,50,28
Seminole,State Senate,Danny Williams,REP,670022,0,2,32,34,28
Seminole,State Senate,Charles Mashek,REP,670022,0,0,9,9,28
Seminole,State Senate,Joe Dobry,REP,670022,1,1,15,17,28
Seminole,State Senate,Michael Ballard,REP,670022,0,1,7,8,28
Seminole,Superintendent of Public Instruction,John Cox,DEM,670023,2,4,61,67,
Seminole,Superintendent of Public Instruction,Jack Jr.,DEM,670023,1,1,26,28,
Seminole,Superintendent of Public Instruction,Ivan Holmes,DEM,670023,0,0,3,3,
Seminole,Superintendent of Public Instruction,Freda Deskin,DEM,670023,1,0,53,54,
Seminole,U.S. Senate,Patrick Michael Hayes,DEM,670023,2,2,33,37,
Seminole,U.S. Senate,Jim Rogers,DEM,670023,0,1,59,60,
Seminole,U.S. Senate,Connie Johnson,DEM,670023,2,2,47,51,
Seminole,U.S. House,Tom Guild,DEM,670023,1,3,92,96,05
Seminole,U.S. House,Al Mcaffrey,DEM,670023,2,2,23,27,05
Seminole,U.S. House,Leona Leonard,DEM,670023,0,0,23,23,05
Seminole,State Senate,Marilyn Rainwater,DEM,670023,3,0,96,99,28
Seminole,State Senate,Billy Hinton,DEM,670023,2,5,47,54,28
Seminole,Governor,Dax Ewbank,REP,670023,0,0,7,7,
Seminole,Governor,Chad Moody,REP,670023,0,1,18,19,
Seminole,Governor,Mary Fallin,REP,670023,5,2,116,123,
Seminole,Superintendent of Public Instruction,Brian Kelly,REP,670023,0,1,24,25,
Seminole,Superintendent of Public Instruction,Janet Costello Barresi,REP,670023,4,0,22,26,
Seminole,Superintendent of Public Instruction,Joy Hofmeister,REP,670023,1,1,92,94,
Seminole,Insurance Commissioner,Bill Viner,REP,670023,1,0,21,22,
Seminole,Insurance Commissioner,John Doak,REP,670023,4,3,111,118,
Seminole,Corporation Commissioner,Todd Hiett,REP,670023,3,1,80,84,
Seminole,Corporation Commissioner,Cliff Branan,REP,670023,1,1,53,55,
Seminole,U.S. Senate,Evelyn Rogers,REP,670023,0,0,4,4,
Seminole,U.S. Senate,Rob Moye,REP,670023,0,0,0,0,
Seminole,U.S. Senate,D. Jean Mcbride-Samuels,REP,670023,0,0,0,0,
Seminole,U.S. Senate,Jim Inhofe,REP,670023,5,3,128,136,
Seminole,U.S. Senate,Erick Paul Wyatt,REP,670023,0,0,7,7,
Seminole,U.S. Senate,Andy Craig,REP,670023,0,0,3,3,
Seminole,U.S. Senate,T. Shannon,REP,670023,2,0,29,31,
Seminole,U.S. Senate,Randy Brogdon,REP,670023,0,0,3,3,
Seminole,U.S. Senate,Eric Mccray,REP,670023,0,0,1,1,
Seminole,U.S. Senate,Kevin Crow,REP,670023,0,0,0,0,
Seminole,U.S. Senate,James Lankford,REP,670023,3,3,104,110,
Seminole,U.S. Senate,Jason Weger,REP,670023,0,0,0,0,
Seminole,U.S. House,Shane David Jett,REP,670023,0,1,48,49,05
Seminole,U.S. House,Patrice Douglas,REP,670023,1,1,25,27,05
Seminole,U.S. House,Mike Turner,REP,670023,2,0,10,12,05
Seminole,U.S. House,Steve Russell,REP,670023,2,0,25,27,05
Seminole,U.S. House,Harvey Sparks,REP,670023,0,0,9,9,05
Seminole,U.S. House,Clark Jolley,REP,670023,0,0,20,20,05
Seminole,State Senate,Jason Smalley,REP,670023,4,1,64,69,28
Seminole,State Senate,Danny Williams,REP,670023,0,2,36,38,28
Seminole,State Senate,Charles Mashek,REP,670023,0,0,17,17,28
Seminole,State Senate,Joe Dobry,REP,670023,0,0,15,15,28
Seminole,State Senate,Michael Ballard,REP,670023,0,0,4,4,28
Seminole,Superintendent of Public Instruction,John Cox,DEM,670024,1,1,46,48,
Seminole,Superintendent of Public Instruction,Jack Jr.,DEM,670024,0,0,9,9,
Seminole,Superintendent of Public Instruction,Ivan Holmes,DEM,670024,0,0,3,3,
Seminole,Superintendent of Public Instruction,Freda Deskin,DEM,670024,0,1,35,36,
Seminole,U.S. Senate,Patrick Michael Hayes,DEM,670024,0,1,24,25,
Seminole,U.S. Senate,Jim Rogers,DEM,670024,0,1,37,38,
Seminole,U.S. Senate,Connie Johnson,DEM,670024,1,0,29,30,
Seminole,U.S. House,Tom Guild,DEM,670024,0,2,48,50,05
Seminole,U.S. House,Al Mcaffrey,DEM,670024,1,0,20,21,05
Seminole,U.S. House,Leona Leonard,DEM,670024,0,0,22,22,05
Seminole,State Senate,Marilyn Rainwater,DEM,670024,0,1,61,62,28
Seminole,State Senate,Billy Hinton,DEM,670024,0,1,32,33,28
Seminole,Governor,Dax Ewbank,REP,670024,0,0,3,3,
Seminole,Governor,Chad Moody,REP,670024,0,1,14,15,
Seminole,Governor,Mary Fallin,REP,670024,2,3,63,68,
Seminole,Superintendent of Public Instruction,Brian Kelly,REP,670024,1,1,23,25,
Seminole,Superintendent of Public Instruction,Janet Costello Barresi,REP,670024,0,0,7,7,
Seminole,Superintendent of Public Instruction,Joy Hofmeister,REP,670024,0,3,51,54,
Seminole,Insurance Commissioner,Bill Viner,REP,670024,1,1,12,14,
Seminole,Insurance Commissioner,John Doak,REP,670024,0,3,67,70,
Seminole,Corporation Commissioner,Todd Hiett,REP,670024,2,2,38,42,
Seminole,Corporation Commissioner,Cliff Branan,REP,670024,0,2,41,43,
Seminole,U.S. Senate,Evelyn Rogers,REP,670024,0,0,4,4,
Seminole,U.S. Senate,Rob Moye,REP,670024,0,0,0,0,
Seminole,U.S. Senate,D. Jean Mcbride-Samuels,REP,670024,0,0,1,1,
Seminole,U.S. Senate,Jim Inhofe,REP,670024,2,4,66,72,
Seminole,U.S. Senate,Erick Paul Wyatt,REP,670024,0,0,10,10,
Seminole,U.S. Senate,Andy Craig,REP,670024,0,0,1,1,
Seminole,U.S. Senate,T. Shannon,REP,670024,1,0,17,18,
Seminole,U.S. Senate,Randy Brogdon,REP,670024,0,0,2,2,
Seminole,U.S. Senate,Eric Mccray,REP,670024,0,0,0,0,
Seminole,U.S. Senate,Kevin Crow,REP,670024,0,0,0,0,
Seminole,U.S. Senate,James Lankford,REP,670024,1,4,61,66,
Seminole,U.S. Senate,Jason Weger,REP,670024,0,0,0,0,
Seminole,U.S. House,Shane David Jett,REP,670024,1,1,26,28,05
Seminole,U.S. House,Patrice Douglas,REP,670024,0,0,9,9,05
Seminole,U.S. House,Mike Turner,REP,670024,0,0,10,10,05
Seminole,U.S. House,Steve Russell,REP,670024,0,0,13,13,05
Seminole,U.S. House,Harvey Sparks,REP,670024,0,0,2,2,05
Seminole,U.S. House,Clark Jolley,REP,670024,0,3,20,23,05
Seminole,State Senate,Jason Smalley,REP,670024,2,0,37,39,28
Seminole,State Senate,Danny Williams,REP,670024,0,2,20,22,28
Seminole,State Senate,Charles Mashek,REP,670024,0,0,3,3,28
Seminole,State Senate,Joe Dobry,REP,670024,0,0,6,6,28
Seminole,State Senate,Michael Ballard,REP,670024,0,2,13,15,28
Seminole,Superintendent of Public Instruction,John Cox,DEM,670025,2,2,14,18,
Seminole,Superintendent of Public Instruction,Jack Jr.,DEM,670025,0,0,2,2,
Seminole,Superintendent of Public Instruction,Ivan Holmes,DEM,670025,2,0,4,6,
Seminole,Superintendent of Public Instruction,Freda Deskin,DEM,670025,2,1,7,10,
Seminole,U.S. Senate,Patrick Michael Hayes,DEM,670025,3,0,7,10,
Seminole,U.S. Senate,Jim Rogers,DEM,670025,1,1,12,14,
Seminole,U.S. Senate,Connie Johnson,DEM,670025,2,2,8,12,
Seminole,U.S. House,Tom Guild,DEM,670025,2,1,17,20,05
Seminole,U.S. House,Al Mcaffrey,DEM,670025,4,1,6,11,05
Seminole,U.S. House,Leona Leonard,DEM,670025,0,1,4,5,05
Seminole,Governor,Dax Ewbank,REP,670025,0,0,2,2,
Seminole,Governor,Chad Moody,REP,670025,0,0,1,1,
Seminole,Governor,Mary Fallin,REP,670025,0,2,22,24,
Seminole,Superintendent of Public Instruction,Brian Kelly,REP,670025,0,1,4,5,
Seminole,Superintendent of Public Instruction,Janet Costello Barresi,REP,670025,0,0,4,4,
Seminole,Superintendent of Public Instruction,Joy Hofmeister,REP,670025,0,1,15,16,
Seminole,Insurance Commissioner,Bill Viner,REP,670025,0,2,2,4,
Seminole,Insurance Commissioner,John Doak,REP,670025,0,0,22,22,
Seminole,Corporation Commissioner,Todd Hiett,REP,670025,0,0,11,11,
Seminole,Corporation Commissioner,Cliff Branan,REP,670025,0,2,14,16,
Seminole,U.S. Senate,Evelyn Rogers,REP,670025,0,0,0,0,
Seminole,U.S. Senate,Rob Moye,REP,670025,0,0,0,0,
Seminole,U.S. Senate,D. Jean Mcbride-Samuels,REP,670025,0,0,1,1,
Seminole,U.S. Senate,Jim Inhofe,REP,670025,0,2,22,24,
Seminole,U.S. Senate,Erick Paul Wyatt,REP,670025,0,0,2,2,
Seminole,U.S. Senate,Andy Craig,REP,670025,0,0,0,0,
Seminole,U.S. Senate,T. Shannon,REP,670025,0,0,5,5,
Seminole,U.S. Senate,Randy Brogdon,REP,670025,0,0,0,0,
Seminole,U.S. Senate,Eric Mccray,REP,670025,0,0,0,0,
Seminole,U.S. Senate,Kevin Crow,REP,670025,0,0,0,0,
Seminole,U.S. Senate,James Lankford,REP,670025,0,2,20,22,
Seminole,U.S. Senate,Jason Weger,REP,670025,0,0,0,0,
Seminole,U.S. House,Shane David Jett,REP,670025,0,2,10,12,05
Seminole,U.S. House,Patrice Douglas,REP,670025,0,0,6,6,05
Seminole,U.S. House,Mike Turner,REP,670025,0,0,2,2,05
Seminole,U.S. House,Steve Russell,REP,670025,0,0,4,4,05
Seminole,U.S. House,Harvey Sparks,REP,670025,0,0,2,2,05
Seminole,U.S. House,Clark Jolley,REP,670025,0,0,1,1,05
Seminole,Superintendent of Public Instruction,John Cox,DEM,670030,0,0,29,29,
Seminole,Superintendent of Public Instruction,Jack Jr.,DEM,670030,0,0,13,13,
Seminole,Superintendent of Public Instruction,Ivan Holmes,DEM,670030,0,0,5,5,
Seminole,Superintendent of Public Instruction,Freda Deskin,DEM,670030,0,0,25,25,
Seminole,U.S. Senate,Patrick Michael Hayes,DEM,670030,0,0,13,13,
Seminole,U.S. Senate,Jim Rogers,DEM,670030,0,0,30,30,
Seminole,U.S. Senate,Connie Johnson,DEM,670030,0,0,24,24,
Seminole,U.S. House,Tom Guild,DEM,670030,0,0,31,31,05
Seminole,U.S. House,Al Mcaffrey,DEM,670030,0,0,13,13,05
Seminole,U.S. House,Leona Leonard,DEM,670030,0,0,21,21,05
Seminole,State Senate,Marilyn Rainwater,DEM,670030,0,0,37,37,28
Seminole,State Senate,Billy Hinton,DEM,670030,0,0,29,29,28
Seminole,Governor,Dax Ewbank,REP,670030,0,0,4,4,
Seminole,Governor,Chad Moody,REP,670030,0,0,1,1,
Seminole,Governor,Mary Fallin,REP,670030,0,0,24,24,
Seminole,Superintendent of Public Instruction,Brian Kelly,REP,670030,0,0,5,5,
Seminole,Superintendent of Public Instruction,Janet Costello Barresi,REP,670030,0,0,4,4,
Seminole,Superintendent of Public Instruction,Joy Hofmeister,REP,670030,0,0,21,21,
Seminole,Insurance Commissioner,Bill Viner,REP,670030,0,0,5,5,
Seminole,Insurance Commissioner,John Doak,REP,670030,0,0,25,25,
Seminole,Corporation Commissioner,Todd Hiett,REP,670030,0,0,19,19,
Seminole,Corporation Commissioner,Cliff Branan,REP,670030,0,0,11,11,
Seminole,U.S. Senate,Evelyn Rogers,REP,670030,0,0,2,2,
Seminole,U.S. Senate,Rob Moye,REP,670030,0,0,0,0,
Seminole,U.S. Senate,D. Jean Mcbride-Samuels,REP,670030,0,0,0,0,
Seminole,U.S. Senate,Jim Inhofe,REP,670030,0,0,25,25,
Seminole,U.S. Senate,Erick Paul Wyatt,REP,670030,0,0,4,4,
Seminole,U.S. Senate,Andy Craig,REP,670030,0,0,0,0,
Seminole,U.S. Senate,T. Shannon,REP,670030,0,0,6,6,
Seminole,U.S. Senate,Randy Brogdon,REP,670030,0,0,2,2,
Seminole,U.S. Senate,Eric Mccray,REP,670030,0,0,0,0,
Seminole,U.S. Senate,Kevin Crow,REP,670030,0,0,0,0,
Seminole,U.S. Senate,James Lankford,REP,670030,0,0,23,23,
Seminole,U.S. Senate,Jason Weger,REP,670030,0,0,0,0,
Seminole,U.S. House,Shane David Jett,REP,670030,0,0,6,6,05
Seminole,U.S. House,Patrice Douglas,REP,670030,0,0,3,3,05
Seminole,U.S. House,Mike Turner,REP,670030,0,0,11,11,05
Seminole,U.S. House,Steve Russell,REP,670030,0,0,6,6,05
Seminole,U.S. House,Harvey Sparks,REP,670030,0,0,1,1,05
Seminole,U.S. House,Clark Jolley,REP,670030,0,0,4,4,05
Seminole,State Senate,Jason Smalley,REP,670030,0,0,17,17,28
Seminole,State Senate,Danny Williams,REP,670030,0,0,6,6,28
Seminole,State Senate,Charles Mashek,REP,670030,0,0,0,0,28
Seminole,State Senate,Joe Dobry,REP,670030,0,0,4,4,28
Seminole,State Senate,Michael Ballard,REP,670030,0,0,4,4,28
Seminole,Superintendent of Public Instruction,John Cox,DEM,670032,3,8,86,97,
Seminole,Superintendent of Public Instruction,Jack Jr.,DEM,670032,0,1,21,22,
Seminole,Superintendent of Public Instruction,Ivan Holmes,DEM,670032,0,1,15,16,
Seminole,Superintendent of Public Instruction,Freda Deskin,DEM,670032,1,7,56,64,
Seminole,U.S. Senate,Patrick Michael Hayes,DEM,670032,1,5,31,37,
Seminole,U.S. Senate,Jim Rogers,DEM,670032,2,8,85,95,
Seminole,U.S. Senate,Connie Johnson,DEM,670032,1,3,54,58,
Seminole,U.S. House,Tom Guild,DEM,670032,2,11,107,120,05
Seminole,U.S. House,Al Mcaffrey,DEM,670032,0,4,27,31,05
Seminole,U.S. House,Leona Leonard,DEM,670032,2,2,33,37,05
Seminole,State Senate,Marilyn Rainwater,DEM,670032,4,13,106,123,28
Seminole,State Senate,Billy Hinton,DEM,670032,0,5,69,74,28
Seminole,Governor,Dax Ewbank,REP,670032,0,2,7,9,
Seminole,Governor,Chad Moody,REP,670032,0,0,13,13,
Seminole,Governor,Mary Fallin,REP,670032,1,12,49,62,
Seminole,Superintendent of Public Instruction,Brian Kelly,REP,670032,1,5,22,28,
Seminole,Superintendent of Public Instruction,Janet Costello Barresi,REP,670032,0,2,8,10,
Seminole,Superintendent of Public Instruction,Joy Hofmeister,REP,670032,0,7,37,44,
Seminole,Insurance Commissioner,Bill Viner,REP,670032,0,5,17,22,
Seminole,Insurance Commissioner,John Doak,REP,670032,1,9,47,57,
Seminole,Corporation Commissioner,Todd Hiett,REP,670032,1,3,25,29,
Seminole,Corporation Commissioner,Cliff Branan,REP,670032,0,10,33,43,
Seminole,U.S. Senate,Evelyn Rogers,REP,670032,0,0,1,1,
Seminole,U.S. Senate,Rob Moye,REP,670032,0,0,1,1,
Seminole,U.S. Senate,D. Jean Mcbride-Samuels,REP,670032,0,0,1,1,
Seminole,U.S. Senate,Jim Inhofe,REP,670032,1,14,60,75,
Seminole,U.S. Senate,Erick Paul Wyatt,REP,670032,0,0,3,3,
Seminole,U.S. Senate,Andy Craig,REP,670032,0,0,0,0,
Seminole,U.S. Senate,T. Shannon,REP,670032,1,3,28,32,
Seminole,U.S. Senate,Randy Brogdon,REP,670032,0,1,0,1,
Seminole,U.S. Senate,Eric Mccray,REP,670032,0,0,0,0,
Seminole,U.S. Senate,Kevin Crow,REP,670032,0,0,0,0,
Seminole,U.S. Senate,James Lankford,REP,670032,0,10,41,51,
Seminole,U.S. Senate,Jason Weger,REP,670032,0,0,0,0,
Seminole,U.S. House,Shane David Jett,REP,670032,0,4,23,27,05
Seminole,U.S. House,Patrice Douglas,REP,670032,0,5,13,18,05
Seminole,U.S. House,Mike Turner,REP,670032,0,3,6,9,05
Seminole,U.S. House,Steve Russell,REP,670032,1,1,19,21,05
Seminole,U.S. House,Harvey Sparks,REP,670032,0,0,2,2,05
Seminole,U.S. House,Clark Jolley,REP,670032,0,1,2,3,05
Seminole,State Senate,Jason Smalley,REP,670032,1,8,31,40,28
Seminole,State Senate,Danny Williams,REP,670032,0,5,25,30,28
Seminole,State Senate,Charles Mashek,REP,670032,0,0,1,1,28
Seminole,State Senate,Joe Dobry,REP,670032,0,0,7,7,28
Seminole,State Senate,Michael Ballard,REP,670032,0,1,1,2,28
Seminole,Superintendent of Public Instruction,John Cox,DEM,670033,0,0,11,11,
Seminole,Superintendent of Public Instruction,Jack Jr.,DEM,670033,0,0,0,0,
Seminole,Superintendent of Public Instruction,Ivan Holmes,DEM,670033,0,0,1,1,
Seminole,Superintendent of Public Instruction,Freda Deskin,DEM,670033,0,0,6,6,
Seminole,U.S. Senate,Patrick Michael Hayes,DEM,670033,0,0,4,4,
Seminole,U.S. Senate,Jim Rogers,DEM,670033,0,1,9,10,
Seminole,U.S. Senate,Connie Johnson,DEM,670033,0,0,5,5,
Seminole,U.S. House,Tom Guild,DEM,670033,0,0,11,11,05
Seminole,U.S. House,Al Mcaffrey,DEM,670033,0,0,4,4,05
Seminole,U.S. House,Leona Leonard,DEM,670033,0,0,3,3,05
Seminole,Governor,Dax Ewbank,REP,670033,0,0,2,2,
Seminole,Governor,Chad Moody,REP,670033,0,2,5,7,
Seminole,Governor,Mary Fallin,REP,670033,0,2,11,13,
Seminole,Superintendent of Public Instruction,Brian Kelly,REP,670033,0,1,2,3,
Seminole,Superintendent of Public Instruction,Janet Costello Barresi,REP,670033,0,0,1,1,
Seminole,Superintendent of Public Instruction,Joy Hofmeister,REP,670033,0,3,15,18,
Seminole,Insurance Commissioner,Bill Viner,REP,670033,0,0,4,4,
Seminole,Insurance Commissioner,John Doak,REP,670033,0,3,12,15,
Seminole,Corporation Commissioner,Todd Hiett,REP,670033,0,3,8,11,
Seminole,Corporation Commissioner,Cliff Branan,REP,670033,0,0,9,9,
Seminole,U.S. Senate,Evelyn Rogers,REP,670033,0,0,0,0,
Seminole,U.S. Senate,Rob Moye,REP,670033,0,0,0,0,
Seminole,U.S. Senate,D. Jean Mcbride-Samuels,REP,670033,0,0,0,0,
Seminole,U.S. Senate,Jim Inhofe,REP,670033,0,4,17,21,
Seminole,U.S. Senate,Erick Paul Wyatt,REP,670033,0,0,1,1,
Seminole,U.S. Senate,Andy Craig,REP,670033,0,0,0,0,
Seminole,U.S. Senate,T. Shannon,REP,670033,0,1,0,1,
Seminole,U.S. Senate,Randy Brogdon,REP,670033,0,1,1,2,
Seminole,U.S. Senate,Eric Mccray,REP,670033,0,0,0,0,
Seminole,U.S. Senate,Kevin Crow,REP,670033,0,0,0,0,
Seminole,U.S. Senate,James Lankford,REP,670033,0,1,17,18,
Seminole,U.S. Senate,Jason Weger,REP,670033,0,0,0,0,
Seminole,U.S. House,Shane David Jett,REP,670033,0,3,2,5,05
Seminole,U.S. House,Patrice Douglas,REP,670033,0,0,4,4,05
Seminole,U.S. House,Mike Turner,REP,670033,0,0,3,3,05
Seminole,U.S. House,Steve Russell,REP,670033,0,1,5,6,05
Seminole,U.S. House,Harvey Sparks,REP,670033,0,0,1,1,05
Seminole,U.S. House,Clark Jolley,REP,670033,0,0,2,2,05
Seminole,Superintendent of Public Instruction,John Cox,DEM,670034,4,38,143,185,
Seminole,Superintendent of Public Instruction,Jack Jr.,DEM,670034,2,16,61,79,
Seminole,Superintendent of Public Instruction,Ivan Holmes,DEM,670034,2,1,17,20,
Seminole,Superintendent of Public Instruction,Freda Deskin,DEM,670034,0,16,111,127,
Seminole,U.S. Senate,Patrick Michael Hayes,DEM,670034,0,21,75,96,
Seminole,U.S. Senate,Jim Rogers,DEM,670034,5,28,132,165,
Seminole,U.S. Senate,Connie Johnson,DEM,670034,3,19,120,142,
Seminole,U.S. House,Tom Guild,DEM,670034,5,44,183,232,05
Seminole,U.S. House,Al Mcaffrey,DEM,670034,0,9,52,61,05
Seminole,U.S. House,Leona Leonard,DEM,670034,4,14,91,109,05
Seminole,State Senate,Marilyn Rainwater,DEM,670034,8,47,228,283,28
Seminole,State Senate,Billy Hinton,DEM,670034,1,21,109,131,28
Seminole,Governor,Dax Ewbank,REP,670034,0,2,9,11,
Seminole,Governor,Chad Moody,REP,670034,0,2,18,20,
Seminole,Governor,Mary Fallin,REP,670034,0,6,69,75,
Seminole,Superintendent of Public Instruction,Brian Kelly,REP,670034,0,1,20,21,
Seminole,Superintendent of Public Instruction,Janet Costello Barresi,REP,670034,0,3,15,18,
Seminole,Superintendent of Public Instruction,Joy Hofmeister,REP,670034,0,6,61,67,
Seminole,Insurance Commissioner,Bill Viner,REP,670034,0,2,22,24,
Seminole,Insurance Commissioner,John Doak,REP,670034,0,5,72,77,
Seminole,Corporation Commissioner,Todd Hiett,REP,670034,0,5,56,61,
Seminole,Corporation Commissioner,Cliff Branan,REP,670034,0,4,34,38,
Seminole,U.S. Senate,Evelyn Rogers,REP,670034,0,0,3,3,
Seminole,U.S. Senate,Rob Moye,REP,670034,0,0,0,0,
Seminole,U.S. Senate,D. Jean Mcbride-Samuels,REP,670034,0,0,3,3,
Seminole,U.S. Senate,Jim Inhofe,REP,670034,0,8,85,93,
Seminole,U.S. Senate,Erick Paul Wyatt,REP,670034,0,2,6,8,
Seminole,U.S. Senate,Andy Craig,REP,670034,0,0,0,0,
Seminole,U.S. Senate,T. Shannon,REP,670034,0,3,24,27,
Seminole,U.S. Senate,Randy Brogdon,REP,670034,0,0,2,2,
Seminole,U.S. Senate,Eric Mccray,REP,670034,0,0,1,1,
Seminole,U.S. Senate,Kevin Crow,REP,670034,0,0,0,0,
Seminole,U.S. Senate,James Lankford,REP,670034,0,6,70,76,
Seminole,U.S. Senate,Jason Weger,REP,670034,0,1,0,1,
Seminole,U.S. House,Shane David Jett,REP,670034,0,3,19,22,05
Seminole,U.S. House,Patrice Douglas,REP,670034,0,1,20,21,05
Seminole,U.S. House,Mike Turner,REP,670034,0,1,17,18,05
Seminole,U.S. House,Steve Russell,REP,670034,0,2,21,23,05
Seminole,U.S. House,Harvey Sparks,REP,670034,0,0,4,4,05
Seminole,U.S. House,Clark Jolley,REP,670034,0,2,12,14,05
Seminole,State Senate,Jason Smalley,REP,670034,0,2,37,39,28
Seminole,State Senate,Danny Williams,REP,670034,0,3,25,28,28
Seminole,State Senate,Charles Mashek,REP,670034,0,1,10,11,28
Seminole,State Senate,Joe Dobry,REP,670034,0,2,11,13,28
Seminole,State Senate,Michael Ballard,REP,670034,0,0,12,12,28
Seminole,Superintendent of Public Instruction,John Cox,DEM,670035,0,0,27,27,
Seminole,Superintendent of Public Instruction,Jack Jr.,DEM,670035,0,0,15,15,
Seminole,Superintendent of Public Instruction,Ivan Holmes,DEM,670035,0,0,3,3,
Seminole,Superintendent of Public Instruction,Freda Deskin,DEM,670035,0,1,19,20,
Seminole,U.S. Senate,Patrick Michael Hayes,DEM,670035,0,0,19,19,
Seminole,U.S. Senate,Jim Rogers,DEM,670035,0,0,23,23,
Seminole,U.S. Senate,Connie Johnson,DEM,670035,0,0,22,22,
Seminole,U.S. House,Tom Guild,DEM,670035,0,0,39,39,05
Seminole,U.S. House,Al Mcaffrey,DEM,670035,0,0,11,11,05
Seminole,U.S. House,Leona Leonard,DEM,670035,0,0,15,15,05
Seminole,State Senate,Marilyn Rainwater,DEM,670035,0,1,38,39,28
Seminole,State Senate,Billy Hinton,DEM,670035,0,0,28,28,28
Seminole,Governor,Dax Ewbank,REP,670035,1,0,5,6,
Seminole,Governor,Chad Moody,REP,670035,0,0,15,15,
Seminole,Governor,Mary Fallin,REP,670035,0,2,49,51,
Seminole,Superintendent of Public Instruction,Brian Kelly,REP,670035,0,1,22,23,
Seminole,Superintendent of Public Instruction,Janet Costello Barresi,REP,670035,0,0,9,9,
Seminole,Superintendent of Public Instruction,Joy Hofmeister,REP,670035,1,1,36,38,
Seminole,Insurance Commissioner,Bill Viner,REP,670035,0,1,25,26,
Seminole,Insurance Commissioner,John Doak,REP,670035,1,1,42,44,
Seminole,Corporation Commissioner,Todd Hiett,REP,670035,1,0,39,40,
Seminole,Corporation Commissioner,Cliff Branan,REP,670035,0,2,26,28,
Seminole,U.S. Senate,Evelyn Rogers,REP,670035,0,0,3,3,
Seminole,U.S. Senate,Rob Moye,REP,670035,0,1,1,2,
Seminole,U.S. Senate,D. Jean Mcbride-Samuels,REP,670035,0,0,0,0,
Seminole,U.S. Senate,Jim Inhofe,REP,670035,1,1,64,66,
Seminole,U.S. Senate,Erick Paul Wyatt,REP,670035,0,0,1,1,
Seminole,U.S. Senate,Andy Craig,REP,670035,0,0,0,0,
Seminole,U.S. Senate,T. Shannon,REP,670035,1,1,20,22,
Seminole,U.S. Senate,Randy Brogdon,REP,670035,0,0,4,4,
Seminole,U.S. Senate,Eric Mccray,REP,670035,0,0,1,1,
Seminole,U.S. Senate,Kevin Crow,REP,670035,0,0,0,0,
Seminole,U.S. Senate,James Lankford,REP,670035,0,0,44,44,
Seminole,U.S. Senate,Jason Weger,REP,670035,0,1,0,1,
Seminole,U.S. House,Shane David Jett,REP,670035,0,0,26,26,05
Seminole,U.S. House,Patrice Douglas,REP,670035,0,0,11,11,05
Seminole,U.S. House,Mike Turner,REP,670035,0,1,5,6,05
Seminole,U.S. House,Steve Russell,REP,670035,0,0,16,16,05
Seminole,U.S. House,Harvey Sparks,REP,670035,0,0,3,3,05
Seminole,U.S. House,Clark Jolley,REP,670035,1,0,7,8,05
Seminole,State Senate,Jason Smalley,REP,670035,0,1,28,29,28
Seminole,State Senate,Danny Williams,REP,670035,0,0,27,27,28
Seminole,State Senate,Charles Mashek,REP,670035,0,1,3,4,28
Seminole,State Senate,Joe Dobry,REP,670035,1,0,5,6,28
Seminole,State Senate,Michael Ballard,REP,670035,0,0,5,5,28
Sequoyah,Superintendent of Public Instruction,John Cox,DEM,680101,1,4,124,129,
Sequoyah,Superintendent of Public Instruction,Jack Jr.,DEM,680101,0,0,17,17,
Sequoyah,Superintendent of Public Instruction,Ivan Holmes,DEM,680101,0,0,7,7,
Sequoyah,Superintendent of Public Instruction,Freda Deskin,DEM,680101,0,1,16,17,
Sequoyah,U.S. Senate,Patrick Michael Hayes,DEM,680101,0,1,33,34,
Sequoyah,U.S. Senate,Jim Rogers,DEM,680101,0,2,85,87,
Sequoyah,U.S. Senate,Connie Johnson,DEM,680101,1,0,34,35,
Sequoyah,U.S. House,Earl Everett,DEM,680101,0,3,103,106,02
Sequoyah,U.S. House,Joshua Harris-Till,DEM,680101,1,0,50,51,02
Sequoyah,Governor,Dax Ewbank,REP,680101,0,0,9,9,
Sequoyah,Governor,Chad Moody,REP,680101,0,1,15,16,
Sequoyah,Governor,Mary Fallin,REP,680101,0,2,48,50,
Sequoyah,Superintendent of Public Instruction,Brian Kelly,REP,680101,0,2,16,18,
Sequoyah,Superintendent of Public Instruction,Janet Costello Barresi,REP,680101,0,1,10,11,
Sequoyah,Superintendent of Public Instruction,Joy Hofmeister,REP,680101,0,0,42,42,
Sequoyah,Insurance Commissioner,Bill Viner,REP,680101,0,0,24,24,
Sequoyah,Insurance Commissioner,John Doak,REP,680101,0,2,34,36,
Sequoyah,Corporation Commissioner,Todd Hiett,REP,680101,0,1,25,26,
Sequoyah,Corporation Commissioner,Cliff Branan,REP,680101,0,1,29,30,
Sequoyah,U.S. Senate,Evelyn Rogers,REP,680101,0,1,1,2,
Sequoyah,U.S. Senate,Rob Moye,REP,680101,0,0,4,4,
Sequoyah,U.S. Senate,D. Jean Mcbride-Samuels,REP,680101,0,0,1,1,
Sequoyah,U.S. Senate,Jim Inhofe,REP,680101,0,2,55,57,
Sequoyah,U.S. Senate,Erick Paul Wyatt,REP,680101,0,0,5,5,
Sequoyah,U.S. Senate,Andy Craig,REP,680101,0,0,3,3,
Sequoyah,U.S. Senate,T. Shannon,REP,680101,0,1,31,32,
Sequoyah,U.S. Senate,Randy Brogdon,REP,680101,0,0,1,1,
Sequoyah,U.S. Senate,Eric Mccray,REP,680101,0,0,2,2,
Sequoyah,U.S. Senate,Kevin Crow,REP,680101,0,0,4,4,
Sequoyah,U.S. Senate,James Lankford,REP,680101,0,0,25,25,
Sequoyah,U.S. Senate,Jason Weger,REP,680101,0,1,1,2,
Sequoyah,U.S. House,Darrel Robertson,REP,680101,0,1,16,17,02
Sequoyah,U.S. House,Markwayne Mullin,REP,680101,0,2,50,52,02
Sequoyah,Superintendent of Public Instruction,John Cox,DEM,680102,0,0,51,51,
Sequoyah,Superintendent of Public Instruction,Jack Jr.,DEM,680102,0,1,5,6,
Sequoyah,Superintendent of Public Instruction,Ivan Holmes,DEM,680102,0,0,7,7,
Sequoyah,Superintendent of Public Instruction,Freda Deskin,DEM,680102,0,0,10,10,
Sequoyah,U.S. Senate,Patrick Michael Hayes,DEM,680102,0,0,10,10,
Sequoyah,U.S. Senate,Jim Rogers,DEM,680102,0,1,42,43,
Sequoyah,U.S. Senate,Connie Johnson,DEM,680102,0,0,17,17,
Sequoyah,U.S. House,Earl Everett,DEM,680102,0,1,37,38,02
Sequoyah,U.S. House,Joshua Harris-Till,DEM,680102,0,0,29,29,02
Sequoyah,Governor,Dax Ewbank,REP,680102,0,0,6,6,
Sequoyah,Governor,Chad Moody,REP,680102,0,0,9,9,
Sequoyah,Governor,Mary Fallin,REP,680102,0,0,25,25,
Sequoyah,Superintendent of Public Instruction,Brian Kelly,REP,680102,0,0,8,8,
Sequoyah,Superintendent of Public Instruction,Janet Costello Barresi,REP,680102,0,0,6,6,
Sequoyah,Superintendent of Public Instruction,Joy Hofmeister,REP,680102,0,0,24,24,
Sequoyah,Insurance Commissioner,Bill Viner,REP,680102,0,0,15,15,
Sequoyah,Insurance Commissioner,John Doak,REP,680102,0,0,22,22,
Sequoyah,Corporation Commissioner,Todd Hiett,REP,680102,0,0,15,15,
Sequoyah,Corporation Commissioner,Cliff Branan,REP,680102,0,0,19,19,
Sequoyah,U.S. Senate,Evelyn Rogers,REP,680102,0,0,2,2,
Sequoyah,U.S. Senate,Rob Moye,REP,680102,0,0,0,0,
Sequoyah,U.S. Senate,D. Jean Mcbride-Samuels,REP,680102,0,0,0,0,
Sequoyah,U.S. Senate,Jim Inhofe,REP,680102,0,0,29,29,
Sequoyah,U.S. Senate,Erick Paul Wyatt,REP,680102,0,0,8,8,
Sequoyah,U.S. Senate,Andy Craig,REP,680102,0,0,3,3,
Sequoyah,U.S. Senate,T. Shannon,REP,680102,0,0,16,16,
Sequoyah,U.S. Senate,Randy Brogdon,REP,680102,0,0,3,3,
Sequoyah,U.S. Senate,Eric Mccray,REP,680102,0,0,2,2,
Sequoyah,U.S. Senate,Kevin Crow,REP,680102,0,0,1,1,
Sequoyah,U.S. Senate,James Lankford,REP,680102,0,0,12,12,
Sequoyah,U.S. Senate,Jason Weger,REP,680102,0,0,2,2,
Sequoyah,U.S. House,Darrel Robertson,REP,680102,0,0,14,14,02
Sequoyah,U.S. House,Markwayne Mullin,REP,680102,0,0,26,26,02
Sequoyah,Superintendent of Public Instruction,John Cox,DEM,680103,0,1,55,56,
Sequoyah,Superintendent of Public Instruction,Jack Jr.,DEM,680103,0,0,17,17,
Sequoyah,Superintendent of Public Instruction,Ivan Holmes,DEM,680103,0,1,8,9,
Sequoyah,Superintendent of Public Instruction,Freda Deskin,DEM,680103,0,1,23,24,
Sequoyah,U.S. Senate,Patrick Michael Hayes,DEM,680103,0,2,20,22,
Sequoyah,U.S. Senate,Jim Rogers,DEM,680103,0,1,59,60,
Sequoyah,U.S. Senate,Connie Johnson,DEM,680103,0,0,23,23,
Sequoyah,U.S. House,Earl Everett,DEM,680103,0,2,59,61,02
Sequoyah,U.S. House,Joshua Harris-Till,DEM,680103,0,1,42,43,02
Sequoyah,Governor,Dax Ewbank,REP,680103,0,0,3,3,
Sequoyah,Governor,Chad Moody,REP,680103,0,0,14,14,
Sequoyah,Governor,Mary Fallin,REP,680103,0,0,47,47,
Sequoyah,Superintendent of Public Instruction,Brian Kelly,REP,680103,0,0,17,17,
Sequoyah,Superintendent of Public Instruction,Janet Costello Barresi,REP,680103,0,0,5,5,
Sequoyah,Superintendent of Public Instruction,Joy Hofmeister,REP,680103,0,0,40,40,
Sequoyah,Insurance Commissioner,Bill Viner,REP,680103,0,0,18,18,
Sequoyah,Insurance Commissioner,John Doak,REP,680103,0,0,38,38,
Sequoyah,Corporation Commissioner,Todd Hiett,REP,680103,0,0,23,23,
Sequoyah,Corporation Commissioner,Cliff Branan,REP,680103,0,0,30,30,
Sequoyah,U.S. Senate,Evelyn Rogers,REP,680103,0,0,3,3,
Sequoyah,U.S. Senate,Rob Moye,REP,680103,0,0,1,1,
Sequoyah,U.S. Senate,D. Jean Mcbride-Samuels,REP,680103,0,0,2,2,
Sequoyah,U.S. Senate,Jim Inhofe,REP,680103,0,0,52,52,
Sequoyah,U.S. Senate,Erick Paul Wyatt,REP,680103,0,0,4,4,
Sequoyah,U.S. Senate,Andy Craig,REP,680103,0,0,2,2,
Sequoyah,U.S. Senate,T. Shannon,REP,680103,0,0,25,25,
Sequoyah,U.S. Senate,Randy Brogdon,REP,680103,0,0,2,2,
Sequoyah,U.S. Senate,Eric Mccray,REP,680103,0,0,2,2,
Sequoyah,U.S. Senate,Kevin Crow,REP,680103,0,0,2,2,
Sequoyah,U.S. Senate,James Lankford,REP,680103,0,0,26,26,
Sequoyah,U.S. Senate,Jason Weger,REP,680103,0,0,3,3,
Sequoyah,U.S. House,Darrel Robertson,REP,680103,0,0,9,9,02
Sequoyah,U.S. House,Markwayne Mullin,REP,680103,0,0,51,51,02
Sequoyah,Superintendent of Public Instruction,John Cox,DEM,680104,1,1,54,56,
Sequoyah,Superintendent of Public Instruction,Jack Jr.,DEM,680104,0,1,18,19,
Sequoyah,Superintendent of Public Instruction,Ivan Holmes,DEM,680104,0,0,7,7,
Sequoyah,Superintendent of Public Instruction,Freda Deskin,DEM,680104,0,0,14,14,
Sequoyah,U.S. Senate,Patrick Michael Hayes,DEM,680104,0,1,10,11,
Sequoyah,U.S. Senate,Jim Rogers,DEM,680104,1,1,58,60,
Sequoyah,U.S. Senate,Connie Johnson,DEM,680104,0,0,22,22,
Sequoyah,U.S. House,Earl Everett,DEM,680104,1,1,54,56,02
Sequoyah,U.S. House,Joshua Harris-Till,DEM,680104,0,1,35,36,02
Sequoyah,Governor,Dax Ewbank,REP,680104,0,0,6,6,
Sequoyah,Governor,Chad Moody,REP,680104,0,0,4,4,
Sequoyah,Governor,Mary Fallin,REP,680104,0,4,41,45,
Sequoyah,Superintendent of Public Instruction,Brian Kelly,REP,680104,0,0,10,10,
Sequoyah,Superintendent of Public Instruction,Janet Costello Barresi,REP,680104,0,1,4,5,
Sequoyah,Superintendent of Public Instruction,Joy Hofmeister,REP,680104,0,3,31,34,
Sequoyah,Insurance Commissioner,Bill Viner,REP,680104,0,0,11,11,
Sequoyah,Insurance Commissioner,John Doak,REP,680104,0,4,32,36,
Sequoyah,Corporation Commissioner,Todd Hiett,REP,680104,0,2,22,24,
Sequoyah,Corporation Commissioner,Cliff Branan,REP,680104,0,1,19,20,
Sequoyah,U.S. Senate,Evelyn Rogers,REP,680104,0,0,2,2,
Sequoyah,U.S. Senate,Rob Moye,REP,680104,0,0,3,3,
Sequoyah,U.S. Senate,D. Jean Mcbride-Samuels,REP,680104,0,0,1,1,
Sequoyah,U.S. Senate,Jim Inhofe,REP,680104,0,4,43,47,
Sequoyah,U.S. Senate,Erick Paul Wyatt,REP,680104,0,0,0,0,
Sequoyah,U.S. Senate,Andy Craig,REP,680104,0,0,1,1,
Sequoyah,U.S. Senate,T. Shannon,REP,680104,0,1,23,24,
Sequoyah,U.S. Senate,Randy Brogdon,REP,680104,0,0,1,1,
Sequoyah,U.S. Senate,Eric Mccray,REP,680104,0,1,2,3,
Sequoyah,U.S. Senate,Kevin Crow,REP,680104,0,0,1,1,
Sequoyah,U.S. Senate,James Lankford,REP,680104,0,2,19,21,
Sequoyah,U.S. Senate,Jason Weger,REP,680104,0,0,1,1,
Sequoyah,U.S. House,Darrel Robertson,REP,680104,0,0,14,14,02
Sequoyah,U.S. House,Markwayne Mullin,REP,680104,0,4,36,40,02
Sequoyah,Superintendent of Public Instruction,John Cox,DEM,680105,0,0,30,30,
Sequoyah,Superintendent of Public Instruction,Jack Jr.,DEM,680105,0,0,13,13,
Sequoyah,Superintendent of Public Instruction,Ivan Holmes,DEM,680105,0,0,1,1,
Sequoyah,Superintendent of Public Instruction,Freda Deskin,DEM,680105,0,0,11,11,
Sequoyah,U.S. Senate,Patrick Michael Hayes,DEM,680105,0,0,9,9,
Sequoyah,U.S. Senate,Jim Rogers,DEM,680105,0,0,23,23,
Sequoyah,U.S. Senate,Connie Johnson,DEM,680105,0,0,17,17,
Sequoyah,U.S. House,Earl Everett,DEM,680105,0,0,28,28,02
Sequoyah,U.S. House,Joshua Harris-Till,DEM,680105,0,0,19,19,02
Sequoyah,Governor,Dax Ewbank,REP,680105,0,0,7,7,
Sequoyah,Governor,Chad Moody,REP,680105,0,0,7,7,
Sequoyah,Governor,Mary Fallin,REP,680105,0,0,32,32,
Sequoyah,Superintendent of Public Instruction,Brian Kelly,REP,680105,0,0,15,15,
Sequoyah,Superintendent of Public Instruction,Janet Costello Barresi,REP,680105,0,0,7,7,
Sequoyah,Superintendent of Public Instruction,Joy Hofmeister,REP,680105,0,0,22,22,
Sequoyah,Insurance Commissioner,Bill Viner,REP,680105,0,0,12,12,
Sequoyah,Insurance Commissioner,John Doak,REP,680105,0,0,29,29,
Sequoyah,Corporation Commissioner,Todd Hiett,REP,680105,0,0,23,23,
Sequoyah,Corporation Commissioner,Cliff Branan,REP,680105,0,0,19,19,
Sequoyah,U.S. Senate,Evelyn Rogers,REP,680105,0,0,4,4,
Sequoyah,U.S. Senate,Rob Moye,REP,680105,0,0,1,1,
Sequoyah,U.S. Senate,D. Jean Mcbride-Samuels,REP,680105,0,0,0,0,
Sequoyah,U.S. Senate,Jim Inhofe,REP,680105,0,0,37,37,
Sequoyah,U.S. Senate,Erick Paul Wyatt,REP,680105,0,0,4,4,
Sequoyah,U.S. Senate,Andy Craig,REP,680105,0,0,2,2,
Sequoyah,U.S. Senate,T. Shannon,REP,680105,0,0,18,18,
Sequoyah,U.S. Senate,Randy Brogdon,REP,680105,0,0,0,0,
Sequoyah,U.S. Senate,Eric Mccray,REP,680105,0,0,1,1,
Sequoyah,U.S. Senate,Kevin Crow,REP,680105,0,0,4,4,
Sequoyah,U.S. Senate,James Lankford,REP,680105,0,0,19,19,
Sequoyah,U.S. Senate,Jason Weger,REP,680105,0,0,1,1,
Sequoyah,U.S. House,Darrel Robertson,REP,680105,0,0,15,15,02
Sequoyah,U.S. House,Markwayne Mullin,REP,680105,0,0,30,30,02
Sequoyah,Superintendent of Public Instruction,John Cox,DEM,680106,2,1,42,45,
Sequoyah,Superintendent of Public Instruction,Jack Jr.,DEM,680106,0,0,5,5,
Sequoyah,Superintendent of Public Instruction,Ivan Holmes,DEM,680106,0,0,2,2,
Sequoyah,Superintendent of Public Instruction,Freda Deskin,DEM,680106,0,2,8,10,
Sequoyah,U.S. Senate,Patrick Michael Hayes,DEM,680106,0,0,8,8,
Sequoyah,U.S. Senate,Jim Rogers,DEM,680106,2,3,37,42,
Sequoyah,U.S. Senate,Connie Johnson,DEM,680106,0,0,7,7,
Sequoyah,U.S. House,Earl Everett,DEM,680106,2,3,27,32,02
Sequoyah,U.S. House,Joshua Harris-Till,DEM,680106,0,0,21,21,02
Sequoyah,Governor,Dax Ewbank,REP,680106,0,0,7,7,
Sequoyah,Governor,Chad Moody,REP,680106,0,0,9,9,
Sequoyah,Governor,Mary Fallin,REP,680106,0,0,25,25,
Sequoyah,Superintendent of Public Instruction,Brian Kelly,REP,680106,0,0,15,15,
Sequoyah,Superintendent of Public Instruction,Janet Costello Barresi,REP,680106,0,0,4,4,
Sequoyah,Superintendent of Public Instruction,Joy Hofmeister,REP,680106,0,0,20,20,
Sequoyah,Insurance Commissioner,Bill Viner,REP,680106,0,0,15,15,
Sequoyah,Insurance Commissioner,John Doak,REP,680106,0,0,20,20,
Sequoyah,Corporation Commissioner,Todd Hiett,REP,680106,0,0,23,23,
Sequoyah,Corporation Commissioner,Cliff Branan,REP,680106,0,0,14,14,
Sequoyah,U.S. Senate,Evelyn Rogers,REP,680106,0,0,3,3,
Sequoyah,U.S. Senate,Rob Moye,REP,680106,0,0,1,1,
Sequoyah,U.S. Senate,D. Jean Mcbride-Samuels,REP,680106,0,0,0,0,
Sequoyah,U.S. Senate,Jim Inhofe,REP,680106,0,0,30,30,
Sequoyah,U.S. Senate,Erick Paul Wyatt,REP,680106,0,0,6,6,
Sequoyah,U.S. Senate,Andy Craig,REP,680106,0,0,1,1,
Sequoyah,U.S. Senate,T. Shannon,REP,680106,0,0,27,27,
Sequoyah,U.S. Senate,Randy Brogdon,REP,680106,0,0,0,0,
Sequoyah,U.S. Senate,Eric Mccray,REP,680106,0,0,1,1,
Sequoyah,U.S. Senate,Kevin Crow,REP,680106,0,0,2,2,
Sequoyah,U.S. Senate,James Lankford,REP,680106,0,0,11,11,
Sequoyah,U.S. Senate,Jason Weger,REP,680106,0,0,0,0,
Sequoyah,U.S. House,Darrel Robertson,REP,680106,0,0,9,9,02
Sequoyah,U.S. House,Markwayne Mullin,REP,680106,0,0,32,32,02
Sequoyah,Superintendent of Public Instruction,John Cox,DEM,680201,0,1,15,16,
Sequoyah,Superintendent of Public Instruction,Jack Jr.,DEM,680201,0,0,3,3,
Sequoyah,Superintendent of Public Instruction,Ivan Holmes,DEM,680201,0,0,1,1,
Sequoyah,Superintendent of Public Instruction,Freda Deskin,DEM,680201,0,1,5,6,
Sequoyah,U.S. Senate,Patrick Michael Hayes,DEM,680201,0,1,8,9,
Sequoyah,U.S. Senate,Jim Rogers,DEM,680201,0,1,6,7,
Sequoyah,U.S. Senate,Connie Johnson,DEM,680201,0,0,10,10,
Sequoyah,U.S. House,Earl Everett,DEM,680201,0,1,11,12,02
Sequoyah,U.S. House,Joshua Harris-Till,DEM,680201,0,1,13,14,02
Sequoyah,Governor,Dax Ewbank,REP,680201,0,0,8,8,
Sequoyah,Governor,Chad Moody,REP,680201,0,0,4,4,
Sequoyah,Governor,Mary Fallin,REP,680201,0,0,17,17,
Sequoyah,Superintendent of Public Instruction,Brian Kelly,REP,680201,0,0,11,11,
Sequoyah,Superintendent of Public Instruction,Janet Costello Barresi,REP,680201,0,0,2,2,
Sequoyah,Superintendent of Public Instruction,Joy Hofmeister,REP,680201,0,0,17,17,
Sequoyah,Insurance Commissioner,Bill Viner,REP,680201,0,0,14,14,
Sequoyah,Insurance Commissioner,John Doak,REP,680201,0,0,15,15,
Sequoyah,Corporation Commissioner,Todd Hiett,REP,680201,0,0,11,11,
Sequoyah,Corporation Commissioner,Cliff Branan,REP,680201,0,0,17,17,
Sequoyah,U.S. Senate,Evelyn Rogers,REP,680201,0,0,2,2,
Sequoyah,U.S. Senate,Rob Moye,REP,680201,0,0,1,1,
Sequoyah,U.S. Senate,D. Jean Mcbride-Samuels,REP,680201,0,0,2,2,
Sequoyah,U.S. Senate,Jim Inhofe,REP,680201,0,0,23,23,
Sequoyah,U.S. Senate,Erick Paul Wyatt,REP,680201,0,0,2,2,
Sequoyah,U.S. Senate,Andy Craig,REP,680201,0,0,0,0,
Sequoyah,U.S. Senate,T. Shannon,REP,680201,0,0,17,17,
Sequoyah,U.S. Senate,Randy Brogdon,REP,680201,0,0,0,0,
Sequoyah,U.S. Senate,Eric Mccray,REP,680201,0,0,0,0,
Sequoyah,U.S. Senate,Kevin Crow,REP,680201,0,0,0,0,
Sequoyah,U.S. Senate,James Lankford,REP,680201,0,0,12,12,
Sequoyah,U.S. Senate,Jason Weger,REP,680201,0,0,0,0,
Sequoyah,U.S. House,Darrel Robertson,REP,680201,0,0,7,7,02
Sequoyah,U.S. House,Markwayne Mullin,REP,680201,0,0,21,21,02
Sequoyah,Superintendent of Public Instruction,John Cox,DEM,680202,0,0,32,32,
Sequoyah,Superintendent of Public Instruction,Jack Jr.,DEM,680202,0,0,10,10,
Sequoyah,Superintendent of Public Instruction,Ivan Holmes,DEM,680202,0,0,5,5,
Sequoyah,Superintendent of Public Instruction,Freda Deskin,DEM,680202,0,0,17,17,
Sequoyah,U.S. Senate,Patrick Michael Hayes,DEM,680202,0,0,17,17,
Sequoyah,U.S. Senate,Jim Rogers,DEM,680202,0,0,29,29,
Sequoyah,U.S. Senate,Connie Johnson,DEM,680202,0,0,16,16,
Sequoyah,U.S. House,Earl Everett,DEM,680202,0,0,39,39,02
Sequoyah,U.S. House,Joshua Harris-Till,DEM,680202,0,0,20,20,02
Sequoyah,Governor,Dax Ewbank,REP,680202,1,0,0,1,
Sequoyah,Governor,Chad Moody,REP,680202,0,1,4,5,
Sequoyah,Governor,Mary Fallin,REP,680202,0,0,18,18,
Sequoyah,Superintendent of Public Instruction,Brian Kelly,REP,680202,1,0,4,5,
Sequoyah,Superintendent of Public Instruction,Janet Costello Barresi,REP,680202,0,0,6,6,
Sequoyah,Superintendent of Public Instruction,Joy Hofmeister,REP,680202,0,1,10,11,
Sequoyah,Insurance Commissioner,Bill Viner,REP,680202,1,0,8,9,
Sequoyah,Insurance Commissioner,John Doak,REP,680202,0,1,11,12,
Sequoyah,Corporation Commissioner,Todd Hiett,REP,680202,1,0,8,9,
Sequoyah,Corporation Commissioner,Cliff Branan,REP,680202,0,1,10,11,
Sequoyah,U.S. Senate,Evelyn Rogers,REP,680202,1,0,0,1,
Sequoyah,U.S. Senate,Rob Moye,REP,680202,0,1,0,1,
Sequoyah,U.S. Senate,D. Jean Mcbride-Samuels,REP,680202,0,0,2,2,
Sequoyah,U.S. Senate,Jim Inhofe,REP,680202,0,0,17,17,
Sequoyah,U.S. Senate,Erick Paul Wyatt,REP,680202,0,0,2,2,
Sequoyah,U.S. Senate,Andy Craig,REP,680202,0,0,0,0,
Sequoyah,U.S. Senate,T. Shannon,REP,680202,1,0,11,12,
Sequoyah,U.S. Senate,Randy Brogdon,REP,680202,0,0,0,0,
Sequoyah,U.S. Senate,Eric Mccray,REP,680202,0,0,2,2,
Sequoyah,U.S. Senate,Kevin Crow,REP,680202,0,1,0,1,
Sequoyah,U.S. Senate,James Lankford,REP,680202,0,0,9,9,
Sequoyah,U.S. Senate,Jason Weger,REP,680202,0,0,0,0,
Sequoyah,U.S. House,Darrel Robertson,REP,680202,0,1,5,6,02
Sequoyah,U.S. House,Markwayne Mullin,REP,680202,0,0,16,16,02
Sequoyah,Superintendent of Public Instruction,John Cox,DEM,680203,0,0,23,23,
Sequoyah,Superintendent of Public Instruction,Jack Jr.,DEM,680203,0,0,4,4,
Sequoyah,Superintendent of Public Instruction,Ivan Holmes,DEM,680203,0,0,2,2,
Sequoyah,Superintendent of Public Instruction,Freda Deskin,DEM,680203,0,0,15,15,
Sequoyah,U.S. Senate,Patrick Michael Hayes,DEM,680203,0,0,10,10,
Sequoyah,U.S. Senate,Jim Rogers,DEM,680203,0,0,15,15,
Sequoyah,U.S. Senate,Connie Johnson,DEM,680203,0,0,16,16,
Sequoyah,U.S. House,Earl Everett,DEM,680203,0,0,24,24,02
Sequoyah,U.S. House,Joshua Harris-Till,DEM,680203,0,0,17,17,02
Sequoyah,Governor,Dax Ewbank,REP,680203,0,0,1,1,
Sequoyah,Governor,Chad Moody,REP,680203,0,0,1,1,
Sequoyah,Governor,Mary Fallin,REP,680203,0,0,9,9,
Sequoyah,Superintendent of Public Instruction,Brian Kelly,REP,680203,0,0,4,4,
Sequoyah,Superintendent of Public Instruction,Janet Costello Barresi,REP,680203,0,0,0,0,
Sequoyah,Superintendent of Public Instruction,Joy Hofmeister,REP,680203,0,0,7,7,
Sequoyah,Insurance Commissioner,Bill Viner,REP,680203,0,0,3,3,
Sequoyah,Insurance Commissioner,John Doak,REP,680203,0,0,8,8,
Sequoyah,Corporation Commissioner,Todd Hiett,REP,680203,0,0,6,6,
Sequoyah,Corporation Commissioner,Cliff Branan,REP,680203,0,0,5,5,
Sequoyah,U.S. Senate,Evelyn Rogers,REP,680203,0,0,2,2,
Sequoyah,U.S. Senate,Rob Moye,REP,680203,0,0,0,0,
Sequoyah,U.S. Senate,D. Jean Mcbride-Samuels,REP,680203,0,0,0,0,
Sequoyah,U.S. Senate,Jim Inhofe,REP,680203,0,0,8,8,
Sequoyah,U.S. Senate,Erick Paul Wyatt,REP,680203,0,0,1,1,
Sequoyah,U.S. Senate,Andy Craig,REP,680203,0,0,0,0,
Sequoyah,U.S. Senate,T. Shannon,REP,680203,0,0,7,7,
Sequoyah,U.S. Senate,Randy Brogdon,REP,680203,0,0,0,0,
Sequoyah,U.S. Senate,Eric Mccray,REP,680203,0,0,0,0,
Sequoyah,U.S. Senate,Kevin Crow,REP,680203,0,0,1,1,
Sequoyah,U.S. Senate,James Lankford,REP,680203,0,0,2,2,
Sequoyah,U.S. Senate,Jason Weger,REP,680203,0,0,1,1,
Sequoyah,U.S. House,Darrel Robertson,REP,680203,0,0,3,3,02
Sequoyah,U.S. House,Markwayne Mullin,REP,680203,0,0,8,8,02
Sequoyah,Superintendent of Public Instruction,John Cox,DEM,680204,1,0,9,10,
Sequoyah,Superintendent of Public Instruction,Jack Jr.,DEM,680204,0,0,2,2,
Sequoyah,Superintendent of Public Instruction,Ivan Holmes,DEM,680204,0,0,2,2,
Sequoyah,Superintendent of Public Instruction,Freda Deskin,DEM,680204,0,0,13,13,
Sequoyah,U.S. Senate,Patrick Michael Hayes,DEM,680204,0,0,6,6,
Sequoyah,U.S. Senate,Jim Rogers,DEM,680204,1,0,8,9,
Sequoyah,U.S. Senate,Connie Johnson,DEM,680204,0,0,12,12,
Sequoyah,U.S. House,Earl Everett,DEM,680204,1,0,14,15,02
Sequoyah,U.S. House,Joshua Harris-Till,DEM,680204,0,0,11,11,02
Sequoyah,Governor,Dax Ewbank,REP,680204,0,0,3,3,
Sequoyah,Governor,Chad Moody,REP,680204,0,0,10,10,
Sequoyah,Governor,Mary Fallin,REP,680204,0,0,19,19,
Sequoyah,Superintendent of Public Instruction,Brian Kelly,REP,680204,0,0,9,9,
Sequoyah,Superintendent of Public Instruction,Janet Costello Barresi,REP,680204,0,0,6,6,
Sequoyah,Superintendent of Public Instruction,Joy Hofmeister,REP,680204,0,0,15,15,
Sequoyah,Insurance Commissioner,Bill Viner,REP,680204,0,0,4,4,
Sequoyah,Insurance Commissioner,John Doak,REP,680204,0,0,20,20,
Sequoyah,Corporation Commissioner,Todd Hiett,REP,680204,0,0,21,21,
Sequoyah,Corporation Commissioner,Cliff Branan,REP,680204,0,0,7,7,
Sequoyah,U.S. Senate,Evelyn Rogers,REP,680204,0,0,1,1,
Sequoyah,U.S. Senate,Rob Moye,REP,680204,0,0,1,1,
Sequoyah,U.S. Senate,D. Jean Mcbride-Samuels,REP,680204,0,0,0,0,
Sequoyah,U.S. Senate,Jim Inhofe,REP,680204,0,0,28,28,
Sequoyah,U.S. Senate,Erick Paul Wyatt,REP,680204,0,0,0,0,
Sequoyah,U.S. Senate,Andy Craig,REP,680204,0,0,0,0,
Sequoyah,U.S. Senate,T. Shannon,REP,680204,0,0,16,16,
Sequoyah,U.S. Senate,Randy Brogdon,REP,680204,0,0,2,2,
Sequoyah,U.S. Senate,Eric Mccray,REP,680204,0,0,0,0,
Sequoyah,U.S. Senate,Kevin Crow,REP,680204,0,0,0,0,
Sequoyah,U.S. Senate,James Lankford,REP,680204,0,0,12,12,
Sequoyah,U.S. Senate,Jason Weger,REP,680204,0,0,1,1,
Sequoyah,U.S. House,Darrel Robertson,REP,680204,0,0,2,2,02
Sequoyah,U.S. House,Markwayne Mullin,REP,680204,0,0,29,29,02
Sequoyah,Superintendent of Public Instruction,John Cox,DEM,680205,3,3,54,60,
Sequoyah,Superintendent of Public Instruction,Jack Jr.,DEM,680205,1,0,16,17,
Sequoyah,Superintendent of Public Instruction,Ivan Holmes,DEM,680205,0,2,4,6,
Sequoyah,Superintendent of Public Instruction,Freda Deskin,DEM,680205,1,2,33,36,
Sequoyah,U.S. Senate,Patrick Michael Hayes,DEM,680205,3,1,30,34,
Sequoyah,U.S. Senate,Jim Rogers,DEM,680205,0,4,53,57,
Sequoyah,U.S. Senate,Connie Johnson,DEM,680205,2,2,23,27,
Sequoyah,U.S. House,Earl Everett,DEM,680205,1,1,73,75,02
Sequoyah,U.S. House,Joshua Harris-Till,DEM,680205,4,4,32,40,02
Sequoyah,Governor,Dax Ewbank,REP,680205,0,1,5,6,
Sequoyah,Governor,Chad Moody,REP,680205,0,4,17,21,
Sequoyah,Governor,Mary Fallin,REP,680205,0,2,32,34,
Sequoyah,Superintendent of Public Instruction,Brian Kelly,REP,680205,0,0,14,14,
Sequoyah,Superintendent of Public Instruction,Janet Costello Barresi,REP,680205,0,1,9,10,
Sequoyah,Superintendent of Public Instruction,Joy Hofmeister,REP,680205,0,7,33,40,
Sequoyah,Insurance Commissioner,Bill Viner,REP,680205,0,3,18,21,
Sequoyah,Insurance Commissioner,John Doak,REP,680205,0,3,32,35,
Sequoyah,Corporation Commissioner,Todd Hiett,REP,680205,0,3,16,19,
Sequoyah,Corporation Commissioner,Cliff Branan,REP,680205,0,2,34,36,
Sequoyah,U.S. Senate,Evelyn Rogers,REP,680205,0,0,5,5,
Sequoyah,U.S. Senate,Rob Moye,REP,680205,0,0,1,1,
Sequoyah,U.S. Senate,D. Jean Mcbride-Samuels,REP,680205,0,0,1,1,
Sequoyah,U.S. Senate,Jim Inhofe,REP,680205,0,7,41,48,
Sequoyah,U.S. Senate,Erick Paul Wyatt,REP,680205,0,0,9,9,
Sequoyah,U.S. Senate,Andy Craig,REP,680205,0,0,5,5,
Sequoyah,U.S. Senate,T. Shannon,REP,680205,0,3,19,22,
Sequoyah,U.S. Senate,Randy Brogdon,REP,680205,0,0,0,0,
Sequoyah,U.S. Senate,Eric Mccray,REP,680205,0,0,1,1,
Sequoyah,U.S. Senate,Kevin Crow,REP,680205,0,0,1,1,
Sequoyah,U.S. Senate,James Lankford,REP,680205,0,3,27,30,
Sequoyah,U.S. Senate,Jason Weger,REP,680205,0,0,3,3,
Sequoyah,U.S. House,Darrel Robertson,REP,680205,0,0,14,14,02
Sequoyah,U.S. House,Markwayne Mullin,REP,680205,0,6,43,49,02
Sequoyah,Superintendent of Public Instruction,John Cox,DEM,680206,0,5,24,29,
Sequoyah,Superintendent of Public Instruction,Jack Jr.,DEM,680206,0,1,11,12,
Sequoyah,Superintendent of Public Instruction,Ivan Holmes,DEM,680206,0,0,0,0,
Sequoyah,Superintendent of Public Instruction,Freda Deskin,DEM,680206,0,2,11,13,
Sequoyah,U.S. Senate,Patrick Michael Hayes,DEM,680206,0,3,16,19,
Sequoyah,U.S. Senate,Jim Rogers,DEM,680206,0,2,23,25,
Sequoyah,U.S. Senate,Connie Johnson,DEM,680206,0,2,9,11,
Sequoyah,U.S. House,Earl Everett,DEM,680206,0,5,34,39,02
Sequoyah,U.S. House,Joshua Harris-Till,DEM,680206,0,2,12,14,02
Sequoyah,Governor,Dax Ewbank,REP,680206,0,0,1,1,
Sequoyah,Governor,Chad Moody,REP,680206,0,1,5,6,
Sequoyah,Governor,Mary Fallin,REP,680206,0,2,13,15,
Sequoyah,Superintendent of Public Instruction,Brian Kelly,REP,680206,0,1,5,6,
Sequoyah,Superintendent of Public Instruction,Janet Costello Barresi,REP,680206,0,0,2,2,
Sequoyah,Superintendent of Public Instruction,Joy Hofmeister,REP,680206,0,2,14,16,
Sequoyah,Insurance Commissioner,Bill Viner,REP,680206,0,0,7,7,
Sequoyah,Insurance Commissioner,John Doak,REP,680206,0,3,10,13,
Sequoyah,Corporation Commissioner,Todd Hiett,REP,680206,0,1,10,11,
Sequoyah,Corporation Commissioner,Cliff Branan,REP,680206,0,2,8,10,
Sequoyah,U.S. Senate,Evelyn Rogers,REP,680206,0,1,2,3,
Sequoyah,U.S. Senate,Rob Moye,REP,680206,0,0,0,0,
Sequoyah,U.S. Senate,D. Jean Mcbride-Samuels,REP,680206,0,0,0,0,
Sequoyah,U.S. Senate,Jim Inhofe,REP,680206,0,2,14,16,
Sequoyah,U.S. Senate,Erick Paul Wyatt,REP,680206,0,0,3,3,
Sequoyah,U.S. Senate,Andy Craig,REP,680206,0,0,1,1,
Sequoyah,U.S. Senate,T. Shannon,REP,680206,0,1,5,6,
Sequoyah,U.S. Senate,Randy Brogdon,REP,680206,0,1,0,1,
Sequoyah,U.S. Senate,Eric Mccray,REP,680206,0,0,1,1,
Sequoyah,U.S. Senate,Kevin Crow,REP,680206,0,0,0,0,
Sequoyah,U.S. Senate,James Lankford,REP,680206,0,1,12,13,
Sequoyah,U.S. Senate,Jason Weger,REP,680206,0,0,1,1,
Sequoyah,U.S. House,Darrel Robertson,REP,680206,0,1,5,6,02
Sequoyah,U.S. House,Markwayne Mullin,REP,680206,0,2,15,17,02
Sequoyah,Superintendent of Public Instruction,John Cox,DEM,680207,0,2,30,32,
Sequoyah,Superintendent of Public Instruction,Jack Jr.,DEM,680207,0,0,3,3,
Sequoyah,Superintendent of Public Instruction,Ivan Holmes,DEM,680207,0,0,2,2,
Sequoyah,Superintendent of Public Instruction,Freda Deskin,DEM,680207,0,0,4,4,
Sequoyah,U.S. Senate,Patrick Michael Hayes,DEM,680207,0,0,8,8,
Sequoyah,U.S. Senate,Jim Rogers,DEM,680207,0,2,20,22,
Sequoyah,U.S. Senate,Connie Johnson,DEM,680207,0,0,10,10,
Sequoyah,U.S. House,Earl Everett,DEM,680207,0,2,28,30,02
Sequoyah,U.S. House,Joshua Harris-Till,DEM,680207,0,0,10,10,02
Sequoyah,Governor,Dax Ewbank,REP,680207,0,0,2,2,
Sequoyah,Governor,Chad Moody,REP,680207,0,1,8,9,
Sequoyah,Governor,Mary Fallin,REP,680207,0,1,18,19,
Sequoyah,Superintendent of Public Instruction,Brian Kelly,REP,680207,0,0,9,9,
Sequoyah,Superintendent of Public Instruction,Janet Costello Barresi,REP,680207,0,0,4,4,
Sequoyah,Superintendent of Public Instruction,Joy Hofmeister,REP,680207,0,2,15,17,
Sequoyah,Insurance Commissioner,Bill Viner,REP,680207,0,1,9,10,
Sequoyah,Insurance Commissioner,John Doak,REP,680207,0,1,16,17,
Sequoyah,Corporation Commissioner,Todd Hiett,REP,680207,0,0,19,19,
Sequoyah,Corporation Commissioner,Cliff Branan,REP,680207,0,2,9,11,
Sequoyah,U.S. Senate,Evelyn Rogers,REP,680207,0,0,0,0,
Sequoyah,U.S. Senate,Rob Moye,REP,680207,0,0,1,1,
Sequoyah,U.S. Senate,D. Jean Mcbride-Samuels,REP,680207,0,0,0,0,
Sequoyah,U.S. Senate,Jim Inhofe,REP,680207,0,2,24,26,
Sequoyah,U.S. Senate,Erick Paul Wyatt,REP,680207,0,0,3,3,
Sequoyah,U.S. Senate,Andy Craig,REP,680207,0,0,0,0,
Sequoyah,U.S. Senate,T. Shannon,REP,680207,0,2,18,20,
Sequoyah,U.S. Senate,Randy Brogdon,REP,680207,0,0,0,0,
Sequoyah,U.S. Senate,Eric Mccray,REP,680207,0,0,0,0,
Sequoyah,U.S. Senate,Kevin Crow,REP,680207,0,0,1,1,
Sequoyah,U.S. Senate,James Lankford,REP,680207,0,0,8,8,
Sequoyah,U.S. Senate,Jason Weger,REP,680207,0,0,1,1,
Sequoyah,U.S. House,Darrel Robertson,REP,680207,0,0,7,7,02
Sequoyah,U.S. House,Markwayne Mullin,REP,680207,0,2,21,23,02
Sequoyah,Superintendent of Public Instruction,John Cox,DEM,680208,1,3,37,41,
Sequoyah,Superintendent of Public Instruction,Jack Jr.,DEM,680208,0,0,13,13,
Sequoyah,Superintendent of Public Instruction,Ivan Holmes,DEM,680208,0,1,5,6,
Sequoyah,Superintendent of Public Instruction,Freda Deskin,DEM,680208,0,0,25,25,
Sequoyah,U.S. Senate,Patrick Michael Hayes,DEM,680208,0,2,17,19,
Sequoyah,U.S. Senate,Jim Rogers,DEM,680208,0,0,35,35,
Sequoyah,U.S. Senate,Connie Johnson,DEM,680208,1,2,26,29,
Sequoyah,U.S. House,Earl Everett,DEM,680208,0,2,38,40,02
Sequoyah,U.S. House,Joshua Harris-Till,DEM,680208,1,1,40,42,02
Sequoyah,Governor,Dax Ewbank,REP,680208,0,3,10,13,
Sequoyah,Governor,Chad Moody,REP,680208,0,1,7,8,
Sequoyah,Governor,Mary Fallin,REP,680208,0,0,27,27,
Sequoyah,Superintendent of Public Instruction,Brian Kelly,REP,680208,0,1,21,22,
Sequoyah,Superintendent of Public Instruction,Janet Costello Barresi,REP,680208,0,0,6,6,
Sequoyah,Superintendent of Public Instruction,Joy Hofmeister,REP,680208,0,3,17,20,
Sequoyah,Insurance Commissioner,Bill Viner,REP,680208,0,1,11,12,
Sequoyah,Insurance Commissioner,John Doak,REP,680208,0,3,28,31,
Sequoyah,Corporation Commissioner,Todd Hiett,REP,680208,0,1,21,22,
Sequoyah,Corporation Commissioner,Cliff Branan,REP,680208,0,3,21,24,
Sequoyah,U.S. Senate,Evelyn Rogers,REP,680208,0,0,0,0,
Sequoyah,U.S. Senate,Rob Moye,REP,680208,0,0,0,0,
Sequoyah,U.S. Senate,D. Jean Mcbride-Samuels,REP,680208,0,1,3,4,
Sequoyah,U.S. Senate,Jim Inhofe,REP,680208,0,3,39,42,
Sequoyah,U.S. Senate,Erick Paul Wyatt,REP,680208,0,0,1,1,
Sequoyah,U.S. Senate,Andy Craig,REP,680208,0,1,0,1,
Sequoyah,U.S. Senate,T. Shannon,REP,680208,0,3,22,25,
Sequoyah,U.S. Senate,Randy Brogdon,REP,680208,0,0,3,3,
Sequoyah,U.S. Senate,Eric Mccray,REP,680208,0,0,0,0,
Sequoyah,U.S. Senate,Kevin Crow,REP,680208,0,0,1,1,
Sequoyah,U.S. Senate,James Lankford,REP,680208,0,0,16,16,
Sequoyah,U.S. Senate,Jason Weger,REP,680208,0,0,1,1,
Sequoyah,U.S. House,Darrel Robertson,REP,680208,0,0,13,13,02
Sequoyah,U.S. House,Markwayne Mullin,REP,680208,0,4,29,33,02
Sequoyah,Superintendent of Public Instruction,John Cox,DEM,680209,0,0,57,57,
Sequoyah,Superintendent of Public Instruction,Jack Jr.,DEM,680209,1,0,9,10,
Sequoyah,Superintendent of Public Instruction,Ivan Holmes,DEM,680209,1,0,1,2,
Sequoyah,Superintendent of Public Instruction,Freda Deskin,DEM,680209,1,0,19,20,
Sequoyah,U.S. Senate,Patrick Michael Hayes,DEM,680209,0,0,10,10,
Sequoyah,U.S. Senate,Jim Rogers,DEM,680209,3,0,49,52,
Sequoyah,U.S. Senate,Connie Johnson,DEM,680209,0,0,27,27,
Sequoyah,U.S. House,Earl Everett,DEM,680209,2,0,55,57,02
Sequoyah,U.S. House,Joshua Harris-Till,DEM,680209,1,0,30,31,02
Sequoyah,Governor,Dax Ewbank,REP,680209,0,0,0,0,
Sequoyah,Governor,Chad Moody,REP,680209,2,0,6,8,
Sequoyah,Governor,Mary Fallin,REP,680209,0,1,31,32,
Sequoyah,Superintendent of Public Instruction,Brian Kelly,REP,680209,1,0,11,12,
Sequoyah,Superintendent of Public Instruction,Janet Costello Barresi,REP,680209,0,0,8,8,
Sequoyah,Superintendent of Public Instruction,Joy Hofmeister,REP,680209,0,1,17,18,
Sequoyah,Insurance Commissioner,Bill Viner,REP,680209,0,1,10,11,
Sequoyah,Insurance Commissioner,John Doak,REP,680209,1,0,24,25,
Sequoyah,Corporation Commissioner,Todd Hiett,REP,680209,0,0,15,15,
Sequoyah,Corporation Commissioner,Cliff Branan,REP,680209,1,1,18,20,
Sequoyah,U.S. Senate,Evelyn Rogers,REP,680209,0,0,5,5,
Sequoyah,U.S. Senate,Rob Moye,REP,680209,0,0,1,1,
Sequoyah,U.S. Senate,D. Jean Mcbride-Samuels,REP,680209,0,0,0,0,
Sequoyah,U.S. Senate,Jim Inhofe,REP,680209,2,1,28,31,
Sequoyah,U.S. Senate,Erick Paul Wyatt,REP,680209,0,0,3,3,
Sequoyah,U.S. Senate,Andy Craig,REP,680209,0,0,1,1,
Sequoyah,U.S. Senate,T. Shannon,REP,680209,0,1,16,17,
Sequoyah,U.S. Senate,Randy Brogdon,REP,680209,1,0,1,2,
Sequoyah,U.S. Senate,Eric Mccray,REP,680209,0,0,0,0,
Sequoyah,U.S. Senate,Kevin Crow,REP,680209,0,0,1,1,
Sequoyah,U.S. Senate,James Lankford,REP,680209,0,0,17,17,
Sequoyah,U.S. Senate,Jason Weger,REP,680209,0,0,1,1,
Sequoyah,U.S. House,Darrel Robertson,REP,680209,2,0,5,7,02
Sequoyah,U.S. House,Markwayne Mullin,REP,680209,0,1,33,34,02
Sequoyah,Superintendent of Public Instruction,John Cox,DEM,680210,0,0,41,41,
Sequoyah,Superintendent of Public Instruction,Jack Jr.,DEM,680210,0,0,5,5,
Sequoyah,Superintendent of Public Instruction,Ivan Holmes,DEM,680210,0,0,5,5,
Sequoyah,Superintendent of Public Instruction,Freda Deskin,DEM,680210,0,1,23,24,
Sequoyah,U.S. Senate,Patrick Michael Hayes,DEM,680210,0,1,20,21,
Sequoyah,U.S. Senate,Jim Rogers,DEM,680210,0,0,31,31,
Sequoyah,U.S. Senate,Connie Johnson,DEM,680210,0,0,17,17,
Sequoyah,U.S. House,Earl Everett,DEM,680210,0,1,36,37,02
Sequoyah,U.S. House,Joshua Harris-Till,DEM,680210,0,0,28,28,02
Sequoyah,Governor,Dax Ewbank,REP,680210,1,0,1,2,
Sequoyah,Governor,Chad Moody,REP,680210,0,0,5,5,
Sequoyah,Governor,Mary Fallin,REP,680210,0,0,45,45,
Sequoyah,Superintendent of Public Instruction,Brian Kelly,REP,680210,0,0,7,7,
Sequoyah,Superintendent of Public Instruction,Janet Costello Barresi,REP,680210,0,0,11,11,
Sequoyah,Superintendent of Public Instruction,Joy Hofmeister,REP,680210,1,0,33,34,
Sequoyah,Insurance Commissioner,Bill Viner,REP,680210,1,0,9,10,
Sequoyah,Insurance Commissioner,John Doak,REP,680210,0,0,36,36,
Sequoyah,Corporation Commissioner,Todd Hiett,REP,680210,1,0,23,24,
Sequoyah,Corporation Commissioner,Cliff Branan,REP,680210,0,0,22,22,
Sequoyah,U.S. Senate,Evelyn Rogers,REP,680210,1,0,2,3,
Sequoyah,U.S. Senate,Rob Moye,REP,680210,0,0,1,1,
Sequoyah,U.S. Senate,D. Jean Mcbride-Samuels,REP,680210,0,0,2,2,
Sequoyah,U.S. Senate,Jim Inhofe,REP,680210,0,0,46,46,
Sequoyah,U.S. Senate,Erick Paul Wyatt,REP,680210,0,0,0,0,
Sequoyah,U.S. Senate,Andy Craig,REP,680210,1,0,1,2,
Sequoyah,U.S. Senate,T. Shannon,REP,680210,0,0,26,26,
Sequoyah,U.S. Senate,Randy Brogdon,REP,680210,0,0,2,2,
Sequoyah,U.S. Senate,Eric Mccray,REP,680210,0,0,0,0,
Sequoyah,U.S. Senate,Kevin Crow,REP,680210,0,0,0,0,
Sequoyah,U.S. Senate,James Lankford,REP,680210,0,0,21,21,
Sequoyah,U.S. Senate,Jason Weger,REP,680210,0,0,1,1,
Sequoyah,U.S. House,Darrel Robertson,REP,680210,1,0,10,11,02
Sequoyah,U.S. House,Markwayne Mullin,REP,680210,0,0,40,40,02
Sequoyah,Superintendent of Public Instruction,John Cox,DEM,680301,10,3,79,92,
Sequoyah,Superintendent of Public Instruction,Jack Jr.,DEM,680301,1,3,21,25,
Sequoyah,Superintendent of Public Instruction,Ivan Holmes,DEM,680301,2,2,11,15,
Sequoyah,Superintendent of Public Instruction,Freda Deskin,DEM,680301,3,2,24,29,
Sequoyah,U.S. Senate,Patrick Michael Hayes,DEM,680301,3,2,33,38,
Sequoyah,U.S. Senate,Jim Rogers,DEM,680301,7,2,59,68,
Sequoyah,U.S. Senate,Connie Johnson,DEM,680301,4,6,37,47,
Sequoyah,U.S. House,Earl Everett,DEM,680301,10,6,73,89,02
Sequoyah,U.S. House,Joshua Harris-Till,DEM,680301,4,3,50,57,02
Sequoyah,Governor,Dax Ewbank,REP,680301,0,1,8,9,
Sequoyah,Governor,Chad Moody,REP,680301,2,4,23,29,
Sequoyah,Governor,Mary Fallin,REP,680301,7,4,51,62,
Sequoyah,Superintendent of Public Instruction,Brian Kelly,REP,680301,3,0,19,22,
Sequoyah,Superintendent of Public Instruction,Janet Costello Barresi,REP,680301,0,0,11,11,
Sequoyah,Superintendent of Public Instruction,Joy Hofmeister,REP,680301,4,9,53,66,
Sequoyah,Insurance Commissioner,Bill Viner,REP,680301,3,2,27,32,
Sequoyah,Insurance Commissioner,John Doak,REP,680301,5,6,50,61,
Sequoyah,Corporation Commissioner,Todd Hiett,REP,680301,4,6,43,53,
Sequoyah,Corporation Commissioner,Cliff Branan,REP,680301,4,3,34,41,
Sequoyah,U.S. Senate,Evelyn Rogers,REP,680301,2,1,11,14,
Sequoyah,U.S. Senate,Rob Moye,REP,680301,1,0,2,3,
Sequoyah,U.S. Senate,D. Jean Mcbride-Samuels,REP,680301,0,1,2,3,
Sequoyah,U.S. Senate,Jim Inhofe,REP,680301,3,7,64,74,
Sequoyah,U.S. Senate,Erick Paul Wyatt,REP,680301,2,0,5,7,
Sequoyah,U.S. Senate,Andy Craig,REP,680301,1,0,5,6,
Sequoyah,U.S. Senate,T. Shannon,REP,680301,2,6,35,43,
Sequoyah,U.S. Senate,Randy Brogdon,REP,680301,1,0,3,4,
Sequoyah,U.S. Senate,Eric Mccray,REP,680301,0,0,3,3,
Sequoyah,U.S. Senate,Kevin Crow,REP,680301,1,0,2,3,
Sequoyah,U.S. Senate,James Lankford,REP,680301,2,2,32,36,
Sequoyah,U.S. Senate,Jason Weger,REP,680301,1,1,2,4,
Sequoyah,U.S. House,Darrel Robertson,REP,680301,2,5,22,29,02
Sequoyah,U.S. House,Markwayne Mullin,REP,680301,5,4,63,72,02
Sequoyah,Superintendent of Public Instruction,John Cox,DEM,680302,0,5,22,27,
Sequoyah,Superintendent of Public Instruction,Jack Jr.,DEM,680302,0,0,6,6,
Sequoyah,Superintendent of Public Instruction,Ivan Holmes,DEM,680302,0,0,5,5,
Sequoyah,Superintendent of Public Instruction,Freda Deskin,DEM,680302,1,0,16,17,
Sequoyah,U.S. Senate,Patrick Michael Hayes,DEM,680302,1,0,15,16,
Sequoyah,U.S. Senate,Jim Rogers,DEM,680302,0,3,19,22,
Sequoyah,U.S. Senate,Connie Johnson,DEM,680302,0,2,14,16,
Sequoyah,U.S. House,Earl Everett,DEM,680302,1,5,27,33,02
Sequoyah,U.S. House,Joshua Harris-Till,DEM,680302,0,0,18,18,02
Sequoyah,Governor,Dax Ewbank,REP,680302,0,0,1,1,
Sequoyah,Governor,Chad Moody,REP,680302,0,0,4,4,
Sequoyah,Governor,Mary Fallin,REP,680302,0,6,17,23,
Sequoyah,Superintendent of Public Instruction,Brian Kelly,REP,680302,0,0,5,5,
Sequoyah,Superintendent of Public Instruction,Janet Costello Barresi,REP,680302,0,0,3,3,
Sequoyah,Superintendent of Public Instruction,Joy Hofmeister,REP,680302,0,5,15,20,
Sequoyah,Insurance Commissioner,Bill Viner,REP,680302,0,3,8,11,
Sequoyah,Insurance Commissioner,John Doak,REP,680302,0,3,11,14,
Sequoyah,Corporation Commissioner,Todd Hiett,REP,680302,0,0,12,12,
Sequoyah,Corporation Commissioner,Cliff Branan,REP,680302,0,5,8,13,
Sequoyah,U.S. Senate,Evelyn Rogers,REP,680302,0,0,2,2,
Sequoyah,U.S. Senate,Rob Moye,REP,680302,0,0,1,1,
Sequoyah,U.S. Senate,D. Jean Mcbride-Samuels,REP,680302,0,0,0,0,
Sequoyah,U.S. Senate,Jim Inhofe,REP,680302,0,6,16,22,
Sequoyah,U.S. Senate,Erick Paul Wyatt,REP,680302,0,0,2,2,
Sequoyah,U.S. Senate,Andy Craig,REP,680302,0,1,0,1,
Sequoyah,U.S. Senate,T. Shannon,REP,680302,0,3,6,9,
Sequoyah,U.S. Senate,Randy Brogdon,REP,680302,0,0,0,0,
Sequoyah,U.S. Senate,Eric Mccray,REP,680302,0,0,1,1,
Sequoyah,U.S. Senate,Kevin Crow,REP,680302,0,0,0,0,
Sequoyah,U.S. Senate,James Lankford,REP,680302,0,2,13,15,
Sequoyah,U.S. Senate,Jason Weger,REP,680302,0,0,1,1,
Sequoyah,U.S. House,Darrel Robertson,REP,680302,0,1,2,3,02
Sequoyah,U.S. House,Markwayne Mullin,REP,680302,0,5,19,24,02
Sequoyah,Superintendent of Public Instruction,John Cox,DEM,680303,0,5,102,107,
Sequoyah,Superintendent of Public Instruction,Jack Jr.,DEM,680303,0,1,15,16,
Sequoyah,Superintendent of Public Instruction,Ivan Holmes,DEM,680303,0,0,9,9,
Sequoyah,Superintendent of Public Instruction,Freda Deskin,DEM,680303,1,3,31,35,
Sequoyah,U.S. Senate,Patrick Michael Hayes,DEM,680303,0,0,37,37,
Sequoyah,U.S. Senate,Jim Rogers,DEM,680303,1,8,70,79,
Sequoyah,U.S. Senate,Connie Johnson,DEM,680303,0,1,36,37,
Sequoyah,U.S. House,Earl Everett,DEM,680303,1,5,84,90,02
Sequoyah,U.S. House,Joshua Harris-Till,DEM,680303,0,3,59,62,02
Sequoyah,Governor,Dax Ewbank,REP,680303,0,1,12,13,
Sequoyah,Governor,Chad Moody,REP,680303,0,3,14,17,
Sequoyah,Governor,Mary Fallin,REP,680303,0,0,43,43,
Sequoyah,Superintendent of Public Instruction,Brian Kelly,REP,680303,0,1,7,8,
Sequoyah,Superintendent of Public Instruction,Janet Costello Barresi,REP,680303,0,0,11,11,
Sequoyah,Superintendent of Public Instruction,Joy Hofmeister,REP,680303,0,3,50,53,
Sequoyah,Insurance Commissioner,Bill Viner,REP,680303,0,2,19,21,
Sequoyah,Insurance Commissioner,John Doak,REP,680303,0,2,42,44,
Sequoyah,Corporation Commissioner,Todd Hiett,REP,680303,0,2,38,40,
Sequoyah,Corporation Commissioner,Cliff Branan,REP,680303,0,2,25,27,
Sequoyah,U.S. Senate,Evelyn Rogers,REP,680303,0,0,10,10,
Sequoyah,U.S. Senate,Rob Moye,REP,680303,0,0,1,1,
Sequoyah,U.S. Senate,D. Jean Mcbride-Samuels,REP,680303,0,0,2,2,
Sequoyah,U.S. Senate,Jim Inhofe,REP,680303,0,4,51,55,
Sequoyah,U.S. Senate,Erick Paul Wyatt,REP,680303,0,0,2,2,
Sequoyah,U.S. Senate,Andy Craig,REP,680303,0,0,4,4,
Sequoyah,U.S. Senate,T. Shannon,REP,680303,0,3,24,27,
Sequoyah,U.S. Senate,Randy Brogdon,REP,680303,0,0,4,4,
Sequoyah,U.S. Senate,Eric Mccray,REP,680303,0,0,1,1,
Sequoyah,U.S. Senate,Kevin Crow,REP,680303,0,0,0,0,
Sequoyah,U.S. Senate,James Lankford,REP,680303,0,1,33,34,
Sequoyah,U.S. Senate,Jason Weger,REP,680303,0,0,1,1,
Sequoyah,U.S. House,Darrel Robertson,REP,680303,0,1,15,16,02
Sequoyah,U.S. House,Markwayne Mullin,REP,680303,0,3,52,55,02
Sequoyah,Superintendent of Public Instruction,John Cox,DEM,680304,0,2,29,31,
Sequoyah,Superintendent of Public Instruction,Jack Jr.,DEM,680304,0,0,6,6,
Sequoyah,Superintendent of Public Instruction,Ivan Holmes,DEM,680304,0,0,5,5,
Sequoyah,Superintendent of Public Instruction,Freda Deskin,DEM,680304,1,0,18,19,
Sequoyah,U.S. Senate,Patrick Michael Hayes,DEM,680304,1,1,13,15,
Sequoyah,U.S. Senate,Jim Rogers,DEM,680304,0,1,25,26,
Sequoyah,U.S. Senate,Connie Johnson,DEM,680304,0,0,20,20,
Sequoyah,U.S. House,Earl Everett,DEM,680304,1,1,39,41,02
Sequoyah,U.S. House,Joshua Harris-Till,DEM,680304,0,1,17,18,02
Sequoyah,Governor,Dax Ewbank,REP,680304,0,0,4,4,
Sequoyah,Governor,Chad Moody,REP,680304,0,0,3,3,
Sequoyah,Governor,Mary Fallin,REP,680304,0,2,22,24,
Sequoyah,Superintendent of Public Instruction,Brian Kelly,REP,680304,0,2,7,9,
Sequoyah,Superintendent of Public Instruction,Janet Costello Barresi,REP,680304,0,0,2,2,
Sequoyah,Superintendent of Public Instruction,Joy Hofmeister,REP,680304,0,0,18,18,
Sequoyah,Insurance Commissioner,Bill Viner,REP,680304,0,2,7,9,
Sequoyah,Insurance Commissioner,John Doak,REP,680304,0,0,19,19,
Sequoyah,Corporation Commissioner,Todd Hiett,REP,680304,0,0,13,13,
Sequoyah,Corporation Commissioner,Cliff Branan,REP,680304,0,2,10,12,
Sequoyah,U.S. Senate,Evelyn Rogers,REP,680304,0,0,5,5,
Sequoyah,U.S. Senate,Rob Moye,REP,680304,0,0,0,0,
Sequoyah,U.S. Senate,D. Jean Mcbride-Samuels,REP,680304,0,2,1,3,
Sequoyah,U.S. Senate,Jim Inhofe,REP,680304,0,0,18,18,
Sequoyah,U.S. Senate,Erick Paul Wyatt,REP,680304,0,0,4,4,
Sequoyah,U.S. Senate,Andy Craig,REP,680304,0,0,5,5,
Sequoyah,U.S. Senate,T. Shannon,REP,680304,0,0,6,6,
Sequoyah,U.S. Senate,Randy Brogdon,REP,680304,0,0,0,0,
Sequoyah,U.S. Senate,Eric Mccray,REP,680304,0,0,1,1,
Sequoyah,U.S. Senate,Kevin Crow,REP,680304,0,0,0,0,
Sequoyah,U.S. Senate,James Lankford,REP,680304,0,2,13,15,
Sequoyah,U.S. Senate,Jason Weger,REP,680304,0,0,2,2,
Sequoyah,U.S. House,Darrel Robertson,REP,680304,0,0,1,1,02
Sequoyah,U.S. House,Markwayne Mullin,REP,680304,0,2,26,28,02
Sequoyah,Superintendent of Public Instruction,John Cox,DEM,680305,0,1,30,31,
Sequoyah,Superintendent of Public Instruction,Jack Jr.,DEM,680305,0,0,4,4,
Sequoyah,Superintendent of Public Instruction,Ivan Holmes,DEM,680305,0,0,4,4,
Sequoyah,Superintendent of Public Instruction,Freda Deskin,DEM,680305,0,0,12,12,
Sequoyah,U.S. Senate,Patrick Michael Hayes,DEM,680305,0,1,19,20,
Sequoyah,U.S. Senate,Jim Rogers,DEM,680305,0,0,18,18,
Sequoyah,U.S. Senate,Connie Johnson,DEM,680305,0,0,11,11,
Sequoyah,U.S. House,Earl Everett,DEM,680305,0,0,31,31,02
Sequoyah,U.S. House,Joshua Harris-Till,DEM,680305,0,1,14,15,02
Sequoyah,Governor,Dax Ewbank,REP,680305,0,0,1,1,
Sequoyah,Governor,Chad Moody,REP,680305,0,0,2,2,
Sequoyah,Governor,Mary Fallin,REP,680305,0,0,24,24,
Sequoyah,Superintendent of Public Instruction,Brian Kelly,REP,680305,0,0,6,6,
Sequoyah,Superintendent of Public Instruction,Janet Costello Barresi,REP,680305,0,0,1,1,
Sequoyah,Superintendent of Public Instruction,Joy Hofmeister,REP,680305,0,0,21,21,
Sequoyah,Insurance Commissioner,Bill Viner,REP,680305,0,0,8,8,
Sequoyah,Insurance Commissioner,John Doak,REP,680305,0,0,15,15,
Sequoyah,Corporation Commissioner,Todd Hiett,REP,680305,0,0,12,12,
Sequoyah,Corporation Commissioner,Cliff Branan,REP,680305,0,0,13,13,
Sequoyah,U.S. Senate,Evelyn Rogers,REP,680305,0,0,0,0,
Sequoyah,U.S. Senate,Rob Moye,REP,680305,0,0,0,0,
Sequoyah,U.S. Senate,D. Jean Mcbride-Samuels,REP,680305,0,0,0,0,
Sequoyah,U.S. Senate,Jim Inhofe,REP,680305,0,0,22,22,
Sequoyah,U.S. Senate,Erick Paul Wyatt,REP,680305,0,0,4,4,
Sequoyah,U.S. Senate,Andy Craig,REP,680305,0,0,2,2,
Sequoyah,U.S. Senate,T. Shannon,REP,680305,0,0,13,13,
Sequoyah,U.S. Senate,Randy Brogdon,REP,680305,0,0,1,1,
Sequoyah,U.S. Senate,Eric Mccray,REP,680305,0,0,1,1,
Sequoyah,U.S. Senate,Kevin Crow,REP,680305,0,0,0,0,
Sequoyah,U.S. Senate,James Lankford,REP,680305,0,0,10,10,
Sequoyah,U.S. Senate,Jason Weger,REP,680305,0,0,1,1,
Sequoyah,U.S. House,Darrel Robertson,REP,680305,0,0,7,7,02
Sequoyah,U.S. House,Markwayne Mullin,REP,680305,0,0,20,20,02
Sequoyah,Superintendent of Public Instruction,John Cox,DEM,680306,0,1,51,52,
Sequoyah,Superintendent of Public Instruction,Jack Jr.,DEM,680306,0,0,5,5,
Sequoyah,Superintendent of Public Instruction,Ivan Holmes,DEM,680306,0,0,13,13,
Sequoyah,Superintendent of Public Instruction,Freda Deskin,DEM,680306,0,1,12,13,
Sequoyah,U.S. Senate,Patrick Michael Hayes,DEM,680306,0,0,12,12,
Sequoyah,U.S. Senate,Jim Rogers,DEM,680306,0,1,35,36,
Sequoyah,U.S. Senate,Connie Johnson,DEM,680306,0,1,26,27,
Sequoyah,U.S. House,Earl Everett,DEM,680306,0,0,39,39,02
Sequoyah,U.S. House,Joshua Harris-Till,DEM,680306,0,2,30,32,02
Sequoyah,Governor,Dax Ewbank,REP,680306,0,0,4,4,
Sequoyah,Governor,Chad Moody,REP,680306,0,1,16,17,
Sequoyah,Governor,Mary Fallin,REP,680306,0,4,49,53,
Sequoyah,Superintendent of Public Instruction,Brian Kelly,REP,680306,0,2,13,15,
Sequoyah,Superintendent of Public Instruction,Janet Costello Barresi,REP,680306,0,0,8,8,
Sequoyah,Superintendent of Public Instruction,Joy Hofmeister,REP,680306,0,2,47,49,
Sequoyah,Insurance Commissioner,Bill Viner,REP,680306,0,3,23,26,
Sequoyah,Insurance Commissioner,John Doak,REP,680306,0,1,38,39,
Sequoyah,Corporation Commissioner,Todd Hiett,REP,680306,0,2,31,33,
Sequoyah,Corporation Commissioner,Cliff Branan,REP,680306,0,2,31,33,
Sequoyah,U.S. Senate,Evelyn Rogers,REP,680306,0,0,6,6,
Sequoyah,U.S. Senate,Rob Moye,REP,680306,0,0,3,3,
Sequoyah,U.S. Senate,D. Jean Mcbride-Samuels,REP,680306,0,0,3,3,
Sequoyah,U.S. Senate,Jim Inhofe,REP,680306,0,5,55,60,
Sequoyah,U.S. Senate,Erick Paul Wyatt,REP,680306,0,0,0,0,
Sequoyah,U.S. Senate,Andy Craig,REP,680306,0,0,2,2,
Sequoyah,U.S. Senate,T. Shannon,REP,680306,0,5,19,24,
Sequoyah,U.S. Senate,Randy Brogdon,REP,680306,0,0,2,2,
Sequoyah,U.S. Senate,Eric Mccray,REP,680306,0,0,7,7,
Sequoyah,U.S. Senate,Kevin Crow,REP,680306,0,0,1,1,
Sequoyah,U.S. Senate,James Lankford,REP,680306,0,0,32,32,
Sequoyah,U.S. Senate,Jason Weger,REP,680306,0,0,3,3,
Sequoyah,U.S. House,Darrel Robertson,REP,680306,0,0,17,17,02
Sequoyah,U.S. House,Markwayne Mullin,REP,680306,0,5,54,59,02
Sequoyah,Superintendent of Public Instruction,John Cox,DEM,680307,0,3,37,40,
Sequoyah,Superintendent of Public Instruction,Jack Jr.,DEM,680307,0,0,4,4,
Sequoyah,Superintendent of Public Instruction,Ivan Holmes,DEM,680307,0,0,5,5,
Sequoyah,Superintendent of Public Instruction,Freda Deskin,DEM,680307,0,1,10,11,
Sequoyah,U.S. Senate,Patrick Michael Hayes,DEM,680307,0,0,15,15,
Sequoyah,U.S. Senate,Jim Rogers,DEM,680307,0,3,28,31,
Sequoyah,U.S. Senate,Connie Johnson,DEM,680307,0,1,12,13,
Sequoyah,U.S. House,Earl Everett,DEM,680307,0,3,35,38,02
Sequoyah,U.S. House,Joshua Harris-Till,DEM,680307,0,1,18,19,02
Sequoyah,Governor,Dax Ewbank,REP,680307,0,0,0,0,
Sequoyah,Governor,Chad Moody,REP,680307,0,1,7,8,
Sequoyah,Governor,Mary Fallin,REP,680307,0,0,19,19,
Sequoyah,Superintendent of Public Instruction,Brian Kelly,REP,680307,0,0,7,7,
Sequoyah,Superintendent of Public Instruction,Janet Costello Barresi,REP,680307,0,0,3,3,
Sequoyah,Superintendent of Public Instruction,Joy Hofmeister,REP,680307,0,1,15,16,
Sequoyah,Insurance Commissioner,Bill Viner,REP,680307,0,0,7,7,
Sequoyah,Insurance Commissioner,John Doak,REP,680307,0,1,16,17,
Sequoyah,Corporation Commissioner,Todd Hiett,REP,680307,0,0,17,17,
Sequoyah,Corporation Commissioner,Cliff Branan,REP,680307,0,1,8,9,
Sequoyah,U.S. Senate,Evelyn Rogers,REP,680307,0,1,2,3,
Sequoyah,U.S. Senate,Rob Moye,REP,680307,0,0,1,1,
Sequoyah,U.S. Senate,D. Jean Mcbride-Samuels,REP,680307,0,0,0,0,
Sequoyah,U.S. Senate,Jim Inhofe,REP,680307,0,0,23,23,
Sequoyah,U.S. Senate,Erick Paul Wyatt,REP,680307,0,0,0,0,
Sequoyah,U.S. Senate,Andy Craig,REP,680307,0,0,1,1,
Sequoyah,U.S. Senate,T. Shannon,REP,680307,0,0,16,16,
Sequoyah,U.S. Senate,Randy Brogdon,REP,680307,0,0,0,0,
Sequoyah,U.S. Senate,Eric Mccray,REP,680307,0,0,0,0,
Sequoyah,U.S. Senate,Kevin Crow,REP,680307,0,0,1,1,
Sequoyah,U.S. Senate,James Lankford,REP,680307,0,1,7,8,
Sequoyah,U.S. Senate,Jason Weger,REP,680307,0,0,1,1,
Sequoyah,U.S. House,Darrel Robertson,REP,680307,0,1,5,6,02
Sequoyah,U.S. House,Markwayne Mullin,REP,680307,0,0,21,21,02
Sequoyah,Superintendent of Public Instruction,John Cox,DEM,680308,0,2,26,28,
Sequoyah,Superintendent of Public Instruction,Jack Jr.,DEM,680308,0,0,3,3,
Sequoyah,Superintendent of Public Instruction,Ivan Holmes,DEM,680308,0,0,5,5,
Sequoyah,Superintendent of Public Instruction,Freda Deskin,DEM,680308,0,1,1,2,
Sequoyah,U.S. Senate,Patrick Michael Hayes,DEM,680308,0,1,5,6,
Sequoyah,U.S. Senate,Jim Rogers,DEM,680308,0,2,15,17,
Sequoyah,U.S. Senate,Connie Johnson,DEM,680308,0,0,12,12,
Sequoyah,U.S. House,Earl Everett,DEM,680308,0,1,16,17,02
Sequoyah,U.S. House,Joshua Harris-Till,DEM,680308,0,2,16,18,02
Sequoyah,Governor,Dax Ewbank,REP,680308,0,0,1,1,
Sequoyah,Governor,Chad Moody,REP,680308,0,1,3,4,
Sequoyah,Governor,Mary Fallin,REP,680308,0,0,3,3,
Sequoyah,Superintendent of Public Instruction,Brian Kelly,REP,680308,0,1,2,3,
Sequoyah,Superintendent of Public Instruction,Janet Costello Barresi,REP,680308,0,0,2,2,
Sequoyah,Superintendent of Public Instruction,Joy Hofmeister,REP,680308,0,0,3,3,
Sequoyah,Insurance Commissioner,Bill Viner,REP,680308,0,0,3,3,
Sequoyah,Insurance Commissioner,John Doak,REP,680308,0,1,8,9,
Sequoyah,Corporation Commissioner,Todd Hiett,REP,680308,0,0,4,4,
Sequoyah,Corporation Commissioner,Cliff Branan,REP,680308,0,1,3,4,
Sequoyah,U.S. Senate,Evelyn Rogers,REP,680308,0,0,0,0,
Sequoyah,U.S. Senate,Rob Moye,REP,680308,0,0,1,1,
Sequoyah,U.S. Senate,D. Jean Mcbride-Samuels,REP,680308,0,0,1,1,
Sequoyah,U.S. Senate,Jim Inhofe,REP,680308,0,1,8,9,
Sequoyah,U.S. Senate,Erick Paul Wyatt,REP,680308,0,0,1,1,
Sequoyah,U.S. Senate,Andy Craig,REP,680308,0,0,0,0,
Sequoyah,U.S. Senate,T. Shannon,REP,680308,0,1,5,6,
Sequoyah,U.S. Senate,Randy Brogdon,REP,680308,0,0,0,0,
Sequoyah,U.S. Senate,Eric Mccray,REP,680308,0,0,0,0,
Sequoyah,U.S. Senate,Kevin Crow,REP,680308,0,0,0,0,
Sequoyah,U.S. Senate,James Lankford,REP,680308,0,0,4,4,
Sequoyah,U.S. Senate,Jason Weger,REP,680308,0,0,2,2,
Sequoyah,U.S. House,Darrel Robertson,REP,680308,0,0,2,2,02
Sequoyah,U.S. House,Markwayne Mullin,REP,680308,0,1,9,10,02
Sequoyah,Superintendent of Public Instruction,John Cox,DEM,680309,0,0,31,31,
Sequoyah,Superintendent of Public Instruction,Jack Jr.,DEM,680309,0,0,2,2,
Sequoyah,Superintendent of Public Instruction,Ivan Holmes,DEM,680309,0,0,1,1,
Sequoyah,Superintendent of Public Instruction,Freda Deskin,DEM,680309,1,0,4,5,
Sequoyah,U.S. Senate,Patrick Michael Hayes,DEM,680309,0,0,7,7,
Sequoyah,U.S. Senate,Jim Rogers,DEM,680309,0,0,20,20,
Sequoyah,U.S. Senate,Connie Johnson,DEM,680309,1,0,7,8,
Sequoyah,U.S. House,Earl Everett,DEM,680309,0,0,16,16,02
Sequoyah,U.S. House,Joshua Harris-Till,DEM,680309,1,0,15,16,02
Sequoyah,Governor,Dax Ewbank,REP,680309,0,0,1,1,
Sequoyah,Governor,Chad Moody,REP,680309,0,0,3,3,
Sequoyah,Governor,Mary Fallin,REP,680309,0,0,17,17,
Sequoyah,Superintendent of Public Instruction,Brian Kelly,REP,680309,0,0,8,8,
Sequoyah,Superintendent of Public Instruction,Janet Costello Barresi,REP,680309,0,0,4,4,
Sequoyah,Superintendent of Public Instruction,Joy Hofmeister,REP,680309,0,0,6,6,
Sequoyah,Insurance Commissioner,Bill Viner,REP,680309,0,0,8,8,
Sequoyah,Insurance Commissioner,John Doak,REP,680309,0,0,10,10,
Sequoyah,Corporation Commissioner,Todd Hiett,REP,680309,0,0,6,6,
Sequoyah,Corporation Commissioner,Cliff Branan,REP,680309,0,0,12,12,
Sequoyah,U.S. Senate,Evelyn Rogers,REP,680309,0,0,2,2,
Sequoyah,U.S. Senate,Rob Moye,REP,680309,0,0,3,3,
Sequoyah,U.S. Senate,D. Jean Mcbride-Samuels,REP,680309,0,0,1,1,
Sequoyah,U.S. Senate,Jim Inhofe,REP,680309,0,0,10,10,
Sequoyah,U.S. Senate,Erick Paul Wyatt,REP,680309,0,0,5,5,
Sequoyah,U.S. Senate,Andy Craig,REP,680309,0,0,2,2,
Sequoyah,U.S. Senate,T. Shannon,REP,680309,0,0,5,5,
Sequoyah,U.S. Senate,Randy Brogdon,REP,680309,0,0,1,1,
Sequoyah,U.S. Senate,Eric Mccray,REP,680309,0,0,1,1,
Sequoyah,U.S. Senate,Kevin Crow,REP,680309,0,0,1,1,
Sequoyah,U.S. Senate,James Lankford,REP,680309,0,0,9,9,
Sequoyah,U.S. Senate,Jason Weger,REP,680309,0,0,0,0,
Sequoyah,U.S. House,Darrel Robertson,REP,680309,0,0,4,4,02
Sequoyah,U.S. House,Markwayne Mullin,REP,680309,0,0,17,17,02
Sequoyah,Superintendent of Public Instruction,John Cox,DEM,680310,0,0,40,40,
Sequoyah,Superintendent of Public Instruction,Jack Jr.,DEM,680310,0,0,3,3,
Sequoyah,Superintendent of Public Instruction,Ivan Holmes,DEM,680310,0,0,7,7,
Sequoyah,Superintendent of Public Instruction,Freda Deskin,DEM,680310,0,0,11,11,
Sequoyah,U.S. Senate,Patrick Michael Hayes,DEM,680310,0,0,9,9,
Sequoyah,U.S. Senate,Jim Rogers,DEM,680310,0,0,37,37,
Sequoyah,U.S. Senate,Connie Johnson,DEM,680310,0,0,15,15,
Sequoyah,U.S. House,Earl Everett,DEM,680310,0,0,44,44,02
Sequoyah,U.S. House,Joshua Harris-Till,DEM,680310,0,0,12,12,02
Sequoyah,Governor,Dax Ewbank,REP,680310,0,0,5,5,
Sequoyah,Governor,Chad Moody,REP,680310,0,0,0,0,
Sequoyah,Governor,Mary Fallin,REP,680310,0,1,15,16,
Sequoyah,Superintendent of Public Instruction,Brian Kelly,REP,680310,0,0,6,6,
Sequoyah,Superintendent of Public Instruction,Janet Costello Barresi,REP,680310,0,0,3,3,
Sequoyah,Superintendent of Public Instruction,Joy Hofmeister,REP,680310,0,1,11,12,
Sequoyah,Insurance Commissioner,Bill Viner,REP,680310,0,0,11,11,
Sequoyah,Insurance Commissioner,John Doak,REP,680310,0,1,9,10,
Sequoyah,Corporation Commissioner,Todd Hiett,REP,680310,0,1,9,10,
Sequoyah,Corporation Commissioner,Cliff Branan,REP,680310,0,0,10,10,
Sequoyah,U.S. Senate,Evelyn Rogers,REP,680310,0,0,0,0,
Sequoyah,U.S. Senate,Rob Moye,REP,680310,0,0,1,1,
Sequoyah,U.S. Senate,D. Jean Mcbride-Samuels,REP,680310,0,0,0,0,
Sequoyah,U.S. Senate,Jim Inhofe,REP,680310,0,1,17,18,
Sequoyah,U.S. Senate,Erick Paul Wyatt,REP,680310,0,0,2,2,
Sequoyah,U.S. Senate,Andy Craig,REP,680310,0,0,0,0,
Sequoyah,U.S. Senate,T. Shannon,REP,680310,0,0,10,10,
Sequoyah,U.S. Senate,Randy Brogdon,REP,680310,0,0,2,2,
Sequoyah,U.S. Senate,Eric Mccray,REP,680310,0,0,0,0,
Sequoyah,U.S. Senate,Kevin Crow,REP,680310,0,0,0,0,
Sequoyah,U.S. Senate,James Lankford,REP,680310,0,1,8,9,
Sequoyah,U.S. Senate,Jason Weger,REP,680310,0,0,0,0,
Sequoyah,U.S. House,Darrel Robertson,REP,680310,0,0,5,5,02
Sequoyah,U.S. House,Markwayne Mullin,REP,680310,0,1,14,15,02
Stephens,Superintendent of Public Instruction,John Cox,DEM,690001,0,3,39,42,
Stephens,Superintendent of Public Instruction,Jack Jr.,DEM,690001,0,2,24,26,
Stephens,Superintendent of Public Instruction,Ivan Holmes,DEM,690001,0,0,7,7,
Stephens,Superintendent of Public Instruction,Freda Deskin,DEM,690001,0,1,10,11,
Stephens,U.S. Senate,Patrick Michael Hayes,DEM,690001,0,1,16,17,
Stephens,U.S. Senate,Jim Rogers,DEM,690001,0,3,28,31,
Stephens,U.S. Senate,Connie Johnson,DEM,690001,0,2,36,38,
Stephens,U.S. House,Bert Smith,DEM,690001,0,5,67,72,04
Stephens,U.S. House,Tae Si,DEM,690001,0,1,10,11,04
Stephens,Governor,Dax Ewbank,REP,690001,0,1,22,23,
Stephens,Governor,Chad Moody,REP,690001,0,2,19,21,
Stephens,Governor,Mary Fallin,REP,690001,0,16,165,181,
Stephens,Superintendent of Public Instruction,Brian Kelly,REP,690001,0,4,35,39,
Stephens,Superintendent of Public Instruction,Janet Costello Barresi,REP,690001,0,3,55,58,
Stephens,Superintendent of Public Instruction,Joy Hofmeister,REP,690001,0,11,114,125,
Stephens,Insurance Commissioner,Bill Viner,REP,690001,0,5,33,38,
Stephens,Insurance Commissioner,John Doak,REP,690001,0,11,157,168,
Stephens,Corporation Commissioner,Todd Hiett,REP,690001,0,9,92,101,
Stephens,Corporation Commissioner,Cliff Branan,REP,690001,0,8,98,106,
Stephens,U.S. Senate,Evelyn Rogers,REP,690001,0,0,8,8,
Stephens,U.S. Senate,Rob Moye,REP,690001,0,0,2,2,
Stephens,U.S. Senate,D. Jean Mcbride-Samuels,REP,690001,0,0,3,3,
Stephens,U.S. Senate,Jim Inhofe,REP,690001,0,18,195,213,
Stephens,U.S. Senate,Erick Paul Wyatt,REP,690001,0,1,3,4,
Stephens,U.S. Senate,Andy Craig,REP,690001,0,0,3,3,
Stephens,U.S. Senate,T. Shannon,REP,690001,0,6,101,107,
Stephens,U.S. Senate,Randy Brogdon,REP,690001,0,0,7,7,
Stephens,U.S. Senate,Eric Mccray,REP,690001,0,0,2,2,
Stephens,U.S. Senate,Kevin Crow,REP,690001,0,0,1,1,
Stephens,U.S. Senate,James Lankford,REP,690001,0,12,97,109,
Stephens,U.S. Senate,Jason Weger,REP,690001,0,0,1,1,
Stephens,U.S. House,Anna Flatt,REP,690001,0,1,25,26,04
Stephens,U.S. House,Tom Cole,REP,690001,0,17,181,198,04
Stephens,Superintendent of Public Instruction,John Cox,DEM,690003,0,0,27,27,
Stephens,Superintendent of Public Instruction,Jack Jr.,DEM,690003,0,0,19,19,
Stephens,Superintendent of Public Instruction,Ivan Holmes,DEM,690003,1,0,5,6,
Stephens,Superintendent of Public Instruction,Freda Deskin,DEM,690003,1,2,10,13,
Stephens,U.S. Senate,Patrick Michael Hayes,DEM,690003,0,1,16,17,
Stephens,U.S. Senate,Jim Rogers,DEM,690003,1,0,19,20,
Stephens,U.S. Senate,Connie Johnson,DEM,690003,1,1,26,28,
Stephens,U.S. House,Bert Smith,DEM,690003,1,1,45,47,04
Stephens,U.S. House,Tae Si,DEM,690003,0,0,15,15,04
Stephens,Governor,Dax Ewbank,REP,690003,0,3,18,21,
Stephens,Governor,Chad Moody,REP,690003,0,4,35,39,
Stephens,Governor,Mary Fallin,REP,690003,0,11,124,135,
Stephens,Superintendent of Public Instruction,Brian Kelly,REP,690003,0,5,32,37,
Stephens,Superintendent of Public Instruction,Janet Costello Barresi,REP,690003,0,5,50,55,
Stephens,Superintendent of Public Instruction,Joy Hofmeister,REP,690003,0,8,91,99,
Stephens,Insurance Commissioner,Bill Viner,REP,690003,0,5,28,33,
Stephens,Insurance Commissioner,John Doak,REP,690003,0,11,136,147,
Stephens,Corporation Commissioner,Todd Hiett,REP,690003,0,13,71,84,
Stephens,Corporation Commissioner,Cliff Branan,REP,690003,0,5,96,101,
Stephens,U.S. Senate,Evelyn Rogers,REP,690003,0,0,7,7,
Stephens,U.S. Senate,Rob Moye,REP,690003,0,0,4,4,
Stephens,U.S. Senate,D. Jean Mcbride-Samuels,REP,690003,0,0,3,3,
Stephens,U.S. Senate,Jim Inhofe,REP,690003,0,18,158,176,
Stephens,U.S. Senate,Erick Paul Wyatt,REP,690003,0,0,5,5,
Stephens,U.S. Senate,Andy Craig,REP,690003,0,0,2,2,
Stephens,U.S. Senate,T. Shannon,REP,690003,0,4,82,86,
Stephens,U.S. Senate,Randy Brogdon,REP,690003,0,0,0,0,
Stephens,U.S. Senate,Eric Mccray,REP,690003,0,0,1,1,
Stephens,U.S. Senate,Kevin Crow,REP,690003,0,0,5,5,
Stephens,U.S. Senate,James Lankford,REP,690003,0,14,85,99,
Stephens,U.S. Senate,Jason Weger,REP,690003,0,0,0,0,
Stephens,U.S. House,Anna Flatt,REP,690003,0,3,23,26,04
Stephens,U.S. House,Tom Cole,REP,690003,0,15,152,167,04
Stephens,Superintendent of Public Instruction,John Cox,DEM,690004,0,3,22,25,
Stephens,Superintendent of Public Instruction,Jack Jr.,DEM,690004,0,1,23,24,
Stephens,Superintendent of Public Instruction,Ivan Holmes,DEM,690004,0,0,5,5,
Stephens,Superintendent of Public Instruction,Freda Deskin,DEM,690004,0,2,10,12,
Stephens,U.S. Senate,Patrick Michael Hayes,DEM,690004,0,1,13,14,
Stephens,U.S. Senate,Jim Rogers,DEM,690004,0,1,22,23,
Stephens,U.S. Senate,Connie Johnson,DEM,690004,0,4,23,27,
Stephens,U.S. House,Bert Smith,DEM,690004,0,3,42,45,04
Stephens,U.S. House,Tae Si,DEM,690004,0,2,13,15,04
Stephens,Governor,Dax Ewbank,REP,690004,0,3,12,15,
Stephens,Governor,Chad Moody,REP,690004,0,1,18,19,
Stephens,Governor,Mary Fallin,REP,690004,4,5,76,85,
Stephens,Superintendent of Public Instruction,Brian Kelly,REP,690004,2,0,20,22,
Stephens,Superintendent of Public Instruction,Janet Costello Barresi,REP,690004,1,5,31,37,
Stephens,Superintendent of Public Instruction,Joy Hofmeister,REP,690004,1,4,53,58,
Stephens,Insurance Commissioner,Bill Viner,REP,690004,2,2,30,34,
Stephens,Insurance Commissioner,John Doak,REP,690004,2,7,64,73,
Stephens,Corporation Commissioner,Todd Hiett,REP,690004,4,4,37,45,
Stephens,Corporation Commissioner,Cliff Branan,REP,690004,0,4,59,63,
Stephens,U.S. Senate,Evelyn Rogers,REP,690004,0,0,6,6,
Stephens,U.S. Senate,Rob Moye,REP,690004,0,1,3,4,
Stephens,U.S. Senate,D. Jean Mcbride-Samuels,REP,690004,0,0,1,1,
Stephens,U.S. Senate,Jim Inhofe,REP,690004,3,8,92,103,
Stephens,U.S. Senate,Erick Paul Wyatt,REP,690004,1,0,5,6,
Stephens,U.S. Senate,Andy Craig,REP,690004,0,0,1,1,
Stephens,U.S. Senate,T. Shannon,REP,690004,4,3,58,65,
Stephens,U.S. Senate,Randy Brogdon,REP,690004,0,3,4,7,
Stephens,U.S. Senate,Eric Mccray,REP,690004,0,0,1,1,
Stephens,U.S. Senate,Kevin Crow,REP,690004,0,0,0,0,
Stephens,U.S. Senate,James Lankford,REP,690004,0,3,42,45,
Stephens,U.S. Senate,Jason Weger,REP,690004,0,0,1,1,
Stephens,U.S. House,Anna Flatt,REP,690004,1,3,14,18,04
Stephens,U.S. House,Tom Cole,REP,690004,3,6,94,103,04
Stephens,Superintendent of Public Instruction,John Cox,DEM,690008,0,0,20,20,
Stephens,Superintendent of Public Instruction,Jack Jr.,DEM,690008,0,0,24,24,
Stephens,Superintendent of Public Instruction,Ivan Holmes,DEM,690008,0,0,5,5,
Stephens,Superintendent of Public Instruction,Freda Deskin,DEM,690008,1,1,9,11,
Stephens,U.S. Senate,Patrick Michael Hayes,DEM,690008,0,0,15,15,
Stephens,U.S. Senate,Jim Rogers,DEM,690008,0,1,24,25,
Stephens,U.S. Senate,Connie Johnson,DEM,690008,1,0,18,19,
Stephens,U.S. House,Bert Smith,DEM,690008,1,1,49,51,04
Stephens,U.S. House,Tae Si,DEM,690008,0,0,6,6,04
Stephens,Governor,Dax Ewbank,REP,690008,0,0,3,3,
Stephens,Governor,Chad Moody,REP,690008,0,0,3,3,
Stephens,Governor,Mary Fallin,REP,690008,0,5,29,34,
Stephens,Superintendent of Public Instruction,Brian Kelly,REP,690008,0,2,10,12,
Stephens,Superintendent of Public Instruction,Janet Costello Barresi,REP,690008,0,3,9,12,
Stephens,Superintendent of Public Instruction,Joy Hofmeister,REP,690008,0,0,16,16,
Stephens,Insurance Commissioner,Bill Viner,REP,690008,0,1,10,11,
Stephens,Insurance Commissioner,John Doak,REP,690008,0,4,25,29,
Stephens,Corporation Commissioner,Todd Hiett,REP,690008,0,2,19,21,
Stephens,Corporation Commissioner,Cliff Branan,REP,690008,0,3,15,18,
Stephens,U.S. Senate,Evelyn Rogers,REP,690008,0,0,2,2,
Stephens,U.S. Senate,Rob Moye,REP,690008,0,0,1,1,
Stephens,U.S. Senate,D. Jean Mcbride-Samuels,REP,690008,0,0,1,1,
Stephens,U.S. Senate,Jim Inhofe,REP,690008,0,5,28,33,
Stephens,U.S. Senate,Erick Paul Wyatt,REP,690008,0,0,2,2,
Stephens,U.S. Senate,Andy Craig,REP,690008,0,0,0,0,
Stephens,U.S. Senate,T. Shannon,REP,690008,0,0,19,19,
Stephens,U.S. Senate,Randy Brogdon,REP,690008,0,0,1,1,
Stephens,U.S. Senate,Eric Mccray,REP,690008,0,0,0,0,
Stephens,U.S. Senate,Kevin Crow,REP,690008,0,0,1,1,
Stephens,U.S. Senate,James Lankford,REP,690008,0,5,13,18,
Stephens,U.S. Senate,Jason Weger,REP,690008,0,0,1,1,
Stephens,U.S. House,Anna Flatt,REP,690008,0,1,5,6,04
Stephens,U.S. House,Tom Cole,REP,690008,0,4,29,33,04
Stephens,Superintendent of Public Instruction,John Cox,DEM,690012,0,1,19,20,
Stephens,Superintendent of Public Instruction,Jack Jr.,DEM,690012,0,0,17,17,
Stephens,Superintendent of Public Instruction,Ivan Holmes,DEM,690012,1,0,3,4,
Stephens,Superintendent of Public Instruction,Freda Deskin,DEM,690012,0,2,10,12,
Stephens,U.S. Senate,Patrick Michael Hayes,DEM,690012,1,2,8,11,
Stephens,U.S. Senate,Jim Rogers,DEM,690012,0,0,23,23,
Stephens,U.S. Senate,Connie Johnson,DEM,690012,0,1,17,18,
Stephens,U.S. House,Bert Smith,DEM,690012,0,3,37,40,04
Stephens,U.S. House,Tae Si,DEM,690012,1,0,8,9,04
Stephens,Governor,Dax Ewbank,REP,690012,0,1,10,11,
Stephens,Governor,Chad Moody,REP,690012,0,1,23,24,
Stephens,Governor,Mary Fallin,REP,690012,1,12,46,59,
Stephens,Superintendent of Public Instruction,Brian Kelly,REP,690012,1,4,16,21,
Stephens,Superintendent of Public Instruction,Janet Costello Barresi,REP,690012,0,8,27,35,
Stephens,Superintendent of Public Instruction,Joy Hofmeister,REP,690012,0,2,36,38,
Stephens,Insurance Commissioner,Bill Viner,REP,690012,1,1,21,23,
Stephens,Insurance Commissioner,John Doak,REP,690012,0,8,53,61,
Stephens,Corporation Commissioner,Todd Hiett,REP,690012,1,7,38,46,
Stephens,Corporation Commissioner,Cliff Branan,REP,690012,0,3,37,40,
Stephens,U.S. Senate,Evelyn Rogers,REP,690012,0,0,6,6,
Stephens,U.S. Senate,Rob Moye,REP,690012,0,1,1,2,
Stephens,U.S. Senate,D. Jean Mcbride-Samuels,REP,690012,0,0,2,2,
Stephens,U.S. Senate,Jim Inhofe,REP,690012,1,12,66,79,
Stephens,U.S. Senate,Erick Paul Wyatt,REP,690012,0,0,3,3,
Stephens,U.S. Senate,Andy Craig,REP,690012,0,0,3,3,
Stephens,U.S. Senate,T. Shannon,REP,690012,1,3,41,45,
Stephens,U.S. Senate,Randy Brogdon,REP,690012,0,0,1,1,
Stephens,U.S. Senate,Eric Mccray,REP,690012,0,0,1,1,
Stephens,U.S. Senate,Kevin Crow,REP,690012,0,1,1,2,
Stephens,U.S. Senate,James Lankford,REP,690012,0,10,33,43,
Stephens,U.S. Senate,Jason Weger,REP,690012,0,0,0,0,
Stephens,U.S. House,Anna Flatt,REP,690012,0,1,16,17,04
Stephens,U.S. House,Tom Cole,REP,690012,1,13,63,77,04
Stephens,Superintendent of Public Instruction,John Cox,DEM,690013,1,1,7,9,
Stephens,Superintendent of Public Instruction,Jack Jr.,DEM,690013,0,0,9,9,
Stephens,Superintendent of Public Instruction,Ivan Holmes,DEM,690013,0,0,2,2,
Stephens,Superintendent of Public Instruction,Freda Deskin,DEM,690013,1,0,4,5,
Stephens,U.S. Senate,Patrick Michael Hayes,DEM,690013,1,1,8,10,
Stephens,U.S. Senate,Jim Rogers,DEM,690013,0,0,6,6,
Stephens,U.S. Senate,Connie Johnson,DEM,690013,1,0,8,9,
Stephens,U.S. House,Bert Smith,DEM,690013,2,1,20,23,04
Stephens,U.S. House,Tae Si,DEM,690013,0,0,2,2,04
Stephens,Governor,Dax Ewbank,REP,690013,0,1,3,4,
Stephens,Governor,Chad Moody,REP,690013,0,0,5,5,
Stephens,Governor,Mary Fallin,REP,690013,0,0,12,12,
Stephens,Superintendent of Public Instruction,Brian Kelly,REP,690013,0,0,6,6,
Stephens,Superintendent of Public Instruction,Janet Costello Barresi,REP,690013,0,0,3,3,
Stephens,Superintendent of Public Instruction,Joy Hofmeister,REP,690013,0,1,11,12,
Stephens,Insurance Commissioner,Bill Viner,REP,690013,0,0,4,4,
Stephens,Insurance Commissioner,John Doak,REP,690013,0,1,15,16,
Stephens,Corporation Commissioner,Todd Hiett,REP,690013,0,1,7,8,
Stephens,Corporation Commissioner,Cliff Branan,REP,690013,0,0,11,11,
Stephens,U.S. Senate,Evelyn Rogers,REP,690013,0,0,2,2,
Stephens,U.S. Senate,Rob Moye,REP,690013,0,0,0,0,
Stephens,U.S. Senate,D. Jean Mcbride-Samuels,REP,690013,0,0,0,0,
Stephens,U.S. Senate,Jim Inhofe,REP,690013,0,1,17,18,
Stephens,U.S. Senate,Erick Paul Wyatt,REP,690013,0,0,1,1,
Stephens,U.S. Senate,Andy Craig,REP,690013,0,0,0,0,
Stephens,U.S. Senate,T. Shannon,REP,690013,0,1,14,15,
Stephens,U.S. Senate,Randy Brogdon,REP,690013,0,0,3,3,
Stephens,U.S. Senate,Eric Mccray,REP,690013,0,0,0,0,
Stephens,U.S. Senate,Kevin Crow,REP,690013,0,0,0,0,
Stephens,U.S. Senate,James Lankford,REP,690013,0,0,3,3,
Stephens,U.S. Senate,Jason Weger,REP,690013,0,0,0,0,
Stephens,U.S. House,Anna Flatt,REP,690013,0,0,3,3,04
Stephens,U.S. House,Tom Cole,REP,690013,0,1,17,18,04
Stephens,Superintendent of Public Instruction,John Cox,DEM,690014,0,6,30,36,
Stephens,Superintendent of Public Instruction,Jack Jr.,DEM,690014,1,2,19,22,
Stephens,Superintendent of Public Instruction,Ivan Holmes,DEM,690014,0,1,2,3,
Stephens,Superintendent of Public Instruction,Freda Deskin,DEM,690014,0,2,16,18,
Stephens,U.S. Senate,Patrick Michael Hayes,DEM,690014,1,0,18,19,
Stephens,U.S. Senate,Jim Rogers,DEM,690014,0,7,23,30,
Stephens,U.S. Senate,Connie Johnson,DEM,690014,0,4,24,28,
Stephens,U.S. House,Bert Smith,DEM,690014,0,9,55,64,04
Stephens,U.S. House,Tae Si,DEM,690014,1,2,9,12,04
Stephens,Governor,Dax Ewbank,REP,690014,0,2,6,8,
Stephens,Governor,Chad Moody,REP,690014,0,1,31,32,
Stephens,Governor,Mary Fallin,REP,690014,2,12,89,103,
Stephens,Superintendent of Public Instruction,Brian Kelly,REP,690014,0,3,25,28,
Stephens,Superintendent of Public Instruction,Janet Costello Barresi,REP,690014,1,4,24,29,
Stephens,Superintendent of Public Instruction,Joy Hofmeister,REP,690014,0,8,74,82,
Stephens,Insurance Commissioner,Bill Viner,REP,690014,0,4,30,34,
Stephens,Insurance Commissioner,John Doak,REP,690014,0,9,83,92,
Stephens,Corporation Commissioner,Todd Hiett,REP,690014,1,4,57,62,
Stephens,Corporation Commissioner,Cliff Branan,REP,690014,0,8,58,66,
Stephens,U.S. Senate,Evelyn Rogers,REP,690014,0,0,3,3,
Stephens,U.S. Senate,Rob Moye,REP,690014,0,0,2,2,
Stephens,U.S. Senate,D. Jean Mcbride-Samuels,REP,690014,1,0,4,5,
Stephens,U.S. Senate,Jim Inhofe,REP,690014,1,10,113,124,
Stephens,U.S. Senate,Erick Paul Wyatt,REP,690014,0,4,2,6,
Stephens,U.S. Senate,Andy Craig,REP,690014,0,0,0,0,
Stephens,U.S. Senate,T. Shannon,REP,690014,1,11,66,78,
Stephens,U.S. Senate,Randy Brogdon,REP,690014,0,0,0,0,
Stephens,U.S. Senate,Eric Mccray,REP,690014,0,0,1,1,
Stephens,U.S. Senate,Kevin Crow,REP,690014,0,0,1,1,
Stephens,U.S. Senate,James Lankford,REP,690014,0,5,59,64,
Stephens,U.S. Senate,Jason Weger,REP,690014,1,0,0,1,
Stephens,U.S. House,Anna Flatt,REP,690014,1,6,24,31,04
Stephens,U.S. House,Tom Cole,REP,690014,1,10,101,112,04
Stephens,Superintendent of Public Instruction,John Cox,DEM,690015,0,0,7,7,
Stephens,Superintendent of Public Instruction,Jack Jr.,DEM,690015,0,0,4,4,
Stephens,Superintendent of Public Instruction,Ivan Holmes,DEM,690015,0,0,3,3,
Stephens,Superintendent of Public Instruction,Freda Deskin,DEM,690015,0,0,4,4,
Stephens,U.S. Senate,Patrick Michael Hayes,DEM,690015,0,0,5,5,
Stephens,U.S. Senate,Jim Rogers,DEM,690015,0,0,7,7,
Stephens,U.S. Senate,Connie Johnson,DEM,690015,0,0,6,6,
Stephens,U.S. House,Bert Smith,DEM,690015,0,0,15,15,04
Stephens,U.S. House,Tae Si,DEM,690015,0,0,3,3,04
Stephens,Governor,Dax Ewbank,REP,690015,0,3,2,5,
Stephens,Governor,Chad Moody,REP,690015,0,0,9,9,
Stephens,Governor,Mary Fallin,REP,690015,0,0,19,19,
Stephens,Superintendent of Public Instruction,Brian Kelly,REP,690015,0,1,7,8,
Stephens,Superintendent of Public Instruction,Janet Costello Barresi,REP,690015,0,2,5,7,
Stephens,Superintendent of Public Instruction,Joy Hofmeister,REP,690015,0,0,18,18,
Stephens,Insurance Commissioner,Bill Viner,REP,690015,0,1,4,5,
Stephens,Insurance Commissioner,John Doak,REP,690015,0,2,22,24,
Stephens,Corporation Commissioner,Todd Hiett,REP,690015,0,0,15,15,
Stephens,Corporation Commissioner,Cliff Branan,REP,690015,0,3,12,15,
Stephens,U.S. Senate,Evelyn Rogers,REP,690015,0,0,2,2,
Stephens,U.S. Senate,Rob Moye,REP,690015,0,0,1,1,
Stephens,U.S. Senate,D. Jean Mcbride-Samuels,REP,690015,0,0,0,0,
Stephens,U.S. Senate,Jim Inhofe,REP,690015,0,2,27,29,
Stephens,U.S. Senate,Erick Paul Wyatt,REP,690015,0,1,0,1,
Stephens,U.S. Senate,Andy Craig,REP,690015,0,0,0,0,
Stephens,U.S. Senate,T. Shannon,REP,690015,0,0,20,20,
Stephens,U.S. Senate,Randy Brogdon,REP,690015,0,0,1,1,
Stephens,U.S. Senate,Eric Mccray,REP,690015,0,0,1,1,
Stephens,U.S. Senate,Kevin Crow,REP,690015,0,0,3,3,
Stephens,U.S. Senate,James Lankford,REP,690015,0,3,5,8,
Stephens,U.S. Senate,Jason Weger,REP,690015,0,0,0,0,
Stephens,U.S. House,Anna Flatt,REP,690015,0,1,4,5,04
Stephens,U.S. House,Tom Cole,REP,690015,0,2,25,27,04
Stephens,Superintendent of Public Instruction,John Cox,DEM,690016,1,3,54,58,
Stephens,Superintendent of Public Instruction,Jack Jr.,DEM,690016,2,0,46,48,
Stephens,Superintendent of Public Instruction,Ivan Holmes,DEM,690016,0,0,8,8,
Stephens,Superintendent of Public Instruction,Freda Deskin,DEM,690016,2,0,16,18,
Stephens,U.S. Senate,Patrick Michael Hayes,DEM,690016,1,1,30,32,
Stephens,U.S. Senate,Jim Rogers,DEM,690016,3,0,41,44,
Stephens,U.S. Senate,Connie Johnson,DEM,690016,1,2,50,53,
Stephens,U.S. House,Bert Smith,DEM,690016,3,1,103,107,04
Stephens,U.S. House,Tae Si,DEM,690016,1,0,20,21,04
Stephens,Governor,Dax Ewbank,REP,690016,0,1,23,24,
Stephens,Governor,Chad Moody,REP,690016,0,2,38,40,
Stephens,Governor,Mary Fallin,REP,690016,2,8,151,161,
Stephens,Superintendent of Public Instruction,Brian Kelly,REP,690016,1,4,45,50,
Stephens,Superintendent of Public Instruction,Janet Costello Barresi,REP,690016,1,0,60,61,
Stephens,Superintendent of Public Instruction,Joy Hofmeister,REP,690016,0,7,104,111,
Stephens,Insurance Commissioner,Bill Viner,REP,690016,0,2,54,56,
Stephens,Insurance Commissioner,John Doak,REP,690016,2,9,140,151,
Stephens,Corporation Commissioner,Todd Hiett,REP,690016,2,6,93,101,
Stephens,Corporation Commissioner,Cliff Branan,REP,690016,0,5,110,115,
Stephens,U.S. Senate,Evelyn Rogers,REP,690016,0,1,6,7,
Stephens,U.S. Senate,Rob Moye,REP,690016,0,0,6,6,
Stephens,U.S. Senate,D. Jean Mcbride-Samuels,REP,690016,0,1,3,4,
Stephens,U.S. Senate,Jim Inhofe,REP,690016,2,9,188,199,
Stephens,U.S. Senate,Erick Paul Wyatt,REP,690016,0,0,8,8,
Stephens,U.S. Senate,Andy Craig,REP,690016,0,0,1,1,
Stephens,U.S. Senate,T. Shannon,REP,690016,0,4,99,103,
Stephens,U.S. Senate,Randy Brogdon,REP,690016,0,0,4,4,
Stephens,U.S. Senate,Eric Mccray,REP,690016,0,1,1,2,
Stephens,U.S. Senate,Kevin Crow,REP,690016,0,0,5,5,
Stephens,U.S. Senate,James Lankford,REP,690016,2,6,103,111,
Stephens,U.S. Senate,Jason Weger,REP,690016,0,0,0,0,
Stephens,U.S. House,Anna Flatt,REP,690016,0,0,25,25,04
Stephens,U.S. House,Tom Cole,REP,690016,2,11,186,199,04
Stephens,Superintendent of Public Instruction,John Cox,DEM,690019,0,3,34,37,
Stephens,Superintendent of Public Instruction,Jack Jr.,DEM,690019,0,4,32,36,
Stephens,Superintendent of Public Instruction,Ivan Holmes,DEM,690019,0,0,8,8,
Stephens,Superintendent of Public Instruction,Freda Deskin,DEM,690019,0,0,45,45,
Stephens,U.S. Senate,Patrick Michael Hayes,DEM,690019,0,4,28,32,
Stephens,U.S. Senate,Jim Rogers,DEM,690019,0,0,46,46,
Stephens,U.S. Senate,Connie Johnson,DEM,690019,0,2,38,40,
Stephens,U.S. House,Bert Smith,DEM,690019,0,6,95,101,04
Stephens,U.S. House,Tae Si,DEM,690019,0,0,20,20,04
Stephens,Governor,Dax Ewbank,REP,690019,0,0,23,23,
Stephens,Governor,Chad Moody,REP,690019,2,4,35,41,
Stephens,Governor,Mary Fallin,REP,690019,10,13,180,203,
Stephens,Superintendent of Public Instruction,Brian Kelly,REP,690019,5,4,37,46,
Stephens,Superintendent of Public Instruction,Janet Costello Barresi,REP,690019,3,8,66,77,
Stephens,Superintendent of Public Instruction,Joy Hofmeister,REP,690019,3,5,132,140,
Stephens,Insurance Commissioner,Bill Viner,REP,690019,3,6,50,59,
Stephens,Insurance Commissioner,John Doak,REP,690019,8,11,166,185,
Stephens,Corporation Commissioner,Todd Hiett,REP,690019,2,9,114,125,
Stephens,Corporation Commissioner,Cliff Branan,REP,690019,8,8,97,113,
Stephens,U.S. Senate,Evelyn Rogers,REP,690019,1,0,8,9,
Stephens,U.S. Senate,Rob Moye,REP,690019,0,0,1,1,
Stephens,U.S. Senate,D. Jean Mcbride-Samuels,REP,690019,0,1,1,2,
Stephens,U.S. Senate,Jim Inhofe,REP,690019,11,16,223,250,
Stephens,U.S. Senate,Erick Paul Wyatt,REP,690019,0,0,6,6,
Stephens,U.S. Senate,Andy Craig,REP,690019,0,0,2,2,
Stephens,U.S. Senate,T. Shannon,REP,690019,4,7,106,117,
Stephens,U.S. Senate,Randy Brogdon,REP,690019,0,0,4,4,
Stephens,U.S. Senate,Eric Mccray,REP,690019,0,0,1,1,
Stephens,U.S. Senate,Kevin Crow,REP,690019,0,0,1,1,
Stephens,U.S. Senate,James Lankford,REP,690019,8,10,129,147,
Stephens,U.S. Senate,Jason Weger,REP,690019,0,0,1,1,
Stephens,U.S. House,Anna Flatt,REP,690019,0,2,29,31,04
Stephens,U.S. House,Tom Cole,REP,690019,12,15,213,240,04
Stephens,Superintendent of Public Instruction,John Cox,DEM,690032,1,1,36,38,
Stephens,Superintendent of Public Instruction,Jack Jr.,DEM,690032,0,1,34,35,
Stephens,Superintendent of Public Instruction,Ivan Holmes,DEM,690032,0,1,6,7,
Stephens,Superintendent of Public Instruction,Freda Deskin,DEM,690032,2,0,30,32,
Stephens,U.S. Senate,Patrick Michael Hayes,DEM,690032,0,0,31,31,
Stephens,U.S. Senate,Jim Rogers,DEM,690032,0,2,37,39,
Stephens,U.S. Senate,Connie Johnson,DEM,690032,3,1,30,34,
Stephens,U.S. House,Bert Smith,DEM,690032,2,3,85,90,04
Stephens,U.S. House,Tae Si,DEM,690032,1,0,9,10,04
Stephens,Governor,Dax Ewbank,REP,690032,0,1,7,8,
Stephens,Governor,Chad Moody,REP,690032,0,2,31,33,
Stephens,Governor,Mary Fallin,REP,690032,0,2,80,82,
Stephens,Superintendent of Public Instruction,Brian Kelly,REP,690032,0,0,24,24,
Stephens,Superintendent of Public Instruction,Janet Costello Barresi,REP,690032,0,1,24,25,
Stephens,Superintendent of Public Instruction,Joy Hofmeister,REP,690032,0,4,68,72,
Stephens,Insurance Commissioner,Bill Viner,REP,690032,0,4,27,31,
Stephens,Insurance Commissioner,John Doak,REP,690032,0,1,75,76,
Stephens,Corporation Commissioner,Todd Hiett,REP,690032,0,4,47,51,
Stephens,Corporation Commissioner,Cliff Branan,REP,690032,0,1,61,62,
Stephens,U.S. Senate,Evelyn Rogers,REP,690032,0,0,10,10,
Stephens,U.S. Senate,Rob Moye,REP,690032,0,0,1,1,
Stephens,U.S. Senate,D. Jean Mcbride-Samuels,REP,690032,0,0,2,2,
Stephens,U.S. Senate,Jim Inhofe,REP,690032,0,3,100,103,
Stephens,U.S. Senate,Erick Paul Wyatt,REP,690032,0,2,4,6,
Stephens,U.S. Senate,Andy Craig,REP,690032,0,0,3,3,
Stephens,U.S. Senate,T. Shannon,REP,690032,0,2,70,72,
Stephens,U.S. Senate,Randy Brogdon,REP,690032,0,0,3,3,
Stephens,U.S. Senate,Eric Mccray,REP,690032,0,0,0,0,
Stephens,U.S. Senate,Kevin Crow,REP,690032,0,0,0,0,
Stephens,U.S. Senate,James Lankford,REP,690032,0,3,41,44,
Stephens,U.S. Senate,Jason Weger,REP,690032,0,0,1,1,
Stephens,U.S. House,Anna Flatt,REP,690032,0,1,22,23,04
Stephens,U.S. House,Tom Cole,REP,690032,0,4,95,99,04
Stephens,Superintendent of Public Instruction,John Cox,DEM,690033,3,0,72,75,
Stephens,Superintendent of Public Instruction,Jack Jr.,DEM,690033,0,0,47,47,
Stephens,Superintendent of Public Instruction,Ivan Holmes,DEM,690033,0,1,5,6,
Stephens,Superintendent of Public Instruction,Freda Deskin,DEM,690033,0,1,25,26,
Stephens,U.S. Senate,Patrick Michael Hayes,DEM,690033,0,0,52,52,
Stephens,U.S. Senate,Jim Rogers,DEM,690033,2,1,63,66,
Stephens,U.S. Senate,Connie Johnson,DEM,690033,1,1,30,32,
Stephens,U.S. House,Bert Smith,DEM,690033,0,1,126,127,04
Stephens,U.S. House,Tae Si,DEM,690033,3,1,16,20,04
Stephens,Governor,Dax Ewbank,REP,690033,0,0,21,21,
Stephens,Governor,Chad Moody,REP,690033,0,1,50,51,
Stephens,Governor,Mary Fallin,REP,690033,4,2,98,104,
Stephens,Superintendent of Public Instruction,Brian Kelly,REP,690033,1,2,32,35,
Stephens,Superintendent of Public Instruction,Janet Costello Barresi,REP,690033,0,0,27,27,
Stephens,Superintendent of Public Instruction,Joy Hofmeister,REP,690033,3,0,106,109,
Stephens,Insurance Commissioner,Bill Viner,REP,690033,1,1,39,41,
Stephens,Insurance Commissioner,John Doak,REP,690033,2,1,118,121,
Stephens,Corporation Commissioner,Todd Hiett,REP,690033,1,1,78,80,
Stephens,Corporation Commissioner,Cliff Branan,REP,690033,2,1,80,83,
Stephens,U.S. Senate,Evelyn Rogers,REP,690033,0,0,0,0,
Stephens,U.S. Senate,Rob Moye,REP,690033,0,0,1,1,
Stephens,U.S. Senate,D. Jean Mcbride-Samuels,REP,690033,0,0,6,6,
Stephens,U.S. Senate,Jim Inhofe,REP,690033,3,4,149,156,
Stephens,U.S. Senate,Erick Paul Wyatt,REP,690033,1,0,12,13,
Stephens,U.S. Senate,Andy Craig,REP,690033,0,0,3,3,
Stephens,U.S. Senate,T. Shannon,REP,690033,1,4,77,82,
Stephens,U.S. Senate,Randy Brogdon,REP,690033,0,0,3,3,
Stephens,U.S. Senate,Eric Mccray,REP,690033,0,0,0,0,
Stephens,U.S. Senate,Kevin Crow,REP,690033,0,0,3,3,
Stephens,U.S. Senate,James Lankford,REP,690033,2,0,82,84,
Stephens,U.S. Senate,Jason Weger,REP,690033,0,0,0,0,
Stephens,U.S. House,Anna Flatt,REP,690033,1,1,17,19,04
Stephens,U.S. House,Tom Cole,REP,690033,3,3,152,158,04
Stephens,Superintendent of Public Instruction,John Cox,DEM,690041,0,0,41,41,
Stephens,Superintendent of Public Instruction,Jack Jr.,DEM,690041,0,1,22,23,
Stephens,Superintendent of Public Instruction,Ivan Holmes,DEM,690041,0,0,6,6,
Stephens,Superintendent of Public Instruction,Freda Deskin,DEM,690041,0,0,19,19,
Stephens,U.S. Senate,Patrick Michael Hayes,DEM,690041,0,0,19,19,
Stephens,U.S. Senate,Jim Rogers,DEM,690041,0,1,40,41,
Stephens,U.S. Senate,Connie Johnson,DEM,690041,0,0,28,28,
Stephens,U.S. House,Bert Smith,DEM,690041,0,1,74,75,04
Stephens,U.S. House,Tae Si,DEM,690041,0,0,11,11,04
Stephens,Governor,Dax Ewbank,REP,690041,0,2,14,16,
Stephens,Governor,Chad Moody,REP,690041,0,2,31,33,
Stephens,Governor,Mary Fallin,REP,690041,0,3,69,72,
Stephens,Superintendent of Public Instruction,Brian Kelly,REP,690041,0,0,11,11,
Stephens,Superintendent of Public Instruction,Janet Costello Barresi,REP,690041,0,0,22,22,
Stephens,Superintendent of Public Instruction,Joy Hofmeister,REP,690041,0,7,80,87,
Stephens,Insurance Commissioner,Bill Viner,REP,690041,0,0,28,28,
Stephens,Insurance Commissioner,John Doak,REP,690041,0,6,78,84,
Stephens,Corporation Commissioner,Todd Hiett,REP,690041,0,1,55,56,
Stephens,Corporation Commissioner,Cliff Branan,REP,690041,0,5,54,59,
Stephens,U.S. Senate,Evelyn Rogers,REP,690041,0,2,4,6,
Stephens,U.S. Senate,Rob Moye,REP,690041,0,0,1,1,
Stephens,U.S. Senate,D. Jean Mcbride-Samuels,REP,690041,0,0,0,0,
Stephens,U.S. Senate,Jim Inhofe,REP,690041,0,5,101,106,
Stephens,U.S. Senate,Erick Paul Wyatt,REP,690041,0,0,9,9,
Stephens,U.S. Senate,Andy Craig,REP,690041,0,0,0,0,
Stephens,U.S. Senate,T. Shannon,REP,690041,0,3,61,64,
Stephens,U.S. Senate,Randy Brogdon,REP,690041,0,0,2,2,
Stephens,U.S. Senate,Eric Mccray,REP,690041,0,0,1,1,
Stephens,U.S. Senate,Kevin Crow,REP,690041,0,0,2,2,
Stephens,U.S. Senate,James Lankford,REP,690041,0,3,46,49,
Stephens,U.S. Senate,Jason Weger,REP,690041,0,0,2,2,
Stephens,U.S. House,Anna Flatt,REP,690041,0,0,9,9,04
Stephens,U.S. House,Tom Cole,REP,690041,0,7,104,111,04
Stephens,Superintendent of Public Instruction,John Cox,DEM,690049,0,0,5,5,
Stephens,Superintendent of Public Instruction,Jack Jr.,DEM,690049,0,0,7,7,
Stephens,Superintendent of Public Instruction,Ivan Holmes,DEM,690049,0,0,2,2,
Stephens,Superintendent of Public Instruction,Freda Deskin,DEM,690049,0,0,3,3,
Stephens,U.S. Senate,Patrick Michael Hayes,DEM,690049,0,0,6,6,
Stephens,U.S. Senate,Jim Rogers,DEM,690049,0,0,4,4,
Stephens,U.S. Senate,Connie Johnson,DEM,690049,0,0,6,6,
Stephens,U.S. House,Bert Smith,DEM,690049,0,0,14,14,04
Stephens,U.S. House,Tae Si,DEM,690049,0,0,3,3,04
Stephens,Governor,Dax Ewbank,REP,690049,0,0,0,0,
Stephens,Governor,Chad Moody,REP,690049,0,0,8,8,
Stephens,Governor,Mary Fallin,REP,690049,0,1,12,13,
Stephens,Superintendent of Public Instruction,Brian Kelly,REP,690049,0,0,4,4,
Stephens,Superintendent of Public Instruction,Janet Costello Barresi,REP,690049,0,0,5,5,
Stephens,Superintendent of Public Instruction,Joy Hofmeister,REP,690049,0,0,11,11,
Stephens,Insurance Commissioner,Bill Viner,REP,690049,0,0,5,5,
Stephens,Insurance Commissioner,John Doak,REP,690049,0,0,15,15,
Stephens,Corporation Commissioner,Todd Hiett,REP,690049,0,0,7,7,
Stephens,Corporation Commissioner,Cliff Branan,REP,690049,0,0,12,12,
Stephens,U.S. Senate,Evelyn Rogers,REP,690049,0,0,0,0,
Stephens,U.S. Senate,Rob Moye,REP,690049,0,0,0,0,
Stephens,U.S. Senate,D. Jean Mcbride-Samuels,REP,690049,0,0,0,0,
Stephens,U.S. Senate,Jim Inhofe,REP,690049,0,1,19,20,
Stephens,U.S. Senate,Erick Paul Wyatt,REP,690049,0,0,1,1,
Stephens,U.S. Senate,Andy Craig,REP,690049,0,0,0,0,
Stephens,U.S. Senate,T. Shannon,REP,690049,0,0,13,13,
Stephens,U.S. Senate,Randy Brogdon,REP,690049,0,0,0,0,
Stephens,U.S. Senate,Eric Mccray,REP,690049,0,1,0,1,
Stephens,U.S. Senate,Kevin Crow,REP,690049,0,0,0,0,
Stephens,U.S. Senate,James Lankford,REP,690049,0,0,7,7,
Stephens,U.S. Senate,Jason Weger,REP,690049,0,0,0,0,
Stephens,U.S. House,Anna Flatt,REP,690049,0,0,4,4,04
Stephens,U.S. House,Tom Cole,REP,690049,0,1,16,17,04
Stephens,Superintendent of Public Instruction,John Cox,DEM,690050,0,4,35,39,
Stephens,Superintendent of Public Instruction,Jack Jr.,DEM,690050,0,2,32,34,
Stephens,Superintendent of Public Instruction,Ivan Holmes,DEM,690050,0,0,4,4,
Stephens,Superintendent of Public Instruction,Freda Deskin,DEM,690050,2,1,29,32,
Stephens,U.S. Senate,Patrick Michael Hayes,DEM,690050,1,3,21,25,
Stephens,U.S. Senate,Jim Rogers,DEM,690050,0,1,42,43,
Stephens,U.S. Senate,Connie Johnson,DEM,690050,1,2,34,37,
Stephens,U.S. House,Bert Smith,DEM,690050,2,4,82,88,04
Stephens,U.S. House,Tae Si,DEM,690050,0,2,16,18,04
Stephens,Governor,Dax Ewbank,REP,690050,0,1,8,9,
Stephens,Governor,Chad Moody,REP,690050,0,4,27,31,
Stephens,Governor,Mary Fallin,REP,690050,0,9,136,145,
Stephens,Superintendent of Public Instruction,Brian Kelly,REP,690050,0,4,27,31,
Stephens,Superintendent of Public Instruction,Janet Costello Barresi,REP,690050,0,8,56,64,
Stephens,Superintendent of Public Instruction,Joy Hofmeister,REP,690050,0,2,86,88,
Stephens,Insurance Commissioner,Bill Viner,REP,690050,0,7,38,45,
Stephens,Insurance Commissioner,John Doak,REP,690050,0,6,117,123,
Stephens,Corporation Commissioner,Todd Hiett,REP,690050,0,4,81,85,
Stephens,Corporation Commissioner,Cliff Branan,REP,690050,0,9,77,86,
Stephens,U.S. Senate,Evelyn Rogers,REP,690050,0,2,4,6,
Stephens,U.S. Senate,Rob Moye,REP,690050,0,0,1,1,
Stephens,U.S. Senate,D. Jean Mcbride-Samuels,REP,690050,0,0,1,1,
Stephens,U.S. Senate,Jim Inhofe,REP,690050,0,11,157,168,
Stephens,U.S. Senate,Erick Paul Wyatt,REP,690050,0,1,6,7,
Stephens,U.S. Senate,Andy Craig,REP,690050,0,1,1,2,
Stephens,U.S. Senate,T. Shannon,REP,690050,0,5,105,110,
Stephens,U.S. Senate,Randy Brogdon,REP,690050,0,1,6,7,
Stephens,U.S. Senate,Eric Mccray,REP,690050,0,0,0,0,
Stephens,U.S. Senate,Kevin Crow,REP,690050,0,0,1,1,
Stephens,U.S. Senate,James Lankford,REP,690050,0,7,58,65,
Stephens,U.S. Senate,Jason Weger,REP,690050,0,0,0,0,
Stephens,U.S. House,Anna Flatt,REP,690050,0,4,20,24,04
Stephens,U.S. House,Tom Cole,REP,690050,0,10,148,158,04
Stephens,Superintendent of Public Instruction,John Cox,DEM,690051,0,0,24,24,
Stephens,Superintendent of Public Instruction,Jack Jr.,DEM,690051,0,0,8,8,
Stephens,Superintendent of Public Instruction,Ivan Holmes,DEM,690051,0,0,4,4,
Stephens,Superintendent of Public Instruction,Freda Deskin,DEM,690051,0,0,8,8,
Stephens,U.S. Senate,Patrick Michael Hayes,DEM,690051,0,0,14,14,
Stephens,U.S. Senate,Jim Rogers,DEM,690051,0,0,15,15,
Stephens,U.S. Senate,Connie Johnson,DEM,690051,0,0,15,15,
Stephens,U.S. House,Bert Smith,DEM,690051,0,0,41,41,04
Stephens,U.S. House,Tae Si,DEM,690051,0,0,3,3,04
Stephens,Governor,Dax Ewbank,REP,690051,0,0,8,8,
Stephens,Governor,Chad Moody,REP,690051,0,0,10,10,
Stephens,Governor,Mary Fallin,REP,690051,0,0,49,49,
Stephens,Superintendent of Public Instruction,Brian Kelly,REP,690051,0,0,6,6,
Stephens,Superintendent of Public Instruction,Janet Costello Barresi,REP,690051,0,0,12,12,
Stephens,Superintendent of Public Instruction,Joy Hofmeister,REP,690051,0,0,49,49,
Stephens,Insurance Commissioner,Bill Viner,REP,690051,0,0,11,11,
Stephens,Insurance Commissioner,John Doak,REP,690051,0,0,51,51,
Stephens,Corporation Commissioner,Todd Hiett,REP,690051,0,0,37,37,
Stephens,Corporation Commissioner,Cliff Branan,REP,690051,0,0,27,27,
Stephens,U.S. Senate,Evelyn Rogers,REP,690051,0,0,3,3,
Stephens,U.S. Senate,Rob Moye,REP,690051,0,0,2,2,
Stephens,U.S. Senate,D. Jean Mcbride-Samuels,REP,690051,0,0,3,3,
Stephens,U.S. Senate,Jim Inhofe,REP,690051,0,0,57,57,
Stephens,U.S. Senate,Erick Paul Wyatt,REP,690051,0,0,4,4,
Stephens,U.S. Senate,Andy Craig,REP,690051,0,0,0,0,
Stephens,U.S. Senate,T. Shannon,REP,690051,0,0,44,44,
Stephens,U.S. Senate,Randy Brogdon,REP,690051,0,0,1,1,
Stephens,U.S. Senate,Eric Mccray,REP,690051,0,0,1,1,
Stephens,U.S. Senate,Kevin Crow,REP,690051,0,0,1,1,
Stephens,U.S. Senate,James Lankford,REP,690051,0,0,23,23,
Stephens,U.S. Senate,Jason Weger,REP,690051,0,0,0,0,
Stephens,U.S. House,Anna Flatt,REP,690051,0,0,10,10,04
Stephens,U.S. House,Tom Cole,REP,690051,0,0,59,59,04
Stephens,State House,Renae Sexton,REP,690051,0,0,29,29,65
Stephens,State House,Scott Hayes,REP,690051,0,0,12,12,65
Stephens,State House,Scooter Park,REP,690051,0,0,9,9,65
Stephens,State House,Stephen Mills,REP,690051,0,0,17,17,65
Stephens,Superintendent of Public Instruction,John Cox,DEM,690052,0,1,6,7,
Stephens,Superintendent of Public Instruction,Jack Jr.,DEM,690052,1,1,0,2,
Stephens,Superintendent of Public Instruction,Ivan Holmes,DEM,690052,0,0,0,0,
Stephens,Superintendent of Public Instruction,Freda Deskin,DEM,690052,0,0,2,2,
Stephens,U.S. Senate,Patrick Michael Hayes,DEM,690052,0,0,0,0,
Stephens,U.S. Senate,Jim Rogers,DEM,690052,1,0,4,5,
Stephens,U.S. Senate,Connie Johnson,DEM,690052,0,2,4,6,
Stephens,U.S. House,Bert Smith,DEM,690052,1,2,7,10,04
Stephens,U.S. House,Tae Si,DEM,690052,0,0,1,1,04
Stephens,Governor,Dax Ewbank,REP,690052,0,0,1,1,
Stephens,Governor,Chad Moody,REP,690052,1,0,3,4,
Stephens,Governor,Mary Fallin,REP,690052,0,10,16,26,
Stephens,Superintendent of Public Instruction,Brian Kelly,REP,690052,0,1,6,7,
Stephens,Superintendent of Public Instruction,Janet Costello Barresi,REP,690052,0,1,3,4,
Stephens,Superintendent of Public Instruction,Joy Hofmeister,REP,690052,1,7,9,17,
Stephens,Insurance Commissioner,Bill Viner,REP,690052,0,0,7,7,
Stephens,Insurance Commissioner,John Doak,REP,690052,1,9,11,21,
Stephens,Corporation Commissioner,Todd Hiett,REP,690052,0,5,7,12,
Stephens,Corporation Commissioner,Cliff Branan,REP,690052,1,4,11,16,
Stephens,U.S. Senate,Evelyn Rogers,REP,690052,0,0,0,0,
Stephens,U.S. Senate,Rob Moye,REP,690052,0,0,1,1,
Stephens,U.S. Senate,D. Jean Mcbride-Samuels,REP,690052,1,0,0,1,
Stephens,U.S. Senate,Jim Inhofe,REP,690052,0,10,18,28,
Stephens,U.S. Senate,Erick Paul Wyatt,REP,690052,0,0,0,0,
Stephens,U.S. Senate,Andy Craig,REP,690052,0,0,0,0,
Stephens,U.S. Senate,T. Shannon,REP,690052,1,3,10,14,
Stephens,U.S. Senate,Randy Brogdon,REP,690052,0,0,0,0,
Stephens,U.S. Senate,Eric Mccray,REP,690052,0,0,0,0,
Stephens,U.S. Senate,Kevin Crow,REP,690052,0,0,0,0,
Stephens,U.S. Senate,James Lankford,REP,690052,0,7,10,17,
Stephens,U.S. Senate,Jason Weger,REP,690052,0,0,0,0,
Stephens,U.S. House,Anna Flatt,REP,690052,0,0,3,3,04
Stephens,U.S. House,Tom Cole,REP,690052,1,10,17,28,04
Stephens,Superintendent of Public Instruction,John Cox,DEM,690053,0,0,5,5,
Stephens,Superintendent of Public Instruction,Jack Jr.,DEM,690053,0,0,8,8,
Stephens,Superintendent of Public Instruction,Ivan Holmes,DEM,690053,0,0,0,0,
Stephens,Superintendent of Public Instruction,Freda Deskin,DEM,690053,0,0,5,5,
Stephens,U.S. Senate,Patrick Michael Hayes,DEM,690053,0,0,6,6,
Stephens,U.S. Senate,Jim Rogers,DEM,690053,0,0,6,6,
Stephens,U.S. Senate,Connie Johnson,DEM,690053,0,0,5,5,
Stephens,U.S. House,Bert Smith,DEM,690053,0,0,15,15,04
Stephens,U.S. House,Tae Si,DEM,690053,0,0,0,0,04
Stephens,Governor,Dax Ewbank,REP,690053,0,1,2,3,
Stephens,Governor,Chad Moody,REP,690053,0,0,2,2,
Stephens,Governor,Mary Fallin,REP,690053,0,0,13,13,
Stephens,Superintendent of Public Instruction,Brian Kelly,REP,690053,0,1,3,4,
Stephens,Superintendent of Public Instruction,Janet Costello Barresi,REP,690053,0,0,2,2,
Stephens,Superintendent of Public Instruction,Joy Hofmeister,REP,690053,0,1,11,12,
Stephens,Insurance Commissioner,Bill Viner,REP,690053,0,1,5,6,
Stephens,Insurance Commissioner,John Doak,REP,690053,0,1,10,11,
Stephens,Corporation Commissioner,Todd Hiett,REP,690053,0,1,9,10,
Stephens,Corporation Commissioner,Cliff Branan,REP,690053,0,0,7,7,
Stephens,U.S. Senate,Evelyn Rogers,REP,690053,0,0,0,0,
Stephens,U.S. Senate,Rob Moye,REP,690053,0,0,0,0,
Stephens,U.S. Senate,D. Jean Mcbride-Samuels,REP,690053,0,0,0,0,
Stephens,U.S. Senate,Jim Inhofe,REP,690053,0,2,15,17,
Stephens,U.S. Senate,Erick Paul Wyatt,REP,690053,0,0,2,2,
Stephens,U.S. Senate,Andy Craig,REP,690053,0,1,0,1,
Stephens,U.S. Senate,T. Shannon,REP,690053,0,0,11,11,
Stephens,U.S. Senate,Randy Brogdon,REP,690053,0,0,0,0,
Stephens,U.S. Senate,Eric Mccray,REP,690053,0,0,1,1,
Stephens,U.S. Senate,Kevin Crow,REP,690053,0,0,0,0,
Stephens,U.S. Senate,James Lankford,REP,690053,0,1,4,5,
Stephens,U.S. Senate,Jason Weger,REP,690053,0,0,1,1,
Stephens,U.S. House,Anna Flatt,REP,690053,0,0,4,4,04
Stephens,U.S. House,Tom Cole,REP,690053,0,2,13,15,04
Stephens,Superintendent of Public Instruction,John Cox,DEM,690054,0,0,16,16,
Stephens,Superintendent of Public Instruction,Jack Jr.,DEM,690054,0,0,7,7,
Stephens,Superintendent of Public Instruction,Ivan Holmes,DEM,690054,0,0,2,2,
Stephens,Superintendent of Public Instruction,Freda Deskin,DEM,690054,0,0,14,14,
Stephens,U.S. Senate,Patrick Michael Hayes,DEM,690054,0,0,11,11,
Stephens,U.S. Senate,Jim Rogers,DEM,690054,0,0,16,16,
Stephens,U.S. Senate,Connie Johnson,DEM,690054,0,0,12,12,
Stephens,U.S. House,Bert Smith,DEM,690054,0,0,32,32,04
Stephens,U.S. House,Tae Si,DEM,690054,0,0,4,4,04
Stephens,Governor,Dax Ewbank,REP,690054,0,0,4,4,
Stephens,Governor,Chad Moody,REP,690054,0,0,3,3,
Stephens,Governor,Mary Fallin,REP,690054,0,0,24,24,
Stephens,Superintendent of Public Instruction,Brian Kelly,REP,690054,0,0,4,4,
Stephens,Superintendent of Public Instruction,Janet Costello Barresi,REP,690054,0,0,8,8,
Stephens,Superintendent of Public Instruction,Joy Hofmeister,REP,690054,0,0,17,17,
Stephens,Insurance Commissioner,Bill Viner,REP,690054,0,0,4,4,
Stephens,Insurance Commissioner,John Doak,REP,690054,0,0,25,25,
Stephens,Corporation Commissioner,Todd Hiett,REP,690054,0,0,20,20,
Stephens,Corporation Commissioner,Cliff Branan,REP,690054,0,0,9,9,
Stephens,U.S. Senate,Evelyn Rogers,REP,690054,0,0,0,0,
Stephens,U.S. Senate,Rob Moye,REP,690054,0,0,0,0,
Stephens,U.S. Senate,D. Jean Mcbride-Samuels,REP,690054,0,0,0,0,
Stephens,U.S. Senate,Jim Inhofe,REP,690054,0,0,27,27,
Stephens,U.S. Senate,Erick Paul Wyatt,REP,690054,0,0,3,3,
Stephens,U.S. Senate,Andy Craig,REP,690054,0,0,0,0,
Stephens,U.S. Senate,T. Shannon,REP,690054,0,0,20,20,
Stephens,U.S. Senate,Randy Brogdon,REP,690054,0,0,3,3,
Stephens,U.S. Senate,Eric Mccray,REP,690054,0,0,0,0,
Stephens,U.S. Senate,Kevin Crow,REP,690054,0,0,0,0,
Stephens,U.S. Senate,James Lankford,REP,690054,0,0,8,8,
Stephens,U.S. Senate,Jason Weger,REP,690054,0,0,0,0,
Stephens,U.S. House,Anna Flatt,REP,690054,0,0,3,3,04
Stephens,U.S. House,Tom Cole,REP,690054,0,0,28,28,04
Stephens,Superintendent of Public Instruction,John Cox,DEM,690055,0,0,14,14,
Stephens,Superintendent of Public Instruction,Jack Jr.,DEM,690055,0,0,5,5,
Stephens,Superintendent of Public Instruction,Ivan Holmes,DEM,690055,0,0,3,3,
Stephens,Superintendent of Public Instruction,Freda Deskin,DEM,690055,0,0,12,12,
Stephens,U.S. Senate,Patrick Michael Hayes,DEM,690055,0,0,8,8,
Stephens,U.S. Senate,Jim Rogers,DEM,690055,0,0,11,11,
Stephens,U.S. Senate,Connie Johnson,DEM,690055,0,0,15,15,
Stephens,U.S. House,Bert Smith,DEM,690055,0,0,28,28,04
Stephens,U.S. House,Tae Si,DEM,690055,0,0,3,3,04
Stephens,Governor,Dax Ewbank,REP,690055,0,0,0,0,
Stephens,Governor,Chad Moody,REP,690055,0,0,8,8,
Stephens,Governor,Mary Fallin,REP,690055,1,0,34,35,
Stephens,Superintendent of Public Instruction,Brian Kelly,REP,690055,0,0,10,10,
Stephens,Superintendent of Public Instruction,Janet Costello Barresi,REP,690055,0,0,14,14,
Stephens,Superintendent of Public Instruction,Joy Hofmeister,REP,690055,1,0,18,19,
Stephens,Insurance Commissioner,Bill Viner,REP,690055,0,0,12,12,
Stephens,Insurance Commissioner,John Doak,REP,690055,1,0,26,27,
Stephens,Corporation Commissioner,Todd Hiett,REP,690055,1,0,24,25,
Stephens,Corporation Commissioner,Cliff Branan,REP,690055,0,0,15,15,
Stephens,U.S. Senate,Evelyn Rogers,REP,690055,0,0,3,3,
Stephens,U.S. Senate,Rob Moye,REP,690055,0,0,0,0,
Stephens,U.S. Senate,D. Jean Mcbride-Samuels,REP,690055,0,0,0,0,
Stephens,U.S. Senate,Jim Inhofe,REP,690055,1,0,36,37,
Stephens,U.S. Senate,Erick Paul Wyatt,REP,690055,0,0,2,2,
Stephens,U.S. Senate,Andy Craig,REP,690055,0,0,0,0,
Stephens,U.S. Senate,T. Shannon,REP,690055,0,0,23,23,
Stephens,U.S. Senate,Randy Brogdon,REP,690055,0,0,1,1,
Stephens,U.S. Senate,Eric Mccray,REP,690055,0,0,0,0,
Stephens,U.S. Senate,Kevin Crow,REP,690055,0,0,0,0,
Stephens,U.S. Senate,James Lankford,REP,690055,1,0,17,18,
Stephens,U.S. Senate,Jason Weger,REP,690055,0,0,1,1,
Stephens,U.S. House,Anna Flatt,REP,690055,0,0,5,5,04
Stephens,U.S. House,Tom Cole,REP,690055,1,0,37,38,04
Stephens,Superintendent of Public Instruction,John Cox,DEM,690056,0,0,22,22,
Stephens,Superintendent of Public Instruction,Jack Jr.,DEM,690056,0,0,9,9,
Stephens,Superintendent of Public Instruction,Ivan Holmes,DEM,690056,0,0,1,1,
Stephens,Superintendent of Public Instruction,Freda Deskin,DEM,690056,0,0,4,4,
Stephens,U.S. Senate,Patrick Michael Hayes,DEM,690056,0,0,9,9,
Stephens,U.S. Senate,Jim Rogers,DEM,690056,0,0,10,10,
Stephens,U.S. Senate,Connie Johnson,DEM,690056,0,0,15,15,
Stephens,U.S. House,Bert Smith,DEM,690056,0,0,30,30,04
Stephens,U.S. House,Tae Si,DEM,690056,0,0,5,5,04
Stephens,Governor,Dax Ewbank,REP,690056,0,0,0,0,
Stephens,Governor,Chad Moody,REP,690056,0,0,2,2,
Stephens,Governor,Mary Fallin,REP,690056,0,1,29,30,
Stephens,Superintendent of Public Instruction,Brian Kelly,REP,690056,0,0,10,10,
Stephens,Superintendent of Public Instruction,Janet Costello Barresi,REP,690056,0,1,7,8,
Stephens,Superintendent of Public Instruction,Joy Hofmeister,REP,690056,0,0,14,14,
Stephens,Insurance Commissioner,Bill Viner,REP,690056,0,1,3,4,
Stephens,Insurance Commissioner,John Doak,REP,690056,0,0,23,23,
Stephens,Corporation Commissioner,Todd Hiett,REP,690056,0,1,19,20,
Stephens,Corporation Commissioner,Cliff Branan,REP,690056,0,0,8,8,
Stephens,U.S. Senate,Evelyn Rogers,REP,690056,0,0,0,0,
Stephens,U.S. Senate,Rob Moye,REP,690056,0,0,0,0,
Stephens,U.S. Senate,D. Jean Mcbride-Samuels,REP,690056,0,0,0,0,
Stephens,U.S. Senate,Jim Inhofe,REP,690056,0,1,31,32,
Stephens,U.S. Senate,Erick Paul Wyatt,REP,690056,0,0,0,0,
Stephens,U.S. Senate,Andy Craig,REP,690056,0,0,1,1,
Stephens,U.S. Senate,T. Shannon,REP,690056,0,0,17,17,
Stephens,U.S. Senate,Randy Brogdon,REP,690056,0,0,2,2,
Stephens,U.S. Senate,Eric Mccray,REP,690056,0,0,0,0,
Stephens,U.S. Senate,Kevin Crow,REP,690056,0,0,0,0,
Stephens,U.S. Senate,James Lankford,REP,690056,0,1,12,13,
Stephens,U.S. Senate,Jason Weger,REP,690056,0,0,0,0,
Stephens,U.S. House,Anna Flatt,REP,690056,0,0,0,0,04
Stephens,U.S. House,Tom Cole,REP,690056,0,1,31,32,04
Stephens,Superintendent of Public Instruction,John Cox,DEM,690057,0,4,8,12,
Stephens,Superintendent of Public Instruction,Jack Jr.,DEM,690057,0,0,19,19,
Stephens,Superintendent of Public Instruction,Ivan Holmes,DEM,690057,0,0,3,3,
Stephens,Superintendent of Public Instruction,Freda Deskin,DEM,690057,0,0,9,9,
Stephens,U.S. Senate,Patrick Michael Hayes,DEM,690057,0,2,10,12,
Stephens,U.S. Senate,Jim Rogers,DEM,690057,0,0,15,15,
Stephens,U.S. Senate,Connie Johnson,DEM,690057,0,0,15,15,
Stephens,U.S. House,Bert Smith,DEM,690057,0,2,33,35,04
Stephens,U.S. House,Tae Si,DEM,690057,0,0,3,3,04
Stephens,Governor,Dax Ewbank,REP,690057,0,0,13,13,
Stephens,Governor,Chad Moody,REP,690057,0,1,12,13,
Stephens,Governor,Mary Fallin,REP,690057,2,5,61,68,
Stephens,Superintendent of Public Instruction,Brian Kelly,REP,690057,0,0,20,20,
Stephens,Superintendent of Public Instruction,Janet Costello Barresi,REP,690057,0,1,21,22,
Stephens,Superintendent of Public Instruction,Joy Hofmeister,REP,690057,2,5,43,50,
Stephens,Insurance Commissioner,Bill Viner,REP,690057,0,1,20,21,
Stephens,Insurance Commissioner,John Doak,REP,690057,2,5,52,59,
Stephens,Corporation Commissioner,Todd Hiett,REP,690057,0,2,37,39,
Stephens,Corporation Commissioner,Cliff Branan,REP,690057,2,4,36,42,
Stephens,U.S. Senate,Evelyn Rogers,REP,690057,0,0,6,6,
Stephens,U.S. Senate,Rob Moye,REP,690057,0,0,1,1,
Stephens,U.S. Senate,D. Jean Mcbride-Samuels,REP,690057,0,0,1,1,
Stephens,U.S. Senate,Jim Inhofe,REP,690057,2,6,71,79,
Stephens,U.S. Senate,Erick Paul Wyatt,REP,690057,0,0,6,6,
Stephens,U.S. Senate,Andy Craig,REP,690057,0,0,0,0,
Stephens,U.S. Senate,T. Shannon,REP,690057,0,4,38,42,
Stephens,U.S. Senate,Randy Brogdon,REP,690057,0,0,3,3,
Stephens,U.S. Senate,Eric Mccray,REP,690057,0,0,0,0,
Stephens,U.S. Senate,Kevin Crow,REP,690057,0,1,1,2,
Stephens,U.S. Senate,James Lankford,REP,690057,2,1,44,47,
Stephens,U.S. Senate,Jason Weger,REP,690057,0,0,2,2,
Stephens,U.S. House,Anna Flatt,REP,690057,0,1,15,16,04
Stephens,U.S. House,Tom Cole,REP,690057,2,5,69,76,04
Stephens,Superintendent of Public Instruction,John Cox,DEM,690058,0,1,28,29,
Stephens,Superintendent of Public Instruction,Jack Jr.,DEM,690058,0,1,13,14,
Stephens,Superintendent of Public Instruction,Ivan Holmes,DEM,690058,0,0,4,4,
Stephens,Superintendent of Public Instruction,Freda Deskin,DEM,690058,0,0,6,6,
Stephens,U.S. Senate,Patrick Michael Hayes,DEM,690058,0,1,16,17,
Stephens,U.S. Senate,Jim Rogers,DEM,690058,0,0,18,18,
Stephens,U.S. Senate,Connie Johnson,DEM,690058,0,1,19,20,
Stephens,U.S. House,Bert Smith,DEM,690058,0,2,49,51,04
Stephens,U.S. House,Tae Si,DEM,690058,0,0,3,3,04
Stephens,Governor,Dax Ewbank,REP,690058,0,0,0,0,
Stephens,Governor,Chad Moody,REP,690058,0,0,5,5,
Stephens,Governor,Mary Fallin,REP,690058,0,0,33,33,
Stephens,Superintendent of Public Instruction,Brian Kelly,REP,690058,0,0,9,9,
Stephens,Superintendent of Public Instruction,Janet Costello Barresi,REP,690058,0,0,4,4,
Stephens,Superintendent of Public Instruction,Joy Hofmeister,REP,690058,0,0,27,27,
Stephens,Insurance Commissioner,Bill Viner,REP,690058,0,0,10,10,
Stephens,Insurance Commissioner,John Doak,REP,690058,0,0,28,28,
Stephens,Corporation Commissioner,Todd Hiett,REP,690058,0,0,24,24,
Stephens,Corporation Commissioner,Cliff Branan,REP,690058,0,0,14,14,
Stephens,U.S. Senate,Evelyn Rogers,REP,690058,0,0,0,0,
Stephens,U.S. Senate,Rob Moye,REP,690058,0,0,1,1,
Stephens,U.S. Senate,D. Jean Mcbride-Samuels,REP,690058,0,0,0,0,
Stephens,U.S. Senate,Jim Inhofe,REP,690058,0,0,37,37,
Stephens,U.S. Senate,Erick Paul Wyatt,REP,690058,0,0,2,2,
Stephens,U.S. Senate,Andy Craig,REP,690058,0,0,1,1,
Stephens,U.S. Senate,T. Shannon,REP,690058,0,0,21,21,
Stephens,U.S. Senate,Randy Brogdon,REP,690058,0,0,0,0,
Stephens,U.S. Senate,Eric Mccray,REP,690058,0,0,0,0,
Stephens,U.S. Senate,Kevin Crow,REP,690058,0,0,0,0,
Stephens,U.S. Senate,James Lankford,REP,690058,0,0,17,17,
Stephens,U.S. Senate,Jason Weger,REP,690058,0,0,1,1,
Stephens,U.S. House,Anna Flatt,REP,690058,0,0,2,2,04
Stephens,U.S. House,Tom Cole,REP,690058,0,0,37,37,04
Stephens,Superintendent of Public Instruction,John Cox,DEM,690059,0,0,8,8,
Stephens,Superintendent of Public Instruction,Jack Jr.,DEM,690059,0,0,7,7,
Stephens,Superintendent of Public Instruction,Ivan Holmes,DEM,690059,0,0,3,3,
Stephens,Superintendent of Public Instruction,Freda Deskin,DEM,690059,0,0,8,8,
Stephens,U.S. Senate,Patrick Michael Hayes,DEM,690059,0,0,5,5,
Stephens,U.S. Senate,Jim Rogers,DEM,690059,0,0,10,10,
Stephens,U.S. Senate,Connie Johnson,DEM,690059,0,0,12,12,
Stephens,U.S. House,Bert Smith,DEM,690059,0,0,25,25,04
Stephens,U.S. House,Tae Si,DEM,690059,0,0,3,3,04
Stephens,Governor,Dax Ewbank,REP,690059,0,0,4,4,
Stephens,Governor,Chad Moody,REP,690059,0,1,1,2,
Stephens,Governor,Mary Fallin,REP,690059,0,0,13,13,
Stephens,Superintendent of Public Instruction,Brian Kelly,REP,690059,0,0,3,3,
Stephens,Superintendent of Public Instruction,Janet Costello Barresi,REP,690059,0,0,3,3,
Stephens,Superintendent of Public Instruction,Joy Hofmeister,REP,690059,0,1,12,13,
Stephens,Insurance Commissioner,Bill Viner,REP,690059,0,0,4,4,
Stephens,Insurance Commissioner,John Doak,REP,690059,0,1,12,13,
Stephens,Corporation Commissioner,Todd Hiett,REP,690059,0,0,7,7,
Stephens,Corporation Commissioner,Cliff Branan,REP,690059,0,0,9,9,
Stephens,U.S. Senate,Evelyn Rogers,REP,690059,0,0,0,0,
Stephens,U.S. Senate,Rob Moye,REP,690059,0,0,1,1,
Stephens,U.S. Senate,D. Jean Mcbride-Samuels,REP,690059,0,0,0,0,
Stephens,U.S. Senate,Jim Inhofe,REP,690059,0,1,15,16,
Stephens,U.S. Senate,Erick Paul Wyatt,REP,690059,0,0,2,2,
Stephens,U.S. Senate,Andy Craig,REP,690059,0,0,0,0,
Stephens,U.S. Senate,T. Shannon,REP,690059,0,0,9,9,
Stephens,U.S. Senate,Randy Brogdon,REP,690059,0,0,2,2,
Stephens,U.S. Senate,Eric Mccray,REP,690059,0,0,0,0,
Stephens,U.S. Senate,Kevin Crow,REP,690059,0,1,0,1,
Stephens,U.S. Senate,James Lankford,REP,690059,0,0,5,5,
Stephens,U.S. Senate,Jason Weger,REP,690059,0,0,0,0,
Stephens,U.S. House,Anna Flatt,REP,690059,0,0,4,4,04
Stephens,U.S. House,Tom Cole,REP,690059,0,0,14,14,04
Stephens,Superintendent of Public Instruction,John Cox,DEM,690060,0,0,0,0,
Stephens,Superintendent of Public Instruction,Jack Jr.,DEM,690060,0,0,0,0,
Stephens,Superintendent of Public Instruction,Ivan Holmes,DEM,690060,0,0,1,1,
Stephens,Superintendent of Public Instruction,Freda Deskin,DEM,690060,0,0,0,0,
Stephens,U.S. Senate,Patrick Michael Hayes,DEM,690060,0,0,0,0,
Stephens,U.S. Senate,Jim Rogers,DEM,690060,0,0,1,1,
Stephens,U.S. Senate,Connie Johnson,DEM,690060,0,0,0,0,
Stephens,U.S. House,Bert Smith,DEM,690060,0,0,1,1,04
Stephens,U.S. House,Tae Si,DEM,690060,0,0,0,0,04
Stephens,Governor,Dax Ewbank,REP,690060,0,0,0,0,
Stephens,Governor,Chad Moody,REP,690060,0,0,0,0,
Stephens,Governor,Mary Fallin,REP,690060,0,2,1,3,
Stephens,Superintendent of Public Instruction,Brian Kelly,REP,690060,0,0,0,0,
Stephens,Superintendent of Public Instruction,Janet Costello Barresi,REP,690060,0,0,1,1,
Stephens,Superintendent of Public Instruction,Joy Hofmeister,REP,690060,0,2,0,2,
Stephens,Insurance Commissioner,Bill Viner,REP,690060,0,0,0,0,
Stephens,Insurance Commissioner,John Doak,REP,690060,0,2,1,3,
Stephens,Corporation Commissioner,Todd Hiett,REP,690060,0,2,1,3,
Stephens,Corporation Commissioner,Cliff Branan,REP,690060,0,0,0,0,
Stephens,U.S. Senate,Evelyn Rogers,REP,690060,0,0,0,0,
Stephens,U.S. Senate,Rob Moye,REP,690060,0,0,0,0,
Stephens,U.S. Senate,D. Jean Mcbride-Samuels,REP,690060,0,0,0,0,
Stephens,U.S. Senate,Jim Inhofe,REP,690060,0,2,1,3,
Stephens,U.S. Senate,Erick Paul Wyatt,REP,690060,0,0,0,0,
Stephens,U.S. Senate,Andy Craig,REP,690060,0,0,0,0,
Stephens,U.S. Senate,T. Shannon,REP,690060,0,0,1,1,
Stephens,U.S. Senate,Randy Brogdon,REP,690060,0,0,0,0,
Stephens,U.S. Senate,Eric Mccray,REP,690060,0,0,0,0,
Stephens,U.S. Senate,Kevin Crow,REP,690060,0,0,0,0,
Stephens,U.S. Senate,James Lankford,REP,690060,0,2,0,2,
Stephens,U.S. Senate,Jason Weger,REP,690060,0,0,0,0,
Stephens,U.S. House,Anna Flatt,REP,690060,0,0,1,1,04
Stephens,U.S. House,Tom Cole,REP,690060,0,2,0,2,04
Stephens,State House,Renae Sexton,REP,690060,0,0,0,0,65
Stephens,State House,Scott Hayes,REP,690060,0,0,0,0,65
Stephens,State House,Scooter Park,REP,690060,0,2,0,2,65
Stephens,State House,Stephen Mills,REP,690060,0,0,1,1,65
Stephens,Superintendent of Public Instruction,John Cox,DEM,690061,0,0,30,30,
Stephens,Superintendent of Public Instruction,Jack Jr.,DEM,690061,0,1,9,10,
Stephens,Superintendent of Public Instruction,Ivan Holmes,DEM,690061,0,0,2,2,
Stephens,Superintendent of Public Instruction,Freda Deskin,DEM,690061,0,0,14,14,
Stephens,U.S. Senate,Patrick Michael Hayes,DEM,690061,0,1,12,13,
Stephens,U.S. Senate,Jim Rogers,DEM,690061,0,0,21,21,
Stephens,U.S. Senate,Connie Johnson,DEM,690061,0,0,19,19,
Stephens,U.S. House,Bert Smith,DEM,690061,0,1,49,50,04
Stephens,U.S. House,Tae Si,DEM,690061,0,0,5,5,04
Stephens,Governor,Dax Ewbank,REP,690061,0,0,9,9,
Stephens,Governor,Chad Moody,REP,690061,0,0,26,26,
Stephens,Governor,Mary Fallin,REP,690061,0,0,55,55,
Stephens,Superintendent of Public Instruction,Brian Kelly,REP,690061,0,0,17,17,
Stephens,Superintendent of Public Instruction,Janet Costello Barresi,REP,690061,0,0,8,8,
Stephens,Superintendent of Public Instruction,Joy Hofmeister,REP,690061,0,0,62,62,
Stephens,Insurance Commissioner,Bill Viner,REP,690061,0,0,21,21,
Stephens,Insurance Commissioner,John Doak,REP,690061,0,0,63,63,
Stephens,Corporation Commissioner,Todd Hiett,REP,690061,0,0,47,47,
Stephens,Corporation Commissioner,Cliff Branan,REP,690061,0,0,38,38,
Stephens,U.S. Senate,Evelyn Rogers,REP,690061,0,0,4,4,
Stephens,U.S. Senate,Rob Moye,REP,690061,0,0,0,0,
Stephens,U.S. Senate,D. Jean Mcbride-Samuels,REP,690061,0,0,3,3,
Stephens,U.S. Senate,Jim Inhofe,REP,690061,0,0,81,81,
Stephens,U.S. Senate,Erick Paul Wyatt,REP,690061,0,0,1,1,
Stephens,U.S. Senate,Andy Craig,REP,690061,0,0,0,0,
Stephens,U.S. Senate,T. Shannon,REP,690061,0,0,53,53,
Stephens,U.S. Senate,Randy Brogdon,REP,690061,0,0,1,1,
Stephens,U.S. Senate,Eric Mccray,REP,690061,0,0,0,0,
Stephens,U.S. Senate,Kevin Crow,REP,690061,0,0,2,2,
Stephens,U.S. Senate,James Lankford,REP,690061,0,0,33,33,
Stephens,U.S. Senate,Jason Weger,REP,690061,0,0,0,0,
Stephens,U.S. House,Anna Flatt,REP,690061,0,0,11,11,04
Stephens,U.S. House,Tom Cole,REP,690061,0,0,78,78,04
Stephens,Superintendent of Public Instruction,John Cox,DEM,690062,0,2,24,26,
Stephens,Superintendent of Public Instruction,Jack Jr.,DEM,690062,0,0,5,5,
Stephens,Superintendent of Public Instruction,Ivan Holmes,DEM,690062,0,1,5,6,
Stephens,Superintendent of Public Instruction,Freda Deskin,DEM,690062,0,0,5,5,
Stephens,U.S. Senate,Patrick Michael Hayes,DEM,690062,0,1,8,9,
Stephens,U.S. Senate,Jim Rogers,DEM,690062,0,2,14,16,
Stephens,U.S. Senate,Connie Johnson,DEM,690062,0,0,14,14,
Stephens,U.S. House,Bert Smith,DEM,690062,0,2,29,31,04
Stephens,U.S. House,Tae Si,DEM,690062,0,1,6,7,04
Stephens,Governor,Dax Ewbank,REP,690062,0,0,7,7,
Stephens,Governor,Chad Moody,REP,690062,0,1,14,15,
Stephens,Governor,Mary Fallin,REP,690062,0,0,40,40,
Stephens,Superintendent of Public Instruction,Brian Kelly,REP,690062,0,0,4,4,
Stephens,Superintendent of Public Instruction,Janet Costello Barresi,REP,690062,0,0,13,13,
Stephens,Superintendent of Public Instruction,Joy Hofmeister,REP,690062,0,1,46,47,
Stephens,Insurance Commissioner,Bill Viner,REP,690062,0,1,7,8,
Stephens,Insurance Commissioner,John Doak,REP,690062,0,0,44,44,
Stephens,Corporation Commissioner,Todd Hiett,REP,690062,0,0,26,26,
Stephens,Corporation Commissioner,Cliff Branan,REP,690062,0,1,27,28,
Stephens,U.S. Senate,Evelyn Rogers,REP,690062,0,0,2,2,
Stephens,U.S. Senate,Rob Moye,REP,690062,0,0,0,0,
Stephens,U.S. Senate,D. Jean Mcbride-Samuels,REP,690062,0,0,1,1,
Stephens,U.S. Senate,Jim Inhofe,REP,690062,0,0,58,58,
Stephens,U.S. Senate,Erick Paul Wyatt,REP,690062,0,1,2,3,
Stephens,U.S. Senate,Andy Craig,REP,690062,0,0,0,0,
Stephens,U.S. Senate,T. Shannon,REP,690062,0,0,42,42,
Stephens,U.S. Senate,Randy Brogdon,REP,690062,0,1,3,4,
Stephens,U.S. Senate,Eric Mccray,REP,690062,0,0,1,1,
Stephens,U.S. Senate,Kevin Crow,REP,690062,0,0,0,0,
Stephens,U.S. Senate,James Lankford,REP,690062,0,0,18,18,
Stephens,U.S. Senate,Jason Weger,REP,690062,0,0,1,1,
Stephens,U.S. House,Anna Flatt,REP,690062,0,1,8,9,04
Stephens,U.S. House,Tom Cole,REP,690062,0,0,56,56,04
Stephens,Superintendent of Public Instruction,John Cox,DEM,690063,0,1,10,11,
Stephens,Superintendent of Public Instruction,Jack Jr.,DEM,690063,0,0,6,6,
Stephens,Superintendent of Public Instruction,Ivan Holmes,DEM,690063,0,0,2,2,
Stephens,Superintendent of Public Instruction,Freda Deskin,DEM,690063,0,0,6,6,
Stephens,U.S. Senate,Patrick Michael Hayes,DEM,690063,0,0,8,8,
Stephens,U.S. Senate,Jim Rogers,DEM,690063,0,1,10,11,
Stephens,U.S. Senate,Connie Johnson,DEM,690063,0,0,4,4,
Stephens,U.S. House,Bert Smith,DEM,690063,0,1,18,19,04
Stephens,U.S. House,Tae Si,DEM,690063,0,0,2,2,04
Stephens,Governor,Dax Ewbank,REP,690063,1,1,3,5,
Stephens,Governor,Chad Moody,REP,690063,0,1,21,22,
Stephens,Governor,Mary Fallin,REP,690063,0,0,29,29,
Stephens,Superintendent of Public Instruction,Brian Kelly,REP,690063,0,0,9,9,
Stephens,Superintendent of Public Instruction,Janet Costello Barresi,REP,690063,0,0,9,9,
Stephens,Superintendent of Public Instruction,Joy Hofmeister,REP,690063,1,3,36,40,
Stephens,Insurance Commissioner,Bill Viner,REP,690063,1,0,12,13,
Stephens,Insurance Commissioner,John Doak,REP,690063,0,3,32,35,
Stephens,Corporation Commissioner,Todd Hiett,REP,690063,1,3,30,34,
Stephens,Corporation Commissioner,Cliff Branan,REP,690063,0,0,17,17,
Stephens,U.S. Senate,Evelyn Rogers,REP,690063,0,0,6,6,
Stephens,U.S. Senate,Rob Moye,REP,690063,0,0,0,0,
Stephens,U.S. Senate,D. Jean Mcbride-Samuels,REP,690063,0,0,0,0,
Stephens,U.S. Senate,Jim Inhofe,REP,690063,0,3,41,44,
Stephens,U.S. Senate,Erick Paul Wyatt,REP,690063,1,0,2,3,
Stephens,U.S. Senate,Andy Craig,REP,690063,0,1,0,1,
Stephens,U.S. Senate,T. Shannon,REP,690063,0,1,31,32,
Stephens,U.S. Senate,Randy Brogdon,REP,690063,0,0,1,1,
Stephens,U.S. Senate,Eric Mccray,REP,690063,0,0,0,0,
Stephens,U.S. Senate,Kevin Crow,REP,690063,0,0,6,6,
Stephens,U.S. Senate,James Lankford,REP,690063,0,1,11,12,
Stephens,U.S. Senate,Jason Weger,REP,690063,1,0,1,2,
Stephens,U.S. House,Anna Flatt,REP,690063,0,0,15,15,04
Stephens,U.S. House,Tom Cole,REP,690063,1,3,37,41,04
Stephens,State House,Renae Sexton,REP,690063,0,2,14,16,65
Stephens,State House,Scott Hayes,REP,690063,0,1,10,11,65
Stephens,State House,Scooter Park,REP,690063,0,0,12,12,65
Stephens,State House,Stephen Mills,REP,690063,1,0,14,15,65
Texas,Superintendent of Public Instruction,John Cox,DEM,700101,1,1,17,19,
Texas,Superintendent of Public Instruction,Jack Jr.,DEM,700101,1,1,8,10,
Texas,Superintendent of Public Instruction,Ivan Holmes,DEM,700101,0,1,6,7,
Texas,Superintendent of Public Instruction,Freda Deskin,DEM,700101,0,0,12,12,
Texas,U.S. Senate,Patrick Michael Hayes,DEM,700101,0,1,2,3,
Texas,U.S. Senate,Jim Rogers,DEM,700101,1,1,22,24,
Texas,U.S. Senate,Connie Johnson,DEM,700101,1,1,18,20,
Texas,Governor,Dax Ewbank,REP,700101,0,2,26,28,
Texas,Governor,Chad Moody,REP,700101,2,5,70,77,
Texas,Governor,Mary Fallin,REP,700101,14,11,248,273,
Texas,Superintendent of Public Instruction,Brian Kelly,REP,700101,6,5,104,115,
Texas,Superintendent of Public Instruction,Janet Costello Barresi,REP,700101,0,3,45,48,
Texas,Superintendent of Public Instruction,Joy Hofmeister,REP,700101,12,10,195,217,
Texas,Insurance Commissioner,Bill Viner,REP,700101,2,7,124,133,
Texas,Insurance Commissioner,John Doak,REP,700101,11,10,203,224,
Texas,Corporation Commissioner,Todd Hiett,REP,700101,6,12,186,204,
Texas,Corporation Commissioner,Cliff Branan,REP,700101,7,5,143,155,
Texas,U.S. Senate,Evelyn Rogers,REP,700101,1,0,18,19,
Texas,U.S. Senate,Rob Moye,REP,700101,0,0,7,7,
Texas,U.S. Senate,D. Jean Mcbride-Samuels,REP,700101,0,0,7,7,
Texas,U.S. Senate,Jim Inhofe,REP,700101,15,17,291,323,
Texas,U.S. Senate,Erick Paul Wyatt,REP,700101,1,1,25,27,
Texas,U.S. Senate,Andy Craig,REP,700101,0,0,6,6,
Texas,U.S. Senate,T. Shannon,REP,700101,9,11,171,191,
Texas,U.S. Senate,Randy Brogdon,REP,700101,1,0,19,20,
Texas,U.S. Senate,Eric Mccray,REP,700101,0,1,15,16,
Texas,U.S. Senate,Kevin Crow,REP,700101,0,0,15,15,
Texas,U.S. Senate,James Lankford,REP,700101,7,6,112,125,
Texas,U.S. Senate,Jason Weger,REP,700101,0,0,2,2,
Texas,U.S. House,Timothy Ray Murray,REP,700101,1,0,25,26,03
Texas,U.S. House,Robert Hubbard,REP,700101,0,1,53,54,03
Texas,U.S. House,Frank Lucas,REP,700101,16,17,269,302,03
Texas,State House,Casey Murdock,REP,700101,6,5,115,126,61
Texas,State House,David Elder,REP,700101,2,2,24,28,61
Texas,State House,Steve Moore,REP,700101,4,4,53,61,61
Texas,State House,Kenny Bob Tapp,REP,700101,5,5,126,136,61
Texas,State House,Larry Swager,REP,700101,1,2,26,29,61
Texas,Superintendent of Public Instruction,John Cox,DEM,700102,0,0,5,5,
Texas,Superintendent of Public Instruction,Jack Jr.,DEM,700102,0,1,3,4,
Texas,Superintendent of Public Instruction,Ivan Holmes,DEM,700102,0,0,6,6,
Texas,Superintendent of Public Instruction,Freda Deskin,DEM,700102,0,2,2,4,
Texas,U.S. Senate,Patrick Michael Hayes,DEM,700102,0,0,6,6,
Texas,U.S. Senate,Jim Rogers,DEM,700102,0,1,7,8,
Texas,U.S. Senate,Connie Johnson,DEM,700102,0,2,2,4,
Texas,Governor,Dax Ewbank,REP,700102,0,0,2,2,
Texas,Governor,Chad Moody,REP,700102,0,1,6,7,
Texas,Governor,Mary Fallin,REP,700102,0,1,41,42,
Texas,Superintendent of Public Instruction,Brian Kelly,REP,700102,0,1,15,16,
Texas,Superintendent of Public Instruction,Janet Costello Barresi,REP,700102,0,1,8,9,
Texas,Superintendent of Public Instruction,Joy Hofmeister,REP,700102,0,0,23,23,
Texas,Insurance Commissioner,Bill Viner,REP,700102,0,1,7,8,
Texas,Insurance Commissioner,John Doak,REP,700102,0,1,39,40,
Texas,Corporation Commissioner,Todd Hiett,REP,700102,0,2,17,19,
Texas,Corporation Commissioner,Cliff Branan,REP,700102,0,0,28,28,
Texas,U.S. Senate,Evelyn Rogers,REP,700102,0,0,2,2,
Texas,U.S. Senate,Rob Moye,REP,700102,0,0,2,2,
Texas,U.S. Senate,D. Jean Mcbride-Samuels,REP,700102,0,0,1,1,
Texas,U.S. Senate,Jim Inhofe,REP,700102,0,2,39,41,
Texas,U.S. Senate,Erick Paul Wyatt,REP,700102,0,0,4,4,
Texas,U.S. Senate,Andy Craig,REP,700102,0,0,0,0,
Texas,U.S. Senate,T. Shannon,REP,700102,0,2,26,28,
Texas,U.S. Senate,Randy Brogdon,REP,700102,0,0,1,1,
Texas,U.S. Senate,Eric Mccray,REP,700102,0,0,1,1,
Texas,U.S. Senate,Kevin Crow,REP,700102,0,0,1,1,
Texas,U.S. Senate,James Lankford,REP,700102,0,0,17,17,
Texas,U.S. Senate,Jason Weger,REP,700102,0,0,1,1,
Texas,U.S. House,Timothy Ray Murray,REP,700102,0,0,6,6,03
Texas,U.S. House,Robert Hubbard,REP,700102,0,1,5,6,03
Texas,U.S. House,Frank Lucas,REP,700102,0,1,38,39,03
Texas,State House,Casey Murdock,REP,700102,0,0,13,13,61
Texas,State House,David Elder,REP,700102,0,0,16,16,61
Texas,State House,Steve Moore,REP,700102,0,1,6,7,61
Texas,State House,Kenny Bob Tapp,REP,700102,0,1,7,8,61
Texas,State House,Larry Swager,REP,700102,0,0,7,7,61
Texas,Superintendent of Public Instruction,John Cox,DEM,700104,0,0,9,9,
Texas,Superintendent of Public Instruction,Jack Jr.,DEM,700104,1,0,4,5,
Texas,Superintendent of Public Instruction,Ivan Holmes,DEM,700104,0,0,4,4,
Texas,Superintendent of Public Instruction,Freda Deskin,DEM,700104,0,1,3,4,
Texas,U.S. Senate,Patrick Michael Hayes,DEM,700104,1,0,5,6,
Texas,U.S. Senate,Jim Rogers,DEM,700104,0,0,9,9,
Texas,U.S. Senate,Connie Johnson,DEM,700104,0,1,5,6,
Texas,Governor,Dax Ewbank,REP,700104,0,0,22,22,
Texas,Governor,Chad Moody,REP,700104,2,2,10,14,
Texas,Governor,Mary Fallin,REP,700104,8,0,86,94,
Texas,Superintendent of Public Instruction,Brian Kelly,REP,700104,1,1,42,44,
Texas,Superintendent of Public Instruction,Janet Costello Barresi,REP,700104,3,1,13,17,
Texas,Superintendent of Public Instruction,Joy Hofmeister,REP,700104,6,0,57,63,
Texas,Insurance Commissioner,Bill Viner,REP,700104,4,2,38,44,
Texas,Insurance Commissioner,John Doak,REP,700104,6,0,70,76,
Texas,Corporation Commissioner,Todd Hiett,REP,700104,7,1,58,66,
Texas,Corporation Commissioner,Cliff Branan,REP,700104,3,1,53,57,
Texas,U.S. Senate,Evelyn Rogers,REP,700104,1,0,9,10,
Texas,U.S. Senate,Rob Moye,REP,700104,0,2,8,10,
Texas,U.S. Senate,D. Jean Mcbride-Samuels,REP,700104,0,0,2,2,
Texas,U.S. Senate,Jim Inhofe,REP,700104,9,0,89,98,
Texas,U.S. Senate,Erick Paul Wyatt,REP,700104,0,0,10,10,
Texas,U.S. Senate,Andy Craig,REP,700104,1,1,3,5,
Texas,U.S. Senate,T. Shannon,REP,700104,1,0,37,38,
Texas,U.S. Senate,Randy Brogdon,REP,700104,1,0,8,9,
Texas,U.S. Senate,Eric Mccray,REP,700104,0,0,1,1,
Texas,U.S. Senate,Kevin Crow,REP,700104,2,0,8,10,
Texas,U.S. Senate,James Lankford,REP,700104,5,1,53,59,
Texas,U.S. Senate,Jason Weger,REP,700104,0,0,5,5,
Texas,U.S. House,Timothy Ray Murray,REP,700104,1,2,12,15,03
Texas,U.S. House,Robert Hubbard,REP,700104,0,0,18,18,03
Texas,U.S. House,Frank Lucas,REP,700104,9,0,87,96,03
Texas,State House,Casey Murdock,REP,700104,2,0,23,25,61
Texas,State House,David Elder,REP,700104,1,0,5,6,61
Texas,State House,Steve Moore,REP,700104,4,2,32,38,61
Texas,State House,Kenny Bob Tapp,REP,700104,2,0,48,50,61
Texas,State House,Larry Swager,REP,700104,1,0,9,10,61
Texas,Superintendent of Public Instruction,John Cox,DEM,700107,0,0,3,3,
Texas,Superintendent of Public Instruction,Jack Jr.,DEM,700107,0,0,4,4,
Texas,Superintendent of Public Instruction,Ivan Holmes,DEM,700107,0,0,2,2,
Texas,Superintendent of Public Instruction,Freda Deskin,DEM,700107,0,0,3,3,
Texas,U.S. Senate,Patrick Michael Hayes,DEM,700107,0,0,2,2,
Texas,U.S. Senate,Jim Rogers,DEM,700107,0,0,8,8,
Texas,U.S. Senate,Connie Johnson,DEM,700107,0,0,3,3,
Texas,Governor,Dax Ewbank,REP,700107,2,2,6,10,
Texas,Governor,Chad Moody,REP,700107,1,0,12,13,
Texas,Governor,Mary Fallin,REP,700107,1,2,39,42,
Texas,Superintendent of Public Instruction,Brian Kelly,REP,700107,0,2,18,20,
Texas,Superintendent of Public Instruction,Janet Costello Barresi,REP,700107,0,0,12,12,
Texas,Superintendent of Public Instruction,Joy Hofmeister,REP,700107,3,2,25,30,
Texas,Insurance Commissioner,Bill Viner,REP,700107,3,0,13,16,
Texas,Insurance Commissioner,John Doak,REP,700107,0,3,39,42,
Texas,Corporation Commissioner,Todd Hiett,REP,700107,3,4,31,38,
Texas,Corporation Commissioner,Cliff Branan,REP,700107,0,0,22,22,
Texas,U.S. Senate,Evelyn Rogers,REP,700107,0,0,2,2,
Texas,U.S. Senate,Rob Moye,REP,700107,0,0,3,3,
Texas,U.S. Senate,D. Jean Mcbride-Samuels,REP,700107,0,0,2,2,
Texas,U.S. Senate,Jim Inhofe,REP,700107,4,4,46,54,
Texas,U.S. Senate,Erick Paul Wyatt,REP,700107,0,0,2,2,
Texas,U.S. Senate,Andy Craig,REP,700107,0,0,2,2,
Texas,U.S. Senate,T. Shannon,REP,700107,1,0,28,29,
Texas,U.S. Senate,Randy Brogdon,REP,700107,0,2,4,6,
Texas,U.S. Senate,Eric Mccray,REP,700107,2,0,0,2,
Texas,U.S. Senate,Kevin Crow,REP,700107,0,0,1,1,
Texas,U.S. Senate,James Lankford,REP,700107,0,2,17,19,
Texas,U.S. Senate,Jason Weger,REP,700107,0,0,1,1,
Texas,U.S. House,Timothy Ray Murray,REP,700107,0,0,5,5,03
Texas,U.S. House,Robert Hubbard,REP,700107,1,2,6,9,03
Texas,U.S. House,Frank Lucas,REP,700107,3,2,45,50,03
Texas,State House,Casey Murdock,REP,700107,2,0,34,36,61
Texas,State House,David Elder,REP,700107,0,0,3,3,61
Texas,State House,Steve Moore,REP,700107,0,0,3,3,61
Texas,State House,Kenny Bob Tapp,REP,700107,1,4,12,17,61
Texas,State House,Larry Swager,REP,700107,1,0,5,6,61
Texas,Superintendent of Public Instruction,John Cox,DEM,700201,0,4,22,26,
Texas,Superintendent of Public Instruction,Jack Jr.,DEM,700201,0,0,10,10,
Texas,Superintendent of Public Instruction,Ivan Holmes,DEM,700201,1,0,6,7,
Texas,Superintendent of Public Instruction,Freda Deskin,DEM,700201,0,1,17,18,
Texas,U.S. Senate,Patrick Michael Hayes,DEM,700201,1,2,12,15,
Texas,U.S. Senate,Jim Rogers,DEM,700201,0,3,24,27,
Texas,U.S. Senate,Connie Johnson,DEM,700201,0,0,20,20,
Texas,Governor,Dax Ewbank,REP,700201,1,2,14,17,
Texas,Governor,Chad Moody,REP,700201,0,7,40,47,
Texas,Governor,Mary Fallin,REP,700201,7,19,167,193,
Texas,Superintendent of Public Instruction,Brian Kelly,REP,700201,2,7,70,79,
Texas,Superintendent of Public Instruction,Janet Costello Barresi,REP,700201,2,1,36,39,
Texas,Superintendent of Public Instruction,Joy Hofmeister,REP,700201,4,19,117,140,
Texas,Insurance Commissioner,Bill Viner,REP,700201,1,8,62,71,
Texas,Insurance Commissioner,John Doak,REP,700201,7,19,149,175,
Texas,Corporation Commissioner,Todd Hiett,REP,700201,3,12,112,127,
Texas,Corporation Commissioner,Cliff Branan,REP,700201,3,13,101,117,
Texas,U.S. Senate,Evelyn Rogers,REP,700201,1,2,12,15,
Texas,U.S. Senate,Rob Moye,REP,700201,0,0,5,5,
Texas,U.S. Senate,D. Jean Mcbride-Samuels,REP,700201,0,0,5,5,
Texas,U.S. Senate,Jim Inhofe,REP,700201,7,22,184,213,
Texas,U.S. Senate,Erick Paul Wyatt,REP,700201,0,1,17,18,
Texas,U.S. Senate,Andy Craig,REP,700201,0,1,6,7,
Texas,U.S. Senate,T. Shannon,REP,700201,3,12,98,113,
Texas,U.S. Senate,Randy Brogdon,REP,700201,0,0,17,17,
Texas,U.S. Senate,Eric Mccray,REP,700201,1,0,8,9,
Texas,U.S. Senate,Kevin Crow,REP,700201,0,0,7,7,
Texas,U.S. Senate,James Lankford,REP,700201,4,10,83,97,
Texas,U.S. Senate,Jason Weger,REP,700201,0,2,4,6,
Texas,U.S. House,Timothy Ray Murray,REP,700201,0,2,13,15,03
Texas,U.S. House,Robert Hubbard,REP,700201,0,4,29,33,03
Texas,U.S. House,Frank Lucas,REP,700201,8,21,182,211,03
Texas,State House,Casey Murdock,REP,700201,1,14,72,87,61
Texas,State House,David Elder,REP,700201,3,5,52,60,61
Texas,State House,Steve Moore,REP,700201,0,2,20,22,61
Texas,State House,Kenny Bob Tapp,REP,700201,2,0,33,35,61
Texas,State House,Larry Swager,REP,700201,2,7,49,58,61
Texas,Superintendent of Public Instruction,John Cox,DEM,700202,0,1,4,5,
Texas,Superintendent of Public Instruction,Jack Jr.,DEM,700202,0,0,2,2,
Texas,Superintendent of Public Instruction,Ivan Holmes,DEM,700202,0,1,2,3,
Texas,Superintendent of Public Instruction,Freda Deskin,DEM,700202,0,1,5,6,
Texas,U.S. Senate,Patrick Michael Hayes,DEM,700202,0,0,2,2,
Texas,U.S. Senate,Jim Rogers,DEM,700202,0,2,7,9,
Texas,U.S. Senate,Connie Johnson,DEM,700202,0,2,4,6,
Texas,Governor,Dax Ewbank,REP,700202,0,1,5,6,
Texas,Governor,Chad Moody,REP,700202,0,5,10,15,
Texas,Governor,Mary Fallin,REP,700202,1,10,49,60,
Texas,Superintendent of Public Instruction,Brian Kelly,REP,700202,0,3,23,26,
Texas,Superintendent of Public Instruction,Janet Costello Barresi,REP,700202,1,5,5,11,
Texas,Superintendent of Public Instruction,Joy Hofmeister,REP,700202,0,8,36,44,
Texas,Insurance Commissioner,Bill Viner,REP,700202,0,3,16,19,
Texas,Insurance Commissioner,John Doak,REP,700202,1,11,44,56,
Texas,Corporation Commissioner,Todd Hiett,REP,700202,1,9,30,40,
Texas,Corporation Commissioner,Cliff Branan,REP,700202,0,6,30,36,
Texas,U.S. Senate,Evelyn Rogers,REP,700202,0,1,1,2,
Texas,U.S. Senate,Rob Moye,REP,700202,0,0,1,1,
Texas,U.S. Senate,D. Jean Mcbride-Samuels,REP,700202,0,0,2,2,
Texas,U.S. Senate,Jim Inhofe,REP,700202,1,14,53,68,
Texas,U.S. Senate,Erick Paul Wyatt,REP,700202,0,1,4,5,
Texas,U.S. Senate,Andy Craig,REP,700202,0,0,4,4,
Texas,U.S. Senate,T. Shannon,REP,700202,0,9,31,40,
Texas,U.S. Senate,Randy Brogdon,REP,700202,0,0,3,3,
Texas,U.S. Senate,Eric Mccray,REP,700202,0,0,0,0,
Texas,U.S. Senate,Kevin Crow,REP,700202,0,0,1,1,
Texas,U.S. Senate,James Lankford,REP,700202,1,7,24,32,
Texas,U.S. Senate,Jason Weger,REP,700202,0,0,0,0,
Texas,U.S. House,Timothy Ray Murray,REP,700202,0,2,0,2,03
Texas,U.S. House,Robert Hubbard,REP,700202,0,1,8,9,03
Texas,U.S. House,Frank Lucas,REP,700202,1,13,55,69,03
Texas,State House,Casey Murdock,REP,700202,0,6,28,34,61
Texas,State House,David Elder,REP,700202,0,5,11,16,61
Texas,State House,Steve Moore,REP,700202,0,0,5,5,61
Texas,State House,Kenny Bob Tapp,REP,700202,0,1,11,12,61
Texas,State House,Larry Swager,REP,700202,1,4,8,13,61
Texas,Superintendent of Public Instruction,John Cox,DEM,700205,0,0,23,23,
Texas,Superintendent of Public Instruction,Jack Jr.,DEM,700205,0,1,9,10,
Texas,Superintendent of Public Instruction,Ivan Holmes,DEM,700205,0,2,2,4,
Texas,Superintendent of Public Instruction,Freda Deskin,DEM,700205,0,3,13,16,
Texas,U.S. Senate,Patrick Michael Hayes,DEM,700205,0,0,14,14,
Texas,U.S. Senate,Jim Rogers,DEM,700205,0,1,17,18,
Texas,U.S. Senate,Connie Johnson,DEM,700205,0,2,15,17,
Texas,Governor,Dax Ewbank,REP,700205,0,0,11,11,
Texas,Governor,Chad Moody,REP,700205,2,4,37,43,
Texas,Governor,Mary Fallin,REP,700205,10,11,181,202,
Texas,Superintendent of Public Instruction,Brian Kelly,REP,700205,4,3,86,93,
Texas,Superintendent of Public Instruction,Janet Costello Barresi,REP,700205,2,5,37,44,
Texas,Superintendent of Public Instruction,Joy Hofmeister,REP,700205,5,4,101,110,
Texas,Insurance Commissioner,Bill Viner,REP,700205,2,2,69,73,
Texas,Insurance Commissioner,John Doak,REP,700205,9,11,140,160,
Texas,Corporation Commissioner,Todd Hiett,REP,700205,7,11,121,139,
Texas,Corporation Commissioner,Cliff Branan,REP,700205,4,2,84,90,
Texas,U.S. Senate,Evelyn Rogers,REP,700205,1,1,7,9,
Texas,U.S. Senate,Rob Moye,REP,700205,0,0,4,4,
Texas,U.S. Senate,D. Jean Mcbride-Samuels,REP,700205,0,0,6,6,
Texas,U.S. Senate,Jim Inhofe,REP,700205,11,14,200,225,
Texas,U.S. Senate,Erick Paul Wyatt,REP,700205,0,0,10,10,
Texas,U.S. Senate,Andy Craig,REP,700205,1,1,3,5,
Texas,U.S. Senate,T. Shannon,REP,700205,5,8,91,104,
Texas,U.S. Senate,Randy Brogdon,REP,700205,0,1,14,15,
Texas,U.S. Senate,Eric Mccray,REP,700205,0,0,4,4,
Texas,U.S. Senate,Kevin Crow,REP,700205,0,0,6,6,
Texas,U.S. Senate,James Lankford,REP,700205,7,3,98,108,
Texas,U.S. Senate,Jason Weger,REP,700205,0,1,8,9,
Texas,U.S. House,Timothy Ray Murray,REP,700205,2,0,9,11,03
Texas,U.S. House,Robert Hubbard,REP,700205,0,2,40,42,03
Texas,U.S. House,Frank Lucas,REP,700205,11,13,177,201,03
Texas,State House,Casey Murdock,REP,700205,10,7,81,98,61
Texas,State House,David Elder,REP,700205,0,6,40,46,61
Texas,State House,Steve Moore,REP,700205,0,0,22,22,61
Texas,State House,Kenny Bob Tapp,REP,700205,1,0,13,14,61
Texas,State House,Larry Swager,REP,700205,2,2,72,76,61
Texas,Superintendent of Public Instruction,John Cox,DEM,700302,0,1,3,4,
Texas,Superintendent of Public Instruction,Jack Jr.,DEM,700302,0,0,1,1,
Texas,Superintendent of Public Instruction,Ivan Holmes,DEM,700302,0,0,5,5,
Texas,Superintendent of Public Instruction,Freda Deskin,DEM,700302,0,0,1,1,
Texas,U.S. Senate,Patrick Michael Hayes,DEM,700302,0,0,4,4,
Texas,U.S. Senate,Jim Rogers,DEM,700302,0,0,6,6,
Texas,U.S. Senate,Connie Johnson,DEM,700302,0,1,0,1,
Texas,Governor,Dax Ewbank,REP,700302,2,0,4,6,
Texas,Governor,Chad Moody,REP,700302,0,0,12,12,
Texas,Governor,Mary Fallin,REP,700302,4,7,17,28,
Texas,Superintendent of Public Instruction,Brian Kelly,REP,700302,2,0,12,14,
Texas,Superintendent of Public Instruction,Janet Costello Barresi,REP,700302,1,0,1,2,
Texas,Superintendent of Public Instruction,Joy Hofmeister,REP,700302,3,6,17,26,
Texas,Insurance Commissioner,Bill Viner,REP,700302,2,0,9,11,
Texas,Insurance Commissioner,John Doak,REP,700302,4,7,18,29,
Texas,Corporation Commissioner,Todd Hiett,REP,700302,6,2,14,22,
Texas,Corporation Commissioner,Cliff Branan,REP,700302,0,5,14,19,
Texas,U.S. Senate,Evelyn Rogers,REP,700302,0,0,1,1,
Texas,U.S. Senate,Rob Moye,REP,700302,0,0,2,2,
Texas,U.S. Senate,D. Jean Mcbride-Samuels,REP,700302,0,0,0,0,
Texas,U.S. Senate,Jim Inhofe,REP,700302,6,7,25,38,
Texas,U.S. Senate,Erick Paul Wyatt,REP,700302,0,0,5,5,
Texas,U.S. Senate,Andy Craig,REP,700302,0,0,0,0,
Texas,U.S. Senate,T. Shannon,REP,700302,3,6,20,29,
Texas,U.S. Senate,Randy Brogdon,REP,700302,3,1,2,6,
Texas,U.S. Senate,Eric Mccray,REP,700302,0,0,0,0,
Texas,U.S. Senate,Kevin Crow,REP,700302,0,0,1,1,
Texas,U.S. Senate,James Lankford,REP,700302,0,0,8,8,
Texas,U.S. Senate,Jason Weger,REP,700302,0,0,2,2,
Texas,U.S. House,Timothy Ray Murray,REP,700302,0,0,2,2,03
Texas,U.S. House,Robert Hubbard,REP,700302,0,2,5,7,03
Texas,U.S. House,Frank Lucas,REP,700302,6,5,26,37,03
Texas,State House,Casey Murdock,REP,700302,2,6,24,32,61
Texas,State House,David Elder,REP,700302,4,0,2,6,61
Texas,State House,Steve Moore,REP,700302,0,0,2,2,61
Texas,State House,Kenny Bob Tapp,REP,700302,0,0,2,2,61
Texas,State House,Larry Swager,REP,700302,0,1,3,4,61
Texas,Superintendent of Public Instruction,John Cox,DEM,700303,0,0,14,14,
Texas,Superintendent of Public Instruction,Jack Jr.,DEM,700303,1,0,8,9,
Texas,Superintendent of Public Instruction,Ivan Holmes,DEM,700303,0,0,3,3,
Texas,Superintendent of Public Instruction,Freda Deskin,DEM,700303,1,0,6,7,
Texas,U.S. Senate,Patrick Michael Hayes,DEM,700303,2,0,9,11,
Texas,U.S. Senate,Jim Rogers,DEM,700303,0,0,11,11,
Texas,U.S. Senate,Connie Johnson,DEM,700303,0,0,11,11,
Texas,Governor,Dax Ewbank,REP,700303,1,0,11,12,
Texas,Governor,Chad Moody,REP,700303,3,0,17,20,
Texas,Governor,Mary Fallin,REP,700303,2,0,85,87,
Texas,Superintendent of Public Instruction,Brian Kelly,REP,700303,0,0,42,42,
Texas,Superintendent of Public Instruction,Janet Costello Barresi,REP,700303,0,0,13,13,
Texas,Superintendent of Public Instruction,Joy Hofmeister,REP,700303,6,0,51,57,
Texas,Insurance Commissioner,Bill Viner,REP,700303,0,0,26,26,
Texas,Insurance Commissioner,John Doak,REP,700303,4,0,78,82,
Texas,Corporation Commissioner,Todd Hiett,REP,700303,2,0,46,48,
Texas,Corporation Commissioner,Cliff Branan,REP,700303,2,0,50,52,
Texas,U.S. Senate,Evelyn Rogers,REP,700303,0,0,5,5,
Texas,U.S. Senate,Rob Moye,REP,700303,0,0,1,1,
Texas,U.S. Senate,D. Jean Mcbride-Samuels,REP,700303,0,0,0,0,
Texas,U.S. Senate,Jim Inhofe,REP,700303,5,0,91,96,
Texas,U.S. Senate,Erick Paul Wyatt,REP,700303,1,0,9,10,
Texas,U.S. Senate,Andy Craig,REP,700303,1,0,3,4,
Texas,U.S. Senate,T. Shannon,REP,700303,5,0,48,53,
Texas,U.S. Senate,Randy Brogdon,REP,700303,0,0,7,7,
Texas,U.S. Senate,Eric Mccray,REP,700303,0,0,3,3,
Texas,U.S. Senate,Kevin Crow,REP,700303,0,0,5,5,
Texas,U.S. Senate,James Lankford,REP,700303,0,0,43,43,
Texas,U.S. Senate,Jason Weger,REP,700303,0,0,1,1,
Texas,U.S. House,Timothy Ray Murray,REP,700303,0,0,8,8,03
Texas,U.S. House,Robert Hubbard,REP,700303,0,0,17,17,03
Texas,U.S. House,Frank Lucas,REP,700303,6,0,84,90,03
Texas,State House,Casey Murdock,REP,700303,2,0,54,56,61
Texas,State House,David Elder,REP,700303,2,0,8,10,61
Texas,State House,Steve Moore,REP,700303,1,0,27,28,61
Texas,State House,Kenny Bob Tapp,REP,700303,0,0,14,14,61
Texas,State House,Larry Swager,REP,700303,1,0,10,11,61
Texas,Superintendent of Public Instruction,John Cox,DEM,700304,0,0,14,14,
Texas,Superintendent of Public Instruction,Jack Jr.,DEM,700304,0,0,7,7,
Texas,Superintendent of Public Instruction,Ivan Holmes,DEM,700304,0,0,3,3,
Texas,Superintendent of Public Instruction,Freda Deskin,DEM,700304,0,0,10,10,
Texas,U.S. Senate,Patrick Michael Hayes,DEM,700304,0,0,8,8,
Texas,U.S. Senate,Jim Rogers,DEM,700304,0,0,18,18,
Texas,U.S. Senate,Connie Johnson,DEM,700304,0,0,9,9,
Texas,Governor,Dax Ewbank,REP,700304,0,2,15,17,
Texas,Governor,Chad Moody,REP,700304,0,1,23,24,
Texas,Governor,Mary Fallin,REP,700304,0,4,52,56,
Texas,Superintendent of Public Instruction,Brian Kelly,REP,700304,0,5,37,42,
Texas,Superintendent of Public Instruction,Janet Costello Barresi,REP,700304,0,0,8,8,
Texas,Superintendent of Public Instruction,Joy Hofmeister,REP,700304,0,2,43,45,
Texas,Insurance Commissioner,Bill Viner,REP,700304,0,3,28,31,
Texas,Insurance Commissioner,John Doak,REP,700304,0,4,51,55,
Texas,Corporation Commissioner,Todd Hiett,REP,700304,0,2,39,41,
Texas,Corporation Commissioner,Cliff Branan,REP,700304,0,5,42,47,
Texas,U.S. Senate,Evelyn Rogers,REP,700304,0,0,7,7,
Texas,U.S. Senate,Rob Moye,REP,700304,0,0,1,1,
Texas,U.S. Senate,D. Jean Mcbride-Samuels,REP,700304,0,1,2,3,
Texas,U.S. Senate,Jim Inhofe,REP,700304,0,6,68,74,
Texas,U.S. Senate,Erick Paul Wyatt,REP,700304,0,0,11,11,
Texas,U.S. Senate,Andy Craig,REP,700304,0,0,2,2,
Texas,U.S. Senate,T. Shannon,REP,700304,0,4,34,38,
Texas,U.S. Senate,Randy Brogdon,REP,700304,0,1,6,7,
Texas,U.S. Senate,Eric Mccray,REP,700304,0,0,5,5,
Texas,U.S. Senate,Kevin Crow,REP,700304,0,0,10,10,
Texas,U.S. Senate,James Lankford,REP,700304,0,2,32,34,
Texas,U.S. Senate,Jason Weger,REP,700304,0,0,1,1,
Texas,U.S. House,Timothy Ray Murray,REP,700304,0,0,9,9,03
Texas,U.S. House,Robert Hubbard,REP,700304,0,1,9,10,03
Texas,U.S. House,Frank Lucas,REP,700304,0,6,71,77,03
Texas,State House,Casey Murdock,REP,700304,0,2,31,33,61
Texas,State House,David Elder,REP,700304,0,0,27,27,61
Texas,State House,Steve Moore,REP,700304,0,1,8,9,61
Texas,State House,Kenny Bob Tapp,REP,700304,0,0,10,10,61
Texas,State House,Larry Swager,REP,700304,0,4,14,18,61
Texas,Superintendent of Public Instruction,John Cox,DEM,700305,0,1,16,17,
Texas,Superintendent of Public Instruction,Jack Jr.,DEM,700305,0,1,3,4,
Texas,Superintendent of Public Instruction,Ivan Holmes,DEM,700305,0,0,11,11,
Texas,Superintendent of Public Instruction,Freda Deskin,DEM,700305,1,1,13,15,
Texas,U.S. Senate,Patrick Michael Hayes,DEM,700305,0,1,9,10,
Texas,U.S. Senate,Jim Rogers,DEM,700305,1,1,18,20,
Texas,U.S. Senate,Connie Johnson,DEM,700305,0,1,14,15,
Texas,Governor,Dax Ewbank,REP,700305,0,3,14,17,
Texas,Governor,Chad Moody,REP,700305,0,4,46,50,
Texas,Governor,Mary Fallin,REP,700305,3,21,172,196,
Texas,Superintendent of Public Instruction,Brian Kelly,REP,700305,1,4,81,86,
Texas,Superintendent of Public Instruction,Janet Costello Barresi,REP,700305,0,7,36,43,
Texas,Superintendent of Public Instruction,Joy Hofmeister,REP,700305,2,15,109,126,
Texas,Insurance Commissioner,Bill Viner,REP,700305,1,3,68,72,
Texas,Insurance Commissioner,John Doak,REP,700305,3,22,151,176,
Texas,Corporation Commissioner,Todd Hiett,REP,700305,1,10,110,121,
Texas,Corporation Commissioner,Cliff Branan,REP,700305,3,12,102,117,
Texas,U.S. Senate,Evelyn Rogers,REP,700305,0,4,19,23,
Texas,U.S. Senate,Rob Moye,REP,700305,0,0,9,9,
Texas,U.S. Senate,D. Jean Mcbride-Samuels,REP,700305,0,1,5,6,
Texas,U.S. Senate,Jim Inhofe,REP,700305,2,20,185,207,
Texas,U.S. Senate,Erick Paul Wyatt,REP,700305,1,3,13,17,
Texas,U.S. Senate,Andy Craig,REP,700305,0,0,6,6,
Texas,U.S. Senate,T. Shannon,REP,700305,0,15,118,133,
Texas,U.S. Senate,Randy Brogdon,REP,700305,0,4,14,18,
Texas,U.S. Senate,Eric Mccray,REP,700305,0,1,10,11,
Texas,U.S. Senate,Kevin Crow,REP,700305,0,0,8,8,
Texas,U.S. Senate,James Lankford,REP,700305,3,7,72,82,
Texas,U.S. Senate,Jason Weger,REP,700305,1,1,2,4,
Texas,U.S. House,Timothy Ray Murray,REP,700305,0,3,27,30,03
Texas,U.S. House,Robert Hubbard,REP,700305,2,5,24,31,03
Texas,U.S. House,Frank Lucas,REP,700305,2,19,179,200,03
Texas,State House,Casey Murdock,REP,700305,1,13,91,105,61
Texas,State House,David Elder,REP,700305,2,2,39,43,61
Texas,State House,Steve Moore,REP,700305,1,3,19,23,61
Texas,State House,Kenny Bob Tapp,REP,700305,0,7,19,26,61
Texas,State House,Larry Swager,REP,700305,0,3,66,69,61
Tillman,Superintendent of Public Instruction,John Cox,DEM,710001,0,16,44,60,
Tillman,Superintendent of Public Instruction,Jack Jr.,DEM,710001,0,11,23,34,
Tillman,Superintendent of Public Instruction,Ivan Holmes,DEM,710001,1,4,21,26,
Tillman,Superintendent of Public Instruction,Freda Deskin,DEM,710001,2,7,18,27,
Tillman,U.S. Senate,Patrick Michael Hayes,DEM,710001,0,10,30,40,
Tillman,U.S. Senate,Jim Rogers,DEM,710001,1,14,39,54,
Tillman,U.S. Senate,Connie Johnson,DEM,710001,2,13,34,49,
Tillman,U.S. House,Bert Smith,DEM,710001,3,35,92,130,04
Tillman,U.S. House,Tae Si,DEM,710001,0,2,7,9,04
Tillman,State House,B. L. Cozad Jr,DEM,710001,1,14,34,49,63
Tillman,State House,Juan Rodriguez,DEM,710001,2,25,69,96,63
Tillman,Governor,Dax Ewbank,REP,710001,0,3,8,11,
Tillman,Governor,Chad Moody,REP,710001,3,2,36,41,
Tillman,Governor,Mary Fallin,REP,710001,6,33,114,153,
Tillman,Superintendent of Public Instruction,Brian Kelly,REP,710001,2,6,39,47,
Tillman,Superintendent of Public Instruction,Janet Costello Barresi,REP,710001,0,3,11,14,
Tillman,Superintendent of Public Instruction,Joy Hofmeister,REP,710001,7,28,106,141,
Tillman,Insurance Commissioner,Bill Viner,REP,710001,2,14,33,49,
Tillman,Insurance Commissioner,John Doak,REP,710001,7,23,107,137,
Tillman,Corporation Commissioner,Todd Hiett,REP,710001,4,19,77,100,
Tillman,Corporation Commissioner,Cliff Branan,REP,710001,3,18,65,86,
Tillman,U.S. Senate,Evelyn Rogers,REP,710001,2,0,9,11,
Tillman,U.S. Senate,Rob Moye,REP,710001,0,1,2,3,
Tillman,U.S. Senate,D. Jean Mcbride-Samuels,REP,710001,1,0,2,3,
Tillman,U.S. Senate,Jim Inhofe,REP,710001,5,39,141,185,
Tillman,U.S. Senate,Erick Paul Wyatt,REP,710001,1,0,6,7,
Tillman,U.S. Senate,Andy Craig,REP,710001,0,2,2,4,
Tillman,U.S. Senate,T. Shannon,REP,710001,3,25,87,115,
Tillman,U.S. Senate,Randy Brogdon,REP,710001,0,0,3,3,
Tillman,U.S. Senate,Eric Mccray,REP,710001,1,1,0,2,
Tillman,U.S. Senate,Kevin Crow,REP,710001,0,0,1,1,
Tillman,U.S. Senate,James Lankford,REP,710001,5,11,66,82,
Tillman,U.S. Senate,Jason Weger,REP,710001,0,0,0,0,
Tillman,U.S. House,Anna Flatt,REP,710001,0,2,12,14,04
Tillman,U.S. House,Tom Cole,REP,710001,9,37,150,196,04
Tillman,State House,Jeff Coody,REP,710001,0,0,24,24,63
Tillman,State House,Hurchel Trey Caldwell,REP,710001,0,0,3,3,63
Tillman,State House,Greg Howard,REP,710001,9,40,137,186,63
Tillman,Superintendent of Public Instruction,John Cox,DEM,710002,1,6,19,26,
Tillman,Superintendent of Public Instruction,Jack Jr.,DEM,710002,0,1,17,18,
Tillman,Superintendent of Public Instruction,Ivan Holmes,DEM,710002,0,0,10,10,
Tillman,Superintendent of Public Instruction,Freda Deskin,DEM,710002,0,3,16,19,
Tillman,U.S. Senate,Patrick Michael Hayes,DEM,710002,0,5,24,29,
Tillman,U.S. Senate,Jim Rogers,DEM,710002,1,3,24,28,
Tillman,U.S. Senate,Connie Johnson,DEM,710002,0,2,15,17,
Tillman,U.S. House,Bert Smith,DEM,710002,1,9,53,63,04
Tillman,U.S. House,Tae Si,DEM,710002,0,0,8,8,04
Tillman,State House,B. L. Cozad Jr,DEM,710002,0,6,21,27,63
Tillman,State House,Juan Rodriguez,DEM,710002,1,3,41,45,63
Tillman,Governor,Dax Ewbank,REP,710002,0,1,9,10,
Tillman,Governor,Chad Moody,REP,710002,0,4,18,22,
Tillman,Governor,Mary Fallin,REP,710002,0,10,39,49,
Tillman,Superintendent of Public Instruction,Brian Kelly,REP,710002,0,7,22,29,
Tillman,Superintendent of Public Instruction,Janet Costello Barresi,REP,710002,0,2,7,9,
Tillman,Superintendent of Public Instruction,Joy Hofmeister,REP,710002,0,5,34,39,
Tillman,Insurance Commissioner,Bill Viner,REP,710002,0,7,18,25,
Tillman,Insurance Commissioner,John Doak,REP,710002,0,5,44,49,
Tillman,Corporation Commissioner,Todd Hiett,REP,710002,0,2,25,27,
Tillman,Corporation Commissioner,Cliff Branan,REP,710002,0,11,38,49,
Tillman,U.S. Senate,Evelyn Rogers,REP,710002,0,0,2,2,
Tillman,U.S. Senate,Rob Moye,REP,710002,0,0,6,6,
Tillman,U.S. Senate,D. Jean Mcbride-Samuels,REP,710002,0,0,1,1,
Tillman,U.S. Senate,Jim Inhofe,REP,710002,0,14,52,66,
Tillman,U.S. Senate,Erick Paul Wyatt,REP,710002,0,0,6,6,
Tillman,U.S. Senate,Andy Craig,REP,710002,0,0,2,2,
Tillman,U.S. Senate,T. Shannon,REP,710002,0,13,37,50,
Tillman,U.S. Senate,Randy Brogdon,REP,710002,0,0,0,0,
Tillman,U.S. Senate,Eric Mccray,REP,710002,0,0,2,2,
Tillman,U.S. Senate,Kevin Crow,REP,710002,0,0,1,1,
Tillman,U.S. Senate,James Lankford,REP,710002,0,2,22,24,
Tillman,U.S. Senate,Jason Weger,REP,710002,0,1,3,4,
Tillman,U.S. House,Anna Flatt,REP,710002,0,1,12,13,04
Tillman,U.S. House,Tom Cole,REP,710002,0,14,55,69,04
Tillman,State House,Jeff Coody,REP,710002,0,2,4,6,63
Tillman,State House,Hurchel Trey Caldwell,REP,710002,0,0,0,0,63
Tillman,State House,Greg Howard,REP,710002,0,14,63,77,63
Tillman,Superintendent of Public Instruction,John Cox,DEM,710003,0,1,9,10,
Tillman,Superintendent of Public Instruction,Jack Jr.,DEM,710003,0,1,5,6,
Tillman,Superintendent of Public Instruction,Ivan Holmes,DEM,710003,0,0,2,2,
Tillman,Superintendent of Public Instruction,Freda Deskin,DEM,710003,0,0,8,8,
Tillman,U.S. Senate,Patrick Michael Hayes,DEM,710003,0,1,9,10,
Tillman,U.S. Senate,Jim Rogers,DEM,710003,0,1,11,12,
Tillman,U.S. Senate,Connie Johnson,DEM,710003,0,0,6,6,
Tillman,U.S. House,Bert Smith,DEM,710003,0,2,23,25,04
Tillman,U.S. House,Tae Si,DEM,710003,0,0,2,2,04
Tillman,State House,B. L. Cozad Jr,DEM,710003,0,0,6,6,63
Tillman,State House,Juan Rodriguez,DEM,710003,0,2,20,22,63
Tillman,Governor,Dax Ewbank,REP,710003,0,0,1,1,
Tillman,Governor,Chad Moody,REP,710003,0,3,2,5,
Tillman,Governor,Mary Fallin,REP,710003,1,8,21,30,
Tillman,Superintendent of Public Instruction,Brian Kelly,REP,710003,0,2,5,7,
Tillman,Superintendent of Public Instruction,Janet Costello Barresi,REP,710003,0,0,2,2,
Tillman,Superintendent of Public Instruction,Joy Hofmeister,REP,710003,1,9,16,26,
Tillman,Insurance Commissioner,Bill Viner,REP,710003,0,1,4,5,
Tillman,Insurance Commissioner,John Doak,REP,710003,1,8,18,27,
Tillman,Corporation Commissioner,Todd Hiett,REP,710003,1,5,11,17,
Tillman,Corporation Commissioner,Cliff Branan,REP,710003,0,4,11,15,
Tillman,U.S. Senate,Evelyn Rogers,REP,710003,0,2,1,3,
Tillman,U.S. Senate,Rob Moye,REP,710003,0,0,0,0,
Tillman,U.S. Senate,D. Jean Mcbride-Samuels,REP,710003,0,0,0,0,
Tillman,U.S. Senate,Jim Inhofe,REP,710003,1,8,22,31,
Tillman,U.S. Senate,Erick Paul Wyatt,REP,710003,0,1,1,2,
Tillman,U.S. Senate,Andy Craig,REP,710003,0,0,1,1,
Tillman,U.S. Senate,T. Shannon,REP,710003,1,8,13,22,
Tillman,U.S. Senate,Randy Brogdon,REP,710003,0,0,0,0,
Tillman,U.S. Senate,Eric Mccray,REP,710003,0,1,0,1,
Tillman,U.S. Senate,Kevin Crow,REP,710003,0,0,0,0,
Tillman,U.S. Senate,James Lankford,REP,710003,0,2,10,12,
Tillman,U.S. Senate,Jason Weger,REP,710003,0,0,0,0,
Tillman,U.S. House,Anna Flatt,REP,710003,0,3,1,4,04
Tillman,U.S. House,Tom Cole,REP,710003,1,8,23,32,04
Tillman,State House,Jeff Coody,REP,710003,0,2,4,6,63
Tillman,State House,Hurchel Trey Caldwell,REP,710003,0,0,0,0,63
Tillman,State House,Greg Howard,REP,710003,1,9,20,30,63
Tillman,Superintendent of Public Instruction,John Cox,DEM,710004,0,3,16,19,
Tillman,Superintendent of Public Instruction,Jack Jr.,DEM,710004,0,2,12,14,
Tillman,Superintendent of Public Instruction,Ivan Holmes,DEM,710004,1,2,6,9,
Tillman,Superintendent of Public Instruction,Freda Deskin,DEM,710004,0,3,9,12,
Tillman,U.S. Senate,Patrick Michael Hayes,DEM,710004,0,2,14,16,
Tillman,U.S. Senate,Jim Rogers,DEM,710004,1,4,13,18,
Tillman,U.S. Senate,Connie Johnson,DEM,710004,0,4,14,18,
Tillman,U.S. House,Bert Smith,DEM,710004,1,7,32,40,04
Tillman,U.S. House,Tae Si,DEM,710004,0,2,9,11,04
Tillman,State House,B. L. Cozad Jr,DEM,710004,0,2,14,16,63
Tillman,State House,Juan Rodriguez,DEM,710004,1,7,28,36,63
Tillman,Governor,Dax Ewbank,REP,710004,0,1,4,5,
Tillman,Governor,Chad Moody,REP,710004,0,2,6,8,
Tillman,Governor,Mary Fallin,REP,710004,0,8,29,37,
Tillman,Superintendent of Public Instruction,Brian Kelly,REP,710004,0,3,8,11,
Tillman,Superintendent of Public Instruction,Janet Costello Barresi,REP,710004,0,2,6,8,
Tillman,Superintendent of Public Instruction,Joy Hofmeister,REP,710004,0,5,22,27,
Tillman,Insurance Commissioner,Bill Viner,REP,710004,0,3,11,14,
Tillman,Insurance Commissioner,John Doak,REP,710004,0,6,24,30,
Tillman,Corporation Commissioner,Todd Hiett,REP,710004,0,4,14,18,
Tillman,Corporation Commissioner,Cliff Branan,REP,710004,0,6,21,27,
Tillman,U.S. Senate,Evelyn Rogers,REP,710004,0,1,3,4,
Tillman,U.S. Senate,Rob Moye,REP,710004,0,0,0,0,
Tillman,U.S. Senate,D. Jean Mcbride-Samuels,REP,710004,0,0,0,0,
Tillman,U.S. Senate,Jim Inhofe,REP,710004,0,9,33,42,
Tillman,U.S. Senate,Erick Paul Wyatt,REP,710004,0,1,2,3,
Tillman,U.S. Senate,Andy Craig,REP,710004,0,0,1,1,
Tillman,U.S. Senate,T. Shannon,REP,710004,0,9,20,29,
Tillman,U.S. Senate,Randy Brogdon,REP,710004,0,0,1,1,
Tillman,U.S. Senate,Eric Mccray,REP,710004,0,0,0,0,
Tillman,U.S. Senate,Kevin Crow,REP,710004,0,0,0,0,
Tillman,U.S. Senate,James Lankford,REP,710004,0,2,15,17,
Tillman,U.S. Senate,Jason Weger,REP,710004,0,0,2,2,
Tillman,U.S. House,Anna Flatt,REP,710004,0,0,3,3,04
Tillman,U.S. House,Tom Cole,REP,710004,0,11,36,47,04
Tillman,State House,Jeff Coody,REP,710004,0,0,9,9,63
Tillman,State House,Hurchel Trey Caldwell,REP,710004,0,0,0,0,63
Tillman,State House,Greg Howard,REP,710004,0,12,30,42,63
Tillman,Superintendent of Public Instruction,John Cox,DEM,710006,0,1,16,17,
Tillman,Superintendent of Public Instruction,Jack Jr.,DEM,710006,0,0,10,10,
Tillman,Superintendent of Public Instruction,Ivan Holmes,DEM,710006,0,0,2,2,
Tillman,Superintendent of Public Instruction,Freda Deskin,DEM,710006,0,0,5,5,
Tillman,U.S. Senate,Patrick Michael Hayes,DEM,710006,0,0,12,12,
Tillman,U.S. Senate,Jim Rogers,DEM,710006,0,1,12,13,
Tillman,U.S. Senate,Connie Johnson,DEM,710006,0,0,10,10,
Tillman,U.S. House,Bert Smith,DEM,710006,0,1,34,35,04
Tillman,U.S. House,Tae Si,DEM,710006,0,0,1,1,04
Tillman,State House,B. L. Cozad Jr,DEM,710006,0,1,9,10,63
Tillman,State House,Juan Rodriguez,DEM,710006,0,0,27,27,63
Tillman,Governor,Dax Ewbank,REP,710006,0,0,2,2,
Tillman,Governor,Chad Moody,REP,710006,2,2,6,10,
Tillman,Governor,Mary Fallin,REP,710006,2,4,27,33,
Tillman,Superintendent of Public Instruction,Brian Kelly,REP,710006,0,0,5,5,
Tillman,Superintendent of Public Instruction,Janet Costello Barresi,REP,710006,0,0,8,8,
Tillman,Superintendent of Public Instruction,Joy Hofmeister,REP,710006,4,6,24,34,
Tillman,Insurance Commissioner,Bill Viner,REP,710006,0,2,6,8,
Tillman,Insurance Commissioner,John Doak,REP,710006,4,4,23,31,
Tillman,Corporation Commissioner,Todd Hiett,REP,710006,4,2,21,27,
Tillman,Corporation Commissioner,Cliff Branan,REP,710006,0,4,12,16,
Tillman,U.S. Senate,Evelyn Rogers,REP,710006,0,2,1,3,
Tillman,U.S. Senate,Rob Moye,REP,710006,0,0,0,0,
Tillman,U.S. Senate,D. Jean Mcbride-Samuels,REP,710006,0,0,0,0,
Tillman,U.S. Senate,Jim Inhofe,REP,710006,4,4,36,44,
Tillman,U.S. Senate,Erick Paul Wyatt,REP,710006,0,0,0,0,
Tillman,U.S. Senate,Andy Craig,REP,710006,0,0,1,1,
Tillman,U.S. Senate,T. Shannon,REP,710006,0,6,24,30,
Tillman,U.S. Senate,Randy Brogdon,REP,710006,2,0,0,2,
Tillman,U.S. Senate,Eric Mccray,REP,710006,0,0,0,0,
Tillman,U.S. Senate,Kevin Crow,REP,710006,0,0,0,0,
Tillman,U.S. Senate,James Lankford,REP,710006,2,0,11,13,
Tillman,U.S. Senate,Jason Weger,REP,710006,0,0,0,0,
Tillman,U.S. House,Anna Flatt,REP,710006,0,0,2,2,04
Tillman,U.S. House,Tom Cole,REP,710006,4,6,34,44,04
Tillman,State House,Jeff Coody,REP,710006,0,3,14,17,63
Tillman,State House,Hurchel Trey Caldwell,REP,710006,0,0,6,6,63
Tillman,State House,Greg Howard,REP,710006,4,3,18,25,63
Tillman,Superintendent of Public Instruction,John Cox,DEM,710007,0,0,31,31,
Tillman,Superintendent of Public Instruction,Jack Jr.,DEM,710007,0,0,27,27,
Tillman,Superintendent of Public Instruction,Ivan Holmes,DEM,710007,0,0,26,26,
Tillman,Superintendent of Public Instruction,Freda Deskin,DEM,710007,0,0,23,23,
Tillman,U.S. Senate,Patrick Michael Hayes,DEM,710007,0,0,41,41,
Tillman,U.S. Senate,Jim Rogers,DEM,710007,0,0,31,31,
Tillman,U.S. Senate,Connie Johnson,DEM,710007,0,0,34,34,
Tillman,U.S. House,Bert Smith,DEM,710007,0,0,97,97,04
Tillman,U.S. House,Tae Si,DEM,710007,0,0,7,7,04
Tillman,State House,B. L. Cozad Jr,DEM,710007,0,0,40,40,63
Tillman,State House,Juan Rodriguez,DEM,710007,0,0,63,63,63
Tillman,Governor,Dax Ewbank,REP,710007,0,0,7,7,
Tillman,Governor,Chad Moody,REP,710007,0,1,18,19,
Tillman,Governor,Mary Fallin,REP,710007,2,1,75,78,
Tillman,Superintendent of Public Instruction,Brian Kelly,REP,710007,2,1,34,37,
Tillman,Superintendent of Public Instruction,Janet Costello Barresi,REP,710007,0,0,12,12,
Tillman,Superintendent of Public Instruction,Joy Hofmeister,REP,710007,0,1,50,51,
Tillman,Insurance Commissioner,Bill Viner,REP,710007,2,2,27,31,
Tillman,Insurance Commissioner,John Doak,REP,710007,0,0,56,56,
Tillman,Corporation Commissioner,Todd Hiett,REP,710007,2,1,48,51,
Tillman,Corporation Commissioner,Cliff Branan,REP,710007,0,1,36,37,
Tillman,U.S. Senate,Evelyn Rogers,REP,710007,0,0,2,2,
Tillman,U.S. Senate,Rob Moye,REP,710007,0,0,3,3,
Tillman,U.S. Senate,D. Jean Mcbride-Samuels,REP,710007,0,0,7,7,
Tillman,U.S. Senate,Jim Inhofe,REP,710007,0,1,74,75,
Tillman,U.S. Senate,Erick Paul Wyatt,REP,710007,2,1,9,12,
Tillman,U.S. Senate,Andy Craig,REP,710007,0,0,2,2,
Tillman,U.S. Senate,T. Shannon,REP,710007,2,2,64,68,
Tillman,U.S. Senate,Randy Brogdon,REP,710007,0,0,4,4,
Tillman,U.S. Senate,Eric Mccray,REP,710007,0,0,1,1,
Tillman,U.S. Senate,Kevin Crow,REP,710007,0,0,1,1,
Tillman,U.S. Senate,James Lankford,REP,710007,0,0,21,21,
Tillman,U.S. Senate,Jason Weger,REP,710007,0,0,6,6,
Tillman,U.S. House,Anna Flatt,REP,710007,2,1,17,20,04
Tillman,U.S. House,Tom Cole,REP,710007,0,1,82,83,04
Tillman,State House,Jeff Coody,REP,710007,2,2,96,100,63
Tillman,State House,Hurchel Trey Caldwell,REP,710007,0,0,0,0,63
Tillman,State House,Greg Howard,REP,710007,0,0,10,10,63
Tillman,Superintendent of Public Instruction,John Cox,DEM,710009,0,6,12,18,
Tillman,Superintendent of Public Instruction,Jack Jr.,DEM,710009,0,0,10,10,
Tillman,Superintendent of Public Instruction,Ivan Holmes,DEM,710009,0,0,4,4,
Tillman,Superintendent of Public Instruction,Freda Deskin,DEM,710009,0,2,6,8,
Tillman,U.S. Senate,Patrick Michael Hayes,DEM,710009,0,2,9,11,
Tillman,U.S. Senate,Jim Rogers,DEM,710009,0,4,13,17,
Tillman,U.S. Senate,Connie Johnson,DEM,710009,0,2,9,11,
Tillman,U.S. House,Bert Smith,DEM,710009,0,6,30,36,04
Tillman,U.S. House,Tae Si,DEM,710009,0,2,2,4,04
Tillman,State House,B. L. Cozad Jr,DEM,710009,0,4,15,19,63
Tillman,State House,Juan Rodriguez,DEM,710009,0,5,17,22,63
Tillman,Governor,Dax Ewbank,REP,710009,0,0,2,2,
Tillman,Governor,Chad Moody,REP,710009,0,0,6,6,
Tillman,Governor,Mary Fallin,REP,710009,0,2,14,16,
Tillman,Superintendent of Public Instruction,Brian Kelly,REP,710009,0,1,5,6,
Tillman,Superintendent of Public Instruction,Janet Costello Barresi,REP,710009,0,0,1,1,
Tillman,Superintendent of Public Instruction,Joy Hofmeister,REP,710009,0,1,16,17,
Tillman,Insurance Commissioner,Bill Viner,REP,710009,0,0,8,8,
Tillman,Insurance Commissioner,John Doak,REP,710009,0,2,14,16,
Tillman,Corporation Commissioner,Todd Hiett,REP,710009,0,1,14,15,
Tillman,Corporation Commissioner,Cliff Branan,REP,710009,0,1,8,9,
Tillman,U.S. Senate,Evelyn Rogers,REP,710009,0,0,1,1,
Tillman,U.S. Senate,Rob Moye,REP,710009,0,0,0,0,
Tillman,U.S. Senate,D. Jean Mcbride-Samuels,REP,710009,0,0,0,0,
Tillman,U.S. Senate,Jim Inhofe,REP,710009,0,2,19,21,
Tillman,U.S. Senate,Erick Paul Wyatt,REP,710009,0,0,2,2,
Tillman,U.S. Senate,Andy Craig,REP,710009,0,1,2,3,
Tillman,U.S. Senate,T. Shannon,REP,710009,0,1,10,11,
Tillman,U.S. Senate,Randy Brogdon,REP,710009,0,0,0,0,
Tillman,U.S. Senate,Eric Mccray,REP,710009,0,0,0,0,
Tillman,U.S. Senate,Kevin Crow,REP,710009,0,0,0,0,
Tillman,U.S. Senate,James Lankford,REP,710009,0,0,9,9,
Tillman,U.S. Senate,Jason Weger,REP,710009,0,0,1,1,
Tillman,U.S. House,Anna Flatt,REP,710009,0,0,3,3,04
Tillman,U.S. House,Tom Cole,REP,710009,0,2,19,21,04
Tillman,State House,Jeff Coody,REP,710009,0,0,9,9,63
Tillman,State House,Hurchel Trey Caldwell,REP,710009,0,0,0,0,63
Tillman,State House,Greg Howard,REP,710009,0,3,14,17,63
Tillman,Superintendent of Public Instruction,John Cox,DEM,710010,0,2,33,35,
Tillman,Superintendent of Public Instruction,Jack Jr.,DEM,710010,0,2,13,15,
Tillman,Superintendent of Public Instruction,Ivan Holmes,DEM,710010,0,2,7,9,
Tillman,Superintendent of Public Instruction,Freda Deskin,DEM,710010,0,1,14,15,
Tillman,U.S. Senate,Patrick Michael Hayes,DEM,710010,0,2,21,23,
Tillman,U.S. Senate,Jim Rogers,DEM,710010,0,2,28,30,
Tillman,U.S. Senate,Connie Johnson,DEM,710010,0,3,13,16,
Tillman,U.S. House,Bert Smith,DEM,710010,0,6,53,59,04
Tillman,U.S. House,Tae Si,DEM,710010,0,1,9,10,04
Tillman,State House,B. L. Cozad Jr,DEM,710010,0,2,15,17,63
Tillman,State House,Juan Rodriguez,DEM,710010,0,5,52,57,63
Tillman,Governor,Dax Ewbank,REP,710010,0,1,2,3,
Tillman,Governor,Chad Moody,REP,710010,2,1,12,15,
Tillman,Governor,Mary Fallin,REP,710010,0,7,72,79,
Tillman,Superintendent of Public Instruction,Brian Kelly,REP,710010,2,1,19,22,
Tillman,Superintendent of Public Instruction,Janet Costello Barresi,REP,710010,0,3,14,17,
Tillman,Superintendent of Public Instruction,Joy Hofmeister,REP,710010,0,4,50,54,
Tillman,Insurance Commissioner,Bill Viner,REP,710010,0,1,17,18,
Tillman,Insurance Commissioner,John Doak,REP,710010,0,6,58,64,
Tillman,Corporation Commissioner,Todd Hiett,REP,710010,0,4,41,45,
Tillman,Corporation Commissioner,Cliff Branan,REP,710010,2,3,37,42,
Tillman,U.S. Senate,Evelyn Rogers,REP,710010,0,0,4,4,
Tillman,U.S. Senate,Rob Moye,REP,710010,0,0,2,2,
Tillman,U.S. Senate,D. Jean Mcbride-Samuels,REP,710010,0,0,0,0,
Tillman,U.S. Senate,Jim Inhofe,REP,710010,2,9,75,86,
Tillman,U.S. Senate,Erick Paul Wyatt,REP,710010,0,0,4,4,
Tillman,U.S. Senate,Andy Craig,REP,710010,0,0,0,0,
Tillman,U.S. Senate,T. Shannon,REP,710010,0,4,56,60,
Tillman,U.S. Senate,Randy Brogdon,REP,710010,0,0,0,0,
Tillman,U.S. Senate,Eric Mccray,REP,710010,0,0,2,2,
Tillman,U.S. Senate,Kevin Crow,REP,710010,0,0,1,1,
Tillman,U.S. Senate,James Lankford,REP,710010,2,5,28,35,
Tillman,U.S. Senate,Jason Weger,REP,710010,0,0,0,0,
Tillman,U.S. House,Anna Flatt,REP,710010,0,1,11,12,04
Tillman,U.S. House,Tom Cole,REP,710010,2,8,75,85,04
Tillman,State House,Jeff Coody,REP,710010,0,2,27,29,63
Tillman,State House,Hurchel Trey Caldwell,REP,710010,0,2,0,2,63
Tillman,State House,Greg Howard,REP,710010,2,5,62,69,63
Tillman,Superintendent of Public Instruction,John Cox,DEM,710012,0,1,6,7,
Tillman,Superintendent of Public Instruction,Jack Jr.,DEM,710012,0,0,6,6,
Tillman,Superintendent of Public Instruction,Ivan Holmes,DEM,710012,0,1,3,4,
Tillman,Superintendent of Public Instruction,Freda Deskin,DEM,710012,1,2,6,9,
Tillman,U.S. Senate,Patrick Michael Hayes,DEM,710012,0,2,3,5,
Tillman,U.S. Senate,Jim Rogers,DEM,710012,0,1,7,8,
Tillman,U.S. Senate,Connie Johnson,DEM,710012,1,1,11,13,
Tillman,U.S. House,Bert Smith,DEM,710012,1,4,19,24,04
Tillman,U.S. House,Tae Si,DEM,710012,0,0,1,1,04
Tillman,State House,B. L. Cozad Jr,DEM,710012,0,2,11,13,63
Tillman,State House,Juan Rodriguez,DEM,710012,0,1,7,8,63
Tillman,Governor,Dax Ewbank,REP,710012,0,0,0,0,
Tillman,Governor,Chad Moody,REP,710012,0,1,0,1,
Tillman,Governor,Mary Fallin,REP,710012,0,4,22,26,
Tillman,Superintendent of Public Instruction,Brian Kelly,REP,710012,0,0,4,4,
Tillman,Superintendent of Public Instruction,Janet Costello Barresi,REP,710012,0,2,4,6,
Tillman,Superintendent of Public Instruction,Joy Hofmeister,REP,710012,0,3,11,14,
Tillman,Insurance Commissioner,Bill Viner,REP,710012,0,0,0,0,
Tillman,Insurance Commissioner,John Doak,REP,710012,0,5,17,22,
Tillman,Corporation Commissioner,Todd Hiett,REP,710012,0,3,11,14,
Tillman,Corporation Commissioner,Cliff Branan,REP,710012,0,2,8,10,
Tillman,U.S. Senate,Evelyn Rogers,REP,710012,0,0,0,0,
Tillman,U.S. Senate,Rob Moye,REP,710012,0,0,0,0,
Tillman,U.S. Senate,D. Jean Mcbride-Samuels,REP,710012,0,0,0,0,
Tillman,U.S. Senate,Jim Inhofe,REP,710012,0,5,20,25,
Tillman,U.S. Senate,Erick Paul Wyatt,REP,710012,0,0,0,0,
Tillman,U.S. Senate,Andy Craig,REP,710012,0,0,0,0,
Tillman,U.S. Senate,T. Shannon,REP,710012,0,4,13,17,
Tillman,U.S. Senate,Randy Brogdon,REP,710012,0,0,0,0,
Tillman,U.S. Senate,Eric Mccray,REP,710012,0,0,0,0,
Tillman,U.S. Senate,Kevin Crow,REP,710012,0,0,0,0,
Tillman,U.S. Senate,James Lankford,REP,710012,0,1,7,8,
Tillman,U.S. Senate,Jason Weger,REP,710012,0,0,0,0,
Tillman,U.S. House,Anna Flatt,REP,710012,0,1,2,3,04
Tillman,U.S. House,Tom Cole,REP,710012,0,4,19,23,04
Tillman,State House,Jeff Coody,REP,710012,0,1,5,6,63
Tillman,State House,Hurchel Trey Caldwell,REP,710012,0,0,0,0,63
Tillman,State House,Greg Howard,REP,710012,0,4,17,21,63
Tulsa,Superintendent of Public Instruction,John Cox,DEM,720001,0,0,49,49,
Tulsa,Superintendent of Public Instruction,Jack Jr.,DEM,720001,0,0,50,50,
Tulsa,Superintendent of Public Instruction,Ivan Holmes,DEM,720001,0,0,23,23,
Tulsa,Superintendent of Public Instruction,Freda Deskin,DEM,720001,0,0,95,95,
Tulsa,U.S. Senate,Patrick Michael Hayes,DEM,720001,0,0,48,48,
Tulsa,U.S. Senate,Jim Rogers,DEM,720001,0,0,28,28,
Tulsa,U.S. Senate,Connie Johnson,DEM,720001,0,0,140,140,
Tulsa,Governor,Dax Ewbank,REP,720001,0,0,1,1,
Tulsa,Governor,Chad Moody,REP,720001,0,0,1,1,
Tulsa,Governor,Mary Fallin,REP,720001,0,0,7,7,
Tulsa,Superintendent of Public Instruction,Brian Kelly,REP,720001,0,0,3,3,
Tulsa,Superintendent of Public Instruction,Janet Costello Barresi,REP,720001,0,0,1,1,
Tulsa,Superintendent of Public Instruction,Joy Hofmeister,REP,720001,0,0,6,6,
Tulsa,Insurance Commissioner,Bill Viner,REP,720001,0,0,1,1,
Tulsa,Insurance Commissioner,John Doak,REP,720001,0,0,8,8,
Tulsa,Corporation Commissioner,Todd Hiett,REP,720001,0,0,7,7,
Tulsa,Corporation Commissioner,Cliff Branan,REP,720001,0,0,3,3,
Tulsa,U.S. Senate,Evelyn Rogers,REP,720001,0,0,1,1,
Tulsa,U.S. Senate,Rob Moye,REP,720001,0,0,1,1,
Tulsa,U.S. Senate,D. Jean Mcbride-Samuels,REP,720001,0,0,0,0,
Tulsa,U.S. Senate,Jim Inhofe,REP,720001,0,0,8,8,
Tulsa,U.S. Senate,Erick Paul Wyatt,REP,720001,0,0,0,0,
Tulsa,U.S. Senate,Andy Craig,REP,720001,0,0,0,0,
Tulsa,U.S. Senate,T. Shannon,REP,720001,0,0,5,5,
Tulsa,U.S. Senate,Randy Brogdon,REP,720001,0,0,1,1,
Tulsa,U.S. Senate,Eric Mccray,REP,720001,0,0,0,0,
Tulsa,U.S. Senate,Kevin Crow,REP,720001,0,0,0,0,
Tulsa,U.S. Senate,James Lankford,REP,720001,0,0,4,4,
Tulsa,U.S. Senate,Jason Weger,REP,720001,0,0,0,0,
Tulsa,Superintendent of Public Instruction,John Cox,DEM,720002,0,0,29,29,
Tulsa,Superintendent of Public Instruction,Jack Jr.,DEM,720002,0,0,42,42,
Tulsa,Superintendent of Public Instruction,Ivan Holmes,DEM,720002,0,0,23,23,
Tulsa,Superintendent of Public Instruction,Freda Deskin,DEM,720002,0,0,72,72,
Tulsa,U.S. Senate,Patrick Michael Hayes,DEM,720002,0,0,27,27,
Tulsa,U.S. Senate,Jim Rogers,DEM,720002,0,0,26,26,
Tulsa,U.S. Senate,Connie Johnson,DEM,720002,0,0,115,115,
Tulsa,Governor,Dax Ewbank,REP,720002,0,0,2,2,
Tulsa,Governor,Chad Moody,REP,720002,0,0,2,2,
Tulsa,Governor,Mary Fallin,REP,720002,0,0,9,9,
Tulsa,Superintendent of Public Instruction,Brian Kelly,REP,720002,0,0,5,5,
Tulsa,Superintendent of Public Instruction,Janet Costello Barresi,REP,720002,0,0,0,0,
Tulsa,Superintendent of Public Instruction,Joy Hofmeister,REP,720002,0,0,6,6,
Tulsa,Insurance Commissioner,Bill Viner,REP,720002,0,0,0,0,
Tulsa,Insurance Commissioner,John Doak,REP,720002,0,0,11,11,
Tulsa,Corporation Commissioner,Todd Hiett,REP,720002,0,0,7,7,
Tulsa,Corporation Commissioner,Cliff Branan,REP,720002,0,0,4,4,
Tulsa,U.S. Senate,Evelyn Rogers,REP,720002,0,0,1,1,
Tulsa,U.S. Senate,Rob Moye,REP,720002,0,0,0,0,
Tulsa,U.S. Senate,D. Jean Mcbride-Samuels,REP,720002,0,0,0,0,
Tulsa,U.S. Senate,Jim Inhofe,REP,720002,0,0,8,8,
Tulsa,U.S. Senate,Erick Paul Wyatt,REP,720002,0,0,2,2,
Tulsa,U.S. Senate,Andy Craig,REP,720002,0,0,1,1,
Tulsa,U.S. Senate,T. Shannon,REP,720002,0,0,4,4,
Tulsa,U.S. Senate,Randy Brogdon,REP,720002,0,0,1,1,
Tulsa,U.S. Senate,Eric Mccray,REP,720002,0,0,0,0,
Tulsa,U.S. Senate,Kevin Crow,REP,720002,0,0,0,0,
Tulsa,U.S. Senate,James Lankford,REP,720002,0,0,7,7,
Tulsa,U.S. Senate,Jason Weger,REP,720002,0,0,0,0,
Tulsa,Superintendent of Public Instruction,John Cox,DEM,720003,0,0,11,11,
Tulsa,Superintendent of Public Instruction,Jack Jr.,DEM,720003,0,0,3,3,
Tulsa,Superintendent of Public Instruction,Ivan Holmes,DEM,720003,0,0,1,1,
Tulsa,Superintendent of Public Instruction,Freda Deskin,DEM,720003,0,0,17,17,
Tulsa,U.S. Senate,Patrick Michael Hayes,DEM,720003,0,0,7,7,
Tulsa,U.S. Senate,Jim Rogers,DEM,720003,0,0,10,10,
Tulsa,U.S. Senate,Connie Johnson,DEM,720003,0,0,14,14,
Tulsa,Governor,Dax Ewbank,REP,720003,0,0,3,3,
Tulsa,Governor,Chad Moody,REP,720003,0,0,4,4,
Tulsa,Governor,Mary Fallin,REP,720003,0,0,32,32,
Tulsa,Superintendent of Public Instruction,Brian Kelly,REP,720003,0,0,8,8,
Tulsa,Superintendent of Public Instruction,Janet Costello Barresi,REP,720003,0,0,7,7,
Tulsa,Superintendent of Public Instruction,Joy Hofmeister,REP,720003,0,0,24,24,
Tulsa,Insurance Commissioner,Bill Viner,REP,720003,0,0,13,13,
Tulsa,Insurance Commissioner,John Doak,REP,720003,0,0,25,25,
Tulsa,Corporation Commissioner,Todd Hiett,REP,720003,0,0,24,24,
Tulsa,Corporation Commissioner,Cliff Branan,REP,720003,0,0,14,14,
Tulsa,U.S. Senate,Evelyn Rogers,REP,720003,0,0,4,4,
Tulsa,U.S. Senate,Rob Moye,REP,720003,0,0,0,0,
Tulsa,U.S. Senate,D. Jean Mcbride-Samuels,REP,720003,0,0,0,0,
Tulsa,U.S. Senate,Jim Inhofe,REP,720003,0,0,32,32,
Tulsa,U.S. Senate,Erick Paul Wyatt,REP,720003,0,0,3,3,
Tulsa,U.S. Senate,Andy Craig,REP,720003,0,0,0,0,
Tulsa,U.S. Senate,T. Shannon,REP,720003,0,0,14,14,
Tulsa,U.S. Senate,Randy Brogdon,REP,720003,0,0,5,5,
Tulsa,U.S. Senate,Eric Mccray,REP,720003,0,0,2,2,
Tulsa,U.S. Senate,Kevin Crow,REP,720003,0,0,0,0,
Tulsa,U.S. Senate,James Lankford,REP,720003,0,0,17,17,
Tulsa,U.S. Senate,Jason Weger,REP,720003,0,0,1,1,
Tulsa,Superintendent of Public Instruction,John Cox,DEM,720004,0,0,65,65,
Tulsa,Superintendent of Public Instruction,Jack Jr.,DEM,720004,0,0,54,54,
Tulsa,Superintendent of Public Instruction,Ivan Holmes,DEM,720004,0,0,29,29,
Tulsa,Superintendent of Public Instruction,Freda Deskin,DEM,720004,0,0,112,112,
Tulsa,U.S. Senate,Patrick Michael Hayes,DEM,720004,0,0,42,42,
Tulsa,U.S. Senate,Jim Rogers,DEM,720004,0,0,31,31,
Tulsa,U.S. Senate,Connie Johnson,DEM,720004,0,0,189,189,
Tulsa,Governor,Dax Ewbank,REP,720004,0,0,1,1,
Tulsa,Governor,Chad Moody,REP,720004,0,0,2,2,
Tulsa,Governor,Mary Fallin,REP,720004,0,0,10,10,
Tulsa,Superintendent of Public Instruction,Brian Kelly,REP,720004,0,0,6,6,
Tulsa,Superintendent of Public Instruction,Janet Costello Barresi,REP,720004,0,0,2,2,
Tulsa,Superintendent of Public Instruction,Joy Hofmeister,REP,720004,0,0,6,6,
Tulsa,Insurance Commissioner,Bill Viner,REP,720004,0,0,5,5,
Tulsa,Insurance Commissioner,John Doak,REP,720004,0,0,8,8,
Tulsa,Corporation Commissioner,Todd Hiett,REP,720004,0,0,7,7,
Tulsa,Corporation Commissioner,Cliff Branan,REP,720004,0,0,6,6,
Tulsa,U.S. Senate,Evelyn Rogers,REP,720004,0,0,5,5,
Tulsa,U.S. Senate,Rob Moye,REP,720004,0,0,0,0,
Tulsa,U.S. Senate,D. Jean Mcbride-Samuels,REP,720004,0,0,0,0,
Tulsa,U.S. Senate,Jim Inhofe,REP,720004,0,0,9,9,
Tulsa,U.S. Senate,Erick Paul Wyatt,REP,720004,0,0,0,0,
Tulsa,U.S. Senate,Andy Craig,REP,720004,0,0,0,0,
Tulsa,U.S. Senate,T. Shannon,REP,720004,0,0,8,8,
Tulsa,U.S. Senate,Randy Brogdon,REP,720004,0,0,0,0,
Tulsa,U.S. Senate,Eric Mccray,REP,720004,0,0,0,0,
Tulsa,U.S. Senate,Kevin Crow,REP,720004,0,0,1,1,
Tulsa,U.S. Senate,James Lankford,REP,720004,0,0,5,5,
Tulsa,U.S. Senate,Jason Weger,REP,720004,0,0,0,0,
Tulsa,Superintendent of Public Instruction,John Cox,DEM,720005,0,0,23,23,
Tulsa,Superintendent of Public Instruction,Jack Jr.,DEM,720005,0,0,29,29,
Tulsa,Superintendent of Public Instruction,Ivan Holmes,DEM,720005,0,0,20,20,
Tulsa,Superintendent of Public Instruction,Freda Deskin,DEM,720005,0,0,43,43,
Tulsa,U.S. Senate,Patrick Michael Hayes,DEM,720005,0,0,13,13,
Tulsa,U.S. Senate,Jim Rogers,DEM,720005,0,0,18,18,
Tulsa,U.S. Senate,Connie Johnson,DEM,720005,0,0,84,84,
Tulsa,Governor,Dax Ewbank,REP,720005,0,0,1,1,
Tulsa,Governor,Chad Moody,REP,720005,0,0,5,5,
Tulsa,Governor,Mary Fallin,REP,720005,0,0,2,2,
Tulsa,Superintendent of Public Instruction,Brian Kelly,REP,720005,0,0,1,1,
Tulsa,Superintendent of Public Instruction,Janet Costello Barresi,REP,720005,0,0,1,1,
Tulsa,Superintendent of Public Instruction,Joy Hofmeister,REP,720005,0,0,6,6,
Tulsa,Insurance Commissioner,Bill Viner,REP,720005,0,0,4,4,
Tulsa,Insurance Commissioner,John Doak,REP,720005,0,0,4,4,
Tulsa,Corporation Commissioner,Todd Hiett,REP,720005,0,0,5,5,
Tulsa,Corporation Commissioner,Cliff Branan,REP,720005,0,0,2,2,
Tulsa,U.S. Senate,Evelyn Rogers,REP,720005,0,0,1,1,
Tulsa,U.S. Senate,Rob Moye,REP,720005,0,0,0,0,
Tulsa,U.S. Senate,D. Jean Mcbride-Samuels,REP,720005,0,0,0,0,
Tulsa,U.S. Senate,Jim Inhofe,REP,720005,0,0,4,4,
Tulsa,U.S. Senate,Erick Paul Wyatt,REP,720005,0,0,3,3,
Tulsa,U.S. Senate,Andy Craig,REP,720005,0,0,0,0,
Tulsa,U.S. Senate,T. Shannon,REP,720005,0,0,4,4,
Tulsa,U.S. Senate,Randy Brogdon,REP,720005,0,0,0,0,
Tulsa,U.S. Senate,Eric Mccray,REP,720005,0,0,0,0,
Tulsa,U.S. Senate,Kevin Crow,REP,720005,0,0,0,0,
Tulsa,U.S. Senate,James Lankford,REP,720005,0,0,3,3,
Tulsa,U.S. Senate,Jason Weger,REP,720005,0,0,1,1,
Tulsa,Superintendent of Public Instruction,John Cox,DEM,720006,0,0,63,63,
Tulsa,Superintendent of Public Instruction,Jack Jr.,DEM,720006,0,0,80,80,
Tulsa,Superintendent of Public Instruction,Ivan Holmes,DEM,720006,0,0,51,51,
Tulsa,Superintendent of Public Instruction,Freda Deskin,DEM,720006,0,0,141,141,
Tulsa,U.S. Senate,Patrick Michael Hayes,DEM,720006,0,0,63,63,
Tulsa,U.S. Senate,Jim Rogers,DEM,720006,0,0,31,31,
Tulsa,U.S. Senate,Connie Johnson,DEM,720006,0,0,239,239,
Tulsa,Governor,Dax Ewbank,REP,720006,0,0,1,1,
Tulsa,Governor,Chad Moody,REP,720006,0,0,2,2,
Tulsa,Governor,Mary Fallin,REP,720006,0,0,3,3,
Tulsa,Superintendent of Public Instruction,Brian Kelly,REP,720006,0,0,0,0,
Tulsa,Superintendent of Public Instruction,Janet Costello Barresi,REP,720006,0,0,2,2,
Tulsa,Superintendent of Public Instruction,Joy Hofmeister,REP,720006,0,0,3,3,
Tulsa,Insurance Commissioner,Bill Viner,REP,720006,0,0,1,1,
Tulsa,Insurance Commissioner,John Doak,REP,720006,0,0,4,4,
Tulsa,Corporation Commissioner,Todd Hiett,REP,720006,0,0,4,4,
Tulsa,Corporation Commissioner,Cliff Branan,REP,720006,0,0,1,1,
Tulsa,U.S. Senate,Evelyn Rogers,REP,720006,0,0,2,2,
Tulsa,U.S. Senate,Rob Moye,REP,720006,0,0,0,0,
Tulsa,U.S. Senate,D. Jean Mcbride-Samuels,REP,720006,0,0,0,0,
Tulsa,U.S. Senate,Jim Inhofe,REP,720006,0,0,3,3,
Tulsa,U.S. Senate,Erick Paul Wyatt,REP,720006,0,0,0,0,
Tulsa,U.S. Senate,Andy Craig,REP,720006,0,0,0,0,
Tulsa,U.S. Senate,T. Shannon,REP,720006,0,0,4,4,
Tulsa,U.S. Senate,Randy Brogdon,REP,720006,0,0,0,0,
Tulsa,U.S. Senate,Eric Mccray,REP,720006,0,0,0,0,
Tulsa,U.S. Senate,Kevin Crow,REP,720006,0,0,0,0,
Tulsa,U.S. Senate,James Lankford,REP,720006,0,0,1,1,
Tulsa,U.S. Senate,Jason Weger,REP,720006,0,0,0,0,
Tulsa,Superintendent of Public Instruction,John Cox,DEM,720007,0,0,32,32,
Tulsa,Superintendent of Public Instruction,Jack Jr.,DEM,720007,0,0,50,50,
Tulsa,Superintendent of Public Instruction,Ivan Holmes,DEM,720007,0,0,17,17,
Tulsa,Superintendent of Public Instruction,Freda Deskin,DEM,720007,0,0,76,76,
Tulsa,U.S. Senate,Patrick Michael Hayes,DEM,720007,0,0,28,28,
Tulsa,U.S. Senate,Jim Rogers,DEM,720007,0,0,15,15,
Tulsa,U.S. Senate,Connie Johnson,DEM,720007,0,0,128,128,
Tulsa,Governor,Dax Ewbank,REP,720007,0,0,4,4,
Tulsa,Governor,Chad Moody,REP,720007,0,0,7,7,
Tulsa,Governor,Mary Fallin,REP,720007,0,0,9,9,
Tulsa,Superintendent of Public Instruction,Brian Kelly,REP,720007,0,0,2,2,
Tulsa,Superintendent of Public Instruction,Janet Costello Barresi,REP,720007,0,0,3,3,
Tulsa,Superintendent of Public Instruction,Joy Hofmeister,REP,720007,0,0,15,15,
Tulsa,Insurance Commissioner,Bill Viner,REP,720007,0,0,4,4,
Tulsa,Insurance Commissioner,John Doak,REP,720007,0,0,13,13,
Tulsa,Corporation Commissioner,Todd Hiett,REP,720007,0,0,11,11,
Tulsa,Corporation Commissioner,Cliff Branan,REP,720007,0,0,6,6,
Tulsa,U.S. Senate,Evelyn Rogers,REP,720007,0,0,3,3,
Tulsa,U.S. Senate,Rob Moye,REP,720007,0,0,1,1,
Tulsa,U.S. Senate,D. Jean Mcbride-Samuels,REP,720007,0,0,1,1,
Tulsa,U.S. Senate,Jim Inhofe,REP,720007,0,0,13,13,
Tulsa,U.S. Senate,Erick Paul Wyatt,REP,720007,0,0,1,1,
Tulsa,U.S. Senate,Andy Craig,REP,720007,0,0,0,0,
Tulsa,U.S. Senate,T. Shannon,REP,720007,0,0,7,7,
Tulsa,U.S. Senate,Randy Brogdon,REP,720007,0,0,0,0,
Tulsa,U.S. Senate,Eric Mccray,REP,720007,0,0,0,0,
Tulsa,U.S. Senate,Kevin Crow,REP,720007,0,0,0,0,
Tulsa,U.S. Senate,James Lankford,REP,720007,0,0,10,10,
Tulsa,U.S. Senate,Jason Weger,REP,720007,0,0,3,3,
Tulsa,Superintendent of Public Instruction,John Cox,DEM,720008,0,0,19,19,
Tulsa,Superintendent of Public Instruction,Jack Jr.,DEM,720008,0,0,28,28,
Tulsa,Superintendent of Public Instruction,Ivan Holmes,DEM,720008,0,0,12,12,
Tulsa,Superintendent of Public Instruction,Freda Deskin,DEM,720008,0,0,48,48,
Tulsa,U.S. Senate,Patrick Michael Hayes,DEM,720008,0,0,24,24,
Tulsa,U.S. Senate,Jim Rogers,DEM,720008,0,0,12,12,
Tulsa,U.S. Senate,Connie Johnson,DEM,720008,0,0,70,70,
Tulsa,Governor,Dax Ewbank,REP,720008,0,0,0,0,
Tulsa,Governor,Chad Moody,REP,720008,0,0,5,5,
Tulsa,Governor,Mary Fallin,REP,720008,0,0,12,12,
Tulsa,Superintendent of Public Instruction,Brian Kelly,REP,720008,0,0,4,4,
Tulsa,Superintendent of Public Instruction,Janet Costello Barresi,REP,720008,0,0,2,2,
Tulsa,Superintendent of Public Instruction,Joy Hofmeister,REP,720008,0,0,11,11,
Tulsa,Insurance Commissioner,Bill Viner,REP,720008,0,0,8,8,
Tulsa,Insurance Commissioner,John Doak,REP,720008,0,0,9,9,
Tulsa,Corporation Commissioner,Todd Hiett,REP,720008,0,0,5,5,
Tulsa,Corporation Commissioner,Cliff Branan,REP,720008,0,0,12,12,
Tulsa,U.S. Senate,Evelyn Rogers,REP,720008,0,0,2,2,
Tulsa,U.S. Senate,Rob Moye,REP,720008,0,0,0,0,
Tulsa,U.S. Senate,D. Jean Mcbride-Samuels,REP,720008,0,0,1,1,
Tulsa,U.S. Senate,Jim Inhofe,REP,720008,0,0,13,13,
Tulsa,U.S. Senate,Erick Paul Wyatt,REP,720008,0,0,1,1,
Tulsa,U.S. Senate,Andy Craig,REP,720008,0,0,0,0,
Tulsa,U.S. Senate,T. Shannon,REP,720008,0,0,8,8,
Tulsa,U.S. Senate,Randy Brogdon,REP,720008,0,0,1,1,
Tulsa,U.S. Senate,Eric Mccray,REP,720008,0,0,0,0,
Tulsa,U.S. Senate,Kevin Crow,REP,720008,0,0,0,0,
Tulsa,U.S. Senate,James Lankford,REP,720008,0,0,8,8,
Tulsa,U.S. Senate,Jason Weger,REP,720008,0,0,0,0,
Tulsa,Superintendent of Public Instruction,John Cox,DEM,720009,0,0,3,3,
Tulsa,Superintendent of Public Instruction,Jack Jr.,DEM,720009,0,0,6,6,
Tulsa,Superintendent of Public Instruction,Ivan Holmes,DEM,720009,0,0,9,9,
Tulsa,Superintendent of Public Instruction,Freda Deskin,DEM,720009,0,0,11,11,
Tulsa,U.S. Senate,Patrick Michael Hayes,DEM,720009,0,0,3,3,
Tulsa,U.S. Senate,Jim Rogers,DEM,720009,0,0,2,2,
Tulsa,U.S. Senate,Connie Johnson,DEM,720009,0,0,22,22,
Tulsa,Governor,Dax Ewbank,REP,720009,0,0,0,0,
Tulsa,Governor,Chad Moody,REP,720009,0,0,0,0,
Tulsa,Governor,Mary Fallin,REP,720009,0,0,4,4,
Tulsa,Superintendent of Public Instruction,Brian Kelly,REP,720009,0,0,1,1,
Tulsa,Superintendent of Public Instruction,Janet Costello Barresi,REP,720009,0,0,1,1,
Tulsa,Superintendent of Public Instruction,Joy Hofmeister,REP,720009,0,0,1,1,
Tulsa,Insurance Commissioner,Bill Viner,REP,720009,0,0,0,0,
Tulsa,Insurance Commissioner,John Doak,REP,720009,0,0,3,3,
Tulsa,Corporation Commissioner,Todd Hiett,REP,720009,0,0,1,1,
Tulsa,Corporation Commissioner,Cliff Branan,REP,720009,0,0,2,2,
Tulsa,U.S. Senate,Evelyn Rogers,REP,720009,0,0,0,0,
Tulsa,U.S. Senate,Rob Moye,REP,720009,0,0,0,0,
Tulsa,U.S. Senate,D. Jean Mcbride-Samuels,REP,720009,0,0,0,0,
Tulsa,U.S. Senate,Jim Inhofe,REP,720009,0,0,3,3,
Tulsa,U.S. Senate,Erick Paul Wyatt,REP,720009,0,0,1,1,
Tulsa,U.S. Senate,Andy Craig,REP,720009,0,0,0,0,
Tulsa,U.S. Senate,T. Shannon,REP,720009,0,0,1,1,
Tulsa,U.S. Senate,Randy Brogdon,REP,720009,0,0,1,1,
Tulsa,U.S. Senate,Eric Mccray,REP,720009,0,0,0,0,
Tulsa,U.S. Senate,Kevin Crow,REP,720009,0,0,0,0,
Tulsa,U.S. Senate,James Lankford,REP,720009,0,0,2,2,
Tulsa,U.S. Senate,Jason Weger,REP,720009,0,0,0,0,
Tulsa,Superintendent of Public Instruction,John Cox,DEM,720010,0,0,45,45,
Tulsa,Superintendent of Public Instruction,Jack Jr.,DEM,720010,0,0,37,37,
Tulsa,Superintendent of Public Instruction,Ivan Holmes,DEM,720010,0,0,22,22,
Tulsa,Superintendent of Public Instruction,Freda Deskin,DEM,720010,0,0,55,55,
Tulsa,U.S. Senate,Patrick Michael Hayes,DEM,720010,0,0,25,25,
Tulsa,U.S. Senate,Jim Rogers,DEM,720010,0,0,21,21,
Tulsa,U.S. Senate,Connie Johnson,DEM,720010,0,0,119,119,
Tulsa,Governor,Dax Ewbank,REP,720010,0,0,0,0,
Tulsa,Governor,Chad Moody,REP,720010,0,0,4,4,
Tulsa,Governor,Mary Fallin,REP,720010,0,0,9,9,
Tulsa,Superintendent of Public Instruction,Brian Kelly,REP,720010,0,0,5,5,
Tulsa,Superintendent of Public Instruction,Janet Costello Barresi,REP,720010,0,0,3,3,
Tulsa,Superintendent of Public Instruction,Joy Hofmeister,REP,720010,0,0,4,4,
Tulsa,Insurance Commissioner,Bill Viner,REP,720010,0,0,1,1,
Tulsa,Insurance Commissioner,John Doak,REP,720010,0,0,11,11,
Tulsa,Corporation Commissioner,Todd Hiett,REP,720010,0,0,7,7,
Tulsa,Corporation Commissioner,Cliff Branan,REP,720010,0,0,4,4,
Tulsa,U.S. Senate,Evelyn Rogers,REP,720010,0,0,2,2,
Tulsa,U.S. Senate,Rob Moye,REP,720010,0,0,0,0,
Tulsa,U.S. Senate,D. Jean Mcbride-Samuels,REP,720010,0,0,0,0,
Tulsa,U.S. Senate,Jim Inhofe,REP,720010,0,0,10,10,
Tulsa,U.S. Senate,Erick Paul Wyatt,REP,720010,0,0,0,0,
Tulsa,U.S. Senate,Andy Craig,REP,720010,0,0,0,0,
Tulsa,U.S. Senate,T. Shannon,REP,720010,0,0,4,4,
Tulsa,U.S. Senate,Randy Brogdon,REP,720010,0,0,3,3,
Tulsa,U.S. Senate,Eric Mccray,REP,720010,0,0,0,0,
Tulsa,U.S. Senate,Kevin Crow,REP,720010,0,0,0,0,
Tulsa,U.S. Senate,James Lankford,REP,720010,0,0,5,5,
Tulsa,U.S. Senate,Jason Weger,REP,720010,0,0,0,0,
Tulsa,Superintendent of Public Instruction,John Cox,DEM,720011,0,0,17,17,
Tulsa,Superintendent of Public Instruction,Jack Jr.,DEM,720011,0,0,11,11,
Tulsa,Superintendent of Public Instruction,Ivan Holmes,DEM,720011,0,0,3,3,
Tulsa,Superintendent of Public Instruction,Freda Deskin,DEM,720011,0,0,24,24,
Tulsa,U.S. Senate,Patrick Michael Hayes,DEM,720011,0,0,11,11,
Tulsa,U.S. Senate,Jim Rogers,DEM,720011,0,0,18,18,
Tulsa,U.S. Senate,Connie Johnson,DEM,720011,0,0,25,25,
Tulsa,Governor,Dax Ewbank,REP,720011,0,0,6,6,
Tulsa,Governor,Chad Moody,REP,720011,0,0,5,5,
Tulsa,Governor,Mary Fallin,REP,720011,0,0,23,23,
Tulsa,Superintendent of Public Instruction,Brian Kelly,REP,720011,0,0,12,12,
Tulsa,Superintendent of Public Instruction,Janet Costello Barresi,REP,720011,0,0,6,6,
Tulsa,Superintendent of Public Instruction,Joy Hofmeister,REP,720011,0,0,15,15,
Tulsa,Insurance Commissioner,Bill Viner,REP,720011,0,0,11,11,
Tulsa,Insurance Commissioner,John Doak,REP,720011,0,0,23,23,
Tulsa,Corporation Commissioner,Todd Hiett,REP,720011,0,0,16,16,
Tulsa,Corporation Commissioner,Cliff Branan,REP,720011,0,0,16,16,
Tulsa,U.S. Senate,Evelyn Rogers,REP,720011,0,0,2,2,
Tulsa,U.S. Senate,Rob Moye,REP,720011,0,0,1,1,
Tulsa,U.S. Senate,D. Jean Mcbride-Samuels,REP,720011,0,0,1,1,
Tulsa,U.S. Senate,Jim Inhofe,REP,720011,0,0,26,26,
Tulsa,U.S. Senate,Erick Paul Wyatt,REP,720011,0,0,3,3,
Tulsa,U.S. Senate,Andy Craig,REP,720011,0,0,0,0,
Tulsa,U.S. Senate,T. Shannon,REP,720011,0,0,20,20,
Tulsa,U.S. Senate,Randy Brogdon,REP,720011,0,0,4,4,
Tulsa,U.S. Senate,Eric Mccray,REP,720011,0,0,0,0,
Tulsa,U.S. Senate,Kevin Crow,REP,720011,0,0,1,1,
Tulsa,U.S. Senate,James Lankford,REP,720011,0,0,9,9,
Tulsa,U.S. Senate,Jason Weger,REP,720011,0,0,0,0,
Tulsa,Superintendent of Public Instruction,John Cox,DEM,720012,0,0,14,14,
Tulsa,Superintendent of Public Instruction,Jack Jr.,DEM,720012,0,0,14,14,
Tulsa,Superintendent of Public Instruction,Ivan Holmes,DEM,720012,0,0,7,7,
Tulsa,Superintendent of Public Instruction,Freda Deskin,DEM,720012,0,0,25,25,
Tulsa,U.S. Senate,Patrick Michael Hayes,DEM,720012,0,0,14,14,
Tulsa,U.S. Senate,Jim Rogers,DEM,720012,0,0,19,19,
Tulsa,U.S. Senate,Connie Johnson,DEM,720012,0,0,29,29,
Tulsa,Governor,Dax Ewbank,REP,720012,0,0,5,5,
Tulsa,Governor,Chad Moody,REP,720012,0,0,4,4,
Tulsa,Governor,Mary Fallin,REP,720012,0,0,19,19,
Tulsa,Superintendent of Public Instruction,Brian Kelly,REP,720012,0,0,11,11,
Tulsa,Superintendent of Public Instruction,Janet Costello Barresi,REP,720012,0,0,6,6,
Tulsa,Superintendent of Public Instruction,Joy Hofmeister,REP,720012,0,0,11,11,
Tulsa,Insurance Commissioner,Bill Viner,REP,720012,0,0,6,6,
Tulsa,Insurance Commissioner,John Doak,REP,720012,0,0,20,20,
Tulsa,Corporation Commissioner,Todd Hiett,REP,720012,0,0,16,16,
Tulsa,Corporation Commissioner,Cliff Branan,REP,720012,0,0,10,10,
Tulsa,U.S. Senate,Evelyn Rogers,REP,720012,0,0,2,2,
Tulsa,U.S. Senate,Rob Moye,REP,720012,0,0,1,1,
Tulsa,U.S. Senate,D. Jean Mcbride-Samuels,REP,720012,0,0,1,1,
Tulsa,U.S. Senate,Jim Inhofe,REP,720012,0,0,24,24,
Tulsa,U.S. Senate,Erick Paul Wyatt,REP,720012,0,0,0,0,
Tulsa,U.S. Senate,Andy Craig,REP,720012,0,0,1,1,
Tulsa,U.S. Senate,T. Shannon,REP,720012,0,0,11,11,
Tulsa,U.S. Senate,Randy Brogdon,REP,720012,0,0,3,3,
Tulsa,U.S. Senate,Eric Mccray,REP,720012,0,0,0,0,
Tulsa,U.S. Senate,Kevin Crow,REP,720012,0,0,0,0,
Tulsa,U.S. Senate,James Lankford,REP,720012,0,0,13,13,
Tulsa,U.S. Senate,Jason Weger,REP,720012,0,0,0,0,
Tulsa,Superintendent of Public Instruction,John Cox,DEM,720013,0,0,70,70,
Tulsa,Superintendent of Public Instruction,Jack Jr.,DEM,720013,0,0,63,63,
Tulsa,Superintendent of Public Instruction,Ivan Holmes,DEM,720013,0,0,46,46,
Tulsa,Superintendent of Public Instruction,Freda Deskin,DEM,720013,0,0,131,131,
Tulsa,U.S. Senate,Patrick Michael Hayes,DEM,720013,0,0,59,59,
Tulsa,U.S. Senate,Jim Rogers,DEM,720013,0,0,40,40,
Tulsa,U.S. Senate,Connie Johnson,DEM,720013,0,0,222,222,
Tulsa,Governor,Dax Ewbank,REP,720013,0,0,1,1,
Tulsa,Governor,Chad Moody,REP,720013,0,0,4,4,
Tulsa,Governor,Mary Fallin,REP,720013,0,0,6,6,
Tulsa,Superintendent of Public Instruction,Brian Kelly,REP,720013,0,0,4,4,
Tulsa,Superintendent of Public Instruction,Janet Costello Barresi,REP,720013,0,0,2,2,
Tulsa,Superintendent of Public Instruction,Joy Hofmeister,REP,720013,0,0,5,5,
Tulsa,Insurance Commissioner,Bill Viner,REP,720013,0,0,2,2,
Tulsa,Insurance Commissioner,John Doak,REP,720013,0,0,8,8,
Tulsa,Corporation Commissioner,Todd Hiett,REP,720013,0,0,7,7,
Tulsa,Corporation Commissioner,Cliff Branan,REP,720013,0,0,3,3,
Tulsa,U.S. Senate,Evelyn Rogers,REP,720013,0,0,4,4,
Tulsa,U.S. Senate,Rob Moye,REP,720013,0,0,0,0,
Tulsa,U.S. Senate,D. Jean Mcbride-Samuels,REP,720013,0,0,2,2,
Tulsa,U.S. Senate,Jim Inhofe,REP,720013,0,0,5,5,
Tulsa,U.S. Senate,Erick Paul Wyatt,REP,720013,0,0,0,0,
Tulsa,U.S. Senate,Andy Craig,REP,720013,0,0,0,0,
Tulsa,U.S. Senate,T. Shannon,REP,720013,0,0,8,8,
Tulsa,U.S. Senate,Randy Brogdon,REP,720013,0,0,0,0,
Tulsa,U.S. Senate,Eric Mccray,REP,720013,0,0,0,0,
Tulsa,U.S. Senate,Kevin Crow,REP,720013,0,0,0,0,
Tulsa,U.S. Senate,James Lankford,REP,720013,0,0,3,3,
Tulsa,U.S. Senate,Jason Weger,REP,720013,0,0,0,0,
Tulsa,Superintendent of Public Instruction,John Cox,DEM,720014,0,0,30,30,
Tulsa,Superintendent of Public Instruction,Jack Jr.,DEM,720014,0,0,38,38,
Tulsa,Superintendent of Public Instruction,Ivan Holmes,DEM,720014,0,0,22,22,
Tulsa,Superintendent of Public Instruction,Freda Deskin,DEM,720014,0,0,83,83,
Tulsa,U.S. Senate,Patrick Michael Hayes,DEM,720014,0,0,28,28,
Tulsa,U.S. Senate,Jim Rogers,DEM,720014,0,0,18,18,
Tulsa,U.S. Senate,Connie Johnson,DEM,720014,0,0,124,124,
Tulsa,Governor,Dax Ewbank,REP,720014,0,0,3,3,
Tulsa,Governor,Chad Moody,REP,720014,0,0,10,10,
Tulsa,Governor,Mary Fallin,REP,720014,0,0,6,6,
Tulsa,Superintendent of Public Instruction,Brian Kelly,REP,720014,0,0,2,2,
Tulsa,Superintendent of Public Instruction,Janet Costello Barresi,REP,720014,0,0,4,4,
Tulsa,Superintendent of Public Instruction,Joy Hofmeister,REP,720014,0,0,13,13,
Tulsa,Insurance Commissioner,Bill Viner,REP,720014,0,0,4,4,
Tulsa,Insurance Commissioner,John Doak,REP,720014,0,0,12,12,
Tulsa,Corporation Commissioner,Todd Hiett,REP,720014,0,0,12,12,
Tulsa,Corporation Commissioner,Cliff Branan,REP,720014,0,0,7,7,
Tulsa,U.S. Senate,Evelyn Rogers,REP,720014,0,0,4,4,
Tulsa,U.S. Senate,Rob Moye,REP,720014,0,0,0,0,
Tulsa,U.S. Senate,D. Jean Mcbride-Samuels,REP,720014,0,0,1,1,
Tulsa,U.S. Senate,Jim Inhofe,REP,720014,0,0,12,12,
Tulsa,U.S. Senate,Erick Paul Wyatt,REP,720014,0,0,2,2,
Tulsa,U.S. Senate,Andy Craig,REP,720014,0,0,1,1,
Tulsa,U.S. Senate,T. Shannon,REP,720014,0,0,7,7,
Tulsa,U.S. Senate,Randy Brogdon,REP,720014,0,0,2,2,
Tulsa,U.S. Senate,Eric Mccray,REP,720014,0,0,0,0,
Tulsa,U.S. Senate,Kevin Crow,REP,720014,0,0,1,1,
Tulsa,U.S. Senate,James Lankford,REP,720014,0,0,7,7,
Tulsa,U.S. Senate,Jason Weger,REP,720014,0,0,2,2,
Tulsa,Superintendent of Public Instruction,John Cox,DEM,720015,0,0,19,19,
Tulsa,Superintendent of Public Instruction,Jack Jr.,DEM,720015,0,0,30,30,
Tulsa,Superintendent of Public Instruction,Ivan Holmes,DEM,720015,0,0,12,12,
Tulsa,Superintendent of Public Instruction,Freda Deskin,DEM,720015,0,0,40,40,
Tulsa,U.S. Senate,Patrick Michael Hayes,DEM,720015,0,0,14,14,
Tulsa,U.S. Senate,Jim Rogers,DEM,720015,0,0,17,17,
Tulsa,U.S. Senate,Connie Johnson,DEM,720015,0,0,60,60,
Tulsa,Governor,Dax Ewbank,REP,720015,0,0,3,3,
Tulsa,Governor,Chad Moody,REP,720015,0,0,5,5,
Tulsa,Governor,Mary Fallin,REP,720015,0,0,5,5,
Tulsa,Superintendent of Public Instruction,Brian Kelly,REP,720015,0,0,5,5,
Tulsa,Superintendent of Public Instruction,Janet Costello Barresi,REP,720015,0,0,3,3,
Tulsa,Superintendent of Public Instruction,Joy Hofmeister,REP,720015,0,0,5,5,
Tulsa,Insurance Commissioner,Bill Viner,REP,720015,0,0,6,6,
Tulsa,Insurance Commissioner,John Doak,REP,720015,0,0,7,7,
Tulsa,Corporation Commissioner,Todd Hiett,REP,720015,0,0,3,3,
Tulsa,Corporation Commissioner,Cliff Branan,REP,720015,0,0,10,10,
Tulsa,U.S. Senate,Evelyn Rogers,REP,720015,0,0,1,1,
Tulsa,U.S. Senate,Rob Moye,REP,720015,0,0,1,1,
Tulsa,U.S. Senate,D. Jean Mcbride-Samuels,REP,720015,0,0,2,2,
Tulsa,U.S. Senate,Jim Inhofe,REP,720015,0,0,5,5,
Tulsa,U.S. Senate,Erick Paul Wyatt,REP,720015,0,0,4,4,
Tulsa,U.S. Senate,Andy Craig,REP,720015,0,0,0,0,
Tulsa,U.S. Senate,T. Shannon,REP,720015,0,0,6,6,
Tulsa,U.S. Senate,Randy Brogdon,REP,720015,0,0,1,1,
Tulsa,U.S. Senate,Eric Mccray,REP,720015,0,0,1,1,
Tulsa,U.S. Senate,Kevin Crow,REP,720015,0,0,0,0,
Tulsa,U.S. Senate,James Lankford,REP,720015,0,0,5,5,
Tulsa,U.S. Senate,Jason Weger,REP,720015,0,0,1,1,
Tulsa,Superintendent of Public Instruction,John Cox,DEM,720016,0,0,7,7,
Tulsa,Superintendent of Public Instruction,Jack Jr.,DEM,720016,0,0,1,1,
Tulsa,Superintendent of Public Instruction,Ivan Holmes,DEM,720016,0,0,0,0,
Tulsa,Superintendent of Public Instruction,Freda Deskin,DEM,720016,0,0,10,10,
Tulsa,U.S. Senate,Patrick Michael Hayes,DEM,720016,0,0,4,4,
Tulsa,U.S. Senate,Jim Rogers,DEM,720016,0,0,1,1,
Tulsa,U.S. Senate,Connie Johnson,DEM,720016,0,0,13,13,
Tulsa,Governor,Dax Ewbank,REP,720016,0,0,2,2,
Tulsa,Governor,Chad Moody,REP,720016,0,0,4,4,
Tulsa,Governor,Mary Fallin,REP,720016,0,0,19,19,
Tulsa,Superintendent of Public Instruction,Brian Kelly,REP,720016,0,0,6,6,
Tulsa,Superintendent of Public Instruction,Janet Costello Barresi,REP,720016,0,0,8,8,
Tulsa,Superintendent of Public Instruction,Joy Hofmeister,REP,720016,0,0,11,11,
Tulsa,Insurance Commissioner,Bill Viner,REP,720016,0,0,8,8,
Tulsa,Insurance Commissioner,John Doak,REP,720016,0,0,17,17,
Tulsa,Corporation Commissioner,Todd Hiett,REP,720016,0,0,18,18,
Tulsa,Corporation Commissioner,Cliff Branan,REP,720016,0,0,7,7,
Tulsa,U.S. Senate,Evelyn Rogers,REP,720016,0,0,0,0,
Tulsa,U.S. Senate,Rob Moye,REP,720016,0,0,2,2,
Tulsa,U.S. Senate,D. Jean Mcbride-Samuels,REP,720016,0,0,0,0,
Tulsa,U.S. Senate,Jim Inhofe,REP,720016,0,0,22,22,
Tulsa,U.S. Senate,Erick Paul Wyatt,REP,720016,0,0,1,1,
Tulsa,U.S. Senate,Andy Craig,REP,720016,0,0,0,0,
Tulsa,U.S. Senate,T. Shannon,REP,720016,0,0,7,7,
Tulsa,U.S. Senate,Randy Brogdon,REP,720016,0,0,0,0,
Tulsa,U.S. Senate,Eric Mccray,REP,720016,0,0,0,0,
Tulsa,U.S. Senate,Kevin Crow,REP,720016,0,0,0,0,
Tulsa,U.S. Senate,James Lankford,REP,720016,0,0,18,18,
Tulsa,U.S. Senate,Jason Weger,REP,720016,0,0,0,0,
Tulsa,Superintendent of Public Instruction,John Cox,DEM,720017,0,0,14,14,
Tulsa,Superintendent of Public Instruction,Jack Jr.,DEM,720017,0,0,4,4,
Tulsa,Superintendent of Public Instruction,Ivan Holmes,DEM,720017,0,0,1,1,
Tulsa,Superintendent of Public Instruction,Freda Deskin,DEM,720017,0,0,23,23,
Tulsa,U.S. Senate,Patrick Michael Hayes,DEM,720017,0,0,10,10,
Tulsa,U.S. Senate,Jim Rogers,DEM,720017,0,0,6,6,
Tulsa,U.S. Senate,Connie Johnson,DEM,720017,0,0,25,25,
Tulsa,Governor,Dax Ewbank,REP,720017,0,0,4,4,
Tulsa,Governor,Chad Moody,REP,720017,0,0,6,6,
Tulsa,Governor,Mary Fallin,REP,720017,0,0,21,21,
Tulsa,Superintendent of Public Instruction,Brian Kelly,REP,720017,0,0,5,5,
Tulsa,Superintendent of Public Instruction,Janet Costello Barresi,REP,720017,0,0,8,8,
Tulsa,Superintendent of Public Instruction,Joy Hofmeister,REP,720017,0,0,16,16,
Tulsa,Insurance Commissioner,Bill Viner,REP,720017,0,0,8,8,
Tulsa,Insurance Commissioner,John Doak,REP,720017,0,0,21,21,
Tulsa,Corporation Commissioner,Todd Hiett,REP,720017,0,0,14,14,
Tulsa,Corporation Commissioner,Cliff Branan,REP,720017,0,0,17,17,
Tulsa,U.S. Senate,Evelyn Rogers,REP,720017,0,0,4,4,
Tulsa,U.S. Senate,Rob Moye,REP,720017,0,0,0,0,
Tulsa,U.S. Senate,D. Jean Mcbride-Samuels,REP,720017,0,0,1,1,
Tulsa,U.S. Senate,Jim Inhofe,REP,720017,0,0,25,25,
Tulsa,U.S. Senate,Erick Paul Wyatt,REP,720017,0,0,1,1,
Tulsa,U.S. Senate,Andy Craig,REP,720017,0,0,1,1,
Tulsa,U.S. Senate,T. Shannon,REP,720017,0,0,13,13,
Tulsa,U.S. Senate,Randy Brogdon,REP,720017,0,0,4,4,
Tulsa,U.S. Senate,Eric Mccray,REP,720017,0,0,0,0,
Tulsa,U.S. Senate,Kevin Crow,REP,720017,0,0,0,0,
Tulsa,U.S. Senate,James Lankford,REP,720017,0,0,12,12,
Tulsa,U.S. Senate,Jason Weger,REP,720017,0,0,1,1,
Tulsa,Superintendent of Public Instruction,John Cox,DEM,720018,0,0,17,17,
Tulsa,Superintendent of Public Instruction,Jack Jr.,DEM,720018,0,0,6,6,
Tulsa,Superintendent of Public Instruction,Ivan Holmes,DEM,720018,0,0,4,4,
Tulsa,Superintendent of Public Instruction,Freda Deskin,DEM,720018,0,0,24,24,
Tulsa,U.S. Senate,Patrick Michael Hayes,DEM,720018,0,0,16,16,
Tulsa,U.S. Senate,Jim Rogers,DEM,720018,0,0,12,12,
Tulsa,U.S. Senate,Connie Johnson,DEM,720018,0,0,23,23,
Tulsa,Governor,Dax Ewbank,REP,720018,0,0,4,4,
Tulsa,Governor,Chad Moody,REP,720018,0,0,5,5,
Tulsa,Governor,Mary Fallin,REP,720018,0,0,21,21,
Tulsa,Superintendent of Public Instruction,Brian Kelly,REP,720018,0,0,4,4,
Tulsa,Superintendent of Public Instruction,Janet Costello Barresi,REP,720018,0,0,6,6,
Tulsa,Superintendent of Public Instruction,Joy Hofmeister,REP,720018,0,0,19,19,
Tulsa,Insurance Commissioner,Bill Viner,REP,720018,0,0,9,9,
Tulsa,Insurance Commissioner,John Doak,REP,720018,0,0,19,19,
Tulsa,Corporation Commissioner,Todd Hiett,REP,720018,0,0,12,12,
Tulsa,Corporation Commissioner,Cliff Branan,REP,720018,0,0,15,15,
Tulsa,U.S. Senate,Evelyn Rogers,REP,720018,0,0,3,3,
Tulsa,U.S. Senate,Rob Moye,REP,720018,0,0,1,1,
Tulsa,U.S. Senate,D. Jean Mcbride-Samuels,REP,720018,0,0,0,0,
Tulsa,U.S. Senate,Jim Inhofe,REP,720018,0,0,24,24,
Tulsa,U.S. Senate,Erick Paul Wyatt,REP,720018,0,0,2,2,
Tulsa,U.S. Senate,Andy Craig,REP,720018,0,0,1,1,
Tulsa,U.S. Senate,T. Shannon,REP,720018,0,0,12,12,
Tulsa,U.S. Senate,Randy Brogdon,REP,720018,0,0,4,4,
Tulsa,U.S. Senate,Eric Mccray,REP,720018,0,0,0,0,
Tulsa,U.S. Senate,Kevin Crow,REP,720018,0,0,2,2,
Tulsa,U.S. Senate,James Lankford,REP,720018,0,0,9,9,
Tulsa,U.S. Senate,Jason Weger,REP,720018,0,0,1,1,
Tulsa,Superintendent of Public Instruction,John Cox,DEM,720019,0,0,15,15,
Tulsa,Superintendent of Public Instruction,Jack Jr.,DEM,720019,0,0,4,4,
Tulsa,Superintendent of Public Instruction,Ivan Holmes,DEM,720019,0,0,5,5,
Tulsa,Superintendent of Public Instruction,Freda Deskin,DEM,720019,0,0,23,23,
Tulsa,U.S. Senate,Patrick Michael Hayes,DEM,720019,0,0,13,13,
Tulsa,U.S. Senate,Jim Rogers,DEM,720019,0,0,11,11,
Tulsa,U.S. Senate,Connie Johnson,DEM,720019,0,0,23,23,
Tulsa,Governor,Dax Ewbank,REP,720019,0,0,6,6,
Tulsa,Governor,Chad Moody,REP,720019,0,0,10,10,
Tulsa,Governor,Mary Fallin,REP,720019,0,0,38,38,
Tulsa,Superintendent of Public Instruction,Brian Kelly,REP,720019,0,0,17,17,
Tulsa,Superintendent of Public Instruction,Janet Costello Barresi,REP,720019,0,0,11,11,
Tulsa,Superintendent of Public Instruction,Joy Hofmeister,REP,720019,0,0,25,25,
Tulsa,Insurance Commissioner,Bill Viner,REP,720019,0,0,18,18,
Tulsa,Insurance Commissioner,John Doak,REP,720019,0,0,34,34,
Tulsa,Corporation Commissioner,Todd Hiett,REP,720019,0,0,21,21,
Tulsa,Corporation Commissioner,Cliff Branan,REP,720019,0,0,32,32,
Tulsa,U.S. Senate,Evelyn Rogers,REP,720019,0,0,1,1,
Tulsa,U.S. Senate,Rob Moye,REP,720019,0,0,0,0,
Tulsa,U.S. Senate,D. Jean Mcbride-Samuels,REP,720019,0,0,1,1,
Tulsa,U.S. Senate,Jim Inhofe,REP,720019,0,0,49,49,
Tulsa,U.S. Senate,Erick Paul Wyatt,REP,720019,0,0,2,2,
Tulsa,U.S. Senate,Andy Craig,REP,720019,0,0,2,2,
Tulsa,U.S. Senate,T. Shannon,REP,720019,0,0,22,22,
Tulsa,U.S. Senate,Randy Brogdon,REP,720019,0,0,6,6,
Tulsa,U.S. Senate,Eric Mccray,REP,720019,0,0,0,0,
Tulsa,U.S. Senate,Kevin Crow,REP,720019,0,0,1,1,
Tulsa,U.S. Senate,James Lankford,REP,720019,0,0,24,24,
Tulsa,U.S. Senate,Jason Weger,REP,720019,0,0,1,1,
Tulsa,Superintendent of Public Instruction,John Cox,DEM,720020,0,0,19,19,
Tulsa,Superintendent of Public Instruction,Jack Jr.,DEM,720020,0,0,4,4,
Tulsa,Superintendent of Public Instruction,Ivan Holmes,DEM,720020,0,0,4,4,
Tulsa,Superintendent of Public Instruction,Freda Deskin,DEM,720020,0,0,24,24,
Tulsa,U.S. Senate,Patrick Michael Hayes,DEM,720020,0,0,11,11,
Tulsa,U.S. Senate,Jim Rogers,DEM,720020,0,0,14,14,
Tulsa,U.S. Senate,Connie Johnson,DEM,720020,0,0,26,26,
Tulsa,Governor,Dax Ewbank,REP,720020,0,0,5,5,
Tulsa,Governor,Chad Moody,REP,720020,0,0,19,19,
Tulsa,Governor,Mary Fallin,REP,720020,0,0,37,37,
Tulsa,Superintendent of Public Instruction,Brian Kelly,REP,720020,0,0,18,18,
Tulsa,Superintendent of Public Instruction,Janet Costello Barresi,REP,720020,0,0,9,9,
Tulsa,Superintendent of Public Instruction,Joy Hofmeister,REP,720020,0,0,31,31,
Tulsa,Insurance Commissioner,Bill Viner,REP,720020,0,0,24,24,
Tulsa,Insurance Commissioner,John Doak,REP,720020,0,0,34,34,
Tulsa,Corporation Commissioner,Todd Hiett,REP,720020,0,0,39,39,
Tulsa,Corporation Commissioner,Cliff Branan,REP,720020,0,0,19,19,
Tulsa,U.S. Senate,Evelyn Rogers,REP,720020,0,0,6,6,
Tulsa,U.S. Senate,Rob Moye,REP,720020,0,0,3,3,
Tulsa,U.S. Senate,D. Jean Mcbride-Samuels,REP,720020,0,0,3,3,
Tulsa,U.S. Senate,Jim Inhofe,REP,720020,0,0,42,42,
Tulsa,U.S. Senate,Erick Paul Wyatt,REP,720020,0,0,7,7,
Tulsa,U.S. Senate,Andy Craig,REP,720020,0,0,1,1,
Tulsa,U.S. Senate,T. Shannon,REP,720020,0,0,22,22,
Tulsa,U.S. Senate,Randy Brogdon,REP,720020,0,0,9,9,
Tulsa,U.S. Senate,Eric Mccray,REP,720020,0,0,2,2,
Tulsa,U.S. Senate,Kevin Crow,REP,720020,0,0,2,2,
Tulsa,U.S. Senate,James Lankford,REP,720020,0,0,23,23,
Tulsa,U.S. Senate,Jason Weger,REP,720020,0,0,1,1,
Tulsa,Superintendent of Public Instruction,John Cox,DEM,720021,0,0,2,2,
Tulsa,Superintendent of Public Instruction,Jack Jr.,DEM,720021,0,0,1,1,
Tulsa,Superintendent of Public Instruction,Ivan Holmes,DEM,720021,0,0,1,1,
Tulsa,Superintendent of Public Instruction,Freda Deskin,DEM,720021,0,0,2,2,
Tulsa,U.S. Senate,Patrick Michael Hayes,DEM,720021,0,0,1,1,
Tulsa,U.S. Senate,Jim Rogers,DEM,720021,0,0,1,1,
Tulsa,U.S. Senate,Connie Johnson,DEM,720021,0,0,4,4,
Tulsa,Governor,Dax Ewbank,REP,720021,0,0,1,1,
Tulsa,Governor,Chad Moody,REP,720021,0,0,1,1,
Tulsa,Governor,Mary Fallin,REP,720021,0,0,11,11,
Tulsa,Superintendent of Public Instruction,Brian Kelly,REP,720021,0,0,1,1,
Tulsa,Superintendent of Public Instruction,Janet Costello Barresi,REP,720021,0,0,4,4,
Tulsa,Superintendent of Public Instruction,Joy Hofmeister,REP,720021,0,0,8,8,
Tulsa,Insurance Commissioner,Bill Viner,REP,720021,0,0,0,0,
Tulsa,Insurance Commissioner,John Doak,REP,720021,0,0,12,12,
Tulsa,Corporation Commissioner,Todd Hiett,REP,720021,0,0,4,4,
Tulsa,Corporation Commissioner,Cliff Branan,REP,720021,0,0,4,4,
Tulsa,U.S. Senate,Evelyn Rogers,REP,720021,0,0,0,0,
Tulsa,U.S. Senate,Rob Moye,REP,720021,0,0,2,2,
Tulsa,U.S. Senate,D. Jean Mcbride-Samuels,REP,720021,0,0,0,0,
Tulsa,U.S. Senate,Jim Inhofe,REP,720021,0,0,10,10,
Tulsa,U.S. Senate,Erick Paul Wyatt,REP,720021,0,0,0,0,
Tulsa,U.S. Senate,Andy Craig,REP,720021,0,0,0,0,
Tulsa,U.S. Senate,T. Shannon,REP,720021,0,0,4,4,
Tulsa,U.S. Senate,Randy Brogdon,REP,720021,0,0,1,1,
Tulsa,U.S. Senate,Eric Mccray,REP,720021,0,0,0,0,
Tulsa,U.S. Senate,Kevin Crow,REP,720021,0,0,0,0,
Tulsa,U.S. Senate,James Lankford,REP,720021,0,0,7,7,
Tulsa,U.S. Senate,Jason Weger,REP,720021,0,0,0,0,
Tulsa,Superintendent of Public Instruction,John Cox,DEM,720022,0,0,15,15,
Tulsa,Superintendent of Public Instruction,Jack Jr.,DEM,720022,0,0,1,1,
Tulsa,Superintendent of Public Instruction,Ivan Holmes,DEM,720022,0,0,2,2,
Tulsa,Superintendent of Public Instruction,Freda Deskin,DEM,720022,0,0,35,35,
Tulsa,U.S. Senate,Patrick Michael Hayes,DEM,720022,0,0,8,8,
Tulsa,U.S. Senate,Jim Rogers,DEM,720022,0,0,15,15,
Tulsa,U.S. Senate,Connie Johnson,DEM,720022,0,0,29,29,
Tulsa,Governor,Dax Ewbank,REP,720022,0,0,3,3,
Tulsa,Governor,Chad Moody,REP,720022,0,0,13,13,
Tulsa,Governor,Mary Fallin,REP,720022,0,0,86,86,
Tulsa,Superintendent of Public Instruction,Brian Kelly,REP,720022,0,0,26,26,
Tulsa,Superintendent of Public Instruction,Janet Costello Barresi,REP,720022,0,0,18,18,
Tulsa,Superintendent of Public Instruction,Joy Hofmeister,REP,720022,0,0,59,59,
Tulsa,Insurance Commissioner,Bill Viner,REP,720022,0,0,21,21,
Tulsa,Insurance Commissioner,John Doak,REP,720022,0,0,78,78,
Tulsa,Corporation Commissioner,Todd Hiett,REP,720022,0,0,51,51,
Tulsa,Corporation Commissioner,Cliff Branan,REP,720022,0,0,46,46,
Tulsa,U.S. Senate,Evelyn Rogers,REP,720022,0,0,6,6,
Tulsa,U.S. Senate,Rob Moye,REP,720022,0,0,4,4,
Tulsa,U.S. Senate,D. Jean Mcbride-Samuels,REP,720022,0,0,1,1,
Tulsa,U.S. Senate,Jim Inhofe,REP,720022,0,0,90,90,
Tulsa,U.S. Senate,Erick Paul Wyatt,REP,720022,0,0,4,4,
Tulsa,U.S. Senate,Andy Craig,REP,720022,0,0,1,1,
Tulsa,U.S. Senate,T. Shannon,REP,720022,0,0,40,40,
Tulsa,U.S. Senate,Randy Brogdon,REP,720022,0,0,11,11,
Tulsa,U.S. Senate,Eric Mccray,REP,720022,0,0,1,1,
Tulsa,U.S. Senate,Kevin Crow,REP,720022,0,0,2,2,
Tulsa,U.S. Senate,James Lankford,REP,720022,0,0,48,48,
Tulsa,U.S. Senate,Jason Weger,REP,720022,0,0,1,1,
Tulsa,Superintendent of Public Instruction,John Cox,DEM,720023,0,0,5,5,
Tulsa,Superintendent of Public Instruction,Jack Jr.,DEM,720023,0,0,4,4,
Tulsa,Superintendent of Public Instruction,Ivan Holmes,DEM,720023,0,0,2,2,
Tulsa,Superintendent of Public Instruction,Freda Deskin,DEM,720023,0,0,10,10,
Tulsa,U.S. Senate,Patrick Michael Hayes,DEM,720023,0,0,5,5,
Tulsa,U.S. Senate,Jim Rogers,DEM,720023,0,0,8,8,
Tulsa,U.S. Senate,Connie Johnson,DEM,720023,0,0,7,7,
Tulsa,Governor,Dax Ewbank,REP,720023,0,0,4,4,
Tulsa,Governor,Chad Moody,REP,720023,0,0,5,5,
Tulsa,Governor,Mary Fallin,REP,720023,0,0,31,31,
Tulsa,Superintendent of Public Instruction,Brian Kelly,REP,720023,0,0,8,8,
Tulsa,Superintendent of Public Instruction,Janet Costello Barresi,REP,720023,0,0,11,11,
Tulsa,Superintendent of Public Instruction,Joy Hofmeister,REP,720023,0,0,20,20,
Tulsa,Insurance Commissioner,Bill Viner,REP,720023,0,0,8,8,
Tulsa,Insurance Commissioner,John Doak,REP,720023,0,0,26,26,
Tulsa,Corporation Commissioner,Todd Hiett,REP,720023,0,0,20,20,
Tulsa,Corporation Commissioner,Cliff Branan,REP,720023,0,0,17,17,
Tulsa,U.S. Senate,Evelyn Rogers,REP,720023,0,0,1,1,
Tulsa,U.S. Senate,Rob Moye,REP,720023,0,0,2,2,
Tulsa,U.S. Senate,D. Jean Mcbride-Samuels,REP,720023,0,0,0,0,
Tulsa,U.S. Senate,Jim Inhofe,REP,720023,0,0,31,31,
Tulsa,U.S. Senate,Erick Paul Wyatt,REP,720023,0,0,6,6,
Tulsa,U.S. Senate,Andy Craig,REP,720023,0,0,0,0,
Tulsa,U.S. Senate,T. Shannon,REP,720023,0,0,22,22,
Tulsa,U.S. Senate,Randy Brogdon,REP,720023,0,0,7,7,
Tulsa,U.S. Senate,Eric Mccray,REP,720023,0,0,1,1,
Tulsa,U.S. Senate,Kevin Crow,REP,720023,0,0,1,1,
Tulsa,U.S. Senate,James Lankford,REP,720023,0,0,9,9,
Tulsa,U.S. Senate,Jason Weger,REP,720023,0,0,0,0,
Tulsa,Superintendent of Public Instruction,John Cox,DEM,720024,0,0,18,18,
Tulsa,Superintendent of Public Instruction,Jack Jr.,DEM,720024,0,0,4,4,
Tulsa,Superintendent of Public Instruction,Ivan Holmes,DEM,720024,0,0,5,5,
Tulsa,Superintendent of Public Instruction,Freda Deskin,DEM,720024,0,0,33,33,
Tulsa,U.S. Senate,Patrick Michael Hayes,DEM,720024,0,0,22,22,
Tulsa,U.S. Senate,Jim Rogers,DEM,720024,0,0,13,13,
Tulsa,U.S. Senate,Connie Johnson,DEM,720024,0,0,25,25,
Tulsa,Governor,Dax Ewbank,REP,720024,0,0,6,6,
Tulsa,Governor,Chad Moody,REP,720024,0,0,7,7,
Tulsa,Governor,Mary Fallin,REP,720024,0,0,41,41,
Tulsa,Superintendent of Public Instruction,Brian Kelly,REP,720024,0,0,14,14,
Tulsa,Superintendent of Public Instruction,Janet Costello Barresi,REP,720024,0,0,12,12,
Tulsa,Superintendent of Public Instruction,Joy Hofmeister,REP,720024,0,0,28,28,
Tulsa,Insurance Commissioner,Bill Viner,REP,720024,0,0,18,18,
Tulsa,Insurance Commissioner,John Doak,REP,720024,0,0,35,35,
Tulsa,Corporation Commissioner,Todd Hiett,REP,720024,0,0,26,26,
Tulsa,Corporation Commissioner,Cliff Branan,REP,720024,0,0,26,26,
Tulsa,U.S. Senate,Evelyn Rogers,REP,720024,0,0,0,0,
Tulsa,U.S. Senate,Rob Moye,REP,720024,0,0,1,1,
Tulsa,U.S. Senate,D. Jean Mcbride-Samuels,REP,720024,0,0,1,1,
Tulsa,U.S. Senate,Jim Inhofe,REP,720024,0,0,50,50,
Tulsa,U.S. Senate,Erick Paul Wyatt,REP,720024,0,0,1,1,
Tulsa,U.S. Senate,Andy Craig,REP,720024,0,0,1,1,
Tulsa,U.S. Senate,T. Shannon,REP,720024,0,0,25,25,
Tulsa,U.S. Senate,Randy Brogdon,REP,720024,0,0,8,8,
Tulsa,U.S. Senate,Eric Mccray,REP,720024,0,0,1,1,
Tulsa,U.S. Senate,Kevin Crow,REP,720024,0,0,0,0,
Tulsa,U.S. Senate,James Lankford,REP,720024,0,0,19,19,
Tulsa,U.S. Senate,Jason Weger,REP,720024,0,0,0,0,
Tulsa,Superintendent of Public Instruction,John Cox,DEM,720025,0,0,11,11,
Tulsa,Superintendent of Public Instruction,Jack Jr.,DEM,720025,0,0,4,4,
Tulsa,Superintendent of Public Instruction,Ivan Holmes,DEM,720025,0,0,5,5,
Tulsa,Superintendent of Public Instruction,Freda Deskin,DEM,720025,0,0,22,22,
Tulsa,U.S. Senate,Patrick Michael Hayes,DEM,720025,0,0,9,9,
Tulsa,U.S. Senate,Jim Rogers,DEM,720025,0,0,12,12,
Tulsa,U.S. Senate,Connie Johnson,DEM,720025,0,0,21,21,
Tulsa,Governor,Dax Ewbank,REP,720025,0,0,3,3,
Tulsa,Governor,Chad Moody,REP,720025,0,0,8,8,
Tulsa,Governor,Mary Fallin,REP,720025,0,0,37,37,
Tulsa,Superintendent of Public Instruction,Brian Kelly,REP,720025,0,0,11,11,
Tulsa,Superintendent of Public Instruction,Janet Costello Barresi,REP,720025,0,0,12,12,
Tulsa,Superintendent of Public Instruction,Joy Hofmeister,REP,720025,0,0,24,24,
Tulsa,Insurance Commissioner,Bill Viner,REP,720025,0,0,8,8,
Tulsa,Insurance Commissioner,John Doak,REP,720025,0,0,34,34,
Tulsa,Corporation Commissioner,Todd Hiett,REP,720025,0,0,27,27,
Tulsa,Corporation Commissioner,Cliff Branan,REP,720025,0,0,15,15,
Tulsa,U.S. Senate,Evelyn Rogers,REP,720025,0,0,2,2,
Tulsa,U.S. Senate,Rob Moye,REP,720025,0,0,0,0,
Tulsa,U.S. Senate,D. Jean Mcbride-Samuels,REP,720025,0,0,1,1,
Tulsa,U.S. Senate,Jim Inhofe,REP,720025,0,0,41,41,
Tulsa,U.S. Senate,Erick Paul Wyatt,REP,720025,0,0,3,3,
Tulsa,U.S. Senate,Andy Craig,REP,720025,0,0,0,0,
Tulsa,U.S. Senate,T. Shannon,REP,720025,0,0,20,20,
Tulsa,U.S. Senate,Randy Brogdon,REP,720025,0,0,7,7,
Tulsa,U.S. Senate,Eric Mccray,REP,720025,0,0,1,1,
Tulsa,U.S. Senate,Kevin Crow,REP,720025,0,0,0,0,
Tulsa,U.S. Senate,James Lankford,REP,720025,0,0,19,19,
Tulsa,U.S. Senate,Jason Weger,REP,720025,0,0,2,2,
Tulsa,Superintendent of Public Instruction,John Cox,DEM,720026,0,0,15,15,
Tulsa,Superintendent of Public Instruction,Jack Jr.,DEM,720026,0,0,5,5,
Tulsa,Superintendent of Public Instruction,Ivan Holmes,DEM,720026,0,0,3,3,
Tulsa,Superintendent of Public Instruction,Freda Deskin,DEM,720026,0,0,28,28,
Tulsa,U.S. Senate,Patrick Michael Hayes,DEM,720026,0,0,13,13,
Tulsa,U.S. Senate,Jim Rogers,DEM,720026,0,0,16,16,
Tulsa,U.S. Senate,Connie Johnson,DEM,720026,0,0,22,22,
Tulsa,Governor,Dax Ewbank,REP,720026,0,0,5,5,
Tulsa,Governor,Chad Moody,REP,720026,0,0,10,10,
Tulsa,Governor,Mary Fallin,REP,720026,0,0,38,38,
Tulsa,Superintendent of Public Instruction,Brian Kelly,REP,720026,0,0,10,10,
Tulsa,Superintendent of Public Instruction,Janet Costello Barresi,REP,720026,0,0,7,7,
Tulsa,Superintendent of Public Instruction,Joy Hofmeister,REP,720026,0,0,35,35,
Tulsa,Insurance Commissioner,Bill Viner,REP,720026,0,0,13,13,
Tulsa,Insurance Commissioner,John Doak,REP,720026,0,0,36,36,
Tulsa,Corporation Commissioner,Todd Hiett,REP,720026,0,0,20,20,
Tulsa,Corporation Commissioner,Cliff Branan,REP,720026,0,0,28,28,
Tulsa,U.S. Senate,Evelyn Rogers,REP,720026,0,0,1,1,
Tulsa,U.S. Senate,Rob Moye,REP,720026,0,0,0,0,
Tulsa,U.S. Senate,D. Jean Mcbride-Samuels,REP,720026,0,0,0,0,
Tulsa,U.S. Senate,Jim Inhofe,REP,720026,0,0,47,47,
Tulsa,U.S. Senate,Erick Paul Wyatt,REP,720026,0,0,5,5,
Tulsa,U.S. Senate,Andy Craig,REP,720026,0,0,0,0,
Tulsa,U.S. Senate,T. Shannon,REP,720026,0,0,27,27,
Tulsa,U.S. Senate,Randy Brogdon,REP,720026,0,0,7,7,
Tulsa,U.S. Senate,Eric Mccray,REP,720026,0,0,1,1,
Tulsa,U.S. Senate,Kevin Crow,REP,720026,0,0,0,0,
Tulsa,U.S. Senate,James Lankford,REP,720026,0,0,17,17,
Tulsa,U.S. Senate,Jason Weger,REP,720026,0,0,1,1,
Tulsa,Superintendent of Public Instruction,John Cox,DEM,720027,0,0,11,11,
Tulsa,Superintendent of Public Instruction,Jack Jr.,DEM,720027,0,0,3,3,
Tulsa,Superintendent of Public Instruction,Ivan Holmes,DEM,720027,0,0,5,5,
Tulsa,Superintendent of Public Instruction,Freda Deskin,DEM,720027,0,0,11,11,
Tulsa,U.S. Senate,Patrick Michael Hayes,DEM,720027,0,0,4,4,
Tulsa,U.S. Senate,Jim Rogers,DEM,720027,0,0,7,7,
Tulsa,U.S. Senate,Connie Johnson,DEM,720027,0,0,19,19,
Tulsa,Governor,Dax Ewbank,REP,720027,0,0,2,2,
Tulsa,Governor,Chad Moody,REP,720027,0,0,10,10,
Tulsa,Governor,Mary Fallin,REP,720027,0,0,43,43,
Tulsa,Superintendent of Public Instruction,Brian Kelly,REP,720027,0,0,18,18,
Tulsa,Superintendent of Public Instruction,Janet Costello Barresi,REP,720027,0,0,12,12,
Tulsa,Superintendent of Public Instruction,Joy Hofmeister,REP,720027,0,0,25,25,
Tulsa,Insurance Commissioner,Bill Viner,REP,720027,0,0,11,11,
Tulsa,Insurance Commissioner,John Doak,REP,720027,0,0,39,39,
Tulsa,Corporation Commissioner,Todd Hiett,REP,720027,0,0,28,28,
Tulsa,Corporation Commissioner,Cliff Branan,REP,720027,0,0,21,21,
Tulsa,U.S. Senate,Evelyn Rogers,REP,720027,0,0,7,7,
Tulsa,U.S. Senate,Rob Moye,REP,720027,0,0,0,0,
Tulsa,U.S. Senate,D. Jean Mcbride-Samuels,REP,720027,0,0,0,0,
Tulsa,U.S. Senate,Jim Inhofe,REP,720027,0,0,42,42,
Tulsa,U.S. Senate,Erick Paul Wyatt,REP,720027,0,0,3,3,
Tulsa,U.S. Senate,Andy Craig,REP,720027,0,0,0,0,
Tulsa,U.S. Senate,T. Shannon,REP,720027,0,0,21,21,
Tulsa,U.S. Senate,Randy Brogdon,REP,720027,0,0,4,4,
Tulsa,U.S. Senate,Eric Mccray,REP,720027,0,0,0,0,
Tulsa,U.S. Senate,Kevin Crow,REP,720027,0,0,0,0,
Tulsa,U.S. Senate,James Lankford,REP,720027,0,0,29,29,
Tulsa,U.S. Senate,Jason Weger,REP,720027,0,0,0,0,
Tulsa,Superintendent of Public Instruction,John Cox,DEM,720028,0,0,18,18,
Tulsa,Superintendent of Public Instruction,Jack Jr.,DEM,720028,0,0,5,5,
Tulsa,Superintendent of Public Instruction,Ivan Holmes,DEM,720028,0,0,5,5,
Tulsa,Superintendent of Public Instruction,Freda Deskin,DEM,720028,0,0,34,34,
Tulsa,U.S. Senate,Patrick Michael Hayes,DEM,720028,0,0,25,25,
Tulsa,U.S. Senate,Jim Rogers,DEM,720028,0,0,10,10,
Tulsa,U.S. Senate,Connie Johnson,DEM,720028,0,0,28,28,
Tulsa,Governor,Dax Ewbank,REP,720028,0,0,5,5,
Tulsa,Governor,Chad Moody,REP,720028,0,0,15,15,
Tulsa,Governor,Mary Fallin,REP,720028,0,0,59,59,
Tulsa,Superintendent of Public Instruction,Brian Kelly,REP,720028,0,0,22,22,
Tulsa,Superintendent of Public Instruction,Janet Costello Barresi,REP,720028,0,0,11,11,
Tulsa,Superintendent of Public Instruction,Joy Hofmeister,REP,720028,0,0,45,45,
Tulsa,Insurance Commissioner,Bill Viner,REP,720028,0,0,16,16,
Tulsa,Insurance Commissioner,John Doak,REP,720028,0,0,59,59,
Tulsa,Corporation Commissioner,Todd Hiett,REP,720028,0,0,32,32,
Tulsa,Corporation Commissioner,Cliff Branan,REP,720028,0,0,41,41,
Tulsa,U.S. Senate,Evelyn Rogers,REP,720028,0,0,4,4,
Tulsa,U.S. Senate,Rob Moye,REP,720028,0,0,1,1,
Tulsa,U.S. Senate,D. Jean Mcbride-Samuels,REP,720028,0,0,1,1,
Tulsa,U.S. Senate,Jim Inhofe,REP,720028,0,0,66,66,
Tulsa,U.S. Senate,Erick Paul Wyatt,REP,720028,0,0,5,5,
Tulsa,U.S. Senate,Andy Craig,REP,720028,0,0,1,1,
Tulsa,U.S. Senate,T. Shannon,REP,720028,0,0,28,28,
Tulsa,U.S. Senate,Randy Brogdon,REP,720028,0,0,8,8,
Tulsa,U.S. Senate,Eric Mccray,REP,720028,0,0,1,1,
Tulsa,U.S. Senate,Kevin Crow,REP,720028,0,0,2,2,
Tulsa,U.S. Senate,James Lankford,REP,720028,0,0,36,36,
Tulsa,U.S. Senate,Jason Weger,REP,720028,0,0,0,0,
Tulsa,Superintendent of Public Instruction,John Cox,DEM,720029,0,0,23,23,
Tulsa,Superintendent of Public Instruction,Jack Jr.,DEM,720029,0,0,1,1,
Tulsa,Superintendent of Public Instruction,Ivan Holmes,DEM,720029,0,0,2,2,
Tulsa,Superintendent of Public Instruction,Freda Deskin,DEM,720029,0,0,30,30,
Tulsa,U.S. Senate,Patrick Michael Hayes,DEM,720029,0,0,10,10,
Tulsa,U.S. Senate,Jim Rogers,DEM,720029,0,0,18,18,
Tulsa,U.S. Senate,Connie Johnson,DEM,720029,0,0,27,27,
Tulsa,Governor,Dax Ewbank,REP,720029,0,0,5,5,
Tulsa,Governor,Chad Moody,REP,720029,0,0,10,10,
Tulsa,Governor,Mary Fallin,REP,720029,0,0,49,49,
Tulsa,Superintendent of Public Instruction,Brian Kelly,REP,720029,0,0,9,9,
Tulsa,Superintendent of Public Instruction,Janet Costello Barresi,REP,720029,0,0,9,9,
Tulsa,Superintendent of Public Instruction,Joy Hofmeister,REP,720029,0,0,47,47,
Tulsa,Insurance Commissioner,Bill Viner,REP,720029,0,0,14,14,
Tulsa,Insurance Commissioner,John Doak,REP,720029,0,0,44,44,
Tulsa,Corporation Commissioner,Todd Hiett,REP,720029,0,0,26,26,
Tulsa,Corporation Commissioner,Cliff Branan,REP,720029,0,0,28,28,
Tulsa,U.S. Senate,Evelyn Rogers,REP,720029,0,0,4,4,
Tulsa,U.S. Senate,Rob Moye,REP,720029,0,0,3,3,
Tulsa,U.S. Senate,D. Jean Mcbride-Samuels,REP,720029,0,0,0,0,
Tulsa,U.S. Senate,Jim Inhofe,REP,720029,0,0,54,54,
Tulsa,U.S. Senate,Erick Paul Wyatt,REP,720029,0,0,5,5,
Tulsa,U.S. Senate,Andy Craig,REP,720029,0,0,1,1,
Tulsa,U.S. Senate,T. Shannon,REP,720029,0,0,26,26,
Tulsa,U.S. Senate,Randy Brogdon,REP,720029,0,0,8,8,
Tulsa,U.S. Senate,Eric Mccray,REP,720029,0,0,1,1,
Tulsa,U.S. Senate,Kevin Crow,REP,720029,0,0,0,0,
Tulsa,U.S. Senate,James Lankford,REP,720029,0,0,29,29,
Tulsa,U.S. Senate,Jason Weger,REP,720029,0,0,0,0,
Tulsa,Superintendent of Public Instruction,John Cox,DEM,720030,0,0,12,12,
Tulsa,Superintendent of Public Instruction,Jack Jr.,DEM,720030,0,0,10,10,
Tulsa,Superintendent of Public Instruction,Ivan Holmes,DEM,720030,0,0,2,2,
Tulsa,Superintendent of Public Instruction,Freda Deskin,DEM,720030,0,0,41,41,
Tulsa,U.S. Senate,Patrick Michael Hayes,DEM,720030,0,0,6,6,
Tulsa,U.S. Senate,Jim Rogers,DEM,720030,0,0,9,9,
Tulsa,U.S. Senate,Connie Johnson,DEM,720030,0,0,49,49,
Tulsa,Governor,Dax Ewbank,REP,720030,0,0,10,10,
Tulsa,Governor,Chad Moody,REP,720030,0,0,12,12,
Tulsa,Governor,Mary Fallin,REP,720030,0,0,36,36,
Tulsa,Superintendent of Public Instruction,Brian Kelly,REP,720030,0,0,11,11,
Tulsa,Superintendent of Public Instruction,Janet Costello Barresi,REP,720030,0,0,8,8,
Tulsa,Superintendent of Public Instruction,Joy Hofmeister,REP,720030,0,0,36,36,
Tulsa,Insurance Commissioner,Bill Viner,REP,720030,0,0,9,9,
Tulsa,Insurance Commissioner,John Doak,REP,720030,0,0,40,40,
Tulsa,Corporation Commissioner,Todd Hiett,REP,720030,0,0,25,25,
Tulsa,Corporation Commissioner,Cliff Branan,REP,720030,0,0,25,25,
Tulsa,U.S. Senate,Evelyn Rogers,REP,720030,0,0,5,5,
Tulsa,U.S. Senate,Rob Moye,REP,720030,0,0,3,3,
Tulsa,U.S. Senate,D. Jean Mcbride-Samuels,REP,720030,0,0,2,2,
Tulsa,U.S. Senate,Jim Inhofe,REP,720030,0,0,44,44,
Tulsa,U.S. Senate,Erick Paul Wyatt,REP,720030,0,0,2,2,
Tulsa,U.S. Senate,Andy Craig,REP,720030,0,0,1,1,
Tulsa,U.S. Senate,T. Shannon,REP,720030,0,0,22,22,
Tulsa,U.S. Senate,Randy Brogdon,REP,720030,0,0,1,1,
Tulsa,U.S. Senate,Eric Mccray,REP,720030,0,0,1,1,
Tulsa,U.S. Senate,Kevin Crow,REP,720030,0,0,2,2,
Tulsa,U.S. Senate,James Lankford,REP,720030,0,0,29,29,
Tulsa,U.S. Senate,Jason Weger,REP,720030,0,0,0,0,
Tulsa,Superintendent of Public Instruction,John Cox,DEM,720031,0,0,5,5,
Tulsa,Superintendent of Public Instruction,Jack Jr.,DEM,720031,0,0,3,3,
Tulsa,Superintendent of Public Instruction,Ivan Holmes,DEM,720031,0,0,1,1,
Tulsa,Superintendent of Public Instruction,Freda Deskin,DEM,720031,0,0,17,17,
Tulsa,U.S. Senate,Patrick Michael Hayes,DEM,720031,0,0,4,4,
Tulsa,U.S. Senate,Jim Rogers,DEM,720031,0,0,7,7,
Tulsa,U.S. Senate,Connie Johnson,DEM,720031,0,0,15,15,
Tulsa,Governor,Dax Ewbank,REP,720031,0,0,3,3,
Tulsa,Governor,Chad Moody,REP,720031,0,0,2,2,
Tulsa,Governor,Mary Fallin,REP,720031,0,0,29,29,
Tulsa,Superintendent of Public Instruction,Brian Kelly,REP,720031,0,0,6,6,
Tulsa,Superintendent of Public Instruction,Janet Costello Barresi,REP,720031,0,0,9,9,
Tulsa,Superintendent of Public Instruction,Joy Hofmeister,REP,720031,0,0,18,18,
Tulsa,Insurance Commissioner,Bill Viner,REP,720031,0,0,5,5,
Tulsa,Insurance Commissioner,John Doak,REP,720031,0,0,22,22,
Tulsa,Corporation Commissioner,Todd Hiett,REP,720031,0,0,15,15,
Tulsa,Corporation Commissioner,Cliff Branan,REP,720031,0,0,14,14,
Tulsa,U.S. Senate,Evelyn Rogers,REP,720031,0,0,3,3,
Tulsa,U.S. Senate,Rob Moye,REP,720031,0,0,0,0,
Tulsa,U.S. Senate,D. Jean Mcbride-Samuels,REP,720031,0,0,0,0,
Tulsa,U.S. Senate,Jim Inhofe,REP,720031,0,0,29,29,
Tulsa,U.S. Senate,Erick Paul Wyatt,REP,720031,0,0,2,2,
Tulsa,U.S. Senate,Andy Craig,REP,720031,0,0,1,1,
Tulsa,U.S. Senate,T. Shannon,REP,720031,0,0,17,17,
Tulsa,U.S. Senate,Randy Brogdon,REP,720031,0,0,2,2,
Tulsa,U.S. Senate,Eric Mccray,REP,720031,0,0,0,0,
Tulsa,U.S. Senate,Kevin Crow,REP,720031,0,0,0,0,
Tulsa,U.S. Senate,James Lankford,REP,720031,0,0,13,13,
Tulsa,U.S. Senate,Jason Weger,REP,720031,0,0,1,1,
Tulsa,Superintendent of Public Instruction,John Cox,DEM,720032,0,0,14,14,
Tulsa,Superintendent of Public Instruction,Jack Jr.,DEM,720032,0,0,9,9,
Tulsa,Superintendent of Public Instruction,Ivan Holmes,DEM,720032,0,0,5,5,
Tulsa,Superintendent of Public Instruction,Freda Deskin,DEM,720032,0,0,29,29,
Tulsa,U.S. Senate,Patrick Michael Hayes,DEM,720032,0,0,12,12,
Tulsa,U.S. Senate,Jim Rogers,DEM,720032,0,0,12,12,
Tulsa,U.S. Senate,Connie Johnson,DEM,720032,0,0,35,35,
Tulsa,Governor,Dax Ewbank,REP,720032,0,0,7,7,
Tulsa,Governor,Chad Moody,REP,720032,0,0,6,6,
Tulsa,Governor,Mary Fallin,REP,720032,0,0,32,32,
Tulsa,Superintendent of Public Instruction,Brian Kelly,REP,720032,0,0,11,11,
Tulsa,Superintendent of Public Instruction,Janet Costello Barresi,REP,720032,0,0,10,10,
Tulsa,Superintendent of Public Instruction,Joy Hofmeister,REP,720032,0,0,22,22,
Tulsa,Insurance Commissioner,Bill Viner,REP,720032,0,0,8,8,
Tulsa,Insurance Commissioner,John Doak,REP,720032,0,0,32,32,
Tulsa,Corporation Commissioner,Todd Hiett,REP,720032,0,0,27,27,
Tulsa,Corporation Commissioner,Cliff Branan,REP,720032,0,0,10,10,
Tulsa,U.S. Senate,Evelyn Rogers,REP,720032,0,0,0,0,
Tulsa,U.S. Senate,Rob Moye,REP,720032,0,0,0,0,
Tulsa,U.S. Senate,D. Jean Mcbride-Samuels,REP,720032,0,0,1,1,
Tulsa,U.S. Senate,Jim Inhofe,REP,720032,0,0,38,38,
Tulsa,U.S. Senate,Erick Paul Wyatt,REP,720032,0,0,4,4,
Tulsa,U.S. Senate,Andy Craig,REP,720032,0,0,1,1,
Tulsa,U.S. Senate,T. Shannon,REP,720032,0,0,22,22,
Tulsa,U.S. Senate,Randy Brogdon,REP,720032,0,0,3,3,
Tulsa,U.S. Senate,Eric Mccray,REP,720032,0,0,1,1,
Tulsa,U.S. Senate,Kevin Crow,REP,720032,0,0,0,0,
Tulsa,U.S. Senate,James Lankford,REP,720032,0,0,18,18,
Tulsa,U.S. Senate,Jason Weger,REP,720032,0,0,0,0,
Tulsa,Superintendent of Public Instruction,John Cox,DEM,720033,0,0,7,7,
Tulsa,Superintendent of Public Instruction,Jack Jr.,DEM,720033,0,0,4,4,
Tulsa,Superintendent of Public Instruction,Ivan Holmes,DEM,720033,0,0,2,2,
Tulsa,Superintendent of Public Instruction,Freda Deskin,DEM,720033,0,0,25,25,
Tulsa,U.S. Senate,Patrick Michael Hayes,DEM,720033,0,0,5,5,
Tulsa,U.S. Senate,Jim Rogers,DEM,720033,0,0,7,7,
Tulsa,U.S. Senate,Connie Johnson,DEM,720033,0,0,28,28,
Tulsa,Governor,Dax Ewbank,REP,720033,0,0,8,8,
Tulsa,Governor,Chad Moody,REP,720033,0,0,4,4,
Tulsa,Governor,Mary Fallin,REP,720033,0,0,29,29,
Tulsa,Superintendent of Public Instruction,Brian Kelly,REP,720033,0,0,8,8,
Tulsa,Superintendent of Public Instruction,Janet Costello Barresi,REP,720033,0,0,13,13,
Tulsa,Superintendent of Public Instruction,Joy Hofmeister,REP,720033,0,0,19,19,
Tulsa,Insurance Commissioner,Bill Viner,REP,720033,0,0,2,2,
Tulsa,Insurance Commissioner,John Doak,REP,720033,0,0,34,34,
Tulsa,Corporation Commissioner,Todd Hiett,REP,720033,0,0,26,26,
Tulsa,Corporation Commissioner,Cliff Branan,REP,720033,0,0,11,11,
Tulsa,U.S. Senate,Evelyn Rogers,REP,720033,0,0,2,2,
Tulsa,U.S. Senate,Rob Moye,REP,720033,0,0,0,0,
Tulsa,U.S. Senate,D. Jean Mcbride-Samuels,REP,720033,0,0,2,2,
Tulsa,U.S. Senate,Jim Inhofe,REP,720033,0,0,35,35,
Tulsa,U.S. Senate,Erick Paul Wyatt,REP,720033,0,0,1,1,
Tulsa,U.S. Senate,Andy Craig,REP,720033,0,0,2,2,
Tulsa,U.S. Senate,T. Shannon,REP,720033,0,0,13,13,
Tulsa,U.S. Senate,Randy Brogdon,REP,720033,0,0,5,5,
Tulsa,U.S. Senate,Eric Mccray,REP,720033,0,0,0,0,
Tulsa,U.S. Senate,Kevin Crow,REP,720033,0,0,0,0,
Tulsa,U.S. Senate,James Lankford,REP,720033,0,0,19,19,
Tulsa,U.S. Senate,Jason Weger,REP,720033,0,0,0,0,
Tulsa,Superintendent of Public Instruction,John Cox,DEM,720034,0,0,14,14,
Tulsa,Superintendent of Public Instruction,Jack Jr.,DEM,720034,0,0,6,6,
Tulsa,Superintendent of Public Instruction,Ivan Holmes,DEM,720034,0,0,1,1,
Tulsa,Superintendent of Public Instruction,Freda Deskin,DEM,720034,0,0,21,21,
Tulsa,U.S. Senate,Patrick Michael Hayes,DEM,720034,0,0,10,10,
Tulsa,U.S. Senate,Jim Rogers,DEM,720034,0,0,8,8,
Tulsa,U.S. Senate,Connie Johnson,DEM,720034,0,0,26,26,
Tulsa,Governor,Dax Ewbank,REP,720034,0,0,0,0,
Tulsa,Governor,Chad Moody,REP,720034,0,0,7,7,
Tulsa,Governor,Mary Fallin,REP,720034,0,0,34,34,
Tulsa,Superintendent of Public Instruction,Brian Kelly,REP,720034,0,0,10,10,
Tulsa,Superintendent of Public Instruction,Janet Costello Barresi,REP,720034,0,0,4,4,
Tulsa,Superintendent of Public Instruction,Joy Hofmeister,REP,720034,0,0,30,30,
Tulsa,Insurance Commissioner,Bill Viner,REP,720034,0,0,11,11,
Tulsa,Insurance Commissioner,John Doak,REP,720034,0,0,31,31,
Tulsa,Corporation Commissioner,Todd Hiett,REP,720034,0,0,18,18,
Tulsa,Corporation Commissioner,Cliff Branan,REP,720034,0,0,23,23,
Tulsa,U.S. Senate,Evelyn Rogers,REP,720034,0,0,1,1,
Tulsa,U.S. Senate,Rob Moye,REP,720034,0,0,2,2,
Tulsa,U.S. Senate,D. Jean Mcbride-Samuels,REP,720034,0,0,1,1,
Tulsa,U.S. Senate,Jim Inhofe,REP,720034,0,0,38,38,
Tulsa,U.S. Senate,Erick Paul Wyatt,REP,720034,0,0,1,1,
Tulsa,U.S. Senate,Andy Craig,REP,720034,0,0,0,0,
Tulsa,U.S. Senate,T. Shannon,REP,720034,0,0,17,17,
Tulsa,U.S. Senate,Randy Brogdon,REP,720034,0,0,2,2,
Tulsa,U.S. Senate,Eric Mccray,REP,720034,0,0,1,1,
Tulsa,U.S. Senate,Kevin Crow,REP,720034,0,0,0,0,
Tulsa,U.S. Senate,James Lankford,REP,720034,0,0,23,23,
Tulsa,U.S. Senate,Jason Weger,REP,720034,0,0,1,1,
Tulsa,Superintendent of Public Instruction,John Cox,DEM,720035,0,0,40,40,
Tulsa,Superintendent of Public Instruction,Jack Jr.,DEM,720035,0,0,12,12,
Tulsa,Superintendent of Public Instruction,Ivan Holmes,DEM,720035,0,0,10,10,
Tulsa,Superintendent of Public Instruction,Freda Deskin,DEM,720035,0,0,66,66,
Tulsa,U.S. Senate,Patrick Michael Hayes,DEM,720035,0,0,20,20,
Tulsa,U.S. Senate,Jim Rogers,DEM,720035,0,0,23,23,
Tulsa,U.S. Senate,Connie Johnson,DEM,720035,0,0,80,80,
Tulsa,Governor,Dax Ewbank,REP,720035,0,0,28,28,
Tulsa,Governor,Chad Moody,REP,720035,0,0,27,27,
Tulsa,Governor,Mary Fallin,REP,720035,0,0,108,108,
Tulsa,Superintendent of Public Instruction,Brian Kelly,REP,720035,0,0,33,33,
Tulsa,Superintendent of Public Instruction,Janet Costello Barresi,REP,720035,0,0,27,27,
Tulsa,Superintendent of Public Instruction,Joy Hofmeister,REP,720035,0,0,99,99,
Tulsa,Insurance Commissioner,Bill Viner,REP,720035,0,0,39,39,
Tulsa,Insurance Commissioner,John Doak,REP,720035,0,0,110,110,
Tulsa,Corporation Commissioner,Todd Hiett,REP,720035,0,0,80,80,
Tulsa,Corporation Commissioner,Cliff Branan,REP,720035,0,0,70,70,
Tulsa,U.S. Senate,Evelyn Rogers,REP,720035,0,0,10,10,
Tulsa,U.S. Senate,Rob Moye,REP,720035,0,0,4,4,
Tulsa,U.S. Senate,D. Jean Mcbride-Samuels,REP,720035,0,0,1,1,
Tulsa,U.S. Senate,Jim Inhofe,REP,720035,0,0,133,133,
Tulsa,U.S. Senate,Erick Paul Wyatt,REP,720035,0,0,14,14,
Tulsa,U.S. Senate,Andy Craig,REP,720035,0,0,0,0,
Tulsa,U.S. Senate,T. Shannon,REP,720035,0,0,70,70,
Tulsa,U.S. Senate,Randy Brogdon,REP,720035,0,0,21,21,
Tulsa,U.S. Senate,Eric Mccray,REP,720035,0,0,0,0,
Tulsa,U.S. Senate,Kevin Crow,REP,720035,0,0,5,5,
Tulsa,U.S. Senate,James Lankford,REP,720035,0,0,68,68,
Tulsa,U.S. Senate,Jason Weger,REP,720035,0,0,1,1,
Tulsa,Superintendent of Public Instruction,John Cox,DEM,720036,0,0,28,28,
Tulsa,Superintendent of Public Instruction,Jack Jr.,DEM,720036,0,0,19,19,
Tulsa,Superintendent of Public Instruction,Ivan Holmes,DEM,720036,0,0,7,7,
Tulsa,Superintendent of Public Instruction,Freda Deskin,DEM,720036,0,0,65,65,
Tulsa,U.S. Senate,Patrick Michael Hayes,DEM,720036,0,0,17,17,
Tulsa,U.S. Senate,Jim Rogers,DEM,720036,0,0,23,23,
Tulsa,U.S. Senate,Connie Johnson,DEM,720036,0,0,74,74,
Tulsa,Governor,Dax Ewbank,REP,720036,0,0,10,10,
Tulsa,Governor,Chad Moody,REP,720036,0,0,33,33,
Tulsa,Governor,Mary Fallin,REP,720036,0,0,127,127,
Tulsa,Superintendent of Public Instruction,Brian Kelly,REP,720036,0,0,22,22,
Tulsa,Superintendent of Public Instruction,Janet Costello Barresi,REP,720036,0,0,31,31,
Tulsa,Superintendent of Public Instruction,Joy Hofmeister,REP,720036,0,0,120,120,
Tulsa,Insurance Commissioner,Bill Viner,REP,720036,0,0,40,40,
Tulsa,Insurance Commissioner,John Doak,REP,720036,0,0,120,120,
Tulsa,Corporation Commissioner,Todd Hiett,REP,720036,0,0,94,94,
Tulsa,Corporation Commissioner,Cliff Branan,REP,720036,0,0,65,65,
Tulsa,U.S. Senate,Evelyn Rogers,REP,720036,0,0,6,6,
Tulsa,U.S. Senate,Rob Moye,REP,720036,0,0,4,4,
Tulsa,U.S. Senate,D. Jean Mcbride-Samuels,REP,720036,0,0,5,5,
Tulsa,U.S. Senate,Jim Inhofe,REP,720036,0,0,152,152,
Tulsa,U.S. Senate,Erick Paul Wyatt,REP,720036,0,0,9,9,
Tulsa,U.S. Senate,Andy Craig,REP,720036,0,0,1,1,
Tulsa,U.S. Senate,T. Shannon,REP,720036,0,0,72,72,
Tulsa,U.S. Senate,Randy Brogdon,REP,720036,0,0,13,13,
Tulsa,U.S. Senate,Eric Mccray,REP,720036,0,0,1,1,
Tulsa,U.S. Senate,Kevin Crow,REP,720036,0,0,4,4,
Tulsa,U.S. Senate,James Lankford,REP,720036,0,0,82,82,
Tulsa,U.S. Senate,Jason Weger,REP,720036,0,0,1,1,
Tulsa,Superintendent of Public Instruction,John Cox,DEM,720037,0,0,8,8,
Tulsa,Superintendent of Public Instruction,Jack Jr.,DEM,720037,0,0,3,3,
Tulsa,Superintendent of Public Instruction,Ivan Holmes,DEM,720037,0,0,1,1,
Tulsa,Superintendent of Public Instruction,Freda Deskin,DEM,720037,0,0,16,16,
Tulsa,U.S. Senate,Patrick Michael Hayes,DEM,720037,0,0,6,6,
Tulsa,U.S. Senate,Jim Rogers,DEM,720037,0,0,4,4,
Tulsa,U.S. Senate,Connie Johnson,DEM,720037,0,0,17,17,
Tulsa,Governor,Dax Ewbank,REP,720037,0,0,2,2,
Tulsa,Governor,Chad Moody,REP,720037,0,0,1,1,
Tulsa,Governor,Mary Fallin,REP,720037,0,0,15,15,
Tulsa,Superintendent of Public Instruction,Brian Kelly,REP,720037,0,0,4,4,
Tulsa,Superintendent of Public Instruction,Janet Costello Barresi,REP,720037,0,0,4,4,
Tulsa,Superintendent of Public Instruction,Joy Hofmeister,REP,720037,0,0,10,10,
Tulsa,Insurance Commissioner,Bill Viner,REP,720037,0,0,4,4,
Tulsa,Insurance Commissioner,John Doak,REP,720037,0,0,14,14,
Tulsa,Corporation Commissioner,Todd Hiett,REP,720037,0,0,7,7,
Tulsa,Corporation Commissioner,Cliff Branan,REP,720037,0,0,11,11,
Tulsa,U.S. Senate,Evelyn Rogers,REP,720037,0,0,1,1,
Tulsa,U.S. Senate,Rob Moye,REP,720037,0,0,0,0,
Tulsa,U.S. Senate,D. Jean Mcbride-Samuels,REP,720037,0,0,0,0,
Tulsa,U.S. Senate,Jim Inhofe,REP,720037,0,0,16,16,
Tulsa,U.S. Senate,Erick Paul Wyatt,REP,720037,0,0,1,1,
Tulsa,U.S. Senate,Andy Craig,REP,720037,0,0,0,0,
Tulsa,U.S. Senate,T. Shannon,REP,720037,0,0,13,13,
Tulsa,U.S. Senate,Randy Brogdon,REP,720037,0,0,1,1,
Tulsa,U.S. Senate,Eric Mccray,REP,720037,0,0,0,0,
Tulsa,U.S. Senate,Kevin Crow,REP,720037,0,0,0,0,
Tulsa,U.S. Senate,James Lankford,REP,720037,0,0,4,4,
Tulsa,U.S. Senate,Jason Weger,REP,720037,0,0,0,0,
Tulsa,Superintendent of Public Instruction,John Cox,DEM,720038,0,0,16,16,
Tulsa,Superintendent of Public Instruction,Jack Jr.,DEM,720038,0,0,8,8,
Tulsa,Superintendent of Public Instruction,Ivan Holmes,DEM,720038,0,0,1,1,
Tulsa,Superintendent of Public Instruction,Freda Deskin,DEM,720038,0,0,19,19,
Tulsa,U.S. Senate,Patrick Michael Hayes,DEM,720038,0,0,16,16,
Tulsa,U.S. Senate,Jim Rogers,DEM,720038,0,0,11,11,
Tulsa,U.S. Senate,Connie Johnson,DEM,720038,0,0,18,18,
Tulsa,Governor,Dax Ewbank,REP,720038,0,0,7,7,
Tulsa,Governor,Chad Moody,REP,720038,0,0,17,17,
Tulsa,Governor,Mary Fallin,REP,720038,0,0,61,61,
Tulsa,Superintendent of Public Instruction,Brian Kelly,REP,720038,0,0,18,18,
Tulsa,Superintendent of Public Instruction,Janet Costello Barresi,REP,720038,0,0,14,14,
Tulsa,Superintendent of Public Instruction,Joy Hofmeister,REP,720038,0,0,50,50,
Tulsa,Insurance Commissioner,Bill Viner,REP,720038,0,0,18,18,
Tulsa,Insurance Commissioner,John Doak,REP,720038,0,0,61,61,
Tulsa,Corporation Commissioner,Todd Hiett,REP,720038,0,0,44,44,
Tulsa,Corporation Commissioner,Cliff Branan,REP,720038,0,0,34,34,
Tulsa,U.S. Senate,Evelyn Rogers,REP,720038,0,0,9,9,
Tulsa,U.S. Senate,Rob Moye,REP,720038,0,0,0,0,
Tulsa,U.S. Senate,D. Jean Mcbride-Samuels,REP,720038,0,0,0,0,
Tulsa,U.S. Senate,Jim Inhofe,REP,720038,0,0,68,68,
Tulsa,U.S. Senate,Erick Paul Wyatt,REP,720038,0,0,8,8,
Tulsa,U.S. Senate,Andy Craig,REP,720038,0,0,0,0,
Tulsa,U.S. Senate,T. Shannon,REP,720038,0,0,26,26,
Tulsa,U.S. Senate,Randy Brogdon,REP,720038,0,0,11,11,
Tulsa,U.S. Senate,Eric Mccray,REP,720038,0,0,0,0,
Tulsa,U.S. Senate,Kevin Crow,REP,720038,0,0,2,2,
Tulsa,U.S. Senate,James Lankford,REP,720038,0,0,45,45,
Tulsa,U.S. Senate,Jason Weger,REP,720038,0,0,2,2,
Tulsa,Superintendent of Public Instruction,John Cox,DEM,720039,0,0,19,19,
Tulsa,Superintendent of Public Instruction,Jack Jr.,DEM,720039,0,0,11,11,
Tulsa,Superintendent of Public Instruction,Ivan Holmes,DEM,720039,0,0,6,6,
Tulsa,Superintendent of Public Instruction,Freda Deskin,DEM,720039,0,0,35,35,
Tulsa,U.S. Senate,Patrick Michael Hayes,DEM,720039,0,0,17,17,
Tulsa,U.S. Senate,Jim Rogers,DEM,720039,0,0,23,23,
Tulsa,U.S. Senate,Connie Johnson,DEM,720039,0,0,31,31,
Tulsa,Governor,Dax Ewbank,REP,720039,0,0,6,6,
Tulsa,Governor,Chad Moody,REP,720039,0,0,16,16,
Tulsa,Governor,Mary Fallin,REP,720039,0,0,90,90,
Tulsa,Superintendent of Public Instruction,Brian Kelly,REP,720039,0,0,25,25,
Tulsa,Superintendent of Public Instruction,Janet Costello Barresi,REP,720039,0,0,17,17,
Tulsa,Superintendent of Public Instruction,Joy Hofmeister,REP,720039,0,0,66,66,
Tulsa,Insurance Commissioner,Bill Viner,REP,720039,0,0,29,29,
Tulsa,Insurance Commissioner,John Doak,REP,720039,0,0,76,76,
Tulsa,Corporation Commissioner,Todd Hiett,REP,720039,0,0,67,67,
Tulsa,Corporation Commissioner,Cliff Branan,REP,720039,0,0,39,39,
Tulsa,U.S. Senate,Evelyn Rogers,REP,720039,0,0,4,4,
Tulsa,U.S. Senate,Rob Moye,REP,720039,0,0,3,3,
Tulsa,U.S. Senate,D. Jean Mcbride-Samuels,REP,720039,0,0,1,1,
Tulsa,U.S. Senate,Jim Inhofe,REP,720039,0,0,101,101,
Tulsa,U.S. Senate,Erick Paul Wyatt,REP,720039,0,0,4,4,
Tulsa,U.S. Senate,Andy Craig,REP,720039,0,0,0,0,
Tulsa,U.S. Senate,T. Shannon,REP,720039,0,0,41,41,
Tulsa,U.S. Senate,Randy Brogdon,REP,720039,0,0,16,16,
Tulsa,U.S. Senate,Eric Mccray,REP,720039,0,0,2,2,
Tulsa,U.S. Senate,Kevin Crow,REP,720039,0,0,2,2,
Tulsa,U.S. Senate,James Lankford,REP,720039,0,0,51,51,
Tulsa,U.S. Senate,Jason Weger,REP,720039,0,0,1,1,
Tulsa,Superintendent of Public Instruction,John Cox,DEM,720040,0,0,8,8,
Tulsa,Superintendent of Public Instruction,Jack Jr.,DEM,720040,0,0,2,2,
Tulsa,Superintendent of Public Instruction,Ivan Holmes,DEM,720040,0,0,0,0,
Tulsa,Superintendent of Public Instruction,Freda Deskin,DEM,720040,0,0,15,15,
Tulsa,U.S. Senate,Patrick Michael Hayes,DEM,720040,0,0,2,2,
Tulsa,U.S. Senate,Jim Rogers,DEM,720040,0,0,6,6,
Tulsa,U.S. Senate,Connie Johnson,DEM,720040,0,0,16,16,
Tulsa,Governor,Dax Ewbank,REP,720040,0,0,2,2,
Tulsa,Governor,Chad Moody,REP,720040,0,0,4,4,
Tulsa,Governor,Mary Fallin,REP,720040,0,0,25,25,
Tulsa,Superintendent of Public Instruction,Brian Kelly,REP,720040,0,0,6,6,
Tulsa,Superintendent of Public Instruction,Janet Costello Barresi,REP,720040,0,0,5,5,
Tulsa,Superintendent of Public Instruction,Joy Hofmeister,REP,720040,0,0,20,20,
Tulsa,Insurance Commissioner,Bill Viner,REP,720040,0,0,8,8,
Tulsa,Insurance Commissioner,John Doak,REP,720040,0,0,22,22,
Tulsa,Corporation Commissioner,Todd Hiett,REP,720040,0,0,13,13,
Tulsa,Corporation Commissioner,Cliff Branan,REP,720040,0,0,17,17,
Tulsa,U.S. Senate,Evelyn Rogers,REP,720040,0,0,1,1,
Tulsa,U.S. Senate,Rob Moye,REP,720040,0,0,0,0,
Tulsa,U.S. Senate,D. Jean Mcbride-Samuels,REP,720040,0,0,0,0,
Tulsa,U.S. Senate,Jim Inhofe,REP,720040,0,0,28,28,
Tulsa,U.S. Senate,Erick Paul Wyatt,REP,720040,0,0,2,2,
Tulsa,U.S. Senate,Andy Craig,REP,720040,0,0,1,1,
Tulsa,U.S. Senate,T. Shannon,REP,720040,0,0,14,14,
Tulsa,U.S. Senate,Randy Brogdon,REP,720040,0,0,2,2,
Tulsa,U.S. Senate,Eric Mccray,REP,720040,0,0,1,1,
Tulsa,U.S. Senate,Kevin Crow,REP,720040,0,0,1,1,
Tulsa,U.S. Senate,James Lankford,REP,720040,0,0,12,12,
Tulsa,U.S. Senate,Jason Weger,REP,720040,0,0,0,0,
Tulsa,Superintendent of Public Instruction,John Cox,DEM,720041,0,0,10,10,
Tulsa,Superintendent of Public Instruction,Jack Jr.,DEM,720041,0,0,4,4,
Tulsa,Superintendent of Public Instruction,Ivan Holmes,DEM,720041,0,0,2,2,
Tulsa,Superintendent of Public Instruction,Freda Deskin,DEM,720041,0,0,11,11,
Tulsa,U.S. Senate,Patrick Michael Hayes,DEM,720041,0,0,10,10,
Tulsa,U.S. Senate,Jim Rogers,DEM,720041,0,0,4,4,
Tulsa,U.S. Senate,Connie Johnson,DEM,720041,0,0,13,13,
Tulsa,Governor,Dax Ewbank,REP,720041,0,0,5,5,
Tulsa,Governor,Chad Moody,REP,720041,0,0,5,5,
Tulsa,Governor,Mary Fallin,REP,720041,0,0,51,51,
Tulsa,Superintendent of Public Instruction,Brian Kelly,REP,720041,0,0,12,12,
Tulsa,Superintendent of Public Instruction,Janet Costello Barresi,REP,720041,0,0,11,11,
Tulsa,Superintendent of Public Instruction,Joy Hofmeister,REP,720041,0,0,36,36,
Tulsa,Insurance Commissioner,Bill Viner,REP,720041,0,0,11,11,
Tulsa,Insurance Commissioner,John Doak,REP,720041,0,0,45,45,
Tulsa,Corporation Commissioner,Todd Hiett,REP,720041,0,0,31,31,
Tulsa,Corporation Commissioner,Cliff Branan,REP,720041,0,0,26,26,
Tulsa,U.S. Senate,Evelyn Rogers,REP,720041,0,0,4,4,
Tulsa,U.S. Senate,Rob Moye,REP,720041,0,0,1,1,
Tulsa,U.S. Senate,D. Jean Mcbride-Samuels,REP,720041,0,0,2,2,
Tulsa,U.S. Senate,Jim Inhofe,REP,720041,0,0,48,48,
Tulsa,U.S. Senate,Erick Paul Wyatt,REP,720041,0,0,4,4,
Tulsa,U.S. Senate,Andy Craig,REP,720041,0,0,0,0,
Tulsa,U.S. Senate,T. Shannon,REP,720041,0,0,28,28,
Tulsa,U.S. Senate,Randy Brogdon,REP,720041,0,0,7,7,
Tulsa,U.S. Senate,Eric Mccray,REP,720041,0,0,0,0,
Tulsa,U.S. Senate,Kevin Crow,REP,720041,0,0,0,0,
Tulsa,U.S. Senate,James Lankford,REP,720041,0,0,26,26,
Tulsa,U.S. Senate,Jason Weger,REP,720041,0,0,0,0,
Tulsa,Superintendent of Public Instruction,John Cox,DEM,720042,0,0,15,15,
Tulsa,Superintendent of Public Instruction,Jack Jr.,DEM,720042,0,0,4,4,
Tulsa,Superintendent of Public Instruction,Ivan Holmes,DEM,720042,0,0,1,1,
Tulsa,Superintendent of Public Instruction,Freda Deskin,DEM,720042,0,0,22,22,
Tulsa,U.S. Senate,Patrick Michael Hayes,DEM,720042,0,0,15,15,
Tulsa,U.S. Senate,Jim Rogers,DEM,720042,0,0,15,15,
Tulsa,U.S. Senate,Connie Johnson,DEM,720042,0,0,10,10,
Tulsa,Governor,Dax Ewbank,REP,720042,0,0,3,3,
Tulsa,Governor,Chad Moody,REP,720042,0,0,12,12,
Tulsa,Governor,Mary Fallin,REP,720042,0,0,67,67,
Tulsa,Superintendent of Public Instruction,Brian Kelly,REP,720042,0,0,20,20,
Tulsa,Superintendent of Public Instruction,Janet Costello Barresi,REP,720042,0,0,12,12,
Tulsa,Superintendent of Public Instruction,Joy Hofmeister,REP,720042,0,0,50,50,
Tulsa,Insurance Commissioner,Bill Viner,REP,720042,0,0,16,16,
Tulsa,Insurance Commissioner,John Doak,REP,720042,0,0,64,64,
Tulsa,Corporation Commissioner,Todd Hiett,REP,720042,0,0,45,45,
Tulsa,Corporation Commissioner,Cliff Branan,REP,720042,0,0,36,36,
Tulsa,U.S. Senate,Evelyn Rogers,REP,720042,0,0,5,5,
Tulsa,U.S. Senate,Rob Moye,REP,720042,0,0,2,2,
Tulsa,U.S. Senate,D. Jean Mcbride-Samuels,REP,720042,0,0,0,0,
Tulsa,U.S. Senate,Jim Inhofe,REP,720042,0,0,70,70,
Tulsa,U.S. Senate,Erick Paul Wyatt,REP,720042,0,0,5,5,
Tulsa,U.S. Senate,Andy Craig,REP,720042,0,0,0,0,
Tulsa,U.S. Senate,T. Shannon,REP,720042,0,0,35,35,
Tulsa,U.S. Senate,Randy Brogdon,REP,720042,0,0,4,4,
Tulsa,U.S. Senate,Eric Mccray,REP,720042,0,0,0,0,
Tulsa,U.S. Senate,Kevin Crow,REP,720042,0,0,0,0,
Tulsa,U.S. Senate,James Lankford,REP,720042,0,0,42,42,
Tulsa,U.S. Senate,Jason Weger,REP,720042,0,0,1,1,
Tulsa,Superintendent of Public Instruction,John Cox,DEM,720043,0,0,12,12,
Tulsa,Superintendent of Public Instruction,Jack Jr.,DEM,720043,0,0,3,3,
Tulsa,Superintendent of Public Instruction,Ivan Holmes,DEM,720043,0,0,4,4,
Tulsa,Superintendent of Public Instruction,Freda Deskin,DEM,720043,0,0,17,17,
Tulsa,U.S. Senate,Patrick Michael Hayes,DEM,720043,0,0,8,8,
Tulsa,U.S. Senate,Jim Rogers,DEM,720043,0,0,14,14,
Tulsa,U.S. Senate,Connie Johnson,DEM,720043,0,0,12,12,
Tulsa,Governor,Dax Ewbank,REP,720043,0,0,7,7,
Tulsa,Governor,Chad Moody,REP,720043,0,0,5,5,
Tulsa,Governor,Mary Fallin,REP,720043,0,0,65,65,
Tulsa,Superintendent of Public Instruction,Brian Kelly,REP,720043,0,0,13,13,
Tulsa,Superintendent of Public Instruction,Janet Costello Barresi,REP,720043,0,0,25,25,
Tulsa,Superintendent of Public Instruction,Joy Hofmeister,REP,720043,0,0,38,38,
Tulsa,Insurance Commissioner,Bill Viner,REP,720043,0,0,8,8,
Tulsa,Insurance Commissioner,John Doak,REP,720043,0,0,68,68,
Tulsa,Corporation Commissioner,Todd Hiett,REP,720043,0,0,48,48,
Tulsa,Corporation Commissioner,Cliff Branan,REP,720043,0,0,26,26,
Tulsa,U.S. Senate,Evelyn Rogers,REP,720043,0,0,2,2,
Tulsa,U.S. Senate,Rob Moye,REP,720043,0,0,0,0,
Tulsa,U.S. Senate,D. Jean Mcbride-Samuels,REP,720043,0,0,0,0,
Tulsa,U.S. Senate,Jim Inhofe,REP,720043,0,0,70,70,
Tulsa,U.S. Senate,Erick Paul Wyatt,REP,720043,0,0,5,5,
Tulsa,U.S. Senate,Andy Craig,REP,720043,0,0,1,1,
Tulsa,U.S. Senate,T. Shannon,REP,720043,0,0,27,27,
Tulsa,U.S. Senate,Randy Brogdon,REP,720043,0,0,7,7,
Tulsa,U.S. Senate,Eric Mccray,REP,720043,0,0,1,1,
Tulsa,U.S. Senate,Kevin Crow,REP,720043,0,0,0,0,
Tulsa,U.S. Senate,James Lankford,REP,720043,0,0,41,41,
Tulsa,U.S. Senate,Jason Weger,REP,720043,0,0,0,0,
Tulsa,Superintendent of Public Instruction,John Cox,DEM,720044,0,0,20,20,
Tulsa,Superintendent of Public Instruction,Jack Jr.,DEM,720044,0,0,3,3,
Tulsa,Superintendent of Public Instruction,Ivan Holmes,DEM,720044,0,0,6,6,
Tulsa,Superintendent of Public Instruction,Freda Deskin,DEM,720044,0,0,24,24,
Tulsa,U.S. Senate,Patrick Michael Hayes,DEM,720044,0,0,8,8,
Tulsa,U.S. Senate,Jim Rogers,DEM,720044,0,0,15,15,
Tulsa,U.S. Senate,Connie Johnson,DEM,720044,0,0,25,25,
Tulsa,Governor,Dax Ewbank,REP,720044,0,0,13,13,
Tulsa,Governor,Chad Moody,REP,720044,0,0,18,18,
Tulsa,Governor,Mary Fallin,REP,720044,0,0,123,123,
Tulsa,Superintendent of Public Instruction,Brian Kelly,REP,720044,0,0,29,29,
Tulsa,Superintendent of Public Instruction,Janet Costello Barresi,REP,720044,0,0,40,40,
Tulsa,Superintendent of Public Instruction,Joy Hofmeister,REP,720044,0,0,83,83,
Tulsa,Insurance Commissioner,Bill Viner,REP,720044,0,0,31,31,
Tulsa,Insurance Commissioner,John Doak,REP,720044,0,0,111,111,
Tulsa,Corporation Commissioner,Todd Hiett,REP,720044,0,0,92,92,
Tulsa,Corporation Commissioner,Cliff Branan,REP,720044,0,0,51,51,
Tulsa,U.S. Senate,Evelyn Rogers,REP,720044,0,0,7,7,
Tulsa,U.S. Senate,Rob Moye,REP,720044,0,0,1,1,
Tulsa,U.S. Senate,D. Jean Mcbride-Samuels,REP,720044,0,0,1,1,
Tulsa,U.S. Senate,Jim Inhofe,REP,720044,0,0,140,140,
Tulsa,U.S. Senate,Erick Paul Wyatt,REP,720044,0,0,5,5,
Tulsa,U.S. Senate,Andy Craig,REP,720044,0,0,1,1,
Tulsa,U.S. Senate,T. Shannon,REP,720044,0,0,60,60,
Tulsa,U.S. Senate,Randy Brogdon,REP,720044,0,0,16,16,
Tulsa,U.S. Senate,Eric Mccray,REP,720044,0,0,0,0,
Tulsa,U.S. Senate,Kevin Crow,REP,720044,0,0,3,3,
Tulsa,U.S. Senate,James Lankford,REP,720044,0,0,75,75,
Tulsa,U.S. Senate,Jason Weger,REP,720044,0,0,0,0,
Tulsa,Superintendent of Public Instruction,John Cox,DEM,720045,0,0,0,0,
Tulsa,Superintendent of Public Instruction,Jack Jr.,DEM,720045,0,0,0,0,
Tulsa,Superintendent of Public Instruction,Ivan Holmes,DEM,720045,0,0,0,0,
Tulsa,Superintendent of Public Instruction,Freda Deskin,DEM,720045,0,0,0,0,
Tulsa,U.S. Senate,Patrick Michael Hayes,DEM,720045,0,0,0,0,
Tulsa,U.S. Senate,Jim Rogers,DEM,720045,0,0,0,0,
Tulsa,U.S. Senate,Connie Johnson,DEM,720045,0,0,0,0,
Tulsa,Governor,Dax Ewbank,REP,720045,0,0,0,0,
Tulsa,Governor,Chad Moody,REP,720045,0,0,0,0,
Tulsa,Governor,Mary Fallin,REP,720045,0,0,0,0,
Tulsa,Superintendent of Public Instruction,Brian Kelly,REP,720045,0,0,0,0,
Tulsa,Superintendent of Public Instruction,Janet Costello Barresi,REP,720045,0,0,0,0,
Tulsa,Superintendent of Public Instruction,Joy Hofmeister,REP,720045,0,0,0,0,
Tulsa,Insurance Commissioner,Bill Viner,REP,720045,0,0,0,0,
Tulsa,Insurance Commissioner,John Doak,REP,720045,0,0,0,0,
Tulsa,Corporation Commissioner,Todd Hiett,REP,720045,0,0,0,0,
Tulsa,Corporation Commissioner,Cliff Branan,REP,720045,0,0,0,0,
Tulsa,U.S. Senate,Evelyn Rogers,REP,720045,0,0,0,0,
Tulsa,U.S. Senate,Rob Moye,REP,720045,0,0,0,0,
Tulsa,U.S. Senate,D. Jean Mcbride-Samuels,REP,720045,0,0,0,0,
Tulsa,U.S. Senate,Jim Inhofe,REP,720045,0,0,0,0,
Tulsa,U.S. Senate,Erick Paul Wyatt,REP,720045,0,0,0,0,
Tulsa,U.S. Senate,Andy Craig,REP,720045,0,0,0,0,
Tulsa,U.S. Senate,T. Shannon,REP,720045,0,0,0,0,
Tulsa,U.S. Senate,Randy Brogdon,REP,720045,0,0,0,0,
Tulsa,U.S. Senate,Eric Mccray,REP,720045,0,0,0,0,
Tulsa,U.S. Senate,Kevin Crow,REP,720045,0,0,0,0,
Tulsa,U.S. Senate,James Lankford,REP,720045,0,0,0,0,
Tulsa,U.S. Senate,Jason Weger,REP,720045,0,0,0,0,
Tulsa,Superintendent of Public Instruction,John Cox,DEM,720046,0,0,59,59,
Tulsa,Superintendent of Public Instruction,Jack Jr.,DEM,720046,0,0,28,28,
Tulsa,Superintendent of Public Instruction,Ivan Holmes,DEM,720046,0,0,15,15,
Tulsa,Superintendent of Public Instruction,Freda Deskin,DEM,720046,0,0,127,127,
Tulsa,U.S. Senate,Patrick Michael Hayes,DEM,720046,0,0,34,34,
Tulsa,U.S. Senate,Jim Rogers,DEM,720046,0,0,39,39,
Tulsa,U.S. Senate,Connie Johnson,DEM,720046,0,0,149,149,
Tulsa,Governor,Dax Ewbank,REP,720046,0,0,31,31,
Tulsa,Governor,Chad Moody,REP,720046,0,0,43,43,
Tulsa,Governor,Mary Fallin,REP,720046,0,0,153,153,
Tulsa,Superintendent of Public Instruction,Brian Kelly,REP,720046,0,0,31,31,
Tulsa,Superintendent of Public Instruction,Janet Costello Barresi,REP,720046,0,0,42,42,
Tulsa,Superintendent of Public Instruction,Joy Hofmeister,REP,720046,0,0,148,148,
Tulsa,Insurance Commissioner,Bill Viner,REP,720046,0,0,58,58,
Tulsa,Insurance Commissioner,John Doak,REP,720046,0,0,145,145,
Tulsa,Corporation Commissioner,Todd Hiett,REP,720046,0,0,112,112,
Tulsa,Corporation Commissioner,Cliff Branan,REP,720046,0,0,83,83,
Tulsa,U.S. Senate,Evelyn Rogers,REP,720046,0,0,34,34,
Tulsa,U.S. Senate,Rob Moye,REP,720046,0,0,6,6,
Tulsa,U.S. Senate,D. Jean Mcbride-Samuels,REP,720046,0,0,9,9,
Tulsa,U.S. Senate,Jim Inhofe,REP,720046,0,0,162,162,
Tulsa,U.S. Senate,Erick Paul Wyatt,REP,720046,0,0,11,11,
Tulsa,U.S. Senate,Andy Craig,REP,720046,0,0,3,3,
Tulsa,U.S. Senate,T. Shannon,REP,720046,0,0,74,74,
Tulsa,U.S. Senate,Randy Brogdon,REP,720046,0,0,33,33,
Tulsa,U.S. Senate,Eric Mccray,REP,720046,0,0,1,1,
Tulsa,U.S. Senate,Kevin Crow,REP,720046,0,0,5,5,
Tulsa,U.S. Senate,James Lankford,REP,720046,0,0,112,112,
Tulsa,U.S. Senate,Jason Weger,REP,720046,0,0,1,1,
Tulsa,Superintendent of Public Instruction,John Cox,DEM,720047,0,0,4,4,
Tulsa,Superintendent of Public Instruction,Jack Jr.,DEM,720047,0,0,3,3,
Tulsa,Superintendent of Public Instruction,Ivan Holmes,DEM,720047,0,0,0,0,
Tulsa,Superintendent of Public Instruction,Freda Deskin,DEM,720047,0,0,12,12,
Tulsa,U.S. Senate,Patrick Michael Hayes,DEM,720047,0,0,2,2,
Tulsa,U.S. Senate,Jim Rogers,DEM,720047,0,0,4,4,
Tulsa,U.S. Senate,Connie Johnson,DEM,720047,0,0,15,15,
Tulsa,Governor,Dax Ewbank,REP,720047,0,0,4,4,
Tulsa,Governor,Chad Moody,REP,720047,0,0,1,1,
Tulsa,Governor,Mary Fallin,REP,720047,0,0,13,13,
Tulsa,Superintendent of Public Instruction,Brian Kelly,REP,720047,0,0,5,5,
Tulsa,Superintendent of Public Instruction,Janet Costello Barresi,REP,720047,0,0,3,3,
Tulsa,Superintendent of Public Instruction,Joy Hofmeister,REP,720047,0,0,10,10,
Tulsa,Insurance Commissioner,Bill Viner,REP,720047,0,0,1,1,
Tulsa,Insurance Commissioner,John Doak,REP,720047,0,0,14,14,
Tulsa,Corporation Commissioner,Todd Hiett,REP,720047,0,0,8,8,
Tulsa,Corporation Commissioner,Cliff Branan,REP,720047,0,0,8,8,
Tulsa,U.S. Senate,Evelyn Rogers,REP,720047,0,0,0,0,
Tulsa,U.S. Senate,Rob Moye,REP,720047,0,0,0,0,
Tulsa,U.S. Senate,D. Jean Mcbride-Samuels,REP,720047,0,0,0,0,
Tulsa,U.S. Senate,Jim Inhofe,REP,720047,0,0,17,17,
Tulsa,U.S. Senate,Erick Paul Wyatt,REP,720047,0,0,1,1,
Tulsa,U.S. Senate,Andy Craig,REP,720047,0,0,0,0,
Tulsa,U.S. Senate,T. Shannon,REP,720047,0,0,9,9,
Tulsa,U.S. Senate,Randy Brogdon,REP,720047,0,0,2,2,
Tulsa,U.S. Senate,Eric Mccray,REP,720047,0,0,0,0,
Tulsa,U.S. Senate,Kevin Crow,REP,720047,0,0,1,1,
Tulsa,U.S. Senate,James Lankford,REP,720047,0,0,6,6,
Tulsa,U.S. Senate,Jason Weger,REP,720047,0,0,0,0,
Tulsa,Superintendent of Public Instruction,John Cox,DEM,720048,0,0,36,36,
Tulsa,Superintendent of Public Instruction,Jack Jr.,DEM,720048,0,0,9,9,
Tulsa,Superintendent of Public Instruction,Ivan Holmes,DEM,720048,0,0,16,16,
Tulsa,Superintendent of Public Instruction,Freda Deskin,DEM,720048,0,0,64,64,
Tulsa,U.S. Senate,Patrick Michael Hayes,DEM,720048,0,0,12,12,
Tulsa,U.S. Senate,Jim Rogers,DEM,720048,0,0,26,26,
Tulsa,U.S. Senate,Connie Johnson,DEM,720048,0,0,82,82,
Tulsa,Governor,Dax Ewbank,REP,720048,0,0,11,11,
Tulsa,Governor,Chad Moody,REP,720048,0,0,33,33,
Tulsa,Governor,Mary Fallin,REP,720048,0,0,101,101,
Tulsa,Superintendent of Public Instruction,Brian Kelly,REP,720048,0,0,13,13,
Tulsa,Superintendent of Public Instruction,Janet Costello Barresi,REP,720048,0,0,24,24,
Tulsa,Superintendent of Public Instruction,Joy Hofmeister,REP,720048,0,0,110,110,
Tulsa,Insurance Commissioner,Bill Viner,REP,720048,0,0,28,28,
Tulsa,Insurance Commissioner,John Doak,REP,720048,0,0,100,100,
Tulsa,Corporation Commissioner,Todd Hiett,REP,720048,0,0,63,63,
Tulsa,Corporation Commissioner,Cliff Branan,REP,720048,0,0,59,59,
Tulsa,U.S. Senate,Evelyn Rogers,REP,720048,0,0,12,12,
Tulsa,U.S. Senate,Rob Moye,REP,720048,0,0,2,2,
Tulsa,U.S. Senate,D. Jean Mcbride-Samuels,REP,720048,0,0,8,8,
Tulsa,U.S. Senate,Jim Inhofe,REP,720048,0,0,115,115,
Tulsa,U.S. Senate,Erick Paul Wyatt,REP,720048,0,0,8,8,
Tulsa,U.S. Senate,Andy Craig,REP,720048,0,0,1,1,
Tulsa,U.S. Senate,T. Shannon,REP,720048,0,0,41,41,
Tulsa,U.S. Senate,Randy Brogdon,REP,720048,0,0,11,11,
Tulsa,U.S. Senate,Eric Mccray,REP,720048,0,0,1,1,
Tulsa,U.S. Senate,Kevin Crow,REP,720048,0,0,4,4,
Tulsa,U.S. Senate,James Lankford,REP,720048,0,0,90,90,
Tulsa,U.S. Senate,Jason Weger,REP,720048,0,0,0,0,
Tulsa,Superintendent of Public Instruction,John Cox,DEM,720049,0,0,12,12,
Tulsa,Superintendent of Public Instruction,Jack Jr.,DEM,720049,0,0,4,4,
Tulsa,Superintendent of Public Instruction,Ivan Holmes,DEM,720049,0,0,6,6,
Tulsa,Superintendent of Public Instruction,Freda Deskin,DEM,720049,0,0,41,41,
Tulsa,U.S. Senate,Patrick Michael Hayes,DEM,720049,0,0,8,8,
Tulsa,U.S. Senate,Jim Rogers,DEM,720049,0,0,7,7,
Tulsa,U.S. Senate,Connie Johnson,DEM,720049,0,0,45,45,
Tulsa,Governor,Dax Ewbank,REP,720049,0,0,9,9,
Tulsa,Governor,Chad Moody,REP,720049,0,0,11,11,
Tulsa,Governor,Mary Fallin,REP,720049,0,0,32,32,
Tulsa,Superintendent of Public Instruction,Brian Kelly,REP,720049,0,0,7,7,
Tulsa,Superintendent of Public Instruction,Janet Costello Barresi,REP,720049,0,0,8,8,
Tulsa,Superintendent of Public Instruction,Joy Hofmeister,REP,720049,0,0,41,41,
Tulsa,Insurance Commissioner,Bill Viner,REP,720049,0,0,13,13,
Tulsa,Insurance Commissioner,John Doak,REP,720049,0,0,38,38,
Tulsa,Corporation Commissioner,Todd Hiett,REP,720049,0,0,29,29,
Tulsa,Corporation Commissioner,Cliff Branan,REP,720049,0,0,22,22,
Tulsa,U.S. Senate,Evelyn Rogers,REP,720049,0,0,7,7,
Tulsa,U.S. Senate,Rob Moye,REP,720049,0,0,0,0,
Tulsa,U.S. Senate,D. Jean Mcbride-Samuels,REP,720049,0,0,2,2,
Tulsa,U.S. Senate,Jim Inhofe,REP,720049,0,0,41,41,
Tulsa,U.S. Senate,Erick Paul Wyatt,REP,720049,0,0,3,3,
Tulsa,U.S. Senate,Andy Craig,REP,720049,0,0,1,1,
Tulsa,U.S. Senate,T. Shannon,REP,720049,0,0,24,24,
Tulsa,U.S. Senate,Randy Brogdon,REP,720049,0,0,6,6,
Tulsa,U.S. Senate,Eric Mccray,REP,720049,0,0,0,0,
Tulsa,U.S. Senate,Kevin Crow,REP,720049,0,0,1,1,
Tulsa,U.S. Senate,James Lankford,REP,720049,0,0,23,23,
Tulsa,U.S. Senate,Jason Weger,REP,720049,0,0,0,0,
Tulsa,Superintendent of Public Instruction,John Cox,DEM,720050,0,0,19,19,
Tulsa,Superintendent of Public Instruction,Jack Jr.,DEM,720050,0,0,6,6,
Tulsa,Superintendent of Public Instruction,Ivan Holmes,DEM,720050,0,0,6,6,
Tulsa,Superintendent of Public Instruction,Freda Deskin,DEM,720050,0,0,48,48,
Tulsa,U.S. Senate,Patrick Michael Hayes,DEM,720050,0,0,7,7,
Tulsa,U.S. Senate,Jim Rogers,DEM,720050,0,0,7,7,
Tulsa,U.S. Senate,Connie Johnson,DEM,720050,0,0,65,65,
Tulsa,Governor,Dax Ewbank,REP,720050,0,0,13,13,
Tulsa,Governor,Chad Moody,REP,720050,0,0,16,16,
Tulsa,Governor,Mary Fallin,REP,720050,0,0,56,56,
Tulsa,Superintendent of Public Instruction,Brian Kelly,REP,720050,0,0,13,13,
Tulsa,Superintendent of Public Instruction,Janet Costello Barresi,REP,720050,0,0,12,12,
Tulsa,Superintendent of Public Instruction,Joy Hofmeister,REP,720050,0,0,57,57,
Tulsa,Insurance Commissioner,Bill Viner,REP,720050,0,0,19,19,
Tulsa,Insurance Commissioner,John Doak,REP,720050,0,0,55,55,
Tulsa,Corporation Commissioner,Todd Hiett,REP,720050,0,0,37,37,
Tulsa,Corporation Commissioner,Cliff Branan,REP,720050,0,0,37,37,
Tulsa,U.S. Senate,Evelyn Rogers,REP,720050,0,0,4,4,
Tulsa,U.S. Senate,Rob Moye,REP,720050,0,0,1,1,
Tulsa,U.S. Senate,D. Jean Mcbride-Samuels,REP,720050,0,0,3,3,
Tulsa,U.S. Senate,Jim Inhofe,REP,720050,0,0,67,67,
Tulsa,U.S. Senate,Erick Paul Wyatt,REP,720050,0,0,8,8,
Tulsa,U.S. Senate,Andy Craig,REP,720050,0,0,1,1,
Tulsa,U.S. Senate,T. Shannon,REP,720050,0,0,19,19,
Tulsa,U.S. Senate,Randy Brogdon,REP,720050,0,0,17,17,
Tulsa,U.S. Senate,Eric Mccray,REP,720050,0,0,1,1,
Tulsa,U.S. Senate,Kevin Crow,REP,720050,0,0,1,1,
Tulsa,U.S. Senate,James Lankford,REP,720050,0,0,42,42,
Tulsa,U.S. Senate,Jason Weger,REP,720050,0,0,1,1,
Tulsa,Superintendent of Public Instruction,John Cox,DEM,720051,0,0,30,30,
Tulsa,Superintendent of Public Instruction,Jack Jr.,DEM,720051,0,0,13,13,
Tulsa,Superintendent of Public Instruction,Ivan Holmes,DEM,720051,0,0,7,7,
Tulsa,Superintendent of Public Instruction,Freda Deskin,DEM,720051,0,0,43,43,
Tulsa,U.S. Senate,Patrick Michael Hayes,DEM,720051,0,0,15,15,
Tulsa,U.S. Senate,Jim Rogers,DEM,720051,0,0,11,11,
Tulsa,U.S. Senate,Connie Johnson,DEM,720051,0,0,63,63,
Tulsa,Governor,Dax Ewbank,REP,720051,0,0,18,18,
Tulsa,Governor,Chad Moody,REP,720051,0,0,20,20,
Tulsa,Governor,Mary Fallin,REP,720051,0,0,71,71,
Tulsa,Superintendent of Public Instruction,Brian Kelly,REP,720051,0,0,18,18,
Tulsa,Superintendent of Public Instruction,Janet Costello Barresi,REP,720051,0,0,19,19,
Tulsa,Superintendent of Public Instruction,Joy Hofmeister,REP,720051,0,0,73,73,
Tulsa,Insurance Commissioner,Bill Viner,REP,720051,0,0,13,13,
Tulsa,Insurance Commissioner,John Doak,REP,720051,0,0,90,90,
Tulsa,Corporation Commissioner,Todd Hiett,REP,720051,0,0,66,66,
Tulsa,Corporation Commissioner,Cliff Branan,REP,720051,0,0,36,36,
Tulsa,U.S. Senate,Evelyn Rogers,REP,720051,0,0,10,10,
Tulsa,U.S. Senate,Rob Moye,REP,720051,0,0,2,2,
Tulsa,U.S. Senate,D. Jean Mcbride-Samuels,REP,720051,0,0,6,6,
Tulsa,U.S. Senate,Jim Inhofe,REP,720051,0,0,89,89,
Tulsa,U.S. Senate,Erick Paul Wyatt,REP,720051,0,0,4,4,
Tulsa,U.S. Senate,Andy Craig,REP,720051,0,0,1,1,
Tulsa,U.S. Senate,T. Shannon,REP,720051,0,0,43,43,
Tulsa,U.S. Senate,Randy Brogdon,REP,720051,0,0,19,19,
Tulsa,U.S. Senate,Eric Mccray,REP,720051,0,0,4,4,
Tulsa,U.S. Senate,Kevin Crow,REP,720051,0,0,4,4,
Tulsa,U.S. Senate,James Lankford,REP,720051,0,0,42,42,
Tulsa,U.S. Senate,Jason Weger,REP,720051,0,0,0,0,
Tulsa,Superintendent of Public Instruction,John Cox,DEM,720052,0,0,54,54,
Tulsa,Superintendent of Public Instruction,Jack Jr.,DEM,720052,0,0,26,26,
Tulsa,Superintendent of Public Instruction,Ivan Holmes,DEM,720052,0,0,5,5,
Tulsa,Superintendent of Public Instruction,Freda Deskin,DEM,720052,0,0,106,106,
Tulsa,U.S. Senate,Patrick Michael Hayes,DEM,720052,0,0,25,25,
Tulsa,U.S. Senate,Jim Rogers,DEM,720052,0,0,32,32,
Tulsa,U.S. Senate,Connie Johnson,DEM,720052,0,0,130,130,
Tulsa,Governor,Dax Ewbank,REP,720052,0,0,22,22,
Tulsa,Governor,Chad Moody,REP,720052,0,0,44,44,
Tulsa,Governor,Mary Fallin,REP,720052,0,0,173,173,
Tulsa,Superintendent of Public Instruction,Brian Kelly,REP,720052,0,0,22,22,
Tulsa,Superintendent of Public Instruction,Janet Costello Barresi,REP,720052,0,0,38,38,
Tulsa,Superintendent of Public Instruction,Joy Hofmeister,REP,720052,0,0,185,185,
Tulsa,Insurance Commissioner,Bill Viner,REP,720052,0,0,45,45,
Tulsa,Insurance Commissioner,John Doak,REP,720052,0,0,174,174,
Tulsa,Corporation Commissioner,Todd Hiett,REP,720052,0,0,123,123,
Tulsa,Corporation Commissioner,Cliff Branan,REP,720052,0,0,94,94,
Tulsa,U.S. Senate,Evelyn Rogers,REP,720052,0,0,12,12,
Tulsa,U.S. Senate,Rob Moye,REP,720052,0,0,6,6,
Tulsa,U.S. Senate,D. Jean Mcbride-Samuels,REP,720052,0,0,12,12,
Tulsa,U.S. Senate,Jim Inhofe,REP,720052,0,0,201,201,
Tulsa,U.S. Senate,Erick Paul Wyatt,REP,720052,0,0,11,11,
Tulsa,U.S. Senate,Andy Craig,REP,720052,0,0,4,4,
Tulsa,U.S. Senate,T. Shannon,REP,720052,0,0,78,78,
Tulsa,U.S. Senate,Randy Brogdon,REP,720052,0,0,18,18,
Tulsa,U.S. Senate,Eric Mccray,REP,720052,0,0,3,3,
Tulsa,U.S. Senate,Kevin Crow,REP,720052,0,0,1,1,
Tulsa,U.S. Senate,James Lankford,REP,720052,0,0,141,141,
Tulsa,U.S. Senate,Jason Weger,REP,720052,0,0,1,1,
Tulsa,Superintendent of Public Instruction,John Cox,DEM,720053,0,0,26,26,
Tulsa,Superintendent of Public Instruction,Jack Jr.,DEM,720053,0,0,14,14,
Tulsa,Superintendent of Public Instruction,Ivan Holmes,DEM,720053,0,0,8,8,
Tulsa,Superintendent of Public Instruction,Freda Deskin,DEM,720053,0,0,52,52,
Tulsa,U.S. Senate,Patrick Michael Hayes,DEM,720053,0,0,23,23,
Tulsa,U.S. Senate,Jim Rogers,DEM,720053,0,0,29,29,
Tulsa,U.S. Senate,Connie Johnson,DEM,720053,0,0,46,46,
Tulsa,Governor,Dax Ewbank,REP,720053,0,0,11,11,
Tulsa,Governor,Chad Moody,REP,720053,0,0,25,25,
Tulsa,Governor,Mary Fallin,REP,720053,0,0,154,154,
Tulsa,Superintendent of Public Instruction,Brian Kelly,REP,720053,0,0,34,34,
Tulsa,Superintendent of Public Instruction,Janet Costello Barresi,REP,720053,0,0,43,43,
Tulsa,Superintendent of Public Instruction,Joy Hofmeister,REP,720053,0,0,111,111,
Tulsa,Insurance Commissioner,Bill Viner,REP,720053,0,0,42,42,
Tulsa,Insurance Commissioner,John Doak,REP,720053,0,0,135,135,
Tulsa,Corporation Commissioner,Todd Hiett,REP,720053,0,0,111,111,
Tulsa,Corporation Commissioner,Cliff Branan,REP,720053,0,0,65,65,
Tulsa,U.S. Senate,Evelyn Rogers,REP,720053,0,0,4,4,
Tulsa,U.S. Senate,Rob Moye,REP,720053,0,0,5,5,
Tulsa,U.S. Senate,D. Jean Mcbride-Samuels,REP,720053,0,0,4,4,
Tulsa,U.S. Senate,Jim Inhofe,REP,720053,0,0,168,168,
Tulsa,U.S. Senate,Erick Paul Wyatt,REP,720053,0,0,7,7,
Tulsa,U.S. Senate,Andy Craig,REP,720053,0,0,0,0,
Tulsa,U.S. Senate,T. Shannon,REP,720053,0,0,91,91,
Tulsa,U.S. Senate,Randy Brogdon,REP,720053,0,0,13,13,
Tulsa,U.S. Senate,Eric Mccray,REP,720053,0,0,3,3,
Tulsa,U.S. Senate,Kevin Crow,REP,720053,0,0,1,1,
Tulsa,U.S. Senate,James Lankford,REP,720053,0,0,84,84,
Tulsa,U.S. Senate,Jason Weger,REP,720053,0,0,1,1,
Tulsa,Superintendent of Public Instruction,John Cox,DEM,720054,0,0,45,45,
Tulsa,Superintendent of Public Instruction,Jack Jr.,DEM,720054,0,0,19,19,
Tulsa,Superintendent of Public Instruction,Ivan Holmes,DEM,720054,0,0,10,10,
Tulsa,Superintendent of Public Instruction,Freda Deskin,DEM,720054,0,0,84,84,
Tulsa,U.S. Senate,Patrick Michael Hayes,DEM,720054,0,0,22,22,
Tulsa,U.S. Senate,Jim Rogers,DEM,720054,0,0,34,34,
Tulsa,U.S. Senate,Connie Johnson,DEM,720054,0,0,102,102,
Tulsa,Governor,Dax Ewbank,REP,720054,0,0,24,24,
Tulsa,Governor,Chad Moody,REP,720054,0,0,36,36,
Tulsa,Governor,Mary Fallin,REP,720054,0,0,148,148,
Tulsa,Superintendent of Public Instruction,Brian Kelly,REP,720054,0,0,36,36,
Tulsa,Superintendent of Public Instruction,Janet Costello Barresi,REP,720054,0,0,33,33,
Tulsa,Superintendent of Public Instruction,Joy Hofmeister,REP,720054,0,0,143,143,
Tulsa,Insurance Commissioner,Bill Viner,REP,720054,0,0,49,49,
Tulsa,Insurance Commissioner,John Doak,REP,720054,0,0,149,149,
Tulsa,Corporation Commissioner,Todd Hiett,REP,720054,0,0,117,117,
Tulsa,Corporation Commissioner,Cliff Branan,REP,720054,0,0,83,83,
Tulsa,U.S. Senate,Evelyn Rogers,REP,720054,0,0,15,15,
Tulsa,U.S. Senate,Rob Moye,REP,720054,0,0,5,5,
Tulsa,U.S. Senate,D. Jean Mcbride-Samuels,REP,720054,0,0,6,6,
Tulsa,U.S. Senate,Jim Inhofe,REP,720054,0,0,178,178,
Tulsa,U.S. Senate,Erick Paul Wyatt,REP,720054,0,0,7,7,
Tulsa,U.S. Senate,Andy Craig,REP,720054,0,0,1,1,
Tulsa,U.S. Senate,T. Shannon,REP,720054,0,0,75,75,
Tulsa,U.S. Senate,Randy Brogdon,REP,720054,0,0,27,27,
Tulsa,U.S. Senate,Eric Mccray,REP,720054,0,0,3,3,
Tulsa,U.S. Senate,Kevin Crow,REP,720054,0,0,2,2,
Tulsa,U.S. Senate,James Lankford,REP,720054,0,0,101,101,
Tulsa,U.S. Senate,Jason Weger,REP,720054,0,0,1,1,
Tulsa,Superintendent of Public Instruction,John Cox,DEM,720055,0,0,18,18,
Tulsa,Superintendent of Public Instruction,Jack Jr.,DEM,720055,0,0,6,6,
Tulsa,Superintendent of Public Instruction,Ivan Holmes,DEM,720055,0,0,4,4,
Tulsa,Superintendent of Public Instruction,Freda Deskin,DEM,720055,0,0,40,40,
Tulsa,U.S. Senate,Patrick Michael Hayes,DEM,720055,0,0,12,12,
Tulsa,U.S. Senate,Jim Rogers,DEM,720055,0,0,11,11,
Tulsa,U.S. Senate,Connie Johnson,DEM,720055,0,0,42,42,
Tulsa,Governor,Dax Ewbank,REP,720055,0,0,14,14,
Tulsa,Governor,Chad Moody,REP,720055,0,0,17,17,
Tulsa,Governor,Mary Fallin,REP,720055,0,0,87,87,
Tulsa,Superintendent of Public Instruction,Brian Kelly,REP,720055,0,0,28,28,
Tulsa,Superintendent of Public Instruction,Janet Costello Barresi,REP,720055,0,0,18,18,
Tulsa,Superintendent of Public Instruction,Joy Hofmeister,REP,720055,0,0,73,73,
Tulsa,Insurance Commissioner,Bill Viner,REP,720055,0,0,22,22,
Tulsa,Insurance Commissioner,John Doak,REP,720055,0,0,88,88,
Tulsa,Corporation Commissioner,Todd Hiett,REP,720055,0,0,56,56,
Tulsa,Corporation Commissioner,Cliff Branan,REP,720055,0,0,54,54,
Tulsa,U.S. Senate,Evelyn Rogers,REP,720055,0,0,8,8,
Tulsa,U.S. Senate,Rob Moye,REP,720055,0,0,2,2,
Tulsa,U.S. Senate,D. Jean Mcbride-Samuels,REP,720055,0,0,2,2,
Tulsa,U.S. Senate,Jim Inhofe,REP,720055,0,0,102,102,
Tulsa,U.S. Senate,Erick Paul Wyatt,REP,720055,0,0,4,4,
Tulsa,U.S. Senate,Andy Craig,REP,720055,0,0,3,3,
Tulsa,U.S. Senate,T. Shannon,REP,720055,0,0,43,43,
Tulsa,U.S. Senate,Randy Brogdon,REP,720055,0,0,7,7,
Tulsa,U.S. Senate,Eric Mccray,REP,720055,0,0,0,0,
Tulsa,U.S. Senate,Kevin Crow,REP,720055,0,0,0,0,
Tulsa,U.S. Senate,James Lankford,REP,720055,0,0,65,65,
Tulsa,U.S. Senate,Jason Weger,REP,720055,0,0,0,0,
Tulsa,Superintendent of Public Instruction,John Cox,DEM,720056,0,0,27,27,
Tulsa,Superintendent of Public Instruction,Jack Jr.,DEM,720056,0,0,16,16,
Tulsa,Superintendent of Public Instruction,Ivan Holmes,DEM,720056,0,0,4,4,
Tulsa,Superintendent of Public Instruction,Freda Deskin,DEM,720056,0,0,34,34,
Tulsa,U.S. Senate,Patrick Michael Hayes,DEM,720056,0,0,12,12,
Tulsa,U.S. Senate,Jim Rogers,DEM,720056,0,0,23,23,
Tulsa,U.S. Senate,Connie Johnson,DEM,720056,0,0,43,43,
Tulsa,Governor,Dax Ewbank,REP,720056,0,0,13,13,
Tulsa,Governor,Chad Moody,REP,720056,0,0,14,14,
Tulsa,Governor,Mary Fallin,REP,720056,0,0,140,140,
Tulsa,Superintendent of Public Instruction,Brian Kelly,REP,720056,0,0,28,28,
Tulsa,Superintendent of Public Instruction,Janet Costello Barresi,REP,720056,0,0,41,41,
Tulsa,Superintendent of Public Instruction,Joy Hofmeister,REP,720056,0,0,94,94,
Tulsa,Insurance Commissioner,Bill Viner,REP,720056,0,0,27,27,
Tulsa,Insurance Commissioner,John Doak,REP,720056,0,0,127,127,
Tulsa,Corporation Commissioner,Todd Hiett,REP,720056,0,0,70,70,
Tulsa,Corporation Commissioner,Cliff Branan,REP,720056,0,0,79,79,
Tulsa,U.S. Senate,Evelyn Rogers,REP,720056,0,0,5,5,
Tulsa,U.S. Senate,Rob Moye,REP,720056,0,0,1,1,
Tulsa,U.S. Senate,D. Jean Mcbride-Samuels,REP,720056,0,0,2,2,
Tulsa,U.S. Senate,Jim Inhofe,REP,720056,0,0,152,152,
Tulsa,U.S. Senate,Erick Paul Wyatt,REP,720056,0,0,6,6,
Tulsa,U.S. Senate,Andy Craig,REP,720056,0,0,1,1,
Tulsa,U.S. Senate,T. Shannon,REP,720056,0,0,66,66,
Tulsa,U.S. Senate,Randy Brogdon,REP,720056,0,0,11,11,
Tulsa,U.S. Senate,Eric Mccray,REP,720056,0,0,0,0,
Tulsa,U.S. Senate,Kevin Crow,REP,720056,0,0,1,1,
Tulsa,U.S. Senate,James Lankford,REP,720056,0,0,87,87,
Tulsa,U.S. Senate,Jason Weger,REP,720056,0,0,1,1,
Tulsa,Superintendent of Public Instruction,John Cox,DEM,720057,0,0,9,9,
Tulsa,Superintendent of Public Instruction,Jack Jr.,DEM,720057,0,0,4,4,
Tulsa,Superintendent of Public Instruction,Ivan Holmes,DEM,720057,0,0,2,2,
Tulsa,Superintendent of Public Instruction,Freda Deskin,DEM,720057,0,0,13,13,
Tulsa,U.S. Senate,Patrick Michael Hayes,DEM,720057,0,0,3,3,
Tulsa,U.S. Senate,Jim Rogers,DEM,720057,0,0,11,11,
Tulsa,U.S. Senate,Connie Johnson,DEM,720057,0,0,12,12,
Tulsa,Governor,Dax Ewbank,REP,720057,0,0,5,5,
Tulsa,Governor,Chad Moody,REP,720057,0,0,11,11,
Tulsa,Governor,Mary Fallin,REP,720057,0,0,51,51,
Tulsa,Superintendent of Public Instruction,Brian Kelly,REP,720057,0,0,15,15,
Tulsa,Superintendent of Public Instruction,Janet Costello Barresi,REP,720057,0,0,14,14,
Tulsa,Superintendent of Public Instruction,Joy Hofmeister,REP,720057,0,0,39,39,
Tulsa,Insurance Commissioner,Bill Viner,REP,720057,0,0,17,17,
Tulsa,Insurance Commissioner,John Doak,REP,720057,0,0,45,45,
Tulsa,Corporation Commissioner,Todd Hiett,REP,720057,0,0,38,38,
Tulsa,Corporation Commissioner,Cliff Branan,REP,720057,0,0,22,22,
Tulsa,U.S. Senate,Evelyn Rogers,REP,720057,0,0,4,4,
Tulsa,U.S. Senate,Rob Moye,REP,720057,0,0,0,0,
Tulsa,U.S. Senate,D. Jean Mcbride-Samuels,REP,720057,0,0,1,1,
Tulsa,U.S. Senate,Jim Inhofe,REP,720057,0,0,60,60,
Tulsa,U.S. Senate,Erick Paul Wyatt,REP,720057,0,0,3,3,
Tulsa,U.S. Senate,Andy Craig,REP,720057,0,0,0,0,
Tulsa,U.S. Senate,T. Shannon,REP,720057,0,0,21,21,
Tulsa,U.S. Senate,Randy Brogdon,REP,720057,0,0,9,9,
Tulsa,U.S. Senate,Eric Mccray,REP,720057,0,0,0,0,
Tulsa,U.S. Senate,Kevin Crow,REP,720057,0,0,2,2,
Tulsa,U.S. Senate,James Lankford,REP,720057,0,0,36,36,
Tulsa,U.S. Senate,Jason Weger,REP,720057,0,0,1,1,
Tulsa,Superintendent of Public Instruction,John Cox,DEM,720058,0,0,21,21,
Tulsa,Superintendent of Public Instruction,Jack Jr.,DEM,720058,0,0,4,4,
Tulsa,Superintendent of Public Instruction,Ivan Holmes,DEM,720058,0,0,2,2,
Tulsa,Superintendent of Public Instruction,Freda Deskin,DEM,720058,0,0,19,19,
Tulsa,U.S. Senate,Patrick Michael Hayes,DEM,720058,0,0,8,8,
Tulsa,U.S. Senate,Jim Rogers,DEM,720058,0,0,10,10,
Tulsa,U.S. Senate,Connie Johnson,DEM,720058,0,0,23,23,
Tulsa,Governor,Dax Ewbank,REP,720058,0,0,11,11,
Tulsa,Governor,Chad Moody,REP,720058,0,0,11,11,
Tulsa,Governor,Mary Fallin,REP,720058,0,0,93,93,
Tulsa,Superintendent of Public Instruction,Brian Kelly,REP,720058,0,0,27,27,
Tulsa,Superintendent of Public Instruction,Janet Costello Barresi,REP,720058,0,0,28,28,
Tulsa,Superintendent of Public Instruction,Joy Hofmeister,REP,720058,0,0,55,55,
Tulsa,Insurance Commissioner,Bill Viner,REP,720058,0,0,26,26,
Tulsa,Insurance Commissioner,John Doak,REP,720058,0,0,77,77,
Tulsa,Corporation Commissioner,Todd Hiett,REP,720058,0,0,51,51,
Tulsa,Corporation Commissioner,Cliff Branan,REP,720058,0,0,49,49,
Tulsa,U.S. Senate,Evelyn Rogers,REP,720058,0,0,5,5,
Tulsa,U.S. Senate,Rob Moye,REP,720058,0,0,4,4,
Tulsa,U.S. Senate,D. Jean Mcbride-Samuels,REP,720058,0,0,0,0,
Tulsa,U.S. Senate,Jim Inhofe,REP,720058,0,0,97,97,
Tulsa,U.S. Senate,Erick Paul Wyatt,REP,720058,0,0,5,5,
Tulsa,U.S. Senate,Andy Craig,REP,720058,0,0,3,3,
Tulsa,U.S. Senate,T. Shannon,REP,720058,0,0,54,54,
Tulsa,U.S. Senate,Randy Brogdon,REP,720058,0,0,9,9,
Tulsa,U.S. Senate,Eric Mccray,REP,720058,0,0,0,0,
Tulsa,U.S. Senate,Kevin Crow,REP,720058,0,0,4,4,
Tulsa,U.S. Senate,James Lankford,REP,720058,0,0,44,44,
Tulsa,U.S. Senate,Jason Weger,REP,720058,0,0,0,0,
Tulsa,Superintendent of Public Instruction,John Cox,DEM,720059,0,0,20,20,
Tulsa,Superintendent of Public Instruction,Jack Jr.,DEM,720059,0,0,4,4,
Tulsa,Superintendent of Public Instruction,Ivan Holmes,DEM,720059,0,0,3,3,
Tulsa,Superintendent of Public Instruction,Freda Deskin,DEM,720059,0,0,27,27,
Tulsa,U.S. Senate,Patrick Michael Hayes,DEM,720059,0,0,11,11,
Tulsa,U.S. Senate,Jim Rogers,DEM,720059,0,0,19,19,
Tulsa,U.S. Senate,Connie Johnson,DEM,720059,0,0,23,23,
Tulsa,Governor,Dax Ewbank,REP,720059,0,0,13,13,
Tulsa,Governor,Chad Moody,REP,720059,0,0,23,23,
Tulsa,Governor,Mary Fallin,REP,720059,0,0,63,63,
Tulsa,Superintendent of Public Instruction,Brian Kelly,REP,720059,0,0,25,25,
Tulsa,Superintendent of Public Instruction,Janet Costello Barresi,REP,720059,0,0,17,17,
Tulsa,Superintendent of Public Instruction,Joy Hofmeister,REP,720059,0,0,57,57,
Tulsa,Insurance Commissioner,Bill Viner,REP,720059,0,0,18,18,
Tulsa,Insurance Commissioner,John Doak,REP,720059,0,0,76,76,
Tulsa,Corporation Commissioner,Todd Hiett,REP,720059,0,0,60,60,
Tulsa,Corporation Commissioner,Cliff Branan,REP,720059,0,0,37,37,
Tulsa,U.S. Senate,Evelyn Rogers,REP,720059,0,0,5,5,
Tulsa,U.S. Senate,Rob Moye,REP,720059,0,0,2,2,
Tulsa,U.S. Senate,D. Jean Mcbride-Samuels,REP,720059,0,0,2,2,
Tulsa,U.S. Senate,Jim Inhofe,REP,720059,0,0,87,87,
Tulsa,U.S. Senate,Erick Paul Wyatt,REP,720059,0,0,3,3,
Tulsa,U.S. Senate,Andy Craig,REP,720059,0,0,0,0,
Tulsa,U.S. Senate,T. Shannon,REP,720059,0,0,39,39,
Tulsa,U.S. Senate,Randy Brogdon,REP,720059,0,0,10,10,
Tulsa,U.S. Senate,Eric Mccray,REP,720059,0,0,1,1,
Tulsa,U.S. Senate,Kevin Crow,REP,720059,0,0,2,2,
Tulsa,U.S. Senate,James Lankford,REP,720059,0,0,47,47,
Tulsa,U.S. Senate,Jason Weger,REP,720059,0,0,0,0,
Tulsa,Superintendent of Public Instruction,John Cox,DEM,720060,0,0,25,25,
Tulsa,Superintendent of Public Instruction,Jack Jr.,DEM,720060,0,0,9,9,
Tulsa,Superintendent of Public Instruction,Ivan Holmes,DEM,720060,0,0,1,1,
Tulsa,Superintendent of Public Instruction,Freda Deskin,DEM,720060,0,0,36,36,
Tulsa,U.S. Senate,Patrick Michael Hayes,DEM,720060,0,0,13,13,
Tulsa,U.S. Senate,Jim Rogers,DEM,720060,0,0,21,21,
Tulsa,U.S. Senate,Connie Johnson,DEM,720060,0,0,36,36,
Tulsa,Governor,Dax Ewbank,REP,720060,0,0,14,14,
Tulsa,Governor,Chad Moody,REP,720060,0,0,21,21,
Tulsa,Governor,Mary Fallin,REP,720060,0,0,82,82,
Tulsa,Superintendent of Public Instruction,Brian Kelly,REP,720060,0,0,27,27,
Tulsa,Superintendent of Public Instruction,Janet Costello Barresi,REP,720060,0,0,12,12,
Tulsa,Superintendent of Public Instruction,Joy Hofmeister,REP,720060,0,0,77,77,
Tulsa,Insurance Commissioner,Bill Viner,REP,720060,0,0,21,21,
Tulsa,Insurance Commissioner,John Doak,REP,720060,0,0,90,90,
Tulsa,Corporation Commissioner,Todd Hiett,REP,720060,0,0,70,70,
Tulsa,Corporation Commissioner,Cliff Branan,REP,720060,0,0,37,37,
Tulsa,U.S. Senate,Evelyn Rogers,REP,720060,0,0,7,7,
Tulsa,U.S. Senate,Rob Moye,REP,720060,0,0,3,3,
Tulsa,U.S. Senate,D. Jean Mcbride-Samuels,REP,720060,0,0,3,3,
Tulsa,U.S. Senate,Jim Inhofe,REP,720060,0,0,95,95,
Tulsa,U.S. Senate,Erick Paul Wyatt,REP,720060,0,0,10,10,
Tulsa,U.S. Senate,Andy Craig,REP,720060,0,0,1,1,
Tulsa,U.S. Senate,T. Shannon,REP,720060,0,0,54,54,
Tulsa,U.S. Senate,Randy Brogdon,REP,720060,0,0,10,10,
Tulsa,U.S. Senate,Eric Mccray,REP,720060,0,0,0,0,
Tulsa,U.S. Senate,Kevin Crow,REP,720060,0,0,0,0,
Tulsa,U.S. Senate,James Lankford,REP,720060,0,0,51,51,
Tulsa,U.S. Senate,Jason Weger,REP,720060,0,0,1,1,
Tulsa,Superintendent of Public Instruction,John Cox,DEM,720061,0,0,34,34,
Tulsa,Superintendent of Public Instruction,Jack Jr.,DEM,720061,0,0,8,8,
Tulsa,Superintendent of Public Instruction,Ivan Holmes,DEM,720061,0,0,7,7,
Tulsa,Superintendent of Public Instruction,Freda Deskin,DEM,720061,0,0,39,39,
Tulsa,U.S. Senate,Patrick Michael Hayes,DEM,720061,0,0,22,22,
Tulsa,U.S. Senate,Jim Rogers,DEM,720061,0,0,24,24,
Tulsa,U.S. Senate,Connie Johnson,DEM,720061,0,0,39,39,
Tulsa,Governor,Dax Ewbank,REP,720061,0,0,12,12,
Tulsa,Governor,Chad Moody,REP,720061,0,0,16,16,
Tulsa,Governor,Mary Fallin,REP,720061,0,0,107,107,
Tulsa,Superintendent of Public Instruction,Brian Kelly,REP,720061,0,0,37,37,
Tulsa,Superintendent of Public Instruction,Janet Costello Barresi,REP,720061,0,0,22,22,
Tulsa,Superintendent of Public Instruction,Joy Hofmeister,REP,720061,0,0,71,71,
Tulsa,Insurance Commissioner,Bill Viner,REP,720061,0,0,30,30,
Tulsa,Insurance Commissioner,John Doak,REP,720061,0,0,96,96,
Tulsa,Corporation Commissioner,Todd Hiett,REP,720061,0,0,68,68,
Tulsa,Corporation Commissioner,Cliff Branan,REP,720061,0,0,59,59,
Tulsa,U.S. Senate,Evelyn Rogers,REP,720061,0,0,9,9,
Tulsa,U.S. Senate,Rob Moye,REP,720061,0,0,1,1,
Tulsa,U.S. Senate,D. Jean Mcbride-Samuels,REP,720061,0,0,4,4,
Tulsa,U.S. Senate,Jim Inhofe,REP,720061,0,0,117,117,
Tulsa,U.S. Senate,Erick Paul Wyatt,REP,720061,0,0,3,3,
Tulsa,U.S. Senate,Andy Craig,REP,720061,0,0,0,0,
Tulsa,U.S. Senate,T. Shannon,REP,720061,0,0,62,62,
Tulsa,U.S. Senate,Randy Brogdon,REP,720061,0,0,12,12,
Tulsa,U.S. Senate,Eric Mccray,REP,720061,0,0,2,2,
Tulsa,U.S. Senate,Kevin Crow,REP,720061,0,0,5,5,
Tulsa,U.S. Senate,James Lankford,REP,720061,0,0,58,58,
Tulsa,U.S. Senate,Jason Weger,REP,720061,0,0,0,0,
Tulsa,Superintendent of Public Instruction,John Cox,DEM,720062,0,0,51,51,
Tulsa,Superintendent of Public Instruction,Jack Jr.,DEM,720062,0,0,33,33,
Tulsa,Superintendent of Public Instruction,Ivan Holmes,DEM,720062,0,0,12,12,
Tulsa,Superintendent of Public Instruction,Freda Deskin,DEM,720062,0,0,114,114,
Tulsa,U.S. Senate,Patrick Michael Hayes,DEM,720062,0,0,25,25,
Tulsa,U.S. Senate,Jim Rogers,DEM,720062,0,0,33,33,
Tulsa,U.S. Senate,Connie Johnson,DEM,720062,0,0,140,140,
Tulsa,Governor,Dax Ewbank,REP,720062,0,0,23,23,
Tulsa,Governor,Chad Moody,REP,720062,0,0,69,69,
Tulsa,Governor,Mary Fallin,REP,720062,0,0,262,262,
Tulsa,Superintendent of Public Instruction,Brian Kelly,REP,720062,0,0,43,43,
Tulsa,Superintendent of Public Instruction,Janet Costello Barresi,REP,720062,0,0,59,59,
Tulsa,Superintendent of Public Instruction,Joy Hofmeister,REP,720062,0,0,260,260,
Tulsa,Insurance Commissioner,Bill Viner,REP,720062,0,0,67,67,
Tulsa,Insurance Commissioner,John Doak,REP,720062,0,0,250,250,
Tulsa,Corporation Commissioner,Todd Hiett,REP,720062,0,0,200,200,
Tulsa,Corporation Commissioner,Cliff Branan,REP,720062,0,0,127,127,
Tulsa,U.S. Senate,Evelyn Rogers,REP,720062,0,0,34,34,
Tulsa,U.S. Senate,Rob Moye,REP,720062,0,0,9,9,
Tulsa,U.S. Senate,D. Jean Mcbride-Samuels,REP,720062,0,0,9,9,
Tulsa,U.S. Senate,Jim Inhofe,REP,720062,0,0,294,294,
Tulsa,U.S. Senate,Erick Paul Wyatt,REP,720062,0,0,15,15,
Tulsa,U.S. Senate,Andy Craig,REP,720062,0,0,2,2,
Tulsa,U.S. Senate,T. Shannon,REP,720062,0,0,116,116,
Tulsa,U.S. Senate,Randy Brogdon,REP,720062,0,0,12,12,
Tulsa,U.S. Senate,Eric Mccray,REP,720062,0,0,1,1,
Tulsa,U.S. Senate,Kevin Crow,REP,720062,0,0,3,3,
Tulsa,U.S. Senate,James Lankford,REP,720062,0,0,227,227,
Tulsa,U.S. Senate,Jason Weger,REP,720062,0,0,2,2,
Tulsa,Superintendent of Public Instruction,John Cox,DEM,720063,0,0,20,20,
Tulsa,Superintendent of Public Instruction,Jack Jr.,DEM,720063,0,0,8,8,
Tulsa,Superintendent of Public Instruction,Ivan Holmes,DEM,720063,0,0,5,5,
Tulsa,Superintendent of Public Instruction,Freda Deskin,DEM,720063,0,0,33,33,
Tulsa,U.S. Senate,Patrick Michael Hayes,DEM,720063,0,0,9,9,
Tulsa,U.S. Senate,Jim Rogers,DEM,720063,0,0,14,14,
Tulsa,U.S. Senate,Connie Johnson,DEM,720063,0,0,40,40,
Tulsa,Governor,Dax Ewbank,REP,720063,0,0,14,14,
Tulsa,Governor,Chad Moody,REP,720063,0,0,23,23,
Tulsa,Governor,Mary Fallin,REP,720063,0,0,72,72,
Tulsa,Superintendent of Public Instruction,Brian Kelly,REP,720063,0,0,15,15,
Tulsa,Superintendent of Public Instruction,Janet Costello Barresi,REP,720063,0,0,23,23,
Tulsa,Superintendent of Public Instruction,Joy Hofmeister,REP,720063,0,0,71,71,
Tulsa,Insurance Commissioner,Bill Viner,REP,720063,0,0,25,25,
Tulsa,Insurance Commissioner,John Doak,REP,720063,0,0,70,70,
Tulsa,Corporation Commissioner,Todd Hiett,REP,720063,0,0,53,53,
Tulsa,Corporation Commissioner,Cliff Branan,REP,720063,0,0,38,38,
Tulsa,U.S. Senate,Evelyn Rogers,REP,720063,0,0,9,9,
Tulsa,U.S. Senate,Rob Moye,REP,720063,0,0,4,4,
Tulsa,U.S. Senate,D. Jean Mcbride-Samuels,REP,720063,0,0,4,4,
Tulsa,U.S. Senate,Jim Inhofe,REP,720063,0,0,81,81,
Tulsa,U.S. Senate,Erick Paul Wyatt,REP,720063,0,0,8,8,
Tulsa,U.S. Senate,Andy Craig,REP,720063,0,0,3,3,
Tulsa,U.S. Senate,T. Shannon,REP,720063,0,0,42,42,
Tulsa,U.S. Senate,Randy Brogdon,REP,720063,0,0,8,8,
Tulsa,U.S. Senate,Eric Mccray,REP,720063,0,0,1,1,
Tulsa,U.S. Senate,Kevin Crow,REP,720063,0,0,3,3,
Tulsa,U.S. Senate,James Lankford,REP,720063,0,0,48,48,
Tulsa,U.S. Senate,Jason Weger,REP,720063,0,0,2,2,
Tulsa,Superintendent of Public Instruction,John Cox,DEM,720064,0,0,16,16,
Tulsa,Superintendent of Public Instruction,Jack Jr.,DEM,720064,0,0,9,9,
Tulsa,Superintendent of Public Instruction,Ivan Holmes,DEM,720064,0,0,3,3,
Tulsa,Superintendent of Public Instruction,Freda Deskin,DEM,720064,0,0,40,40,
Tulsa,U.S. Senate,Patrick Michael Hayes,DEM,720064,0,0,6,6,
Tulsa,U.S. Senate,Jim Rogers,DEM,720064,0,0,14,14,
Tulsa,U.S. Senate,Connie Johnson,DEM,720064,0,0,51,51,
Tulsa,Governor,Dax Ewbank,REP,720064,0,0,19,19,
Tulsa,Governor,Chad Moody,REP,720064,0,0,32,32,
Tulsa,Governor,Mary Fallin,REP,720064,0,0,88,88,
Tulsa,Superintendent of Public Instruction,Brian Kelly,REP,720064,0,0,22,22,
Tulsa,Superintendent of Public Instruction,Janet Costello Barresi,REP,720064,0,0,24,24,
Tulsa,Superintendent of Public Instruction,Joy Hofmeister,REP,720064,0,0,96,96,
Tulsa,Insurance Commissioner,Bill Viner,REP,720064,0,0,31,31,
Tulsa,Insurance Commissioner,John Doak,REP,720064,0,0,92,92,
Tulsa,Corporation Commissioner,Todd Hiett,REP,720064,0,0,76,76,
Tulsa,Corporation Commissioner,Cliff Branan,REP,720064,0,0,51,51,
Tulsa,U.S. Senate,Evelyn Rogers,REP,720064,0,0,7,7,
Tulsa,U.S. Senate,Rob Moye,REP,720064,0,0,3,3,
Tulsa,U.S. Senate,D. Jean Mcbride-Samuels,REP,720064,0,0,1,1,
Tulsa,U.S. Senate,Jim Inhofe,REP,720064,0,0,126,126,
Tulsa,U.S. Senate,Erick Paul Wyatt,REP,720064,0,0,3,3,
Tulsa,U.S. Senate,Andy Craig,REP,720064,0,0,3,3,
Tulsa,U.S. Senate,T. Shannon,REP,720064,0,0,50,50,
Tulsa,U.S. Senate,Randy Brogdon,REP,720064,0,0,16,16,
Tulsa,U.S. Senate,Eric Mccray,REP,720064,0,0,0,0,
Tulsa,U.S. Senate,Kevin Crow,REP,720064,0,0,4,4,
Tulsa,U.S. Senate,James Lankford,REP,720064,0,0,64,64,
Tulsa,U.S. Senate,Jason Weger,REP,720064,0,0,0,0,
Tulsa,Superintendent of Public Instruction,John Cox,DEM,720065,0,0,32,32,
Tulsa,Superintendent of Public Instruction,Jack Jr.,DEM,720065,0,0,20,20,
Tulsa,Superintendent of Public Instruction,Ivan Holmes,DEM,720065,0,0,0,0,
Tulsa,Superintendent of Public Instruction,Freda Deskin,DEM,720065,0,0,58,58,
Tulsa,U.S. Senate,Patrick Michael Hayes,DEM,720065,0,0,22,22,
Tulsa,U.S. Senate,Jim Rogers,DEM,720065,0,0,17,17,
Tulsa,U.S. Senate,Connie Johnson,DEM,720065,0,0,60,60,
Tulsa,Governor,Dax Ewbank,REP,720065,0,0,15,15,
Tulsa,Governor,Chad Moody,REP,720065,0,0,49,49,
Tulsa,Governor,Mary Fallin,REP,720065,0,0,214,214,
Tulsa,Superintendent of Public Instruction,Brian Kelly,REP,720065,0,0,18,18,
Tulsa,Superintendent of Public Instruction,Janet Costello Barresi,REP,720065,0,0,78,78,
Tulsa,Superintendent of Public Instruction,Joy Hofmeister,REP,720065,0,0,192,192,
Tulsa,Insurance Commissioner,Bill Viner,REP,720065,0,0,55,55,
Tulsa,Insurance Commissioner,John Doak,REP,720065,0,0,190,190,
Tulsa,Corporation Commissioner,Todd Hiett,REP,720065,0,0,154,154,
Tulsa,Corporation Commissioner,Cliff Branan,REP,720065,0,0,98,98,
Tulsa,U.S. Senate,Evelyn Rogers,REP,720065,0,0,21,21,
Tulsa,U.S. Senate,Rob Moye,REP,720065,0,0,8,8,
Tulsa,U.S. Senate,D. Jean Mcbride-Samuels,REP,720065,0,0,7,7,
Tulsa,U.S. Senate,Jim Inhofe,REP,720065,0,0,242,242,
Tulsa,U.S. Senate,Erick Paul Wyatt,REP,720065,0,0,6,6,
Tulsa,U.S. Senate,Andy Craig,REP,720065,0,0,0,0,
Tulsa,U.S. Senate,T. Shannon,REP,720065,0,0,96,96,
Tulsa,U.S. Senate,Randy Brogdon,REP,720065,0,0,11,11,
Tulsa,U.S. Senate,Eric Mccray,REP,720065,0,0,1,1,
Tulsa,U.S. Senate,Kevin Crow,REP,720065,0,0,2,2,
Tulsa,U.S. Senate,James Lankford,REP,720065,0,0,177,177,
Tulsa,U.S. Senate,Jason Weger,REP,720065,0,0,2,2,
Tulsa,Superintendent of Public Instruction,John Cox,DEM,720066,0,0,24,24,
Tulsa,Superintendent of Public Instruction,Jack Jr.,DEM,720066,0,0,9,9,
Tulsa,Superintendent of Public Instruction,Ivan Holmes,DEM,720066,0,0,2,2,
Tulsa,Superintendent of Public Instruction,Freda Deskin,DEM,720066,0,0,45,45,
Tulsa,U.S. Senate,Patrick Michael Hayes,DEM,720066,0,0,8,8,
Tulsa,U.S. Senate,Jim Rogers,DEM,720066,0,0,12,12,
Tulsa,U.S. Senate,Connie Johnson,DEM,720066,0,0,56,56,
Tulsa,Governor,Dax Ewbank,REP,720066,0,0,15,15,
Tulsa,Governor,Chad Moody,REP,720066,0,0,45,45,
Tulsa,Governor,Mary Fallin,REP,720066,0,0,205,205,
Tulsa,Superintendent of Public Instruction,Brian Kelly,REP,720066,0,0,27,27,
Tulsa,Superintendent of Public Instruction,Janet Costello Barresi,REP,720066,0,0,46,46,
Tulsa,Superintendent of Public Instruction,Joy Hofmeister,REP,720066,0,0,194,194,
Tulsa,Insurance Commissioner,Bill Viner,REP,720066,0,0,35,35,
Tulsa,Insurance Commissioner,John Doak,REP,720066,0,0,193,193,
Tulsa,Corporation Commissioner,Todd Hiett,REP,720066,0,0,139,139,
Tulsa,Corporation Commissioner,Cliff Branan,REP,720066,0,0,96,96,
Tulsa,U.S. Senate,Evelyn Rogers,REP,720066,0,0,25,25,
Tulsa,U.S. Senate,Rob Moye,REP,720066,0,0,3,3,
Tulsa,U.S. Senate,D. Jean Mcbride-Samuels,REP,720066,0,0,8,8,
Tulsa,U.S. Senate,Jim Inhofe,REP,720066,0,0,227,227,
Tulsa,U.S. Senate,Erick Paul Wyatt,REP,720066,0,0,7,7,
Tulsa,U.S. Senate,Andy Craig,REP,720066,0,0,2,2,
Tulsa,U.S. Senate,T. Shannon,REP,720066,0,0,88,88,
Tulsa,U.S. Senate,Randy Brogdon,REP,720066,0,0,12,12,
Tulsa,U.S. Senate,Eric Mccray,REP,720066,0,0,3,3,
Tulsa,U.S. Senate,Kevin Crow,REP,720066,0,0,0,0,
Tulsa,U.S. Senate,James Lankford,REP,720066,0,0,164,164,
Tulsa,U.S. Senate,Jason Weger,REP,720066,0,0,2,2,
Tulsa,Superintendent of Public Instruction,John Cox,DEM,720067,0,0,26,26,
Tulsa,Superintendent of Public Instruction,Jack Jr.,DEM,720067,0,0,4,4,
Tulsa,Superintendent of Public Instruction,Ivan Holmes,DEM,720067,0,0,0,0,
Tulsa,Superintendent of Public Instruction,Freda Deskin,DEM,720067,0,0,39,39,
Tulsa,U.S. Senate,Patrick Michael Hayes,DEM,720067,0,0,11,11,
Tulsa,U.S. Senate,Jim Rogers,DEM,720067,0,0,11,11,
Tulsa,U.S. Senate,Connie Johnson,DEM,720067,0,0,45,45,
Tulsa,Governor,Dax Ewbank,REP,720067,0,0,13,13,
Tulsa,Governor,Chad Moody,REP,720067,0,0,29,29,
Tulsa,Governor,Mary Fallin,REP,720067,0,0,157,157,
Tulsa,Superintendent of Public Instruction,Brian Kelly,REP,720067,0,0,20,20,
Tulsa,Superintendent of Public Instruction,Janet Costello Barresi,REP,720067,0,0,40,40,
Tulsa,Superintendent of Public Instruction,Joy Hofmeister,REP,720067,0,0,141,141,
Tulsa,Insurance Commissioner,Bill Viner,REP,720067,0,0,39,39,
Tulsa,Insurance Commissioner,John Doak,REP,720067,0,0,140,140,
Tulsa,Corporation Commissioner,Todd Hiett,REP,720067,0,0,107,107,
Tulsa,Corporation Commissioner,Cliff Branan,REP,720067,0,0,71,71,
Tulsa,U.S. Senate,Evelyn Rogers,REP,720067,0,0,12,12,
Tulsa,U.S. Senate,Rob Moye,REP,720067,0,0,1,1,
Tulsa,U.S. Senate,D. Jean Mcbride-Samuels,REP,720067,0,0,6,6,
Tulsa,U.S. Senate,Jim Inhofe,REP,720067,0,0,177,177,
Tulsa,U.S. Senate,Erick Paul Wyatt,REP,720067,0,0,4,4,
Tulsa,U.S. Senate,Andy Craig,REP,720067,0,0,0,0,
Tulsa,U.S. Senate,T. Shannon,REP,720067,0,0,58,58,
Tulsa,U.S. Senate,Randy Brogdon,REP,720067,0,0,14,14,
Tulsa,U.S. Senate,Eric Mccray,REP,720067,0,0,1,1,
Tulsa,U.S. Senate,Kevin Crow,REP,720067,0,0,0,0,
Tulsa,U.S. Senate,James Lankford,REP,720067,0,0,126,126,
Tulsa,U.S. Senate,Jason Weger,REP,720067,0,0,2,2,
Tulsa,Superintendent of Public Instruction,John Cox,DEM,720068,0,0,19,19,
Tulsa,Superintendent of Public Instruction,Jack Jr.,DEM,720068,0,0,7,7,
Tulsa,Superintendent of Public Instruction,Ivan Holmes,DEM,720068,0,0,3,3,
Tulsa,Superintendent of Public Instruction,Freda Deskin,DEM,720068,0,0,38,38,
Tulsa,U.S. Senate,Patrick Michael Hayes,DEM,720068,0,0,7,7,
Tulsa,U.S. Senate,Jim Rogers,DEM,720068,0,0,12,12,
Tulsa,U.S. Senate,Connie Johnson,DEM,720068,0,0,46,46,
Tulsa,Governor,Dax Ewbank,REP,720068,0,0,23,23,
Tulsa,Governor,Chad Moody,REP,720068,0,0,16,16,
Tulsa,Governor,Mary Fallin,REP,720068,0,0,66,66,
Tulsa,Superintendent of Public Instruction,Brian Kelly,REP,720068,0,0,22,22,
Tulsa,Superintendent of Public Instruction,Janet Costello Barresi,REP,720068,0,0,17,17,
Tulsa,Superintendent of Public Instruction,Joy Hofmeister,REP,720068,0,0,62,62,
Tulsa,Insurance Commissioner,Bill Viner,REP,720068,0,0,14,14,
Tulsa,Insurance Commissioner,John Doak,REP,720068,0,0,83,83,
Tulsa,Corporation Commissioner,Todd Hiett,REP,720068,0,0,60,60,
Tulsa,Corporation Commissioner,Cliff Branan,REP,720068,0,0,37,37,
Tulsa,U.S. Senate,Evelyn Rogers,REP,720068,0,0,9,9,
Tulsa,U.S. Senate,Rob Moye,REP,720068,0,0,0,0,
Tulsa,U.S. Senate,D. Jean Mcbride-Samuels,REP,720068,0,0,4,4,
Tulsa,U.S. Senate,Jim Inhofe,REP,720068,0,0,91,91,
Tulsa,U.S. Senate,Erick Paul Wyatt,REP,720068,0,0,3,3,
Tulsa,U.S. Senate,Andy Craig,REP,720068,0,0,1,1,
Tulsa,U.S. Senate,T. Shannon,REP,720068,0,0,51,51,
Tulsa,U.S. Senate,Randy Brogdon,REP,720068,0,0,19,19,
Tulsa,U.S. Senate,Eric Mccray,REP,720068,0,0,1,1,
Tulsa,U.S. Senate,Kevin Crow,REP,720068,0,0,1,1,
Tulsa,U.S. Senate,James Lankford,REP,720068,0,0,33,33,
Tulsa,U.S. Senate,Jason Weger,REP,720068,0,0,0,0,
Tulsa,Superintendent of Public Instruction,John Cox,DEM,720069,0,0,41,41,
Tulsa,Superintendent of Public Instruction,Jack Jr.,DEM,720069,0,0,20,20,
Tulsa,Superintendent of Public Instruction,Ivan Holmes,DEM,720069,0,0,11,11,
Tulsa,Superintendent of Public Instruction,Freda Deskin,DEM,720069,0,0,59,59,
Tulsa,U.S. Senate,Patrick Michael Hayes,DEM,720069,0,0,25,25,
Tulsa,U.S. Senate,Jim Rogers,DEM,720069,0,0,27,27,
Tulsa,U.S. Senate,Connie Johnson,DEM,720069,0,0,74,74,
Tulsa,Governor,Dax Ewbank,REP,720069,0,0,27,27,
Tulsa,Governor,Chad Moody,REP,720069,0,0,33,33,
Tulsa,Governor,Mary Fallin,REP,720069,0,0,228,228,
Tulsa,Superintendent of Public Instruction,Brian Kelly,REP,720069,0,0,31,31,
Tulsa,Superintendent of Public Instruction,Janet Costello Barresi,REP,720069,0,0,63,63,
Tulsa,Superintendent of Public Instruction,Joy Hofmeister,REP,720069,0,0,192,192,
Tulsa,Insurance Commissioner,Bill Viner,REP,720069,0,0,53,53,
Tulsa,Insurance Commissioner,John Doak,REP,720069,0,0,208,208,
Tulsa,Corporation Commissioner,Todd Hiett,REP,720069,0,0,158,158,
Tulsa,Corporation Commissioner,Cliff Branan,REP,720069,0,0,103,103,
Tulsa,U.S. Senate,Evelyn Rogers,REP,720069,0,0,17,17,
Tulsa,U.S. Senate,Rob Moye,REP,720069,0,0,10,10,
Tulsa,U.S. Senate,D. Jean Mcbride-Samuels,REP,720069,0,0,6,6,
Tulsa,U.S. Senate,Jim Inhofe,REP,720069,0,0,253,253,
Tulsa,U.S. Senate,Erick Paul Wyatt,REP,720069,0,0,4,4,
Tulsa,U.S. Senate,Andy Craig,REP,720069,0,0,3,3,
Tulsa,U.S. Senate,T. Shannon,REP,720069,0,0,108,108,
Tulsa,U.S. Senate,Randy Brogdon,REP,720069,0,0,15,15,
Tulsa,U.S. Senate,Eric Mccray,REP,720069,0,0,1,1,
Tulsa,U.S. Senate,Kevin Crow,REP,720069,0,0,1,1,
Tulsa,U.S. Senate,James Lankford,REP,720069,0,0,158,158,
Tulsa,U.S. Senate,Jason Weger,REP,720069,0,0,2,2,
Tulsa,Superintendent of Public Instruction,John Cox,DEM,720070,0,0,8,8,
Tulsa,Superintendent of Public Instruction,Jack Jr.,DEM,720070,0,0,3,3,
Tulsa,Superintendent of Public Instruction,Ivan Holmes,DEM,720070,0,0,2,2,
Tulsa,Superintendent of Public Instruction,Freda Deskin,DEM,720070,0,0,13,13,
Tulsa,U.S. Senate,Patrick Michael Hayes,DEM,720070,0,0,7,7,
Tulsa,U.S. Senate,Jim Rogers,DEM,720070,0,0,5,5,
Tulsa,U.S. Senate,Connie Johnson,DEM,720070,0,0,13,13,
Tulsa,Governor,Dax Ewbank,REP,720070,0,0,7,7,
Tulsa,Governor,Chad Moody,REP,720070,0,0,9,9,
Tulsa,Governor,Mary Fallin,REP,720070,0,0,40,40,
Tulsa,Superintendent of Public Instruction,Brian Kelly,REP,720070,0,0,12,12,
Tulsa,Superintendent of Public Instruction,Janet Costello Barresi,REP,720070,0,0,10,10,
Tulsa,Superintendent of Public Instruction,Joy Hofmeister,REP,720070,0,0,34,34,
Tulsa,Insurance Commissioner,Bill Viner,REP,720070,0,0,14,14,
Tulsa,Insurance Commissioner,John Doak,REP,720070,0,0,39,39,
Tulsa,Corporation Commissioner,Todd Hiett,REP,720070,0,0,36,36,
Tulsa,Corporation Commissioner,Cliff Branan,REP,720070,0,0,16,16,
Tulsa,U.S. Senate,Evelyn Rogers,REP,720070,0,0,1,1,
Tulsa,U.S. Senate,Rob Moye,REP,720070,0,0,1,1,
Tulsa,U.S. Senate,D. Jean Mcbride-Samuels,REP,720070,0,0,1,1,
Tulsa,U.S. Senate,Jim Inhofe,REP,720070,0,0,52,52,
Tulsa,U.S. Senate,Erick Paul Wyatt,REP,720070,0,0,1,1,
Tulsa,U.S. Senate,Andy Craig,REP,720070,0,0,0,0,
Tulsa,U.S. Senate,T. Shannon,REP,720070,0,0,32,32,
Tulsa,U.S. Senate,Randy Brogdon,REP,720070,0,0,6,6,
Tulsa,U.S. Senate,Eric Mccray,REP,720070,0,0,0,0,
Tulsa,U.S. Senate,Kevin Crow,REP,720070,0,0,1,1,
Tulsa,U.S. Senate,James Lankford,REP,720070,0,0,16,16,
Tulsa,U.S. Senate,Jason Weger,REP,720070,0,0,1,1,
Tulsa,Superintendent of Public Instruction,John Cox,DEM,720071,0,0,55,55,
Tulsa,Superintendent of Public Instruction,Jack Jr.,DEM,720071,0,0,28,28,
Tulsa,Superintendent of Public Instruction,Ivan Holmes,DEM,720071,0,0,11,11,
Tulsa,Superintendent of Public Instruction,Freda Deskin,DEM,720071,0,0,110,110,
Tulsa,U.S. Senate,Patrick Michael Hayes,DEM,720071,0,0,32,32,
Tulsa,U.S. Senate,Jim Rogers,DEM,720071,0,0,37,37,
Tulsa,U.S. Senate,Connie Johnson,DEM,720071,0,0,123,123,
Tulsa,Governor,Dax Ewbank,REP,720071,0,0,22,22,
Tulsa,Governor,Chad Moody,REP,720071,0,0,99,99,
Tulsa,Governor,Mary Fallin,REP,720071,0,0,369,369,
Tulsa,Superintendent of Public Instruction,Brian Kelly,REP,720071,0,0,49,49,
Tulsa,Superintendent of Public Instruction,Janet Costello Barresi,REP,720071,0,0,92,92,
Tulsa,Superintendent of Public Instruction,Joy Hofmeister,REP,720071,0,0,352,352,
Tulsa,Insurance Commissioner,Bill Viner,REP,720071,0,0,99,99,
Tulsa,Insurance Commissioner,John Doak,REP,720071,0,0,327,327,
Tulsa,Corporation Commissioner,Todd Hiett,REP,720071,0,0,235,235,
Tulsa,Corporation Commissioner,Cliff Branan,REP,720071,0,0,189,189,
Tulsa,U.S. Senate,Evelyn Rogers,REP,720071,0,0,40,40,
Tulsa,U.S. Senate,Rob Moye,REP,720071,0,0,11,11,
Tulsa,U.S. Senate,D. Jean Mcbride-Samuels,REP,720071,0,0,14,14,
Tulsa,U.S. Senate,Jim Inhofe,REP,720071,0,0,418,418,
Tulsa,U.S. Senate,Erick Paul Wyatt,REP,720071,0,0,12,12,
Tulsa,U.S. Senate,Andy Craig,REP,720071,0,0,6,6,
Tulsa,U.S. Senate,T. Shannon,REP,720071,0,0,156,156,
Tulsa,U.S. Senate,Randy Brogdon,REP,720071,0,0,31,31,
Tulsa,U.S. Senate,Eric Mccray,REP,720071,0,0,4,4,
Tulsa,U.S. Senate,Kevin Crow,REP,720071,0,0,5,5,
Tulsa,U.S. Senate,James Lankford,REP,720071,0,0,292,292,
Tulsa,U.S. Senate,Jason Weger,REP,720071,0,0,4,4,
Tulsa,Superintendent of Public Instruction,John Cox,DEM,720072,0,0,27,27,
Tulsa,Superintendent of Public Instruction,Jack Jr.,DEM,720072,0,0,7,7,
Tulsa,Superintendent of Public Instruction,Ivan Holmes,DEM,720072,0,0,3,3,
Tulsa,Superintendent of Public Instruction,Freda Deskin,DEM,720072,0,0,35,35,
Tulsa,U.S. Senate,Patrick Michael Hayes,DEM,720072,0,0,7,7,
Tulsa,U.S. Senate,Jim Rogers,DEM,720072,0,0,9,9,
Tulsa,U.S. Senate,Connie Johnson,DEM,720072,0,0,53,53,
Tulsa,Governor,Dax Ewbank,REP,720072,0,0,18,18,
Tulsa,Governor,Chad Moody,REP,720072,0,0,33,33,
Tulsa,Governor,Mary Fallin,REP,720072,0,0,158,158,
Tulsa,Superintendent of Public Instruction,Brian Kelly,REP,720072,0,0,17,17,
Tulsa,Superintendent of Public Instruction,Janet Costello Barresi,REP,720072,0,0,44,44,
Tulsa,Superintendent of Public Instruction,Joy Hofmeister,REP,720072,0,0,152,152,
Tulsa,Insurance Commissioner,Bill Viner,REP,720072,0,0,48,48,
Tulsa,Insurance Commissioner,John Doak,REP,720072,0,0,146,146,
Tulsa,Corporation Commissioner,Todd Hiett,REP,720072,0,0,91,91,
Tulsa,Corporation Commissioner,Cliff Branan,REP,720072,0,0,104,104,
Tulsa,U.S. Senate,Evelyn Rogers,REP,720072,0,0,12,12,
Tulsa,U.S. Senate,Rob Moye,REP,720072,0,0,3,3,
Tulsa,U.S. Senate,D. Jean Mcbride-Samuels,REP,720072,0,0,8,8,
Tulsa,U.S. Senate,Jim Inhofe,REP,720072,0,0,182,182,
Tulsa,U.S. Senate,Erick Paul Wyatt,REP,720072,0,0,5,5,
Tulsa,U.S. Senate,Andy Craig,REP,720072,0,0,1,1,
Tulsa,U.S. Senate,T. Shannon,REP,720072,0,0,81,81,
Tulsa,U.S. Senate,Randy Brogdon,REP,720072,0,0,6,6,
Tulsa,U.S. Senate,Eric Mccray,REP,720072,0,0,1,1,
Tulsa,U.S. Senate,Kevin Crow,REP,720072,0,0,2,2,
Tulsa,U.S. Senate,James Lankford,REP,720072,0,0,124,124,
Tulsa,U.S. Senate,Jason Weger,REP,720072,0,0,0,0,
Tulsa,Superintendent of Public Instruction,John Cox,DEM,720073,0,0,17,17,
Tulsa,Superintendent of Public Instruction,Jack Jr.,DEM,720073,0,0,1,1,
Tulsa,Superintendent of Public Instruction,Ivan Holmes,DEM,720073,0,0,2,2,
Tulsa,Superintendent of Public Instruction,Freda Deskin,DEM,720073,0,0,51,51,
Tulsa,U.S. Senate,Patrick Michael Hayes,DEM,720073,0,0,8,8,
Tulsa,U.S. Senate,Jim Rogers,DEM,720073,0,0,11,11,
Tulsa,U.S. Senate,Connie Johnson,DEM,720073,0,0,50,50,
Tulsa,Governor,Dax Ewbank,REP,720073,0,0,14,14,
Tulsa,Governor,Chad Moody,REP,720073,0,0,45,45,
Tulsa,Governor,Mary Fallin,REP,720073,0,0,198,198,
Tulsa,Superintendent of Public Instruction,Brian Kelly,REP,720073,0,0,27,27,
Tulsa,Superintendent of Public Instruction,Janet Costello Barresi,REP,720073,0,0,45,45,
Tulsa,Superintendent of Public Instruction,Joy Hofmeister,REP,720073,0,0,186,186,
Tulsa,Insurance Commissioner,Bill Viner,REP,720073,0,0,36,36,
Tulsa,Insurance Commissioner,John Doak,REP,720073,0,0,195,195,
Tulsa,Corporation Commissioner,Todd Hiett,REP,720073,0,0,120,120,
Tulsa,Corporation Commissioner,Cliff Branan,REP,720073,0,0,115,115,
Tulsa,U.S. Senate,Evelyn Rogers,REP,720073,0,0,16,16,
Tulsa,U.S. Senate,Rob Moye,REP,720073,0,0,6,6,
Tulsa,U.S. Senate,D. Jean Mcbride-Samuels,REP,720073,0,0,11,11,
Tulsa,U.S. Senate,Jim Inhofe,REP,720073,0,0,211,211,
Tulsa,U.S. Senate,Erick Paul Wyatt,REP,720073,0,0,12,12,
Tulsa,U.S. Senate,Andy Craig,REP,720073,0,0,1,1,
Tulsa,U.S. Senate,T. Shannon,REP,720073,0,0,75,75,
Tulsa,U.S. Senate,Randy Brogdon,REP,720073,0,0,10,10,
Tulsa,U.S. Senate,Eric Mccray,REP,720073,0,0,2,2,
Tulsa,U.S. Senate,Kevin Crow,REP,720073,0,0,1,1,
Tulsa,U.S. Senate,James Lankford,REP,720073,0,0,172,172,
Tulsa,U.S. Senate,Jason Weger,REP,720073,0,0,0,0,
Tulsa,Superintendent of Public Instruction,John Cox,DEM,720074,0,0,39,39,
Tulsa,Superintendent of Public Instruction,Jack Jr.,DEM,720074,0,0,9,9,
Tulsa,Superintendent of Public Instruction,Ivan Holmes,DEM,720074,0,0,3,3,
Tulsa,Superintendent of Public Instruction,Freda Deskin,DEM,720074,0,0,43,43,
Tulsa,U.S. Senate,Patrick Michael Hayes,DEM,720074,0,0,15,15,
Tulsa,U.S. Senate,Jim Rogers,DEM,720074,0,0,16,16,
Tulsa,U.S. Senate,Connie Johnson,DEM,720074,0,0,60,60,
Tulsa,Governor,Dax Ewbank,REP,720074,0,0,16,16,
Tulsa,Governor,Chad Moody,REP,720074,0,0,41,41,
Tulsa,Governor,Mary Fallin,REP,720074,0,0,241,241,
Tulsa,Superintendent of Public Instruction,Brian Kelly,REP,720074,0,0,29,29,
Tulsa,Superintendent of Public Instruction,Janet Costello Barresi,REP,720074,0,0,66,66,
Tulsa,Superintendent of Public Instruction,Joy Hofmeister,REP,720074,0,0,198,198,
Tulsa,Insurance Commissioner,Bill Viner,REP,720074,0,0,42,42,
Tulsa,Insurance Commissioner,John Doak,REP,720074,0,0,216,216,
Tulsa,Corporation Commissioner,Todd Hiett,REP,720074,0,0,153,153,
Tulsa,Corporation Commissioner,Cliff Branan,REP,720074,0,0,111,111,
Tulsa,U.S. Senate,Evelyn Rogers,REP,720074,0,0,13,13,
Tulsa,U.S. Senate,Rob Moye,REP,720074,0,0,3,3,
Tulsa,U.S. Senate,D. Jean Mcbride-Samuels,REP,720074,0,0,10,10,
Tulsa,U.S. Senate,Jim Inhofe,REP,720074,0,0,266,266,
Tulsa,U.S. Senate,Erick Paul Wyatt,REP,720074,0,0,5,5,
Tulsa,U.S. Senate,Andy Craig,REP,720074,0,0,1,1,
Tulsa,U.S. Senate,T. Shannon,REP,720074,0,0,94,94,
Tulsa,U.S. Senate,Randy Brogdon,REP,720074,0,0,11,11,
Tulsa,U.S. Senate,Eric Mccray,REP,720074,0,0,3,3,
Tulsa,U.S. Senate,Kevin Crow,REP,720074,0,0,0,0,
Tulsa,U.S. Senate,James Lankford,REP,720074,0,0,190,190,
Tulsa,U.S. Senate,Jason Weger,REP,720074,0,0,1,1,
Tulsa,Superintendent of Public Instruction,John Cox,DEM,720075,0,0,20,20,
Tulsa,Superintendent of Public Instruction,Jack Jr.,DEM,720075,0,0,8,8,
Tulsa,Superintendent of Public Instruction,Ivan Holmes,DEM,720075,0,0,5,5,
Tulsa,Superintendent of Public Instruction,Freda Deskin,DEM,720075,0,0,47,47,
Tulsa,U.S. Senate,Patrick Michael Hayes,DEM,720075,0,0,11,11,
Tulsa,U.S. Senate,Jim Rogers,DEM,720075,0,0,10,10,
Tulsa,U.S. Senate,Connie Johnson,DEM,720075,0,0,59,59,
Tulsa,Governor,Dax Ewbank,REP,720075,0,0,10,10,
Tulsa,Governor,Chad Moody,REP,720075,0,0,13,13,
Tulsa,Governor,Mary Fallin,REP,720075,0,0,64,64,
Tulsa,Superintendent of Public Instruction,Brian Kelly,REP,720075,0,0,17,17,
Tulsa,Superintendent of Public Instruction,Janet Costello Barresi,REP,720075,0,0,15,15,
Tulsa,Superintendent of Public Instruction,Joy Hofmeister,REP,720075,0,0,54,54,
Tulsa,Insurance Commissioner,Bill Viner,REP,720075,0,0,14,14,
Tulsa,Insurance Commissioner,John Doak,REP,720075,0,0,65,65,
Tulsa,Corporation Commissioner,Todd Hiett,REP,720075,0,0,43,43,
Tulsa,Corporation Commissioner,Cliff Branan,REP,720075,0,0,34,34,
Tulsa,U.S. Senate,Evelyn Rogers,REP,720075,0,0,12,12,
Tulsa,U.S. Senate,Rob Moye,REP,720075,0,0,2,2,
Tulsa,U.S. Senate,D. Jean Mcbride-Samuels,REP,720075,0,0,1,1,
Tulsa,U.S. Senate,Jim Inhofe,REP,720075,0,0,64,64,
Tulsa,U.S. Senate,Erick Paul Wyatt,REP,720075,0,0,6,6,
Tulsa,U.S. Senate,Andy Craig,REP,720075,0,0,0,0,
Tulsa,U.S. Senate,T. Shannon,REP,720075,0,0,36,36,
Tulsa,U.S. Senate,Randy Brogdon,REP,720075,0,0,9,9,
Tulsa,U.S. Senate,Eric Mccray,REP,720075,0,0,0,0,
Tulsa,U.S. Senate,Kevin Crow,REP,720075,0,0,1,1,
Tulsa,U.S. Senate,James Lankford,REP,720075,0,0,39,39,
Tulsa,U.S. Senate,Jason Weger,REP,720075,0,0,2,2,
Tulsa,Superintendent of Public Instruction,John Cox,DEM,720076,0,0,40,40,
Tulsa,Superintendent of Public Instruction,Jack Jr.,DEM,720076,0,0,13,13,
Tulsa,Superintendent of Public Instruction,Ivan Holmes,DEM,720076,0,0,3,3,
Tulsa,Superintendent of Public Instruction,Freda Deskin,DEM,720076,0,0,55,55,
Tulsa,U.S. Senate,Patrick Michael Hayes,DEM,720076,0,0,24,24,
Tulsa,U.S. Senate,Jim Rogers,DEM,720076,0,0,17,17,
Tulsa,U.S. Senate,Connie Johnson,DEM,720076,0,0,63,63,
Tulsa,Governor,Dax Ewbank,REP,720076,0,0,10,10,
Tulsa,Governor,Chad Moody,REP,720076,0,0,18,18,
Tulsa,Governor,Mary Fallin,REP,720076,0,0,110,110,
Tulsa,Superintendent of Public Instruction,Brian Kelly,REP,720076,0,0,19,19,
Tulsa,Superintendent of Public Instruction,Janet Costello Barresi,REP,720076,0,0,17,17,
Tulsa,Superintendent of Public Instruction,Joy Hofmeister,REP,720076,0,0,104,104,
Tulsa,Insurance Commissioner,Bill Viner,REP,720076,0,0,27,27,
Tulsa,Insurance Commissioner,John Doak,REP,720076,0,0,102,102,
Tulsa,Corporation Commissioner,Todd Hiett,REP,720076,0,0,68,68,
Tulsa,Corporation Commissioner,Cliff Branan,REP,720076,0,0,54,54,
Tulsa,U.S. Senate,Evelyn Rogers,REP,720076,0,0,10,10,
Tulsa,U.S. Senate,Rob Moye,REP,720076,0,0,4,4,
Tulsa,U.S. Senate,D. Jean Mcbride-Samuels,REP,720076,0,0,2,2,
Tulsa,U.S. Senate,Jim Inhofe,REP,720076,0,0,118,118,
Tulsa,U.S. Senate,Erick Paul Wyatt,REP,720076,0,0,4,4,
Tulsa,U.S. Senate,Andy Craig,REP,720076,0,0,0,0,
Tulsa,U.S. Senate,T. Shannon,REP,720076,0,0,51,51,
Tulsa,U.S. Senate,Randy Brogdon,REP,720076,0,0,13,13,
Tulsa,U.S. Senate,Eric Mccray,REP,720076,0,0,0,0,
Tulsa,U.S. Senate,Kevin Crow,REP,720076,0,0,1,1,
Tulsa,U.S. Senate,James Lankford,REP,720076,0,0,72,72,
Tulsa,U.S. Senate,Jason Weger,REP,720076,0,0,2,2,
Tulsa,Superintendent of Public Instruction,John Cox,DEM,720077,0,0,30,30,
Tulsa,Superintendent of Public Instruction,Jack Jr.,DEM,720077,0,0,7,7,
Tulsa,Superintendent of Public Instruction,Ivan Holmes,DEM,720077,0,0,6,6,
Tulsa,Superintendent of Public Instruction,Freda Deskin,DEM,720077,0,0,77,77,
Tulsa,U.S. Senate,Patrick Michael Hayes,DEM,720077,0,0,22,22,
Tulsa,U.S. Senate,Jim Rogers,DEM,720077,0,0,24,24,
Tulsa,U.S. Senate,Connie Johnson,DEM,720077,0,0,70,70,
Tulsa,Governor,Dax Ewbank,REP,720077,0,0,20,20,
Tulsa,Governor,Chad Moody,REP,720077,0,0,33,33,
Tulsa,Governor,Mary Fallin,REP,720077,0,0,160,160,
Tulsa,Superintendent of Public Instruction,Brian Kelly,REP,720077,0,0,27,27,
Tulsa,Superintendent of Public Instruction,Janet Costello Barresi,REP,720077,0,0,40,40,
Tulsa,Superintendent of Public Instruction,Joy Hofmeister,REP,720077,0,0,151,151,
Tulsa,Insurance Commissioner,Bill Viner,REP,720077,0,0,31,31,
Tulsa,Insurance Commissioner,John Doak,REP,720077,0,0,163,163,
Tulsa,Corporation Commissioner,Todd Hiett,REP,720077,0,0,96,96,
Tulsa,Corporation Commissioner,Cliff Branan,REP,720077,0,0,99,99,
Tulsa,U.S. Senate,Evelyn Rogers,REP,720077,0,0,8,8,
Tulsa,U.S. Senate,Rob Moye,REP,720077,0,0,3,3,
Tulsa,U.S. Senate,D. Jean Mcbride-Samuels,REP,720077,0,0,8,8,
Tulsa,U.S. Senate,Jim Inhofe,REP,720077,0,0,189,189,
Tulsa,U.S. Senate,Erick Paul Wyatt,REP,720077,0,0,3,3,
Tulsa,U.S. Senate,Andy Craig,REP,720077,0,0,4,4,
Tulsa,U.S. Senate,T. Shannon,REP,720077,0,0,83,83,
Tulsa,U.S. Senate,Randy Brogdon,REP,720077,0,0,17,17,
Tulsa,U.S. Senate,Eric Mccray,REP,720077,0,0,2,2,
Tulsa,U.S. Senate,Kevin Crow,REP,720077,0,0,0,0,
Tulsa,U.S. Senate,James Lankford,REP,720077,0,0,110,110,
Tulsa,U.S. Senate,Jason Weger,REP,720077,0,0,1,1,
Tulsa,Superintendent of Public Instruction,John Cox,DEM,720078,0,0,35,35,
Tulsa,Superintendent of Public Instruction,Jack Jr.,DEM,720078,0,0,13,13,
Tulsa,Superintendent of Public Instruction,Ivan Holmes,DEM,720078,0,0,5,5,
Tulsa,Superintendent of Public Instruction,Freda Deskin,DEM,720078,0,0,51,51,
Tulsa,U.S. Senate,Patrick Michael Hayes,DEM,720078,0,0,17,17,
Tulsa,U.S. Senate,Jim Rogers,DEM,720078,0,0,27,27,
Tulsa,U.S. Senate,Connie Johnson,DEM,720078,0,0,60,60,
Tulsa,Governor,Dax Ewbank,REP,720078,0,0,16,16,
Tulsa,Governor,Chad Moody,REP,720078,0,0,34,34,
Tulsa,Governor,Mary Fallin,REP,720078,0,0,189,189,
Tulsa,Superintendent of Public Instruction,Brian Kelly,REP,720078,0,0,40,40,
Tulsa,Superintendent of Public Instruction,Janet Costello Barresi,REP,720078,0,0,62,62,
Tulsa,Superintendent of Public Instruction,Joy Hofmeister,REP,720078,0,0,143,143,
Tulsa,Insurance Commissioner,Bill Viner,REP,720078,0,0,48,48,
Tulsa,Insurance Commissioner,John Doak,REP,720078,0,0,172,172,
Tulsa,Corporation Commissioner,Todd Hiett,REP,720078,0,0,119,119,
Tulsa,Corporation Commissioner,Cliff Branan,REP,720078,0,0,95,95,
Tulsa,U.S. Senate,Evelyn Rogers,REP,720078,0,0,10,10,
Tulsa,U.S. Senate,Rob Moye,REP,720078,0,0,2,2,
Tulsa,U.S. Senate,D. Jean Mcbride-Samuels,REP,720078,0,0,5,5,
Tulsa,U.S. Senate,Jim Inhofe,REP,720078,0,0,215,215,
Tulsa,U.S. Senate,Erick Paul Wyatt,REP,720078,0,0,11,11,
Tulsa,U.S. Senate,Andy Craig,REP,720078,0,0,1,1,
Tulsa,U.S. Senate,T. Shannon,REP,720078,0,0,92,92,
Tulsa,U.S. Senate,Randy Brogdon,REP,720078,0,0,22,22,
Tulsa,U.S. Senate,Eric Mccray,REP,720078,0,0,2,2,
Tulsa,U.S. Senate,Kevin Crow,REP,720078,0,0,1,1,
Tulsa,U.S. Senate,James Lankford,REP,720078,0,0,124,124,
Tulsa,U.S. Senate,Jason Weger,REP,720078,0,0,1,1,
Tulsa,Superintendent of Public Instruction,John Cox,DEM,720079,0,0,37,37,
Tulsa,Superintendent of Public Instruction,Jack Jr.,DEM,720079,0,0,6,6,
Tulsa,Superintendent of Public Instruction,Ivan Holmes,DEM,720079,0,0,6,6,
Tulsa,Superintendent of Public Instruction,Freda Deskin,DEM,720079,0,0,59,59,
Tulsa,U.S. Senate,Patrick Michael Hayes,DEM,720079,0,0,14,14,
Tulsa,U.S. Senate,Jim Rogers,DEM,720079,0,0,27,27,
Tulsa,U.S. Senate,Connie Johnson,DEM,720079,0,0,66,66,
Tulsa,Governor,Dax Ewbank,REP,720079,0,0,23,23,
Tulsa,Governor,Chad Moody,REP,720079,0,0,34,34,
Tulsa,Governor,Mary Fallin,REP,720079,0,0,156,156,
Tulsa,Superintendent of Public Instruction,Brian Kelly,REP,720079,0,0,41,41,
Tulsa,Superintendent of Public Instruction,Janet Costello Barresi,REP,720079,0,0,38,38,
Tulsa,Superintendent of Public Instruction,Joy Hofmeister,REP,720079,0,0,137,137,
Tulsa,Insurance Commissioner,Bill Viner,REP,720079,0,0,39,39,
Tulsa,Insurance Commissioner,John Doak,REP,720079,0,0,158,158,
Tulsa,Corporation Commissioner,Todd Hiett,REP,720079,0,0,106,106,
Tulsa,Corporation Commissioner,Cliff Branan,REP,720079,0,0,93,93,
Tulsa,U.S. Senate,Evelyn Rogers,REP,720079,0,0,12,12,
Tulsa,U.S. Senate,Rob Moye,REP,720079,0,0,6,6,
Tulsa,U.S. Senate,D. Jean Mcbride-Samuels,REP,720079,0,0,6,6,
Tulsa,U.S. Senate,Jim Inhofe,REP,720079,0,0,182,182,
Tulsa,U.S. Senate,Erick Paul Wyatt,REP,720079,0,0,5,5,
Tulsa,U.S. Senate,Andy Craig,REP,720079,0,0,3,3,
Tulsa,U.S. Senate,T. Shannon,REP,720079,0,0,91,91,
Tulsa,U.S. Senate,Randy Brogdon,REP,720079,0,0,17,17,
Tulsa,U.S. Senate,Eric Mccray,REP,720079,0,0,4,4,
Tulsa,U.S. Senate,Kevin Crow,REP,720079,0,0,0,0,
Tulsa,U.S. Senate,James Lankford,REP,720079,0,0,97,97,
Tulsa,U.S. Senate,Jason Weger,REP,720079,0,0,4,4,
Tulsa,Superintendent of Public Instruction,John Cox,DEM,720080,0,0,4,4,
Tulsa,Superintendent of Public Instruction,Jack Jr.,DEM,720080,0,0,2,2,
Tulsa,Superintendent of Public Instruction,Ivan Holmes,DEM,720080,0,0,1,1,
Tulsa,Superintendent of Public Instruction,Freda Deskin,DEM,720080,0,0,11,11,
Tulsa,U.S. Senate,Patrick Michael Hayes,DEM,720080,0,0,4,4,
Tulsa,U.S. Senate,Jim Rogers,DEM,720080,0,0,4,4,
Tulsa,U.S. Senate,Connie Johnson,DEM,720080,0,0,9,9,
Tulsa,Governor,Dax Ewbank,REP,720080,0,0,6,6,
Tulsa,Governor,Chad Moody,REP,720080,0,0,8,8,
Tulsa,Governor,Mary Fallin,REP,720080,0,0,31,31,
Tulsa,Superintendent of Public Instruction,Brian Kelly,REP,720080,0,0,11,11,
Tulsa,Superintendent of Public Instruction,Janet Costello Barresi,REP,720080,0,0,5,5,
Tulsa,Superintendent of Public Instruction,Joy Hofmeister,REP,720080,0,0,31,31,
Tulsa,Insurance Commissioner,Bill Viner,REP,720080,0,0,9,9,
Tulsa,Insurance Commissioner,John Doak,REP,720080,0,0,34,34,
Tulsa,Corporation Commissioner,Todd Hiett,REP,720080,0,0,30,30,
Tulsa,Corporation Commissioner,Cliff Branan,REP,720080,0,0,14,14,
Tulsa,U.S. Senate,Evelyn Rogers,REP,720080,0,0,7,7,
Tulsa,U.S. Senate,Rob Moye,REP,720080,0,0,0,0,
Tulsa,U.S. Senate,D. Jean Mcbride-Samuels,REP,720080,0,0,3,3,
Tulsa,U.S. Senate,Jim Inhofe,REP,720080,0,0,30,30,
Tulsa,U.S. Senate,Erick Paul Wyatt,REP,720080,0,0,6,6,
Tulsa,U.S. Senate,Andy Craig,REP,720080,0,0,0,0,
Tulsa,U.S. Senate,T. Shannon,REP,720080,0,0,15,15,
Tulsa,U.S. Senate,Randy Brogdon,REP,720080,0,0,1,1,
Tulsa,U.S. Senate,Eric Mccray,REP,720080,0,0,2,2,
Tulsa,U.S. Senate,Kevin Crow,REP,720080,0,0,1,1,
Tulsa,U.S. Senate,James Lankford,REP,720080,0,0,27,27,
Tulsa,U.S. Senate,Jason Weger,REP,720080,0,0,1,1,
Tulsa,Superintendent of Public Instruction,John Cox,DEM,720081,0,0,41,41,
Tulsa,Superintendent of Public Instruction,Jack Jr.,DEM,720081,0,0,14,14,
Tulsa,Superintendent of Public Instruction,Ivan Holmes,DEM,720081,0,0,7,7,
Tulsa,Superintendent of Public Instruction,Freda Deskin,DEM,720081,0,0,61,61,
Tulsa,U.S. Senate,Patrick Michael Hayes,DEM,720081,0,0,14,14,
Tulsa,U.S. Senate,Jim Rogers,DEM,720081,0,0,30,30,
Tulsa,U.S. Senate,Connie Johnson,DEM,720081,0,0,77,77,
Tulsa,Governor,Dax Ewbank,REP,720081,0,0,12,12,
Tulsa,Governor,Chad Moody,REP,720081,0,0,46,46,
Tulsa,Governor,Mary Fallin,REP,720081,0,0,226,226,
Tulsa,Superintendent of Public Instruction,Brian Kelly,REP,720081,0,0,52,52,
Tulsa,Superintendent of Public Instruction,Janet Costello Barresi,REP,720081,0,0,44,44,
Tulsa,Superintendent of Public Instruction,Joy Hofmeister,REP,720081,0,0,184,184,
Tulsa,Insurance Commissioner,Bill Viner,REP,720081,0,0,67,67,
Tulsa,Insurance Commissioner,John Doak,REP,720081,0,0,187,187,
Tulsa,Corporation Commissioner,Todd Hiett,REP,720081,0,0,142,142,
Tulsa,Corporation Commissioner,Cliff Branan,REP,720081,0,0,120,120,
Tulsa,U.S. Senate,Evelyn Rogers,REP,720081,0,0,16,16,
Tulsa,U.S. Senate,Rob Moye,REP,720081,0,0,7,7,
Tulsa,U.S. Senate,D. Jean Mcbride-Samuels,REP,720081,0,0,10,10,
Tulsa,U.S. Senate,Jim Inhofe,REP,720081,0,0,241,241,
Tulsa,U.S. Senate,Erick Paul Wyatt,REP,720081,0,0,11,11,
Tulsa,U.S. Senate,Andy Craig,REP,720081,0,0,3,3,
Tulsa,U.S. Senate,T. Shannon,REP,720081,0,0,80,80,
Tulsa,U.S. Senate,Randy Brogdon,REP,720081,0,0,23,23,
Tulsa,U.S. Senate,Eric Mccray,REP,720081,0,0,4,4,
Tulsa,U.S. Senate,Kevin Crow,REP,720081,0,0,1,1,
Tulsa,U.S. Senate,James Lankford,REP,720081,0,0,177,177,
Tulsa,U.S. Senate,Jason Weger,REP,720081,0,0,0,0,
Tulsa,Superintendent of Public Instruction,John Cox,DEM,720082,0,0,20,20,
Tulsa,Superintendent of Public Instruction,Jack Jr.,DEM,720082,0,0,7,7,
Tulsa,Superintendent of Public Instruction,Ivan Holmes,DEM,720082,0,0,4,4,
Tulsa,Superintendent of Public Instruction,Freda Deskin,DEM,720082,0,0,44,44,
Tulsa,U.S. Senate,Patrick Michael Hayes,DEM,720082,0,0,9,9,
Tulsa,U.S. Senate,Jim Rogers,DEM,720082,0,0,12,12,
Tulsa,U.S. Senate,Connie Johnson,DEM,720082,0,0,51,51,
Tulsa,Governor,Dax Ewbank,REP,720082,0,0,17,17,
Tulsa,Governor,Chad Moody,REP,720082,0,0,26,26,
Tulsa,Governor,Mary Fallin,REP,720082,0,0,152,152,
Tulsa,Superintendent of Public Instruction,Brian Kelly,REP,720082,0,0,28,28,
Tulsa,Superintendent of Public Instruction,Janet Costello Barresi,REP,720082,0,0,24,24,
Tulsa,Superintendent of Public Instruction,Joy Hofmeister,REP,720082,0,0,142,142,
Tulsa,Insurance Commissioner,Bill Viner,REP,720082,0,0,32,32,
Tulsa,Insurance Commissioner,John Doak,REP,720082,0,0,146,146,
Tulsa,Corporation Commissioner,Todd Hiett,REP,720082,0,0,90,90,
Tulsa,Corporation Commissioner,Cliff Branan,REP,720082,0,0,91,91,
Tulsa,U.S. Senate,Evelyn Rogers,REP,720082,0,0,10,10,
Tulsa,U.S. Senate,Rob Moye,REP,720082,0,0,1,1,
Tulsa,U.S. Senate,D. Jean Mcbride-Samuels,REP,720082,0,0,3,3,
Tulsa,U.S. Senate,Jim Inhofe,REP,720082,0,0,166,166,
Tulsa,U.S. Senate,Erick Paul Wyatt,REP,720082,0,0,13,13,
Tulsa,U.S. Senate,Andy Craig,REP,720082,0,0,1,1,
Tulsa,U.S. Senate,T. Shannon,REP,720082,0,0,78,78,
Tulsa,U.S. Senate,Randy Brogdon,REP,720082,0,0,10,10,
Tulsa,U.S. Senate,Eric Mccray,REP,720082,0,0,0,0,
Tulsa,U.S. Senate,Kevin Crow,REP,720082,0,0,1,1,
Tulsa,U.S. Senate,James Lankford,REP,720082,0,0,106,106,
Tulsa,U.S. Senate,Jason Weger,REP,720082,0,0,1,1,
Tulsa,Superintendent of Public Instruction,John Cox,DEM,720083,0,0,34,34,
Tulsa,Superintendent of Public Instruction,Jack Jr.,DEM,720083,0,0,11,11,
Tulsa,Superintendent of Public Instruction,Ivan Holmes,DEM,720083,0,0,4,4,
Tulsa,Superintendent of Public Instruction,Freda Deskin,DEM,720083,0,0,46,46,
Tulsa,U.S. Senate,Patrick Michael Hayes,DEM,720083,0,0,13,13,
Tulsa,U.S. Senate,Jim Rogers,DEM,720083,0,0,15,15,
Tulsa,U.S. Senate,Connie Johnson,DEM,720083,0,0,64,64,
Tulsa,Governor,Dax Ewbank,REP,720083,0,0,18,18,
Tulsa,Governor,Chad Moody,REP,720083,0,0,17,17,
Tulsa,Governor,Mary Fallin,REP,720083,0,0,87,87,
Tulsa,Superintendent of Public Instruction,Brian Kelly,REP,720083,0,0,17,17,
Tulsa,Superintendent of Public Instruction,Janet Costello Barresi,REP,720083,0,0,28,28,
Tulsa,Superintendent of Public Instruction,Joy Hofmeister,REP,720083,0,0,81,81,
Tulsa,Insurance Commissioner,Bill Viner,REP,720083,0,0,25,25,
Tulsa,Insurance Commissioner,John Doak,REP,720083,0,0,90,90,
Tulsa,Corporation Commissioner,Todd Hiett,REP,720083,0,0,67,67,
Tulsa,Corporation Commissioner,Cliff Branan,REP,720083,0,0,45,45,
Tulsa,U.S. Senate,Evelyn Rogers,REP,720083,0,0,8,8,
Tulsa,U.S. Senate,Rob Moye,REP,720083,0,0,0,0,
Tulsa,U.S. Senate,D. Jean Mcbride-Samuels,REP,720083,0,0,7,7,
Tulsa,U.S. Senate,Jim Inhofe,REP,720083,0,0,106,106,
Tulsa,U.S. Senate,Erick Paul Wyatt,REP,720083,0,0,1,1,
Tulsa,U.S. Senate,Andy Craig,REP,720083,0,0,1,1,
Tulsa,U.S. Senate,T. Shannon,REP,720083,0,0,47,47,
Tulsa,U.S. Senate,Randy Brogdon,REP,720083,0,0,16,16,
Tulsa,U.S. Senate,Eric Mccray,REP,720083,0,0,3,3,
Tulsa,U.S. Senate,Kevin Crow,REP,720083,0,0,1,1,
Tulsa,U.S. Senate,James Lankford,REP,720083,0,0,54,54,
Tulsa,U.S. Senate,Jason Weger,REP,720083,0,0,1,1,
Tulsa,Superintendent of Public Instruction,John Cox,DEM,720084,0,0,21,21,
Tulsa,Superintendent of Public Instruction,Jack Jr.,DEM,720084,0,0,3,3,
Tulsa,Superintendent of Public Instruction,Ivan Holmes,DEM,720084,0,0,1,1,
Tulsa,Superintendent of Public Instruction,Freda Deskin,DEM,720084,0,0,45,45,
Tulsa,U.S. Senate,Patrick Michael Hayes,DEM,720084,0,0,13,13,
Tulsa,U.S. Senate,Jim Rogers,DEM,720084,0,0,11,11,
Tulsa,U.S. Senate,Connie Johnson,DEM,720084,0,0,45,45,
Tulsa,Governor,Dax Ewbank,REP,720084,0,0,16,16,
Tulsa,Governor,Chad Moody,REP,720084,0,0,33,33,
Tulsa,Governor,Mary Fallin,REP,720084,0,0,151,151,
Tulsa,Superintendent of Public Instruction,Brian Kelly,REP,720084,0,0,22,22,
Tulsa,Superintendent of Public Instruction,Janet Costello Barresi,REP,720084,0,0,46,46,
Tulsa,Superintendent of Public Instruction,Joy Hofmeister,REP,720084,0,0,130,130,
Tulsa,Insurance Commissioner,Bill Viner,REP,720084,0,0,42,42,
Tulsa,Insurance Commissioner,John Doak,REP,720084,0,0,138,138,
Tulsa,Corporation Commissioner,Todd Hiett,REP,720084,0,0,105,105,
Tulsa,Corporation Commissioner,Cliff Branan,REP,720084,0,0,74,74,
Tulsa,U.S. Senate,Evelyn Rogers,REP,720084,0,0,12,12,
Tulsa,U.S. Senate,Rob Moye,REP,720084,0,0,2,2,
Tulsa,U.S. Senate,D. Jean Mcbride-Samuels,REP,720084,0,0,6,6,
Tulsa,U.S. Senate,Jim Inhofe,REP,720084,0,0,168,168,
Tulsa,U.S. Senate,Erick Paul Wyatt,REP,720084,0,0,12,12,
Tulsa,U.S. Senate,Andy Craig,REP,720084,0,0,0,0,
Tulsa,U.S. Senate,T. Shannon,REP,720084,0,0,64,64,
Tulsa,U.S. Senate,Randy Brogdon,REP,720084,0,0,18,18,
Tulsa,U.S. Senate,Eric Mccray,REP,720084,0,0,2,2,
Tulsa,U.S. Senate,Kevin Crow,REP,720084,0,0,2,2,
Tulsa,U.S. Senate,James Lankford,REP,720084,0,0,109,109,
Tulsa,U.S. Senate,Jason Weger,REP,720084,0,0,2,2,
Tulsa,Superintendent of Public Instruction,John Cox,DEM,720085,0,0,15,15,
Tulsa,Superintendent of Public Instruction,Jack Jr.,DEM,720085,0,0,6,6,
Tulsa,Superintendent of Public Instruction,Ivan Holmes,DEM,720085,0,0,1,1,
Tulsa,Superintendent of Public Instruction,Freda Deskin,DEM,720085,0,0,18,18,
Tulsa,U.S. Senate,Patrick Michael Hayes,DEM,720085,0,0,6,6,
Tulsa,U.S. Senate,Jim Rogers,DEM,720085,0,0,4,4,
Tulsa,U.S. Senate,Connie Johnson,DEM,720085,0,0,29,29,
Tulsa,Governor,Dax Ewbank,REP,720085,0,0,4,4,
Tulsa,Governor,Chad Moody,REP,720085,0,0,13,13,
Tulsa,Governor,Mary Fallin,REP,720085,0,0,35,35,
Tulsa,Superintendent of Public Instruction,Brian Kelly,REP,720085,0,0,13,13,
Tulsa,Superintendent of Public Instruction,Janet Costello Barresi,REP,720085,0,0,13,13,
Tulsa,Superintendent of Public Instruction,Joy Hofmeister,REP,720085,0,0,28,28,
Tulsa,Insurance Commissioner,Bill Viner,REP,720085,0,0,12,12,
Tulsa,Insurance Commissioner,John Doak,REP,720085,0,0,39,39,
Tulsa,Corporation Commissioner,Todd Hiett,REP,720085,0,0,23,23,
Tulsa,Corporation Commissioner,Cliff Branan,REP,720085,0,0,22,22,
Tulsa,U.S. Senate,Evelyn Rogers,REP,720085,0,0,3,3,
Tulsa,U.S. Senate,Rob Moye,REP,720085,0,0,0,0,
Tulsa,U.S. Senate,D. Jean Mcbride-Samuels,REP,720085,0,0,1,1,
Tulsa,U.S. Senate,Jim Inhofe,REP,720085,0,0,42,42,
Tulsa,U.S. Senate,Erick Paul Wyatt,REP,720085,0,0,6,6,
Tulsa,U.S. Senate,Andy Craig,REP,720085,0,0,0,0,
Tulsa,U.S. Senate,T. Shannon,REP,720085,0,0,18,18,
Tulsa,U.S. Senate,Randy Brogdon,REP,720085,0,0,5,5,
Tulsa,U.S. Senate,Eric Mccray,REP,720085,0,0,1,1,
Tulsa,U.S. Senate,Kevin Crow,REP,720085,0,0,1,1,
Tulsa,U.S. Senate,James Lankford,REP,720085,0,0,28,28,
Tulsa,U.S. Senate,Jason Weger,REP,720085,0,0,1,1,
Tulsa,Superintendent of Public Instruction,John Cox,DEM,720086,0,0,18,18,
Tulsa,Superintendent of Public Instruction,Jack Jr.,DEM,720086,0,0,4,4,
Tulsa,Superintendent of Public Instruction,Ivan Holmes,DEM,720086,0,0,3,3,
Tulsa,Superintendent of Public Instruction,Freda Deskin,DEM,720086,0,0,32,32,
Tulsa,U.S. Senate,Patrick Michael Hayes,DEM,720086,0,0,17,17,
Tulsa,U.S. Senate,Jim Rogers,DEM,720086,0,0,16,16,
Tulsa,U.S. Senate,Connie Johnson,DEM,720086,0,0,23,23,
Tulsa,Governor,Dax Ewbank,REP,720086,0,0,19,19,
Tulsa,Governor,Chad Moody,REP,720086,0,0,32,32,
Tulsa,Governor,Mary Fallin,REP,720086,0,0,133,133,
Tulsa,Superintendent of Public Instruction,Brian Kelly,REP,720086,0,0,38,38,
Tulsa,Superintendent of Public Instruction,Janet Costello Barresi,REP,720086,0,0,37,37,
Tulsa,Superintendent of Public Instruction,Joy Hofmeister,REP,720086,0,0,114,114,
Tulsa,Insurance Commissioner,Bill Viner,REP,720086,0,0,36,36,
Tulsa,Insurance Commissioner,John Doak,REP,720086,0,0,136,136,
Tulsa,Corporation Commissioner,Todd Hiett,REP,720086,0,0,109,109,
Tulsa,Corporation Commissioner,Cliff Branan,REP,720086,0,0,68,68,
Tulsa,U.S. Senate,Evelyn Rogers,REP,720086,0,0,6,6,
Tulsa,U.S. Senate,Rob Moye,REP,720086,0,0,7,7,
Tulsa,U.S. Senate,D. Jean Mcbride-Samuels,REP,720086,0,0,5,5,
Tulsa,U.S. Senate,Jim Inhofe,REP,720086,0,0,161,161,
Tulsa,U.S. Senate,Erick Paul Wyatt,REP,720086,0,0,8,8,
Tulsa,U.S. Senate,Andy Craig,REP,720086,0,0,2,2,
Tulsa,U.S. Senate,T. Shannon,REP,720086,0,0,73,73,
Tulsa,U.S. Senate,Randy Brogdon,REP,720086,0,0,21,21,
Tulsa,U.S. Senate,Eric Mccray,REP,720086,0,0,1,1,
Tulsa,U.S. Senate,Kevin Crow,REP,720086,0,0,1,1,
Tulsa,U.S. Senate,James Lankford,REP,720086,0,0,90,90,
Tulsa,U.S. Senate,Jason Weger,REP,720086,0,0,0,0,
Tulsa,Superintendent of Public Instruction,John Cox,DEM,720087,0,0,31,31,
Tulsa,Superintendent of Public Instruction,Jack Jr.,DEM,720087,0,0,7,7,
Tulsa,Superintendent of Public Instruction,Ivan Holmes,DEM,720087,0,0,4,4,
Tulsa,Superintendent of Public Instruction,Freda Deskin,DEM,720087,0,0,40,40,
Tulsa,U.S. Senate,Patrick Michael Hayes,DEM,720087,0,0,10,10,
Tulsa,U.S. Senate,Jim Rogers,DEM,720087,0,0,23,23,
Tulsa,U.S. Senate,Connie Johnson,DEM,720087,0,0,47,47,
Tulsa,Governor,Dax Ewbank,REP,720087,0,0,9,9,
Tulsa,Governor,Chad Moody,REP,720087,0,0,55,55,
Tulsa,Governor,Mary Fallin,REP,720087,0,0,195,195,
Tulsa,Superintendent of Public Instruction,Brian Kelly,REP,720087,0,0,33,33,
Tulsa,Superintendent of Public Instruction,Janet Costello Barresi,REP,720087,0,0,45,45,
Tulsa,Superintendent of Public Instruction,Joy Hofmeister,REP,720087,0,0,183,183,
Tulsa,Insurance Commissioner,Bill Viner,REP,720087,0,0,47,47,
Tulsa,Insurance Commissioner,John Doak,REP,720087,0,0,188,188,
Tulsa,Corporation Commissioner,Todd Hiett,REP,720087,0,0,115,115,
Tulsa,Corporation Commissioner,Cliff Branan,REP,720087,0,0,120,120,
Tulsa,U.S. Senate,Evelyn Rogers,REP,720087,0,0,17,17,
Tulsa,U.S. Senate,Rob Moye,REP,720087,0,0,3,3,
Tulsa,U.S. Senate,D. Jean Mcbride-Samuels,REP,720087,0,0,13,13,
Tulsa,U.S. Senate,Jim Inhofe,REP,720087,0,0,219,219,
Tulsa,U.S. Senate,Erick Paul Wyatt,REP,720087,0,0,9,9,
Tulsa,U.S. Senate,Andy Craig,REP,720087,0,0,2,2,
Tulsa,U.S. Senate,T. Shannon,REP,720087,0,0,95,95,
Tulsa,U.S. Senate,Randy Brogdon,REP,720087,0,0,14,14,
Tulsa,U.S. Senate,Eric Mccray,REP,720087,0,0,3,3,
Tulsa,U.S. Senate,Kevin Crow,REP,720087,0,0,0,0,
Tulsa,U.S. Senate,James Lankford,REP,720087,0,0,150,150,
Tulsa,U.S. Senate,Jason Weger,REP,720087,0,0,0,0,
Tulsa,State House,Weldon Watson,REP,720087,0,0,196,196,79
Tulsa,State House,Lois Jacobs,REP,720087,0,0,49,49,79
Tulsa,Superintendent of Public Instruction,John Cox,DEM,720088,0,0,6,6,
Tulsa,Superintendent of Public Instruction,Jack Jr.,DEM,720088,0,0,2,2,
Tulsa,Superintendent of Public Instruction,Ivan Holmes,DEM,720088,0,0,0,0,
Tulsa,Superintendent of Public Instruction,Freda Deskin,DEM,720088,0,0,6,6,
Tulsa,U.S. Senate,Patrick Michael Hayes,DEM,720088,0,0,3,3,
Tulsa,U.S. Senate,Jim Rogers,DEM,720088,0,0,1,1,
Tulsa,U.S. Senate,Connie Johnson,DEM,720088,0,0,10,10,
Tulsa,Governor,Dax Ewbank,REP,720088,0,0,5,5,
Tulsa,Governor,Chad Moody,REP,720088,0,0,11,11,
Tulsa,Governor,Mary Fallin,REP,720088,0,0,35,35,
Tulsa,Superintendent of Public Instruction,Brian Kelly,REP,720088,0,0,7,7,
Tulsa,Superintendent of Public Instruction,Janet Costello Barresi,REP,720088,0,0,7,7,
Tulsa,Superintendent of Public Instruction,Joy Hofmeister,REP,720088,0,0,38,38,
Tulsa,Insurance Commissioner,Bill Viner,REP,720088,0,0,10,10,
Tulsa,Insurance Commissioner,John Doak,REP,720088,0,0,40,40,
Tulsa,Corporation Commissioner,Todd Hiett,REP,720088,0,0,29,29,
Tulsa,Corporation Commissioner,Cliff Branan,REP,720088,0,0,20,20,
Tulsa,U.S. Senate,Evelyn Rogers,REP,720088,0,0,2,2,
Tulsa,U.S. Senate,Rob Moye,REP,720088,0,0,1,1,
Tulsa,U.S. Senate,D. Jean Mcbride-Samuels,REP,720088,0,0,0,0,
Tulsa,U.S. Senate,Jim Inhofe,REP,720088,0,0,45,45,
Tulsa,U.S. Senate,Erick Paul Wyatt,REP,720088,0,0,5,5,
Tulsa,U.S. Senate,Andy Craig,REP,720088,0,0,1,1,
Tulsa,U.S. Senate,T. Shannon,REP,720088,0,0,18,18,
Tulsa,U.S. Senate,Randy Brogdon,REP,720088,0,0,4,4,
Tulsa,U.S. Senate,Eric Mccray,REP,720088,0,0,0,0,
Tulsa,U.S. Senate,Kevin Crow,REP,720088,0,0,0,0,
Tulsa,U.S. Senate,James Lankford,REP,720088,0,0,30,30,
Tulsa,U.S. Senate,Jason Weger,REP,720088,0,0,0,0,
Tulsa,Superintendent of Public Instruction,John Cox,DEM,720089,0,0,11,11,
Tulsa,Superintendent of Public Instruction,Jack Jr.,DEM,720089,0,0,3,3,
Tulsa,Superintendent of Public Instruction,Ivan Holmes,DEM,720089,0,0,0,0,
Tulsa,Superintendent of Public Instruction,Freda Deskin,DEM,720089,0,0,32,32,
Tulsa,U.S. Senate,Patrick Michael Hayes,DEM,720089,0,0,9,9,
Tulsa,U.S. Senate,Jim Rogers,DEM,720089,0,0,7,7,
Tulsa,U.S. Senate,Connie Johnson,DEM,720089,0,0,28,28,
Tulsa,Governor,Dax Ewbank,REP,720089,0,0,8,8,
Tulsa,Governor,Chad Moody,REP,720089,0,0,17,17,
Tulsa,Governor,Mary Fallin,REP,720089,0,0,53,53,
Tulsa,Superintendent of Public Instruction,Brian Kelly,REP,720089,0,0,13,13,
Tulsa,Superintendent of Public Instruction,Janet Costello Barresi,REP,720089,0,0,10,10,
Tulsa,Superintendent of Public Instruction,Joy Hofmeister,REP,720089,0,0,55,55,
Tulsa,Insurance Commissioner,Bill Viner,REP,720089,0,0,13,13,
Tulsa,Insurance Commissioner,John Doak,REP,720089,0,0,59,59,
Tulsa,Corporation Commissioner,Todd Hiett,REP,720089,0,0,37,37,
Tulsa,Corporation Commissioner,Cliff Branan,REP,720089,0,0,40,40,
Tulsa,U.S. Senate,Evelyn Rogers,REP,720089,0,0,3,3,
Tulsa,U.S. Senate,Rob Moye,REP,720089,0,0,2,2,
Tulsa,U.S. Senate,D. Jean Mcbride-Samuels,REP,720089,0,0,2,2,
Tulsa,U.S. Senate,Jim Inhofe,REP,720089,0,0,64,64,
Tulsa,U.S. Senate,Erick Paul Wyatt,REP,720089,0,0,7,7,
Tulsa,U.S. Senate,Andy Craig,REP,720089,0,0,0,0,
Tulsa,U.S. Senate,T. Shannon,REP,720089,0,0,38,38,
Tulsa,U.S. Senate,Randy Brogdon,REP,720089,0,0,8,8,
Tulsa,U.S. Senate,Eric Mccray,REP,720089,0,0,1,1,
Tulsa,U.S. Senate,Kevin Crow,REP,720089,0,0,2,2,
Tulsa,U.S. Senate,James Lankford,REP,720089,0,0,28,28,
Tulsa,U.S. Senate,Jason Weger,REP,720089,0,0,1,1,
Tulsa,Superintendent of Public Instruction,John Cox,DEM,720090,0,0,8,8,
Tulsa,Superintendent of Public Instruction,Jack Jr.,DEM,720090,0,0,1,1,
Tulsa,Superintendent of Public Instruction,Ivan Holmes,DEM,720090,0,0,0,0,
Tulsa,Superintendent of Public Instruction,Freda Deskin,DEM,720090,0,0,9,9,
Tulsa,U.S. Senate,Patrick Michael Hayes,DEM,720090,0,0,4,4,
Tulsa,U.S. Senate,Jim Rogers,DEM,720090,0,0,3,3,
Tulsa,U.S. Senate,Connie Johnson,DEM,720090,0,0,9,9,
Tulsa,Governor,Dax Ewbank,REP,720090,0,0,2,2,
Tulsa,Governor,Chad Moody,REP,720090,0,0,6,6,
Tulsa,Governor,Mary Fallin,REP,720090,0,0,27,27,
Tulsa,Superintendent of Public Instruction,Brian Kelly,REP,720090,0,0,8,8,
Tulsa,Superintendent of Public Instruction,Janet Costello Barresi,REP,720090,0,0,4,4,
Tulsa,Superintendent of Public Instruction,Joy Hofmeister,REP,720090,0,0,23,23,
Tulsa,Insurance Commissioner,Bill Viner,REP,720090,0,0,8,8,
Tulsa,Insurance Commissioner,John Doak,REP,720090,0,0,27,27,
Tulsa,Corporation Commissioner,Todd Hiett,REP,720090,0,0,19,19,
Tulsa,Corporation Commissioner,Cliff Branan,REP,720090,0,0,16,16,
Tulsa,U.S. Senate,Evelyn Rogers,REP,720090,0,0,1,1,
Tulsa,U.S. Senate,Rob Moye,REP,720090,0,0,0,0,
Tulsa,U.S. Senate,D. Jean Mcbride-Samuels,REP,720090,0,0,0,0,
Tulsa,U.S. Senate,Jim Inhofe,REP,720090,0,0,33,33,
Tulsa,U.S. Senate,Erick Paul Wyatt,REP,720090,0,0,1,1,
Tulsa,U.S. Senate,Andy Craig,REP,720090,0,0,0,0,
Tulsa,U.S. Senate,T. Shannon,REP,720090,0,0,17,17,
Tulsa,U.S. Senate,Randy Brogdon,REP,720090,0,0,4,4,
Tulsa,U.S. Senate,Eric Mccray,REP,720090,0,0,0,0,
Tulsa,U.S. Senate,Kevin Crow,REP,720090,0,0,1,1,
Tulsa,U.S. Senate,James Lankford,REP,720090,0,0,12,12,
Tulsa,U.S. Senate,Jason Weger,REP,720090,0,0,0,0,
Tulsa,Superintendent of Public Instruction,John Cox,DEM,720091,0,0,16,16,
Tulsa,Superintendent of Public Instruction,Jack Jr.,DEM,720091,0,0,5,5,
Tulsa,Superintendent of Public Instruction,Ivan Holmes,DEM,720091,0,0,1,1,
Tulsa,Superintendent of Public Instruction,Freda Deskin,DEM,720091,0,0,15,15,
Tulsa,U.S. Senate,Patrick Michael Hayes,DEM,720091,0,0,4,4,
Tulsa,U.S. Senate,Jim Rogers,DEM,720091,0,0,12,12,
Tulsa,U.S. Senate,Connie Johnson,DEM,720091,0,0,21,21,
Tulsa,Governor,Dax Ewbank,REP,720091,0,0,19,19,
Tulsa,Governor,Chad Moody,REP,720091,0,0,19,19,
Tulsa,Governor,Mary Fallin,REP,720091,0,0,72,72,
Tulsa,Superintendent of Public Instruction,Brian Kelly,REP,720091,0,0,20,20,
Tulsa,Superintendent of Public Instruction,Janet Costello Barresi,REP,720091,0,0,19,19,
Tulsa,Superintendent of Public Instruction,Joy Hofmeister,REP,720091,0,0,69,69,
Tulsa,Insurance Commissioner,Bill Viner,REP,720091,0,0,23,23,
Tulsa,Insurance Commissioner,John Doak,REP,720091,0,0,84,84,
Tulsa,Corporation Commissioner,Todd Hiett,REP,720091,0,0,58,58,
Tulsa,Corporation Commissioner,Cliff Branan,REP,720091,0,0,48,48,
Tulsa,U.S. Senate,Evelyn Rogers,REP,720091,0,0,8,8,
Tulsa,U.S. Senate,Rob Moye,REP,720091,0,0,1,1,
Tulsa,U.S. Senate,D. Jean Mcbride-Samuels,REP,720091,0,0,2,2,
Tulsa,U.S. Senate,Jim Inhofe,REP,720091,0,0,89,89,
Tulsa,U.S. Senate,Erick Paul Wyatt,REP,720091,0,0,10,10,
Tulsa,U.S. Senate,Andy Craig,REP,720091,0,0,0,0,
Tulsa,U.S. Senate,T. Shannon,REP,720091,0,0,29,29,
Tulsa,U.S. Senate,Randy Brogdon,REP,720091,0,0,15,15,
Tulsa,U.S. Senate,Eric Mccray,REP,720091,0,0,1,1,
Tulsa,U.S. Senate,Kevin Crow,REP,720091,0,0,1,1,
Tulsa,U.S. Senate,James Lankford,REP,720091,0,0,67,67,
Tulsa,U.S. Senate,Jason Weger,REP,720091,0,0,0,0,
Tulsa,State House,Weldon Watson,REP,720091,0,0,58,58,79
Tulsa,State House,Lois Jacobs,REP,720091,0,0,48,48,79
Tulsa,Superintendent of Public Instruction,John Cox,DEM,720092,0,0,21,21,
Tulsa,Superintendent of Public Instruction,Jack Jr.,DEM,720092,0,0,6,6,
Tulsa,Superintendent of Public Instruction,Ivan Holmes,DEM,720092,0,0,1,1,
Tulsa,Superintendent of Public Instruction,Freda Deskin,DEM,720092,0,0,28,28,
Tulsa,U.S. Senate,Patrick Michael Hayes,DEM,720092,0,0,14,14,
Tulsa,U.S. Senate,Jim Rogers,DEM,720092,0,0,11,11,
Tulsa,U.S. Senate,Connie Johnson,DEM,720092,0,0,30,30,
Tulsa,Governor,Dax Ewbank,REP,720092,0,0,13,13,
Tulsa,Governor,Chad Moody,REP,720092,0,0,17,17,
Tulsa,Governor,Mary Fallin,REP,720092,0,0,65,65,
Tulsa,Superintendent of Public Instruction,Brian Kelly,REP,720092,0,0,14,14,
Tulsa,Superintendent of Public Instruction,Janet Costello Barresi,REP,720092,0,0,23,23,
Tulsa,Superintendent of Public Instruction,Joy Hofmeister,REP,720092,0,0,61,61,
Tulsa,Insurance Commissioner,Bill Viner,REP,720092,0,0,25,25,
Tulsa,Insurance Commissioner,John Doak,REP,720092,0,0,69,69,
Tulsa,Corporation Commissioner,Todd Hiett,REP,720092,0,0,48,48,
Tulsa,Corporation Commissioner,Cliff Branan,REP,720092,0,0,48,48,
Tulsa,U.S. Senate,Evelyn Rogers,REP,720092,0,0,4,4,
Tulsa,U.S. Senate,Rob Moye,REP,720092,0,0,0,0,
Tulsa,U.S. Senate,D. Jean Mcbride-Samuels,REP,720092,0,0,2,2,
Tulsa,U.S. Senate,Jim Inhofe,REP,720092,0,0,83,83,
Tulsa,U.S. Senate,Erick Paul Wyatt,REP,720092,0,0,6,6,
Tulsa,U.S. Senate,Andy Craig,REP,720092,0,0,1,1,
Tulsa,U.S. Senate,T. Shannon,REP,720092,0,0,35,35,
Tulsa,U.S. Senate,Randy Brogdon,REP,720092,0,0,11,11,
Tulsa,U.S. Senate,Eric Mccray,REP,720092,0,0,1,1,
Tulsa,U.S. Senate,Kevin Crow,REP,720092,0,0,3,3,
Tulsa,U.S. Senate,James Lankford,REP,720092,0,0,43,43,
Tulsa,U.S. Senate,Jason Weger,REP,720092,0,0,3,3,
Tulsa,Superintendent of Public Instruction,John Cox,DEM,720093,0,0,15,15,
Tulsa,Superintendent of Public Instruction,Jack Jr.,DEM,720093,0,0,7,7,
Tulsa,Superintendent of Public Instruction,Ivan Holmes,DEM,720093,0,0,0,0,
Tulsa,Superintendent of Public Instruction,Freda Deskin,DEM,720093,0,0,21,21,
Tulsa,U.S. Senate,Patrick Michael Hayes,DEM,720093,0,0,9,9,
Tulsa,U.S. Senate,Jim Rogers,DEM,720093,0,0,10,10,
Tulsa,U.S. Senate,Connie Johnson,DEM,720093,0,0,22,22,
Tulsa,Governor,Dax Ewbank,REP,720093,0,0,4,4,
Tulsa,Governor,Chad Moody,REP,720093,0,0,10,10,
Tulsa,Governor,Mary Fallin,REP,720093,0,0,94,94,
Tulsa,Superintendent of Public Instruction,Brian Kelly,REP,720093,0,0,17,17,
Tulsa,Superintendent of Public Instruction,Janet Costello Barresi,REP,720093,0,0,24,24,
Tulsa,Superintendent of Public Instruction,Joy Hofmeister,REP,720093,0,0,66,66,
Tulsa,Insurance Commissioner,Bill Viner,REP,720093,0,0,21,21,
Tulsa,Insurance Commissioner,John Doak,REP,720093,0,0,76,76,
Tulsa,Corporation Commissioner,Todd Hiett,REP,720093,0,0,53,53,
Tulsa,Corporation Commissioner,Cliff Branan,REP,720093,0,0,45,45,
Tulsa,U.S. Senate,Evelyn Rogers,REP,720093,0,0,6,6,
Tulsa,U.S. Senate,Rob Moye,REP,720093,0,0,1,1,
Tulsa,U.S. Senate,D. Jean Mcbride-Samuels,REP,720093,0,0,4,4,
Tulsa,U.S. Senate,Jim Inhofe,REP,720093,0,0,96,96,
Tulsa,U.S. Senate,Erick Paul Wyatt,REP,720093,0,0,3,3,
Tulsa,U.S. Senate,Andy Craig,REP,720093,0,0,1,1,
Tulsa,U.S. Senate,T. Shannon,REP,720093,0,0,35,35,
Tulsa,U.S. Senate,Randy Brogdon,REP,720093,0,0,7,7,
Tulsa,U.S. Senate,Eric Mccray,REP,720093,0,0,0,0,
Tulsa,U.S. Senate,Kevin Crow,REP,720093,0,0,1,1,
Tulsa,U.S. Senate,James Lankford,REP,720093,0,0,66,66,
Tulsa,U.S. Senate,Jason Weger,REP,720093,0,0,0,0,
Tulsa,Superintendent of Public Instruction,John Cox,DEM,720094,0,0,30,30,
Tulsa,Superintendent of Public Instruction,Jack Jr.,DEM,720094,0,0,5,5,
Tulsa,Superintendent of Public Instruction,Ivan Holmes,DEM,720094,0,0,5,5,
Tulsa,Superintendent of Public Instruction,Freda Deskin,DEM,720094,0,0,40,40,
Tulsa,U.S. Senate,Patrick Michael Hayes,DEM,720094,0,0,19,19,
Tulsa,U.S. Senate,Jim Rogers,DEM,720094,0,0,20,20,
Tulsa,U.S. Senate,Connie Johnson,DEM,720094,0,0,36,36,
Tulsa,Governor,Dax Ewbank,REP,720094,0,0,13,13,
Tulsa,Governor,Chad Moody,REP,720094,0,0,34,34,
Tulsa,Governor,Mary Fallin,REP,720094,0,0,131,131,
Tulsa,Superintendent of Public Instruction,Brian Kelly,REP,720094,0,0,23,23,
Tulsa,Superintendent of Public Instruction,Janet Costello Barresi,REP,720094,0,0,38,38,
Tulsa,Superintendent of Public Instruction,Joy Hofmeister,REP,720094,0,0,115,115,
Tulsa,Insurance Commissioner,Bill Viner,REP,720094,0,0,40,40,
Tulsa,Insurance Commissioner,John Doak,REP,720094,0,0,119,119,
Tulsa,Corporation Commissioner,Todd Hiett,REP,720094,0,0,101,101,
Tulsa,Corporation Commissioner,Cliff Branan,REP,720094,0,0,58,58,
Tulsa,U.S. Senate,Evelyn Rogers,REP,720094,0,0,6,6,
Tulsa,U.S. Senate,Rob Moye,REP,720094,0,0,1,1,
Tulsa,U.S. Senate,D. Jean Mcbride-Samuels,REP,720094,0,0,5,5,
Tulsa,U.S. Senate,Jim Inhofe,REP,720094,0,0,158,158,
Tulsa,U.S. Senate,Erick Paul Wyatt,REP,720094,0,0,6,6,
Tulsa,U.S. Senate,Andy Craig,REP,720094,0,0,0,0,
Tulsa,U.S. Senate,T. Shannon,REP,720094,0,0,75,75,
Tulsa,U.S. Senate,Randy Brogdon,REP,720094,0,0,10,10,
Tulsa,U.S. Senate,Eric Mccray,REP,720094,0,0,4,4,
Tulsa,U.S. Senate,Kevin Crow,REP,720094,0,0,0,0,
Tulsa,U.S. Senate,James Lankford,REP,720094,0,0,91,91,
Tulsa,U.S. Senate,Jason Weger,REP,720094,0,0,0,0,
Tulsa,Superintendent of Public Instruction,John Cox,DEM,720095,0,0,25,25,
Tulsa,Superintendent of Public Instruction,Jack Jr.,DEM,720095,0,0,10,10,
Tulsa,Superintendent of Public Instruction,Ivan Holmes,DEM,720095,0,0,2,2,
Tulsa,Superintendent of Public Instruction,Freda Deskin,DEM,720095,0,0,35,35,
Tulsa,U.S. Senate,Patrick Michael Hayes,DEM,720095,0,0,9,9,
Tulsa,U.S. Senate,Jim Rogers,DEM,720095,0,0,20,20,
Tulsa,U.S. Senate,Connie Johnson,DEM,720095,0,0,38,38,
Tulsa,Governor,Dax Ewbank,REP,720095,0,0,10,10,
Tulsa,Governor,Chad Moody,REP,720095,0,0,33,33,
Tulsa,Governor,Mary Fallin,REP,720095,0,0,171,171,
Tulsa,Superintendent of Public Instruction,Brian Kelly,REP,720095,0,0,43,43,
Tulsa,Superintendent of Public Instruction,Janet Costello Barresi,REP,720095,0,0,38,38,
Tulsa,Superintendent of Public Instruction,Joy Hofmeister,REP,720095,0,0,133,133,
Tulsa,Insurance Commissioner,Bill Viner,REP,720095,0,0,40,40,
Tulsa,Insurance Commissioner,John Doak,REP,720095,0,0,148,148,
Tulsa,Corporation Commissioner,Todd Hiett,REP,720095,0,0,109,109,
Tulsa,Corporation Commissioner,Cliff Branan,REP,720095,0,0,81,81,
Tulsa,U.S. Senate,Evelyn Rogers,REP,720095,0,0,12,12,
Tulsa,U.S. Senate,Rob Moye,REP,720095,0,0,2,2,
Tulsa,U.S. Senate,D. Jean Mcbride-Samuels,REP,720095,0,0,7,7,
Tulsa,U.S. Senate,Jim Inhofe,REP,720095,0,0,188,188,
Tulsa,U.S. Senate,Erick Paul Wyatt,REP,720095,0,0,4,4,
Tulsa,U.S. Senate,Andy Craig,REP,720095,0,0,1,1,
Tulsa,U.S. Senate,T. Shannon,REP,720095,0,0,98,98,
Tulsa,U.S. Senate,Randy Brogdon,REP,720095,0,0,13,13,
Tulsa,U.S. Senate,Eric Mccray,REP,720095,0,0,1,1,
Tulsa,U.S. Senate,Kevin Crow,REP,720095,0,0,2,2,
Tulsa,U.S. Senate,James Lankford,REP,720095,0,0,99,99,
Tulsa,U.S. Senate,Jason Weger,REP,720095,0,0,1,1,
Tulsa,Superintendent of Public Instruction,John Cox,DEM,720096,0,0,23,23,
Tulsa,Superintendent of Public Instruction,Jack Jr.,DEM,720096,0,0,4,4,
Tulsa,Superintendent of Public Instruction,Ivan Holmes,DEM,720096,0,0,3,3,
Tulsa,Superintendent of Public Instruction,Freda Deskin,DEM,720096,0,0,30,30,
Tulsa,U.S. Senate,Patrick Michael Hayes,DEM,720096,0,0,13,13,
Tulsa,U.S. Senate,Jim Rogers,DEM,720096,0,0,12,12,
Tulsa,U.S. Senate,Connie Johnson,DEM,720096,0,0,32,32,
Tulsa,Governor,Dax Ewbank,REP,720096,0,0,7,7,
Tulsa,Governor,Chad Moody,REP,720096,0,0,15,15,
Tulsa,Governor,Mary Fallin,REP,720096,0,0,80,80,
Tulsa,Superintendent of Public Instruction,Brian Kelly,REP,720096,0,0,14,14,
Tulsa,Superintendent of Public Instruction,Janet Costello Barresi,REP,720096,0,0,18,18,
Tulsa,Superintendent of Public Instruction,Joy Hofmeister,REP,720096,0,0,71,71,
Tulsa,Insurance Commissioner,Bill Viner,REP,720096,0,0,18,18,
Tulsa,Insurance Commissioner,John Doak,REP,720096,0,0,79,79,
Tulsa,Corporation Commissioner,Todd Hiett,REP,720096,0,0,59,59,
Tulsa,Corporation Commissioner,Cliff Branan,REP,720096,0,0,38,38,
Tulsa,U.S. Senate,Evelyn Rogers,REP,720096,0,0,5,5,
Tulsa,U.S. Senate,Rob Moye,REP,720096,0,0,3,3,
Tulsa,U.S. Senate,D. Jean Mcbride-Samuels,REP,720096,0,0,2,2,
Tulsa,U.S. Senate,Jim Inhofe,REP,720096,0,0,88,88,
Tulsa,U.S. Senate,Erick Paul Wyatt,REP,720096,0,0,4,4,
Tulsa,U.S. Senate,Andy Craig,REP,720096,0,0,2,2,
Tulsa,U.S. Senate,T. Shannon,REP,720096,0,0,45,45,
Tulsa,U.S. Senate,Randy Brogdon,REP,720096,0,0,9,9,
Tulsa,U.S. Senate,Eric Mccray,REP,720096,0,0,2,2,
Tulsa,U.S. Senate,Kevin Crow,REP,720096,0,0,0,0,
Tulsa,U.S. Senate,James Lankford,REP,720096,0,0,45,45,
Tulsa,U.S. Senate,Jason Weger,REP,720096,0,0,2,2,
Tulsa,Superintendent of Public Instruction,John Cox,DEM,720097,0,0,21,21,
Tulsa,Superintendent of Public Instruction,Jack Jr.,DEM,720097,0,0,9,9,
Tulsa,Superintendent of Public Instruction,Ivan Holmes,DEM,720097,0,0,3,3,
Tulsa,Superintendent of Public Instruction,Freda Deskin,DEM,720097,0,0,39,39,
Tulsa,U.S. Senate,Patrick Michael Hayes,DEM,720097,0,0,17,17,
Tulsa,U.S. Senate,Jim Rogers,DEM,720097,0,0,14,14,
Tulsa,U.S. Senate,Connie Johnson,DEM,720097,0,0,41,41,
Tulsa,Governor,Dax Ewbank,REP,720097,0,0,12,12,
Tulsa,Governor,Chad Moody,REP,720097,0,0,32,32,
Tulsa,Governor,Mary Fallin,REP,720097,0,0,110,110,
Tulsa,Superintendent of Public Instruction,Brian Kelly,REP,720097,0,0,26,26,
Tulsa,Superintendent of Public Instruction,Janet Costello Barresi,REP,720097,0,0,38,38,
Tulsa,Superintendent of Public Instruction,Joy Hofmeister,REP,720097,0,0,91,91,
Tulsa,Insurance Commissioner,Bill Viner,REP,720097,0,0,32,32,
Tulsa,Insurance Commissioner,John Doak,REP,720097,0,0,115,115,
Tulsa,Corporation Commissioner,Todd Hiett,REP,720097,0,0,96,96,
Tulsa,Corporation Commissioner,Cliff Branan,REP,720097,0,0,50,50,
Tulsa,U.S. Senate,Evelyn Rogers,REP,720097,0,0,10,10,
Tulsa,U.S. Senate,Rob Moye,REP,720097,0,0,2,2,
Tulsa,U.S. Senate,D. Jean Mcbride-Samuels,REP,720097,0,0,8,8,
Tulsa,U.S. Senate,Jim Inhofe,REP,720097,0,0,129,129,
Tulsa,U.S. Senate,Erick Paul Wyatt,REP,720097,0,0,3,3,
Tulsa,U.S. Senate,Andy Craig,REP,720097,0,0,1,1,
Tulsa,U.S. Senate,T. Shannon,REP,720097,0,0,58,58,
Tulsa,U.S. Senate,Randy Brogdon,REP,720097,0,0,21,21,
Tulsa,U.S. Senate,Eric Mccray,REP,720097,0,0,3,3,
Tulsa,U.S. Senate,Kevin Crow,REP,720097,0,0,3,3,
Tulsa,U.S. Senate,James Lankford,REP,720097,0,0,69,69,
Tulsa,U.S. Senate,Jason Weger,REP,720097,0,0,0,0,
Tulsa,Superintendent of Public Instruction,John Cox,DEM,720098,0,0,16,16,
Tulsa,Superintendent of Public Instruction,Jack Jr.,DEM,720098,0,0,4,4,
Tulsa,Superintendent of Public Instruction,Ivan Holmes,DEM,720098,0,0,4,4,
Tulsa,Superintendent of Public Instruction,Freda Deskin,DEM,720098,0,0,29,29,
Tulsa,U.S. Senate,Patrick Michael Hayes,DEM,720098,0,0,9,9,
Tulsa,U.S. Senate,Jim Rogers,DEM,720098,0,0,11,11,
Tulsa,U.S. Senate,Connie Johnson,DEM,720098,0,0,32,32,
Tulsa,Governor,Dax Ewbank,REP,720098,0,0,13,13,
Tulsa,Governor,Chad Moody,REP,720098,0,0,23,23,
Tulsa,Governor,Mary Fallin,REP,720098,0,0,85,85,
Tulsa,Superintendent of Public Instruction,Brian Kelly,REP,720098,0,0,22,22,
Tulsa,Superintendent of Public Instruction,Janet Costello Barresi,REP,720098,0,0,15,15,
Tulsa,Superintendent of Public Instruction,Joy Hofmeister,REP,720098,0,0,80,80,
Tulsa,Insurance Commissioner,Bill Viner,REP,720098,0,0,25,25,
Tulsa,Insurance Commissioner,John Doak,REP,720098,0,0,83,83,
Tulsa,Corporation Commissioner,Todd Hiett,REP,720098,0,0,52,52,
Tulsa,Corporation Commissioner,Cliff Branan,REP,720098,0,0,53,53,
Tulsa,U.S. Senate,Evelyn Rogers,REP,720098,0,0,5,5,
Tulsa,U.S. Senate,Rob Moye,REP,720098,0,0,0,0,
Tulsa,U.S. Senate,D. Jean Mcbride-Samuels,REP,720098,0,0,3,3,
Tulsa,U.S. Senate,Jim Inhofe,REP,720098,0,0,104,104,
Tulsa,U.S. Senate,Erick Paul Wyatt,REP,720098,0,0,9,9,
Tulsa,U.S. Senate,Andy Craig,REP,720098,0,0,3,3,
Tulsa,U.S. Senate,T. Shannon,REP,720098,0,0,46,46,
Tulsa,U.S. Senate,Randy Brogdon,REP,720098,0,0,12,12,
Tulsa,U.S. Senate,Eric Mccray,REP,720098,0,0,0,0,
Tulsa,U.S. Senate,Kevin Crow,REP,720098,0,0,1,1,
Tulsa,U.S. Senate,James Lankford,REP,720098,0,0,59,59,
Tulsa,U.S. Senate,Jason Weger,REP,720098,0,0,0,0,
Tulsa,Superintendent of Public Instruction,John Cox,DEM,720099,0,0,10,10,
Tulsa,Superintendent of Public Instruction,Jack Jr.,DEM,720099,0,0,7,7,
Tulsa,Superintendent of Public Instruction,Ivan Holmes,DEM,720099,0,0,2,2,
Tulsa,Superintendent of Public Instruction,Freda Deskin,DEM,720099,0,0,17,17,
Tulsa,U.S. Senate,Patrick Michael Hayes,DEM,720099,0,0,7,7,
Tulsa,U.S. Senate,Jim Rogers,DEM,720099,0,0,10,10,
Tulsa,U.S. Senate,Connie Johnson,DEM,720099,0,0,19,19,
Tulsa,Governor,Dax Ewbank,REP,720099,0,0,11,11,
Tulsa,Governor,Chad Moody,REP,720099,0,0,15,15,
Tulsa,Governor,Mary Fallin,REP,720099,0,0,59,59,
Tulsa,Superintendent of Public Instruction,Brian Kelly,REP,720099,0,0,14,14,
Tulsa,Superintendent of Public Instruction,Janet Costello Barresi,REP,720099,0,0,17,17,
Tulsa,Superintendent of Public Instruction,Joy Hofmeister,REP,720099,0,0,53,53,
Tulsa,Insurance Commissioner,Bill Viner,REP,720099,0,0,23,23,
Tulsa,Insurance Commissioner,John Doak,REP,720099,0,0,59,59,
Tulsa,Corporation Commissioner,Todd Hiett,REP,720099,0,0,37,37,
Tulsa,Corporation Commissioner,Cliff Branan,REP,720099,0,0,42,42,
Tulsa,U.S. Senate,Evelyn Rogers,REP,720099,0,0,6,6,
Tulsa,U.S. Senate,Rob Moye,REP,720099,0,0,1,1,
Tulsa,U.S. Senate,D. Jean Mcbride-Samuels,REP,720099,0,0,4,4,
Tulsa,U.S. Senate,Jim Inhofe,REP,720099,0,0,66,66,
Tulsa,U.S. Senate,Erick Paul Wyatt,REP,720099,0,0,5,5,
Tulsa,U.S. Senate,Andy Craig,REP,720099,0,0,1,1,
Tulsa,U.S. Senate,T. Shannon,REP,720099,0,0,42,42,
Tulsa,U.S. Senate,Randy Brogdon,REP,720099,0,0,8,8,
Tulsa,U.S. Senate,Eric Mccray,REP,720099,0,0,0,0,
Tulsa,U.S. Senate,Kevin Crow,REP,720099,0,0,0,0,
Tulsa,U.S. Senate,James Lankford,REP,720099,0,0,33,33,
Tulsa,U.S. Senate,Jason Weger,REP,720099,0,0,1,1,
Tulsa,Superintendent of Public Instruction,John Cox,DEM,720100,0,0,4,4,
Tulsa,Superintendent of Public Instruction,Jack Jr.,DEM,720100,0,0,1,1,
Tulsa,Superintendent of Public Instruction,Ivan Holmes,DEM,720100,0,0,1,1,
Tulsa,Superintendent of Public Instruction,Freda Deskin,DEM,720100,0,0,12,12,
Tulsa,U.S. Senate,Patrick Michael Hayes,DEM,720100,0,0,2,2,
Tulsa,U.S. Senate,Jim Rogers,DEM,720100,0,0,7,7,
Tulsa,U.S. Senate,Connie Johnson,DEM,720100,0,0,8,8,
Tulsa,Governor,Dax Ewbank,REP,720100,0,0,16,16,
Tulsa,Governor,Chad Moody,REP,720100,0,0,6,6,
Tulsa,Governor,Mary Fallin,REP,720100,0,0,55,55,
Tulsa,Superintendent of Public Instruction,Brian Kelly,REP,720100,0,0,11,11,
Tulsa,Superintendent of Public Instruction,Janet Costello Barresi,REP,720100,0,0,14,14,
Tulsa,Superintendent of Public Instruction,Joy Hofmeister,REP,720100,0,0,54,54,
Tulsa,Insurance Commissioner,Bill Viner,REP,720100,0,0,14,14,
Tulsa,Insurance Commissioner,John Doak,REP,720100,0,0,57,57,
Tulsa,Corporation Commissioner,Todd Hiett,REP,720100,0,0,41,41,
Tulsa,Corporation Commissioner,Cliff Branan,REP,720100,0,0,30,30,
Tulsa,U.S. Senate,Evelyn Rogers,REP,720100,0,0,2,2,
Tulsa,U.S. Senate,Rob Moye,REP,720100,0,0,0,0,
Tulsa,U.S. Senate,D. Jean Mcbride-Samuels,REP,720100,0,0,2,2,
Tulsa,U.S. Senate,Jim Inhofe,REP,720100,0,0,68,68,
Tulsa,U.S. Senate,Erick Paul Wyatt,REP,720100,0,0,5,5,
Tulsa,U.S. Senate,Andy Craig,REP,720100,0,0,3,3,
Tulsa,U.S. Senate,T. Shannon,REP,720100,0,0,30,30,
Tulsa,U.S. Senate,Randy Brogdon,REP,720100,0,0,6,6,
Tulsa,U.S. Senate,Eric Mccray,REP,720100,0,0,0,0,
Tulsa,U.S. Senate,Kevin Crow,REP,720100,0,0,0,0,
Tulsa,U.S. Senate,James Lankford,REP,720100,0,0,40,40,
Tulsa,U.S. Senate,Jason Weger,REP,720100,0,0,0,0,
Tulsa,Superintendent of Public Instruction,John Cox,DEM,720101,0,0,24,24,
Tulsa,Superintendent of Public Instruction,Jack Jr.,DEM,720101,0,0,10,10,
Tulsa,Superintendent of Public Instruction,Ivan Holmes,DEM,720101,0,0,2,2,
Tulsa,Superintendent of Public Instruction,Freda Deskin,DEM,720101,0,0,35,35,
Tulsa,U.S. Senate,Patrick Michael Hayes,DEM,720101,0,0,21,21,
Tulsa,U.S. Senate,Jim Rogers,DEM,720101,0,0,16,16,
Tulsa,U.S. Senate,Connie Johnson,DEM,720101,0,0,34,34,
Tulsa,Governor,Dax Ewbank,REP,720101,0,0,14,14,
Tulsa,Governor,Chad Moody,REP,720101,0,0,29,29,
Tulsa,Governor,Mary Fallin,REP,720101,0,0,98,98,
Tulsa,Superintendent of Public Instruction,Brian Kelly,REP,720101,0,0,22,22,
Tulsa,Superintendent of Public Instruction,Janet Costello Barresi,REP,720101,0,0,24,24,
Tulsa,Superintendent of Public Instruction,Joy Hofmeister,REP,720101,0,0,97,97,
Tulsa,Insurance Commissioner,Bill Viner,REP,720101,0,0,33,33,
Tulsa,Insurance Commissioner,John Doak,REP,720101,0,0,95,95,
Tulsa,Corporation Commissioner,Todd Hiett,REP,720101,0,0,77,77,
Tulsa,Corporation Commissioner,Cliff Branan,REP,720101,0,0,57,57,
Tulsa,U.S. Senate,Evelyn Rogers,REP,720101,0,0,12,12,
Tulsa,U.S. Senate,Rob Moye,REP,720101,0,0,3,3,
Tulsa,U.S. Senate,D. Jean Mcbride-Samuels,REP,720101,0,0,1,1,
Tulsa,U.S. Senate,Jim Inhofe,REP,720101,0,0,118,118,
Tulsa,U.S. Senate,Erick Paul Wyatt,REP,720101,0,0,8,8,
Tulsa,U.S. Senate,Andy Craig,REP,720101,0,0,0,0,
Tulsa,U.S. Senate,T. Shannon,REP,720101,0,0,63,63,
Tulsa,U.S. Senate,Randy Brogdon,REP,720101,0,0,13,13,
Tulsa,U.S. Senate,Eric Mccray,REP,720101,0,0,5,5,
Tulsa,U.S. Senate,Kevin Crow,REP,720101,0,0,0,0,
Tulsa,U.S. Senate,James Lankford,REP,720101,0,0,64,64,
Tulsa,U.S. Senate,Jason Weger,REP,720101,0,0,0,0,
Tulsa,Superintendent of Public Instruction,John Cox,DEM,720102,0,0,20,20,
Tulsa,Superintendent of Public Instruction,Jack Jr.,DEM,720102,0,0,6,6,
Tulsa,Superintendent of Public Instruction,Ivan Holmes,DEM,720102,0,0,4,4,
Tulsa,Superintendent of Public Instruction,Freda Deskin,DEM,720102,0,0,28,28,
Tulsa,U.S. Senate,Patrick Michael Hayes,DEM,720102,0,0,9,9,
Tulsa,U.S. Senate,Jim Rogers,DEM,720102,0,0,17,17,
Tulsa,U.S. Senate,Connie Johnson,DEM,720102,0,0,28,28,
Tulsa,Governor,Dax Ewbank,REP,720102,0,0,4,4,
Tulsa,Governor,Chad Moody,REP,720102,0,0,25,25,
Tulsa,Governor,Mary Fallin,REP,720102,0,0,104,104,
Tulsa,Superintendent of Public Instruction,Brian Kelly,REP,720102,0,0,25,25,
Tulsa,Superintendent of Public Instruction,Janet Costello Barresi,REP,720102,0,0,32,32,
Tulsa,Superintendent of Public Instruction,Joy Hofmeister,REP,720102,0,0,79,79,
Tulsa,Insurance Commissioner,Bill Viner,REP,720102,0,0,28,28,
Tulsa,Insurance Commissioner,John Doak,REP,720102,0,0,101,101,
Tulsa,Corporation Commissioner,Todd Hiett,REP,720102,0,0,74,74,
Tulsa,Corporation Commissioner,Cliff Branan,REP,720102,0,0,53,53,
Tulsa,U.S. Senate,Evelyn Rogers,REP,720102,0,0,9,9,
Tulsa,U.S. Senate,Rob Moye,REP,720102,0,0,3,3,
Tulsa,U.S. Senate,D. Jean Mcbride-Samuels,REP,720102,0,0,6,6,
Tulsa,U.S. Senate,Jim Inhofe,REP,720102,0,0,115,115,
Tulsa,U.S. Senate,Erick Paul Wyatt,REP,720102,0,0,1,1,
Tulsa,U.S. Senate,Andy Craig,REP,720102,0,0,2,2,
Tulsa,U.S. Senate,T. Shannon,REP,720102,0,0,46,46,
Tulsa,U.S. Senate,Randy Brogdon,REP,720102,0,0,18,18,
Tulsa,U.S. Senate,Eric Mccray,REP,720102,0,0,1,1,
Tulsa,U.S. Senate,Kevin Crow,REP,720102,0,0,0,0,
Tulsa,U.S. Senate,James Lankford,REP,720102,0,0,69,69,
Tulsa,U.S. Senate,Jason Weger,REP,720102,0,0,2,2,
Tulsa,Superintendent of Public Instruction,John Cox,DEM,720103,0,0,14,14,
Tulsa,Superintendent of Public Instruction,Jack Jr.,DEM,720103,0,0,2,2,
Tulsa,Superintendent of Public Instruction,Ivan Holmes,DEM,720103,0,0,2,2,
Tulsa,Superintendent of Public Instruction,Freda Deskin,DEM,720103,0,0,10,10,
Tulsa,U.S. Senate,Patrick Michael Hayes,DEM,720103,0,0,8,8,
Tulsa,U.S. Senate,Jim Rogers,DEM,720103,0,0,5,5,
Tulsa,U.S. Senate,Connie Johnson,DEM,720103,0,0,14,14,
Tulsa,Governor,Dax Ewbank,REP,720103,0,0,8,8,
Tulsa,Governor,Chad Moody,REP,720103,0,0,6,6,
Tulsa,Governor,Mary Fallin,REP,720103,0,0,41,41,
Tulsa,Superintendent of Public Instruction,Brian Kelly,REP,720103,0,0,5,5,
Tulsa,Superintendent of Public Instruction,Janet Costello Barresi,REP,720103,0,0,13,13,
Tulsa,Superintendent of Public Instruction,Joy Hofmeister,REP,720103,0,0,37,37,
Tulsa,Insurance Commissioner,Bill Viner,REP,720103,0,0,7,7,
Tulsa,Insurance Commissioner,John Doak,REP,720103,0,0,45,45,
Tulsa,Corporation Commissioner,Todd Hiett,REP,720103,0,0,30,30,
Tulsa,Corporation Commissioner,Cliff Branan,REP,720103,0,0,20,20,
Tulsa,U.S. Senate,Evelyn Rogers,REP,720103,0,0,1,1,
Tulsa,U.S. Senate,Rob Moye,REP,720103,0,0,1,1,
Tulsa,U.S. Senate,D. Jean Mcbride-Samuels,REP,720103,0,0,1,1,
Tulsa,U.S. Senate,Jim Inhofe,REP,720103,0,0,49,49,
Tulsa,U.S. Senate,Erick Paul Wyatt,REP,720103,0,0,0,0,
Tulsa,U.S. Senate,Andy Craig,REP,720103,0,0,0,0,
Tulsa,U.S. Senate,T. Shannon,REP,720103,0,0,26,26,
Tulsa,U.S. Senate,Randy Brogdon,REP,720103,0,0,10,10,
Tulsa,U.S. Senate,Eric Mccray,REP,720103,0,0,0,0,
Tulsa,U.S. Senate,Kevin Crow,REP,720103,0,0,0,0,
Tulsa,U.S. Senate,James Lankford,REP,720103,0,0,18,18,
Tulsa,U.S. Senate,Jason Weger,REP,720103,0,0,1,1,
Tulsa,Superintendent of Public Instruction,John Cox,DEM,720104,0,0,11,11,
Tulsa,Superintendent of Public Instruction,Jack Jr.,DEM,720104,0,0,2,2,
Tulsa,Superintendent of Public Instruction,Ivan Holmes,DEM,720104,0,0,2,2,
Tulsa,Superintendent of Public Instruction,Freda Deskin,DEM,720104,0,0,23,23,
Tulsa,U.S. Senate,Patrick Michael Hayes,DEM,720104,0,0,10,10,
Tulsa,U.S. Senate,Jim Rogers,DEM,720104,0,0,7,7,
Tulsa,U.S. Senate,Connie Johnson,DEM,720104,0,0,21,21,
Tulsa,Governor,Dax Ewbank,REP,720104,0,0,6,6,
Tulsa,Governor,Chad Moody,REP,720104,0,0,13,13,
Tulsa,Governor,Mary Fallin,REP,720104,0,0,74,74,
Tulsa,Superintendent of Public Instruction,Brian Kelly,REP,720104,0,0,18,18,
Tulsa,Superintendent of Public Instruction,Janet Costello Barresi,REP,720104,0,0,13,13,
Tulsa,Superintendent of Public Instruction,Joy Hofmeister,REP,720104,0,0,63,63,
Tulsa,Insurance Commissioner,Bill Viner,REP,720104,0,0,14,14,
Tulsa,Insurance Commissioner,John Doak,REP,720104,0,0,74,74,
Tulsa,Corporation Commissioner,Todd Hiett,REP,720104,0,0,47,47,
Tulsa,Corporation Commissioner,Cliff Branan,REP,720104,0,0,40,40,
Tulsa,U.S. Senate,Evelyn Rogers,REP,720104,0,0,4,4,
Tulsa,U.S. Senate,Rob Moye,REP,720104,0,0,0,0,
Tulsa,U.S. Senate,D. Jean Mcbride-Samuels,REP,720104,0,0,1,1,
Tulsa,U.S. Senate,Jim Inhofe,REP,720104,0,0,86,86,
Tulsa,U.S. Senate,Erick Paul Wyatt,REP,720104,0,0,3,3,
Tulsa,U.S. Senate,Andy Craig,REP,720104,0,0,2,2,
Tulsa,U.S. Senate,T. Shannon,REP,720104,0,0,39,39,
Tulsa,U.S. Senate,Randy Brogdon,REP,720104,0,0,7,7,
Tulsa,U.S. Senate,Eric Mccray,REP,720104,0,0,1,1,
Tulsa,U.S. Senate,Kevin Crow,REP,720104,0,0,1,1,
Tulsa,U.S. Senate,James Lankford,REP,720104,0,0,42,42,
Tulsa,U.S. Senate,Jason Weger,REP,720104,0,0,1,1,
Tulsa,Superintendent of Public Instruction,John Cox,DEM,720105,0,0,17,17,
Tulsa,Superintendent of Public Instruction,Jack Jr.,DEM,720105,0,0,8,8,
Tulsa,Superintendent of Public Instruction,Ivan Holmes,DEM,720105,0,0,2,2,
Tulsa,Superintendent of Public Instruction,Freda Deskin,DEM,720105,0,0,27,27,
Tulsa,U.S. Senate,Patrick Michael Hayes,DEM,720105,0,0,5,5,
Tulsa,U.S. Senate,Jim Rogers,DEM,720105,0,0,12,12,
Tulsa,U.S. Senate,Connie Johnson,DEM,720105,0,0,37,37,
Tulsa,Governor,Dax Ewbank,REP,720105,0,0,7,7,
Tulsa,Governor,Chad Moody,REP,720105,0,0,25,25,
Tulsa,Governor,Mary Fallin,REP,720105,0,0,83,83,
Tulsa,Superintendent of Public Instruction,Brian Kelly,REP,720105,0,0,19,19,
Tulsa,Superintendent of Public Instruction,Janet Costello Barresi,REP,720105,0,0,15,15,
Tulsa,Superintendent of Public Instruction,Joy Hofmeister,REP,720105,0,0,79,79,
Tulsa,Insurance Commissioner,Bill Viner,REP,720105,0,0,30,30,
Tulsa,Insurance Commissioner,John Doak,REP,720105,0,0,79,79,
Tulsa,Corporation Commissioner,Todd Hiett,REP,720105,0,0,67,67,
Tulsa,Corporation Commissioner,Cliff Branan,REP,720105,0,0,41,41,
Tulsa,U.S. Senate,Evelyn Rogers,REP,720105,0,0,4,4,
Tulsa,U.S. Senate,Rob Moye,REP,720105,0,0,2,2,
Tulsa,U.S. Senate,D. Jean Mcbride-Samuels,REP,720105,0,0,6,6,
Tulsa,U.S. Senate,Jim Inhofe,REP,720105,0,0,98,98,
Tulsa,U.S. Senate,Erick Paul Wyatt,REP,720105,0,0,6,6,
Tulsa,U.S. Senate,Andy Craig,REP,720105,0,0,2,2,
Tulsa,U.S. Senate,T. Shannon,REP,720105,0,0,49,49,
Tulsa,U.S. Senate,Randy Brogdon,REP,720105,0,0,11,11,
Tulsa,U.S. Senate,Eric Mccray,REP,720105,0,0,2,2,
Tulsa,U.S. Senate,Kevin Crow,REP,720105,0,0,0,0,
Tulsa,U.S. Senate,James Lankford,REP,720105,0,0,51,51,
Tulsa,U.S. Senate,Jason Weger,REP,720105,0,0,1,1,
Tulsa,Superintendent of Public Instruction,John Cox,DEM,720106,0,0,13,13,
Tulsa,Superintendent of Public Instruction,Jack Jr.,DEM,720106,0,0,3,3,
Tulsa,Superintendent of Public Instruction,Ivan Holmes,DEM,720106,0,0,1,1,
Tulsa,Superintendent of Public Instruction,Freda Deskin,DEM,720106,0,0,12,12,
Tulsa,U.S. Senate,Patrick Michael Hayes,DEM,720106,0,0,7,7,
Tulsa,U.S. Senate,Jim Rogers,DEM,720106,0,0,5,5,
Tulsa,U.S. Senate,Connie Johnson,DEM,720106,0,0,17,17,
Tulsa,Governor,Dax Ewbank,REP,720106,0,0,9,9,
Tulsa,Governor,Chad Moody,REP,720106,0,0,6,6,
Tulsa,Governor,Mary Fallin,REP,720106,0,0,60,60,
Tulsa,Superintendent of Public Instruction,Brian Kelly,REP,720106,0,0,15,15,
Tulsa,Superintendent of Public Instruction,Janet Costello Barresi,REP,720106,0,0,9,9,
Tulsa,Superintendent of Public Instruction,Joy Hofmeister,REP,720106,0,0,52,52,
Tulsa,Insurance Commissioner,Bill Viner,REP,720106,0,0,19,19,
Tulsa,Insurance Commissioner,John Doak,REP,720106,0,0,54,54,
Tulsa,Corporation Commissioner,Todd Hiett,REP,720106,0,0,44,44,
Tulsa,Corporation Commissioner,Cliff Branan,REP,720106,0,0,27,27,
Tulsa,U.S. Senate,Evelyn Rogers,REP,720106,0,0,4,4,
Tulsa,U.S. Senate,Rob Moye,REP,720106,0,0,0,0,
Tulsa,U.S. Senate,D. Jean Mcbride-Samuels,REP,720106,0,0,2,2,
Tulsa,U.S. Senate,Jim Inhofe,REP,720106,0,0,62,62,
Tulsa,U.S. Senate,Erick Paul Wyatt,REP,720106,0,0,5,5,
Tulsa,U.S. Senate,Andy Craig,REP,720106,0,0,0,0,
Tulsa,U.S. Senate,T. Shannon,REP,720106,0,0,30,30,
Tulsa,U.S. Senate,Randy Brogdon,REP,720106,0,0,9,9,
Tulsa,U.S. Senate,Eric Mccray,REP,720106,0,0,0,0,
Tulsa,U.S. Senate,Kevin Crow,REP,720106,0,0,0,0,
Tulsa,U.S. Senate,James Lankford,REP,720106,0,0,36,36,
Tulsa,U.S. Senate,Jason Weger,REP,720106,0,0,0,0,
Tulsa,Superintendent of Public Instruction,John Cox,DEM,720107,0,0,29,29,
Tulsa,Superintendent of Public Instruction,Jack Jr.,DEM,720107,0,0,12,12,
Tulsa,Superintendent of Public Instruction,Ivan Holmes,DEM,720107,0,0,8,8,
Tulsa,Superintendent of Public Instruction,Freda Deskin,DEM,720107,0,0,58,58,
Tulsa,U.S. Senate,Patrick Michael Hayes,DEM,720107,0,0,23,23,
Tulsa,U.S. Senate,Jim Rogers,DEM,720107,0,0,23,23,
Tulsa,U.S. Senate,Connie Johnson,DEM,720107,0,0,58,58,
Tulsa,Governor,Dax Ewbank,REP,720107,0,0,18,18,
Tulsa,Governor,Chad Moody,REP,720107,0,0,31,31,
Tulsa,Governor,Mary Fallin,REP,720107,0,0,177,177,
Tulsa,Superintendent of Public Instruction,Brian Kelly,REP,720107,0,0,32,32,
Tulsa,Superintendent of Public Instruction,Janet Costello Barresi,REP,720107,0,0,49,49,
Tulsa,Superintendent of Public Instruction,Joy Hofmeister,REP,720107,0,0,144,144,
Tulsa,Insurance Commissioner,Bill Viner,REP,720107,0,0,46,46,
Tulsa,Insurance Commissioner,John Doak,REP,720107,0,0,169,169,
Tulsa,Corporation Commissioner,Todd Hiett,REP,720107,0,0,135,135,
Tulsa,Corporation Commissioner,Cliff Branan,REP,720107,0,0,73,73,
Tulsa,U.S. Senate,Evelyn Rogers,REP,720107,0,0,6,6,
Tulsa,U.S. Senate,Rob Moye,REP,720107,0,0,3,3,
Tulsa,U.S. Senate,D. Jean Mcbride-Samuels,REP,720107,0,0,1,1,
Tulsa,U.S. Senate,Jim Inhofe,REP,720107,0,0,209,209,
Tulsa,U.S. Senate,Erick Paul Wyatt,REP,720107,0,0,5,5,
Tulsa,U.S. Senate,Andy Craig,REP,720107,0,0,1,1,
Tulsa,U.S. Senate,T. Shannon,REP,720107,0,0,69,69,
Tulsa,U.S. Senate,Randy Brogdon,REP,720107,0,0,23,23,
Tulsa,U.S. Senate,Eric Mccray,REP,720107,0,0,4,4,
Tulsa,U.S. Senate,Kevin Crow,REP,720107,0,0,0,0,
Tulsa,U.S. Senate,James Lankford,REP,720107,0,0,129,129,
Tulsa,U.S. Senate,Jason Weger,REP,720107,0,0,2,2,
Tulsa,Superintendent of Public Instruction,John Cox,DEM,720108,0,0,11,11,
Tulsa,Superintendent of Public Instruction,Jack Jr.,DEM,720108,0,0,9,9,
Tulsa,Superintendent of Public Instruction,Ivan Holmes,DEM,720108,0,0,3,3,
Tulsa,Superintendent of Public Instruction,Freda Deskin,DEM,720108,0,0,31,31,
Tulsa,U.S. Senate,Patrick Michael Hayes,DEM,720108,0,0,10,10,
Tulsa,U.S. Senate,Jim Rogers,DEM,720108,0,0,12,12,
Tulsa,U.S. Senate,Connie Johnson,DEM,720108,0,0,31,31,
Tulsa,Governor,Dax Ewbank,REP,720108,0,0,7,7,
Tulsa,Governor,Chad Moody,REP,720108,0,0,11,11,
Tulsa,Governor,Mary Fallin,REP,720108,0,0,111,111,
Tulsa,Superintendent of Public Instruction,Brian Kelly,REP,720108,0,0,13,13,
Tulsa,Superintendent of Public Instruction,Janet Costello Barresi,REP,720108,0,0,28,28,
Tulsa,Superintendent of Public Instruction,Joy Hofmeister,REP,720108,0,0,90,90,
Tulsa,Insurance Commissioner,Bill Viner,REP,720108,0,0,19,19,
Tulsa,Insurance Commissioner,John Doak,REP,720108,0,0,96,96,
Tulsa,Corporation Commissioner,Todd Hiett,REP,720108,0,0,60,60,
Tulsa,Corporation Commissioner,Cliff Branan,REP,720108,0,0,53,53,
Tulsa,U.S. Senate,Evelyn Rogers,REP,720108,0,0,9,9,
Tulsa,U.S. Senate,Rob Moye,REP,720108,0,0,1,1,
Tulsa,U.S. Senate,D. Jean Mcbride-Samuels,REP,720108,0,0,1,1,
Tulsa,U.S. Senate,Jim Inhofe,REP,720108,0,0,118,118,
Tulsa,U.S. Senate,Erick Paul Wyatt,REP,720108,0,0,2,2,
Tulsa,U.S. Senate,Andy Craig,REP,720108,0,0,0,0,
Tulsa,U.S. Senate,T. Shannon,REP,720108,0,0,47,47,
Tulsa,U.S. Senate,Randy Brogdon,REP,720108,0,0,8,8,
Tulsa,U.S. Senate,Eric Mccray,REP,720108,0,0,0,0,
Tulsa,U.S. Senate,Kevin Crow,REP,720108,0,0,1,1,
Tulsa,U.S. Senate,James Lankford,REP,720108,0,0,75,75,
Tulsa,U.S. Senate,Jason Weger,REP,720108,0,0,0,0,
Tulsa,Superintendent of Public Instruction,John Cox,DEM,720109,0,0,17,17,
Tulsa,Superintendent of Public Instruction,Jack Jr.,DEM,720109,0,0,3,3,
Tulsa,Superintendent of Public Instruction,Ivan Holmes,DEM,720109,0,0,4,4,
Tulsa,Superintendent of Public Instruction,Freda Deskin,DEM,720109,0,0,23,23,
Tulsa,U.S. Senate,Patrick Michael Hayes,DEM,720109,0,0,10,10,
Tulsa,U.S. Senate,Jim Rogers,DEM,720109,0,0,5,5,
Tulsa,U.S. Senate,Connie Johnson,DEM,720109,0,0,31,31,
Tulsa,Governor,Dax Ewbank,REP,720109,0,0,9,9,
Tulsa,Governor,Chad Moody,REP,720109,0,0,12,12,
Tulsa,Governor,Mary Fallin,REP,720109,0,0,64,64,
Tulsa,Superintendent of Public Instruction,Brian Kelly,REP,720109,0,0,10,10,
Tulsa,Superintendent of Public Instruction,Janet Costello Barresi,REP,720109,0,0,13,13,
Tulsa,Superintendent of Public Instruction,Joy Hofmeister,REP,720109,0,0,60,60,
Tulsa,Insurance Commissioner,Bill Viner,REP,720109,0,0,12,12,
Tulsa,Insurance Commissioner,John Doak,REP,720109,0,0,65,65,
Tulsa,Corporation Commissioner,Todd Hiett,REP,720109,0,0,53,53,
Tulsa,Corporation Commissioner,Cliff Branan,REP,720109,0,0,21,21,
Tulsa,U.S. Senate,Evelyn Rogers,REP,720109,0,0,4,4,
Tulsa,U.S. Senate,Rob Moye,REP,720109,0,0,2,2,
Tulsa,U.S. Senate,D. Jean Mcbride-Samuels,REP,720109,0,0,3,3,
Tulsa,U.S. Senate,Jim Inhofe,REP,720109,0,0,72,72,
Tulsa,U.S. Senate,Erick Paul Wyatt,REP,720109,0,0,6,6,
Tulsa,U.S. Senate,Andy Craig,REP,720109,0,0,0,0,
Tulsa,U.S. Senate,T. Shannon,REP,720109,0,0,39,39,
Tulsa,U.S. Senate,Randy Brogdon,REP,720109,0,0,5,5,
Tulsa,U.S. Senate,Eric Mccray,REP,720109,0,0,0,0,
Tulsa,U.S. Senate,Kevin Crow,REP,720109,0,0,0,0,
Tulsa,U.S. Senate,James Lankford,REP,720109,0,0,41,41,
Tulsa,U.S. Senate,Jason Weger,REP,720109,0,0,2,2,
Tulsa,Superintendent of Public Instruction,John Cox,DEM,720110,0,0,14,14,
Tulsa,Superintendent of Public Instruction,Jack Jr.,DEM,720110,0,0,8,8,
Tulsa,Superintendent of Public Instruction,Ivan Holmes,DEM,720110,0,0,4,4,
Tulsa,Superintendent of Public Instruction,Freda Deskin,DEM,720110,0,0,27,27,
Tulsa,U.S. Senate,Patrick Michael Hayes,DEM,720110,0,0,5,5,
Tulsa,U.S. Senate,Jim Rogers,DEM,720110,0,0,17,17,
Tulsa,U.S. Senate,Connie Johnson,DEM,720110,0,0,33,33,
Tulsa,Governor,Dax Ewbank,REP,720110,0,0,12,12,
Tulsa,Governor,Chad Moody,REP,720110,0,0,14,14,
Tulsa,Governor,Mary Fallin,REP,720110,0,0,87,87,
Tulsa,Superintendent of Public Instruction,Brian Kelly,REP,720110,0,0,22,22,
Tulsa,Superintendent of Public Instruction,Janet Costello Barresi,REP,720110,0,0,23,23,
Tulsa,Superintendent of Public Instruction,Joy Hofmeister,REP,720110,0,0,67,67,
Tulsa,Insurance Commissioner,Bill Viner,REP,720110,0,0,20,20,
Tulsa,Insurance Commissioner,John Doak,REP,720110,0,0,89,89,
Tulsa,Corporation Commissioner,Todd Hiett,REP,720110,0,0,62,62,
Tulsa,Corporation Commissioner,Cliff Branan,REP,720110,0,0,45,45,
Tulsa,U.S. Senate,Evelyn Rogers,REP,720110,0,0,9,9,
Tulsa,U.S. Senate,Rob Moye,REP,720110,0,0,1,1,
Tulsa,U.S. Senate,D. Jean Mcbride-Samuels,REP,720110,0,0,1,1,
Tulsa,U.S. Senate,Jim Inhofe,REP,720110,0,0,98,98,
Tulsa,U.S. Senate,Erick Paul Wyatt,REP,720110,0,0,4,4,
Tulsa,U.S. Senate,Andy Craig,REP,720110,0,0,2,2,
Tulsa,U.S. Senate,T. Shannon,REP,720110,0,0,46,46,
Tulsa,U.S. Senate,Randy Brogdon,REP,720110,0,0,18,18,
Tulsa,U.S. Senate,Eric Mccray,REP,720110,0,0,1,1,
Tulsa,U.S. Senate,Kevin Crow,REP,720110,0,0,3,3,
Tulsa,U.S. Senate,James Lankford,REP,720110,0,0,46,46,
Tulsa,U.S. Senate,Jason Weger,REP,720110,0,0,0,0,
Tulsa,Superintendent of Public Instruction,John Cox,DEM,720111,0,0,18,18,
Tulsa,Superintendent of Public Instruction,Jack Jr.,DEM,720111,0,0,2,2,
Tulsa,Superintendent of Public Instruction,Ivan Holmes,DEM,720111,0,0,2,2,
Tulsa,Superintendent of Public Instruction,Freda Deskin,DEM,720111,0,0,27,27,
Tulsa,U.S. Senate,Patrick Michael Hayes,DEM,720111,0,0,6,6,
Tulsa,U.S. Senate,Jim Rogers,DEM,720111,0,0,13,13,
Tulsa,U.S. Senate,Connie Johnson,DEM,720111,0,0,30,30,
Tulsa,Governor,Dax Ewbank,REP,720111,0,0,3,3,
Tulsa,Governor,Chad Moody,REP,720111,0,0,11,11,
Tulsa,Governor,Mary Fallin,REP,720111,0,0,95,95,
Tulsa,Superintendent of Public Instruction,Brian Kelly,REP,720111,0,0,16,16,
Tulsa,Superintendent of Public Instruction,Janet Costello Barresi,REP,720111,0,0,35,35,
Tulsa,Superintendent of Public Instruction,Joy Hofmeister,REP,720111,0,0,57,57,
Tulsa,Insurance Commissioner,Bill Viner,REP,720111,0,0,29,29,
Tulsa,Insurance Commissioner,John Doak,REP,720111,0,0,69,69,
Tulsa,Corporation Commissioner,Todd Hiett,REP,720111,0,0,55,55,
Tulsa,Corporation Commissioner,Cliff Branan,REP,720111,0,0,43,43,
Tulsa,U.S. Senate,Evelyn Rogers,REP,720111,0,0,6,6,
Tulsa,U.S. Senate,Rob Moye,REP,720111,0,0,2,2,
Tulsa,U.S. Senate,D. Jean Mcbride-Samuels,REP,720111,0,0,2,2,
Tulsa,U.S. Senate,Jim Inhofe,REP,720111,0,0,96,96,
Tulsa,U.S. Senate,Erick Paul Wyatt,REP,720111,0,0,4,4,
Tulsa,U.S. Senate,Andy Craig,REP,720111,0,0,1,1,
Tulsa,U.S. Senate,T. Shannon,REP,720111,0,0,34,34,
Tulsa,U.S. Senate,Randy Brogdon,REP,720111,0,0,7,7,
Tulsa,U.S. Senate,Eric Mccray,REP,720111,0,0,0,0,
Tulsa,U.S. Senate,Kevin Crow,REP,720111,0,0,2,2,
Tulsa,U.S. Senate,James Lankford,REP,720111,0,0,65,65,
Tulsa,U.S. Senate,Jason Weger,REP,720111,0,0,0,0,
Tulsa,Superintendent of Public Instruction,John Cox,DEM,720112,0,0,8,8,
Tulsa,Superintendent of Public Instruction,Jack Jr.,DEM,720112,0,0,4,4,
Tulsa,Superintendent of Public Instruction,Ivan Holmes,DEM,720112,0,0,5,5,
Tulsa,Superintendent of Public Instruction,Freda Deskin,DEM,720112,0,0,13,13,
Tulsa,U.S. Senate,Patrick Michael Hayes,DEM,720112,0,0,5,5,
Tulsa,U.S. Senate,Jim Rogers,DEM,720112,0,0,6,6,
Tulsa,U.S. Senate,Connie Johnson,DEM,720112,0,0,18,18,
Tulsa,Governor,Dax Ewbank,REP,720112,0,0,9,9,
Tulsa,Governor,Chad Moody,REP,720112,0,0,9,9,
Tulsa,Governor,Mary Fallin,REP,720112,0,0,52,52,
Tulsa,Superintendent of Public Instruction,Brian Kelly,REP,720112,0,0,12,12,
Tulsa,Superintendent of Public Instruction,Janet Costello Barresi,REP,720112,0,0,24,24,
Tulsa,Superintendent of Public Instruction,Joy Hofmeister,REP,720112,0,0,35,35,
Tulsa,Insurance Commissioner,Bill Viner,REP,720112,0,0,16,16,
Tulsa,Insurance Commissioner,John Doak,REP,720112,0,0,50,50,
Tulsa,Corporation Commissioner,Todd Hiett,REP,720112,0,0,45,45,
Tulsa,Corporation Commissioner,Cliff Branan,REP,720112,0,0,21,21,
Tulsa,U.S. Senate,Evelyn Rogers,REP,720112,0,0,2,2,
Tulsa,U.S. Senate,Rob Moye,REP,720112,0,0,0,0,
Tulsa,U.S. Senate,D. Jean Mcbride-Samuels,REP,720112,0,0,2,2,
Tulsa,U.S. Senate,Jim Inhofe,REP,720112,0,0,63,63,
Tulsa,U.S. Senate,Erick Paul Wyatt,REP,720112,0,0,4,4,
Tulsa,U.S. Senate,Andy Craig,REP,720112,0,0,3,3,
Tulsa,U.S. Senate,T. Shannon,REP,720112,0,0,30,30,
Tulsa,U.S. Senate,Randy Brogdon,REP,720112,0,0,10,10,
Tulsa,U.S. Senate,Eric Mccray,REP,720112,0,0,3,3,
Tulsa,U.S. Senate,Kevin Crow,REP,720112,0,0,0,0,
Tulsa,U.S. Senate,James Lankford,REP,720112,0,0,27,27,
Tulsa,U.S. Senate,Jason Weger,REP,720112,0,0,1,1,
Tulsa,Superintendent of Public Instruction,John Cox,DEM,720113,0,0,17,17,
Tulsa,Superintendent of Public Instruction,Jack Jr.,DEM,720113,0,0,4,4,
Tulsa,Superintendent of Public Instruction,Ivan Holmes,DEM,720113,0,0,3,3,
Tulsa,Superintendent of Public Instruction,Freda Deskin,DEM,720113,0,0,19,19,
Tulsa,U.S. Senate,Patrick Michael Hayes,DEM,720113,0,0,5,5,
Tulsa,U.S. Senate,Jim Rogers,DEM,720113,0,0,9,9,
Tulsa,U.S. Senate,Connie Johnson,DEM,720113,0,0,26,26,
Tulsa,Governor,Dax Ewbank,REP,720113,0,0,10,10,
Tulsa,Governor,Chad Moody,REP,720113,0,0,23,23,
Tulsa,Governor,Mary Fallin,REP,720113,0,0,123,123,
Tulsa,Superintendent of Public Instruction,Brian Kelly,REP,720113,0,0,27,27,
Tulsa,Superintendent of Public Instruction,Janet Costello Barresi,REP,720113,0,0,28,28,
Tulsa,Superintendent of Public Instruction,Joy Hofmeister,REP,720113,0,0,99,99,
Tulsa,Insurance Commissioner,Bill Viner,REP,720113,0,0,30,30,
Tulsa,Insurance Commissioner,John Doak,REP,720113,0,0,95,95,
Tulsa,Corporation Commissioner,Todd Hiett,REP,720113,0,0,79,79,
Tulsa,Corporation Commissioner,Cliff Branan,REP,720113,0,0,59,59,
Tulsa,U.S. Senate,Evelyn Rogers,REP,720113,0,0,8,8,
Tulsa,U.S. Senate,Rob Moye,REP,720113,0,0,2,2,
Tulsa,U.S. Senate,D. Jean Mcbride-Samuels,REP,720113,0,0,5,5,
Tulsa,U.S. Senate,Jim Inhofe,REP,720113,0,0,129,129,
Tulsa,U.S. Senate,Erick Paul Wyatt,REP,720113,0,0,9,9,
Tulsa,U.S. Senate,Andy Craig,REP,720113,0,0,1,1,
Tulsa,U.S. Senate,T. Shannon,REP,720113,0,0,60,60,
Tulsa,U.S. Senate,Randy Brogdon,REP,720113,0,0,12,12,
Tulsa,U.S. Senate,Eric Mccray,REP,720113,0,0,2,2,
Tulsa,U.S. Senate,Kevin Crow,REP,720113,0,0,2,2,
Tulsa,U.S. Senate,James Lankford,REP,720113,0,0,82,82,
Tulsa,U.S. Senate,Jason Weger,REP,720113,0,0,0,0,
Tulsa,State House,Melissa Abdo,REP,720113,0,0,51,51,69
Tulsa,State House,Paul Bowman,REP,720113,0,0,40,40,69
Tulsa,State House,Chuck Strohm,REP,720113,0,0,46,46,69
Tulsa,Superintendent of Public Instruction,John Cox,DEM,720114,0,0,17,17,
Tulsa,Superintendent of Public Instruction,Jack Jr.,DEM,720114,0,0,6,6,
Tulsa,Superintendent of Public Instruction,Ivan Holmes,DEM,720114,0,0,3,3,
Tulsa,Superintendent of Public Instruction,Freda Deskin,DEM,720114,0,0,18,18,
Tulsa,U.S. Senate,Patrick Michael Hayes,DEM,720114,0,0,13,13,
Tulsa,U.S. Senate,Jim Rogers,DEM,720114,0,0,8,8,
Tulsa,U.S. Senate,Connie Johnson,DEM,720114,0,0,24,24,
Tulsa,Governor,Dax Ewbank,REP,720114,0,0,13,13,
Tulsa,Governor,Chad Moody,REP,720114,0,0,18,18,
Tulsa,Governor,Mary Fallin,REP,720114,0,0,83,83,
Tulsa,Superintendent of Public Instruction,Brian Kelly,REP,720114,0,0,15,15,
Tulsa,Superintendent of Public Instruction,Janet Costello Barresi,REP,720114,0,0,22,22,
Tulsa,Superintendent of Public Instruction,Joy Hofmeister,REP,720114,0,0,77,77,
Tulsa,Insurance Commissioner,Bill Viner,REP,720114,0,0,20,20,
Tulsa,Insurance Commissioner,John Doak,REP,720114,0,0,80,80,
Tulsa,Corporation Commissioner,Todd Hiett,REP,720114,0,0,66,66,
Tulsa,Corporation Commissioner,Cliff Branan,REP,720114,0,0,39,39,
Tulsa,U.S. Senate,Evelyn Rogers,REP,720114,0,0,8,8,
Tulsa,U.S. Senate,Rob Moye,REP,720114,0,0,3,3,
Tulsa,U.S. Senate,D. Jean Mcbride-Samuels,REP,720114,0,0,4,4,
Tulsa,U.S. Senate,Jim Inhofe,REP,720114,0,0,96,96,
Tulsa,U.S. Senate,Erick Paul Wyatt,REP,720114,0,0,2,2,
Tulsa,U.S. Senate,Andy Craig,REP,720114,0,0,3,3,
Tulsa,U.S. Senate,T. Shannon,REP,720114,0,0,30,30,
Tulsa,U.S. Senate,Randy Brogdon,REP,720114,0,0,17,17,
Tulsa,U.S. Senate,Eric Mccray,REP,720114,0,0,1,1,
Tulsa,U.S. Senate,Kevin Crow,REP,720114,0,0,0,0,
Tulsa,U.S. Senate,James Lankford,REP,720114,0,0,65,65,
Tulsa,U.S. Senate,Jason Weger,REP,720114,0,0,1,1,
Tulsa,Superintendent of Public Instruction,John Cox,DEM,720115,0,0,9,9,
Tulsa,Superintendent of Public Instruction,Jack Jr.,DEM,720115,0,0,2,2,
Tulsa,Superintendent of Public Instruction,Ivan Holmes,DEM,720115,0,0,1,1,
Tulsa,Superintendent of Public Instruction,Freda Deskin,DEM,720115,0,0,20,20,
Tulsa,U.S. Senate,Patrick Michael Hayes,DEM,720115,0,0,6,6,
Tulsa,U.S. Senate,Jim Rogers,DEM,720115,0,0,4,4,
Tulsa,U.S. Senate,Connie Johnson,DEM,720115,0,0,20,20,
Tulsa,Governor,Dax Ewbank,REP,720115,0,0,5,5,
Tulsa,Governor,Chad Moody,REP,720115,0,0,24,24,
Tulsa,Governor,Mary Fallin,REP,720115,0,0,175,175,
Tulsa,Superintendent of Public Instruction,Brian Kelly,REP,720115,0,0,16,16,
Tulsa,Superintendent of Public Instruction,Janet Costello Barresi,REP,720115,0,0,43,43,
Tulsa,Superintendent of Public Instruction,Joy Hofmeister,REP,720115,0,0,142,142,
Tulsa,Insurance Commissioner,Bill Viner,REP,720115,0,0,26,26,
Tulsa,Insurance Commissioner,John Doak,REP,720115,0,0,151,151,
Tulsa,Corporation Commissioner,Todd Hiett,REP,720115,0,0,123,123,
Tulsa,Corporation Commissioner,Cliff Branan,REP,720115,0,0,60,60,
Tulsa,U.S. Senate,Evelyn Rogers,REP,720115,0,0,8,8,
Tulsa,U.S. Senate,Rob Moye,REP,720115,0,0,2,2,
Tulsa,U.S. Senate,D. Jean Mcbride-Samuels,REP,720115,0,0,6,6,
Tulsa,U.S. Senate,Jim Inhofe,REP,720115,0,0,180,180,
Tulsa,U.S. Senate,Erick Paul Wyatt,REP,720115,0,0,3,3,
Tulsa,U.S. Senate,Andy Craig,REP,720115,0,0,1,1,
Tulsa,U.S. Senate,T. Shannon,REP,720115,0,0,46,46,
Tulsa,U.S. Senate,Randy Brogdon,REP,720115,0,0,11,11,
Tulsa,U.S. Senate,Eric Mccray,REP,720115,0,0,0,0,
Tulsa,U.S. Senate,Kevin Crow,REP,720115,0,0,2,2,
Tulsa,U.S. Senate,James Lankford,REP,720115,0,0,145,145,
Tulsa,U.S. Senate,Jason Weger,REP,720115,0,0,0,0,
Tulsa,Superintendent of Public Instruction,John Cox,DEM,720116,0,0,15,15,
Tulsa,Superintendent of Public Instruction,Jack Jr.,DEM,720116,0,0,9,9,
Tulsa,Superintendent of Public Instruction,Ivan Holmes,DEM,720116,0,0,2,2,
Tulsa,Superintendent of Public Instruction,Freda Deskin,DEM,720116,0,0,36,36,
Tulsa,U.S. Senate,Patrick Michael Hayes,DEM,720116,0,0,5,5,
Tulsa,U.S. Senate,Jim Rogers,DEM,720116,0,0,15,15,
Tulsa,U.S. Senate,Connie Johnson,DEM,720116,0,0,42,42,
Tulsa,Governor,Dax Ewbank,REP,720116,0,0,15,15,
Tulsa,Governor,Chad Moody,REP,720116,0,0,50,50,
Tulsa,Governor,Mary Fallin,REP,720116,0,0,279,279,
Tulsa,Superintendent of Public Instruction,Brian Kelly,REP,720116,0,0,40,40,
Tulsa,Superintendent of Public Instruction,Janet Costello Barresi,REP,720116,0,0,75,75,
Tulsa,Superintendent of Public Instruction,Joy Hofmeister,REP,720116,0,0,230,230,
Tulsa,Insurance Commissioner,Bill Viner,REP,720116,0,0,66,66,
Tulsa,Insurance Commissioner,John Doak,REP,720116,0,0,239,239,
Tulsa,Corporation Commissioner,Todd Hiett,REP,720116,0,0,200,200,
Tulsa,Corporation Commissioner,Cliff Branan,REP,720116,0,0,114,114,
Tulsa,U.S. Senate,Evelyn Rogers,REP,720116,0,0,13,13,
Tulsa,U.S. Senate,Rob Moye,REP,720116,0,0,6,6,
Tulsa,U.S. Senate,D. Jean Mcbride-Samuels,REP,720116,0,0,19,19,
Tulsa,U.S. Senate,Jim Inhofe,REP,720116,0,0,299,299,
Tulsa,U.S. Senate,Erick Paul Wyatt,REP,720116,0,0,7,7,
Tulsa,U.S. Senate,Andy Craig,REP,720116,0,0,3,3,
Tulsa,U.S. Senate,T. Shannon,REP,720116,0,0,121,121,
Tulsa,U.S. Senate,Randy Brogdon,REP,720116,0,0,26,26,
Tulsa,U.S. Senate,Eric Mccray,REP,720116,0,0,1,1,
Tulsa,U.S. Senate,Kevin Crow,REP,720116,0,0,3,3,
Tulsa,U.S. Senate,James Lankford,REP,720116,0,0,197,197,
Tulsa,U.S. Senate,Jason Weger,REP,720116,0,0,2,2,
Tulsa,State House,Melissa Abdo,REP,720116,0,0,154,154,69
Tulsa,State House,Paul Bowman,REP,720116,0,0,73,73,69
Tulsa,State House,Chuck Strohm,REP,720116,0,0,102,102,69
Tulsa,Superintendent of Public Instruction,John Cox,DEM,720117,0,0,33,33,
Tulsa,Superintendent of Public Instruction,Jack Jr.,DEM,720117,0,0,12,12,
Tulsa,Superintendent of Public Instruction,Ivan Holmes,DEM,720117,0,0,5,5,
Tulsa,Superintendent of Public Instruction,Freda Deskin,DEM,720117,0,0,54,54,
Tulsa,U.S. Senate,Patrick Michael Hayes,DEM,720117,0,0,16,16,
Tulsa,U.S. Senate,Jim Rogers,DEM,720117,0,0,23,23,
Tulsa,U.S. Senate,Connie Johnson,DEM,720117,0,0,64,64,
Tulsa,Governor,Dax Ewbank,REP,720117,0,0,20,20,
Tulsa,Governor,Chad Moody,REP,720117,0,0,63,63,
Tulsa,Governor,Mary Fallin,REP,720117,0,0,371,371,
Tulsa,Superintendent of Public Instruction,Brian Kelly,REP,720117,0,0,55,55,
Tulsa,Superintendent of Public Instruction,Janet Costello Barresi,REP,720117,0,0,88,88,
Tulsa,Superintendent of Public Instruction,Joy Hofmeister,REP,720117,0,0,313,313,
Tulsa,Insurance Commissioner,Bill Viner,REP,720117,0,0,68,68,
Tulsa,Insurance Commissioner,John Doak,REP,720117,0,0,340,340,
Tulsa,Corporation Commissioner,Todd Hiett,REP,720117,0,0,249,249,
Tulsa,Corporation Commissioner,Cliff Branan,REP,720117,0,0,166,166,
Tulsa,U.S. Senate,Evelyn Rogers,REP,720117,0,0,22,22,
Tulsa,U.S. Senate,Rob Moye,REP,720117,0,0,7,7,
Tulsa,U.S. Senate,D. Jean Mcbride-Samuels,REP,720117,0,0,2,2,
Tulsa,U.S. Senate,Jim Inhofe,REP,720117,0,0,410,410,
Tulsa,U.S. Senate,Erick Paul Wyatt,REP,720117,0,0,10,10,
Tulsa,U.S. Senate,Andy Craig,REP,720117,0,0,2,2,
Tulsa,U.S. Senate,T. Shannon,REP,720117,0,0,140,140,
Tulsa,U.S. Senate,Randy Brogdon,REP,720117,0,0,23,23,
Tulsa,U.S. Senate,Eric Mccray,REP,720117,0,0,4,4,
Tulsa,U.S. Senate,Kevin Crow,REP,720117,0,0,2,2,
Tulsa,U.S. Senate,James Lankford,REP,720117,0,0,290,290,
Tulsa,U.S. Senate,Jason Weger,REP,720117,0,0,3,3,
Tulsa,Superintendent of Public Instruction,John Cox,DEM,720118,0,0,15,15,
Tulsa,Superintendent of Public Instruction,Jack Jr.,DEM,720118,0,0,3,3,
Tulsa,Superintendent of Public Instruction,Ivan Holmes,DEM,720118,0,0,0,0,
Tulsa,Superintendent of Public Instruction,Freda Deskin,DEM,720118,0,0,31,31,
Tulsa,U.S. Senate,Patrick Michael Hayes,DEM,720118,0,0,10,10,
Tulsa,U.S. Senate,Jim Rogers,DEM,720118,0,0,12,12,
Tulsa,U.S. Senate,Connie Johnson,DEM,720118,0,0,25,25,
Tulsa,Governor,Dax Ewbank,REP,720118,0,0,25,25,
Tulsa,Governor,Chad Moody,REP,720118,0,0,46,46,
Tulsa,Governor,Mary Fallin,REP,720118,0,0,339,339,
Tulsa,Superintendent of Public Instruction,Brian Kelly,REP,720118,0,0,39,39,
Tulsa,Superintendent of Public Instruction,Janet Costello Barresi,REP,720118,0,0,83,83,
Tulsa,Superintendent of Public Instruction,Joy Hofmeister,REP,720118,0,0,290,290,
Tulsa,Insurance Commissioner,Bill Viner,REP,720118,0,0,65,65,
Tulsa,Insurance Commissioner,John Doak,REP,720118,0,0,297,297,
Tulsa,Corporation Commissioner,Todd Hiett,REP,720118,0,0,217,217,
Tulsa,Corporation Commissioner,Cliff Branan,REP,720118,0,0,148,148,
Tulsa,U.S. Senate,Evelyn Rogers,REP,720118,0,0,19,19,
Tulsa,U.S. Senate,Rob Moye,REP,720118,0,0,7,7,
Tulsa,U.S. Senate,D. Jean Mcbride-Samuels,REP,720118,0,0,8,8,
Tulsa,U.S. Senate,Jim Inhofe,REP,720118,0,0,367,367,
Tulsa,U.S. Senate,Erick Paul Wyatt,REP,720118,0,0,10,10,
Tulsa,U.S. Senate,Andy Craig,REP,720118,0,0,1,1,
Tulsa,U.S. Senate,T. Shannon,REP,720118,0,0,142,142,
Tulsa,U.S. Senate,Randy Brogdon,REP,720118,0,0,27,27,
Tulsa,U.S. Senate,Eric Mccray,REP,720118,0,0,0,0,
Tulsa,U.S. Senate,Kevin Crow,REP,720118,0,0,2,2,
Tulsa,U.S. Senate,James Lankford,REP,720118,0,0,245,245,
Tulsa,U.S. Senate,Jason Weger,REP,720118,0,0,2,2,
Tulsa,Superintendent of Public Instruction,John Cox,DEM,720119,0,0,9,9,
Tulsa,Superintendent of Public Instruction,Jack Jr.,DEM,720119,0,0,3,3,
Tulsa,Superintendent of Public Instruction,Ivan Holmes,DEM,720119,0,0,0,0,
Tulsa,Superintendent of Public Instruction,Freda Deskin,DEM,720119,0,0,28,28,
Tulsa,U.S. Senate,Patrick Michael Hayes,DEM,720119,0,0,5,5,
Tulsa,U.S. Senate,Jim Rogers,DEM,720119,0,0,7,7,
Tulsa,U.S. Senate,Connie Johnson,DEM,720119,0,0,28,28,
Tulsa,Governor,Dax Ewbank,REP,720119,0,0,11,11,
Tulsa,Governor,Chad Moody,REP,720119,0,0,30,30,
Tulsa,Governor,Mary Fallin,REP,720119,0,0,239,239,
Tulsa,Superintendent of Public Instruction,Brian Kelly,REP,720119,0,0,30,30,
Tulsa,Superintendent of Public Instruction,Janet Costello Barresi,REP,720119,0,0,44,44,
Tulsa,Superintendent of Public Instruction,Joy Hofmeister,REP,720119,0,0,205,205,
Tulsa,Insurance Commissioner,Bill Viner,REP,720119,0,0,49,49,
Tulsa,Insurance Commissioner,John Doak,REP,720119,0,0,200,200,
Tulsa,Corporation Commissioner,Todd Hiett,REP,720119,0,0,152,152,
Tulsa,Corporation Commissioner,Cliff Branan,REP,720119,0,0,100,100,
Tulsa,U.S. Senate,Evelyn Rogers,REP,720119,0,0,11,11,
Tulsa,U.S. Senate,Rob Moye,REP,720119,0,0,4,4,
Tulsa,U.S. Senate,D. Jean Mcbride-Samuels,REP,720119,0,0,2,2,
Tulsa,U.S. Senate,Jim Inhofe,REP,720119,0,0,259,259,
Tulsa,U.S. Senate,Erick Paul Wyatt,REP,720119,0,0,5,5,
Tulsa,U.S. Senate,Andy Craig,REP,720119,0,0,0,0,
Tulsa,U.S. Senate,T. Shannon,REP,720119,0,0,99,99,
Tulsa,U.S. Senate,Randy Brogdon,REP,720119,0,0,12,12,
Tulsa,U.S. Senate,Eric Mccray,REP,720119,0,0,2,2,
Tulsa,U.S. Senate,Kevin Crow,REP,720119,0,0,1,1,
Tulsa,U.S. Senate,James Lankford,REP,720119,0,0,173,173,
Tulsa,U.S. Senate,Jason Weger,REP,720119,0,0,0,0,
Tulsa,State House,Melissa Abdo,REP,720119,0,0,125,125,69
Tulsa,State House,Paul Bowman,REP,720119,0,0,64,64,69
Tulsa,State House,Chuck Strohm,REP,720119,0,0,80,80,69
Tulsa,Superintendent of Public Instruction,John Cox,DEM,720120,0,0,10,10,
Tulsa,Superintendent of Public Instruction,Jack Jr.,DEM,720120,0,0,1,1,
Tulsa,Superintendent of Public Instruction,Ivan Holmes,DEM,720120,0,0,4,4,
Tulsa,Superintendent of Public Instruction,Freda Deskin,DEM,720120,0,0,13,13,
Tulsa,U.S. Senate,Patrick Michael Hayes,DEM,720120,0,0,5,5,
Tulsa,U.S. Senate,Jim Rogers,DEM,720120,0,0,2,2,
Tulsa,U.S. Senate,Connie Johnson,DEM,720120,0,0,19,19,
Tulsa,Governor,Dax Ewbank,REP,720120,0,0,12,12,
Tulsa,Governor,Chad Moody,REP,720120,0,0,35,35,
Tulsa,Governor,Mary Fallin,REP,720120,0,0,99,99,
Tulsa,Superintendent of Public Instruction,Brian Kelly,REP,720120,0,0,25,25,
Tulsa,Superintendent of Public Instruction,Janet Costello Barresi,REP,720120,0,0,16,16,
Tulsa,Superintendent of Public Instruction,Joy Hofmeister,REP,720120,0,0,107,107,
Tulsa,Insurance Commissioner,Bill Viner,REP,720120,0,0,25,25,
Tulsa,Insurance Commissioner,John Doak,REP,720120,0,0,114,114,
Tulsa,Corporation Commissioner,Todd Hiett,REP,720120,0,0,68,68,
Tulsa,Corporation Commissioner,Cliff Branan,REP,720120,0,0,69,69,
Tulsa,U.S. Senate,Evelyn Rogers,REP,720120,0,0,4,4,
Tulsa,U.S. Senate,Rob Moye,REP,720120,0,0,4,4,
Tulsa,U.S. Senate,D. Jean Mcbride-Samuels,REP,720120,0,0,2,2,
Tulsa,U.S. Senate,Jim Inhofe,REP,720120,0,0,131,131,
Tulsa,U.S. Senate,Erick Paul Wyatt,REP,720120,0,0,6,6,
Tulsa,U.S. Senate,Andy Craig,REP,720120,0,0,1,1,
Tulsa,U.S. Senate,T. Shannon,REP,720120,0,0,46,46,
Tulsa,U.S. Senate,Randy Brogdon,REP,720120,0,0,17,17,
Tulsa,U.S. Senate,Eric Mccray,REP,720120,0,0,0,0,
Tulsa,U.S. Senate,Kevin Crow,REP,720120,0,0,1,1,
Tulsa,U.S. Senate,James Lankford,REP,720120,0,0,83,83,
Tulsa,U.S. Senate,Jason Weger,REP,720120,0,0,1,1,
Tulsa,State House,Weldon Watson,REP,720120,0,0,94,94,79
Tulsa,State House,Lois Jacobs,REP,720120,0,0,40,40,79
Tulsa,Superintendent of Public Instruction,John Cox,DEM,720121,0,0,32,32,
Tulsa,Superintendent of Public Instruction,Jack Jr.,DEM,720121,0,0,7,7,
Tulsa,Superintendent of Public Instruction,Ivan Holmes,DEM,720121,0,0,6,6,
Tulsa,Superintendent of Public Instruction,Freda Deskin,DEM,720121,0,0,65,65,
Tulsa,U.S. Senate,Patrick Michael Hayes,DEM,720121,0,0,15,15,
Tulsa,U.S. Senate,Jim Rogers,DEM,720121,0,0,20,20,
Tulsa,U.S. Senate,Connie Johnson,DEM,720121,0,0,70,70,
Tulsa,Governor,Dax Ewbank,REP,720121,0,0,16,16,
Tulsa,Governor,Chad Moody,REP,720121,0,0,49,49,
Tulsa,Governor,Mary Fallin,REP,720121,0,0,179,179,
Tulsa,Superintendent of Public Instruction,Brian Kelly,REP,720121,0,0,26,26,
Tulsa,Superintendent of Public Instruction,Janet Costello Barresi,REP,720121,0,0,47,47,
Tulsa,Superintendent of Public Instruction,Joy Hofmeister,REP,720121,0,0,176,176,
Tulsa,Insurance Commissioner,Bill Viner,REP,720121,0,0,28,28,
Tulsa,Insurance Commissioner,John Doak,REP,720121,0,0,200,200,
Tulsa,Corporation Commissioner,Todd Hiett,REP,720121,0,0,133,133,
Tulsa,Corporation Commissioner,Cliff Branan,REP,720121,0,0,89,89,
Tulsa,U.S. Senate,Evelyn Rogers,REP,720121,0,0,8,8,
Tulsa,U.S. Senate,Rob Moye,REP,720121,0,0,2,2,
Tulsa,U.S. Senate,D. Jean Mcbride-Samuels,REP,720121,0,0,6,6,
Tulsa,U.S. Senate,Jim Inhofe,REP,720121,0,0,218,218,
Tulsa,U.S. Senate,Erick Paul Wyatt,REP,720121,0,0,14,14,
Tulsa,U.S. Senate,Andy Craig,REP,720121,0,0,2,2,
Tulsa,U.S. Senate,T. Shannon,REP,720121,0,0,86,86,
Tulsa,U.S. Senate,Randy Brogdon,REP,720121,0,0,25,25,
Tulsa,U.S. Senate,Eric Mccray,REP,720121,0,0,0,0,
Tulsa,U.S. Senate,Kevin Crow,REP,720121,0,0,0,0,
Tulsa,U.S. Senate,James Lankford,REP,720121,0,0,140,140,
Tulsa,U.S. Senate,Jason Weger,REP,720121,0,0,0,0,
Tulsa,Superintendent of Public Instruction,John Cox,DEM,720122,0,0,13,13,
Tulsa,Superintendent of Public Instruction,Jack Jr.,DEM,720122,0,0,1,1,
Tulsa,Superintendent of Public Instruction,Ivan Holmes,DEM,720122,0,0,2,2,
Tulsa,Superintendent of Public Instruction,Freda Deskin,DEM,720122,0,0,16,16,
Tulsa,U.S. Senate,Patrick Michael Hayes,DEM,720122,0,0,2,2,
Tulsa,U.S. Senate,Jim Rogers,DEM,720122,0,0,8,8,
Tulsa,U.S. Senate,Connie Johnson,DEM,720122,0,0,18,18,
Tulsa,Governor,Dax Ewbank,REP,720122,0,0,14,14,
Tulsa,Governor,Chad Moody,REP,720122,0,0,15,15,
Tulsa,Governor,Mary Fallin,REP,720122,0,0,97,97,
Tulsa,Superintendent of Public Instruction,Brian Kelly,REP,720122,0,0,11,11,
Tulsa,Superintendent of Public Instruction,Janet Costello Barresi,REP,720122,0,0,22,22,
Tulsa,Superintendent of Public Instruction,Joy Hofmeister,REP,720122,0,0,91,91,
Tulsa,Insurance Commissioner,Bill Viner,REP,720122,0,0,16,16,
Tulsa,Insurance Commissioner,John Doak,REP,720122,0,0,94,94,
Tulsa,Corporation Commissioner,Todd Hiett,REP,720122,0,0,61,61,
Tulsa,Corporation Commissioner,Cliff Branan,REP,720122,0,0,48,48,
Tulsa,U.S. Senate,Evelyn Rogers,REP,720122,0,0,9,9,
Tulsa,U.S. Senate,Rob Moye,REP,720122,0,0,1,1,
Tulsa,U.S. Senate,D. Jean Mcbride-Samuels,REP,720122,0,0,3,3,
Tulsa,U.S. Senate,Jim Inhofe,REP,720122,0,0,107,107,
Tulsa,U.S. Senate,Erick Paul Wyatt,REP,720122,0,0,4,4,
Tulsa,U.S. Senate,Andy Craig,REP,720122,0,0,0,0,
Tulsa,U.S. Senate,T. Shannon,REP,720122,0,0,35,35,
Tulsa,U.S. Senate,Randy Brogdon,REP,720122,0,0,10,10,
Tulsa,U.S. Senate,Eric Mccray,REP,720122,0,0,0,0,
Tulsa,U.S. Senate,Kevin Crow,REP,720122,0,0,0,0,
Tulsa,U.S. Senate,James Lankford,REP,720122,0,0,81,81,
Tulsa,U.S. Senate,Jason Weger,REP,720122,0,0,1,1,
Tulsa,Superintendent of Public Instruction,John Cox,DEM,720123,0,0,23,23,
Tulsa,Superintendent of Public Instruction,Jack Jr.,DEM,720123,0,0,12,12,
Tulsa,Superintendent of Public Instruction,Ivan Holmes,DEM,720123,0,0,2,2,
Tulsa,Superintendent of Public Instruction,Freda Deskin,DEM,720123,0,0,41,41,
Tulsa,U.S. Senate,Patrick Michael Hayes,DEM,720123,0,0,15,15,
Tulsa,U.S. Senate,Jim Rogers,DEM,720123,0,0,12,12,
Tulsa,U.S. Senate,Connie Johnson,DEM,720123,0,0,48,48,
Tulsa,Governor,Dax Ewbank,REP,720123,0,0,16,16,
Tulsa,Governor,Chad Moody,REP,720123,0,0,41,41,
Tulsa,Governor,Mary Fallin,REP,720123,0,0,292,292,
Tulsa,Superintendent of Public Instruction,Brian Kelly,REP,720123,0,0,25,25,
Tulsa,Superintendent of Public Instruction,Janet Costello Barresi,REP,720123,0,0,83,83,
Tulsa,Superintendent of Public Instruction,Joy Hofmeister,REP,720123,0,0,238,238,
Tulsa,Insurance Commissioner,Bill Viner,REP,720123,0,0,64,64,
Tulsa,Insurance Commissioner,John Doak,REP,720123,0,0,249,249,
Tulsa,Corporation Commissioner,Todd Hiett,REP,720123,0,0,189,189,
Tulsa,Corporation Commissioner,Cliff Branan,REP,720123,0,0,129,129,
Tulsa,U.S. Senate,Evelyn Rogers,REP,720123,0,0,17,17,
Tulsa,U.S. Senate,Rob Moye,REP,720123,0,0,7,7,
Tulsa,U.S. Senate,D. Jean Mcbride-Samuels,REP,720123,0,0,9,9,
Tulsa,U.S. Senate,Jim Inhofe,REP,720123,0,0,306,306,
Tulsa,U.S. Senate,Erick Paul Wyatt,REP,720123,0,0,8,8,
Tulsa,U.S. Senate,Andy Craig,REP,720123,0,0,0,0,
Tulsa,U.S. Senate,T. Shannon,REP,720123,0,0,117,117,
Tulsa,U.S. Senate,Randy Brogdon,REP,720123,0,0,18,18,
Tulsa,U.S. Senate,Eric Mccray,REP,720123,0,0,1,1,
Tulsa,U.S. Senate,Kevin Crow,REP,720123,0,0,1,1,
Tulsa,U.S. Senate,James Lankford,REP,720123,0,0,215,215,
Tulsa,U.S. Senate,Jason Weger,REP,720123,0,0,0,0,
Tulsa,Superintendent of Public Instruction,John Cox,DEM,720124,0,0,24,24,
Tulsa,Superintendent of Public Instruction,Jack Jr.,DEM,720124,0,0,4,4,
Tulsa,Superintendent of Public Instruction,Ivan Holmes,DEM,720124,0,0,1,1,
Tulsa,Superintendent of Public Instruction,Freda Deskin,DEM,720124,0,0,42,42,
Tulsa,U.S. Senate,Patrick Michael Hayes,DEM,720124,0,0,9,9,
Tulsa,U.S. Senate,Jim Rogers,DEM,720124,0,0,13,13,
Tulsa,U.S. Senate,Connie Johnson,DEM,720124,0,0,45,45,
Tulsa,Governor,Dax Ewbank,REP,720124,0,0,21,21,
Tulsa,Governor,Chad Moody,REP,720124,0,0,42,42,
Tulsa,Governor,Mary Fallin,REP,720124,0,0,254,254,
Tulsa,Superintendent of Public Instruction,Brian Kelly,REP,720124,0,0,32,32,
Tulsa,Superintendent of Public Instruction,Janet Costello Barresi,REP,720124,0,0,73,73,
Tulsa,Superintendent of Public Instruction,Joy Hofmeister,REP,720124,0,0,213,213,
Tulsa,Insurance Commissioner,Bill Viner,REP,720124,0,0,69,69,
Tulsa,Insurance Commissioner,John Doak,REP,720124,0,0,222,222,
Tulsa,Corporation Commissioner,Todd Hiett,REP,720124,0,0,169,169,
Tulsa,Corporation Commissioner,Cliff Branan,REP,720124,0,0,125,125,
Tulsa,U.S. Senate,Evelyn Rogers,REP,720124,0,0,11,11,
Tulsa,U.S. Senate,Rob Moye,REP,720124,0,0,6,6,
Tulsa,U.S. Senate,D. Jean Mcbride-Samuels,REP,720124,0,0,6,6,
Tulsa,U.S. Senate,Jim Inhofe,REP,720124,0,0,287,287,
Tulsa,U.S. Senate,Erick Paul Wyatt,REP,720124,0,0,7,7,
Tulsa,U.S. Senate,Andy Craig,REP,720124,0,0,3,3,
Tulsa,U.S. Senate,T. Shannon,REP,720124,0,0,90,90,
Tulsa,U.S. Senate,Randy Brogdon,REP,720124,0,0,22,22,
Tulsa,U.S. Senate,Eric Mccray,REP,720124,0,0,3,3,
Tulsa,U.S. Senate,Kevin Crow,REP,720124,0,0,1,1,
Tulsa,U.S. Senate,James Lankford,REP,720124,0,0,197,197,
Tulsa,U.S. Senate,Jason Weger,REP,720124,0,0,2,2,
Tulsa,Superintendent of Public Instruction,John Cox,DEM,720125,0,0,25,25,
Tulsa,Superintendent of Public Instruction,Jack Jr.,DEM,720125,0,0,6,6,
Tulsa,Superintendent of Public Instruction,Ivan Holmes,DEM,720125,0,0,2,2,
Tulsa,Superintendent of Public Instruction,Freda Deskin,DEM,720125,0,0,35,35,
Tulsa,U.S. Senate,Patrick Michael Hayes,DEM,720125,0,0,9,9,
Tulsa,U.S. Senate,Jim Rogers,DEM,720125,0,0,12,12,
Tulsa,U.S. Senate,Connie Johnson,DEM,720125,0,0,41,41,
Tulsa,Governor,Dax Ewbank,REP,720125,0,0,18,18,
Tulsa,Governor,Chad Moody,REP,720125,0,0,38,38,
Tulsa,Governor,Mary Fallin,REP,720125,0,0,236,236,
Tulsa,Superintendent of Public Instruction,Brian Kelly,REP,720125,0,0,33,33,
Tulsa,Superintendent of Public Instruction,Janet Costello Barresi,REP,720125,0,0,51,51,
Tulsa,Superintendent of Public Instruction,Joy Hofmeister,REP,720125,0,0,209,209,
Tulsa,Insurance Commissioner,Bill Viner,REP,720125,0,0,44,44,
Tulsa,Insurance Commissioner,John Doak,REP,720125,0,0,225,225,
Tulsa,Corporation Commissioner,Todd Hiett,REP,720125,0,0,159,159,
Tulsa,Corporation Commissioner,Cliff Branan,REP,720125,0,0,113,113,
Tulsa,U.S. Senate,Evelyn Rogers,REP,720125,0,0,14,14,
Tulsa,U.S. Senate,Rob Moye,REP,720125,0,0,2,2,
Tulsa,U.S. Senate,D. Jean Mcbride-Samuels,REP,720125,0,0,6,6,
Tulsa,U.S. Senate,Jim Inhofe,REP,720125,0,0,267,267,
Tulsa,U.S. Senate,Erick Paul Wyatt,REP,720125,0,0,7,7,
Tulsa,U.S. Senate,Andy Craig,REP,720125,0,0,3,3,
Tulsa,U.S. Senate,T. Shannon,REP,720125,0,0,85,85,
Tulsa,U.S. Senate,Randy Brogdon,REP,720125,0,0,25,25,
Tulsa,U.S. Senate,Eric Mccray,REP,720125,0,0,2,2,
Tulsa,U.S. Senate,Kevin Crow,REP,720125,0,0,1,1,
Tulsa,U.S. Senate,James Lankford,REP,720125,0,0,180,180,
Tulsa,U.S. Senate,Jason Weger,REP,720125,0,0,1,1,
Tulsa,State House,Weldon Watson,REP,720125,0,0,195,195,79
Tulsa,State House,Lois Jacobs,REP,720125,0,0,77,77,79
Tulsa,Superintendent of Public Instruction,John Cox,DEM,720126,0,0,22,22,
Tulsa,Superintendent of Public Instruction,Jack Jr.,DEM,720126,0,0,5,5,
Tulsa,Superintendent of Public Instruction,Ivan Holmes,DEM,720126,0,0,1,1,
Tulsa,Superintendent of Public Instruction,Freda Deskin,DEM,720126,0,0,36,36,
Tulsa,U.S. Senate,Patrick Michael Hayes,DEM,720126,0,0,6,6,
Tulsa,U.S. Senate,Jim Rogers,DEM,720126,0,0,16,16,
Tulsa,U.S. Senate,Connie Johnson,DEM,720126,0,0,42,42,
Tulsa,Governor,Dax Ewbank,REP,720126,0,0,11,11,
Tulsa,Governor,Chad Moody,REP,720126,0,0,26,26,
Tulsa,Governor,Mary Fallin,REP,720126,0,0,247,247,
Tulsa,Superintendent of Public Instruction,Brian Kelly,REP,720126,0,0,30,30,
Tulsa,Superintendent of Public Instruction,Janet Costello Barresi,REP,720126,0,0,47,47,
Tulsa,Superintendent of Public Instruction,Joy Hofmeister,REP,720126,0,0,212,212,
Tulsa,Insurance Commissioner,Bill Viner,REP,720126,0,0,58,58,
Tulsa,Insurance Commissioner,John Doak,REP,720126,0,0,187,187,
Tulsa,Corporation Commissioner,Todd Hiett,REP,720126,0,0,162,162,
Tulsa,Corporation Commissioner,Cliff Branan,REP,720126,0,0,92,92,
Tulsa,U.S. Senate,Evelyn Rogers,REP,720126,0,0,9,9,
Tulsa,U.S. Senate,Rob Moye,REP,720126,0,0,4,4,
Tulsa,U.S. Senate,D. Jean Mcbride-Samuels,REP,720126,0,0,4,4,
Tulsa,U.S. Senate,Jim Inhofe,REP,720126,0,0,267,267,
Tulsa,U.S. Senate,Erick Paul Wyatt,REP,720126,0,0,5,5,
Tulsa,U.S. Senate,Andy Craig,REP,720126,0,0,0,0,
Tulsa,U.S. Senate,T. Shannon,REP,720126,0,0,70,70,
Tulsa,U.S. Senate,Randy Brogdon,REP,720126,0,0,17,17,
Tulsa,U.S. Senate,Eric Mccray,REP,720126,0,0,0,0,
Tulsa,U.S. Senate,Kevin Crow,REP,720126,0,0,0,0,
Tulsa,U.S. Senate,James Lankford,REP,720126,0,0,206,206,
Tulsa,U.S. Senate,Jason Weger,REP,720126,0,0,0,0,
Tulsa,State House,Weldon Watson,REP,720126,0,0,203,203,79
Tulsa,State House,Lois Jacobs,REP,720126,0,0,52,52,79
Tulsa,Superintendent of Public Instruction,John Cox,DEM,720127,0,0,11,11,
Tulsa,Superintendent of Public Instruction,Jack Jr.,DEM,720127,0,0,2,2,
Tulsa,Superintendent of Public Instruction,Ivan Holmes,DEM,720127,0,0,2,2,
Tulsa,Superintendent of Public Instruction,Freda Deskin,DEM,720127,0,0,19,19,
Tulsa,U.S. Senate,Patrick Michael Hayes,DEM,720127,0,0,10,10,
Tulsa,U.S. Senate,Jim Rogers,DEM,720127,0,0,5,5,
Tulsa,U.S. Senate,Connie Johnson,DEM,720127,0,0,19,19,
Tulsa,Governor,Dax Ewbank,REP,720127,0,0,9,9,
Tulsa,Governor,Chad Moody,REP,720127,0,0,19,19,
Tulsa,Governor,Mary Fallin,REP,720127,0,0,124,124,
Tulsa,Superintendent of Public Instruction,Brian Kelly,REP,720127,0,0,22,22,
Tulsa,Superintendent of Public Instruction,Janet Costello Barresi,REP,720127,0,0,19,19,
Tulsa,Superintendent of Public Instruction,Joy Hofmeister,REP,720127,0,0,114,114,
Tulsa,Insurance Commissioner,Bill Viner,REP,720127,0,0,26,26,
Tulsa,Insurance Commissioner,John Doak,REP,720127,0,0,112,112,
Tulsa,Corporation Commissioner,Todd Hiett,REP,720127,0,0,82,82,
Tulsa,Corporation Commissioner,Cliff Branan,REP,720127,0,0,54,54,
Tulsa,U.S. Senate,Evelyn Rogers,REP,720127,0,0,2,2,
Tulsa,U.S. Senate,Rob Moye,REP,720127,0,0,2,2,
Tulsa,U.S. Senate,D. Jean Mcbride-Samuels,REP,720127,0,0,4,4,
Tulsa,U.S. Senate,Jim Inhofe,REP,720127,0,0,139,139,
Tulsa,U.S. Senate,Erick Paul Wyatt,REP,720127,0,0,4,4,
Tulsa,U.S. Senate,Andy Craig,REP,720127,0,0,1,1,
Tulsa,U.S. Senate,T. Shannon,REP,720127,0,0,57,57,
Tulsa,U.S. Senate,Randy Brogdon,REP,720127,0,0,8,8,
Tulsa,U.S. Senate,Eric Mccray,REP,720127,0,0,2,2,
Tulsa,U.S. Senate,Kevin Crow,REP,720127,0,0,0,0,
Tulsa,U.S. Senate,James Lankford,REP,720127,0,0,83,83,
Tulsa,U.S. Senate,Jason Weger,REP,720127,0,0,2,2,
Tulsa,State House,Weldon Watson,REP,720127,0,0,87,87,79
Tulsa,State House,Lois Jacobs,REP,720127,0,0,43,43,79
Tulsa,Superintendent of Public Instruction,John Cox,DEM,720128,0,0,11,11,
Tulsa,Superintendent of Public Instruction,Jack Jr.,DEM,720128,0,0,3,3,
Tulsa,Superintendent of Public Instruction,Ivan Holmes,DEM,720128,0,0,3,3,
Tulsa,Superintendent of Public Instruction,Freda Deskin,DEM,720128,0,0,39,39,
Tulsa,U.S. Senate,Patrick Michael Hayes,DEM,720128,0,0,5,5,
Tulsa,U.S. Senate,Jim Rogers,DEM,720128,0,0,13,13,
Tulsa,U.S. Senate,Connie Johnson,DEM,720128,0,0,39,39,
Tulsa,Governor,Dax Ewbank,REP,720128,0,0,13,13,
Tulsa,Governor,Chad Moody,REP,720128,0,0,33,33,
Tulsa,Governor,Mary Fallin,REP,720128,0,0,197,197,
Tulsa,Superintendent of Public Instruction,Brian Kelly,REP,720128,0,0,33,33,
Tulsa,Superintendent of Public Instruction,Janet Costello Barresi,REP,720128,0,0,47,47,
Tulsa,Superintendent of Public Instruction,Joy Hofmeister,REP,720128,0,0,162,162,
Tulsa,Insurance Commissioner,Bill Viner,REP,720128,0,0,46,46,
Tulsa,Insurance Commissioner,John Doak,REP,720128,0,0,172,172,
Tulsa,Corporation Commissioner,Todd Hiett,REP,720128,0,0,129,129,
Tulsa,Corporation Commissioner,Cliff Branan,REP,720128,0,0,97,97,
Tulsa,U.S. Senate,Evelyn Rogers,REP,720128,0,0,9,9,
Tulsa,U.S. Senate,Rob Moye,REP,720128,0,0,2,2,
Tulsa,U.S. Senate,D. Jean Mcbride-Samuels,REP,720128,0,0,2,2,
Tulsa,U.S. Senate,Jim Inhofe,REP,720128,0,0,222,222,
Tulsa,U.S. Senate,Erick Paul Wyatt,REP,720128,0,0,9,9,
Tulsa,U.S. Senate,Andy Craig,REP,720128,0,0,0,0,
Tulsa,U.S. Senate,T. Shannon,REP,720128,0,0,94,94,
Tulsa,U.S. Senate,Randy Brogdon,REP,720128,0,0,20,20,
Tulsa,U.S. Senate,Eric Mccray,REP,720128,0,0,2,2,
Tulsa,U.S. Senate,Kevin Crow,REP,720128,0,0,1,1,
Tulsa,U.S. Senate,James Lankford,REP,720128,0,0,127,127,
Tulsa,U.S. Senate,Jason Weger,REP,720128,0,0,0,0,
Tulsa,State House,Weldon Watson,REP,720128,0,0,159,159,79
Tulsa,State House,Lois Jacobs,REP,720128,0,0,70,70,79
Tulsa,Superintendent of Public Instruction,John Cox,DEM,720129,0,0,40,40,
Tulsa,Superintendent of Public Instruction,Jack Jr.,DEM,720129,0,0,7,7,
Tulsa,Superintendent of Public Instruction,Ivan Holmes,DEM,720129,0,0,2,2,
Tulsa,Superintendent of Public Instruction,Freda Deskin,DEM,720129,0,0,33,33,
Tulsa,U.S. Senate,Patrick Michael Hayes,DEM,720129,0,0,14,14,
Tulsa,U.S. Senate,Jim Rogers,DEM,720129,0,0,15,15,
Tulsa,U.S. Senate,Connie Johnson,DEM,720129,0,0,48,48,
Tulsa,Governor,Dax Ewbank,REP,720129,0,0,16,16,
Tulsa,Governor,Chad Moody,REP,720129,0,0,42,42,
Tulsa,Governor,Mary Fallin,REP,720129,0,0,212,212,
Tulsa,Superintendent of Public Instruction,Brian Kelly,REP,720129,0,0,27,27,
Tulsa,Superintendent of Public Instruction,Janet Costello Barresi,REP,720129,0,0,53,53,
Tulsa,Superintendent of Public Instruction,Joy Hofmeister,REP,720129,0,0,192,192,
Tulsa,Insurance Commissioner,Bill Viner,REP,720129,0,0,39,39,
Tulsa,Insurance Commissioner,John Doak,REP,720129,0,0,203,203,
Tulsa,Corporation Commissioner,Todd Hiett,REP,720129,0,0,142,142,
Tulsa,Corporation Commissioner,Cliff Branan,REP,720129,0,0,104,104,
Tulsa,U.S. Senate,Evelyn Rogers,REP,720129,0,0,10,10,
Tulsa,U.S. Senate,Rob Moye,REP,720129,0,0,4,4,
Tulsa,U.S. Senate,D. Jean Mcbride-Samuels,REP,720129,0,0,6,6,
Tulsa,U.S. Senate,Jim Inhofe,REP,720129,0,0,243,243,
Tulsa,U.S. Senate,Erick Paul Wyatt,REP,720129,0,0,9,9,
Tulsa,U.S. Senate,Andy Craig,REP,720129,0,0,0,0,
Tulsa,U.S. Senate,T. Shannon,REP,720129,0,0,79,79,
Tulsa,U.S. Senate,Randy Brogdon,REP,720129,0,0,21,21,
Tulsa,U.S. Senate,Eric Mccray,REP,720129,0,0,2,2,
Tulsa,U.S. Senate,Kevin Crow,REP,720129,0,0,1,1,
Tulsa,U.S. Senate,James Lankford,REP,720129,0,0,169,169,
Tulsa,U.S. Senate,Jason Weger,REP,720129,0,0,1,1,
Tulsa,State House,Weldon Watson,REP,720129,0,0,201,201,79
Tulsa,State House,Lois Jacobs,REP,720129,0,0,52,52,79
Tulsa,Superintendent of Public Instruction,John Cox,DEM,720130,0,0,39,39,
Tulsa,Superintendent of Public Instruction,Jack Jr.,DEM,720130,0,0,10,10,
Tulsa,Superintendent of Public Instruction,Ivan Holmes,DEM,720130,0,0,5,5,
Tulsa,Superintendent of Public Instruction,Freda Deskin,DEM,720130,0,0,38,38,
Tulsa,U.S. Senate,Patrick Michael Hayes,DEM,720130,0,0,17,17,
Tulsa,U.S. Senate,Jim Rogers,DEM,720130,0,0,23,23,
Tulsa,U.S. Senate,Connie Johnson,DEM,720130,0,0,52,52,
Tulsa,Governor,Dax Ewbank,REP,720130,0,0,19,19,
Tulsa,Governor,Chad Moody,REP,720130,0,0,35,35,
Tulsa,Governor,Mary Fallin,REP,720130,0,0,202,202,
Tulsa,Superintendent of Public Instruction,Brian Kelly,REP,720130,0,0,41,41,
Tulsa,Superintendent of Public Instruction,Janet Costello Barresi,REP,720130,0,0,44,44,
Tulsa,Superintendent of Public Instruction,Joy Hofmeister,REP,720130,0,0,172,172,
Tulsa,Insurance Commissioner,Bill Viner,REP,720130,0,0,52,52,
Tulsa,Insurance Commissioner,John Doak,REP,720130,0,0,185,185,
Tulsa,Corporation Commissioner,Todd Hiett,REP,720130,0,0,135,135,
Tulsa,Corporation Commissioner,Cliff Branan,REP,720130,0,0,104,104,
Tulsa,U.S. Senate,Evelyn Rogers,REP,720130,0,0,11,11,
Tulsa,U.S. Senate,Rob Moye,REP,720130,0,0,6,6,
Tulsa,U.S. Senate,D. Jean Mcbride-Samuels,REP,720130,0,0,7,7,
Tulsa,U.S. Senate,Jim Inhofe,REP,720130,0,0,223,223,
Tulsa,U.S. Senate,Erick Paul Wyatt,REP,720130,0,0,12,12,
Tulsa,U.S. Senate,Andy Craig,REP,720130,0,0,1,1,
Tulsa,U.S. Senate,T. Shannon,REP,720130,0,0,88,88,
Tulsa,U.S. Senate,Randy Brogdon,REP,720130,0,0,23,23,
Tulsa,U.S. Senate,Eric Mccray,REP,720130,0,0,2,2,
Tulsa,U.S. Senate,Kevin Crow,REP,720130,0,0,1,1,
Tulsa,U.S. Senate,James Lankford,REP,720130,0,0,142,142,
Tulsa,U.S. Senate,Jason Weger,REP,720130,0,0,1,1,
Tulsa,State House,Weldon Watson,REP,720130,0,0,192,192,79
Tulsa,State House,Lois Jacobs,REP,720130,0,0,50,50,79
Tulsa,Superintendent of Public Instruction,John Cox,DEM,720131,0,0,1,1,
Tulsa,Superintendent of Public Instruction,Jack Jr.,DEM,720131,0,0,1,1,
Tulsa,Superintendent of Public Instruction,Ivan Holmes,DEM,720131,0,0,0,0,
Tulsa,Superintendent of Public Instruction,Freda Deskin,DEM,720131,0,0,9,9,
Tulsa,U.S. Senate,Patrick Michael Hayes,DEM,720131,0,0,0,0,
Tulsa,U.S. Senate,Jim Rogers,DEM,720131,0,0,2,2,
Tulsa,U.S. Senate,Connie Johnson,DEM,720131,0,0,9,9,
Tulsa,Governor,Dax Ewbank,REP,720131,0,0,1,1,
Tulsa,Governor,Chad Moody,REP,720131,0,0,1,1,
Tulsa,Governor,Mary Fallin,REP,720131,0,0,13,13,
Tulsa,Superintendent of Public Instruction,Brian Kelly,REP,720131,0,0,1,1,
Tulsa,Superintendent of Public Instruction,Janet Costello Barresi,REP,720131,0,0,3,3,
Tulsa,Superintendent of Public Instruction,Joy Hofmeister,REP,720131,0,0,11,11,
Tulsa,Insurance Commissioner,Bill Viner,REP,720131,0,0,4,4,
Tulsa,Insurance Commissioner,John Doak,REP,720131,0,0,11,11,
Tulsa,Corporation Commissioner,Todd Hiett,REP,720131,0,0,8,8,
Tulsa,Corporation Commissioner,Cliff Branan,REP,720131,0,0,6,6,
Tulsa,U.S. Senate,Evelyn Rogers,REP,720131,0,0,0,0,
Tulsa,U.S. Senate,Rob Moye,REP,720131,0,0,1,1,
Tulsa,U.S. Senate,D. Jean Mcbride-Samuels,REP,720131,0,0,1,1,
Tulsa,U.S. Senate,Jim Inhofe,REP,720131,0,0,12,12,
Tulsa,U.S. Senate,Erick Paul Wyatt,REP,720131,0,0,1,1,
Tulsa,U.S. Senate,Andy Craig,REP,720131,0,0,1,1,
Tulsa,U.S. Senate,T. Shannon,REP,720131,0,0,6,6,
Tulsa,U.S. Senate,Randy Brogdon,REP,720131,0,0,0,0,
Tulsa,U.S. Senate,Eric Mccray,REP,720131,0,0,1,1,
Tulsa,U.S. Senate,Kevin Crow,REP,720131,0,0,1,1,
Tulsa,U.S. Senate,James Lankford,REP,720131,0,0,6,6,
Tulsa,U.S. Senate,Jason Weger,REP,720131,0,0,0,0,
Tulsa,State House,Weldon Watson,REP,720131,0,0,10,10,79
Tulsa,State House,Lois Jacobs,REP,720131,0,0,5,5,79
Tulsa,Superintendent of Public Instruction,John Cox,DEM,720132,0,0,31,31,
Tulsa,Superintendent of Public Instruction,Jack Jr.,DEM,720132,0,0,5,5,
Tulsa,Superintendent of Public Instruction,Ivan Holmes,DEM,720132,0,0,3,3,
Tulsa,Superintendent of Public Instruction,Freda Deskin,DEM,720132,0,0,40,40,
Tulsa,U.S. Senate,Patrick Michael Hayes,DEM,720132,0,0,17,17,
Tulsa,U.S. Senate,Jim Rogers,DEM,720132,0,0,20,20,
Tulsa,U.S. Senate,Connie Johnson,DEM,720132,0,0,38,38,
Tulsa,Governor,Dax Ewbank,REP,720132,0,0,19,19,
Tulsa,Governor,Chad Moody,REP,720132,0,0,37,37,
Tulsa,Governor,Mary Fallin,REP,720132,0,0,217,217,
Tulsa,Superintendent of Public Instruction,Brian Kelly,REP,720132,0,0,24,24,
Tulsa,Superintendent of Public Instruction,Janet Costello Barresi,REP,720132,0,0,54,54,
Tulsa,Superintendent of Public Instruction,Joy Hofmeister,REP,720132,0,0,193,193,
Tulsa,Insurance Commissioner,Bill Viner,REP,720132,0,0,51,51,
Tulsa,Insurance Commissioner,John Doak,REP,720132,0,0,191,191,
Tulsa,Corporation Commissioner,Todd Hiett,REP,720132,0,0,163,163,
Tulsa,Corporation Commissioner,Cliff Branan,REP,720132,0,0,82,82,
Tulsa,U.S. Senate,Evelyn Rogers,REP,720132,0,0,7,7,
Tulsa,U.S. Senate,Rob Moye,REP,720132,0,0,5,5,
Tulsa,U.S. Senate,D. Jean Mcbride-Samuels,REP,720132,0,0,7,7,
Tulsa,U.S. Senate,Jim Inhofe,REP,720132,0,0,243,243,
Tulsa,U.S. Senate,Erick Paul Wyatt,REP,720132,0,0,11,11,
Tulsa,U.S. Senate,Andy Craig,REP,720132,0,0,1,1,
Tulsa,U.S. Senate,T. Shannon,REP,720132,0,0,85,85,
Tulsa,U.S. Senate,Randy Brogdon,REP,720132,0,0,24,24,
Tulsa,U.S. Senate,Eric Mccray,REP,720132,0,0,0,0,
Tulsa,U.S. Senate,Kevin Crow,REP,720132,0,0,0,0,
Tulsa,U.S. Senate,James Lankford,REP,720132,0,0,166,166,
Tulsa,U.S. Senate,Jason Weger,REP,720132,0,0,0,0,
Tulsa,State House,Weldon Watson,REP,720132,0,0,182,182,79
Tulsa,State House,Lois Jacobs,REP,720132,0,0,70,70,79
Tulsa,Superintendent of Public Instruction,John Cox,DEM,720133,0,0,26,26,
Tulsa,Superintendent of Public Instruction,Jack Jr.,DEM,720133,0,0,8,8,
Tulsa,Superintendent of Public Instruction,Ivan Holmes,DEM,720133,0,0,2,2,
Tulsa,Superintendent of Public Instruction,Freda Deskin,DEM,720133,0,0,28,28,
Tulsa,U.S. Senate,Patrick Michael Hayes,DEM,720133,0,0,10,10,
Tulsa,U.S. Senate,Jim Rogers,DEM,720133,0,0,17,17,
Tulsa,U.S. Senate,Connie Johnson,DEM,720133,0,0,38,38,
Tulsa,Governor,Dax Ewbank,REP,720133,0,0,15,15,
Tulsa,Governor,Chad Moody,REP,720133,0,0,39,39,
Tulsa,Governor,Mary Fallin,REP,720133,0,0,212,212,
Tulsa,Superintendent of Public Instruction,Brian Kelly,REP,720133,0,0,38,38,
Tulsa,Superintendent of Public Instruction,Janet Costello Barresi,REP,720133,0,0,33,33,
Tulsa,Superintendent of Public Instruction,Joy Hofmeister,REP,720133,0,0,199,199,
Tulsa,Insurance Commissioner,Bill Viner,REP,720133,0,0,62,62,
Tulsa,Insurance Commissioner,John Doak,REP,720133,0,0,185,185,
Tulsa,Corporation Commissioner,Todd Hiett,REP,720133,0,0,113,113,
Tulsa,Corporation Commissioner,Cliff Branan,REP,720133,0,0,133,133,
Tulsa,U.S. Senate,Evelyn Rogers,REP,720133,0,0,12,12,
Tulsa,U.S. Senate,Rob Moye,REP,720133,0,0,3,3,
Tulsa,U.S. Senate,D. Jean Mcbride-Samuels,REP,720133,0,0,12,12,
Tulsa,U.S. Senate,Jim Inhofe,REP,720133,0,0,229,229,
Tulsa,U.S. Senate,Erick Paul Wyatt,REP,720133,0,0,10,10,
Tulsa,U.S. Senate,Andy Craig,REP,720133,0,0,4,4,
Tulsa,U.S. Senate,T. Shannon,REP,720133,0,0,109,109,
Tulsa,U.S. Senate,Randy Brogdon,REP,720133,0,0,12,12,
Tulsa,U.S. Senate,Eric Mccray,REP,720133,0,0,4,4,
Tulsa,U.S. Senate,Kevin Crow,REP,720133,0,0,4,4,
Tulsa,U.S. Senate,James Lankford,REP,720133,0,0,136,136,
Tulsa,U.S. Senate,Jason Weger,REP,720133,0,0,1,1,
Tulsa,State House,Weldon Watson,REP,720133,0,0,206,206,79
Tulsa,State House,Lois Jacobs,REP,720133,0,0,51,51,79
Tulsa,Superintendent of Public Instruction,John Cox,DEM,720134,0,0,19,19,
Tulsa,Superintendent of Public Instruction,Jack Jr.,DEM,720134,0,0,5,5,
Tulsa,Superintendent of Public Instruction,Ivan Holmes,DEM,720134,0,0,3,3,
Tulsa,Superintendent of Public Instruction,Freda Deskin,DEM,720134,0,0,41,41,
Tulsa,U.S. Senate,Patrick Michael Hayes,DEM,720134,0,0,10,10,
Tulsa,U.S. Senate,Jim Rogers,DEM,720134,0,0,15,15,
Tulsa,U.S. Senate,Connie Johnson,DEM,720134,0,0,41,41,
Tulsa,Governor,Dax Ewbank,REP,720134,0,0,16,16,
Tulsa,Governor,Chad Moody,REP,720134,0,0,43,43,
Tulsa,Governor,Mary Fallin,REP,720134,0,0,199,199,
Tulsa,Superintendent of Public Instruction,Brian Kelly,REP,720134,0,0,31,31,
Tulsa,Superintendent of Public Instruction,Janet Costello Barresi,REP,720134,0,0,59,59,
Tulsa,Superintendent of Public Instruction,Joy Hofmeister,REP,720134,0,0,172,172,
Tulsa,Insurance Commissioner,Bill Viner,REP,720134,0,0,43,43,
Tulsa,Insurance Commissioner,John Doak,REP,720134,0,0,196,196,
Tulsa,Corporation Commissioner,Todd Hiett,REP,720134,0,0,129,129,
Tulsa,Corporation Commissioner,Cliff Branan,REP,720134,0,0,104,104,
Tulsa,U.S. Senate,Evelyn Rogers,REP,720134,0,0,12,12,
Tulsa,U.S. Senate,Rob Moye,REP,720134,0,0,4,4,
Tulsa,U.S. Senate,D. Jean Mcbride-Samuels,REP,720134,0,0,5,5,
Tulsa,U.S. Senate,Jim Inhofe,REP,720134,0,0,230,230,
Tulsa,U.S. Senate,Erick Paul Wyatt,REP,720134,0,0,9,9,
Tulsa,U.S. Senate,Andy Craig,REP,720134,0,0,3,3,
Tulsa,U.S. Senate,T. Shannon,REP,720134,0,0,92,92,
Tulsa,U.S. Senate,Randy Brogdon,REP,720134,0,0,23,23,
Tulsa,U.S. Senate,Eric Mccray,REP,720134,0,0,0,0,
Tulsa,U.S. Senate,Kevin Crow,REP,720134,0,0,1,1,
Tulsa,U.S. Senate,James Lankford,REP,720134,0,0,142,142,
Tulsa,U.S. Senate,Jason Weger,REP,720134,0,0,1,1,
Tulsa,Superintendent of Public Instruction,John Cox,DEM,720135,0,0,33,33,
Tulsa,Superintendent of Public Instruction,Jack Jr.,DEM,720135,0,0,7,7,
Tulsa,Superintendent of Public Instruction,Ivan Holmes,DEM,720135,0,0,2,2,
Tulsa,Superintendent of Public Instruction,Freda Deskin,DEM,720135,0,0,24,24,
Tulsa,U.S. Senate,Patrick Michael Hayes,DEM,720135,0,0,9,9,
Tulsa,U.S. Senate,Jim Rogers,DEM,720135,0,0,20,20,
Tulsa,U.S. Senate,Connie Johnson,DEM,720135,0,0,35,35,
Tulsa,Governor,Dax Ewbank,REP,720135,0,0,28,28,
Tulsa,Governor,Chad Moody,REP,720135,0,0,48,48,
Tulsa,Governor,Mary Fallin,REP,720135,0,0,259,259,
Tulsa,Superintendent of Public Instruction,Brian Kelly,REP,720135,0,0,44,44,
Tulsa,Superintendent of Public Instruction,Janet Costello Barresi,REP,720135,0,0,59,59,
Tulsa,Superintendent of Public Instruction,Joy Hofmeister,REP,720135,0,0,227,227,
Tulsa,Insurance Commissioner,Bill Viner,REP,720135,0,0,55,55,
Tulsa,Insurance Commissioner,John Doak,REP,720135,0,0,250,250,
Tulsa,Corporation Commissioner,Todd Hiett,REP,720135,0,0,188,188,
Tulsa,Corporation Commissioner,Cliff Branan,REP,720135,0,0,113,113,
Tulsa,U.S. Senate,Evelyn Rogers,REP,720135,0,0,12,12,
Tulsa,U.S. Senate,Rob Moye,REP,720135,0,0,2,2,
Tulsa,U.S. Senate,D. Jean Mcbride-Samuels,REP,720135,0,0,2,2,
Tulsa,U.S. Senate,Jim Inhofe,REP,720135,0,0,304,304,
Tulsa,U.S. Senate,Erick Paul Wyatt,REP,720135,0,0,16,16,
Tulsa,U.S. Senate,Andy Craig,REP,720135,0,0,4,4,
Tulsa,U.S. Senate,T. Shannon,REP,720135,0,0,138,138,
Tulsa,U.S. Senate,Randy Brogdon,REP,720135,0,0,37,37,
Tulsa,U.S. Senate,Eric Mccray,REP,720135,0,0,2,2,
Tulsa,U.S. Senate,Kevin Crow,REP,720135,0,0,3,3,
Tulsa,U.S. Senate,James Lankford,REP,720135,0,0,154,154,
Tulsa,U.S. Senate,Jason Weger,REP,720135,0,0,0,0,
Tulsa,Superintendent of Public Instruction,John Cox,DEM,720136,0,0,13,13,
Tulsa,Superintendent of Public Instruction,Jack Jr.,DEM,720136,0,0,2,2,
Tulsa,Superintendent of Public Instruction,Ivan Holmes,DEM,720136,0,0,2,2,
Tulsa,Superintendent of Public Instruction,Freda Deskin,DEM,720136,0,0,16,16,
Tulsa,U.S. Senate,Patrick Michael Hayes,DEM,720136,0,0,3,3,
Tulsa,U.S. Senate,Jim Rogers,DEM,720136,0,0,11,11,
Tulsa,U.S. Senate,Connie Johnson,DEM,720136,0,0,19,19,
Tulsa,Governor,Dax Ewbank,REP,720136,0,0,11,11,
Tulsa,Governor,Chad Moody,REP,720136,0,0,26,26,
Tulsa,Governor,Mary Fallin,REP,720136,0,0,189,189,
Tulsa,Superintendent of Public Instruction,Brian Kelly,REP,720136,0,0,23,23,
Tulsa,Superintendent of Public Instruction,Janet Costello Barresi,REP,720136,0,0,32,32,
Tulsa,Superintendent of Public Instruction,Joy Hofmeister,REP,720136,0,0,172,172,
Tulsa,Insurance Commissioner,Bill Viner,REP,720136,0,0,19,19,
Tulsa,Insurance Commissioner,John Doak,REP,720136,0,0,196,196,
Tulsa,Corporation Commissioner,Todd Hiett,REP,720136,0,0,129,129,
Tulsa,Corporation Commissioner,Cliff Branan,REP,720136,0,0,83,83,
Tulsa,U.S. Senate,Evelyn Rogers,REP,720136,0,0,7,7,
Tulsa,U.S. Senate,Rob Moye,REP,720136,0,0,4,4,
Tulsa,U.S. Senate,D. Jean Mcbride-Samuels,REP,720136,0,0,4,4,
Tulsa,U.S. Senate,Jim Inhofe,REP,720136,0,0,204,204,
Tulsa,U.S. Senate,Erick Paul Wyatt,REP,720136,0,0,6,6,
Tulsa,U.S. Senate,Andy Craig,REP,720136,0,0,0,0,
Tulsa,U.S. Senate,T. Shannon,REP,720136,0,0,89,89,
Tulsa,U.S. Senate,Randy Brogdon,REP,720136,0,0,23,23,
Tulsa,U.S. Senate,Eric Mccray,REP,720136,0,0,2,2,
Tulsa,U.S. Senate,Kevin Crow,REP,720136,0,0,1,1,
Tulsa,U.S. Senate,James Lankford,REP,720136,0,0,111,111,
Tulsa,U.S. Senate,Jason Weger,REP,720136,0,0,1,1,
Tulsa,Superintendent of Public Instruction,John Cox,DEM,720137,0,0,15,15,
Tulsa,Superintendent of Public Instruction,Jack Jr.,DEM,720137,0,0,2,2,
Tulsa,Superintendent of Public Instruction,Ivan Holmes,DEM,720137,0,0,0,0,
Tulsa,Superintendent of Public Instruction,Freda Deskin,DEM,720137,0,0,11,11,
Tulsa,U.S. Senate,Patrick Michael Hayes,DEM,720137,0,0,6,6,
Tulsa,U.S. Senate,Jim Rogers,DEM,720137,0,0,6,6,
Tulsa,U.S. Senate,Connie Johnson,DEM,720137,0,0,17,17,
Tulsa,Governor,Dax Ewbank,REP,720137,0,0,11,11,
Tulsa,Governor,Chad Moody,REP,720137,0,0,12,12,
Tulsa,Governor,Mary Fallin,REP,720137,0,0,71,71,
Tulsa,Superintendent of Public Instruction,Brian Kelly,REP,720137,0,0,10,10,
Tulsa,Superintendent of Public Instruction,Janet Costello Barresi,REP,720137,0,0,18,18,
Tulsa,Superintendent of Public Instruction,Joy Hofmeister,REP,720137,0,0,65,65,
Tulsa,Insurance Commissioner,Bill Viner,REP,720137,0,0,19,19,
Tulsa,Insurance Commissioner,John Doak,REP,720137,0,0,67,67,
Tulsa,Corporation Commissioner,Todd Hiett,REP,720137,0,0,47,47,
Tulsa,Corporation Commissioner,Cliff Branan,REP,720137,0,0,43,43,
Tulsa,U.S. Senate,Evelyn Rogers,REP,720137,0,0,3,3,
Tulsa,U.S. Senate,Rob Moye,REP,720137,0,0,1,1,
Tulsa,U.S. Senate,D. Jean Mcbride-Samuels,REP,720137,0,0,2,2,
Tulsa,U.S. Senate,Jim Inhofe,REP,720137,0,0,86,86,
Tulsa,U.S. Senate,Erick Paul Wyatt,REP,720137,0,0,1,1,
Tulsa,U.S. Senate,Andy Craig,REP,720137,0,0,1,1,
Tulsa,U.S. Senate,T. Shannon,REP,720137,0,0,40,40,
Tulsa,U.S. Senate,Randy Brogdon,REP,720137,0,0,5,5,
Tulsa,U.S. Senate,Eric Mccray,REP,720137,0,0,0,0,
Tulsa,U.S. Senate,Kevin Crow,REP,720137,0,0,1,1,
Tulsa,U.S. Senate,James Lankford,REP,720137,0,0,47,47,
Tulsa,U.S. Senate,Jason Weger,REP,720137,0,0,0,0,
Tulsa,State House,Weldon Watson,REP,720137,0,0,63,63,79
Tulsa,State House,Lois Jacobs,REP,720137,0,0,27,27,79
Tulsa,Superintendent of Public Instruction,John Cox,DEM,720138,0,0,5,5,
Tulsa,Superintendent of Public Instruction,Jack Jr.,DEM,720138,0,0,1,1,
Tulsa,Superintendent of Public Instruction,Ivan Holmes,DEM,720138,0,0,1,1,
Tulsa,Superintendent of Public Instruction,Freda Deskin,DEM,720138,0,0,4,4,
Tulsa,U.S. Senate,Patrick Michael Hayes,DEM,720138,0,0,1,1,
Tulsa,U.S. Senate,Jim Rogers,DEM,720138,0,0,1,1,
Tulsa,U.S. Senate,Connie Johnson,DEM,720138,0,0,9,9,
Tulsa,Governor,Dax Ewbank,REP,720138,0,0,4,4,
Tulsa,Governor,Chad Moody,REP,720138,0,0,4,4,
Tulsa,Governor,Mary Fallin,REP,720138,0,0,14,14,
Tulsa,Superintendent of Public Instruction,Brian Kelly,REP,720138,0,0,3,3,
Tulsa,Superintendent of Public Instruction,Janet Costello Barresi,REP,720138,0,0,7,7,
Tulsa,Superintendent of Public Instruction,Joy Hofmeister,REP,720138,0,0,12,12,
Tulsa,Insurance Commissioner,Bill Viner,REP,720138,0,0,6,6,
Tulsa,Insurance Commissioner,John Doak,REP,720138,0,0,16,16,
Tulsa,Corporation Commissioner,Todd Hiett,REP,720138,0,0,13,13,
Tulsa,Corporation Commissioner,Cliff Branan,REP,720138,0,0,8,8,
Tulsa,U.S. Senate,Evelyn Rogers,REP,720138,0,0,1,1,
Tulsa,U.S. Senate,Rob Moye,REP,720138,0,0,0,0,
Tulsa,U.S. Senate,D. Jean Mcbride-Samuels,REP,720138,0,0,0,0,
Tulsa,U.S. Senate,Jim Inhofe,REP,720138,0,0,17,17,
Tulsa,U.S. Senate,Erick Paul Wyatt,REP,720138,0,0,4,4,
Tulsa,U.S. Senate,Andy Craig,REP,720138,0,0,1,1,
Tulsa,U.S. Senate,T. Shannon,REP,720138,0,0,8,8,
Tulsa,U.S. Senate,Randy Brogdon,REP,720138,0,0,3,3,
Tulsa,U.S. Senate,Eric Mccray,REP,720138,0,0,0,0,
Tulsa,U.S. Senate,Kevin Crow,REP,720138,0,0,1,1,
Tulsa,U.S. Senate,James Lankford,REP,720138,0,0,9,9,
Tulsa,U.S. Senate,Jason Weger,REP,720138,0,0,0,0,
Tulsa,State House,Weldon Watson,REP,720138,0,0,16,16,79
Tulsa,State House,Lois Jacobs,REP,720138,0,0,6,6,79
Tulsa,Superintendent of Public Instruction,John Cox,DEM,720139,0,0,12,12,
Tulsa,Superintendent of Public Instruction,Jack Jr.,DEM,720139,0,0,25,25,
Tulsa,Superintendent of Public Instruction,Ivan Holmes,DEM,720139,0,0,6,6,
Tulsa,Superintendent of Public Instruction,Freda Deskin,DEM,720139,0,0,25,25,
Tulsa,U.S. Senate,Patrick Michael Hayes,DEM,720139,0,0,17,17,
Tulsa,U.S. Senate,Jim Rogers,DEM,720139,0,0,15,15,
Tulsa,U.S. Senate,Connie Johnson,DEM,720139,0,0,36,36,
Tulsa,Governor,Dax Ewbank,REP,720139,0,0,4,4,
Tulsa,Governor,Chad Moody,REP,720139,0,0,3,3,
Tulsa,Governor,Mary Fallin,REP,720139,0,0,27,27,
Tulsa,Superintendent of Public Instruction,Brian Kelly,REP,720139,0,0,9,9,
Tulsa,Superintendent of Public Instruction,Janet Costello Barresi,REP,720139,0,0,8,8,
Tulsa,Superintendent of Public Instruction,Joy Hofmeister,REP,720139,0,0,15,15,
Tulsa,Insurance Commissioner,Bill Viner,REP,720139,0,0,8,8,
Tulsa,Insurance Commissioner,John Doak,REP,720139,0,0,21,21,
Tulsa,Corporation Commissioner,Todd Hiett,REP,720139,0,0,17,17,
Tulsa,Corporation Commissioner,Cliff Branan,REP,720139,0,0,16,16,
Tulsa,U.S. Senate,Evelyn Rogers,REP,720139,0,0,2,2,
Tulsa,U.S. Senate,Rob Moye,REP,720139,0,0,0,0,
Tulsa,U.S. Senate,D. Jean Mcbride-Samuels,REP,720139,0,0,1,1,
Tulsa,U.S. Senate,Jim Inhofe,REP,720139,0,0,26,26,
Tulsa,U.S. Senate,Erick Paul Wyatt,REP,720139,0,0,4,4,
Tulsa,U.S. Senate,Andy Craig,REP,720139,0,0,0,0,
Tulsa,U.S. Senate,T. Shannon,REP,720139,0,0,18,18,
Tulsa,U.S. Senate,Randy Brogdon,REP,720139,0,0,3,3,
Tulsa,U.S. Senate,Eric Mccray,REP,720139,0,0,0,0,
Tulsa,U.S. Senate,Kevin Crow,REP,720139,0,0,1,1,
Tulsa,U.S. Senate,James Lankford,REP,720139,0,0,12,12,
Tulsa,U.S. Senate,Jason Weger,REP,720139,0,0,0,0,
Tulsa,Superintendent of Public Instruction,John Cox,DEM,720140,0,0,11,11,
Tulsa,Superintendent of Public Instruction,Jack Jr.,DEM,720140,0,0,16,16,
Tulsa,Superintendent of Public Instruction,Ivan Holmes,DEM,720140,0,0,1,1,
Tulsa,Superintendent of Public Instruction,Freda Deskin,DEM,720140,0,0,18,18,
Tulsa,U.S. Senate,Patrick Michael Hayes,DEM,720140,0,0,9,9,
Tulsa,U.S. Senate,Jim Rogers,DEM,720140,0,0,6,6,
Tulsa,U.S. Senate,Connie Johnson,DEM,720140,0,0,31,31,
Tulsa,Governor,Dax Ewbank,REP,720140,0,0,5,5,
Tulsa,Governor,Chad Moody,REP,720140,0,0,8,8,
Tulsa,Governor,Mary Fallin,REP,720140,0,0,21,21,
Tulsa,Superintendent of Public Instruction,Brian Kelly,REP,720140,0,0,10,10,
Tulsa,Superintendent of Public Instruction,Janet Costello Barresi,REP,720140,0,0,4,4,
Tulsa,Superintendent of Public Instruction,Joy Hofmeister,REP,720140,0,0,23,23,
Tulsa,Insurance Commissioner,Bill Viner,REP,720140,0,0,10,10,
Tulsa,Insurance Commissioner,John Doak,REP,720140,0,0,23,23,
Tulsa,Corporation Commissioner,Todd Hiett,REP,720140,0,0,24,24,
Tulsa,Corporation Commissioner,Cliff Branan,REP,720140,0,0,9,9,
Tulsa,U.S. Senate,Evelyn Rogers,REP,720140,0,0,2,2,
Tulsa,U.S. Senate,Rob Moye,REP,720140,0,0,0,0,
Tulsa,U.S. Senate,D. Jean Mcbride-Samuels,REP,720140,0,0,2,2,
Tulsa,U.S. Senate,Jim Inhofe,REP,720140,0,0,28,28,
Tulsa,U.S. Senate,Erick Paul Wyatt,REP,720140,0,0,4,4,
Tulsa,U.S. Senate,Andy Craig,REP,720140,0,0,1,1,
Tulsa,U.S. Senate,T. Shannon,REP,720140,0,0,10,10,
Tulsa,U.S. Senate,Randy Brogdon,REP,720140,0,0,4,4,
Tulsa,U.S. Senate,Eric Mccray,REP,720140,0,0,0,0,
Tulsa,U.S. Senate,Kevin Crow,REP,720140,0,0,2,2,
Tulsa,U.S. Senate,James Lankford,REP,720140,0,0,20,20,
Tulsa,U.S. Senate,Jason Weger,REP,720140,0,0,0,0,
Tulsa,Superintendent of Public Instruction,John Cox,DEM,720141,0,0,28,28,
Tulsa,Superintendent of Public Instruction,Jack Jr.,DEM,720141,0,0,16,16,
Tulsa,Superintendent of Public Instruction,Ivan Holmes,DEM,720141,0,0,6,6,
Tulsa,Superintendent of Public Instruction,Freda Deskin,DEM,720141,0,0,52,52,
Tulsa,U.S. Senate,Patrick Michael Hayes,DEM,720141,0,0,22,22,
Tulsa,U.S. Senate,Jim Rogers,DEM,720141,0,0,32,32,
Tulsa,U.S. Senate,Connie Johnson,DEM,720141,0,0,45,45,
Tulsa,Governor,Dax Ewbank,REP,720141,0,0,23,23,
Tulsa,Governor,Chad Moody,REP,720141,0,0,36,36,
Tulsa,Governor,Mary Fallin,REP,720141,0,0,141,141,
Tulsa,Superintendent of Public Instruction,Brian Kelly,REP,720141,0,0,38,38,
Tulsa,Superintendent of Public Instruction,Janet Costello Barresi,REP,720141,0,0,41,41,
Tulsa,Superintendent of Public Instruction,Joy Hofmeister,REP,720141,0,0,120,120,
Tulsa,Insurance Commissioner,Bill Viner,REP,720141,0,0,45,45,
Tulsa,Insurance Commissioner,John Doak,REP,720141,0,0,137,137,
Tulsa,Corporation Commissioner,Todd Hiett,REP,720141,0,0,101,101,
Tulsa,Corporation Commissioner,Cliff Branan,REP,720141,0,0,80,80,
Tulsa,U.S. Senate,Evelyn Rogers,REP,720141,0,0,13,13,
Tulsa,U.S. Senate,Rob Moye,REP,720141,0,0,5,5,
Tulsa,U.S. Senate,D. Jean Mcbride-Samuels,REP,720141,0,0,4,4,
Tulsa,U.S. Senate,Jim Inhofe,REP,720141,0,0,167,167,
Tulsa,U.S. Senate,Erick Paul Wyatt,REP,720141,0,0,10,10,
Tulsa,U.S. Senate,Andy Craig,REP,720141,0,0,2,2,
Tulsa,U.S. Senate,T. Shannon,REP,720141,0,0,80,80,
Tulsa,U.S. Senate,Randy Brogdon,REP,720141,0,0,31,31,
Tulsa,U.S. Senate,Eric Mccray,REP,720141,0,0,2,2,
Tulsa,U.S. Senate,Kevin Crow,REP,720141,0,0,7,7,
Tulsa,U.S. Senate,James Lankford,REP,720141,0,0,80,80,
Tulsa,U.S. Senate,Jason Weger,REP,720141,0,0,1,1,
Tulsa,Superintendent of Public Instruction,John Cox,DEM,720142,0,0,30,30,
Tulsa,Superintendent of Public Instruction,Jack Jr.,DEM,720142,0,0,9,9,
Tulsa,Superintendent of Public Instruction,Ivan Holmes,DEM,720142,0,0,4,4,
Tulsa,Superintendent of Public Instruction,Freda Deskin,DEM,720142,0,0,23,23,
Tulsa,U.S. Senate,Patrick Michael Hayes,DEM,720142,0,0,20,20,
Tulsa,U.S. Senate,Jim Rogers,DEM,720142,0,0,14,14,
Tulsa,U.S. Senate,Connie Johnson,DEM,720142,0,0,27,27,
Tulsa,Governor,Dax Ewbank,REP,720142,0,0,13,13,
Tulsa,Governor,Chad Moody,REP,720142,0,0,13,13,
Tulsa,Governor,Mary Fallin,REP,720142,0,0,90,90,
Tulsa,Superintendent of Public Instruction,Brian Kelly,REP,720142,0,0,13,13,
Tulsa,Superintendent of Public Instruction,Janet Costello Barresi,REP,720142,0,0,10,10,
Tulsa,Superintendent of Public Instruction,Joy Hofmeister,REP,720142,0,0,94,94,
Tulsa,Insurance Commissioner,Bill Viner,REP,720142,0,0,18,18,
Tulsa,Insurance Commissioner,John Doak,REP,720142,0,0,94,94,
Tulsa,Corporation Commissioner,Todd Hiett,REP,720142,0,0,55,55,
Tulsa,Corporation Commissioner,Cliff Branan,REP,720142,0,0,56,56,
Tulsa,U.S. Senate,Evelyn Rogers,REP,720142,0,0,2,2,
Tulsa,U.S. Senate,Rob Moye,REP,720142,0,0,0,0,
Tulsa,U.S. Senate,D. Jean Mcbride-Samuels,REP,720142,0,0,0,0,
Tulsa,U.S. Senate,Jim Inhofe,REP,720142,0,0,106,106,
Tulsa,U.S. Senate,Erick Paul Wyatt,REP,720142,0,0,9,9,
Tulsa,U.S. Senate,Andy Craig,REP,720142,0,0,0,0,
Tulsa,U.S. Senate,T. Shannon,REP,720142,0,0,59,59,
Tulsa,U.S. Senate,Randy Brogdon,REP,720142,0,0,5,5,
Tulsa,U.S. Senate,Eric Mccray,REP,720142,0,0,0,0,
Tulsa,U.S. Senate,Kevin Crow,REP,720142,0,0,3,3,
Tulsa,U.S. Senate,James Lankford,REP,720142,0,0,46,46,
Tulsa,U.S. Senate,Jason Weger,REP,720142,0,0,1,1,
Tulsa,Superintendent of Public Instruction,John Cox,DEM,720143,0,0,21,21,
Tulsa,Superintendent of Public Instruction,Jack Jr.,DEM,720143,0,0,3,3,
Tulsa,Superintendent of Public Instruction,Ivan Holmes,DEM,720143,0,0,3,3,
Tulsa,Superintendent of Public Instruction,Freda Deskin,DEM,720143,0,0,27,27,
Tulsa,U.S. Senate,Patrick Michael Hayes,DEM,720143,0,0,12,12,
Tulsa,U.S. Senate,Jim Rogers,DEM,720143,0,0,17,17,
Tulsa,U.S. Senate,Connie Johnson,DEM,720143,0,0,21,21,
Tulsa,Governor,Dax Ewbank,REP,720143,0,0,7,7,
Tulsa,Governor,Chad Moody,REP,720143,0,0,21,21,
Tulsa,Governor,Mary Fallin,REP,720143,0,0,82,82,
Tulsa,Superintendent of Public Instruction,Brian Kelly,REP,720143,0,0,20,20,
Tulsa,Superintendent of Public Instruction,Janet Costello Barresi,REP,720143,0,0,18,18,
Tulsa,Superintendent of Public Instruction,Joy Hofmeister,REP,720143,0,0,72,72,
Tulsa,Insurance Commissioner,Bill Viner,REP,720143,0,0,20,20,
Tulsa,Insurance Commissioner,John Doak,REP,720143,0,0,82,82,
Tulsa,Corporation Commissioner,Todd Hiett,REP,720143,0,0,59,59,
Tulsa,Corporation Commissioner,Cliff Branan,REP,720143,0,0,47,47,
Tulsa,U.S. Senate,Evelyn Rogers,REP,720143,0,0,8,8,
Tulsa,U.S. Senate,Rob Moye,REP,720143,0,0,1,1,
Tulsa,U.S. Senate,D. Jean Mcbride-Samuels,REP,720143,0,0,2,2,
Tulsa,U.S. Senate,Jim Inhofe,REP,720143,0,0,89,89,
Tulsa,U.S. Senate,Erick Paul Wyatt,REP,720143,0,0,10,10,
Tulsa,U.S. Senate,Andy Craig,REP,720143,0,0,0,0,
Tulsa,U.S. Senate,T. Shannon,REP,720143,0,0,46,46,
Tulsa,U.S. Senate,Randy Brogdon,REP,720143,0,0,4,4,
Tulsa,U.S. Senate,Eric Mccray,REP,720143,0,0,0,0,
Tulsa,U.S. Senate,Kevin Crow,REP,720143,0,0,3,3,
Tulsa,U.S. Senate,James Lankford,REP,720143,0,0,55,55,
Tulsa,U.S. Senate,Jason Weger,REP,720143,0,0,4,4,
Tulsa,Superintendent of Public Instruction,John Cox,DEM,720144,0,0,49,49,
Tulsa,Superintendent of Public Instruction,Jack Jr.,DEM,720144,0,0,6,6,
Tulsa,Superintendent of Public Instruction,Ivan Holmes,DEM,720144,0,0,6,6,
Tulsa,Superintendent of Public Instruction,Freda Deskin,DEM,720144,0,0,51,51,
Tulsa,U.S. Senate,Patrick Michael Hayes,DEM,720144,0,0,17,17,
Tulsa,U.S. Senate,Jim Rogers,DEM,720144,0,0,40,40,
Tulsa,U.S. Senate,Connie Johnson,DEM,720144,0,0,56,56,
Tulsa,Governor,Dax Ewbank,REP,720144,0,0,11,11,
Tulsa,Governor,Chad Moody,REP,720144,0,0,40,40,
Tulsa,Governor,Mary Fallin,REP,720144,0,0,152,152,
Tulsa,Superintendent of Public Instruction,Brian Kelly,REP,720144,0,0,34,34,
Tulsa,Superintendent of Public Instruction,Janet Costello Barresi,REP,720144,0,0,32,32,
Tulsa,Superintendent of Public Instruction,Joy Hofmeister,REP,720144,0,0,137,137,
Tulsa,Insurance Commissioner,Bill Viner,REP,720144,0,0,52,52,
Tulsa,Insurance Commissioner,John Doak,REP,720144,0,0,140,140,
Tulsa,Corporation Commissioner,Todd Hiett,REP,720144,0,0,102,102,
Tulsa,Corporation Commissioner,Cliff Branan,REP,720144,0,0,87,87,
Tulsa,U.S. Senate,Evelyn Rogers,REP,720144,0,0,8,8,
Tulsa,U.S. Senate,Rob Moye,REP,720144,0,0,7,7,
Tulsa,U.S. Senate,D. Jean Mcbride-Samuels,REP,720144,0,0,3,3,
Tulsa,U.S. Senate,Jim Inhofe,REP,720144,0,0,176,176,
Tulsa,U.S. Senate,Erick Paul Wyatt,REP,720144,0,0,6,6,
Tulsa,U.S. Senate,Andy Craig,REP,720144,0,0,0,0,
Tulsa,U.S. Senate,T. Shannon,REP,720144,0,0,79,79,
Tulsa,U.S. Senate,Randy Brogdon,REP,720144,0,0,19,19,
Tulsa,U.S. Senate,Eric Mccray,REP,720144,0,0,4,4,
Tulsa,U.S. Senate,Kevin Crow,REP,720144,0,0,3,3,
Tulsa,U.S. Senate,James Lankford,REP,720144,0,0,98,98,
Tulsa,U.S. Senate,Jason Weger,REP,720144,0,0,1,1,
Tulsa,Superintendent of Public Instruction,John Cox,DEM,720145,0,0,19,19,
Tulsa,Superintendent of Public Instruction,Jack Jr.,DEM,720145,0,0,4,4,
Tulsa,Superintendent of Public Instruction,Ivan Holmes,DEM,720145,0,0,1,1,
Tulsa,Superintendent of Public Instruction,Freda Deskin,DEM,720145,0,0,25,25,
Tulsa,U.S. Senate,Patrick Michael Hayes,DEM,720145,0,0,10,10,
Tulsa,U.S. Senate,Jim Rogers,DEM,720145,0,0,20,20,
Tulsa,U.S. Senate,Connie Johnson,DEM,720145,0,0,16,16,
Tulsa,Governor,Dax Ewbank,REP,720145,0,0,15,15,
Tulsa,Governor,Chad Moody,REP,720145,0,0,33,33,
Tulsa,Governor,Mary Fallin,REP,720145,0,0,226,226,
Tulsa,Superintendent of Public Instruction,Brian Kelly,REP,720145,0,0,37,37,
Tulsa,Superintendent of Public Instruction,Janet Costello Barresi,REP,720145,0,0,56,56,
Tulsa,Superintendent of Public Instruction,Joy Hofmeister,REP,720145,0,0,180,180,
Tulsa,Insurance Commissioner,Bill Viner,REP,720145,0,0,40,40,
Tulsa,Insurance Commissioner,John Doak,REP,720145,0,0,201,201,
Tulsa,Corporation Commissioner,Todd Hiett,REP,720145,0,0,144,144,
Tulsa,Corporation Commissioner,Cliff Branan,REP,720145,0,0,103,103,
Tulsa,U.S. Senate,Evelyn Rogers,REP,720145,0,0,13,13,
Tulsa,U.S. Senate,Rob Moye,REP,720145,0,0,3,3,
Tulsa,U.S. Senate,D. Jean Mcbride-Samuels,REP,720145,0,0,2,2,
Tulsa,U.S. Senate,Jim Inhofe,REP,720145,0,0,245,245,
Tulsa,U.S. Senate,Erick Paul Wyatt,REP,720145,0,0,10,10,
Tulsa,U.S. Senate,Andy Craig,REP,720145,0,0,1,1,
Tulsa,U.S. Senate,T. Shannon,REP,720145,0,0,111,111,
Tulsa,U.S. Senate,Randy Brogdon,REP,720145,0,0,8,8,
Tulsa,U.S. Senate,Eric Mccray,REP,720145,0,0,0,0,
Tulsa,U.S. Senate,Kevin Crow,REP,720145,0,0,2,2,
Tulsa,U.S. Senate,James Lankford,REP,720145,0,0,153,153,
Tulsa,U.S. Senate,Jason Weger,REP,720145,0,0,0,0,
Tulsa,Superintendent of Public Instruction,John Cox,DEM,720146,0,0,24,24,
Tulsa,Superintendent of Public Instruction,Jack Jr.,DEM,720146,0,0,8,8,
Tulsa,Superintendent of Public Instruction,Ivan Holmes,DEM,720146,0,0,2,2,
Tulsa,Superintendent of Public Instruction,Freda Deskin,DEM,720146,0,0,34,34,
Tulsa,U.S. Senate,Patrick Michael Hayes,DEM,720146,0,0,7,7,
Tulsa,U.S. Senate,Jim Rogers,DEM,720146,0,0,30,30,
Tulsa,U.S. Senate,Connie Johnson,DEM,720146,0,0,30,30,
Tulsa,Governor,Dax Ewbank,REP,720146,0,0,16,16,
Tulsa,Governor,Chad Moody,REP,720146,0,0,29,29,
Tulsa,Governor,Mary Fallin,REP,720146,0,0,175,175,
Tulsa,Superintendent of Public Instruction,Brian Kelly,REP,720146,0,0,32,32,
Tulsa,Superintendent of Public Instruction,Janet Costello Barresi,REP,720146,0,0,36,36,
Tulsa,Superintendent of Public Instruction,Joy Hofmeister,REP,720146,0,0,158,158,
Tulsa,Insurance Commissioner,Bill Viner,REP,720146,0,0,53,53,
Tulsa,Insurance Commissioner,John Doak,REP,720146,0,0,155,155,
Tulsa,Corporation Commissioner,Todd Hiett,REP,720146,0,0,127,127,
Tulsa,Corporation Commissioner,Cliff Branan,REP,720146,0,0,83,83,
Tulsa,U.S. Senate,Evelyn Rogers,REP,720146,0,0,7,7,
Tulsa,U.S. Senate,Rob Moye,REP,720146,0,0,4,4,
Tulsa,U.S. Senate,D. Jean Mcbride-Samuels,REP,720146,0,0,3,3,
Tulsa,U.S. Senate,Jim Inhofe,REP,720146,0,0,206,206,
Tulsa,U.S. Senate,Erick Paul Wyatt,REP,720146,0,0,4,4,
Tulsa,U.S. Senate,Andy Craig,REP,720146,0,0,1,1,
Tulsa,U.S. Senate,T. Shannon,REP,720146,0,0,67,67,
Tulsa,U.S. Senate,Randy Brogdon,REP,720146,0,0,18,18,
Tulsa,U.S. Senate,Eric Mccray,REP,720146,0,0,1,1,
Tulsa,U.S. Senate,Kevin Crow,REP,720146,0,0,2,2,
Tulsa,U.S. Senate,James Lankford,REP,720146,0,0,138,138,
Tulsa,U.S. Senate,Jason Weger,REP,720146,0,0,1,1,
Tulsa,Superintendent of Public Instruction,John Cox,DEM,720147,0,0,13,13,
Tulsa,Superintendent of Public Instruction,Jack Jr.,DEM,720147,0,0,9,9,
Tulsa,Superintendent of Public Instruction,Ivan Holmes,DEM,720147,0,0,2,2,
Tulsa,Superintendent of Public Instruction,Freda Deskin,DEM,720147,0,0,17,17,
Tulsa,U.S. Senate,Patrick Michael Hayes,DEM,720147,0,0,8,8,
Tulsa,U.S. Senate,Jim Rogers,DEM,720147,0,0,9,9,
Tulsa,U.S. Senate,Connie Johnson,DEM,720147,0,0,25,25,
Tulsa,Governor,Dax Ewbank,REP,720147,0,0,5,5,
Tulsa,Governor,Chad Moody,REP,720147,0,0,6,6,
Tulsa,Governor,Mary Fallin,REP,720147,0,0,21,21,
Tulsa,Superintendent of Public Instruction,Brian Kelly,REP,720147,0,0,8,8,
Tulsa,Superintendent of Public Instruction,Janet Costello Barresi,REP,720147,0,0,3,3,
Tulsa,Superintendent of Public Instruction,Joy Hofmeister,REP,720147,0,0,18,18,
Tulsa,Insurance Commissioner,Bill Viner,REP,720147,0,0,7,7,
Tulsa,Insurance Commissioner,John Doak,REP,720147,0,0,21,21,
Tulsa,Corporation Commissioner,Todd Hiett,REP,720147,0,0,16,16,
Tulsa,Corporation Commissioner,Cliff Branan,REP,720147,0,0,9,9,
Tulsa,U.S. Senate,Evelyn Rogers,REP,720147,0,0,2,2,
Tulsa,U.S. Senate,Rob Moye,REP,720147,0,0,0,0,
Tulsa,U.S. Senate,D. Jean Mcbride-Samuels,REP,720147,0,0,0,0,
Tulsa,U.S. Senate,Jim Inhofe,REP,720147,0,0,28,28,
Tulsa,U.S. Senate,Erick Paul Wyatt,REP,720147,0,0,1,1,
Tulsa,U.S. Senate,Andy Craig,REP,720147,0,0,0,0,
Tulsa,U.S. Senate,T. Shannon,REP,720147,0,0,11,11,
Tulsa,U.S. Senate,Randy Brogdon,REP,720147,0,0,6,6,
Tulsa,U.S. Senate,Eric Mccray,REP,720147,0,0,0,0,
Tulsa,U.S. Senate,Kevin Crow,REP,720147,0,0,0,0,
Tulsa,U.S. Senate,James Lankford,REP,720147,0,0,15,15,
Tulsa,U.S. Senate,Jason Weger,REP,720147,0,0,0,0,
Tulsa,Superintendent of Public Instruction,John Cox,DEM,720148,0,0,29,29,
Tulsa,Superintendent of Public Instruction,Jack Jr.,DEM,720148,0,0,13,13,
Tulsa,Superintendent of Public Instruction,Ivan Holmes,DEM,720148,0,0,2,2,
Tulsa,Superintendent of Public Instruction,Freda Deskin,DEM,720148,0,0,34,34,
Tulsa,U.S. Senate,Patrick Michael Hayes,DEM,720148,0,0,22,22,
Tulsa,U.S. Senate,Jim Rogers,DEM,720148,0,0,23,23,
Tulsa,U.S. Senate,Connie Johnson,DEM,720148,0,0,31,31,
Tulsa,Governor,Dax Ewbank,REP,720148,0,0,8,8,
Tulsa,Governor,Chad Moody,REP,720148,0,0,17,17,
Tulsa,Governor,Mary Fallin,REP,720148,0,0,72,72,
Tulsa,Superintendent of Public Instruction,Brian Kelly,REP,720148,0,0,26,26,
Tulsa,Superintendent of Public Instruction,Janet Costello Barresi,REP,720148,0,0,23,23,
Tulsa,Superintendent of Public Instruction,Joy Hofmeister,REP,720148,0,0,49,49,
Tulsa,Insurance Commissioner,Bill Viner,REP,720148,0,0,23,23,
Tulsa,Insurance Commissioner,John Doak,REP,720148,0,0,70,70,
Tulsa,Corporation Commissioner,Todd Hiett,REP,720148,0,0,53,53,
Tulsa,Corporation Commissioner,Cliff Branan,REP,720148,0,0,40,40,
Tulsa,U.S. Senate,Evelyn Rogers,REP,720148,0,0,6,6,
Tulsa,U.S. Senate,Rob Moye,REP,720148,0,0,1,1,
Tulsa,U.S. Senate,D. Jean Mcbride-Samuels,REP,720148,0,0,3,3,
Tulsa,U.S. Senate,Jim Inhofe,REP,720148,0,0,83,83,
Tulsa,U.S. Senate,Erick Paul Wyatt,REP,720148,0,0,3,3,
Tulsa,U.S. Senate,Andy Craig,REP,720148,0,0,1,1,
Tulsa,U.S. Senate,T. Shannon,REP,720148,0,0,48,48,
Tulsa,U.S. Senate,Randy Brogdon,REP,720148,0,0,7,7,
Tulsa,U.S. Senate,Eric Mccray,REP,720148,0,0,0,0,
Tulsa,U.S. Senate,Kevin Crow,REP,720148,0,0,0,0,
Tulsa,U.S. Senate,James Lankford,REP,720148,0,0,41,41,
Tulsa,U.S. Senate,Jason Weger,REP,720148,0,0,0,0,
Tulsa,Superintendent of Public Instruction,John Cox,DEM,720149,0,0,20,20,
Tulsa,Superintendent of Public Instruction,Jack Jr.,DEM,720149,0,0,2,2,
Tulsa,Superintendent of Public Instruction,Ivan Holmes,DEM,720149,0,0,3,3,
Tulsa,Superintendent of Public Instruction,Freda Deskin,DEM,720149,0,0,29,29,
Tulsa,U.S. Senate,Patrick Michael Hayes,DEM,720149,0,0,19,19,
Tulsa,U.S. Senate,Jim Rogers,DEM,720149,0,0,17,17,
Tulsa,U.S. Senate,Connie Johnson,DEM,720149,0,0,17,17,
Tulsa,Governor,Dax Ewbank,REP,720149,0,0,2,2,
Tulsa,Governor,Chad Moody,REP,720149,0,0,14,14,
Tulsa,Governor,Mary Fallin,REP,720149,0,0,59,59,
Tulsa,Superintendent of Public Instruction,Brian Kelly,REP,720149,0,0,14,14,
Tulsa,Superintendent of Public Instruction,Janet Costello Barresi,REP,720149,0,0,19,19,
Tulsa,Superintendent of Public Instruction,Joy Hofmeister,REP,720149,0,0,40,40,
Tulsa,Insurance Commissioner,Bill Viner,REP,720149,0,0,23,23,
Tulsa,Insurance Commissioner,John Doak,REP,720149,0,0,51,51,
Tulsa,Corporation Commissioner,Todd Hiett,REP,720149,0,0,36,36,
Tulsa,Corporation Commissioner,Cliff Branan,REP,720149,0,0,35,35,
Tulsa,U.S. Senate,Evelyn Rogers,REP,720149,0,0,4,4,
Tulsa,U.S. Senate,Rob Moye,REP,720149,0,0,2,2,
Tulsa,U.S. Senate,D. Jean Mcbride-Samuels,REP,720149,0,0,2,2,
Tulsa,U.S. Senate,Jim Inhofe,REP,720149,0,0,66,66,
Tulsa,U.S. Senate,Erick Paul Wyatt,REP,720149,0,0,3,3,
Tulsa,U.S. Senate,Andy Craig,REP,720149,0,0,0,0,
Tulsa,U.S. Senate,T. Shannon,REP,720149,0,0,33,33,
Tulsa,U.S. Senate,Randy Brogdon,REP,720149,0,0,6,6,
Tulsa,U.S. Senate,Eric Mccray,REP,720149,0,0,0,0,
Tulsa,U.S. Senate,Kevin Crow,REP,720149,0,0,3,3,
Tulsa,U.S. Senate,James Lankford,REP,720149,0,0,35,35,
Tulsa,U.S. Senate,Jason Weger,REP,720149,0,0,0,0,
Tulsa,Superintendent of Public Instruction,John Cox,DEM,720150,0,0,21,21,
Tulsa,Superintendent of Public Instruction,Jack Jr.,DEM,720150,0,0,6,6,
Tulsa,Superintendent of Public Instruction,Ivan Holmes,DEM,720150,0,0,4,4,
Tulsa,Superintendent of Public Instruction,Freda Deskin,DEM,720150,0,0,19,19,
Tulsa,U.S. Senate,Patrick Michael Hayes,DEM,720150,0,0,14,14,
Tulsa,U.S. Senate,Jim Rogers,DEM,720150,0,0,13,13,
Tulsa,U.S. Senate,Connie Johnson,DEM,720150,0,0,24,24,
Tulsa,Governor,Dax Ewbank,REP,720150,0,0,39,39,
Tulsa,Governor,Chad Moody,REP,720150,0,0,42,42,
Tulsa,Governor,Mary Fallin,REP,720150,0,0,289,289,
Tulsa,Superintendent of Public Instruction,Brian Kelly,REP,720150,0,0,47,47,
Tulsa,Superintendent of Public Instruction,Janet Costello Barresi,REP,720150,0,0,72,72,
Tulsa,Superintendent of Public Instruction,Joy Hofmeister,REP,720150,0,0,254,254,
Tulsa,Insurance Commissioner,Bill Viner,REP,720150,0,0,56,56,
Tulsa,Insurance Commissioner,John Doak,REP,720150,0,0,283,283,
Tulsa,Corporation Commissioner,Todd Hiett,REP,720150,0,0,206,206,
Tulsa,Corporation Commissioner,Cliff Branan,REP,720150,0,0,131,131,
Tulsa,U.S. Senate,Evelyn Rogers,REP,720150,0,0,14,14,
Tulsa,U.S. Senate,Rob Moye,REP,720150,0,0,2,2,
Tulsa,U.S. Senate,D. Jean Mcbride-Samuels,REP,720150,0,0,4,4,
Tulsa,U.S. Senate,Jim Inhofe,REP,720150,0,0,345,345,
Tulsa,U.S. Senate,Erick Paul Wyatt,REP,720150,0,0,6,6,
Tulsa,U.S. Senate,Andy Craig,REP,720150,0,0,2,2,
Tulsa,U.S. Senate,T. Shannon,REP,720150,0,0,151,151,
Tulsa,U.S. Senate,Randy Brogdon,REP,720150,0,0,36,36,
Tulsa,U.S. Senate,Eric Mccray,REP,720150,0,0,0,0,
Tulsa,U.S. Senate,Kevin Crow,REP,720150,0,0,1,1,
Tulsa,U.S. Senate,James Lankford,REP,720150,0,0,186,186,
Tulsa,U.S. Senate,Jason Weger,REP,720150,0,0,0,0,
Tulsa,Superintendent of Public Instruction,John Cox,DEM,720151,0,0,11,11,
Tulsa,Superintendent of Public Instruction,Jack Jr.,DEM,720151,0,0,2,2,
Tulsa,Superintendent of Public Instruction,Ivan Holmes,DEM,720151,0,0,1,1,
Tulsa,Superintendent of Public Instruction,Freda Deskin,DEM,720151,0,0,11,11,
Tulsa,U.S. Senate,Patrick Michael Hayes,DEM,720151,0,0,5,5,
Tulsa,U.S. Senate,Jim Rogers,DEM,720151,0,0,3,3,
Tulsa,U.S. Senate,Connie Johnson,DEM,720151,0,0,16,16,
Tulsa,Governor,Dax Ewbank,REP,720151,0,0,3,3,
Tulsa,Governor,Chad Moody,REP,720151,0,0,14,14,
Tulsa,Governor,Mary Fallin,REP,720151,0,0,76,76,
Tulsa,Superintendent of Public Instruction,Brian Kelly,REP,720151,0,0,7,7,
Tulsa,Superintendent of Public Instruction,Janet Costello Barresi,REP,720151,0,0,17,17,
Tulsa,Superintendent of Public Instruction,Joy Hofmeister,REP,720151,0,0,70,70,
Tulsa,Insurance Commissioner,Bill Viner,REP,720151,0,0,7,7,
Tulsa,Insurance Commissioner,John Doak,REP,720151,0,0,85,85,
Tulsa,Corporation Commissioner,Todd Hiett,REP,720151,0,0,53,53,
Tulsa,Corporation Commissioner,Cliff Branan,REP,720151,0,0,32,32,
Tulsa,U.S. Senate,Evelyn Rogers,REP,720151,0,0,1,1,
Tulsa,U.S. Senate,Rob Moye,REP,720151,0,0,1,1,
Tulsa,U.S. Senate,D. Jean Mcbride-Samuels,REP,720151,0,0,2,2,
Tulsa,U.S. Senate,Jim Inhofe,REP,720151,0,0,85,85,
Tulsa,U.S. Senate,Erick Paul Wyatt,REP,720151,0,0,4,4,
Tulsa,U.S. Senate,Andy Craig,REP,720151,0,0,0,0,
Tulsa,U.S. Senate,T. Shannon,REP,720151,0,0,26,26,
Tulsa,U.S. Senate,Randy Brogdon,REP,720151,0,0,12,12,
Tulsa,U.S. Senate,Eric Mccray,REP,720151,0,0,0,0,
Tulsa,U.S. Senate,Kevin Crow,REP,720151,0,0,0,0,
Tulsa,U.S. Senate,James Lankford,REP,720151,0,0,55,55,
Tulsa,U.S. Senate,Jason Weger,REP,720151,0,0,1,1,
Tulsa,State House,Weldon Watson,REP,720151,0,0,62,62,79
Tulsa,State House,Lois Jacobs,REP,720151,0,0,26,26,79
Tulsa,Superintendent of Public Instruction,John Cox,DEM,720152,0,0,10,10,
Tulsa,Superintendent of Public Instruction,Jack Jr.,DEM,720152,0,0,4,4,
Tulsa,Superintendent of Public Instruction,Ivan Holmes,DEM,720152,0,0,1,1,
Tulsa,Superintendent of Public Instruction,Freda Deskin,DEM,720152,0,0,13,13,
Tulsa,U.S. Senate,Patrick Michael Hayes,DEM,720152,0,0,6,6,
Tulsa,U.S. Senate,Jim Rogers,DEM,720152,0,0,1,1,
Tulsa,U.S. Senate,Connie Johnson,DEM,720152,0,0,21,21,
Tulsa,Governor,Dax Ewbank,REP,720152,0,0,14,14,
Tulsa,Governor,Chad Moody,REP,720152,0,0,32,32,
Tulsa,Governor,Mary Fallin,REP,720152,0,0,121,121,
Tulsa,Superintendent of Public Instruction,Brian Kelly,REP,720152,0,0,19,19,
Tulsa,Superintendent of Public Instruction,Janet Costello Barresi,REP,720152,0,0,22,22,
Tulsa,Superintendent of Public Instruction,Joy Hofmeister,REP,720152,0,0,128,128,
Tulsa,Insurance Commissioner,Bill Viner,REP,720152,0,0,32,32,
Tulsa,Insurance Commissioner,John Doak,REP,720152,0,0,121,121,
Tulsa,Corporation Commissioner,Todd Hiett,REP,720152,0,0,80,80,
Tulsa,Corporation Commissioner,Cliff Branan,REP,720152,0,0,78,78,
Tulsa,U.S. Senate,Evelyn Rogers,REP,720152,0,0,6,6,
Tulsa,U.S. Senate,Rob Moye,REP,720152,0,0,1,1,
Tulsa,U.S. Senate,D. Jean Mcbride-Samuels,REP,720152,0,0,6,6,
Tulsa,U.S. Senate,Jim Inhofe,REP,720152,0,0,150,150,
Tulsa,U.S. Senate,Erick Paul Wyatt,REP,720152,0,0,5,5,
Tulsa,U.S. Senate,Andy Craig,REP,720152,0,0,0,0,
Tulsa,U.S. Senate,T. Shannon,REP,720152,0,0,73,73,
Tulsa,U.S. Senate,Randy Brogdon,REP,720152,0,0,14,14,
Tulsa,U.S. Senate,Eric Mccray,REP,720152,0,0,2,2,
Tulsa,U.S. Senate,Kevin Crow,REP,720152,0,0,0,0,
Tulsa,U.S. Senate,James Lankford,REP,720152,0,0,79,79,
Tulsa,U.S. Senate,Jason Weger,REP,720152,0,0,1,1,
Tulsa,Superintendent of Public Instruction,John Cox,DEM,720153,0,0,21,21,
Tulsa,Superintendent of Public Instruction,Jack Jr.,DEM,720153,0,0,7,7,
Tulsa,Superintendent of Public Instruction,Ivan Holmes,DEM,720153,0,0,2,2,
Tulsa,Superintendent of Public Instruction,Freda Deskin,DEM,720153,0,0,25,25,
Tulsa,U.S. Senate,Patrick Michael Hayes,DEM,720153,0,0,8,8,
Tulsa,U.S. Senate,Jim Rogers,DEM,720153,0,0,10,10,
Tulsa,U.S. Senate,Connie Johnson,DEM,720153,0,0,36,36,
Tulsa,Governor,Dax Ewbank,REP,720153,0,0,12,12,
Tulsa,Governor,Chad Moody,REP,720153,0,0,43,43,
Tulsa,Governor,Mary Fallin,REP,720153,0,0,219,219,
Tulsa,Superintendent of Public Instruction,Brian Kelly,REP,720153,0,0,41,41,
Tulsa,Superintendent of Public Instruction,Janet Costello Barresi,REP,720153,0,0,44,44,
Tulsa,Superintendent of Public Instruction,Joy Hofmeister,REP,720153,0,0,188,188,
Tulsa,Insurance Commissioner,Bill Viner,REP,720153,0,0,48,48,
Tulsa,Insurance Commissioner,John Doak,REP,720153,0,0,221,221,
Tulsa,Corporation Commissioner,Todd Hiett,REP,720153,0,0,143,143,
Tulsa,Corporation Commissioner,Cliff Branan,REP,720153,0,0,114,114,
Tulsa,U.S. Senate,Evelyn Rogers,REP,720153,0,0,14,14,
Tulsa,U.S. Senate,Rob Moye,REP,720153,0,0,6,6,
Tulsa,U.S. Senate,D. Jean Mcbride-Samuels,REP,720153,0,0,5,5,
Tulsa,U.S. Senate,Jim Inhofe,REP,720153,0,0,243,243,
Tulsa,U.S. Senate,Erick Paul Wyatt,REP,720153,0,0,5,5,
Tulsa,U.S. Senate,Andy Craig,REP,720153,0,0,1,1,
Tulsa,U.S. Senate,T. Shannon,REP,720153,0,0,86,86,
Tulsa,U.S. Senate,Randy Brogdon,REP,720153,0,0,22,22,
Tulsa,U.S. Senate,Eric Mccray,REP,720153,0,0,0,0,
Tulsa,U.S. Senate,Kevin Crow,REP,720153,0,0,2,2,
Tulsa,U.S. Senate,James Lankford,REP,720153,0,0,163,163,
Tulsa,U.S. Senate,Jason Weger,REP,720153,0,0,2,2,
Tulsa,Superintendent of Public Instruction,John Cox,DEM,720154,0,0,10,10,
Tulsa,Superintendent of Public Instruction,Jack Jr.,DEM,720154,0,0,4,4,
Tulsa,Superintendent of Public Instruction,Ivan Holmes,DEM,720154,0,0,1,1,
Tulsa,Superintendent of Public Instruction,Freda Deskin,DEM,720154,0,0,21,21,
Tulsa,U.S. Senate,Patrick Michael Hayes,DEM,720154,0,0,7,7,
Tulsa,U.S. Senate,Jim Rogers,DEM,720154,0,0,7,7,
Tulsa,U.S. Senate,Connie Johnson,DEM,720154,0,0,21,21,
Tulsa,Governor,Dax Ewbank,REP,720154,0,0,20,20,
Tulsa,Governor,Chad Moody,REP,720154,0,0,41,41,
Tulsa,Governor,Mary Fallin,REP,720154,0,0,279,279,
Tulsa,Superintendent of Public Instruction,Brian Kelly,REP,720154,0,0,41,41,
Tulsa,Superintendent of Public Instruction,Janet Costello Barresi,REP,720154,0,0,61,61,
Tulsa,Superintendent of Public Instruction,Joy Hofmeister,REP,720154,0,0,242,242,
Tulsa,Insurance Commissioner,Bill Viner,REP,720154,0,0,62,62,
Tulsa,Insurance Commissioner,John Doak,REP,720154,0,0,258,258,
Tulsa,Corporation Commissioner,Todd Hiett,REP,720154,0,0,202,202,
Tulsa,Corporation Commissioner,Cliff Branan,REP,720154,0,0,120,120,
Tulsa,U.S. Senate,Evelyn Rogers,REP,720154,0,0,19,19,
Tulsa,U.S. Senate,Rob Moye,REP,720154,0,0,6,6,
Tulsa,U.S. Senate,D. Jean Mcbride-Samuels,REP,720154,0,0,4,4,
Tulsa,U.S. Senate,Jim Inhofe,REP,720154,0,0,307,307,
Tulsa,U.S. Senate,Erick Paul Wyatt,REP,720154,0,0,7,7,
Tulsa,U.S. Senate,Andy Craig,REP,720154,0,0,2,2,
Tulsa,U.S. Senate,T. Shannon,REP,720154,0,0,125,125,
Tulsa,U.S. Senate,Randy Brogdon,REP,720154,0,0,41,41,
Tulsa,U.S. Senate,Eric Mccray,REP,720154,0,0,0,0,
Tulsa,U.S. Senate,Kevin Crow,REP,720154,0,0,1,1,
Tulsa,U.S. Senate,James Lankford,REP,720154,0,0,179,179,
Tulsa,U.S. Senate,Jason Weger,REP,720154,0,0,0,0,
Tulsa,Superintendent of Public Instruction,John Cox,DEM,720155,0,0,15,15,
Tulsa,Superintendent of Public Instruction,Jack Jr.,DEM,720155,0,0,9,9,
Tulsa,Superintendent of Public Instruction,Ivan Holmes,DEM,720155,0,0,0,0,
Tulsa,Superintendent of Public Instruction,Freda Deskin,DEM,720155,0,0,30,30,
Tulsa,U.S. Senate,Patrick Michael Hayes,DEM,720155,0,0,13,13,
Tulsa,U.S. Senate,Jim Rogers,DEM,720155,0,0,6,6,
Tulsa,U.S. Senate,Connie Johnson,DEM,720155,0,0,32,32,
Tulsa,Governor,Dax Ewbank,REP,720155,0,0,35,35,
Tulsa,Governor,Chad Moody,REP,720155,0,0,74,74,
Tulsa,Governor,Mary Fallin,REP,720155,0,0,575,575,
Tulsa,Superintendent of Public Instruction,Brian Kelly,REP,720155,0,0,47,47,
Tulsa,Superintendent of Public Instruction,Janet Costello Barresi,REP,720155,0,0,97,97,
Tulsa,Superintendent of Public Instruction,Joy Hofmeister,REP,720155,0,0,542,542,
Tulsa,Insurance Commissioner,Bill Viner,REP,720155,0,0,104,104,
Tulsa,Insurance Commissioner,John Doak,REP,720155,0,0,519,519,
Tulsa,Corporation Commissioner,Todd Hiett,REP,720155,0,0,375,375,
Tulsa,Corporation Commissioner,Cliff Branan,REP,720155,0,0,228,228,
Tulsa,U.S. Senate,Evelyn Rogers,REP,720155,0,0,27,27,
Tulsa,U.S. Senate,Rob Moye,REP,720155,0,0,5,5,
Tulsa,U.S. Senate,D. Jean Mcbride-Samuels,REP,720155,0,0,10,10,
Tulsa,U.S. Senate,Jim Inhofe,REP,720155,0,0,624,624,
Tulsa,U.S. Senate,Erick Paul Wyatt,REP,720155,0,0,13,13,
Tulsa,U.S. Senate,Andy Craig,REP,720155,0,0,1,1,
Tulsa,U.S. Senate,T. Shannon,REP,720155,0,0,259,259,
Tulsa,U.S. Senate,Randy Brogdon,REP,720155,0,0,25,25,
Tulsa,U.S. Senate,Eric Mccray,REP,720155,0,0,2,2,
Tulsa,U.S. Senate,Kevin Crow,REP,720155,0,0,1,1,
Tulsa,U.S. Senate,James Lankford,REP,720155,0,0,403,403,
Tulsa,U.S. Senate,Jason Weger,REP,720155,0,0,5,5,
Tulsa,Superintendent of Public Instruction,John Cox,DEM,720156,0,0,6,6,
Tulsa,Superintendent of Public Instruction,Jack Jr.,DEM,720156,0,0,0,0,
Tulsa,Superintendent of Public Instruction,Ivan Holmes,DEM,720156,0,0,1,1,
Tulsa,Superintendent of Public Instruction,Freda Deskin,DEM,720156,0,0,1,1,
Tulsa,U.S. Senate,Patrick Michael Hayes,DEM,720156,0,0,2,2,
Tulsa,U.S. Senate,Jim Rogers,DEM,720156,0,0,3,3,
Tulsa,U.S. Senate,Connie Johnson,DEM,720156,0,0,4,4,
Tulsa,Governor,Dax Ewbank,REP,720156,0,0,5,5,
Tulsa,Governor,Chad Moody,REP,720156,0,0,6,6,
Tulsa,Governor,Mary Fallin,REP,720156,0,0,27,27,
Tulsa,Superintendent of Public Instruction,Brian Kelly,REP,720156,0,0,12,12,
Tulsa,Superintendent of Public Instruction,Janet Costello Barresi,REP,720156,0,0,8,8,
Tulsa,Superintendent of Public Instruction,Joy Hofmeister,REP,720156,0,0,18,18,
Tulsa,Insurance Commissioner,Bill Viner,REP,720156,0,0,7,7,
Tulsa,Insurance Commissioner,John Doak,REP,720156,0,0,26,26,
Tulsa,Corporation Commissioner,Todd Hiett,REP,720156,0,0,19,19,
Tulsa,Corporation Commissioner,Cliff Branan,REP,720156,0,0,14,14,
Tulsa,U.S. Senate,Evelyn Rogers,REP,720156,0,0,3,3,
Tulsa,U.S. Senate,Rob Moye,REP,720156,0,0,1,1,
Tulsa,U.S. Senate,D. Jean Mcbride-Samuels,REP,720156,0,0,0,0,
Tulsa,U.S. Senate,Jim Inhofe,REP,720156,0,0,32,32,
Tulsa,U.S. Senate,Erick Paul Wyatt,REP,720156,0,0,0,0,
Tulsa,U.S. Senate,Andy Craig,REP,720156,0,0,1,1,
Tulsa,U.S. Senate,T. Shannon,REP,720156,0,0,18,18,
Tulsa,U.S. Senate,Randy Brogdon,REP,720156,0,0,2,2,
Tulsa,U.S. Senate,Eric Mccray,REP,720156,0,0,0,0,
Tulsa,U.S. Senate,Kevin Crow,REP,720156,0,0,1,1,
Tulsa,U.S. Senate,James Lankford,REP,720156,0,0,15,15,
Tulsa,U.S. Senate,Jason Weger,REP,720156,0,0,1,1,
Tulsa,State House,Weldon Watson,REP,720156,0,0,19,19,79
Tulsa,State House,Lois Jacobs,REP,720156,0,0,15,15,79
Tulsa,Superintendent of Public Instruction,John Cox,DEM,720157,0,0,18,18,
Tulsa,Superintendent of Public Instruction,Jack Jr.,DEM,720157,0,0,9,9,
Tulsa,Superintendent of Public Instruction,Ivan Holmes,DEM,720157,0,0,2,2,
Tulsa,Superintendent of Public Instruction,Freda Deskin,DEM,720157,0,0,23,23,
Tulsa,U.S. Senate,Patrick Michael Hayes,DEM,720157,0,0,8,8,
Tulsa,U.S. Senate,Jim Rogers,DEM,720157,0,0,10,10,
Tulsa,U.S. Senate,Connie Johnson,DEM,720157,0,0,33,33,
Tulsa,Governor,Dax Ewbank,REP,720157,0,0,36,36,
Tulsa,Governor,Chad Moody,REP,720157,0,0,72,72,
Tulsa,Governor,Mary Fallin,REP,720157,0,0,433,433,
Tulsa,Superintendent of Public Instruction,Brian Kelly,REP,720157,0,0,65,65,
Tulsa,Superintendent of Public Instruction,Janet Costello Barresi,REP,720157,0,0,82,82,
Tulsa,Superintendent of Public Instruction,Joy Hofmeister,REP,720157,0,0,398,398,
Tulsa,Insurance Commissioner,Bill Viner,REP,720157,0,0,70,70,
Tulsa,Insurance Commissioner,John Doak,REP,720157,0,0,423,423,
Tulsa,Corporation Commissioner,Todd Hiett,REP,720157,0,0,285,285,
Tulsa,Corporation Commissioner,Cliff Branan,REP,720157,0,0,204,204,
Tulsa,U.S. Senate,Evelyn Rogers,REP,720157,0,0,23,23,
Tulsa,U.S. Senate,Rob Moye,REP,720157,0,0,3,3,
Tulsa,U.S. Senate,D. Jean Mcbride-Samuels,REP,720157,0,0,6,6,
Tulsa,U.S. Senate,Jim Inhofe,REP,720157,0,0,494,494,
Tulsa,U.S. Senate,Erick Paul Wyatt,REP,720157,0,0,19,19,
Tulsa,U.S. Senate,Andy Craig,REP,720157,0,0,1,1,
Tulsa,U.S. Senate,T. Shannon,REP,720157,0,0,192,192,
Tulsa,U.S. Senate,Randy Brogdon,REP,720157,0,0,46,46,
Tulsa,U.S. Senate,Eric Mccray,REP,720157,0,0,1,1,
Tulsa,U.S. Senate,Kevin Crow,REP,720157,0,0,3,3,
Tulsa,U.S. Senate,James Lankford,REP,720157,0,0,305,305,
Tulsa,U.S. Senate,Jason Weger,REP,720157,0,0,2,2,
Tulsa,State House,Melissa Abdo,REP,720157,0,0,236,236,69
Tulsa,State House,Paul Bowman,REP,720157,0,0,125,125,69
Tulsa,State House,Chuck Strohm,REP,720157,0,0,145,145,69
Tulsa,Superintendent of Public Instruction,John Cox,DEM,720158,0,0,14,14,
Tulsa,Superintendent of Public Instruction,Jack Jr.,DEM,720158,0,0,3,3,
Tulsa,Superintendent of Public Instruction,Ivan Holmes,DEM,720158,0,0,3,3,
Tulsa,Superintendent of Public Instruction,Freda Deskin,DEM,720158,0,0,15,15,
Tulsa,U.S. Senate,Patrick Michael Hayes,DEM,720158,0,0,5,5,
Tulsa,U.S. Senate,Jim Rogers,DEM,720158,0,0,8,8,
Tulsa,U.S. Senate,Connie Johnson,DEM,720158,0,0,19,19,
Tulsa,Governor,Dax Ewbank,REP,720158,0,0,15,15,
Tulsa,Governor,Chad Moody,REP,720158,0,0,49,49,
Tulsa,Governor,Mary Fallin,REP,720158,0,0,178,178,
Tulsa,Superintendent of Public Instruction,Brian Kelly,REP,720158,0,0,27,27,
Tulsa,Superintendent of Public Instruction,Janet Costello Barresi,REP,720158,0,0,46,46,
Tulsa,Superintendent of Public Instruction,Joy Hofmeister,REP,720158,0,0,175,175,
Tulsa,Insurance Commissioner,Bill Viner,REP,720158,0,0,34,34,
Tulsa,Insurance Commissioner,John Doak,REP,720158,0,0,203,203,
Tulsa,Corporation Commissioner,Todd Hiett,REP,720158,0,0,134,134,
Tulsa,Corporation Commissioner,Cliff Branan,REP,720158,0,0,83,83,
Tulsa,U.S. Senate,Evelyn Rogers,REP,720158,0,0,9,9,
Tulsa,U.S. Senate,Rob Moye,REP,720158,0,0,5,5,
Tulsa,U.S. Senate,D. Jean Mcbride-Samuels,REP,720158,0,0,3,3,
Tulsa,U.S. Senate,Jim Inhofe,REP,720158,0,0,224,224,
Tulsa,U.S. Senate,Erick Paul Wyatt,REP,720158,0,0,5,5,
Tulsa,U.S. Senate,Andy Craig,REP,720158,0,0,0,0,
Tulsa,U.S. Senate,T. Shannon,REP,720158,0,0,95,95,
Tulsa,U.S. Senate,Randy Brogdon,REP,720158,0,0,20,20,
Tulsa,U.S. Senate,Eric Mccray,REP,720158,0,0,1,1,
Tulsa,U.S. Senate,Kevin Crow,REP,720158,0,0,1,1,
Tulsa,U.S. Senate,James Lankford,REP,720158,0,0,132,132,
Tulsa,U.S. Senate,Jason Weger,REP,720158,0,0,1,1,
Tulsa,Superintendent of Public Instruction,John Cox,DEM,720159,0,0,9,9,
Tulsa,Superintendent of Public Instruction,Jack Jr.,DEM,720159,0,0,4,4,
Tulsa,Superintendent of Public Instruction,Ivan Holmes,DEM,720159,0,0,1,1,
Tulsa,Superintendent of Public Instruction,Freda Deskin,DEM,720159,0,0,27,27,
Tulsa,U.S. Senate,Patrick Michael Hayes,DEM,720159,0,0,5,5,
Tulsa,U.S. Senate,Jim Rogers,DEM,720159,0,0,4,4,
Tulsa,U.S. Senate,Connie Johnson,DEM,720159,0,0,31,31,
Tulsa,Governor,Dax Ewbank,REP,720159,0,0,16,16,
Tulsa,Governor,Chad Moody,REP,720159,0,0,36,36,
Tulsa,Governor,Mary Fallin,REP,720159,0,0,256,256,
Tulsa,Superintendent of Public Instruction,Brian Kelly,REP,720159,0,0,23,23,
Tulsa,Superintendent of Public Instruction,Janet Costello Barresi,REP,720159,0,0,61,61,
Tulsa,Superintendent of Public Instruction,Joy Hofmeister,REP,720159,0,0,223,223,
Tulsa,Insurance Commissioner,Bill Viner,REP,720159,0,0,51,51,
Tulsa,Insurance Commissioner,John Doak,REP,720159,0,0,227,227,
Tulsa,Corporation Commissioner,Todd Hiett,REP,720159,0,0,175,175,
Tulsa,Corporation Commissioner,Cliff Branan,REP,720159,0,0,101,101,
Tulsa,U.S. Senate,Evelyn Rogers,REP,720159,0,0,11,11,
Tulsa,U.S. Senate,Rob Moye,REP,720159,0,0,6,6,
Tulsa,U.S. Senate,D. Jean Mcbride-Samuels,REP,720159,0,0,6,6,
Tulsa,U.S. Senate,Jim Inhofe,REP,720159,0,0,275,275,
Tulsa,U.S. Senate,Erick Paul Wyatt,REP,720159,0,0,8,8,
Tulsa,U.S. Senate,Andy Craig,REP,720159,0,0,1,1,
Tulsa,U.S. Senate,T. Shannon,REP,720159,0,0,117,117,
Tulsa,U.S. Senate,Randy Brogdon,REP,720159,0,0,31,31,
Tulsa,U.S. Senate,Eric Mccray,REP,720159,0,0,0,0,
Tulsa,U.S. Senate,Kevin Crow,REP,720159,0,0,0,0,
Tulsa,U.S. Senate,James Lankford,REP,720159,0,0,160,160,
Tulsa,U.S. Senate,Jason Weger,REP,720159,0,0,0,0,
Tulsa,Superintendent of Public Instruction,John Cox,DEM,720160,0,0,36,36,
Tulsa,Superintendent of Public Instruction,Jack Jr.,DEM,720160,0,0,13,13,
Tulsa,Superintendent of Public Instruction,Ivan Holmes,DEM,720160,0,0,11,11,
Tulsa,Superintendent of Public Instruction,Freda Deskin,DEM,720160,0,0,55,55,
Tulsa,U.S. Senate,Patrick Michael Hayes,DEM,720160,0,0,12,12,
Tulsa,U.S. Senate,Jim Rogers,DEM,720160,0,0,28,28,
Tulsa,U.S. Senate,Connie Johnson,DEM,720160,0,0,71,71,
Tulsa,Governor,Dax Ewbank,REP,720160,0,0,26,26,
Tulsa,Governor,Chad Moody,REP,720160,0,0,62,62,
Tulsa,Governor,Mary Fallin,REP,720160,0,0,238,238,
Tulsa,Superintendent of Public Instruction,Brian Kelly,REP,720160,0,0,44,44,
Tulsa,Superintendent of Public Instruction,Janet Costello Barresi,REP,720160,0,0,54,54,
Tulsa,Superintendent of Public Instruction,Joy Hofmeister,REP,720160,0,0,229,229,
Tulsa,Insurance Commissioner,Bill Viner,REP,720160,0,0,66,66,
Tulsa,Insurance Commissioner,John Doak,REP,720160,0,0,229,229,
Tulsa,Corporation Commissioner,Todd Hiett,REP,720160,0,0,153,153,
Tulsa,Corporation Commissioner,Cliff Branan,REP,720160,0,0,149,149,
Tulsa,U.S. Senate,Evelyn Rogers,REP,720160,0,0,18,18,
Tulsa,U.S. Senate,Rob Moye,REP,720160,0,0,22,22,
Tulsa,U.S. Senate,D. Jean Mcbride-Samuels,REP,720160,0,0,5,5,
Tulsa,U.S. Senate,Jim Inhofe,REP,720160,0,0,270,270,
Tulsa,U.S. Senate,Erick Paul Wyatt,REP,720160,0,0,15,15,
Tulsa,U.S. Senate,Andy Craig,REP,720160,0,0,4,4,
Tulsa,U.S. Senate,T. Shannon,REP,720160,0,0,112,112,
Tulsa,U.S. Senate,Randy Brogdon,REP,720160,0,0,22,22,
Tulsa,U.S. Senate,Eric Mccray,REP,720160,0,0,2,2,
Tulsa,U.S. Senate,Kevin Crow,REP,720160,0,0,1,1,
Tulsa,U.S. Senate,James Lankford,REP,720160,0,0,185,185,
Tulsa,U.S. Senate,Jason Weger,REP,720160,0,0,4,4,
Tulsa,Superintendent of Public Instruction,John Cox,DEM,720161,0,0,6,6,
Tulsa,Superintendent of Public Instruction,Jack Jr.,DEM,720161,0,0,5,5,
Tulsa,Superintendent of Public Instruction,Ivan Holmes,DEM,720161,0,0,6,6,
Tulsa,Superintendent of Public Instruction,Freda Deskin,DEM,720161,0,0,23,23,
Tulsa,U.S. Senate,Patrick Michael Hayes,DEM,720161,0,0,6,6,
Tulsa,U.S. Senate,Jim Rogers,DEM,720161,0,0,10,10,
Tulsa,U.S. Senate,Connie Johnson,DEM,720161,0,0,22,22,
Tulsa,Governor,Dax Ewbank,REP,720161,0,0,6,6,
Tulsa,Governor,Chad Moody,REP,720161,0,0,5,5,
Tulsa,Governor,Mary Fallin,REP,720161,0,0,39,39,
Tulsa,Superintendent of Public Instruction,Brian Kelly,REP,720161,0,0,8,8,
Tulsa,Superintendent of Public Instruction,Janet Costello Barresi,REP,720161,0,0,15,15,
Tulsa,Superintendent of Public Instruction,Joy Hofmeister,REP,720161,0,0,26,26,
Tulsa,Insurance Commissioner,Bill Viner,REP,720161,0,0,6,6,
Tulsa,Insurance Commissioner,John Doak,REP,720161,0,0,38,38,
Tulsa,Corporation Commissioner,Todd Hiett,REP,720161,0,0,23,23,
Tulsa,Corporation Commissioner,Cliff Branan,REP,720161,0,0,21,21,
Tulsa,U.S. Senate,Evelyn Rogers,REP,720161,0,0,2,2,
Tulsa,U.S. Senate,Rob Moye,REP,720161,0,0,0,0,
Tulsa,U.S. Senate,D. Jean Mcbride-Samuels,REP,720161,0,0,3,3,
Tulsa,U.S. Senate,Jim Inhofe,REP,720161,0,0,43,43,
Tulsa,U.S. Senate,Erick Paul Wyatt,REP,720161,0,0,1,1,
Tulsa,U.S. Senate,Andy Craig,REP,720161,0,0,1,1,
Tulsa,U.S. Senate,T. Shannon,REP,720161,0,0,12,12,
Tulsa,U.S. Senate,Randy Brogdon,REP,720161,0,0,5,5,
Tulsa,U.S. Senate,Eric Mccray,REP,720161,0,0,3,3,
Tulsa,U.S. Senate,Kevin Crow,REP,720161,0,0,3,3,
Tulsa,U.S. Senate,James Lankford,REP,720161,0,0,25,25,
Tulsa,U.S. Senate,Jason Weger,REP,720161,0,0,0,0,
Tulsa,Superintendent of Public Instruction,John Cox,DEM,720162,0,0,0,0,
Tulsa,Superintendent of Public Instruction,Jack Jr.,DEM,720162,0,0,0,0,
Tulsa,Superintendent of Public Instruction,Ivan Holmes,DEM,720162,0,0,0,0,
Tulsa,Superintendent of Public Instruction,Freda Deskin,DEM,720162,0,0,0,0,
Tulsa,U.S. Senate,Patrick Michael Hayes,DEM,720162,0,0,0,0,
Tulsa,U.S. Senate,Jim Rogers,DEM,720162,0,0,0,0,
Tulsa,U.S. Senate,Connie Johnson,DEM,720162,0,0,0,0,
Tulsa,Governor,Dax Ewbank,REP,720162,0,0,2,2,
Tulsa,Governor,Chad Moody,REP,720162,0,0,1,1,
Tulsa,Governor,Mary Fallin,REP,720162,0,0,19,19,
Tulsa,Superintendent of Public Instruction,Brian Kelly,REP,720162,0,0,2,2,
Tulsa,Superintendent of Public Instruction,Janet Costello Barresi,REP,720162,0,0,4,4,
Tulsa,Superintendent of Public Instruction,Joy Hofmeister,REP,720162,0,0,16,16,
Tulsa,Insurance Commissioner,Bill Viner,REP,720162,0,0,3,3,
Tulsa,Insurance Commissioner,John Doak,REP,720162,0,0,15,15,
Tulsa,Corporation Commissioner,Todd Hiett,REP,720162,0,0,14,14,
Tulsa,Corporation Commissioner,Cliff Branan,REP,720162,0,0,3,3,
Tulsa,U.S. Senate,Evelyn Rogers,REP,720162,0,0,0,0,
Tulsa,U.S. Senate,Rob Moye,REP,720162,0,0,1,1,
Tulsa,U.S. Senate,D. Jean Mcbride-Samuels,REP,720162,0,0,1,1,
Tulsa,U.S. Senate,Jim Inhofe,REP,720162,0,0,18,18,
Tulsa,U.S. Senate,Erick Paul Wyatt,REP,720162,0,0,1,1,
Tulsa,U.S. Senate,Andy Craig,REP,720162,0,0,0,0,
Tulsa,U.S. Senate,T. Shannon,REP,720162,0,0,2,2,
Tulsa,U.S. Senate,Randy Brogdon,REP,720162,0,0,4,4,
Tulsa,U.S. Senate,Eric Mccray,REP,720162,0,0,0,0,
Tulsa,U.S. Senate,Kevin Crow,REP,720162,0,0,0,0,
Tulsa,U.S. Senate,James Lankford,REP,720162,0,0,14,14,
Tulsa,U.S. Senate,Jason Weger,REP,720162,0,0,1,1,
Tulsa,State House,Melissa Abdo,REP,720162,0,0,4,4,69
Tulsa,State House,Paul Bowman,REP,720162,0,0,7,7,69
Tulsa,State House,Chuck Strohm,REP,720162,0,0,8,8,69
Tulsa,Superintendent of Public Instruction,John Cox,DEM,720163,0,0,32,32,
Tulsa,Superintendent of Public Instruction,Jack Jr.,DEM,720163,0,0,10,10,
Tulsa,Superintendent of Public Instruction,Ivan Holmes,DEM,720163,0,0,3,3,
Tulsa,Superintendent of Public Instruction,Freda Deskin,DEM,720163,0,0,35,35,
Tulsa,U.S. Senate,Patrick Michael Hayes,DEM,720163,0,0,14,14,
Tulsa,U.S. Senate,Jim Rogers,DEM,720163,0,0,15,15,
Tulsa,U.S. Senate,Connie Johnson,DEM,720163,0,0,52,52,
Tulsa,Governor,Dax Ewbank,REP,720163,0,0,7,7,
Tulsa,Governor,Chad Moody,REP,720163,0,0,36,36,
Tulsa,Governor,Mary Fallin,REP,720163,0,0,212,212,
Tulsa,Superintendent of Public Instruction,Brian Kelly,REP,720163,0,0,27,27,
Tulsa,Superintendent of Public Instruction,Janet Costello Barresi,REP,720163,0,0,51,51,
Tulsa,Superintendent of Public Instruction,Joy Hofmeister,REP,720163,0,0,177,177,
Tulsa,Insurance Commissioner,Bill Viner,REP,720163,0,0,41,41,
Tulsa,Insurance Commissioner,John Doak,REP,720163,0,0,183,183,
Tulsa,Corporation Commissioner,Todd Hiett,REP,720163,0,0,129,129,
Tulsa,Corporation Commissioner,Cliff Branan,REP,720163,0,0,94,94,
Tulsa,U.S. Senate,Evelyn Rogers,REP,720163,0,0,10,10,
Tulsa,U.S. Senate,Rob Moye,REP,720163,0,0,4,4,
Tulsa,U.S. Senate,D. Jean Mcbride-Samuels,REP,720163,0,0,11,11,
Tulsa,U.S. Senate,Jim Inhofe,REP,720163,0,0,223,223,
Tulsa,U.S. Senate,Erick Paul Wyatt,REP,720163,0,0,5,5,
Tulsa,U.S. Senate,Andy Craig,REP,720163,0,0,0,0,
Tulsa,U.S. Senate,T. Shannon,REP,720163,0,0,75,75,
Tulsa,U.S. Senate,Randy Brogdon,REP,720163,0,0,17,17,
Tulsa,U.S. Senate,Eric Mccray,REP,720163,0,0,2,2,
Tulsa,U.S. Senate,Kevin Crow,REP,720163,0,0,3,3,
Tulsa,U.S. Senate,James Lankford,REP,720163,0,0,161,161,
Tulsa,U.S. Senate,Jason Weger,REP,720163,0,0,0,0,
Tulsa,Superintendent of Public Instruction,John Cox,DEM,720164,0,0,11,11,
Tulsa,Superintendent of Public Instruction,Jack Jr.,DEM,720164,0,0,2,2,
Tulsa,Superintendent of Public Instruction,Ivan Holmes,DEM,720164,0,0,3,3,
Tulsa,Superintendent of Public Instruction,Freda Deskin,DEM,720164,0,0,19,19,
Tulsa,U.S. Senate,Patrick Michael Hayes,DEM,720164,0,0,7,7,
Tulsa,U.S. Senate,Jim Rogers,DEM,720164,0,0,5,5,
Tulsa,U.S. Senate,Connie Johnson,DEM,720164,0,0,20,20,
Tulsa,Governor,Dax Ewbank,REP,720164,0,0,15,15,
Tulsa,Governor,Chad Moody,REP,720164,0,0,19,19,
Tulsa,Governor,Mary Fallin,REP,720164,0,0,98,98,
Tulsa,Superintendent of Public Instruction,Brian Kelly,REP,720164,0,0,11,11,
Tulsa,Superintendent of Public Instruction,Janet Costello Barresi,REP,720164,0,0,20,20,
Tulsa,Superintendent of Public Instruction,Joy Hofmeister,REP,720164,0,0,98,98,
Tulsa,Insurance Commissioner,Bill Viner,REP,720164,0,0,23,23,
Tulsa,Insurance Commissioner,John Doak,REP,720164,0,0,91,91,
Tulsa,Corporation Commissioner,Todd Hiett,REP,720164,0,0,67,67,
Tulsa,Corporation Commissioner,Cliff Branan,REP,720164,0,0,50,50,
Tulsa,U.S. Senate,Evelyn Rogers,REP,720164,0,0,9,9,
Tulsa,U.S. Senate,Rob Moye,REP,720164,0,0,3,3,
Tulsa,U.S. Senate,D. Jean Mcbride-Samuels,REP,720164,0,0,6,6,
Tulsa,U.S. Senate,Jim Inhofe,REP,720164,0,0,105,105,
Tulsa,U.S. Senate,Erick Paul Wyatt,REP,720164,0,0,5,5,
Tulsa,U.S. Senate,Andy Craig,REP,720164,0,0,0,0,
Tulsa,U.S. Senate,T. Shannon,REP,720164,0,0,32,32,
Tulsa,U.S. Senate,Randy Brogdon,REP,720164,0,0,10,10,
Tulsa,U.S. Senate,Eric Mccray,REP,720164,0,0,0,0,
Tulsa,U.S. Senate,Kevin Crow,REP,720164,0,0,0,0,
Tulsa,U.S. Senate,James Lankford,REP,720164,0,0,88,88,
Tulsa,U.S. Senate,Jason Weger,REP,720164,0,0,2,2,
Tulsa,Superintendent of Public Instruction,John Cox,DEM,720165,0,0,7,7,
Tulsa,Superintendent of Public Instruction,Jack Jr.,DEM,720165,0,0,0,0,
Tulsa,Superintendent of Public Instruction,Ivan Holmes,DEM,720165,0,0,3,3,
Tulsa,Superintendent of Public Instruction,Freda Deskin,DEM,720165,0,0,16,16,
Tulsa,U.S. Senate,Patrick Michael Hayes,DEM,720165,0,0,2,2,
Tulsa,U.S. Senate,Jim Rogers,DEM,720165,0,0,4,4,
Tulsa,U.S. Senate,Connie Johnson,DEM,720165,0,0,20,20,
Tulsa,Governor,Dax Ewbank,REP,720165,0,0,10,10,
Tulsa,Governor,Chad Moody,REP,720165,0,0,6,6,
Tulsa,Governor,Mary Fallin,REP,720165,0,0,128,128,
Tulsa,Superintendent of Public Instruction,Brian Kelly,REP,720165,0,0,14,14,
Tulsa,Superintendent of Public Instruction,Janet Costello Barresi,REP,720165,0,0,33,33,
Tulsa,Superintendent of Public Instruction,Joy Hofmeister,REP,720165,0,0,99,99,
Tulsa,Insurance Commissioner,Bill Viner,REP,720165,0,0,22,22,
Tulsa,Insurance Commissioner,John Doak,REP,720165,0,0,110,110,
Tulsa,Corporation Commissioner,Todd Hiett,REP,720165,0,0,78,78,
Tulsa,Corporation Commissioner,Cliff Branan,REP,720165,0,0,48,48,
Tulsa,U.S. Senate,Evelyn Rogers,REP,720165,0,0,2,2,
Tulsa,U.S. Senate,Rob Moye,REP,720165,0,0,4,4,
Tulsa,U.S. Senate,D. Jean Mcbride-Samuels,REP,720165,0,0,0,0,
Tulsa,U.S. Senate,Jim Inhofe,REP,720165,0,0,137,137,
Tulsa,U.S. Senate,Erick Paul Wyatt,REP,720165,0,0,2,2,
Tulsa,U.S. Senate,Andy Craig,REP,720165,0,0,3,3,
Tulsa,U.S. Senate,T. Shannon,REP,720165,0,0,63,63,
Tulsa,U.S. Senate,Randy Brogdon,REP,720165,0,0,12,12,
Tulsa,U.S. Senate,Eric Mccray,REP,720165,0,0,2,2,
Tulsa,U.S. Senate,Kevin Crow,REP,720165,0,0,0,0,
Tulsa,U.S. Senate,James Lankford,REP,720165,0,0,66,66,
Tulsa,U.S. Senate,Jason Weger,REP,720165,0,0,0,0,
Tulsa,Superintendent of Public Instruction,John Cox,DEM,720166,0,0,18,18,
Tulsa,Superintendent of Public Instruction,Jack Jr.,DEM,720166,0,0,5,5,
Tulsa,Superintendent of Public Instruction,Ivan Holmes,DEM,720166,0,0,3,3,
Tulsa,Superintendent of Public Instruction,Freda Deskin,DEM,720166,0,0,40,40,
Tulsa,U.S. Senate,Patrick Michael Hayes,DEM,720166,0,0,10,10,
Tulsa,U.S. Senate,Jim Rogers,DEM,720166,0,0,10,10,
Tulsa,U.S. Senate,Connie Johnson,DEM,720166,0,0,47,47,
Tulsa,Governor,Dax Ewbank,REP,720166,0,0,14,14,
Tulsa,Governor,Chad Moody,REP,720166,0,0,48,48,
Tulsa,Governor,Mary Fallin,REP,720166,0,0,312,312,
Tulsa,Superintendent of Public Instruction,Brian Kelly,REP,720166,0,0,35,35,
Tulsa,Superintendent of Public Instruction,Janet Costello Barresi,REP,720166,0,0,72,72,
Tulsa,Superintendent of Public Instruction,Joy Hofmeister,REP,720166,0,0,274,274,
Tulsa,Insurance Commissioner,Bill Viner,REP,720166,0,0,58,58,
Tulsa,Insurance Commissioner,John Doak,REP,720166,0,0,286,286,
Tulsa,Corporation Commissioner,Todd Hiett,REP,720166,0,0,198,198,
Tulsa,Corporation Commissioner,Cliff Branan,REP,720166,0,0,140,140,
Tulsa,U.S. Senate,Evelyn Rogers,REP,720166,0,0,25,25,
Tulsa,U.S. Senate,Rob Moye,REP,720166,0,0,4,4,
Tulsa,U.S. Senate,D. Jean Mcbride-Samuels,REP,720166,0,0,2,2,
Tulsa,U.S. Senate,Jim Inhofe,REP,720166,0,0,339,339,
Tulsa,U.S. Senate,Erick Paul Wyatt,REP,720166,0,0,7,7,
Tulsa,U.S. Senate,Andy Craig,REP,720166,0,0,2,2,
Tulsa,U.S. Senate,T. Shannon,REP,720166,0,0,142,142,
Tulsa,U.S. Senate,Randy Brogdon,REP,720166,0,0,30,30,
Tulsa,U.S. Senate,Eric Mccray,REP,720166,0,0,4,4,
Tulsa,U.S. Senate,Kevin Crow,REP,720166,0,0,1,1,
Tulsa,U.S. Senate,James Lankford,REP,720166,0,0,202,202,
Tulsa,U.S. Senate,Jason Weger,REP,720166,0,0,2,2,
Tulsa,Superintendent of Public Instruction,John Cox,DEM,720167,0,0,5,5,
Tulsa,Superintendent of Public Instruction,Jack Jr.,DEM,720167,0,0,1,1,
Tulsa,Superintendent of Public Instruction,Ivan Holmes,DEM,720167,0,0,1,1,
Tulsa,Superintendent of Public Instruction,Freda Deskin,DEM,720167,0,0,14,14,
Tulsa,U.S. Senate,Patrick Michael Hayes,DEM,720167,0,0,2,2,
Tulsa,U.S. Senate,Jim Rogers,DEM,720167,0,0,4,4,
Tulsa,U.S. Senate,Connie Johnson,DEM,720167,0,0,12,12,
Tulsa,Governor,Dax Ewbank,REP,720167,0,0,24,24,
Tulsa,Governor,Chad Moody,REP,720167,0,0,39,39,
Tulsa,Governor,Mary Fallin,REP,720167,0,0,338,338,
Tulsa,Superintendent of Public Instruction,Brian Kelly,REP,720167,0,0,38,38,
Tulsa,Superintendent of Public Instruction,Janet Costello Barresi,REP,720167,0,0,57,57,
Tulsa,Superintendent of Public Instruction,Joy Hofmeister,REP,720167,0,0,305,305,
Tulsa,Insurance Commissioner,Bill Viner,REP,720167,0,0,70,70,
Tulsa,Insurance Commissioner,John Doak,REP,720167,0,0,290,290,
Tulsa,Corporation Commissioner,Todd Hiett,REP,720167,0,0,218,218,
Tulsa,Corporation Commissioner,Cliff Branan,REP,720167,0,0,133,133,
Tulsa,U.S. Senate,Evelyn Rogers,REP,720167,0,0,18,18,
Tulsa,U.S. Senate,Rob Moye,REP,720167,0,0,6,6,
Tulsa,U.S. Senate,D. Jean Mcbride-Samuels,REP,720167,0,0,2,2,
Tulsa,U.S. Senate,Jim Inhofe,REP,720167,0,0,370,370,
Tulsa,U.S. Senate,Erick Paul Wyatt,REP,720167,0,0,7,7,
Tulsa,U.S. Senate,Andy Craig,REP,720167,0,0,2,2,
Tulsa,U.S. Senate,T. Shannon,REP,720167,0,0,163,163,
Tulsa,U.S. Senate,Randy Brogdon,REP,720167,0,0,18,18,
Tulsa,U.S. Senate,Eric Mccray,REP,720167,0,0,2,2,
Tulsa,U.S. Senate,Kevin Crow,REP,720167,0,0,0,0,
Tulsa,U.S. Senate,James Lankford,REP,720167,0,0,219,219,
Tulsa,U.S. Senate,Jason Weger,REP,720167,0,0,1,1,
Tulsa,State House,Melissa Abdo,REP,720167,0,0,196,196,69
Tulsa,State House,Paul Bowman,REP,720167,0,0,87,87,69
Tulsa,State House,Chuck Strohm,REP,720167,0,0,87,87,69
Tulsa,Superintendent of Public Instruction,John Cox,DEM,720168,0,0,22,22,
Tulsa,Superintendent of Public Instruction,Jack Jr.,DEM,720168,0,0,8,8,
Tulsa,Superintendent of Public Instruction,Ivan Holmes,DEM,720168,0,0,4,4,
Tulsa,Superintendent of Public Instruction,Freda Deskin,DEM,720168,0,0,44,44,
Tulsa,U.S. Senate,Patrick Michael Hayes,DEM,720168,0,0,7,7,
Tulsa,U.S. Senate,Jim Rogers,DEM,720168,0,0,16,16,
Tulsa,U.S. Senate,Connie Johnson,DEM,720168,0,0,52,52,
Tulsa,Governor,Dax Ewbank,REP,720168,0,0,17,17,
Tulsa,Governor,Chad Moody,REP,720168,0,0,37,37,
Tulsa,Governor,Mary Fallin,REP,720168,0,0,248,248,
Tulsa,Superintendent of Public Instruction,Brian Kelly,REP,720168,0,0,38,38,
Tulsa,Superintendent of Public Instruction,Janet Costello Barresi,REP,720168,0,0,63,63,
Tulsa,Superintendent of Public Instruction,Joy Hofmeister,REP,720168,0,0,202,202,
Tulsa,Insurance Commissioner,Bill Viner,REP,720168,0,0,66,66,
Tulsa,Insurance Commissioner,John Doak,REP,720168,0,0,208,208,
Tulsa,Corporation Commissioner,Todd Hiett,REP,720168,0,0,161,161,
Tulsa,Corporation Commissioner,Cliff Branan,REP,720168,0,0,118,118,
Tulsa,U.S. Senate,Evelyn Rogers,REP,720168,0,0,8,8,
Tulsa,U.S. Senate,Rob Moye,REP,720168,0,0,3,3,
Tulsa,U.S. Senate,D. Jean Mcbride-Samuels,REP,720168,0,0,14,14,
Tulsa,U.S. Senate,Jim Inhofe,REP,720168,0,0,270,270,
Tulsa,U.S. Senate,Erick Paul Wyatt,REP,720168,0,0,5,5,
Tulsa,U.S. Senate,Andy Craig,REP,720168,0,0,0,0,
Tulsa,U.S. Senate,T. Shannon,REP,720168,0,0,100,100,
Tulsa,U.S. Senate,Randy Brogdon,REP,720168,0,0,16,16,
Tulsa,U.S. Senate,Eric Mccray,REP,720168,0,0,0,0,
Tulsa,U.S. Senate,Kevin Crow,REP,720168,0,0,1,1,
Tulsa,U.S. Senate,James Lankford,REP,720168,0,0,189,189,
Tulsa,U.S. Senate,Jason Weger,REP,720168,0,0,1,1,
Tulsa,State House,Weldon Watson,REP,720168,0,0,220,220,79
Tulsa,State House,Lois Jacobs,REP,720168,0,0,61,61,79
Tulsa,Superintendent of Public Instruction,John Cox,DEM,720169,0,0,26,26,
Tulsa,Superintendent of Public Instruction,Jack Jr.,DEM,720169,0,0,3,3,
Tulsa,Superintendent of Public Instruction,Ivan Holmes,DEM,720169,0,0,4,4,
Tulsa,Superintendent of Public Instruction,Freda Deskin,DEM,720169,0,0,39,39,
Tulsa,U.S. Senate,Patrick Michael Hayes,DEM,720169,0,0,11,11,
Tulsa,U.S. Senate,Jim Rogers,DEM,720169,0,0,14,14,
Tulsa,U.S. Senate,Connie Johnson,DEM,720169,0,0,40,40,
Tulsa,Governor,Dax Ewbank,REP,720169,0,0,12,12,
Tulsa,Governor,Chad Moody,REP,720169,0,0,34,34,
Tulsa,Governor,Mary Fallin,REP,720169,0,0,162,162,
Tulsa,Superintendent of Public Instruction,Brian Kelly,REP,720169,0,0,22,22,
Tulsa,Superintendent of Public Instruction,Janet Costello Barresi,REP,720169,0,0,40,40,
Tulsa,Superintendent of Public Instruction,Joy Hofmeister,REP,720169,0,0,145,145,
Tulsa,Insurance Commissioner,Bill Viner,REP,720169,0,0,39,39,
Tulsa,Insurance Commissioner,John Doak,REP,720169,0,0,145,145,
Tulsa,Corporation Commissioner,Todd Hiett,REP,720169,0,0,106,106,
Tulsa,Corporation Commissioner,Cliff Branan,REP,720169,0,0,78,78,
Tulsa,U.S. Senate,Evelyn Rogers,REP,720169,0,0,8,8,
Tulsa,U.S. Senate,Rob Moye,REP,720169,0,0,2,2,
Tulsa,U.S. Senate,D. Jean Mcbride-Samuels,REP,720169,0,0,5,5,
Tulsa,U.S. Senate,Jim Inhofe,REP,720169,0,0,174,174,
Tulsa,U.S. Senate,Erick Paul Wyatt,REP,720169,0,0,14,14,
Tulsa,U.S. Senate,Andy Craig,REP,720169,0,0,1,1,
Tulsa,U.S. Senate,T. Shannon,REP,720169,0,0,61,61,
Tulsa,U.S. Senate,Randy Brogdon,REP,720169,0,0,17,17,
Tulsa,U.S. Senate,Eric Mccray,REP,720169,0,0,2,2,
Tulsa,U.S. Senate,Kevin Crow,REP,720169,0,0,0,0,
Tulsa,U.S. Senate,James Lankford,REP,720169,0,0,129,129,
Tulsa,U.S. Senate,Jason Weger,REP,720169,0,0,0,0,
Tulsa,State House,Weldon Watson,REP,720169,0,0,127,127,79
Tulsa,State House,Lois Jacobs,REP,720169,0,0,59,59,79
Tulsa,Superintendent of Public Instruction,John Cox,DEM,720170,0,0,8,8,
Tulsa,Superintendent of Public Instruction,Jack Jr.,DEM,720170,0,0,4,4,
Tulsa,Superintendent of Public Instruction,Ivan Holmes,DEM,720170,0,0,0,0,
Tulsa,Superintendent of Public Instruction,Freda Deskin,DEM,720170,0,0,16,16,
Tulsa,U.S. Senate,Patrick Michael Hayes,DEM,720170,0,0,9,9,
Tulsa,U.S. Senate,Jim Rogers,DEM,720170,0,0,5,5,
Tulsa,U.S. Senate,Connie Johnson,DEM,720170,0,0,14,14,
Tulsa,Governor,Dax Ewbank,REP,720170,0,0,6,6,
Tulsa,Governor,Chad Moody,REP,720170,0,0,25,25,
Tulsa,Governor,Mary Fallin,REP,720170,0,0,208,208,
Tulsa,Superintendent of Public Instruction,Brian Kelly,REP,720170,0,0,26,26,
Tulsa,Superintendent of Public Instruction,Janet Costello Barresi,REP,720170,0,0,52,52,
Tulsa,Superintendent of Public Instruction,Joy Hofmeister,REP,720170,0,0,164,164,
Tulsa,Insurance Commissioner,Bill Viner,REP,720170,0,0,40,40,
Tulsa,Insurance Commissioner,John Doak,REP,720170,0,0,169,169,
Tulsa,Corporation Commissioner,Todd Hiett,REP,720170,0,0,130,130,
Tulsa,Corporation Commissioner,Cliff Branan,REP,720170,0,0,69,69,
Tulsa,U.S. Senate,Evelyn Rogers,REP,720170,0,0,6,6,
Tulsa,U.S. Senate,Rob Moye,REP,720170,0,0,6,6,
Tulsa,U.S. Senate,D. Jean Mcbride-Samuels,REP,720170,0,0,3,3,
Tulsa,U.S. Senate,Jim Inhofe,REP,720170,0,0,221,221,
Tulsa,U.S. Senate,Erick Paul Wyatt,REP,720170,0,0,8,8,
Tulsa,U.S. Senate,Andy Craig,REP,720170,0,0,2,2,
Tulsa,U.S. Senate,T. Shannon,REP,720170,0,0,75,75,
Tulsa,U.S. Senate,Randy Brogdon,REP,720170,0,0,21,21,
Tulsa,U.S. Senate,Eric Mccray,REP,720170,0,0,2,2,
Tulsa,U.S. Senate,Kevin Crow,REP,720170,0,0,0,0,
Tulsa,U.S. Senate,James Lankford,REP,720170,0,0,144,144,
Tulsa,U.S. Senate,Jason Weger,REP,720170,0,0,1,1,
Tulsa,Superintendent of Public Instruction,John Cox,DEM,720171,0,0,13,13,
Tulsa,Superintendent of Public Instruction,Jack Jr.,DEM,720171,0,0,1,1,
Tulsa,Superintendent of Public Instruction,Ivan Holmes,DEM,720171,0,0,1,1,
Tulsa,Superintendent of Public Instruction,Freda Deskin,DEM,720171,0,0,25,25,
Tulsa,U.S. Senate,Patrick Michael Hayes,DEM,720171,0,0,7,7,
Tulsa,U.S. Senate,Jim Rogers,DEM,720171,0,0,8,8,
Tulsa,U.S. Senate,Connie Johnson,DEM,720171,0,0,23,23,
Tulsa,Governor,Dax Ewbank,REP,720171,0,0,9,9,
Tulsa,Governor,Chad Moody,REP,720171,0,0,20,20,
Tulsa,Governor,Mary Fallin,REP,720171,0,0,126,126,
Tulsa,Superintendent of Public Instruction,Brian Kelly,REP,720171,0,0,27,27,
Tulsa,Superintendent of Public Instruction,Janet Costello Barresi,REP,720171,0,0,17,17,
Tulsa,Superintendent of Public Instruction,Joy Hofmeister,REP,720171,0,0,109,109,
Tulsa,Insurance Commissioner,Bill Viner,REP,720171,0,0,29,29,
Tulsa,Insurance Commissioner,John Doak,REP,720171,0,0,118,118,
Tulsa,Corporation Commissioner,Todd Hiett,REP,720171,0,0,75,75,
Tulsa,Corporation Commissioner,Cliff Branan,REP,720171,0,0,65,65,
Tulsa,U.S. Senate,Evelyn Rogers,REP,720171,0,0,5,5,
Tulsa,U.S. Senate,Rob Moye,REP,720171,0,0,2,2,
Tulsa,U.S. Senate,D. Jean Mcbride-Samuels,REP,720171,0,0,4,4,
Tulsa,U.S. Senate,Jim Inhofe,REP,720171,0,0,144,144,
Tulsa,U.S. Senate,Erick Paul Wyatt,REP,720171,0,0,2,2,
Tulsa,U.S. Senate,Andy Craig,REP,720171,0,0,1,1,
Tulsa,U.S. Senate,T. Shannon,REP,720171,0,0,51,51,
Tulsa,U.S. Senate,Randy Brogdon,REP,720171,0,0,11,11,
Tulsa,U.S. Senate,Eric Mccray,REP,720171,0,0,1,1,
Tulsa,U.S. Senate,Kevin Crow,REP,720171,0,0,1,1,
Tulsa,U.S. Senate,James Lankford,REP,720171,0,0,91,91,
Tulsa,U.S. Senate,Jason Weger,REP,720171,0,0,0,0,
Tulsa,State House,Melissa Abdo,REP,720171,0,0,72,72,69
Tulsa,State House,Paul Bowman,REP,720171,0,0,34,34,69
Tulsa,State House,Chuck Strohm,REP,720171,0,0,41,41,69
Tulsa,Superintendent of Public Instruction,John Cox,DEM,720172,0,0,27,27,
Tulsa,Superintendent of Public Instruction,Jack Jr.,DEM,720172,0,0,9,9,
Tulsa,Superintendent of Public Instruction,Ivan Holmes,DEM,720172,0,0,1,1,
Tulsa,Superintendent of Public Instruction,Freda Deskin,DEM,720172,0,0,35,35,
Tulsa,U.S. Senate,Patrick Michael Hayes,DEM,720172,0,0,17,17,
Tulsa,U.S. Senate,Jim Rogers,DEM,720172,0,0,13,13,
Tulsa,U.S. Senate,Connie Johnson,DEM,720172,0,0,38,38,
Tulsa,Governor,Dax Ewbank,REP,720172,0,0,4,4,
Tulsa,Governor,Chad Moody,REP,720172,0,0,38,38,
Tulsa,Governor,Mary Fallin,REP,720172,0,0,171,171,
Tulsa,Superintendent of Public Instruction,Brian Kelly,REP,720172,0,0,33,33,
Tulsa,Superintendent of Public Instruction,Janet Costello Barresi,REP,720172,0,0,29,29,
Tulsa,Superintendent of Public Instruction,Joy Hofmeister,REP,720172,0,0,154,154,
Tulsa,Insurance Commissioner,Bill Viner,REP,720172,0,0,38,38,
Tulsa,Insurance Commissioner,John Doak,REP,720172,0,0,162,162,
Tulsa,Corporation Commissioner,Todd Hiett,REP,720172,0,0,113,113,
Tulsa,Corporation Commissioner,Cliff Branan,REP,720172,0,0,90,90,
Tulsa,U.S. Senate,Evelyn Rogers,REP,720172,0,0,7,7,
Tulsa,U.S. Senate,Rob Moye,REP,720172,0,0,3,3,
Tulsa,U.S. Senate,D. Jean Mcbride-Samuels,REP,720172,0,0,3,3,
Tulsa,U.S. Senate,Jim Inhofe,REP,720172,0,0,200,200,
Tulsa,U.S. Senate,Erick Paul Wyatt,REP,720172,0,0,1,1,
Tulsa,U.S. Senate,Andy Craig,REP,720172,0,0,2,2,
Tulsa,U.S. Senate,T. Shannon,REP,720172,0,0,89,89,
Tulsa,U.S. Senate,Randy Brogdon,REP,720172,0,0,16,16,
Tulsa,U.S. Senate,Eric Mccray,REP,720172,0,0,3,3,
Tulsa,U.S. Senate,Kevin Crow,REP,720172,0,0,1,1,
Tulsa,U.S. Senate,James Lankford,REP,720172,0,0,107,107,
Tulsa,U.S. Senate,Jason Weger,REP,720172,0,0,0,0,
Tulsa,State House,Weldon Watson,REP,720172,0,0,139,139,79
Tulsa,State House,Lois Jacobs,REP,720172,0,0,60,60,79
Tulsa,Superintendent of Public Instruction,John Cox,DEM,720173,0,0,13,13,
Tulsa,Superintendent of Public Instruction,Jack Jr.,DEM,720173,0,0,11,11,
Tulsa,Superintendent of Public Instruction,Ivan Holmes,DEM,720173,0,0,4,4,
Tulsa,Superintendent of Public Instruction,Freda Deskin,DEM,720173,0,0,27,27,
Tulsa,U.S. Senate,Patrick Michael Hayes,DEM,720173,0,0,5,5,
Tulsa,U.S. Senate,Jim Rogers,DEM,720173,0,0,6,6,
Tulsa,U.S. Senate,Connie Johnson,DEM,720173,0,0,40,40,
Tulsa,Governor,Dax Ewbank,REP,720173,0,0,23,23,
Tulsa,Governor,Chad Moody,REP,720173,0,0,42,42,
Tulsa,Governor,Mary Fallin,REP,720173,0,0,302,302,
Tulsa,Superintendent of Public Instruction,Brian Kelly,REP,720173,0,0,45,45,
Tulsa,Superintendent of Public Instruction,Janet Costello Barresi,REP,720173,0,0,75,75,
Tulsa,Superintendent of Public Instruction,Joy Hofmeister,REP,720173,0,0,242,242,
Tulsa,Insurance Commissioner,Bill Viner,REP,720173,0,0,64,64,
Tulsa,Insurance Commissioner,John Doak,REP,720173,0,0,275,275,
Tulsa,Corporation Commissioner,Todd Hiett,REP,720173,0,0,202,202,
Tulsa,Corporation Commissioner,Cliff Branan,REP,720173,0,0,125,125,
Tulsa,U.S. Senate,Evelyn Rogers,REP,720173,0,0,15,15,
Tulsa,U.S. Senate,Rob Moye,REP,720173,0,0,7,7,
Tulsa,U.S. Senate,D. Jean Mcbride-Samuels,REP,720173,0,0,5,5,
Tulsa,U.S. Senate,Jim Inhofe,REP,720173,0,0,331,331,
Tulsa,U.S. Senate,Erick Paul Wyatt,REP,720173,0,0,2,2,
Tulsa,U.S. Senate,Andy Craig,REP,720173,0,0,4,4,
Tulsa,U.S. Senate,T. Shannon,REP,720173,0,0,125,125,
Tulsa,U.S. Senate,Randy Brogdon,REP,720173,0,0,21,21,
Tulsa,U.S. Senate,Eric Mccray,REP,720173,0,0,0,0,
Tulsa,U.S. Senate,Kevin Crow,REP,720173,0,0,0,0,
Tulsa,U.S. Senate,James Lankford,REP,720173,0,0,220,220,
Tulsa,U.S. Senate,Jason Weger,REP,720173,0,0,1,1,
Tulsa,State House,Melissa Abdo,REP,720173,0,0,137,137,69
Tulsa,State House,Paul Bowman,REP,720173,0,0,97,97,69
Tulsa,State House,Chuck Strohm,REP,720173,0,0,119,119,69
Tulsa,Superintendent of Public Instruction,John Cox,DEM,720174,0,0,0,0,
Tulsa,Superintendent of Public Instruction,Jack Jr.,DEM,720174,0,0,0,0,
Tulsa,Superintendent of Public Instruction,Ivan Holmes,DEM,720174,0,0,0,0,
Tulsa,Superintendent of Public Instruction,Freda Deskin,DEM,720174,0,0,0,0,
Tulsa,U.S. Senate,Patrick Michael Hayes,DEM,720174,0,0,0,0,
Tulsa,U.S. Senate,Jim Rogers,DEM,720174,0,0,0,0,
Tulsa,U.S. Senate,Connie Johnson,DEM,720174,0,0,0,0,
Tulsa,Governor,Dax Ewbank,REP,720174,0,0,0,0,
Tulsa,Governor,Chad Moody,REP,720174,0,0,0,0,
Tulsa,Governor,Mary Fallin,REP,720174,0,0,0,0,
Tulsa,Superintendent of Public Instruction,Brian Kelly,REP,720174,0,0,0,0,
Tulsa,Superintendent of Public Instruction,Janet Costello Barresi,REP,720174,0,0,0,0,
Tulsa,Superintendent of Public Instruction,Joy Hofmeister,REP,720174,0,0,0,0,
Tulsa,Insurance Commissioner,Bill Viner,REP,720174,0,0,0,0,
Tulsa,Insurance Commissioner,John Doak,REP,720174,0,0,0,0,
Tulsa,Corporation Commissioner,Todd Hiett,REP,720174,0,0,0,0,
Tulsa,Corporation Commissioner,Cliff Branan,REP,720174,0,0,0,0,
Tulsa,U.S. Senate,Evelyn Rogers,REP,720174,0,0,0,0,
Tulsa,U.S. Senate,Rob Moye,REP,720174,0,0,0,0,
Tulsa,U.S. Senate,D. Jean Mcbride-Samuels,REP,720174,0,0,0,0,
Tulsa,U.S. Senate,Jim Inhofe,REP,720174,0,0,0,0,
Tulsa,U.S. Senate,Erick Paul Wyatt,REP,720174,0,0,0,0,
Tulsa,U.S. Senate,Andy Craig,REP,720174,0,0,0,0,
Tulsa,U.S. Senate,T. Shannon,REP,720174,0,0,0,0,
Tulsa,U.S. Senate,Randy Brogdon,REP,720174,0,0,0,0,
Tulsa,U.S. Senate,Eric Mccray,REP,720174,0,0,0,0,
Tulsa,U.S. Senate,Kevin Crow,REP,720174,0,0,0,0,
Tulsa,U.S. Senate,James Lankford,REP,720174,0,0,0,0,
Tulsa,U.S. Senate,Jason Weger,REP,720174,0,0,0,0,
Tulsa,Superintendent of Public Instruction,John Cox,DEM,720175,0,0,0,0,
Tulsa,Superintendent of Public Instruction,Jack Jr.,DEM,720175,0,0,0,0,
Tulsa,Superintendent of Public Instruction,Ivan Holmes,DEM,720175,0,0,0,0,
Tulsa,Superintendent of Public Instruction,Freda Deskin,DEM,720175,0,0,0,0,
Tulsa,U.S. Senate,Patrick Michael Hayes,DEM,720175,0,0,0,0,
Tulsa,U.S. Senate,Jim Rogers,DEM,720175,0,0,0,0,
Tulsa,U.S. Senate,Connie Johnson,DEM,720175,0,0,0,0,
Tulsa,Governor,Dax Ewbank,REP,720175,0,0,0,0,
Tulsa,Governor,Chad Moody,REP,720175,0,0,0,0,
Tulsa,Governor,Mary Fallin,REP,720175,0,0,0,0,
Tulsa,Superintendent of Public Instruction,Brian Kelly,REP,720175,0,0,0,0,
Tulsa,Superintendent of Public Instruction,Janet Costello Barresi,REP,720175,0,0,0,0,
Tulsa,Superintendent of Public Instruction,Joy Hofmeister,REP,720175,0,0,0,0,
Tulsa,Insurance Commissioner,Bill Viner,REP,720175,0,0,0,0,
Tulsa,Insurance Commissioner,John Doak,REP,720175,0,0,0,0,
Tulsa,Corporation Commissioner,Todd Hiett,REP,720175,0,0,0,0,
Tulsa,Corporation Commissioner,Cliff Branan,REP,720175,0,0,0,0,
Tulsa,U.S. Senate,Evelyn Rogers,REP,720175,0,0,0,0,
Tulsa,U.S. Senate,Rob Moye,REP,720175,0,0,0,0,
Tulsa,U.S. Senate,D. Jean Mcbride-Samuels,REP,720175,0,0,0,0,
Tulsa,U.S. Senate,Jim Inhofe,REP,720175,0,0,0,0,
Tulsa,U.S. Senate,Erick Paul Wyatt,REP,720175,0,0,0,0,
Tulsa,U.S. Senate,Andy Craig,REP,720175,0,0,0,0,
Tulsa,U.S. Senate,T. Shannon,REP,720175,0,0,0,0,
Tulsa,U.S. Senate,Randy Brogdon,REP,720175,0,0,0,0,
Tulsa,U.S. Senate,Eric Mccray,REP,720175,0,0,0,0,
Tulsa,U.S. Senate,Kevin Crow,REP,720175,0,0,0,0,
Tulsa,U.S. Senate,James Lankford,REP,720175,0,0,0,0,
Tulsa,U.S. Senate,Jason Weger,REP,720175,0,0,0,0,
Tulsa,Superintendent of Public Instruction,John Cox,DEM,720176,0,0,0,0,
Tulsa,Superintendent of Public Instruction,Jack Jr.,DEM,720176,0,0,0,0,
Tulsa,Superintendent of Public Instruction,Ivan Holmes,DEM,720176,0,0,0,0,
Tulsa,Superintendent of Public Instruction,Freda Deskin,DEM,720176,0,0,0,0,
Tulsa,U.S. Senate,Patrick Michael Hayes,DEM,720176,0,0,0,0,
Tulsa,U.S. Senate,Jim Rogers,DEM,720176,0,0,0,0,
Tulsa,U.S. Senate,Connie Johnson,DEM,720176,0,0,0,0,
Tulsa,Governor,Dax Ewbank,REP,720176,0,0,0,0,
Tulsa,Governor,Chad Moody,REP,720176,0,0,0,0,
Tulsa,Governor,Mary Fallin,REP,720176,0,0,0,0,
Tulsa,Superintendent of Public Instruction,Brian Kelly,REP,720176,0,0,0,0,
Tulsa,Superintendent of Public Instruction,Janet Costello Barresi,REP,720176,0,0,0,0,
Tulsa,Superintendent of Public Instruction,Joy Hofmeister,REP,720176,0,0,0,0,
Tulsa,Insurance Commissioner,Bill Viner,REP,720176,0,0,0,0,
Tulsa,Insurance Commissioner,John Doak,REP,720176,0,0,0,0,
Tulsa,Corporation Commissioner,Todd Hiett,REP,720176,0,0,0,0,
Tulsa,Corporation Commissioner,Cliff Branan,REP,720176,0,0,0,0,
Tulsa,U.S. Senate,Evelyn Rogers,REP,720176,0,0,0,0,
Tulsa,U.S. Senate,Rob Moye,REP,720176,0,0,0,0,
Tulsa,U.S. Senate,D. Jean Mcbride-Samuels,REP,720176,0,0,0,0,
Tulsa,U.S. Senate,Jim Inhofe,REP,720176,0,0,0,0,
Tulsa,U.S. Senate,Erick Paul Wyatt,REP,720176,0,0,0,0,
Tulsa,U.S. Senate,Andy Craig,REP,720176,0,0,0,0,
Tulsa,U.S. Senate,T. Shannon,REP,720176,0,0,0,0,
Tulsa,U.S. Senate,Randy Brogdon,REP,720176,0,0,0,0,
Tulsa,U.S. Senate,Eric Mccray,REP,720176,0,0,0,0,
Tulsa,U.S. Senate,Kevin Crow,REP,720176,0,0,0,0,
Tulsa,U.S. Senate,James Lankford,REP,720176,0,0,0,0,
Tulsa,U.S. Senate,Jason Weger,REP,720176,0,0,0,0,
Tulsa,Superintendent of Public Instruction,John Cox,DEM,720351,0,0,22,22,
Tulsa,Superintendent of Public Instruction,Jack Jr.,DEM,720351,0,0,5,5,
Tulsa,Superintendent of Public Instruction,Ivan Holmes,DEM,720351,0,0,3,3,
Tulsa,Superintendent of Public Instruction,Freda Deskin,DEM,720351,0,0,25,25,
Tulsa,U.S. Senate,Patrick Michael Hayes,DEM,720351,0,0,12,12,
Tulsa,U.S. Senate,Jim Rogers,DEM,720351,0,0,21,21,
Tulsa,U.S. Senate,Connie Johnson,DEM,720351,0,0,21,21,
Tulsa,Governor,Dax Ewbank,REP,720351,0,0,42,42,
Tulsa,Governor,Chad Moody,REP,720351,0,0,42,42,
Tulsa,Governor,Mary Fallin,REP,720351,0,0,265,265,
Tulsa,Superintendent of Public Instruction,Brian Kelly,REP,720351,0,0,53,53,
Tulsa,Superintendent of Public Instruction,Janet Costello Barresi,REP,720351,0,0,53,53,
Tulsa,Superintendent of Public Instruction,Joy Hofmeister,REP,720351,0,0,247,247,
Tulsa,Insurance Commissioner,Bill Viner,REP,720351,0,0,58,58,
Tulsa,Insurance Commissioner,John Doak,REP,720351,0,0,275,275,
Tulsa,Corporation Commissioner,Todd Hiett,REP,720351,0,0,187,187,
Tulsa,Corporation Commissioner,Cliff Branan,REP,720351,0,0,136,136,
Tulsa,U.S. Senate,Evelyn Rogers,REP,720351,0,0,12,12,
Tulsa,U.S. Senate,Rob Moye,REP,720351,0,0,8,8,
Tulsa,U.S. Senate,D. Jean Mcbride-Samuels,REP,720351,0,0,2,2,
Tulsa,U.S. Senate,Jim Inhofe,REP,720351,0,0,313,313,
Tulsa,U.S. Senate,Erick Paul Wyatt,REP,720351,0,0,15,15,
Tulsa,U.S. Senate,Andy Craig,REP,720351,0,0,5,5,
Tulsa,U.S. Senate,T. Shannon,REP,720351,0,0,174,174,
Tulsa,U.S. Senate,Randy Brogdon,REP,720351,0,0,21,21,
Tulsa,U.S. Senate,Eric Mccray,REP,720351,0,0,4,4,
Tulsa,U.S. Senate,Kevin Crow,REP,720351,0,0,2,2,
Tulsa,U.S. Senate,James Lankford,REP,720351,0,0,154,154,
Tulsa,U.S. Senate,Jason Weger,REP,720351,0,0,1,1,
Tulsa,State House,Melissa Abdo,REP,720351,0,0,143,143,69
Tulsa,State House,Paul Bowman,REP,720351,0,0,90,90,69
Tulsa,State House,Chuck Strohm,REP,720351,0,0,105,105,69
Tulsa,Superintendent of Public Instruction,John Cox,DEM,720352,0,0,9,9,
Tulsa,Superintendent of Public Instruction,Jack Jr.,DEM,720352,0,0,4,4,
Tulsa,Superintendent of Public Instruction,Ivan Holmes,DEM,720352,0,0,1,1,
Tulsa,Superintendent of Public Instruction,Freda Deskin,DEM,720352,0,0,19,19,
Tulsa,U.S. Senate,Patrick Michael Hayes,DEM,720352,0,0,7,7,
Tulsa,U.S. Senate,Jim Rogers,DEM,720352,0,0,7,7,
Tulsa,U.S. Senate,Connie Johnson,DEM,720352,0,0,17,17,
Tulsa,Governor,Dax Ewbank,REP,720352,0,0,11,11,
Tulsa,Governor,Chad Moody,REP,720352,0,0,25,25,
Tulsa,Governor,Mary Fallin,REP,720352,0,0,154,154,
Tulsa,Superintendent of Public Instruction,Brian Kelly,REP,720352,0,0,25,25,
Tulsa,Superintendent of Public Instruction,Janet Costello Barresi,REP,720352,0,0,37,37,
Tulsa,Superintendent of Public Instruction,Joy Hofmeister,REP,720352,0,0,122,122,
Tulsa,Insurance Commissioner,Bill Viner,REP,720352,0,0,33,33,
Tulsa,Insurance Commissioner,John Doak,REP,720352,0,0,140,140,
Tulsa,Corporation Commissioner,Todd Hiett,REP,720352,0,0,107,107,
Tulsa,Corporation Commissioner,Cliff Branan,REP,720352,0,0,67,67,
Tulsa,U.S. Senate,Evelyn Rogers,REP,720352,0,0,6,6,
Tulsa,U.S. Senate,Rob Moye,REP,720352,0,0,3,3,
Tulsa,U.S. Senate,D. Jean Mcbride-Samuels,REP,720352,0,0,4,4,
Tulsa,U.S. Senate,Jim Inhofe,REP,720352,0,0,169,169,
Tulsa,U.S. Senate,Erick Paul Wyatt,REP,720352,0,0,6,6,
Tulsa,U.S. Senate,Andy Craig,REP,720352,0,0,0,0,
Tulsa,U.S. Senate,T. Shannon,REP,720352,0,0,73,73,
Tulsa,U.S. Senate,Randy Brogdon,REP,720352,0,0,19,19,
Tulsa,U.S. Senate,Eric Mccray,REP,720352,0,0,3,3,
Tulsa,U.S. Senate,Kevin Crow,REP,720352,0,0,1,1,
Tulsa,U.S. Senate,James Lankford,REP,720352,0,0,94,94,
Tulsa,U.S. Senate,Jason Weger,REP,720352,0,0,0,0,
Tulsa,Superintendent of Public Instruction,John Cox,DEM,720353,0,0,4,4,
Tulsa,Superintendent of Public Instruction,Jack Jr.,DEM,720353,0,0,1,1,
Tulsa,Superintendent of Public Instruction,Ivan Holmes,DEM,720353,0,0,0,0,
Tulsa,Superintendent of Public Instruction,Freda Deskin,DEM,720353,0,0,4,4,
Tulsa,U.S. Senate,Patrick Michael Hayes,DEM,720353,0,0,1,1,
Tulsa,U.S. Senate,Jim Rogers,DEM,720353,0,0,2,2,
Tulsa,U.S. Senate,Connie Johnson,DEM,720353,0,0,6,6,
Tulsa,Governor,Dax Ewbank,REP,720353,0,0,1,1,
Tulsa,Governor,Chad Moody,REP,720353,0,0,4,4,
Tulsa,Governor,Mary Fallin,REP,720353,0,0,43,43,
Tulsa,Superintendent of Public Instruction,Brian Kelly,REP,720353,0,0,7,7,
Tulsa,Superintendent of Public Instruction,Janet Costello Barresi,REP,720353,0,0,10,10,
Tulsa,Superintendent of Public Instruction,Joy Hofmeister,REP,720353,0,0,29,29,
Tulsa,Insurance Commissioner,Bill Viner,REP,720353,0,0,7,7,
Tulsa,Insurance Commissioner,John Doak,REP,720353,0,0,35,35,
Tulsa,Corporation Commissioner,Todd Hiett,REP,720353,0,0,29,29,
Tulsa,Corporation Commissioner,Cliff Branan,REP,720353,0,0,15,15,
Tulsa,U.S. Senate,Evelyn Rogers,REP,720353,0,0,5,5,
Tulsa,U.S. Senate,Rob Moye,REP,720353,0,0,0,0,
Tulsa,U.S. Senate,D. Jean Mcbride-Samuels,REP,720353,0,0,0,0,
Tulsa,U.S. Senate,Jim Inhofe,REP,720353,0,0,42,42,
Tulsa,U.S. Senate,Erick Paul Wyatt,REP,720353,0,0,2,2,
Tulsa,U.S. Senate,Andy Craig,REP,720353,0,0,1,1,
Tulsa,U.S. Senate,T. Shannon,REP,720353,0,0,16,16,
Tulsa,U.S. Senate,Randy Brogdon,REP,720353,0,0,10,10,
Tulsa,U.S. Senate,Eric Mccray,REP,720353,0,0,0,0,
Tulsa,U.S. Senate,Kevin Crow,REP,720353,0,0,0,0,
Tulsa,U.S. Senate,James Lankford,REP,720353,0,0,21,21,
Tulsa,U.S. Senate,Jason Weger,REP,720353,0,0,1,1,
Tulsa,Superintendent of Public Instruction,John Cox,DEM,720354,0,0,7,7,
Tulsa,Superintendent of Public Instruction,Jack Jr.,DEM,720354,0,0,0,0,
Tulsa,Superintendent of Public Instruction,Ivan Holmes,DEM,720354,0,0,1,1,
Tulsa,Superintendent of Public Instruction,Freda Deskin,DEM,720354,0,0,1,1,
Tulsa,U.S. Senate,Patrick Michael Hayes,DEM,720354,0,0,1,1,
Tulsa,U.S. Senate,Jim Rogers,DEM,720354,0,0,4,4,
Tulsa,U.S. Senate,Connie Johnson,DEM,720354,0,0,5,5,
Tulsa,Governor,Dax Ewbank,REP,720354,0,0,3,3,
Tulsa,Governor,Chad Moody,REP,720354,0,0,5,5,
Tulsa,Governor,Mary Fallin,REP,720354,0,0,23,23,
Tulsa,Superintendent of Public Instruction,Brian Kelly,REP,720354,0,0,5,5,
Tulsa,Superintendent of Public Instruction,Janet Costello Barresi,REP,720354,0,0,4,4,
Tulsa,Superintendent of Public Instruction,Joy Hofmeister,REP,720354,0,0,22,22,
Tulsa,Insurance Commissioner,Bill Viner,REP,720354,0,0,5,5,
Tulsa,Insurance Commissioner,John Doak,REP,720354,0,0,25,25,
Tulsa,Corporation Commissioner,Todd Hiett,REP,720354,0,0,19,19,
Tulsa,Corporation Commissioner,Cliff Branan,REP,720354,0,0,12,12,
Tulsa,U.S. Senate,Evelyn Rogers,REP,720354,0,0,1,1,
Tulsa,U.S. Senate,Rob Moye,REP,720354,0,0,0,0,
Tulsa,U.S. Senate,D. Jean Mcbride-Samuels,REP,720354,0,0,0,0,
Tulsa,U.S. Senate,Jim Inhofe,REP,720354,0,0,29,29,
Tulsa,U.S. Senate,Erick Paul Wyatt,REP,720354,0,0,2,2,
Tulsa,U.S. Senate,Andy Craig,REP,720354,0,0,1,1,
Tulsa,U.S. Senate,T. Shannon,REP,720354,0,0,17,17,
Tulsa,U.S. Senate,Randy Brogdon,REP,720354,0,0,2,2,
Tulsa,U.S. Senate,Eric Mccray,REP,720354,0,0,1,1,
Tulsa,U.S. Senate,Kevin Crow,REP,720354,0,0,0,0,
Tulsa,U.S. Senate,James Lankford,REP,720354,0,0,10,10,
Tulsa,U.S. Senate,Jason Weger,REP,720354,0,0,1,1,
Tulsa,Superintendent of Public Instruction,John Cox,DEM,720355,0,0,4,4,
Tulsa,Superintendent of Public Instruction,Jack Jr.,DEM,720355,0,0,0,0,
Tulsa,Superintendent of Public Instruction,Ivan Holmes,DEM,720355,0,0,1,1,
Tulsa,Superintendent of Public Instruction,Freda Deskin,DEM,720355,0,0,3,3,
Tulsa,U.S. Senate,Patrick Michael Hayes,DEM,720355,0,0,1,1,
Tulsa,U.S. Senate,Jim Rogers,DEM,720355,0,0,3,3,
Tulsa,U.S. Senate,Connie Johnson,DEM,720355,0,0,4,4,
Tulsa,Governor,Dax Ewbank,REP,720355,0,0,8,8,
Tulsa,Governor,Chad Moody,REP,720355,0,0,11,11,
Tulsa,Governor,Mary Fallin,REP,720355,0,0,25,25,
Tulsa,Superintendent of Public Instruction,Brian Kelly,REP,720355,0,0,8,8,
Tulsa,Superintendent of Public Instruction,Janet Costello Barresi,REP,720355,0,0,1,1,
Tulsa,Superintendent of Public Instruction,Joy Hofmeister,REP,720355,0,0,35,35,
Tulsa,Insurance Commissioner,Bill Viner,REP,720355,0,0,8,8,
Tulsa,Insurance Commissioner,John Doak,REP,720355,0,0,32,32,
Tulsa,Corporation Commissioner,Todd Hiett,REP,720355,0,0,21,21,
Tulsa,Corporation Commissioner,Cliff Branan,REP,720355,0,0,22,22,
Tulsa,U.S. Senate,Evelyn Rogers,REP,720355,0,0,3,3,
Tulsa,U.S. Senate,Rob Moye,REP,720355,0,0,0,0,
Tulsa,U.S. Senate,D. Jean Mcbride-Samuels,REP,720355,0,0,1,1,
Tulsa,U.S. Senate,Jim Inhofe,REP,720355,0,0,33,33,
Tulsa,U.S. Senate,Erick Paul Wyatt,REP,720355,0,0,6,6,
Tulsa,U.S. Senate,Andy Craig,REP,720355,0,0,0,0,
Tulsa,U.S. Senate,T. Shannon,REP,720355,0,0,25,25,
Tulsa,U.S. Senate,Randy Brogdon,REP,720355,0,0,2,2,
Tulsa,U.S. Senate,Eric Mccray,REP,720355,0,0,0,0,
Tulsa,U.S. Senate,Kevin Crow,REP,720355,0,0,0,0,
Tulsa,U.S. Senate,James Lankford,REP,720355,0,0,16,16,
Tulsa,U.S. Senate,Jason Weger,REP,720355,0,0,2,2,
Tulsa,Superintendent of Public Instruction,John Cox,DEM,720356,0,0,5,5,
Tulsa,Superintendent of Public Instruction,Jack Jr.,DEM,720356,0,0,0,0,
Tulsa,Superintendent of Public Instruction,Ivan Holmes,DEM,720356,0,0,0,0,
Tulsa,Superintendent of Public Instruction,Freda Deskin,DEM,720356,0,0,3,3,
Tulsa,U.S. Senate,Patrick Michael Hayes,DEM,720356,0,0,3,3,
Tulsa,U.S. Senate,Jim Rogers,DEM,720356,0,0,1,1,
Tulsa,U.S. Senate,Connie Johnson,DEM,720356,0,0,3,3,
Tulsa,Governor,Dax Ewbank,REP,720356,0,0,8,8,
Tulsa,Governor,Chad Moody,REP,720356,0,0,6,6,
Tulsa,Governor,Mary Fallin,REP,720356,0,0,39,39,
Tulsa,Superintendent of Public Instruction,Brian Kelly,REP,720356,0,0,7,7,
Tulsa,Superintendent of Public Instruction,Janet Costello Barresi,REP,720356,0,0,5,5,
Tulsa,Superintendent of Public Instruction,Joy Hofmeister,REP,720356,0,0,41,41,
Tulsa,Insurance Commissioner,Bill Viner,REP,720356,0,0,6,6,
Tulsa,Insurance Commissioner,John Doak,REP,720356,0,0,44,44,
Tulsa,Corporation Commissioner,Todd Hiett,REP,720356,0,0,32,32,
Tulsa,Corporation Commissioner,Cliff Branan,REP,720356,0,0,20,20,
Tulsa,U.S. Senate,Evelyn Rogers,REP,720356,0,0,2,2,
Tulsa,U.S. Senate,Rob Moye,REP,720356,0,0,1,1,
Tulsa,U.S. Senate,D. Jean Mcbride-Samuels,REP,720356,0,0,1,1,
Tulsa,U.S. Senate,Jim Inhofe,REP,720356,0,0,47,47,
Tulsa,U.S. Senate,Erick Paul Wyatt,REP,720356,0,0,2,2,
Tulsa,U.S. Senate,Andy Craig,REP,720356,0,0,0,0,
Tulsa,U.S. Senate,T. Shannon,REP,720356,0,0,25,25,
Tulsa,U.S. Senate,Randy Brogdon,REP,720356,0,0,2,2,
Tulsa,U.S. Senate,Eric Mccray,REP,720356,0,0,0,0,
Tulsa,U.S. Senate,Kevin Crow,REP,720356,0,0,0,0,
Tulsa,U.S. Senate,James Lankford,REP,720356,0,0,26,26,
Tulsa,U.S. Senate,Jason Weger,REP,720356,0,0,0,0,
Tulsa,Superintendent of Public Instruction,John Cox,DEM,720400,0,0,12,12,
Tulsa,Superintendent of Public Instruction,Jack Jr.,DEM,720400,0,0,3,3,
Tulsa,Superintendent of Public Instruction,Ivan Holmes,DEM,720400,0,0,1,1,
Tulsa,Superintendent of Public Instruction,Freda Deskin,DEM,720400,0,0,23,23,
Tulsa,U.S. Senate,Patrick Michael Hayes,DEM,720400,0,0,7,7,
Tulsa,U.S. Senate,Jim Rogers,DEM,720400,0,0,11,11,
Tulsa,U.S. Senate,Connie Johnson,DEM,720400,0,0,20,20,
Tulsa,Governor,Dax Ewbank,REP,720400,0,0,29,29,
Tulsa,Governor,Chad Moody,REP,720400,0,0,40,40,
Tulsa,Governor,Mary Fallin,REP,720400,0,0,263,263,
Tulsa,Superintendent of Public Instruction,Brian Kelly,REP,720400,0,0,51,51,
Tulsa,Superintendent of Public Instruction,Janet Costello Barresi,REP,720400,0,0,39,39,
Tulsa,Superintendent of Public Instruction,Joy Hofmeister,REP,720400,0,0,243,243,
Tulsa,Insurance Commissioner,Bill Viner,REP,720400,0,0,54,54,
Tulsa,Insurance Commissioner,John Doak,REP,720400,0,0,243,243,
Tulsa,Corporation Commissioner,Todd Hiett,REP,720400,0,0,182,182,
Tulsa,Corporation Commissioner,Cliff Branan,REP,720400,0,0,117,117,
Tulsa,U.S. Senate,Evelyn Rogers,REP,720400,0,0,10,10,
Tulsa,U.S. Senate,Rob Moye,REP,720400,0,0,2,2,
Tulsa,U.S. Senate,D. Jean Mcbride-Samuels,REP,720400,0,0,7,7,
Tulsa,U.S. Senate,Jim Inhofe,REP,720400,0,0,302,302,
Tulsa,U.S. Senate,Erick Paul Wyatt,REP,720400,0,0,10,10,
Tulsa,U.S. Senate,Andy Craig,REP,720400,0,0,1,1,
Tulsa,U.S. Senate,T. Shannon,REP,720400,0,0,125,125,
Tulsa,U.S. Senate,Randy Brogdon,REP,720400,0,0,31,31,
Tulsa,U.S. Senate,Eric Mccray,REP,720400,0,0,1,1,
Tulsa,U.S. Senate,Kevin Crow,REP,720400,0,0,0,0,
Tulsa,U.S. Senate,James Lankford,REP,720400,0,0,179,179,
Tulsa,U.S. Senate,Jason Weger,REP,720400,0,0,1,1,
Tulsa,State House,Melissa Abdo,REP,720400,0,0,125,125,69
Tulsa,State House,Paul Bowman,REP,720400,0,0,95,95,69
Tulsa,State House,Chuck Strohm,REP,720400,0,0,82,82,69
Tulsa,Superintendent of Public Instruction,John Cox,DEM,720401,0,0,12,12,
Tulsa,Superintendent of Public Instruction,Jack Jr.,DEM,720401,0,0,5,5,
Tulsa,Superintendent of Public Instruction,Ivan Holmes,DEM,720401,0,0,3,3,
Tulsa,Superintendent of Public Instruction,Freda Deskin,DEM,720401,0,0,21,21,
Tulsa,U.S. Senate,Patrick Michael Hayes,DEM,720401,0,0,9,9,
Tulsa,U.S. Senate,Jim Rogers,DEM,720401,0,0,11,11,
Tulsa,U.S. Senate,Connie Johnson,DEM,720401,0,0,19,19,
Tulsa,Governor,Dax Ewbank,REP,720401,0,0,21,21,
Tulsa,Governor,Chad Moody,REP,720401,0,0,28,28,
Tulsa,Governor,Mary Fallin,REP,720401,0,0,298,298,
Tulsa,Superintendent of Public Instruction,Brian Kelly,REP,720401,0,0,30,30,
Tulsa,Superintendent of Public Instruction,Janet Costello Barresi,REP,720401,0,0,61,61,
Tulsa,Superintendent of Public Instruction,Joy Hofmeister,REP,720401,0,0,258,258,
Tulsa,Insurance Commissioner,Bill Viner,REP,720401,0,0,53,53,
Tulsa,Insurance Commissioner,John Doak,REP,720401,0,0,264,264,
Tulsa,Corporation Commissioner,Todd Hiett,REP,720401,0,0,186,186,
Tulsa,Corporation Commissioner,Cliff Branan,REP,720401,0,0,129,129,
Tulsa,U.S. Senate,Evelyn Rogers,REP,720401,0,0,11,11,
Tulsa,U.S. Senate,Rob Moye,REP,720401,0,0,5,5,
Tulsa,U.S. Senate,D. Jean Mcbride-Samuels,REP,720401,0,0,4,4,
Tulsa,U.S. Senate,Jim Inhofe,REP,720401,0,0,324,324,
Tulsa,U.S. Senate,Erick Paul Wyatt,REP,720401,0,0,6,6,
Tulsa,U.S. Senate,Andy Craig,REP,720401,0,0,4,4,
Tulsa,U.S. Senate,T. Shannon,REP,720401,0,0,128,128,
Tulsa,U.S. Senate,Randy Brogdon,REP,720401,0,0,23,23,
Tulsa,U.S. Senate,Eric Mccray,REP,720401,0,0,0,0,
Tulsa,U.S. Senate,Kevin Crow,REP,720401,0,0,1,1,
Tulsa,U.S. Senate,James Lankford,REP,720401,0,0,194,194,
Tulsa,U.S. Senate,Jason Weger,REP,720401,0,0,1,1,
Tulsa,Superintendent of Public Instruction,John Cox,DEM,720402,0,0,14,14,
Tulsa,Superintendent of Public Instruction,Jack Jr.,DEM,720402,0,0,1,1,
Tulsa,Superintendent of Public Instruction,Ivan Holmes,DEM,720402,0,0,0,0,
Tulsa,Superintendent of Public Instruction,Freda Deskin,DEM,720402,0,0,13,13,
Tulsa,U.S. Senate,Patrick Michael Hayes,DEM,720402,0,0,5,5,
Tulsa,U.S. Senate,Jim Rogers,DEM,720402,0,0,5,5,
Tulsa,U.S. Senate,Connie Johnson,DEM,720402,0,0,18,18,
Tulsa,Governor,Dax Ewbank,REP,720402,0,0,13,13,
Tulsa,Governor,Chad Moody,REP,720402,0,0,17,17,
Tulsa,Governor,Mary Fallin,REP,720402,0,0,94,94,
Tulsa,Superintendent of Public Instruction,Brian Kelly,REP,720402,0,0,14,14,
Tulsa,Superintendent of Public Instruction,Janet Costello Barresi,REP,720402,0,0,19,19,
Tulsa,Superintendent of Public Instruction,Joy Hofmeister,REP,720402,0,0,94,94,
Tulsa,Insurance Commissioner,Bill Viner,REP,720402,0,0,23,23,
Tulsa,Insurance Commissioner,John Doak,REP,720402,0,0,93,93,
Tulsa,Corporation Commissioner,Todd Hiett,REP,720402,0,0,65,65,
Tulsa,Corporation Commissioner,Cliff Branan,REP,720402,0,0,46,46,
Tulsa,U.S. Senate,Evelyn Rogers,REP,720402,0,0,5,5,
Tulsa,U.S. Senate,Rob Moye,REP,720402,0,0,1,1,
Tulsa,U.S. Senate,D. Jean Mcbride-Samuels,REP,720402,0,0,3,3,
Tulsa,U.S. Senate,Jim Inhofe,REP,720402,0,0,112,112,
Tulsa,U.S. Senate,Erick Paul Wyatt,REP,720402,0,0,4,4,
Tulsa,U.S. Senate,Andy Craig,REP,720402,0,0,1,1,
Tulsa,U.S. Senate,T. Shannon,REP,720402,0,0,51,51,
Tulsa,U.S. Senate,Randy Brogdon,REP,720402,0,0,12,12,
Tulsa,U.S. Senate,Eric Mccray,REP,720402,0,0,0,0,
Tulsa,U.S. Senate,Kevin Crow,REP,720402,0,0,2,2,
Tulsa,U.S. Senate,James Lankford,REP,720402,0,0,61,61,
Tulsa,U.S. Senate,Jason Weger,REP,720402,0,0,0,0,
Tulsa,State House,Melissa Abdo,REP,720402,0,0,30,30,69
Tulsa,State House,Paul Bowman,REP,720402,0,0,31,31,69
Tulsa,State House,Chuck Strohm,REP,720402,0,0,56,56,69
Tulsa,Superintendent of Public Instruction,John Cox,DEM,720403,0,0,21,21,
Tulsa,Superintendent of Public Instruction,Jack Jr.,DEM,720403,0,0,12,12,
Tulsa,Superintendent of Public Instruction,Ivan Holmes,DEM,720403,0,0,2,2,
Tulsa,Superintendent of Public Instruction,Freda Deskin,DEM,720403,0,0,44,44,
Tulsa,U.S. Senate,Patrick Michael Hayes,DEM,720403,0,0,10,10,
Tulsa,U.S. Senate,Jim Rogers,DEM,720403,0,0,24,24,
Tulsa,U.S. Senate,Connie Johnson,DEM,720403,0,0,44,44,
Tulsa,Governor,Dax Ewbank,REP,720403,0,0,28,28,
Tulsa,Governor,Chad Moody,REP,720403,0,0,73,73,
Tulsa,Governor,Mary Fallin,REP,720403,0,0,336,336,
Tulsa,Superintendent of Public Instruction,Brian Kelly,REP,720403,0,0,70,70,
Tulsa,Superintendent of Public Instruction,Janet Costello Barresi,REP,720403,0,0,73,73,
Tulsa,Superintendent of Public Instruction,Joy Hofmeister,REP,720403,0,0,293,293,
Tulsa,Insurance Commissioner,Bill Viner,REP,720403,0,0,92,92,
Tulsa,Insurance Commissioner,John Doak,REP,720403,0,0,311,311,
Tulsa,Corporation Commissioner,Todd Hiett,REP,720403,0,0,234,234,
Tulsa,Corporation Commissioner,Cliff Branan,REP,720403,0,0,164,164,
Tulsa,U.S. Senate,Evelyn Rogers,REP,720403,0,0,22,22,
Tulsa,U.S. Senate,Rob Moye,REP,720403,0,0,3,3,
Tulsa,U.S. Senate,D. Jean Mcbride-Samuels,REP,720403,0,0,6,6,
Tulsa,U.S. Senate,Jim Inhofe,REP,720403,0,0,398,398,
Tulsa,U.S. Senate,Erick Paul Wyatt,REP,720403,0,0,9,9,
Tulsa,U.S. Senate,Andy Craig,REP,720403,0,0,6,6,
Tulsa,U.S. Senate,T. Shannon,REP,720403,0,0,207,207,
Tulsa,U.S. Senate,Randy Brogdon,REP,720403,0,0,40,40,
Tulsa,U.S. Senate,Eric Mccray,REP,720403,0,0,1,1,
Tulsa,U.S. Senate,Kevin Crow,REP,720403,0,0,2,2,
Tulsa,U.S. Senate,James Lankford,REP,720403,0,0,186,186,
Tulsa,U.S. Senate,Jason Weger,REP,720403,0,0,2,2,
Tulsa,Superintendent of Public Instruction,John Cox,DEM,720404,0,0,14,14,
Tulsa,Superintendent of Public Instruction,Jack Jr.,DEM,720404,0,0,2,2,
Tulsa,Superintendent of Public Instruction,Ivan Holmes,DEM,720404,0,0,1,1,
Tulsa,Superintendent of Public Instruction,Freda Deskin,DEM,720404,0,0,23,23,
Tulsa,U.S. Senate,Patrick Michael Hayes,DEM,720404,0,0,8,8,
Tulsa,U.S. Senate,Jim Rogers,DEM,720404,0,0,10,10,
Tulsa,U.S. Senate,Connie Johnson,DEM,720404,0,0,21,21,
Tulsa,Governor,Dax Ewbank,REP,720404,0,0,16,16,
Tulsa,Governor,Chad Moody,REP,720404,0,0,31,31,
Tulsa,Governor,Mary Fallin,REP,720404,0,0,284,284,
Tulsa,Superintendent of Public Instruction,Brian Kelly,REP,720404,0,0,36,36,
Tulsa,Superintendent of Public Instruction,Janet Costello Barresi,REP,720404,0,0,64,64,
Tulsa,Superintendent of Public Instruction,Joy Hofmeister,REP,720404,0,0,234,234,
Tulsa,Insurance Commissioner,Bill Viner,REP,720404,0,0,55,55,
Tulsa,Insurance Commissioner,John Doak,REP,720404,0,0,246,246,
Tulsa,Corporation Commissioner,Todd Hiett,REP,720404,0,0,177,177,
Tulsa,Corporation Commissioner,Cliff Branan,REP,720404,0,0,131,131,
Tulsa,U.S. Senate,Evelyn Rogers,REP,720404,0,0,13,13,
Tulsa,U.S. Senate,Rob Moye,REP,720404,0,0,3,3,
Tulsa,U.S. Senate,D. Jean Mcbride-Samuels,REP,720404,0,0,7,7,
Tulsa,U.S. Senate,Jim Inhofe,REP,720404,0,0,299,299,
Tulsa,U.S. Senate,Erick Paul Wyatt,REP,720404,0,0,13,13,
Tulsa,U.S. Senate,Andy Craig,REP,720404,0,0,1,1,
Tulsa,U.S. Senate,T. Shannon,REP,720404,0,0,133,133,
Tulsa,U.S. Senate,Randy Brogdon,REP,720404,0,0,10,10,
Tulsa,U.S. Senate,Eric Mccray,REP,720404,0,0,3,3,
Tulsa,U.S. Senate,Kevin Crow,REP,720404,0,0,0,0,
Tulsa,U.S. Senate,James Lankford,REP,720404,0,0,187,187,
Tulsa,U.S. Senate,Jason Weger,REP,720404,0,0,2,2,
Tulsa,Superintendent of Public Instruction,John Cox,DEM,720405,0,0,2,2,
Tulsa,Superintendent of Public Instruction,Jack Jr.,DEM,720405,0,0,0,0,
Tulsa,Superintendent of Public Instruction,Ivan Holmes,DEM,720405,0,0,0,0,
Tulsa,Superintendent of Public Instruction,Freda Deskin,DEM,720405,0,0,1,1,
Tulsa,U.S. Senate,Patrick Michael Hayes,DEM,720405,0,0,1,1,
Tulsa,U.S. Senate,Jim Rogers,DEM,720405,0,0,0,0,
Tulsa,U.S. Senate,Connie Johnson,DEM,720405,0,0,2,2,
Tulsa,Governor,Dax Ewbank,REP,720405,0,0,4,4,
Tulsa,Governor,Chad Moody,REP,720405,0,0,1,1,
Tulsa,Governor,Mary Fallin,REP,720405,0,0,16,16,
Tulsa,Superintendent of Public Instruction,Brian Kelly,REP,720405,0,0,3,3,
Tulsa,Superintendent of Public Instruction,Janet Costello Barresi,REP,720405,0,0,6,6,
Tulsa,Superintendent of Public Instruction,Joy Hofmeister,REP,720405,0,0,12,12,
Tulsa,Insurance Commissioner,Bill Viner,REP,720405,0,0,3,3,
Tulsa,Insurance Commissioner,John Doak,REP,720405,0,0,16,16,
Tulsa,Corporation Commissioner,Todd Hiett,REP,720405,0,0,11,11,
Tulsa,Corporation Commissioner,Cliff Branan,REP,720405,0,0,7,7,
Tulsa,U.S. Senate,Evelyn Rogers,REP,720405,0,0,0,0,
Tulsa,U.S. Senate,Rob Moye,REP,720405,0,0,0,0,
Tulsa,U.S. Senate,D. Jean Mcbride-Samuels,REP,720405,0,0,0,0,
Tulsa,U.S. Senate,Jim Inhofe,REP,720405,0,0,22,22,
Tulsa,U.S. Senate,Erick Paul Wyatt,REP,720405,0,0,0,0,
Tulsa,U.S. Senate,Andy Craig,REP,720405,0,0,0,0,
Tulsa,U.S. Senate,T. Shannon,REP,720405,0,0,9,9,
Tulsa,U.S. Senate,Randy Brogdon,REP,720405,0,0,2,2,
Tulsa,U.S. Senate,Eric Mccray,REP,720405,0,0,0,0,
Tulsa,U.S. Senate,Kevin Crow,REP,720405,0,0,0,0,
Tulsa,U.S. Senate,James Lankford,REP,720405,0,0,9,9,
Tulsa,U.S. Senate,Jason Weger,REP,720405,0,0,1,1,
Tulsa,Superintendent of Public Instruction,John Cox,DEM,720406,0,0,13,13,
Tulsa,Superintendent of Public Instruction,Jack Jr.,DEM,720406,0,0,3,3,
Tulsa,Superintendent of Public Instruction,Ivan Holmes,DEM,720406,0,0,5,5,
Tulsa,Superintendent of Public Instruction,Freda Deskin,DEM,720406,0,0,25,25,
Tulsa,U.S. Senate,Patrick Michael Hayes,DEM,720406,0,0,6,6,
Tulsa,U.S. Senate,Jim Rogers,DEM,720406,0,0,16,16,
Tulsa,U.S. Senate,Connie Johnson,DEM,720406,0,0,23,23,
Tulsa,Governor,Dax Ewbank,REP,720406,0,0,29,29,
Tulsa,Governor,Chad Moody,REP,720406,0,0,36,36,
Tulsa,Governor,Mary Fallin,REP,720406,0,0,258,258,
Tulsa,Superintendent of Public Instruction,Brian Kelly,REP,720406,0,0,29,29,
Tulsa,Superintendent of Public Instruction,Janet Costello Barresi,REP,720406,0,0,66,66,
Tulsa,Superintendent of Public Instruction,Joy Hofmeister,REP,720406,0,0,229,229,
Tulsa,Insurance Commissioner,Bill Viner,REP,720406,0,0,47,47,
Tulsa,Insurance Commissioner,John Doak,REP,720406,0,0,255,255,
Tulsa,Corporation Commissioner,Todd Hiett,REP,720406,0,0,178,178,
Tulsa,Corporation Commissioner,Cliff Branan,REP,720406,0,0,110,110,
Tulsa,U.S. Senate,Evelyn Rogers,REP,720406,0,0,7,7,
Tulsa,U.S. Senate,Rob Moye,REP,720406,0,0,5,5,
Tulsa,U.S. Senate,D. Jean Mcbride-Samuels,REP,720406,0,0,3,3,
Tulsa,U.S. Senate,Jim Inhofe,REP,720406,0,0,305,305,
Tulsa,U.S. Senate,Erick Paul Wyatt,REP,720406,0,0,5,5,
Tulsa,U.S. Senate,Andy Craig,REP,720406,0,0,0,0,
Tulsa,U.S. Senate,T. Shannon,REP,720406,0,0,116,116,
Tulsa,U.S. Senate,Randy Brogdon,REP,720406,0,0,21,21,
Tulsa,U.S. Senate,Eric Mccray,REP,720406,0,0,3,3,
Tulsa,U.S. Senate,Kevin Crow,REP,720406,0,0,1,1,
Tulsa,U.S. Senate,James Lankford,REP,720406,0,0,185,185,
Tulsa,U.S. Senate,Jason Weger,REP,720406,0,0,1,1,
Tulsa,Superintendent of Public Instruction,John Cox,DEM,720407,0,0,12,12,
Tulsa,Superintendent of Public Instruction,Jack Jr.,DEM,720407,0,0,5,5,
Tulsa,Superintendent of Public Instruction,Ivan Holmes,DEM,720407,0,0,2,2,
Tulsa,Superintendent of Public Instruction,Freda Deskin,DEM,720407,0,0,13,13,
Tulsa,U.S. Senate,Patrick Michael Hayes,DEM,720407,0,0,7,7,
Tulsa,U.S. Senate,Jim Rogers,DEM,720407,0,0,12,12,
Tulsa,U.S. Senate,Connie Johnson,DEM,720407,0,0,12,12,
Tulsa,Governor,Dax Ewbank,REP,720407,0,0,22,22,
Tulsa,Governor,Chad Moody,REP,720407,0,0,41,41,
Tulsa,Governor,Mary Fallin,REP,720407,0,0,236,236,
Tulsa,Superintendent of Public Instruction,Brian Kelly,REP,720407,0,0,42,42,
Tulsa,Superintendent of Public Instruction,Janet Costello Barresi,REP,720407,0,0,44,44,
Tulsa,Superintendent of Public Instruction,Joy Hofmeister,REP,720407,0,0,217,217,
Tulsa,Insurance Commissioner,Bill Viner,REP,720407,0,0,56,56,
Tulsa,Insurance Commissioner,John Doak,REP,720407,0,0,231,231,
Tulsa,Corporation Commissioner,Todd Hiett,REP,720407,0,0,177,177,
Tulsa,Corporation Commissioner,Cliff Branan,REP,720407,0,0,108,108,
Tulsa,U.S. Senate,Evelyn Rogers,REP,720407,0,0,19,19,
Tulsa,U.S. Senate,Rob Moye,REP,720407,0,0,5,5,
Tulsa,U.S. Senate,D. Jean Mcbride-Samuels,REP,720407,0,0,2,2,
Tulsa,U.S. Senate,Jim Inhofe,REP,720407,0,0,268,268,
Tulsa,U.S. Senate,Erick Paul Wyatt,REP,720407,0,0,8,8,
Tulsa,U.S. Senate,Andy Craig,REP,720407,0,0,5,5,
Tulsa,U.S. Senate,T. Shannon,REP,720407,0,0,109,109,
Tulsa,U.S. Senate,Randy Brogdon,REP,720407,0,0,21,21,
Tulsa,U.S. Senate,Eric Mccray,REP,720407,0,0,2,2,
Tulsa,U.S. Senate,Kevin Crow,REP,720407,0,0,3,3,
Tulsa,U.S. Senate,James Lankford,REP,720407,0,0,163,163,
Tulsa,U.S. Senate,Jason Weger,REP,720407,0,0,1,1,
Tulsa,Superintendent of Public Instruction,John Cox,DEM,720408,0,0,16,16,
Tulsa,Superintendent of Public Instruction,Jack Jr.,DEM,720408,0,0,1,1,
Tulsa,Superintendent of Public Instruction,Ivan Holmes,DEM,720408,0,0,4,4,
Tulsa,Superintendent of Public Instruction,Freda Deskin,DEM,720408,0,0,16,16,
Tulsa,U.S. Senate,Patrick Michael Hayes,DEM,720408,0,0,7,7,
Tulsa,U.S. Senate,Jim Rogers,DEM,720408,0,0,11,11,
Tulsa,U.S. Senate,Connie Johnson,DEM,720408,0,0,20,20,
Tulsa,Governor,Dax Ewbank,REP,720408,0,0,24,24,
Tulsa,Governor,Chad Moody,REP,720408,0,0,35,35,
Tulsa,Governor,Mary Fallin,REP,720408,0,0,262,262,
Tulsa,Superintendent of Public Instruction,Brian Kelly,REP,720408,0,0,47,47,
Tulsa,Superintendent of Public Instruction,Janet Costello Barresi,REP,720408,0,0,49,49,
Tulsa,Superintendent of Public Instruction,Joy Hofmeister,REP,720408,0,0,230,230,
Tulsa,Insurance Commissioner,Bill Viner,REP,720408,0,0,53,53,
Tulsa,Insurance Commissioner,John Doak,REP,720408,0,0,242,242,
Tulsa,Corporation Commissioner,Todd Hiett,REP,720408,0,0,175,175,
Tulsa,Corporation Commissioner,Cliff Branan,REP,720408,0,0,122,122,
Tulsa,U.S. Senate,Evelyn Rogers,REP,720408,0,0,9,9,
Tulsa,U.S. Senate,Rob Moye,REP,720408,0,0,6,6,
Tulsa,U.S. Senate,D. Jean Mcbride-Samuels,REP,720408,0,0,2,2,
Tulsa,U.S. Senate,Jim Inhofe,REP,720408,0,0,290,290,
Tulsa,U.S. Senate,Erick Paul Wyatt,REP,720408,0,0,13,13,
Tulsa,U.S. Senate,Andy Craig,REP,720408,0,0,0,0,
Tulsa,U.S. Senate,T. Shannon,REP,720408,0,0,116,116,
Tulsa,U.S. Senate,Randy Brogdon,REP,720408,0,0,18,18,
Tulsa,U.S. Senate,Eric Mccray,REP,720408,0,0,1,1,
Tulsa,U.S. Senate,Kevin Crow,REP,720408,0,0,3,3,
Tulsa,U.S. Senate,James Lankford,REP,720408,0,0,188,188,
Tulsa,U.S. Senate,Jason Weger,REP,720408,0,0,0,0,
Tulsa,Superintendent of Public Instruction,John Cox,DEM,720409,0,0,20,20,
Tulsa,Superintendent of Public Instruction,Jack Jr.,DEM,720409,0,0,6,6,
Tulsa,Superintendent of Public Instruction,Ivan Holmes,DEM,720409,0,0,8,8,
Tulsa,Superintendent of Public Instruction,Freda Deskin,DEM,720409,0,0,20,20,
Tulsa,U.S. Senate,Patrick Michael Hayes,DEM,720409,0,0,9,9,
Tulsa,U.S. Senate,Jim Rogers,DEM,720409,0,0,18,18,
Tulsa,U.S. Senate,Connie Johnson,DEM,720409,0,0,26,26,
Tulsa,Governor,Dax Ewbank,REP,720409,0,0,22,22,
Tulsa,Governor,Chad Moody,REP,720409,0,0,48,48,
Tulsa,Governor,Mary Fallin,REP,720409,0,0,220,220,
Tulsa,Superintendent of Public Instruction,Brian Kelly,REP,720409,0,0,37,37,
Tulsa,Superintendent of Public Instruction,Janet Costello Barresi,REP,720409,0,0,40,40,
Tulsa,Superintendent of Public Instruction,Joy Hofmeister,REP,720409,0,0,214,214,
Tulsa,Insurance Commissioner,Bill Viner,REP,720409,0,0,51,51,
Tulsa,Insurance Commissioner,John Doak,REP,720409,0,0,228,228,
Tulsa,Corporation Commissioner,Todd Hiett,REP,720409,0,0,150,150,
Tulsa,Corporation Commissioner,Cliff Branan,REP,720409,0,0,119,119,
Tulsa,U.S. Senate,Evelyn Rogers,REP,720409,0,0,14,14,
Tulsa,U.S. Senate,Rob Moye,REP,720409,0,0,3,3,
Tulsa,U.S. Senate,D. Jean Mcbride-Samuels,REP,720409,0,0,7,7,
Tulsa,U.S. Senate,Jim Inhofe,REP,720409,0,0,263,263,
Tulsa,U.S. Senate,Erick Paul Wyatt,REP,720409,0,0,9,9,
Tulsa,U.S. Senate,Andy Craig,REP,720409,0,0,3,3,
Tulsa,U.S. Senate,T. Shannon,REP,720409,0,0,131,131,
Tulsa,U.S. Senate,Randy Brogdon,REP,720409,0,0,18,18,
Tulsa,U.S. Senate,Eric Mccray,REP,720409,0,0,3,3,
Tulsa,U.S. Senate,Kevin Crow,REP,720409,0,0,5,5,
Tulsa,U.S. Senate,James Lankford,REP,720409,0,0,133,133,
Tulsa,U.S. Senate,Jason Weger,REP,720409,0,0,3,3,
Tulsa,Superintendent of Public Instruction,John Cox,DEM,720410,0,0,3,3,
Tulsa,Superintendent of Public Instruction,Jack Jr.,DEM,720410,0,0,1,1,
Tulsa,Superintendent of Public Instruction,Ivan Holmes,DEM,720410,0,0,4,4,
Tulsa,Superintendent of Public Instruction,Freda Deskin,DEM,720410,0,0,5,5,
Tulsa,U.S. Senate,Patrick Michael Hayes,DEM,720410,0,0,3,3,
Tulsa,U.S. Senate,Jim Rogers,DEM,720410,0,0,3,3,
Tulsa,U.S. Senate,Connie Johnson,DEM,720410,0,0,5,5,
Tulsa,Governor,Dax Ewbank,REP,720410,0,0,9,9,
Tulsa,Governor,Chad Moody,REP,720410,0,0,29,29,
Tulsa,Governor,Mary Fallin,REP,720410,0,0,154,154,
Tulsa,Superintendent of Public Instruction,Brian Kelly,REP,720410,0,0,20,20,
Tulsa,Superintendent of Public Instruction,Janet Costello Barresi,REP,720410,0,0,31,31,
Tulsa,Superintendent of Public Instruction,Joy Hofmeister,REP,720410,0,0,138,138,
Tulsa,Insurance Commissioner,Bill Viner,REP,720410,0,0,25,25,
Tulsa,Insurance Commissioner,John Doak,REP,720410,0,0,154,154,
Tulsa,Corporation Commissioner,Todd Hiett,REP,720410,0,0,109,109,
Tulsa,Corporation Commissioner,Cliff Branan,REP,720410,0,0,68,68,
Tulsa,U.S. Senate,Evelyn Rogers,REP,720410,0,0,9,9,
Tulsa,U.S. Senate,Rob Moye,REP,720410,0,0,2,2,
Tulsa,U.S. Senate,D. Jean Mcbride-Samuels,REP,720410,0,0,2,2,
Tulsa,U.S. Senate,Jim Inhofe,REP,720410,0,0,163,163,
Tulsa,U.S. Senate,Erick Paul Wyatt,REP,720410,0,0,15,15,
Tulsa,U.S. Senate,Andy Craig,REP,720410,0,0,1,1,
Tulsa,U.S. Senate,T. Shannon,REP,720410,0,0,76,76,
Tulsa,U.S. Senate,Randy Brogdon,REP,720410,0,0,8,8,
Tulsa,U.S. Senate,Eric Mccray,REP,720410,0,0,0,0,
Tulsa,U.S. Senate,Kevin Crow,REP,720410,0,0,0,0,
Tulsa,U.S. Senate,James Lankford,REP,720410,0,0,109,109,
Tulsa,U.S. Senate,Jason Weger,REP,720410,0,0,0,0,
Tulsa,Superintendent of Public Instruction,John Cox,DEM,720411,0,0,11,11,
Tulsa,Superintendent of Public Instruction,Jack Jr.,DEM,720411,0,0,2,2,
Tulsa,Superintendent of Public Instruction,Ivan Holmes,DEM,720411,0,0,2,2,
Tulsa,Superintendent of Public Instruction,Freda Deskin,DEM,720411,0,0,10,10,
Tulsa,U.S. Senate,Patrick Michael Hayes,DEM,720411,0,0,4,4,
Tulsa,U.S. Senate,Jim Rogers,DEM,720411,0,0,2,2,
Tulsa,U.S. Senate,Connie Johnson,DEM,720411,0,0,19,19,
Tulsa,Governor,Dax Ewbank,REP,720411,0,0,11,11,
Tulsa,Governor,Chad Moody,REP,720411,0,0,8,8,
Tulsa,Governor,Mary Fallin,REP,720411,0,0,114,114,
Tulsa,Superintendent of Public Instruction,Brian Kelly,REP,720411,0,0,28,28,
Tulsa,Superintendent of Public Instruction,Janet Costello Barresi,REP,720411,0,0,20,20,
Tulsa,Superintendent of Public Instruction,Joy Hofmeister,REP,720411,0,0,85,85,
Tulsa,Insurance Commissioner,Bill Viner,REP,720411,0,0,17,17,
Tulsa,Insurance Commissioner,John Doak,REP,720411,0,0,109,109,
Tulsa,Corporation Commissioner,Todd Hiett,REP,720411,0,0,66,66,
Tulsa,Corporation Commissioner,Cliff Branan,REP,720411,0,0,59,59,
Tulsa,U.S. Senate,Evelyn Rogers,REP,720411,0,0,5,5,
Tulsa,U.S. Senate,Rob Moye,REP,720411,0,0,0,0,
Tulsa,U.S. Senate,D. Jean Mcbride-Samuels,REP,720411,0,0,3,3,
Tulsa,U.S. Senate,Jim Inhofe,REP,720411,0,0,121,121,
Tulsa,U.S. Senate,Erick Paul Wyatt,REP,720411,0,0,4,4,
Tulsa,U.S. Senate,Andy Craig,REP,720411,0,0,0,0,
Tulsa,U.S. Senate,T. Shannon,REP,720411,0,0,58,58,
Tulsa,U.S. Senate,Randy Brogdon,REP,720411,0,0,6,6,
Tulsa,U.S. Senate,Eric Mccray,REP,720411,0,0,0,0,
Tulsa,U.S. Senate,Kevin Crow,REP,720411,0,0,0,0,
Tulsa,U.S. Senate,James Lankford,REP,720411,0,0,70,70,
Tulsa,U.S. Senate,Jason Weger,REP,720411,0,0,0,0,
Tulsa,Superintendent of Public Instruction,John Cox,DEM,720451,0,0,19,19,
Tulsa,Superintendent of Public Instruction,Jack Jr.,DEM,720451,0,0,3,3,
Tulsa,Superintendent of Public Instruction,Ivan Holmes,DEM,720451,0,0,4,4,
Tulsa,Superintendent of Public Instruction,Freda Deskin,DEM,720451,0,0,17,17,
Tulsa,U.S. Senate,Patrick Michael Hayes,DEM,720451,0,0,9,9,
Tulsa,U.S. Senate,Jim Rogers,DEM,720451,0,0,8,8,
Tulsa,U.S. Senate,Connie Johnson,DEM,720451,0,0,27,27,
Tulsa,Governor,Dax Ewbank,REP,720451,0,0,17,17,
Tulsa,Governor,Chad Moody,REP,720451,0,0,21,21,
Tulsa,Governor,Mary Fallin,REP,720451,0,0,135,135,
Tulsa,Superintendent of Public Instruction,Brian Kelly,REP,720451,0,0,19,19,
Tulsa,Superintendent of Public Instruction,Janet Costello Barresi,REP,720451,0,0,49,49,
Tulsa,Superintendent of Public Instruction,Joy Hofmeister,REP,720451,0,0,105,105,
Tulsa,Insurance Commissioner,Bill Viner,REP,720451,0,0,42,42,
Tulsa,Insurance Commissioner,John Doak,REP,720451,0,0,119,119,
Tulsa,Corporation Commissioner,Todd Hiett,REP,720451,0,0,85,85,
Tulsa,Corporation Commissioner,Cliff Branan,REP,720451,0,0,78,78,
Tulsa,U.S. Senate,Evelyn Rogers,REP,720451,0,0,3,3,
Tulsa,U.S. Senate,Rob Moye,REP,720451,0,0,3,3,
Tulsa,U.S. Senate,D. Jean Mcbride-Samuels,REP,720451,0,0,6,6,
Tulsa,U.S. Senate,Jim Inhofe,REP,720451,0,0,154,154,
Tulsa,U.S. Senate,Erick Paul Wyatt,REP,720451,0,0,6,6,
Tulsa,U.S. Senate,Andy Craig,REP,720451,0,0,7,7,
Tulsa,U.S. Senate,T. Shannon,REP,720451,0,0,72,72,
Tulsa,U.S. Senate,Randy Brogdon,REP,720451,0,0,28,28,
Tulsa,U.S. Senate,Eric Mccray,REP,720451,0,0,1,1,
Tulsa,U.S. Senate,Kevin Crow,REP,720451,0,0,0,0,
Tulsa,U.S. Senate,James Lankford,REP,720451,0,0,65,65,
Tulsa,U.S. Senate,Jason Weger,REP,720451,0,0,0,0,
Tulsa,State House,David Brumbaugh,REP,720451,0,0,132,132,76
Tulsa,State House,Cliff Johns,REP,720451,0,0,31,31,76
Tulsa,Superintendent of Public Instruction,John Cox,DEM,720452,0,0,35,35,
Tulsa,Superintendent of Public Instruction,Jack Jr.,DEM,720452,0,0,20,20,
Tulsa,Superintendent of Public Instruction,Ivan Holmes,DEM,720452,0,0,5,5,
Tulsa,Superintendent of Public Instruction,Freda Deskin,DEM,720452,0,0,49,49,
Tulsa,U.S. Senate,Patrick Michael Hayes,DEM,720452,0,0,30,30,
Tulsa,U.S. Senate,Jim Rogers,DEM,720452,0,0,33,33,
Tulsa,U.S. Senate,Connie Johnson,DEM,720452,0,0,44,44,
Tulsa,Governor,Dax Ewbank,REP,720452,0,0,39,39,
Tulsa,Governor,Chad Moody,REP,720452,0,0,51,51,
Tulsa,Governor,Mary Fallin,REP,720452,0,0,217,217,
Tulsa,Superintendent of Public Instruction,Brian Kelly,REP,720452,0,0,67,67,
Tulsa,Superintendent of Public Instruction,Janet Costello Barresi,REP,720452,0,0,49,49,
Tulsa,Superintendent of Public Instruction,Joy Hofmeister,REP,720452,0,0,185,185,
Tulsa,Insurance Commissioner,Bill Viner,REP,720452,0,0,74,74,
Tulsa,Insurance Commissioner,John Doak,REP,720452,0,0,209,209,
Tulsa,Corporation Commissioner,Todd Hiett,REP,720452,0,0,179,179,
Tulsa,Corporation Commissioner,Cliff Branan,REP,720452,0,0,102,102,
Tulsa,U.S. Senate,Evelyn Rogers,REP,720452,0,0,19,19,
Tulsa,U.S. Senate,Rob Moye,REP,720452,0,0,2,2,
Tulsa,U.S. Senate,D. Jean Mcbride-Samuels,REP,720452,0,0,8,8,
Tulsa,U.S. Senate,Jim Inhofe,REP,720452,0,0,260,260,
Tulsa,U.S. Senate,Erick Paul Wyatt,REP,720452,0,0,16,16,
Tulsa,U.S. Senate,Andy Craig,REP,720452,0,0,7,7,
Tulsa,U.S. Senate,T. Shannon,REP,720452,0,0,121,121,
Tulsa,U.S. Senate,Randy Brogdon,REP,720452,0,0,31,31,
Tulsa,U.S. Senate,Eric Mccray,REP,720452,0,0,6,6,
Tulsa,U.S. Senate,Kevin Crow,REP,720452,0,0,3,3,
Tulsa,U.S. Senate,James Lankford,REP,720452,0,0,139,139,
Tulsa,U.S. Senate,Jason Weger,REP,720452,0,0,1,1,
Tulsa,State House,Michael Rogers,REP,720452,0,0,177,177,98
Tulsa,State House,Terri Cleveland,REP,720452,0,0,109,109,98
Tulsa,Superintendent of Public Instruction,John Cox,DEM,720453,0,0,10,10,
Tulsa,Superintendent of Public Instruction,Jack Jr.,DEM,720453,0,0,3,3,
Tulsa,Superintendent of Public Instruction,Ivan Holmes,DEM,720453,0,0,2,2,
Tulsa,Superintendent of Public Instruction,Freda Deskin,DEM,720453,0,0,17,17,
Tulsa,U.S. Senate,Patrick Michael Hayes,DEM,720453,0,0,4,4,
Tulsa,U.S. Senate,Jim Rogers,DEM,720453,0,0,11,11,
Tulsa,U.S. Senate,Connie Johnson,DEM,720453,0,0,18,18,
Tulsa,Governor,Dax Ewbank,REP,720453,0,0,18,18,
Tulsa,Governor,Chad Moody,REP,720453,0,0,28,28,
Tulsa,Governor,Mary Fallin,REP,720453,0,0,139,139,
Tulsa,Superintendent of Public Instruction,Brian Kelly,REP,720453,0,0,27,27,
Tulsa,Superintendent of Public Instruction,Janet Costello Barresi,REP,720453,0,0,26,26,
Tulsa,Superintendent of Public Instruction,Joy Hofmeister,REP,720453,0,0,130,130,
Tulsa,Insurance Commissioner,Bill Viner,REP,720453,0,0,39,39,
Tulsa,Insurance Commissioner,John Doak,REP,720453,0,0,138,138,
Tulsa,Corporation Commissioner,Todd Hiett,REP,720453,0,0,113,113,
Tulsa,Corporation Commissioner,Cliff Branan,REP,720453,0,0,65,65,
Tulsa,U.S. Senate,Evelyn Rogers,REP,720453,0,0,11,11,
Tulsa,U.S. Senate,Rob Moye,REP,720453,0,0,3,3,
Tulsa,U.S. Senate,D. Jean Mcbride-Samuels,REP,720453,0,0,2,2,
Tulsa,U.S. Senate,Jim Inhofe,REP,720453,0,0,162,162,
Tulsa,U.S. Senate,Erick Paul Wyatt,REP,720453,0,0,5,5,
Tulsa,U.S. Senate,Andy Craig,REP,720453,0,0,0,0,
Tulsa,U.S. Senate,T. Shannon,REP,720453,0,0,83,83,
Tulsa,U.S. Senate,Randy Brogdon,REP,720453,0,0,17,17,
Tulsa,U.S. Senate,Eric Mccray,REP,720453,0,0,2,2,
Tulsa,U.S. Senate,Kevin Crow,REP,720453,0,0,0,0,
Tulsa,U.S. Senate,James Lankford,REP,720453,0,0,85,85,
Tulsa,U.S. Senate,Jason Weger,REP,720453,0,0,0,0,
Tulsa,State House,Michael Rogers,REP,720453,0,0,102,102,98
Tulsa,State House,Terri Cleveland,REP,720453,0,0,66,66,98
Tulsa,Superintendent of Public Instruction,John Cox,DEM,720454,0,0,15,15,
Tulsa,Superintendent of Public Instruction,Jack Jr.,DEM,720454,0,0,5,5,
Tulsa,Superintendent of Public Instruction,Ivan Holmes,DEM,720454,0,0,2,2,
Tulsa,Superintendent of Public Instruction,Freda Deskin,DEM,720454,0,0,21,21,
Tulsa,U.S. Senate,Patrick Michael Hayes,DEM,720454,0,0,5,5,
Tulsa,U.S. Senate,Jim Rogers,DEM,720454,0,0,8,8,
Tulsa,U.S. Senate,Connie Johnson,DEM,720454,0,0,27,27,
Tulsa,Governor,Dax Ewbank,REP,720454,0,0,20,20,
Tulsa,Governor,Chad Moody,REP,720454,0,0,41,41,
Tulsa,Governor,Mary Fallin,REP,720454,0,0,274,274,
Tulsa,Superintendent of Public Instruction,Brian Kelly,REP,720454,0,0,27,27,
Tulsa,Superintendent of Public Instruction,Janet Costello Barresi,REP,720454,0,0,55,55,
Tulsa,Superintendent of Public Instruction,Joy Hofmeister,REP,720454,0,0,249,249,
Tulsa,Insurance Commissioner,Bill Viner,REP,720454,0,0,61,61,
Tulsa,Insurance Commissioner,John Doak,REP,720454,0,0,250,250,
Tulsa,Corporation Commissioner,Todd Hiett,REP,720454,0,0,184,184,
Tulsa,Corporation Commissioner,Cliff Branan,REP,720454,0,0,118,118,
Tulsa,U.S. Senate,Evelyn Rogers,REP,720454,0,0,12,12,
Tulsa,U.S. Senate,Rob Moye,REP,720454,0,0,5,5,
Tulsa,U.S. Senate,D. Jean Mcbride-Samuels,REP,720454,0,0,2,2,
Tulsa,U.S. Senate,Jim Inhofe,REP,720454,0,0,310,310,
Tulsa,U.S. Senate,Erick Paul Wyatt,REP,720454,0,0,7,7,
Tulsa,U.S. Senate,Andy Craig,REP,720454,0,0,0,0,
Tulsa,U.S. Senate,T. Shannon,REP,720454,0,0,118,118,
Tulsa,U.S. Senate,Randy Brogdon,REP,720454,0,0,33,33,
Tulsa,U.S. Senate,Eric Mccray,REP,720454,0,0,1,1,
Tulsa,U.S. Senate,Kevin Crow,REP,720454,0,0,0,0,
Tulsa,U.S. Senate,James Lankford,REP,720454,0,0,179,179,
Tulsa,U.S. Senate,Jason Weger,REP,720454,0,0,0,0,
Tulsa,State House,David Brumbaugh,REP,720454,0,0,211,211,76
Tulsa,State House,Cliff Johns,REP,720454,0,0,106,106,76
Tulsa,Superintendent of Public Instruction,John Cox,DEM,720455,0,0,12,12,
Tulsa,Superintendent of Public Instruction,Jack Jr.,DEM,720455,0,0,6,6,
Tulsa,Superintendent of Public Instruction,Ivan Holmes,DEM,720455,0,0,4,4,
Tulsa,Superintendent of Public Instruction,Freda Deskin,DEM,720455,0,0,19,19,
Tulsa,U.S. Senate,Patrick Michael Hayes,DEM,720455,0,0,3,3,
Tulsa,U.S. Senate,Jim Rogers,DEM,720455,0,0,15,15,
Tulsa,U.S. Senate,Connie Johnson,DEM,720455,0,0,23,23,
Tulsa,Governor,Dax Ewbank,REP,720455,0,0,11,11,
Tulsa,Governor,Chad Moody,REP,720455,0,0,22,22,
Tulsa,Governor,Mary Fallin,REP,720455,0,0,74,74,
Tulsa,Superintendent of Public Instruction,Brian Kelly,REP,720455,0,0,23,23,
Tulsa,Superintendent of Public Instruction,Janet Costello Barresi,REP,720455,0,0,14,14,
Tulsa,Superintendent of Public Instruction,Joy Hofmeister,REP,720455,0,0,69,69,
Tulsa,Insurance Commissioner,Bill Viner,REP,720455,0,0,23,23,
Tulsa,Insurance Commissioner,John Doak,REP,720455,0,0,75,75,
Tulsa,Corporation Commissioner,Todd Hiett,REP,720455,0,0,51,51,
Tulsa,Corporation Commissioner,Cliff Branan,REP,720455,0,0,42,42,
Tulsa,U.S. Senate,Evelyn Rogers,REP,720455,0,0,4,4,
Tulsa,U.S. Senate,Rob Moye,REP,720455,0,0,2,2,
Tulsa,U.S. Senate,D. Jean Mcbride-Samuels,REP,720455,0,0,3,3,
Tulsa,U.S. Senate,Jim Inhofe,REP,720455,0,0,89,89,
Tulsa,U.S. Senate,Erick Paul Wyatt,REP,720455,0,0,9,9,
Tulsa,U.S. Senate,Andy Craig,REP,720455,0,0,8,8,
Tulsa,U.S. Senate,T. Shannon,REP,720455,0,0,40,40,
Tulsa,U.S. Senate,Randy Brogdon,REP,720455,0,0,15,15,
Tulsa,U.S. Senate,Eric Mccray,REP,720455,0,0,0,0,
Tulsa,U.S. Senate,Kevin Crow,REP,720455,0,0,0,0,
Tulsa,U.S. Senate,James Lankford,REP,720455,0,0,45,45,
Tulsa,U.S. Senate,Jason Weger,REP,720455,0,0,0,0,
Tulsa,State House,David Brumbaugh,REP,720455,0,0,90,90,76
Tulsa,State House,Cliff Johns,REP,720455,0,0,14,14,76
Tulsa,Superintendent of Public Instruction,John Cox,DEM,720456,0,0,22,22,
Tulsa,Superintendent of Public Instruction,Jack Jr.,DEM,720456,0,0,1,1,
Tulsa,Superintendent of Public Instruction,Ivan Holmes,DEM,720456,0,0,2,2,
Tulsa,Superintendent of Public Instruction,Freda Deskin,DEM,720456,0,0,31,31,
Tulsa,U.S. Senate,Patrick Michael Hayes,DEM,720456,0,0,10,10,
Tulsa,U.S. Senate,Jim Rogers,DEM,720456,0,0,12,12,
Tulsa,U.S. Senate,Connie Johnson,DEM,720456,0,0,32,32,
Tulsa,Governor,Dax Ewbank,REP,720456,0,0,15,15,
Tulsa,Governor,Chad Moody,REP,720456,0,0,34,34,
Tulsa,Governor,Mary Fallin,REP,720456,0,0,179,179,
Tulsa,Superintendent of Public Instruction,Brian Kelly,REP,720456,0,0,51,51,
Tulsa,Superintendent of Public Instruction,Janet Costello Barresi,REP,720456,0,0,42,42,
Tulsa,Superintendent of Public Instruction,Joy Hofmeister,REP,720456,0,0,132,132,
Tulsa,Insurance Commissioner,Bill Viner,REP,720456,0,0,36,36,
Tulsa,Insurance Commissioner,John Doak,REP,720456,0,0,170,170,
Tulsa,Corporation Commissioner,Todd Hiett,REP,720456,0,0,124,124,
Tulsa,Corporation Commissioner,Cliff Branan,REP,720456,0,0,80,80,
Tulsa,U.S. Senate,Evelyn Rogers,REP,720456,0,0,7,7,
Tulsa,U.S. Senate,Rob Moye,REP,720456,0,0,6,6,
Tulsa,U.S. Senate,D. Jean Mcbride-Samuels,REP,720456,0,0,3,3,
Tulsa,U.S. Senate,Jim Inhofe,REP,720456,0,0,206,206,
Tulsa,U.S. Senate,Erick Paul Wyatt,REP,720456,0,0,5,5,
Tulsa,U.S. Senate,Andy Craig,REP,720456,0,0,1,1,
Tulsa,U.S. Senate,T. Shannon,REP,720456,0,0,99,99,
Tulsa,U.S. Senate,Randy Brogdon,REP,720456,0,0,50,50,
Tulsa,U.S. Senate,Eric Mccray,REP,720456,0,0,0,0,
Tulsa,U.S. Senate,Kevin Crow,REP,720456,0,0,0,0,
Tulsa,U.S. Senate,James Lankford,REP,720456,0,0,80,80,
Tulsa,U.S. Senate,Jason Weger,REP,720456,0,0,0,0,
Tulsa,State House,David Brumbaugh,REP,720456,0,0,175,175,76
Tulsa,State House,Cliff Johns,REP,720456,0,0,38,38,76
Tulsa,Superintendent of Public Instruction,John Cox,DEM,720457,0,0,0,0,
Tulsa,Superintendent of Public Instruction,Jack Jr.,DEM,720457,0,0,0,0,
Tulsa,Superintendent of Public Instruction,Ivan Holmes,DEM,720457,0,0,0,0,
Tulsa,Superintendent of Public Instruction,Freda Deskin,DEM,720457,0,0,0,0,
Tulsa,U.S. Senate,Patrick Michael Hayes,DEM,720457,0,0,0,0,
Tulsa,U.S. Senate,Jim Rogers,DEM,720457,0,0,0,0,
Tulsa,U.S. Senate,Connie Johnson,DEM,720457,0,0,0,0,
Tulsa,Governor,Dax Ewbank,REP,720457,0,0,0,0,
Tulsa,Governor,Chad Moody,REP,720457,0,0,0,0,
Tulsa,Governor,Mary Fallin,REP,720457,0,0,3,3,
Tulsa,Superintendent of Public Instruction,Brian Kelly,REP,720457,0,0,1,1,
Tulsa,Superintendent of Public Instruction,Janet Costello Barresi,REP,720457,0,0,0,0,
Tulsa,Superintendent of Public Instruction,Joy Hofmeister,REP,720457,0,0,2,2,
Tulsa,Insurance Commissioner,Bill Viner,REP,720457,0,0,0,0,
Tulsa,Insurance Commissioner,John Doak,REP,720457,0,0,3,3,
Tulsa,Corporation Commissioner,Todd Hiett,REP,720457,0,0,1,1,
Tulsa,Corporation Commissioner,Cliff Branan,REP,720457,0,0,2,2,
Tulsa,U.S. Senate,Evelyn Rogers,REP,720457,0,0,0,0,
Tulsa,U.S. Senate,Rob Moye,REP,720457,0,0,0,0,
Tulsa,U.S. Senate,D. Jean Mcbride-Samuels,REP,720457,0,0,0,0,
Tulsa,U.S. Senate,Jim Inhofe,REP,720457,0,0,3,3,
Tulsa,U.S. Senate,Erick Paul Wyatt,REP,720457,0,0,0,0,
Tulsa,U.S. Senate,Andy Craig,REP,720457,0,0,0,0,
Tulsa,U.S. Senate,T. Shannon,REP,720457,0,0,1,1,
Tulsa,U.S. Senate,Randy Brogdon,REP,720457,0,0,0,0,
Tulsa,U.S. Senate,Eric Mccray,REP,720457,0,0,0,0,
Tulsa,U.S. Senate,Kevin Crow,REP,720457,0,0,0,0,
Tulsa,U.S. Senate,James Lankford,REP,720457,0,0,2,2,
Tulsa,U.S. Senate,Jason Weger,REP,720457,0,0,0,0,
Tulsa,State House,Michael Rogers,REP,720457,0,0,1,1,98
Tulsa,State House,Terri Cleveland,REP,720457,0,0,2,2,98
Tulsa,Superintendent of Public Instruction,John Cox,DEM,720458,0,0,27,27,
Tulsa,Superintendent of Public Instruction,Jack Jr.,DEM,720458,0,0,11,11,
Tulsa,Superintendent of Public Instruction,Ivan Holmes,DEM,720458,0,0,6,6,
Tulsa,Superintendent of Public Instruction,Freda Deskin,DEM,720458,0,0,35,35,
Tulsa,U.S. Senate,Patrick Michael Hayes,DEM,720458,0,0,8,8,
Tulsa,U.S. Senate,Jim Rogers,DEM,720458,0,0,27,27,
Tulsa,U.S. Senate,Connie Johnson,DEM,720458,0,0,44,44,
Tulsa,Governor,Dax Ewbank,REP,720458,0,0,34,34,
Tulsa,Governor,Chad Moody,REP,720458,0,0,48,48,
Tulsa,Governor,Mary Fallin,REP,720458,0,0,303,303,
Tulsa,Superintendent of Public Instruction,Brian Kelly,REP,720458,0,0,55,55,
Tulsa,Superintendent of Public Instruction,Janet Costello Barresi,REP,720458,0,0,84,84,
Tulsa,Superintendent of Public Instruction,Joy Hofmeister,REP,720458,0,0,245,245,
Tulsa,Insurance Commissioner,Bill Viner,REP,720458,0,0,71,71,
Tulsa,Insurance Commissioner,John Doak,REP,720458,0,0,280,280,
Tulsa,Corporation Commissioner,Todd Hiett,REP,720458,0,0,218,218,
Tulsa,Corporation Commissioner,Cliff Branan,REP,720458,0,0,138,138,
Tulsa,U.S. Senate,Evelyn Rogers,REP,720458,0,0,9,9,
Tulsa,U.S. Senate,Rob Moye,REP,720458,0,0,7,7,
Tulsa,U.S. Senate,D. Jean Mcbride-Samuels,REP,720458,0,0,3,3,
Tulsa,U.S. Senate,Jim Inhofe,REP,720458,0,0,349,349,
Tulsa,U.S. Senate,Erick Paul Wyatt,REP,720458,0,0,16,16,
Tulsa,U.S. Senate,Andy Craig,REP,720458,0,0,3,3,
Tulsa,U.S. Senate,T. Shannon,REP,720458,0,0,155,155,
Tulsa,U.S. Senate,Randy Brogdon,REP,720458,0,0,37,37,
Tulsa,U.S. Senate,Eric Mccray,REP,720458,0,0,1,1,
Tulsa,U.S. Senate,Kevin Crow,REP,720458,0,0,3,3,
Tulsa,U.S. Senate,James Lankford,REP,720458,0,0,185,185,
Tulsa,U.S. Senate,Jason Weger,REP,720458,0,0,3,3,
Tulsa,State House,David Brumbaugh,REP,720458,0,0,303,303,76
Tulsa,State House,Cliff Johns,REP,720458,0,0,62,62,76
Tulsa,Superintendent of Public Instruction,John Cox,DEM,720459,0,0,6,6,
Tulsa,Superintendent of Public Instruction,Jack Jr.,DEM,720459,0,0,3,3,
Tulsa,Superintendent of Public Instruction,Ivan Holmes,DEM,720459,0,0,1,1,
Tulsa,Superintendent of Public Instruction,Freda Deskin,DEM,720459,0,0,17,17,
Tulsa,U.S. Senate,Patrick Michael Hayes,DEM,720459,0,0,8,8,
Tulsa,U.S. Senate,Jim Rogers,DEM,720459,0,0,7,7,
Tulsa,U.S. Senate,Connie Johnson,DEM,720459,0,0,11,11,
Tulsa,Governor,Dax Ewbank,REP,720459,0,0,15,15,
Tulsa,Governor,Chad Moody,REP,720459,0,0,18,18,
Tulsa,Governor,Mary Fallin,REP,720459,0,0,100,100,
Tulsa,Superintendent of Public Instruction,Brian Kelly,REP,720459,0,0,16,16,
Tulsa,Superintendent of Public Instruction,Janet Costello Barresi,REP,720459,0,0,21,21,
Tulsa,Superintendent of Public Instruction,Joy Hofmeister,REP,720459,0,0,100,100,
Tulsa,Insurance Commissioner,Bill Viner,REP,720459,0,0,27,27,
Tulsa,Insurance Commissioner,John Doak,REP,720459,0,0,99,99,
Tulsa,Corporation Commissioner,Todd Hiett,REP,720459,0,0,69,69,
Tulsa,Corporation Commissioner,Cliff Branan,REP,720459,0,0,54,54,
Tulsa,U.S. Senate,Evelyn Rogers,REP,720459,0,0,8,8,
Tulsa,U.S. Senate,Rob Moye,REP,720459,0,0,3,3,
Tulsa,U.S. Senate,D. Jean Mcbride-Samuels,REP,720459,0,0,0,0,
Tulsa,U.S. Senate,Jim Inhofe,REP,720459,0,0,111,111,
Tulsa,U.S. Senate,Erick Paul Wyatt,REP,720459,0,0,13,13,
Tulsa,U.S. Senate,Andy Craig,REP,720459,0,0,0,0,
Tulsa,U.S. Senate,T. Shannon,REP,720459,0,0,55,55,
Tulsa,U.S. Senate,Randy Brogdon,REP,720459,0,0,14,14,
Tulsa,U.S. Senate,Eric Mccray,REP,720459,0,0,0,0,
Tulsa,U.S. Senate,Kevin Crow,REP,720459,0,0,1,1,
Tulsa,U.S. Senate,James Lankford,REP,720459,0,0,65,65,
Tulsa,U.S. Senate,Jason Weger,REP,720459,0,0,0,0,
Tulsa,Superintendent of Public Instruction,John Cox,DEM,720460,0,0,9,9,
Tulsa,Superintendent of Public Instruction,Jack Jr.,DEM,720460,0,0,3,3,
Tulsa,Superintendent of Public Instruction,Ivan Holmes,DEM,720460,0,0,1,1,
Tulsa,Superintendent of Public Instruction,Freda Deskin,DEM,720460,0,0,2,2,
Tulsa,U.S. Senate,Patrick Michael Hayes,DEM,720460,0,0,3,3,
Tulsa,U.S. Senate,Jim Rogers,DEM,720460,0,0,2,2,
Tulsa,U.S. Senate,Connie Johnson,DEM,720460,0,0,10,10,
Tulsa,Governor,Dax Ewbank,REP,720460,0,0,19,19,
Tulsa,Governor,Chad Moody,REP,720460,0,0,21,21,
Tulsa,Governor,Mary Fallin,REP,720460,0,0,171,171,
Tulsa,Superintendent of Public Instruction,Brian Kelly,REP,720460,0,0,27,27,
Tulsa,Superintendent of Public Instruction,Janet Costello Barresi,REP,720460,0,0,32,32,
Tulsa,Superintendent of Public Instruction,Joy Hofmeister,REP,720460,0,0,152,152,
Tulsa,Insurance Commissioner,Bill Viner,REP,720460,0,0,41,41,
Tulsa,Insurance Commissioner,John Doak,REP,720460,0,0,170,170,
Tulsa,Corporation Commissioner,Todd Hiett,REP,720460,0,0,117,117,
Tulsa,Corporation Commissioner,Cliff Branan,REP,720460,0,0,84,84,
Tulsa,U.S. Senate,Evelyn Rogers,REP,720460,0,0,6,6,
Tulsa,U.S. Senate,Rob Moye,REP,720460,0,0,4,4,
Tulsa,U.S. Senate,D. Jean Mcbride-Samuels,REP,720460,0,0,2,2,
Tulsa,U.S. Senate,Jim Inhofe,REP,720460,0,0,199,199,
Tulsa,U.S. Senate,Erick Paul Wyatt,REP,720460,0,0,3,3,
Tulsa,U.S. Senate,Andy Craig,REP,720460,0,0,2,2,
Tulsa,U.S. Senate,T. Shannon,REP,720460,0,0,97,97,
Tulsa,U.S. Senate,Randy Brogdon,REP,720460,0,0,24,24,
Tulsa,U.S. Senate,Eric Mccray,REP,720460,0,0,1,1,
Tulsa,U.S. Senate,Kevin Crow,REP,720460,0,0,0,0,
Tulsa,U.S. Senate,James Lankford,REP,720460,0,0,95,95,
Tulsa,U.S. Senate,Jason Weger,REP,720460,0,0,0,0,
Tulsa,Superintendent of Public Instruction,John Cox,DEM,720461,0,0,19,19,
Tulsa,Superintendent of Public Instruction,Jack Jr.,DEM,720461,0,0,7,7,
Tulsa,Superintendent of Public Instruction,Ivan Holmes,DEM,720461,0,0,1,1,
Tulsa,Superintendent of Public Instruction,Freda Deskin,DEM,720461,0,0,16,16,
Tulsa,U.S. Senate,Patrick Michael Hayes,DEM,720461,0,0,5,5,
Tulsa,U.S. Senate,Jim Rogers,DEM,720461,0,0,7,7,
Tulsa,U.S. Senate,Connie Johnson,DEM,720461,0,0,31,31,
Tulsa,Governor,Dax Ewbank,REP,720461,0,0,20,20,
Tulsa,Governor,Chad Moody,REP,720461,0,0,34,34,
Tulsa,Governor,Mary Fallin,REP,720461,0,0,121,121,
Tulsa,Superintendent of Public Instruction,Brian Kelly,REP,720461,0,0,28,28,
Tulsa,Superintendent of Public Instruction,Janet Costello Barresi,REP,720461,0,0,35,35,
Tulsa,Superintendent of Public Instruction,Joy Hofmeister,REP,720461,0,0,111,111,
Tulsa,Insurance Commissioner,Bill Viner,REP,720461,0,0,43,43,
Tulsa,Insurance Commissioner,John Doak,REP,720461,0,0,130,130,
Tulsa,Corporation Commissioner,Todd Hiett,REP,720461,0,0,84,84,
Tulsa,Corporation Commissioner,Cliff Branan,REP,720461,0,0,86,86,
Tulsa,U.S. Senate,Evelyn Rogers,REP,720461,0,0,7,7,
Tulsa,U.S. Senate,Rob Moye,REP,720461,0,0,3,3,
Tulsa,U.S. Senate,D. Jean Mcbride-Samuels,REP,720461,0,0,5,5,
Tulsa,U.S. Senate,Jim Inhofe,REP,720461,0,0,154,154,
Tulsa,U.S. Senate,Erick Paul Wyatt,REP,720461,0,0,10,10,
Tulsa,U.S. Senate,Andy Craig,REP,720461,0,0,0,0,
Tulsa,U.S. Senate,T. Shannon,REP,720461,0,0,65,65,
Tulsa,U.S. Senate,Randy Brogdon,REP,720461,0,0,21,21,
Tulsa,U.S. Senate,Eric Mccray,REP,720461,0,0,3,3,
Tulsa,U.S. Senate,Kevin Crow,REP,720461,0,0,4,4,
Tulsa,U.S. Senate,James Lankford,REP,720461,0,0,84,84,
Tulsa,U.S. Senate,Jason Weger,REP,720461,0,0,2,2,
Tulsa,Superintendent of Public Instruction,John Cox,DEM,720462,0,0,21,21,
Tulsa,Superintendent of Public Instruction,Jack Jr.,DEM,720462,0,0,8,8,
Tulsa,Superintendent of Public Instruction,Ivan Holmes,DEM,720462,0,0,3,3,
Tulsa,Superintendent of Public Instruction,Freda Deskin,DEM,720462,0,0,28,28,
Tulsa,U.S. Senate,Patrick Michael Hayes,DEM,720462,0,0,13,13,
Tulsa,U.S. Senate,Jim Rogers,DEM,720462,0,0,18,18,
Tulsa,U.S. Senate,Connie Johnson,DEM,720462,0,0,29,29,
Tulsa,Governor,Dax Ewbank,REP,720462,0,0,27,27,
Tulsa,Governor,Chad Moody,REP,720462,0,0,35,35,
Tulsa,Governor,Mary Fallin,REP,720462,0,0,224,224,
Tulsa,Superintendent of Public Instruction,Brian Kelly,REP,720462,0,0,32,32,
Tulsa,Superintendent of Public Instruction,Janet Costello Barresi,REP,720462,0,0,61,61,
Tulsa,Superintendent of Public Instruction,Joy Hofmeister,REP,720462,0,0,182,182,
Tulsa,Insurance Commissioner,Bill Viner,REP,720462,0,0,58,58,
Tulsa,Insurance Commissioner,John Doak,REP,720462,0,0,203,203,
Tulsa,Corporation Commissioner,Todd Hiett,REP,720462,0,0,152,152,
Tulsa,Corporation Commissioner,Cliff Branan,REP,720462,0,0,111,111,
Tulsa,U.S. Senate,Evelyn Rogers,REP,720462,0,0,4,4,
Tulsa,U.S. Senate,Rob Moye,REP,720462,0,0,9,9,
Tulsa,U.S. Senate,D. Jean Mcbride-Samuels,REP,720462,0,0,3,3,
Tulsa,U.S. Senate,Jim Inhofe,REP,720462,0,0,257,257,
Tulsa,U.S. Senate,Erick Paul Wyatt,REP,720462,0,0,7,7,
Tulsa,U.S. Senate,Andy Craig,REP,720462,0,0,3,3,
Tulsa,U.S. Senate,T. Shannon,REP,720462,0,0,124,124,
Tulsa,U.S. Senate,Randy Brogdon,REP,720462,0,0,32,32,
Tulsa,U.S. Senate,Eric Mccray,REP,720462,0,0,1,1,
Tulsa,U.S. Senate,Kevin Crow,REP,720462,0,0,0,0,
Tulsa,U.S. Senate,James Lankford,REP,720462,0,0,123,123,
Tulsa,U.S. Senate,Jason Weger,REP,720462,0,0,3,3,
Tulsa,State House,David Brumbaugh,REP,720462,0,0,235,235,76
Tulsa,State House,Cliff Johns,REP,720462,0,0,29,29,76
Tulsa,Superintendent of Public Instruction,John Cox,DEM,720463,0,0,15,15,
Tulsa,Superintendent of Public Instruction,Jack Jr.,DEM,720463,0,0,1,1,
Tulsa,Superintendent of Public Instruction,Ivan Holmes,DEM,720463,0,0,0,0,
Tulsa,Superintendent of Public Instruction,Freda Deskin,DEM,720463,0,0,14,14,
Tulsa,U.S. Senate,Patrick Michael Hayes,DEM,720463,0,0,7,7,
Tulsa,U.S. Senate,Jim Rogers,DEM,720463,0,0,4,4,
Tulsa,U.S. Senate,Connie Johnson,DEM,720463,0,0,19,19,
Tulsa,Governor,Dax Ewbank,REP,720463,0,0,17,17,
Tulsa,Governor,Chad Moody,REP,720463,0,0,20,20,
Tulsa,Governor,Mary Fallin,REP,720463,0,0,109,109,
Tulsa,Superintendent of Public Instruction,Brian Kelly,REP,720463,0,0,20,20,
Tulsa,Superintendent of Public Instruction,Janet Costello Barresi,REP,720463,0,0,23,23,
Tulsa,Superintendent of Public Instruction,Joy Hofmeister,REP,720463,0,0,102,102,
Tulsa,Insurance Commissioner,Bill Viner,REP,720463,0,0,29,29,
Tulsa,Insurance Commissioner,John Doak,REP,720463,0,0,108,108,
Tulsa,Corporation Commissioner,Todd Hiett,REP,720463,0,0,90,90,
Tulsa,Corporation Commissioner,Cliff Branan,REP,720463,0,0,42,42,
Tulsa,U.S. Senate,Evelyn Rogers,REP,720463,0,0,3,3,
Tulsa,U.S. Senate,Rob Moye,REP,720463,0,0,1,1,
Tulsa,U.S. Senate,D. Jean Mcbride-Samuels,REP,720463,0,0,2,2,
Tulsa,U.S. Senate,Jim Inhofe,REP,720463,0,0,139,139,
Tulsa,U.S. Senate,Erick Paul Wyatt,REP,720463,0,0,2,2,
Tulsa,U.S. Senate,Andy Craig,REP,720463,0,0,2,2,
Tulsa,U.S. Senate,T. Shannon,REP,720463,0,0,81,81,
Tulsa,U.S. Senate,Randy Brogdon,REP,720463,0,0,21,21,
Tulsa,U.S. Senate,Eric Mccray,REP,720463,0,0,0,0,
Tulsa,U.S. Senate,Kevin Crow,REP,720463,0,0,0,0,
Tulsa,U.S. Senate,James Lankford,REP,720463,0,0,45,45,
Tulsa,U.S. Senate,Jason Weger,REP,720463,0,0,0,0,
Tulsa,State House,David Brumbaugh,REP,720463,0,0,103,103,76
Tulsa,State House,Cliff Johns,REP,720463,0,0,36,36,76
Tulsa,Superintendent of Public Instruction,John Cox,DEM,720464,0,0,29,29,
Tulsa,Superintendent of Public Instruction,Jack Jr.,DEM,720464,0,0,14,14,
Tulsa,Superintendent of Public Instruction,Ivan Holmes,DEM,720464,0,0,3,3,
Tulsa,Superintendent of Public Instruction,Freda Deskin,DEM,720464,0,0,26,26,
Tulsa,U.S. Senate,Patrick Michael Hayes,DEM,720464,0,0,18,18,
Tulsa,U.S. Senate,Jim Rogers,DEM,720464,0,0,16,16,
Tulsa,U.S. Senate,Connie Johnson,DEM,720464,0,0,36,36,
Tulsa,Governor,Dax Ewbank,REP,720464,0,0,40,40,
Tulsa,Governor,Chad Moody,REP,720464,0,0,59,59,
Tulsa,Governor,Mary Fallin,REP,720464,0,0,324,324,
Tulsa,Superintendent of Public Instruction,Brian Kelly,REP,720464,0,0,70,70,
Tulsa,Superintendent of Public Instruction,Janet Costello Barresi,REP,720464,0,0,62,62,
Tulsa,Superintendent of Public Instruction,Joy Hofmeister,REP,720464,0,0,289,289,
Tulsa,Insurance Commissioner,Bill Viner,REP,720464,0,0,65,65,
Tulsa,Insurance Commissioner,John Doak,REP,720464,0,0,323,323,
Tulsa,Corporation Commissioner,Todd Hiett,REP,720464,0,0,239,239,
Tulsa,Corporation Commissioner,Cliff Branan,REP,720464,0,0,150,150,
Tulsa,U.S. Senate,Evelyn Rogers,REP,720464,0,0,17,17,
Tulsa,U.S. Senate,Rob Moye,REP,720464,0,0,7,7,
Tulsa,U.S. Senate,D. Jean Mcbride-Samuels,REP,720464,0,0,3,3,
Tulsa,U.S. Senate,Jim Inhofe,REP,720464,0,0,382,382,
Tulsa,U.S. Senate,Erick Paul Wyatt,REP,720464,0,0,14,14,
Tulsa,U.S. Senate,Andy Craig,REP,720464,0,0,8,8,
Tulsa,U.S. Senate,T. Shannon,REP,720464,0,0,178,178,
Tulsa,U.S. Senate,Randy Brogdon,REP,720464,0,0,45,45,
Tulsa,U.S. Senate,Eric Mccray,REP,720464,0,0,1,1,
Tulsa,U.S. Senate,Kevin Crow,REP,720464,0,0,1,1,
Tulsa,U.S. Senate,James Lankford,REP,720464,0,0,192,192,
Tulsa,U.S. Senate,Jason Weger,REP,720464,0,0,0,0,
Tulsa,Superintendent of Public Instruction,John Cox,DEM,720465,0,0,25,25,
Tulsa,Superintendent of Public Instruction,Jack Jr.,DEM,720465,0,0,5,5,
Tulsa,Superintendent of Public Instruction,Ivan Holmes,DEM,720465,0,0,4,4,
Tulsa,Superintendent of Public Instruction,Freda Deskin,DEM,720465,0,0,31,31,
Tulsa,U.S. Senate,Patrick Michael Hayes,DEM,720465,0,0,13,13,
Tulsa,U.S. Senate,Jim Rogers,DEM,720465,0,0,13,13,
Tulsa,U.S. Senate,Connie Johnson,DEM,720465,0,0,38,38,
Tulsa,Governor,Dax Ewbank,REP,720465,0,0,17,17,
Tulsa,Governor,Chad Moody,REP,720465,0,0,39,39,
Tulsa,Governor,Mary Fallin,REP,720465,0,0,193,193,
Tulsa,Superintendent of Public Instruction,Brian Kelly,REP,720465,0,0,37,37,
Tulsa,Superintendent of Public Instruction,Janet Costello Barresi,REP,720465,0,0,48,48,
Tulsa,Superintendent of Public Instruction,Joy Hofmeister,REP,720465,0,0,168,168,
Tulsa,Insurance Commissioner,Bill Viner,REP,720465,0,0,61,61,
Tulsa,Insurance Commissioner,John Doak,REP,720465,0,0,175,175,
Tulsa,Corporation Commissioner,Todd Hiett,REP,720465,0,0,141,141,
Tulsa,Corporation Commissioner,Cliff Branan,REP,720465,0,0,91,91,
Tulsa,U.S. Senate,Evelyn Rogers,REP,720465,0,0,9,9,
Tulsa,U.S. Senate,Rob Moye,REP,720465,0,0,5,5,
Tulsa,U.S. Senate,D. Jean Mcbride-Samuels,REP,720465,0,0,5,5,
Tulsa,U.S. Senate,Jim Inhofe,REP,720465,0,0,221,221,
Tulsa,U.S. Senate,Erick Paul Wyatt,REP,720465,0,0,13,13,
Tulsa,U.S. Senate,Andy Craig,REP,720465,0,0,2,2,
Tulsa,U.S. Senate,T. Shannon,REP,720465,0,0,95,95,
Tulsa,U.S. Senate,Randy Brogdon,REP,720465,0,0,35,35,
Tulsa,U.S. Senate,Eric Mccray,REP,720465,0,0,1,1,
Tulsa,U.S. Senate,Kevin Crow,REP,720465,0,0,0,0,
Tulsa,U.S. Senate,James Lankford,REP,720465,0,0,121,121,
Tulsa,U.S. Senate,Jason Weger,REP,720465,0,0,1,1,
Tulsa,State House,David Brumbaugh,REP,720465,0,0,160,160,76
Tulsa,State House,Cliff Johns,REP,720465,0,0,81,81,76
Tulsa,Superintendent of Public Instruction,John Cox,DEM,720466,0,0,22,22,
Tulsa,Superintendent of Public Instruction,Jack Jr.,DEM,720466,0,0,10,10,
Tulsa,Superintendent of Public Instruction,Ivan Holmes,DEM,720466,0,0,4,4,
Tulsa,Superintendent of Public Instruction,Freda Deskin,DEM,720466,0,0,21,21,
Tulsa,U.S. Senate,Patrick Michael Hayes,DEM,720466,0,0,8,8,
Tulsa,U.S. Senate,Jim Rogers,DEM,720466,0,0,14,14,
Tulsa,U.S. Senate,Connie Johnson,DEM,720466,0,0,35,35,
Tulsa,Governor,Dax Ewbank,REP,720466,0,0,18,18,
Tulsa,Governor,Chad Moody,REP,720466,0,0,32,32,
Tulsa,Governor,Mary Fallin,REP,720466,0,0,232,232,
Tulsa,Superintendent of Public Instruction,Brian Kelly,REP,720466,0,0,44,44,
Tulsa,Superintendent of Public Instruction,Janet Costello Barresi,REP,720466,0,0,39,39,
Tulsa,Superintendent of Public Instruction,Joy Hofmeister,REP,720466,0,0,201,201,
Tulsa,Insurance Commissioner,Bill Viner,REP,720466,0,0,55,55,
Tulsa,Insurance Commissioner,John Doak,REP,720466,0,0,199,199,
Tulsa,Corporation Commissioner,Todd Hiett,REP,720466,0,0,153,153,
Tulsa,Corporation Commissioner,Cliff Branan,REP,720466,0,0,104,104,
Tulsa,U.S. Senate,Evelyn Rogers,REP,720466,0,0,18,18,
Tulsa,U.S. Senate,Rob Moye,REP,720466,0,0,2,2,
Tulsa,U.S. Senate,D. Jean Mcbride-Samuels,REP,720466,0,0,6,6,
Tulsa,U.S. Senate,Jim Inhofe,REP,720466,0,0,256,256,
Tulsa,U.S. Senate,Erick Paul Wyatt,REP,720466,0,0,4,4,
Tulsa,U.S. Senate,Andy Craig,REP,720466,0,0,2,2,
Tulsa,U.S. Senate,T. Shannon,REP,720466,0,0,112,112,
Tulsa,U.S. Senate,Randy Brogdon,REP,720466,0,0,21,21,
Tulsa,U.S. Senate,Eric Mccray,REP,720466,0,0,3,3,
Tulsa,U.S. Senate,Kevin Crow,REP,720466,0,0,3,3,
Tulsa,U.S. Senate,James Lankford,REP,720466,0,0,144,144,
Tulsa,U.S. Senate,Jason Weger,REP,720466,0,0,1,1,
Tulsa,State House,Michael Rogers,REP,720466,0,0,130,130,98
Tulsa,State House,Terri Cleveland,REP,720466,0,0,121,121,98
Tulsa,Superintendent of Public Instruction,John Cox,DEM,720467,0,0,0,0,
Tulsa,Superintendent of Public Instruction,Jack Jr.,DEM,720467,0,0,0,0,
Tulsa,Superintendent of Public Instruction,Ivan Holmes,DEM,720467,0,0,0,0,
Tulsa,Superintendent of Public Instruction,Freda Deskin,DEM,720467,0,0,2,2,
Tulsa,U.S. Senate,Patrick Michael Hayes,DEM,720467,0,0,0,0,
Tulsa,U.S. Senate,Jim Rogers,DEM,720467,0,0,1,1,
Tulsa,U.S. Senate,Connie Johnson,DEM,720467,0,0,1,1,
Tulsa,Governor,Dax Ewbank,REP,720467,0,0,3,3,
Tulsa,Governor,Chad Moody,REP,720467,0,0,2,2,
Tulsa,Governor,Mary Fallin,REP,720467,0,0,34,34,
Tulsa,Superintendent of Public Instruction,Brian Kelly,REP,720467,0,0,4,4,
Tulsa,Superintendent of Public Instruction,Janet Costello Barresi,REP,720467,0,0,8,8,
Tulsa,Superintendent of Public Instruction,Joy Hofmeister,REP,720467,0,0,26,26,
Tulsa,Insurance Commissioner,Bill Viner,REP,720467,0,0,8,8,
Tulsa,Insurance Commissioner,John Doak,REP,720467,0,0,30,30,
Tulsa,Corporation Commissioner,Todd Hiett,REP,720467,0,0,15,15,
Tulsa,Corporation Commissioner,Cliff Branan,REP,720467,0,0,23,23,
Tulsa,U.S. Senate,Evelyn Rogers,REP,720467,0,0,4,4,
Tulsa,U.S. Senate,Rob Moye,REP,720467,0,0,2,2,
Tulsa,U.S. Senate,D. Jean Mcbride-Samuels,REP,720467,0,0,2,2,
Tulsa,U.S. Senate,Jim Inhofe,REP,720467,0,0,28,28,
Tulsa,U.S. Senate,Erick Paul Wyatt,REP,720467,0,0,2,2,
Tulsa,U.S. Senate,Andy Craig,REP,720467,0,0,1,1,
Tulsa,U.S. Senate,T. Shannon,REP,720467,0,0,15,15,
Tulsa,U.S. Senate,Randy Brogdon,REP,720467,0,0,1,1,
Tulsa,U.S. Senate,Eric Mccray,REP,720467,0,0,1,1,
Tulsa,U.S. Senate,Kevin Crow,REP,720467,0,0,1,1,
Tulsa,U.S. Senate,James Lankford,REP,720467,0,0,18,18,
Tulsa,U.S. Senate,Jason Weger,REP,720467,0,0,0,0,
Tulsa,Superintendent of Public Instruction,John Cox,DEM,720468,0,0,18,18,
Tulsa,Superintendent of Public Instruction,Jack Jr.,DEM,720468,0,0,16,16,
Tulsa,Superintendent of Public Instruction,Ivan Holmes,DEM,720468,0,0,3,3,
Tulsa,Superintendent of Public Instruction,Freda Deskin,DEM,720468,0,0,21,21,
Tulsa,U.S. Senate,Patrick Michael Hayes,DEM,720468,0,0,14,14,
Tulsa,U.S. Senate,Jim Rogers,DEM,720468,0,0,10,10,
Tulsa,U.S. Senate,Connie Johnson,DEM,720468,0,0,32,32,
Tulsa,Governor,Dax Ewbank,REP,720468,0,0,34,34,
Tulsa,Governor,Chad Moody,REP,720468,0,0,45,45,
Tulsa,Governor,Mary Fallin,REP,720468,0,0,266,266,
Tulsa,Superintendent of Public Instruction,Brian Kelly,REP,720468,0,0,35,35,
Tulsa,Superintendent of Public Instruction,Janet Costello Barresi,REP,720468,0,0,56,56,
Tulsa,Superintendent of Public Instruction,Joy Hofmeister,REP,720468,0,0,256,256,
Tulsa,Insurance Commissioner,Bill Viner,REP,720468,0,0,45,45,
Tulsa,Insurance Commissioner,John Doak,REP,720468,0,0,284,284,
Tulsa,Corporation Commissioner,Todd Hiett,REP,720468,0,0,187,187,
Tulsa,Corporation Commissioner,Cliff Branan,REP,720468,0,0,131,131,
Tulsa,U.S. Senate,Evelyn Rogers,REP,720468,0,0,15,15,
Tulsa,U.S. Senate,Rob Moye,REP,720468,0,0,5,5,
Tulsa,U.S. Senate,D. Jean Mcbride-Samuels,REP,720468,0,0,3,3,
Tulsa,U.S. Senate,Jim Inhofe,REP,720468,0,0,313,313,
Tulsa,U.S. Senate,Erick Paul Wyatt,REP,720468,0,0,11,11,
Tulsa,U.S. Senate,Andy Craig,REP,720468,0,0,5,5,
Tulsa,U.S. Senate,T. Shannon,REP,720468,0,0,148,148,
Tulsa,U.S. Senate,Randy Brogdon,REP,720468,0,0,41,41,
Tulsa,U.S. Senate,Eric Mccray,REP,720468,0,0,4,4,
Tulsa,U.S. Senate,Kevin Crow,REP,720468,0,0,0,0,
Tulsa,U.S. Senate,James Lankford,REP,720468,0,0,147,147,
Tulsa,U.S. Senate,Jason Weger,REP,720468,0,0,0,0,
Tulsa,State House,David Brumbaugh,REP,720468,0,0,200,200,76
Tulsa,State House,Cliff Johns,REP,720468,0,0,136,136,76
Tulsa,Superintendent of Public Instruction,John Cox,DEM,720469,0,0,7,7,
Tulsa,Superintendent of Public Instruction,Jack Jr.,DEM,720469,0,0,1,1,
Tulsa,Superintendent of Public Instruction,Ivan Holmes,DEM,720469,0,0,0,0,
Tulsa,Superintendent of Public Instruction,Freda Deskin,DEM,720469,0,0,10,10,
Tulsa,U.S. Senate,Patrick Michael Hayes,DEM,720469,0,0,3,3,
Tulsa,U.S. Senate,Jim Rogers,DEM,720469,0,0,5,5,
Tulsa,U.S. Senate,Connie Johnson,DEM,720469,0,0,10,10,
Tulsa,Governor,Dax Ewbank,REP,720469,0,0,4,4,
Tulsa,Governor,Chad Moody,REP,720469,0,0,7,7,
Tulsa,Governor,Mary Fallin,REP,720469,0,0,36,36,
Tulsa,Superintendent of Public Instruction,Brian Kelly,REP,720469,0,0,13,13,
Tulsa,Superintendent of Public Instruction,Janet Costello Barresi,REP,720469,0,0,14,14,
Tulsa,Superintendent of Public Instruction,Joy Hofmeister,REP,720469,0,0,21,21,
Tulsa,Insurance Commissioner,Bill Viner,REP,720469,0,0,6,6,
Tulsa,Insurance Commissioner,John Doak,REP,720469,0,0,37,37,
Tulsa,Corporation Commissioner,Todd Hiett,REP,720469,0,0,22,22,
Tulsa,Corporation Commissioner,Cliff Branan,REP,720469,0,0,22,22,
Tulsa,U.S. Senate,Evelyn Rogers,REP,720469,0,0,3,3,
Tulsa,U.S. Senate,Rob Moye,REP,720469,0,0,1,1,
Tulsa,U.S. Senate,D. Jean Mcbride-Samuels,REP,720469,0,0,1,1,
Tulsa,U.S. Senate,Jim Inhofe,REP,720469,0,0,39,39,
Tulsa,U.S. Senate,Erick Paul Wyatt,REP,720469,0,0,3,3,
Tulsa,U.S. Senate,Andy Craig,REP,720469,0,0,0,0,
Tulsa,U.S. Senate,T. Shannon,REP,720469,0,0,11,11,
Tulsa,U.S. Senate,Randy Brogdon,REP,720469,0,0,6,6,
Tulsa,U.S. Senate,Eric Mccray,REP,720469,0,0,1,1,
Tulsa,U.S. Senate,Kevin Crow,REP,720469,0,0,0,0,
Tulsa,U.S. Senate,James Lankford,REP,720469,0,0,29,29,
Tulsa,U.S. Senate,Jason Weger,REP,720469,0,0,0,0,
Tulsa,State House,Michael Rogers,REP,720469,0,0,30,30,98
Tulsa,State House,Terri Cleveland,REP,720469,0,0,14,14,98
Tulsa,Superintendent of Public Instruction,John Cox,DEM,720470,0,0,17,17,
Tulsa,Superintendent of Public Instruction,Jack Jr.,DEM,720470,0,0,6,6,
Tulsa,Superintendent of Public Instruction,Ivan Holmes,DEM,720470,0,0,6,6,
Tulsa,Superintendent of Public Instruction,Freda Deskin,DEM,720470,0,0,26,26,
Tulsa,U.S. Senate,Patrick Michael Hayes,DEM,720470,0,0,13,13,
Tulsa,U.S. Senate,Jim Rogers,DEM,720470,0,0,11,11,
Tulsa,U.S. Senate,Connie Johnson,DEM,720470,0,0,30,30,
Tulsa,Governor,Dax Ewbank,REP,720470,0,0,25,25,
Tulsa,Governor,Chad Moody,REP,720470,0,0,49,49,
Tulsa,Governor,Mary Fallin,REP,720470,0,0,257,257,
Tulsa,Superintendent of Public Instruction,Brian Kelly,REP,720470,0,0,44,44,
Tulsa,Superintendent of Public Instruction,Janet Costello Barresi,REP,720470,0,0,46,46,
Tulsa,Superintendent of Public Instruction,Joy Hofmeister,REP,720470,0,0,249,249,
Tulsa,Insurance Commissioner,Bill Viner,REP,720470,0,0,47,47,
Tulsa,Insurance Commissioner,John Doak,REP,720470,0,0,260,260,
Tulsa,Corporation Commissioner,Todd Hiett,REP,720470,0,0,161,161,
Tulsa,Corporation Commissioner,Cliff Branan,REP,720470,0,0,134,134,
Tulsa,U.S. Senate,Evelyn Rogers,REP,720470,0,0,17,17,
Tulsa,U.S. Senate,Rob Moye,REP,720470,0,0,3,3,
Tulsa,U.S. Senate,D. Jean Mcbride-Samuels,REP,720470,0,0,4,4,
Tulsa,U.S. Senate,Jim Inhofe,REP,720470,0,0,298,298,
Tulsa,U.S. Senate,Erick Paul Wyatt,REP,720470,0,0,11,11,
Tulsa,U.S. Senate,Andy Craig,REP,720470,0,0,2,2,
Tulsa,U.S. Senate,T. Shannon,REP,720470,0,0,135,135,
Tulsa,U.S. Senate,Randy Brogdon,REP,720470,0,0,28,28,
Tulsa,U.S. Senate,Eric Mccray,REP,720470,0,0,6,6,
Tulsa,U.S. Senate,Kevin Crow,REP,720470,0,0,1,1,
Tulsa,U.S. Senate,James Lankford,REP,720470,0,0,163,163,
Tulsa,U.S. Senate,Jason Weger,REP,720470,0,0,2,2,
Tulsa,State House,David Brumbaugh,REP,720470,0,0,225,225,76
Tulsa,State House,Cliff Johns,REP,720470,0,0,94,94,76
Tulsa,Superintendent of Public Instruction,John Cox,DEM,720471,0,0,3,3,
Tulsa,Superintendent of Public Instruction,Jack Jr.,DEM,720471,0,0,2,2,
Tulsa,Superintendent of Public Instruction,Ivan Holmes,DEM,720471,0,0,0,0,
Tulsa,Superintendent of Public Instruction,Freda Deskin,DEM,720471,0,0,4,4,
Tulsa,U.S. Senate,Patrick Michael Hayes,DEM,720471,0,0,0,0,
Tulsa,U.S. Senate,Jim Rogers,DEM,720471,0,0,2,2,
Tulsa,U.S. Senate,Connie Johnson,DEM,720471,0,0,9,9,
Tulsa,Governor,Dax Ewbank,REP,720471,0,0,7,7,
Tulsa,Governor,Chad Moody,REP,720471,0,0,24,24,
Tulsa,Governor,Mary Fallin,REP,720471,0,0,164,164,
Tulsa,Superintendent of Public Instruction,Brian Kelly,REP,720471,0,0,29,29,
Tulsa,Superintendent of Public Instruction,Janet Costello Barresi,REP,720471,0,0,34,34,
Tulsa,Superintendent of Public Instruction,Joy Hofmeister,REP,720471,0,0,134,134,
Tulsa,Insurance Commissioner,Bill Viner,REP,720471,0,0,23,23,
Tulsa,Insurance Commissioner,John Doak,REP,720471,0,0,160,160,
Tulsa,Corporation Commissioner,Todd Hiett,REP,720471,0,0,103,103,
Tulsa,Corporation Commissioner,Cliff Branan,REP,720471,0,0,76,76,
Tulsa,U.S. Senate,Evelyn Rogers,REP,720471,0,0,9,9,
Tulsa,U.S. Senate,Rob Moye,REP,720471,0,0,1,1,
Tulsa,U.S. Senate,D. Jean Mcbride-Samuels,REP,720471,0,0,1,1,
Tulsa,U.S. Senate,Jim Inhofe,REP,720471,0,0,174,174,
Tulsa,U.S. Senate,Erick Paul Wyatt,REP,720471,0,0,10,10,
Tulsa,U.S. Senate,Andy Craig,REP,720471,0,0,3,3,
Tulsa,U.S. Senate,T. Shannon,REP,720471,0,0,81,81,
Tulsa,U.S. Senate,Randy Brogdon,REP,720471,0,0,12,12,
Tulsa,U.S. Senate,Eric Mccray,REP,720471,0,0,2,2,
Tulsa,U.S. Senate,Kevin Crow,REP,720471,0,0,0,0,
Tulsa,U.S. Senate,James Lankford,REP,720471,0,0,98,98,
Tulsa,U.S. Senate,Jason Weger,REP,720471,0,0,1,1,
Tulsa,State House,David Brumbaugh,REP,720471,0,0,149,149,76
Tulsa,State House,Cliff Johns,REP,720471,0,0,36,36,76
Tulsa,Superintendent of Public Instruction,John Cox,DEM,720472,0,0,12,12,
Tulsa,Superintendent of Public Instruction,Jack Jr.,DEM,720472,0,0,2,2,
Tulsa,Superintendent of Public Instruction,Ivan Holmes,DEM,720472,0,0,0,0,
Tulsa,Superintendent of Public Instruction,Freda Deskin,DEM,720472,0,0,13,13,
Tulsa,U.S. Senate,Patrick Michael Hayes,DEM,720472,0,0,7,7,
Tulsa,U.S. Senate,Jim Rogers,DEM,720472,0,0,3,3,
Tulsa,U.S. Senate,Connie Johnson,DEM,720472,0,0,16,16,
Tulsa,Governor,Dax Ewbank,REP,720472,0,0,10,10,
Tulsa,Governor,Chad Moody,REP,720472,0,0,26,26,
Tulsa,Governor,Mary Fallin,REP,720472,0,0,97,97,
Tulsa,Superintendent of Public Instruction,Brian Kelly,REP,720472,0,0,15,15,
Tulsa,Superintendent of Public Instruction,Janet Costello Barresi,REP,720472,0,0,30,30,
Tulsa,Superintendent of Public Instruction,Joy Hofmeister,REP,720472,0,0,93,93,
Tulsa,Insurance Commissioner,Bill Viner,REP,720472,0,0,21,21,
Tulsa,Insurance Commissioner,John Doak,REP,720472,0,0,104,104,
Tulsa,Corporation Commissioner,Todd Hiett,REP,720472,0,0,78,78,
Tulsa,Corporation Commissioner,Cliff Branan,REP,720472,0,0,44,44,
Tulsa,U.S. Senate,Evelyn Rogers,REP,720472,0,0,4,4,
Tulsa,U.S. Senate,Rob Moye,REP,720472,0,0,2,2,
Tulsa,U.S. Senate,D. Jean Mcbride-Samuels,REP,720472,0,0,2,2,
Tulsa,U.S. Senate,Jim Inhofe,REP,720472,0,0,123,123,
Tulsa,U.S. Senate,Erick Paul Wyatt,REP,720472,0,0,5,5,
Tulsa,U.S. Senate,Andy Craig,REP,720472,0,0,0,0,
Tulsa,U.S. Senate,T. Shannon,REP,720472,0,0,54,54,
Tulsa,U.S. Senate,Randy Brogdon,REP,720472,0,0,12,12,
Tulsa,U.S. Senate,Eric Mccray,REP,720472,0,0,0,0,
Tulsa,U.S. Senate,Kevin Crow,REP,720472,0,0,0,0,
Tulsa,U.S. Senate,James Lankford,REP,720472,0,0,69,69,
Tulsa,U.S. Senate,Jason Weger,REP,720472,0,0,0,0,
Tulsa,Superintendent of Public Instruction,John Cox,DEM,720473,0,0,14,14,
Tulsa,Superintendent of Public Instruction,Jack Jr.,DEM,720473,0,0,1,1,
Tulsa,Superintendent of Public Instruction,Ivan Holmes,DEM,720473,0,0,5,5,
Tulsa,Superintendent of Public Instruction,Freda Deskin,DEM,720473,0,0,14,14,
Tulsa,U.S. Senate,Patrick Michael Hayes,DEM,720473,0,0,6,6,
Tulsa,U.S. Senate,Jim Rogers,DEM,720473,0,0,10,10,
Tulsa,U.S. Senate,Connie Johnson,DEM,720473,0,0,18,18,
Tulsa,Governor,Dax Ewbank,REP,720473,0,0,22,22,
Tulsa,Governor,Chad Moody,REP,720473,0,0,23,23,
Tulsa,Governor,Mary Fallin,REP,720473,0,0,132,132,
Tulsa,Superintendent of Public Instruction,Brian Kelly,REP,720473,0,0,34,34,
Tulsa,Superintendent of Public Instruction,Janet Costello Barresi,REP,720473,0,0,30,30,
Tulsa,Superintendent of Public Instruction,Joy Hofmeister,REP,720473,0,0,114,114,
Tulsa,Insurance Commissioner,Bill Viner,REP,720473,0,0,22,22,
Tulsa,Insurance Commissioner,John Doak,REP,720473,0,0,135,135,
Tulsa,Corporation Commissioner,Todd Hiett,REP,720473,0,0,92,92,
Tulsa,Corporation Commissioner,Cliff Branan,REP,720473,0,0,66,66,
Tulsa,U.S. Senate,Evelyn Rogers,REP,720473,0,0,7,7,
Tulsa,U.S. Senate,Rob Moye,REP,720473,0,0,3,3,
Tulsa,U.S. Senate,D. Jean Mcbride-Samuels,REP,720473,0,0,4,4,
Tulsa,U.S. Senate,Jim Inhofe,REP,720473,0,0,158,158,
Tulsa,U.S. Senate,Erick Paul Wyatt,REP,720473,0,0,5,5,
Tulsa,U.S. Senate,Andy Craig,REP,720473,0,0,3,3,
Tulsa,U.S. Senate,T. Shannon,REP,720473,0,0,80,80,
Tulsa,U.S. Senate,Randy Brogdon,REP,720473,0,0,18,18,
Tulsa,U.S. Senate,Eric Mccray,REP,720473,0,0,2,2,
Tulsa,U.S. Senate,Kevin Crow,REP,720473,0,0,0,0,
Tulsa,U.S. Senate,James Lankford,REP,720473,0,0,73,73,
Tulsa,U.S. Senate,Jason Weger,REP,720473,0,0,3,3,
Tulsa,Superintendent of Public Instruction,John Cox,DEM,720474,0,0,29,29,
Tulsa,Superintendent of Public Instruction,Jack Jr.,DEM,720474,0,0,7,7,
Tulsa,Superintendent of Public Instruction,Ivan Holmes,DEM,720474,0,0,7,7,
Tulsa,Superintendent of Public Instruction,Freda Deskin,DEM,720474,0,0,30,30,
Tulsa,U.S. Senate,Patrick Michael Hayes,DEM,720474,0,0,9,9,
Tulsa,U.S. Senate,Jim Rogers,DEM,720474,0,0,17,17,
Tulsa,U.S. Senate,Connie Johnson,DEM,720474,0,0,45,45,
Tulsa,Governor,Dax Ewbank,REP,720474,0,0,23,23,
Tulsa,Governor,Chad Moody,REP,720474,0,0,48,48,
Tulsa,Governor,Mary Fallin,REP,720474,0,0,282,282,
Tulsa,Superintendent of Public Instruction,Brian Kelly,REP,720474,0,0,54,54,
Tulsa,Superintendent of Public Instruction,Janet Costello Barresi,REP,720474,0,0,60,60,
Tulsa,Superintendent of Public Instruction,Joy Hofmeister,REP,720474,0,0,246,246,
Tulsa,Insurance Commissioner,Bill Viner,REP,720474,0,0,75,75,
Tulsa,Insurance Commissioner,John Doak,REP,720474,0,0,252,252,
Tulsa,Corporation Commissioner,Todd Hiett,REP,720474,0,0,167,167,
Tulsa,Corporation Commissioner,Cliff Branan,REP,720474,0,0,160,160,
Tulsa,U.S. Senate,Evelyn Rogers,REP,720474,0,0,12,12,
Tulsa,U.S. Senate,Rob Moye,REP,720474,0,0,6,6,
Tulsa,U.S. Senate,D. Jean Mcbride-Samuels,REP,720474,0,0,11,11,
Tulsa,U.S. Senate,Jim Inhofe,REP,720474,0,0,314,314,
Tulsa,U.S. Senate,Erick Paul Wyatt,REP,720474,0,0,16,16,
Tulsa,U.S. Senate,Andy Craig,REP,720474,0,0,8,8,
Tulsa,U.S. Senate,T. Shannon,REP,720474,0,0,139,139,
Tulsa,U.S. Senate,Randy Brogdon,REP,720474,0,0,44,44,
Tulsa,U.S. Senate,Eric Mccray,REP,720474,0,0,1,1,
Tulsa,U.S. Senate,Kevin Crow,REP,720474,0,0,0,0,
Tulsa,U.S. Senate,James Lankford,REP,720474,0,0,169,169,
Tulsa,U.S. Senate,Jason Weger,REP,720474,0,0,0,0,
Tulsa,State House,David Brumbaugh,REP,720474,0,0,239,239,76
Tulsa,State House,Cliff Johns,REP,720474,0,0,101,101,76
Tulsa,Superintendent of Public Instruction,John Cox,DEM,720475,0,0,20,20,
Tulsa,Superintendent of Public Instruction,Jack Jr.,DEM,720475,0,0,5,5,
Tulsa,Superintendent of Public Instruction,Ivan Holmes,DEM,720475,0,0,2,2,
Tulsa,Superintendent of Public Instruction,Freda Deskin,DEM,720475,0,0,25,25,
Tulsa,U.S. Senate,Patrick Michael Hayes,DEM,720475,0,0,9,9,
Tulsa,U.S. Senate,Jim Rogers,DEM,720475,0,0,12,12,
Tulsa,U.S. Senate,Connie Johnson,DEM,720475,0,0,29,29,
Tulsa,Governor,Dax Ewbank,REP,720475,0,0,33,33,
Tulsa,Governor,Chad Moody,REP,720475,0,0,41,41,
Tulsa,Governor,Mary Fallin,REP,720475,0,0,297,297,
Tulsa,Superintendent of Public Instruction,Brian Kelly,REP,720475,0,0,52,52,
Tulsa,Superintendent of Public Instruction,Janet Costello Barresi,REP,720475,0,0,65,65,
Tulsa,Superintendent of Public Instruction,Joy Hofmeister,REP,720475,0,0,248,248,
Tulsa,Insurance Commissioner,Bill Viner,REP,720475,0,0,71,71,
Tulsa,Insurance Commissioner,John Doak,REP,720475,0,0,268,268,
Tulsa,Corporation Commissioner,Todd Hiett,REP,720475,0,0,204,204,
Tulsa,Corporation Commissioner,Cliff Branan,REP,720475,0,0,136,136,
Tulsa,U.S. Senate,Evelyn Rogers,REP,720475,0,0,20,20,
Tulsa,U.S. Senate,Rob Moye,REP,720475,0,0,6,6,
Tulsa,U.S. Senate,D. Jean Mcbride-Samuels,REP,720475,0,0,0,0,
Tulsa,U.S. Senate,Jim Inhofe,REP,720475,0,0,325,325,
Tulsa,U.S. Senate,Erick Paul Wyatt,REP,720475,0,0,20,20,
Tulsa,U.S. Senate,Andy Craig,REP,720475,0,0,4,4,
Tulsa,U.S. Senate,T. Shannon,REP,720475,0,0,154,154,
Tulsa,U.S. Senate,Randy Brogdon,REP,720475,0,0,37,37,
Tulsa,U.S. Senate,Eric Mccray,REP,720475,0,0,0,0,
Tulsa,U.S. Senate,Kevin Crow,REP,720475,0,0,1,1,
Tulsa,U.S. Senate,James Lankford,REP,720475,0,0,176,176,
Tulsa,U.S. Senate,Jason Weger,REP,720475,0,0,1,1,
Tulsa,Superintendent of Public Instruction,John Cox,DEM,720476,0,0,15,15,
Tulsa,Superintendent of Public Instruction,Jack Jr.,DEM,720476,0,0,0,0,
Tulsa,Superintendent of Public Instruction,Ivan Holmes,DEM,720476,0,0,1,1,
Tulsa,Superintendent of Public Instruction,Freda Deskin,DEM,720476,0,0,11,11,
Tulsa,U.S. Senate,Patrick Michael Hayes,DEM,720476,0,0,8,8,
Tulsa,U.S. Senate,Jim Rogers,DEM,720476,0,0,5,5,
Tulsa,U.S. Senate,Connie Johnson,DEM,720476,0,0,11,11,
Tulsa,Governor,Dax Ewbank,REP,720476,0,0,11,11,
Tulsa,Governor,Chad Moody,REP,720476,0,0,14,14,
Tulsa,Governor,Mary Fallin,REP,720476,0,0,81,81,
Tulsa,Superintendent of Public Instruction,Brian Kelly,REP,720476,0,0,13,13,
Tulsa,Superintendent of Public Instruction,Janet Costello Barresi,REP,720476,0,0,16,16,
Tulsa,Superintendent of Public Instruction,Joy Hofmeister,REP,720476,0,0,78,78,
Tulsa,Insurance Commissioner,Bill Viner,REP,720476,0,0,20,20,
Tulsa,Insurance Commissioner,John Doak,REP,720476,0,0,80,80,
Tulsa,Corporation Commissioner,Todd Hiett,REP,720476,0,0,56,56,
Tulsa,Corporation Commissioner,Cliff Branan,REP,720476,0,0,41,41,
Tulsa,U.S. Senate,Evelyn Rogers,REP,720476,0,0,3,3,
Tulsa,U.S. Senate,Rob Moye,REP,720476,0,0,0,0,
Tulsa,U.S. Senate,D. Jean Mcbride-Samuels,REP,720476,0,0,2,2,
Tulsa,U.S. Senate,Jim Inhofe,REP,720476,0,0,98,98,
Tulsa,U.S. Senate,Erick Paul Wyatt,REP,720476,0,0,5,5,
Tulsa,U.S. Senate,Andy Craig,REP,720476,0,0,0,0,
Tulsa,U.S. Senate,T. Shannon,REP,720476,0,0,53,53,
Tulsa,U.S. Senate,Randy Brogdon,REP,720476,0,0,6,6,
Tulsa,U.S. Senate,Eric Mccray,REP,720476,0,0,2,2,
Tulsa,U.S. Senate,Kevin Crow,REP,720476,0,0,1,1,
Tulsa,U.S. Senate,James Lankford,REP,720476,0,0,47,47,
Tulsa,U.S. Senate,Jason Weger,REP,720476,0,0,0,0,
Tulsa,State House,Michael Rogers,REP,720476,0,0,71,71,98
Tulsa,State House,Terri Cleveland,REP,720476,0,0,24,24,98
Tulsa,Superintendent of Public Instruction,John Cox,DEM,720501,0,0,24,24,
Tulsa,Superintendent of Public Instruction,Jack Jr.,DEM,720501,0,0,2,2,
Tulsa,Superintendent of Public Instruction,Ivan Holmes,DEM,720501,0,0,1,1,
Tulsa,Superintendent of Public Instruction,Freda Deskin,DEM,720501,0,0,14,14,
Tulsa,U.S. Senate,Patrick Michael Hayes,DEM,720501,0,0,10,10,
Tulsa,U.S. Senate,Jim Rogers,DEM,720501,0,0,12,12,
Tulsa,U.S. Senate,Connie Johnson,DEM,720501,0,0,18,18,
Tulsa,Governor,Dax Ewbank,REP,720501,0,0,5,5,
Tulsa,Governor,Chad Moody,REP,720501,0,0,21,21,
Tulsa,Governor,Mary Fallin,REP,720501,0,0,119,119,
Tulsa,Superintendent of Public Instruction,Brian Kelly,REP,720501,0,0,16,16,
Tulsa,Superintendent of Public Instruction,Janet Costello Barresi,REP,720501,0,0,36,36,
Tulsa,Superintendent of Public Instruction,Joy Hofmeister,REP,720501,0,0,92,92,
Tulsa,Insurance Commissioner,Bill Viner,REP,720501,0,0,29,29,
Tulsa,Insurance Commissioner,John Doak,REP,720501,0,0,104,104,
Tulsa,Corporation Commissioner,Todd Hiett,REP,720501,0,0,69,69,
Tulsa,Corporation Commissioner,Cliff Branan,REP,720501,0,0,69,69,
Tulsa,U.S. Senate,Evelyn Rogers,REP,720501,0,0,4,4,
Tulsa,U.S. Senate,Rob Moye,REP,720501,0,0,1,1,
Tulsa,U.S. Senate,D. Jean Mcbride-Samuels,REP,720501,0,0,1,1,
Tulsa,U.S. Senate,Jim Inhofe,REP,720501,0,0,133,133,
Tulsa,U.S. Senate,Erick Paul Wyatt,REP,720501,0,0,7,7,
Tulsa,U.S. Senate,Andy Craig,REP,720501,0,0,3,3,
Tulsa,U.S. Senate,T. Shannon,REP,720501,0,0,60,60,
Tulsa,U.S. Senate,Randy Brogdon,REP,720501,0,0,23,23,
Tulsa,U.S. Senate,Eric Mccray,REP,720501,0,0,0,0,
Tulsa,U.S. Senate,Kevin Crow,REP,720501,0,0,0,0,
Tulsa,U.S. Senate,James Lankford,REP,720501,0,0,58,58,
Tulsa,U.S. Senate,Jason Weger,REP,720501,0,0,2,2,
Tulsa,Superintendent of Public Instruction,John Cox,DEM,720502,0,0,40,40,
Tulsa,Superintendent of Public Instruction,Jack Jr.,DEM,720502,0,0,8,8,
Tulsa,Superintendent of Public Instruction,Ivan Holmes,DEM,720502,0,0,3,3,
Tulsa,Superintendent of Public Instruction,Freda Deskin,DEM,720502,0,0,27,27,
Tulsa,U.S. Senate,Patrick Michael Hayes,DEM,720502,0,0,15,15,
Tulsa,U.S. Senate,Jim Rogers,DEM,720502,0,0,31,31,
Tulsa,U.S. Senate,Connie Johnson,DEM,720502,0,0,31,31,
Tulsa,Governor,Dax Ewbank,REP,720502,0,0,29,29,
Tulsa,Governor,Chad Moody,REP,720502,0,0,49,49,
Tulsa,Governor,Mary Fallin,REP,720502,0,0,157,157,
Tulsa,Superintendent of Public Instruction,Brian Kelly,REP,720502,0,0,46,46,
Tulsa,Superintendent of Public Instruction,Janet Costello Barresi,REP,720502,0,0,26,26,
Tulsa,Superintendent of Public Instruction,Joy Hofmeister,REP,720502,0,0,167,167,
Tulsa,Insurance Commissioner,Bill Viner,REP,720502,0,0,72,72,
Tulsa,Insurance Commissioner,John Doak,REP,720502,0,0,150,150,
Tulsa,Corporation Commissioner,Todd Hiett,REP,720502,0,0,119,119,
Tulsa,Corporation Commissioner,Cliff Branan,REP,720502,0,0,103,103,
Tulsa,U.S. Senate,Evelyn Rogers,REP,720502,0,0,12,12,
Tulsa,U.S. Senate,Rob Moye,REP,720502,0,0,5,5,
Tulsa,U.S. Senate,D. Jean Mcbride-Samuels,REP,720502,0,0,5,5,
Tulsa,U.S. Senate,Jim Inhofe,REP,720502,0,0,206,206,
Tulsa,U.S. Senate,Erick Paul Wyatt,REP,720502,0,0,7,7,
Tulsa,U.S. Senate,Andy Craig,REP,720502,0,0,2,2,
Tulsa,U.S. Senate,T. Shannon,REP,720502,0,0,93,93,
Tulsa,U.S. Senate,Randy Brogdon,REP,720502,0,0,46,46,
Tulsa,U.S. Senate,Eric Mccray,REP,720502,0,0,0,0,
Tulsa,U.S. Senate,Kevin Crow,REP,720502,0,0,3,3,
Tulsa,U.S. Senate,James Lankford,REP,720502,0,0,94,94,
Tulsa,U.S. Senate,Jason Weger,REP,720502,0,0,1,1,
Tulsa,Superintendent of Public Instruction,John Cox,DEM,720503,0,0,30,30,
Tulsa,Superintendent of Public Instruction,Jack Jr.,DEM,720503,0,0,10,10,
Tulsa,Superintendent of Public Instruction,Ivan Holmes,DEM,720503,0,0,5,5,
Tulsa,Superintendent of Public Instruction,Freda Deskin,DEM,720503,0,0,24,24,
Tulsa,U.S. Senate,Patrick Michael Hayes,DEM,720503,0,0,16,16,
Tulsa,U.S. Senate,Jim Rogers,DEM,720503,0,0,22,22,
Tulsa,U.S. Senate,Connie Johnson,DEM,720503,0,0,30,30,
Tulsa,Governor,Dax Ewbank,REP,720503,0,0,17,17,
Tulsa,Governor,Chad Moody,REP,720503,0,0,32,32,
Tulsa,Governor,Mary Fallin,REP,720503,0,0,102,102,
Tulsa,Superintendent of Public Instruction,Brian Kelly,REP,720503,0,0,24,24,
Tulsa,Superintendent of Public Instruction,Janet Costello Barresi,REP,720503,0,0,16,16,
Tulsa,Superintendent of Public Instruction,Joy Hofmeister,REP,720503,0,0,111,111,
Tulsa,Insurance Commissioner,Bill Viner,REP,720503,0,0,28,28,
Tulsa,Insurance Commissioner,John Doak,REP,720503,0,0,116,116,
Tulsa,Corporation Commissioner,Todd Hiett,REP,720503,0,0,64,64,
Tulsa,Corporation Commissioner,Cliff Branan,REP,720503,0,0,82,82,
Tulsa,U.S. Senate,Evelyn Rogers,REP,720503,0,0,3,3,
Tulsa,U.S. Senate,Rob Moye,REP,720503,0,0,1,1,
Tulsa,U.S. Senate,D. Jean Mcbride-Samuels,REP,720503,0,0,4,4,
Tulsa,U.S. Senate,Jim Inhofe,REP,720503,0,0,137,137,
Tulsa,U.S. Senate,Erick Paul Wyatt,REP,720503,0,0,10,10,
Tulsa,U.S. Senate,Andy Craig,REP,720503,0,0,0,0,
Tulsa,U.S. Senate,T. Shannon,REP,720503,0,0,60,60,
Tulsa,U.S. Senate,Randy Brogdon,REP,720503,0,0,22,22,
Tulsa,U.S. Senate,Eric Mccray,REP,720503,0,0,2,2,
Tulsa,U.S. Senate,Kevin Crow,REP,720503,0,0,2,2,
Tulsa,U.S. Senate,James Lankford,REP,720503,0,0,70,70,
Tulsa,U.S. Senate,Jason Weger,REP,720503,0,0,0,0,
Tulsa,Superintendent of Public Instruction,John Cox,DEM,720504,0,0,66,66,
Tulsa,Superintendent of Public Instruction,Jack Jr.,DEM,720504,0,0,3,3,
Tulsa,Superintendent of Public Instruction,Ivan Holmes,DEM,720504,0,0,2,2,
Tulsa,Superintendent of Public Instruction,Freda Deskin,DEM,720504,0,0,20,20,
Tulsa,U.S. Senate,Patrick Michael Hayes,DEM,720504,0,0,15,15,
Tulsa,U.S. Senate,Jim Rogers,DEM,720504,0,0,41,41,
Tulsa,U.S. Senate,Connie Johnson,DEM,720504,0,0,30,30,
Tulsa,Governor,Dax Ewbank,REP,720504,0,0,21,21,
Tulsa,Governor,Chad Moody,REP,720504,0,0,49,49,
Tulsa,Governor,Mary Fallin,REP,720504,0,0,195,195,
Tulsa,Superintendent of Public Instruction,Brian Kelly,REP,720504,0,0,37,37,
Tulsa,Superintendent of Public Instruction,Janet Costello Barresi,REP,720504,0,0,39,39,
Tulsa,Superintendent of Public Instruction,Joy Hofmeister,REP,720504,0,0,194,194,
Tulsa,Insurance Commissioner,Bill Viner,REP,720504,0,0,79,79,
Tulsa,Insurance Commissioner,John Doak,REP,720504,0,0,171,171,
Tulsa,Corporation Commissioner,Todd Hiett,REP,720504,0,0,135,135,
Tulsa,Corporation Commissioner,Cliff Branan,REP,720504,0,0,118,118,
Tulsa,U.S. Senate,Evelyn Rogers,REP,720504,0,0,10,10,
Tulsa,U.S. Senate,Rob Moye,REP,720504,0,0,4,4,
Tulsa,U.S. Senate,D. Jean Mcbride-Samuels,REP,720504,0,0,6,6,
Tulsa,U.S. Senate,Jim Inhofe,REP,720504,0,0,235,235,
Tulsa,U.S. Senate,Erick Paul Wyatt,REP,720504,0,0,7,7,
Tulsa,U.S. Senate,Andy Craig,REP,720504,0,0,1,1,
Tulsa,U.S. Senate,T. Shannon,REP,720504,0,0,95,95,
Tulsa,U.S. Senate,Randy Brogdon,REP,720504,0,0,42,42,
Tulsa,U.S. Senate,Eric Mccray,REP,720504,0,0,1,1,
Tulsa,U.S. Senate,Kevin Crow,REP,720504,0,0,3,3,
Tulsa,U.S. Senate,James Lankford,REP,720504,0,0,126,126,
Tulsa,U.S. Senate,Jason Weger,REP,720504,0,0,1,1,
Tulsa,Superintendent of Public Instruction,John Cox,DEM,720551,0,0,8,8,
Tulsa,Superintendent of Public Instruction,Jack Jr.,DEM,720551,0,0,4,4,
Tulsa,Superintendent of Public Instruction,Ivan Holmes,DEM,720551,0,0,2,2,
Tulsa,Superintendent of Public Instruction,Freda Deskin,DEM,720551,0,0,9,9,
Tulsa,U.S. Senate,Patrick Michael Hayes,DEM,720551,0,0,9,9,
Tulsa,U.S. Senate,Jim Rogers,DEM,720551,0,0,4,4,
Tulsa,U.S. Senate,Connie Johnson,DEM,720551,0,0,9,9,
Tulsa,Governor,Dax Ewbank,REP,720551,0,0,3,3,
Tulsa,Governor,Chad Moody,REP,720551,0,0,8,8,
Tulsa,Governor,Mary Fallin,REP,720551,0,0,29,29,
Tulsa,Superintendent of Public Instruction,Brian Kelly,REP,720551,0,0,9,9,
Tulsa,Superintendent of Public Instruction,Janet Costello Barresi,REP,720551,0,0,4,4,
Tulsa,Superintendent of Public Instruction,Joy Hofmeister,REP,720551,0,0,27,27,
Tulsa,Insurance Commissioner,Bill Viner,REP,720551,0,0,3,3,
Tulsa,Insurance Commissioner,John Doak,REP,720551,0,0,36,36,
Tulsa,Corporation Commissioner,Todd Hiett,REP,720551,0,0,22,22,
Tulsa,Corporation Commissioner,Cliff Branan,REP,720551,0,0,18,18,
Tulsa,U.S. Senate,Evelyn Rogers,REP,720551,0,0,4,4,
Tulsa,U.S. Senate,Rob Moye,REP,720551,0,0,0,0,
Tulsa,U.S. Senate,D. Jean Mcbride-Samuels,REP,720551,0,0,0,0,
Tulsa,U.S. Senate,Jim Inhofe,REP,720551,0,0,33,33,
Tulsa,U.S. Senate,Erick Paul Wyatt,REP,720551,0,0,4,4,
Tulsa,U.S. Senate,Andy Craig,REP,720551,0,0,0,0,
Tulsa,U.S. Senate,T. Shannon,REP,720551,0,0,13,13,
Tulsa,U.S. Senate,Randy Brogdon,REP,720551,0,0,13,13,
Tulsa,U.S. Senate,Eric Mccray,REP,720551,0,0,0,0,
Tulsa,U.S. Senate,Kevin Crow,REP,720551,0,0,0,0,
Tulsa,U.S. Senate,James Lankford,REP,720551,0,0,14,14,
Tulsa,U.S. Senate,Jason Weger,REP,720551,0,0,1,1,
Tulsa,Superintendent of Public Instruction,John Cox,DEM,720552,0,0,21,21,
Tulsa,Superintendent of Public Instruction,Jack Jr.,DEM,720552,0,0,17,17,
Tulsa,Superintendent of Public Instruction,Ivan Holmes,DEM,720552,0,0,1,1,
Tulsa,Superintendent of Public Instruction,Freda Deskin,DEM,720552,0,0,20,20,
Tulsa,U.S. Senate,Patrick Michael Hayes,DEM,720552,0,0,17,17,
Tulsa,U.S. Senate,Jim Rogers,DEM,720552,0,0,23,23,
Tulsa,U.S. Senate,Connie Johnson,DEM,720552,0,0,16,16,
Tulsa,Governor,Dax Ewbank,REP,720552,0,0,20,20,
Tulsa,Governor,Chad Moody,REP,720552,0,0,17,17,
Tulsa,Governor,Mary Fallin,REP,720552,0,0,74,74,
Tulsa,Superintendent of Public Instruction,Brian Kelly,REP,720552,0,0,22,22,
Tulsa,Superintendent of Public Instruction,Janet Costello Barresi,REP,720552,0,0,11,11,
Tulsa,Superintendent of Public Instruction,Joy Hofmeister,REP,720552,0,0,79,79,
Tulsa,Insurance Commissioner,Bill Viner,REP,720552,0,0,21,21,
Tulsa,Insurance Commissioner,John Doak,REP,720552,0,0,82,82,
Tulsa,Corporation Commissioner,Todd Hiett,REP,720552,0,0,61,61,
Tulsa,Corporation Commissioner,Cliff Branan,REP,720552,0,0,41,41,
Tulsa,U.S. Senate,Evelyn Rogers,REP,720552,0,0,6,6,
Tulsa,U.S. Senate,Rob Moye,REP,720552,0,0,1,1,
Tulsa,U.S. Senate,D. Jean Mcbride-Samuels,REP,720552,0,0,0,0,
Tulsa,U.S. Senate,Jim Inhofe,REP,720552,0,0,99,99,
Tulsa,U.S. Senate,Erick Paul Wyatt,REP,720552,0,0,3,3,
Tulsa,U.S. Senate,Andy Craig,REP,720552,0,0,1,1,
Tulsa,U.S. Senate,T. Shannon,REP,720552,0,0,44,44,
Tulsa,U.S. Senate,Randy Brogdon,REP,720552,0,0,15,15,
Tulsa,U.S. Senate,Eric Mccray,REP,720552,0,0,2,2,
Tulsa,U.S. Senate,Kevin Crow,REP,720552,0,0,0,0,
Tulsa,U.S. Senate,James Lankford,REP,720552,0,0,49,49,
Tulsa,U.S. Senate,Jason Weger,REP,720552,0,0,1,1,
Tulsa,Superintendent of Public Instruction,John Cox,DEM,720553,0,0,15,15,
Tulsa,Superintendent of Public Instruction,Jack Jr.,DEM,720553,0,0,3,3,
Tulsa,Superintendent of Public Instruction,Ivan Holmes,DEM,720553,0,0,1,1,
Tulsa,Superintendent of Public Instruction,Freda Deskin,DEM,720553,0,0,15,15,
Tulsa,U.S. Senate,Patrick Michael Hayes,DEM,720553,0,0,6,6,
Tulsa,U.S. Senate,Jim Rogers,DEM,720553,0,0,13,13,
Tulsa,U.S. Senate,Connie Johnson,DEM,720553,0,0,15,15,
Tulsa,Governor,Dax Ewbank,REP,720553,0,0,6,6,
Tulsa,Governor,Chad Moody,REP,720553,0,0,11,11,
Tulsa,Governor,Mary Fallin,REP,720553,0,0,39,39,
Tulsa,Superintendent of Public Instruction,Brian Kelly,REP,720553,0,0,7,7,
Tulsa,Superintendent of Public Instruction,Janet Costello Barresi,REP,720553,0,0,10,10,
Tulsa,Superintendent of Public Instruction,Joy Hofmeister,REP,720553,0,0,40,40,
Tulsa,Insurance Commissioner,Bill Viner,REP,720553,0,0,10,10,
Tulsa,Insurance Commissioner,John Doak,REP,720553,0,0,44,44,
Tulsa,Corporation Commissioner,Todd Hiett,REP,720553,0,0,32,32,
Tulsa,Corporation Commissioner,Cliff Branan,REP,720553,0,0,23,23,
Tulsa,U.S. Senate,Evelyn Rogers,REP,720553,0,0,5,5,
Tulsa,U.S. Senate,Rob Moye,REP,720553,0,0,0,0,
Tulsa,U.S. Senate,D. Jean Mcbride-Samuels,REP,720553,0,0,0,0,
Tulsa,U.S. Senate,Jim Inhofe,REP,720553,0,0,51,51,
Tulsa,U.S. Senate,Erick Paul Wyatt,REP,720553,0,0,2,2,
Tulsa,U.S. Senate,Andy Craig,REP,720553,0,0,0,0,
Tulsa,U.S. Senate,T. Shannon,REP,720553,0,0,34,34,
Tulsa,U.S. Senate,Randy Brogdon,REP,720553,0,0,12,12,
Tulsa,U.S. Senate,Eric Mccray,REP,720553,0,0,0,0,
Tulsa,U.S. Senate,Kevin Crow,REP,720553,0,0,0,0,
Tulsa,U.S. Senate,James Lankford,REP,720553,0,0,12,12,
Tulsa,U.S. Senate,Jason Weger,REP,720553,0,0,0,0,
Tulsa,Superintendent of Public Instruction,John Cox,DEM,720700,0,0,23,23,
Tulsa,Superintendent of Public Instruction,Jack Jr.,DEM,720700,0,0,4,4,
Tulsa,Superintendent of Public Instruction,Ivan Holmes,DEM,720700,0,0,5,5,
Tulsa,Superintendent of Public Instruction,Freda Deskin,DEM,720700,0,0,25,25,
Tulsa,U.S. Senate,Patrick Michael Hayes,DEM,720700,0,0,5,5,
Tulsa,U.S. Senate,Jim Rogers,DEM,720700,0,0,20,20,
Tulsa,U.S. Senate,Connie Johnson,DEM,720700,0,0,30,30,
Tulsa,Governor,Dax Ewbank,REP,720700,0,0,37,37,
Tulsa,Governor,Chad Moody,REP,720700,0,0,54,54,
Tulsa,Governor,Mary Fallin,REP,720700,0,0,332,332,
Tulsa,Superintendent of Public Instruction,Brian Kelly,REP,720700,0,0,44,44,
Tulsa,Superintendent of Public Instruction,Janet Costello Barresi,REP,720700,0,0,49,49,
Tulsa,Superintendent of Public Instruction,Joy Hofmeister,REP,720700,0,0,332,332,
Tulsa,Insurance Commissioner,Bill Viner,REP,720700,0,0,68,68,
Tulsa,Insurance Commissioner,John Doak,REP,720700,0,0,323,323,
Tulsa,Corporation Commissioner,Todd Hiett,REP,720700,0,0,239,239,
Tulsa,Corporation Commissioner,Cliff Branan,REP,720700,0,0,133,133,
Tulsa,U.S. Senate,Evelyn Rogers,REP,720700,0,0,17,17,
Tulsa,U.S. Senate,Rob Moye,REP,720700,0,0,3,3,
Tulsa,U.S. Senate,D. Jean Mcbride-Samuels,REP,720700,0,0,7,7,
Tulsa,U.S. Senate,Jim Inhofe,REP,720700,0,0,390,390,
Tulsa,U.S. Senate,Erick Paul Wyatt,REP,720700,0,0,10,10,
Tulsa,U.S. Senate,Andy Craig,REP,720700,0,0,2,2,
Tulsa,U.S. Senate,T. Shannon,REP,720700,0,0,152,152,
Tulsa,U.S. Senate,Randy Brogdon,REP,720700,0,0,38,38,
Tulsa,U.S. Senate,Eric Mccray,REP,720700,0,0,2,2,
Tulsa,U.S. Senate,Kevin Crow,REP,720700,0,0,3,3,
Tulsa,U.S. Senate,James Lankford,REP,720700,0,0,231,231,
Tulsa,U.S. Senate,Jason Weger,REP,720700,0,0,3,3,
Tulsa,State House,Melissa Abdo,REP,720700,0,0,195,195,69
Tulsa,State House,Paul Bowman,REP,720700,0,0,64,64,69
Tulsa,State House,Chuck Strohm,REP,720700,0,0,152,152,69
Tulsa,Superintendent of Public Instruction,John Cox,DEM,720701,0,0,31,31,
Tulsa,Superintendent of Public Instruction,Jack Jr.,DEM,720701,0,0,4,4,
Tulsa,Superintendent of Public Instruction,Ivan Holmes,DEM,720701,0,0,3,3,
Tulsa,Superintendent of Public Instruction,Freda Deskin,DEM,720701,0,0,24,24,
Tulsa,U.S. Senate,Patrick Michael Hayes,DEM,720701,0,0,3,3,
Tulsa,U.S. Senate,Jim Rogers,DEM,720701,0,0,18,18,
Tulsa,U.S. Senate,Connie Johnson,DEM,720701,0,0,38,38,
Tulsa,Governor,Dax Ewbank,REP,720701,0,0,32,32,
Tulsa,Governor,Chad Moody,REP,720701,0,0,57,57,
Tulsa,Governor,Mary Fallin,REP,720701,0,0,228,228,
Tulsa,Superintendent of Public Instruction,Brian Kelly,REP,720701,0,0,24,24,
Tulsa,Superintendent of Public Instruction,Janet Costello Barresi,REP,720701,0,0,38,38,
Tulsa,Superintendent of Public Instruction,Joy Hofmeister,REP,720701,0,0,262,262,
Tulsa,Insurance Commissioner,Bill Viner,REP,720701,0,0,54,54,
Tulsa,Insurance Commissioner,John Doak,REP,720701,0,0,237,237,
Tulsa,Corporation Commissioner,Todd Hiett,REP,720701,0,0,168,168,
Tulsa,Corporation Commissioner,Cliff Branan,REP,720701,0,0,112,112,
Tulsa,U.S. Senate,Evelyn Rogers,REP,720701,0,0,16,16,
Tulsa,U.S. Senate,Rob Moye,REP,720701,0,0,4,4,
Tulsa,U.S. Senate,D. Jean Mcbride-Samuels,REP,720701,0,0,7,7,
Tulsa,U.S. Senate,Jim Inhofe,REP,720701,0,0,281,281,
Tulsa,U.S. Senate,Erick Paul Wyatt,REP,720701,0,0,11,11,
Tulsa,U.S. Senate,Andy Craig,REP,720701,0,0,1,1,
Tulsa,U.S. Senate,T. Shannon,REP,720701,0,0,144,144,
Tulsa,U.S. Senate,Randy Brogdon,REP,720701,0,0,19,19,
Tulsa,U.S. Senate,Eric Mccray,REP,720701,0,0,1,1,
Tulsa,U.S. Senate,Kevin Crow,REP,720701,0,0,2,2,
Tulsa,U.S. Senate,James Lankford,REP,720701,0,0,155,155,
Tulsa,U.S. Senate,Jason Weger,REP,720701,0,0,2,2,
Tulsa,Superintendent of Public Instruction,John Cox,DEM,720702,0,0,29,29,
Tulsa,Superintendent of Public Instruction,Jack Jr.,DEM,720702,0,0,5,5,
Tulsa,Superintendent of Public Instruction,Ivan Holmes,DEM,720702,0,0,4,4,
Tulsa,Superintendent of Public Instruction,Freda Deskin,DEM,720702,0,0,32,32,
Tulsa,U.S. Senate,Patrick Michael Hayes,DEM,720702,0,0,14,14,
Tulsa,U.S. Senate,Jim Rogers,DEM,720702,0,0,19,19,
Tulsa,U.S. Senate,Connie Johnson,DEM,720702,0,0,33,33,
Tulsa,Governor,Dax Ewbank,REP,720702,0,0,6,6,
Tulsa,Governor,Chad Moody,REP,720702,0,0,43,43,
Tulsa,Governor,Mary Fallin,REP,720702,0,0,174,174,
Tulsa,Superintendent of Public Instruction,Brian Kelly,REP,720702,0,0,37,37,
Tulsa,Superintendent of Public Instruction,Janet Costello Barresi,REP,720702,0,0,41,41,
Tulsa,Superintendent of Public Instruction,Joy Hofmeister,REP,720702,0,0,146,146,
Tulsa,Insurance Commissioner,Bill Viner,REP,720702,0,0,42,42,
Tulsa,Insurance Commissioner,John Doak,REP,720702,0,0,177,177,
Tulsa,Corporation Commissioner,Todd Hiett,REP,720702,0,0,141,141,
Tulsa,Corporation Commissioner,Cliff Branan,REP,720702,0,0,69,69,
Tulsa,U.S. Senate,Evelyn Rogers,REP,720702,0,0,11,11,
Tulsa,U.S. Senate,Rob Moye,REP,720702,0,0,4,4,
Tulsa,U.S. Senate,D. Jean Mcbride-Samuels,REP,720702,0,0,6,6,
Tulsa,U.S. Senate,Jim Inhofe,REP,720702,0,0,197,197,
Tulsa,U.S. Senate,Erick Paul Wyatt,REP,720702,0,0,8,8,
Tulsa,U.S. Senate,Andy Craig,REP,720702,0,0,1,1,
Tulsa,U.S. Senate,T. Shannon,REP,720702,0,0,90,90,
Tulsa,U.S. Senate,Randy Brogdon,REP,720702,0,0,24,24,
Tulsa,U.S. Senate,Eric Mccray,REP,720702,0,0,1,1,
Tulsa,U.S. Senate,Kevin Crow,REP,720702,0,0,4,4,
Tulsa,U.S. Senate,James Lankford,REP,720702,0,0,104,104,
Tulsa,U.S. Senate,Jason Weger,REP,720702,0,0,2,2,
Tulsa,State House,Melissa Abdo,REP,720702,0,0,111,111,69
Tulsa,State House,Paul Bowman,REP,720702,0,0,36,36,69
Tulsa,State House,Chuck Strohm,REP,720702,0,0,75,75,69
Tulsa,Superintendent of Public Instruction,John Cox,DEM,720703,0,0,27,27,
Tulsa,Superintendent of Public Instruction,Jack Jr.,DEM,720703,0,0,5,5,
Tulsa,Superintendent of Public Instruction,Ivan Holmes,DEM,720703,0,0,1,1,
Tulsa,Superintendent of Public Instruction,Freda Deskin,DEM,720703,0,0,25,25,
Tulsa,U.S. Senate,Patrick Michael Hayes,DEM,720703,0,0,7,7,
Tulsa,U.S. Senate,Jim Rogers,DEM,720703,0,0,13,13,
Tulsa,U.S. Senate,Connie Johnson,DEM,720703,0,0,36,36,
Tulsa,Governor,Dax Ewbank,REP,720703,0,0,33,33,
Tulsa,Governor,Chad Moody,REP,720703,0,0,52,52,
Tulsa,Governor,Mary Fallin,REP,720703,0,0,234,234,
Tulsa,Superintendent of Public Instruction,Brian Kelly,REP,720703,0,0,28,28,
Tulsa,Superintendent of Public Instruction,Janet Costello Barresi,REP,720703,0,0,45,45,
Tulsa,Superintendent of Public Instruction,Joy Hofmeister,REP,720703,0,0,257,257,
Tulsa,Insurance Commissioner,Bill Viner,REP,720703,0,0,51,51,
Tulsa,Insurance Commissioner,John Doak,REP,720703,0,0,231,231,
Tulsa,Corporation Commissioner,Todd Hiett,REP,720703,0,0,177,177,
Tulsa,Corporation Commissioner,Cliff Branan,REP,720703,0,0,106,106,
Tulsa,U.S. Senate,Evelyn Rogers,REP,720703,0,0,13,13,
Tulsa,U.S. Senate,Rob Moye,REP,720703,0,0,6,6,
Tulsa,U.S. Senate,D. Jean Mcbride-Samuels,REP,720703,0,0,6,6,
Tulsa,U.S. Senate,Jim Inhofe,REP,720703,0,0,283,283,
Tulsa,U.S. Senate,Erick Paul Wyatt,REP,720703,0,0,15,15,
Tulsa,U.S. Senate,Andy Craig,REP,720703,0,0,1,1,
Tulsa,U.S. Senate,T. Shannon,REP,720703,0,0,124,124,
Tulsa,U.S. Senate,Randy Brogdon,REP,720703,0,0,21,21,
Tulsa,U.S. Senate,Eric Mccray,REP,720703,0,0,1,1,
Tulsa,U.S. Senate,Kevin Crow,REP,720703,0,0,2,2,
Tulsa,U.S. Senate,James Lankford,REP,720703,0,0,176,176,
Tulsa,U.S. Senate,Jason Weger,REP,720703,0,0,3,3,
Tulsa,Superintendent of Public Instruction,John Cox,DEM,720704,0,0,14,14,
Tulsa,Superintendent of Public Instruction,Jack Jr.,DEM,720704,0,0,1,1,
Tulsa,Superintendent of Public Instruction,Ivan Holmes,DEM,720704,0,0,0,0,
Tulsa,Superintendent of Public Instruction,Freda Deskin,DEM,720704,0,0,24,24,
Tulsa,U.S. Senate,Patrick Michael Hayes,DEM,720704,0,0,1,1,
Tulsa,U.S. Senate,Jim Rogers,DEM,720704,0,0,12,12,
Tulsa,U.S. Senate,Connie Johnson,DEM,720704,0,0,24,24,
Tulsa,Governor,Dax Ewbank,REP,720704,0,0,24,24,
Tulsa,Governor,Chad Moody,REP,720704,0,0,30,30,
Tulsa,Governor,Mary Fallin,REP,720704,0,0,256,256,
Tulsa,Superintendent of Public Instruction,Brian Kelly,REP,720704,0,0,32,32,
Tulsa,Superintendent of Public Instruction,Janet Costello Barresi,REP,720704,0,0,51,51,
Tulsa,Superintendent of Public Instruction,Joy Hofmeister,REP,720704,0,0,227,227,
Tulsa,Insurance Commissioner,Bill Viner,REP,720704,0,0,43,43,
Tulsa,Insurance Commissioner,John Doak,REP,720704,0,0,236,236,
Tulsa,Corporation Commissioner,Todd Hiett,REP,720704,0,0,162,162,
Tulsa,Corporation Commissioner,Cliff Branan,REP,720704,0,0,117,117,
Tulsa,U.S. Senate,Evelyn Rogers,REP,720704,0,0,11,11,
Tulsa,U.S. Senate,Rob Moye,REP,720704,0,0,0,0,
Tulsa,U.S. Senate,D. Jean Mcbride-Samuels,REP,720704,0,0,4,4,
Tulsa,U.S. Senate,Jim Inhofe,REP,720704,0,0,288,288,
Tulsa,U.S. Senate,Erick Paul Wyatt,REP,720704,0,0,7,7,
Tulsa,U.S. Senate,Andy Craig,REP,720704,0,0,2,2,
Tulsa,U.S. Senate,T. Shannon,REP,720704,0,0,131,131,
Tulsa,U.S. Senate,Randy Brogdon,REP,720704,0,0,17,17,
Tulsa,U.S. Senate,Eric Mccray,REP,720704,0,0,1,1,
Tulsa,U.S. Senate,Kevin Crow,REP,720704,0,0,2,2,
Tulsa,U.S. Senate,James Lankford,REP,720704,0,0,160,160,
Tulsa,U.S. Senate,Jason Weger,REP,720704,0,0,0,0,
Tulsa,State House,Melissa Abdo,REP,720704,0,0,150,150,69
Tulsa,State House,Paul Bowman,REP,720704,0,0,61,61,69
Tulsa,State House,Chuck Strohm,REP,720704,0,0,90,90,69
Tulsa,Superintendent of Public Instruction,John Cox,DEM,720705,0,0,25,25,
Tulsa,Superintendent of Public Instruction,Jack Jr.,DEM,720705,0,0,2,2,
Tulsa,Superintendent of Public Instruction,Ivan Holmes,DEM,720705,0,0,2,2,
Tulsa,Superintendent of Public Instruction,Freda Deskin,DEM,720705,0,0,16,16,
Tulsa,U.S. Senate,Patrick Michael Hayes,DEM,720705,0,0,9,9,
Tulsa,U.S. Senate,Jim Rogers,DEM,720705,0,0,15,15,
Tulsa,U.S. Senate,Connie Johnson,DEM,720705,0,0,21,21,
Tulsa,Governor,Dax Ewbank,REP,720705,0,0,16,16,
Tulsa,Governor,Chad Moody,REP,720705,0,0,28,28,
Tulsa,Governor,Mary Fallin,REP,720705,0,0,106,106,
Tulsa,Superintendent of Public Instruction,Brian Kelly,REP,720705,0,0,25,25,
Tulsa,Superintendent of Public Instruction,Janet Costello Barresi,REP,720705,0,0,17,17,
Tulsa,Superintendent of Public Instruction,Joy Hofmeister,REP,720705,0,0,106,106,
Tulsa,Insurance Commissioner,Bill Viner,REP,720705,0,0,29,29,
Tulsa,Insurance Commissioner,John Doak,REP,720705,0,0,115,115,
Tulsa,Corporation Commissioner,Todd Hiett,REP,720705,0,0,88,88,
Tulsa,Corporation Commissioner,Cliff Branan,REP,720705,0,0,51,51,
Tulsa,U.S. Senate,Evelyn Rogers,REP,720705,0,0,6,6,
Tulsa,U.S. Senate,Rob Moye,REP,720705,0,0,3,3,
Tulsa,U.S. Senate,D. Jean Mcbride-Samuels,REP,720705,0,0,4,4,
Tulsa,U.S. Senate,Jim Inhofe,REP,720705,0,0,126,126,
Tulsa,U.S. Senate,Erick Paul Wyatt,REP,720705,0,0,9,9,
Tulsa,U.S. Senate,Andy Craig,REP,720705,0,0,2,2,
Tulsa,U.S. Senate,T. Shannon,REP,720705,0,0,64,64,
Tulsa,U.S. Senate,Randy Brogdon,REP,720705,0,0,17,17,
Tulsa,U.S. Senate,Eric Mccray,REP,720705,0,0,1,1,
Tulsa,U.S. Senate,Kevin Crow,REP,720705,0,0,1,1,
Tulsa,U.S. Senate,James Lankford,REP,720705,0,0,62,62,
Tulsa,U.S. Senate,Jason Weger,REP,720705,0,0,0,0,
Tulsa,State Senate,John Knecht,REP,720705,0,0,43,43,12
Tulsa,State Senate,Brian Bingman,REP,720705,0,0,102,102,12
Tulsa,Superintendent of Public Instruction,John Cox,DEM,720706,0,0,35,35,
Tulsa,Superintendent of Public Instruction,Jack Jr.,DEM,720706,0,0,10,10,
Tulsa,Superintendent of Public Instruction,Ivan Holmes,DEM,720706,0,0,5,5,
Tulsa,Superintendent of Public Instruction,Freda Deskin,DEM,720706,0,0,38,38,
Tulsa,U.S. Senate,Patrick Michael Hayes,DEM,720706,0,0,17,17,
Tulsa,U.S. Senate,Jim Rogers,DEM,720706,0,0,21,21,
Tulsa,U.S. Senate,Connie Johnson,DEM,720706,0,0,42,42,
Tulsa,Governor,Dax Ewbank,REP,720706,0,0,27,27,
Tulsa,Governor,Chad Moody,REP,720706,0,0,48,48,
Tulsa,Governor,Mary Fallin,REP,720706,0,0,237,237,
Tulsa,Superintendent of Public Instruction,Brian Kelly,REP,720706,0,0,53,53,
Tulsa,Superintendent of Public Instruction,Janet Costello Barresi,REP,720706,0,0,51,51,
Tulsa,Superintendent of Public Instruction,Joy Hofmeister,REP,720706,0,0,210,210,
Tulsa,Insurance Commissioner,Bill Viner,REP,720706,0,0,53,53,
Tulsa,Insurance Commissioner,John Doak,REP,720706,0,0,243,243,
Tulsa,Corporation Commissioner,Todd Hiett,REP,720706,0,0,184,184,
Tulsa,Corporation Commissioner,Cliff Branan,REP,720706,0,0,110,110,
Tulsa,U.S. Senate,Evelyn Rogers,REP,720706,0,0,19,19,
Tulsa,U.S. Senate,Rob Moye,REP,720706,0,0,5,5,
Tulsa,U.S. Senate,D. Jean Mcbride-Samuels,REP,720706,0,0,3,3,
Tulsa,U.S. Senate,Jim Inhofe,REP,720706,0,0,270,270,
Tulsa,U.S. Senate,Erick Paul Wyatt,REP,720706,0,0,12,12,
Tulsa,U.S. Senate,Andy Craig,REP,720706,0,0,4,4,
Tulsa,U.S. Senate,T. Shannon,REP,720706,0,0,123,123,
Tulsa,U.S. Senate,Randy Brogdon,REP,720706,0,0,24,24,
Tulsa,U.S. Senate,Eric Mccray,REP,720706,0,0,1,1,
Tulsa,U.S. Senate,Kevin Crow,REP,720706,0,0,5,5,
Tulsa,U.S. Senate,James Lankford,REP,720706,0,0,154,154,
Tulsa,U.S. Senate,Jason Weger,REP,720706,0,0,1,1,
Tulsa,Superintendent of Public Instruction,John Cox,DEM,720707,0,0,23,23,
Tulsa,Superintendent of Public Instruction,Jack Jr.,DEM,720707,0,0,5,5,
Tulsa,Superintendent of Public Instruction,Ivan Holmes,DEM,720707,0,0,5,5,
Tulsa,Superintendent of Public Instruction,Freda Deskin,DEM,720707,0,0,12,12,
Tulsa,U.S. Senate,Patrick Michael Hayes,DEM,720707,0,0,3,3,
Tulsa,U.S. Senate,Jim Rogers,DEM,720707,0,0,10,10,
Tulsa,U.S. Senate,Connie Johnson,DEM,720707,0,0,31,31,
Tulsa,Governor,Dax Ewbank,REP,720707,0,0,8,8,
Tulsa,Governor,Chad Moody,REP,720707,0,0,18,18,
Tulsa,Governor,Mary Fallin,REP,720707,0,0,97,97,
Tulsa,Superintendent of Public Instruction,Brian Kelly,REP,720707,0,0,12,12,
Tulsa,Superintendent of Public Instruction,Janet Costello Barresi,REP,720707,0,0,14,14,
Tulsa,Superintendent of Public Instruction,Joy Hofmeister,REP,720707,0,0,99,99,
Tulsa,Insurance Commissioner,Bill Viner,REP,720707,0,0,18,18,
Tulsa,Insurance Commissioner,John Doak,REP,720707,0,0,96,96,
Tulsa,Corporation Commissioner,Todd Hiett,REP,720707,0,0,72,72,
Tulsa,Corporation Commissioner,Cliff Branan,REP,720707,0,0,40,40,
Tulsa,U.S. Senate,Evelyn Rogers,REP,720707,0,0,3,3,
Tulsa,U.S. Senate,Rob Moye,REP,720707,0,0,0,0,
Tulsa,U.S. Senate,D. Jean Mcbride-Samuels,REP,720707,0,0,1,1,
Tulsa,U.S. Senate,Jim Inhofe,REP,720707,0,0,112,112,
Tulsa,U.S. Senate,Erick Paul Wyatt,REP,720707,0,0,5,5,
Tulsa,U.S. Senate,Andy Craig,REP,720707,0,0,0,0,
Tulsa,U.S. Senate,T. Shannon,REP,720707,0,0,50,50,
Tulsa,U.S. Senate,Randy Brogdon,REP,720707,0,0,13,13,
Tulsa,U.S. Senate,Eric Mccray,REP,720707,0,0,1,1,
Tulsa,U.S. Senate,Kevin Crow,REP,720707,0,0,1,1,
Tulsa,U.S. Senate,James Lankford,REP,720707,0,0,56,56,
Tulsa,U.S. Senate,Jason Weger,REP,720707,0,0,1,1,
Tulsa,State Senate,John Knecht,REP,720707,0,0,23,23,12
Tulsa,State Senate,Brian Bingman,REP,720707,0,0,88,88,12
Tulsa,Superintendent of Public Instruction,John Cox,DEM,720708,0,0,26,26,
Tulsa,Superintendent of Public Instruction,Jack Jr.,DEM,720708,0,0,2,2,
Tulsa,Superintendent of Public Instruction,Ivan Holmes,DEM,720708,0,0,6,6,
Tulsa,Superintendent of Public Instruction,Freda Deskin,DEM,720708,0,0,5,5,
Tulsa,U.S. Senate,Patrick Michael Hayes,DEM,720708,0,0,5,5,
Tulsa,U.S. Senate,Jim Rogers,DEM,720708,0,0,16,16,
Tulsa,U.S. Senate,Connie Johnson,DEM,720708,0,0,16,16,
Tulsa,Governor,Dax Ewbank,REP,720708,0,0,23,23,
Tulsa,Governor,Chad Moody,REP,720708,0,0,29,29,
Tulsa,Governor,Mary Fallin,REP,720708,0,0,133,133,
Tulsa,Superintendent of Public Instruction,Brian Kelly,REP,720708,0,0,27,27,
Tulsa,Superintendent of Public Instruction,Janet Costello Barresi,REP,720708,0,0,26,26,
Tulsa,Superintendent of Public Instruction,Joy Hofmeister,REP,720708,0,0,131,131,
Tulsa,Insurance Commissioner,Bill Viner,REP,720708,0,0,38,38,
Tulsa,Insurance Commissioner,John Doak,REP,720708,0,0,130,130,
Tulsa,Corporation Commissioner,Todd Hiett,REP,720708,0,0,108,108,
Tulsa,Corporation Commissioner,Cliff Branan,REP,720708,0,0,64,64,
Tulsa,U.S. Senate,Evelyn Rogers,REP,720708,0,0,5,5,
Tulsa,U.S. Senate,Rob Moye,REP,720708,0,0,7,7,
Tulsa,U.S. Senate,D. Jean Mcbride-Samuels,REP,720708,0,0,8,8,
Tulsa,U.S. Senate,Jim Inhofe,REP,720708,0,0,157,157,
Tulsa,U.S. Senate,Erick Paul Wyatt,REP,720708,0,0,7,7,
Tulsa,U.S. Senate,Andy Craig,REP,720708,0,0,1,1,
Tulsa,U.S. Senate,T. Shannon,REP,720708,0,0,80,80,
Tulsa,U.S. Senate,Randy Brogdon,REP,720708,0,0,18,18,
Tulsa,U.S. Senate,Eric Mccray,REP,720708,0,0,4,4,
Tulsa,U.S. Senate,Kevin Crow,REP,720708,0,0,2,2,
Tulsa,U.S. Senate,James Lankford,REP,720708,0,0,81,81,
Tulsa,U.S. Senate,Jason Weger,REP,720708,0,0,2,2,
Tulsa,State Senate,John Knecht,REP,720708,0,0,60,60,12
Tulsa,State Senate,Brian Bingman,REP,720708,0,0,108,108,12
Tulsa,Superintendent of Public Instruction,John Cox,DEM,720709,0,0,24,24,
Tulsa,Superintendent of Public Instruction,Jack Jr.,DEM,720709,0,0,10,10,
Tulsa,Superintendent of Public Instruction,Ivan Holmes,DEM,720709,0,0,0,0,
Tulsa,Superintendent of Public Instruction,Freda Deskin,DEM,720709,0,0,30,30,
Tulsa,U.S. Senate,Patrick Michael Hayes,DEM,720709,0,0,13,13,
Tulsa,U.S. Senate,Jim Rogers,DEM,720709,0,0,22,22,
Tulsa,U.S. Senate,Connie Johnson,DEM,720709,0,0,27,27,
Tulsa,Governor,Dax Ewbank,REP,720709,0,0,15,15,
Tulsa,Governor,Chad Moody,REP,720709,0,0,34,34,
Tulsa,Governor,Mary Fallin,REP,720709,0,0,204,204,
Tulsa,Superintendent of Public Instruction,Brian Kelly,REP,720709,0,0,33,33,
Tulsa,Superintendent of Public Instruction,Janet Costello Barresi,REP,720709,0,0,36,36,
Tulsa,Superintendent of Public Instruction,Joy Hofmeister,REP,720709,0,0,182,182,
Tulsa,Insurance Commissioner,Bill Viner,REP,720709,0,0,41,41,
Tulsa,Insurance Commissioner,John Doak,REP,720709,0,0,203,203,
Tulsa,Corporation Commissioner,Todd Hiett,REP,720709,0,0,137,137,
Tulsa,Corporation Commissioner,Cliff Branan,REP,720709,0,0,106,106,
Tulsa,U.S. Senate,Evelyn Rogers,REP,720709,0,0,9,9,
Tulsa,U.S. Senate,Rob Moye,REP,720709,0,0,3,3,
Tulsa,U.S. Senate,D. Jean Mcbride-Samuels,REP,720709,0,0,4,4,
Tulsa,U.S. Senate,Jim Inhofe,REP,720709,0,0,229,229,
Tulsa,U.S. Senate,Erick Paul Wyatt,REP,720709,0,0,7,7,
Tulsa,U.S. Senate,Andy Craig,REP,720709,0,0,2,2,
Tulsa,U.S. Senate,T. Shannon,REP,720709,0,0,93,93,
Tulsa,U.S. Senate,Randy Brogdon,REP,720709,0,0,22,22,
Tulsa,U.S. Senate,Eric Mccray,REP,720709,0,0,2,2,
Tulsa,U.S. Senate,Kevin Crow,REP,720709,0,0,0,0,
Tulsa,U.S. Senate,James Lankford,REP,720709,0,0,136,136,
Tulsa,U.S. Senate,Jason Weger,REP,720709,0,0,1,1,
Tulsa,State House,Melissa Abdo,REP,720709,0,0,116,116,69
Tulsa,State House,Paul Bowman,REP,720709,0,0,51,51,69
Tulsa,State House,Chuck Strohm,REP,720709,0,0,85,85,69
Tulsa,Superintendent of Public Instruction,John Cox,DEM,720710,0,0,8,8,
Tulsa,Superintendent of Public Instruction,Jack Jr.,DEM,720710,0,0,2,2,
Tulsa,Superintendent of Public Instruction,Ivan Holmes,DEM,720710,0,0,0,0,
Tulsa,Superintendent of Public Instruction,Freda Deskin,DEM,720710,0,0,8,8,
Tulsa,U.S. Senate,Patrick Michael Hayes,DEM,720710,0,0,7,7,
Tulsa,U.S. Senate,Jim Rogers,DEM,720710,0,0,7,7,
Tulsa,U.S. Senate,Connie Johnson,DEM,720710,0,0,4,4,
Tulsa,Governor,Dax Ewbank,REP,720710,0,0,9,9,
Tulsa,Governor,Chad Moody,REP,720710,0,0,8,8,
Tulsa,Governor,Mary Fallin,REP,720710,0,0,52,52,
Tulsa,Superintendent of Public Instruction,Brian Kelly,REP,720710,0,0,9,9,
Tulsa,Superintendent of Public Instruction,Janet Costello Barresi,REP,720710,0,0,10,10,
Tulsa,Superintendent of Public Instruction,Joy Hofmeister,REP,720710,0,0,51,51,
Tulsa,Insurance Commissioner,Bill Viner,REP,720710,0,0,12,12,
Tulsa,Insurance Commissioner,John Doak,REP,720710,0,0,53,53,
Tulsa,Corporation Commissioner,Todd Hiett,REP,720710,0,0,44,44,
Tulsa,Corporation Commissioner,Cliff Branan,REP,720710,0,0,23,23,
Tulsa,U.S. Senate,Evelyn Rogers,REP,720710,0,0,3,3,
Tulsa,U.S. Senate,Rob Moye,REP,720710,0,0,2,2,
Tulsa,U.S. Senate,D. Jean Mcbride-Samuels,REP,720710,0,0,0,0,
Tulsa,U.S. Senate,Jim Inhofe,REP,720710,0,0,63,63,
Tulsa,U.S. Senate,Erick Paul Wyatt,REP,720710,0,0,2,2,
Tulsa,U.S. Senate,Andy Craig,REP,720710,0,0,0,0,
Tulsa,U.S. Senate,T. Shannon,REP,720710,0,0,30,30,
Tulsa,U.S. Senate,Randy Brogdon,REP,720710,0,0,12,12,
Tulsa,U.S. Senate,Eric Mccray,REP,720710,0,0,0,0,
Tulsa,U.S. Senate,Kevin Crow,REP,720710,0,0,1,1,
Tulsa,U.S. Senate,James Lankford,REP,720710,0,0,25,25,
Tulsa,U.S. Senate,Jason Weger,REP,720710,0,0,3,3,
Tulsa,Superintendent of Public Instruction,John Cox,DEM,720750,0,0,30,30,
Tulsa,Superintendent of Public Instruction,Jack Jr.,DEM,720750,0,0,6,6,
Tulsa,Superintendent of Public Instruction,Ivan Holmes,DEM,720750,0,0,2,2,
Tulsa,Superintendent of Public Instruction,Freda Deskin,DEM,720750,0,0,28,28,
Tulsa,U.S. Senate,Patrick Michael Hayes,DEM,720750,0,0,16,16,
Tulsa,U.S. Senate,Jim Rogers,DEM,720750,0,0,21,21,
Tulsa,U.S. Senate,Connie Johnson,DEM,720750,0,0,26,26,
Tulsa,Governor,Dax Ewbank,REP,720750,0,0,21,21,
Tulsa,Governor,Chad Moody,REP,720750,0,0,37,37,
Tulsa,Governor,Mary Fallin,REP,720750,0,0,202,202,
Tulsa,Superintendent of Public Instruction,Brian Kelly,REP,720750,0,0,42,42,
Tulsa,Superintendent of Public Instruction,Janet Costello Barresi,REP,720750,0,0,48,48,
Tulsa,Superintendent of Public Instruction,Joy Hofmeister,REP,720750,0,0,174,174,
Tulsa,Insurance Commissioner,Bill Viner,REP,720750,0,0,64,64,
Tulsa,Insurance Commissioner,John Doak,REP,720750,0,0,176,176,
Tulsa,Corporation Commissioner,Todd Hiett,REP,720750,0,0,125,125,
Tulsa,Corporation Commissioner,Cliff Branan,REP,720750,0,0,117,117,
Tulsa,U.S. Senate,Evelyn Rogers,REP,720750,0,0,12,12,
Tulsa,U.S. Senate,Rob Moye,REP,720750,0,0,8,8,
Tulsa,U.S. Senate,D. Jean Mcbride-Samuels,REP,720750,0,0,5,5,
Tulsa,U.S. Senate,Jim Inhofe,REP,720750,0,0,227,227,
Tulsa,U.S. Senate,Erick Paul Wyatt,REP,720750,0,0,11,11,
Tulsa,U.S. Senate,Andy Craig,REP,720750,0,0,4,4,
Tulsa,U.S. Senate,T. Shannon,REP,720750,0,0,84,84,
Tulsa,U.S. Senate,Randy Brogdon,REP,720750,0,0,43,43,
Tulsa,U.S. Senate,Eric Mccray,REP,720750,0,0,0,0,
Tulsa,U.S. Senate,Kevin Crow,REP,720750,0,0,3,3,
Tulsa,U.S. Senate,James Lankford,REP,720750,0,0,132,132,
Tulsa,U.S. Senate,Jason Weger,REP,720750,0,0,0,0,
Tulsa,Superintendent of Public Instruction,John Cox,DEM,720751,0,0,47,47,
Tulsa,Superintendent of Public Instruction,Jack Jr.,DEM,720751,0,0,7,7,
Tulsa,Superintendent of Public Instruction,Ivan Holmes,DEM,720751,0,0,4,4,
Tulsa,Superintendent of Public Instruction,Freda Deskin,DEM,720751,0,0,26,26,
Tulsa,U.S. Senate,Patrick Michael Hayes,DEM,720751,0,0,9,9,
Tulsa,U.S. Senate,Jim Rogers,DEM,720751,0,0,30,30,
Tulsa,U.S. Senate,Connie Johnson,DEM,720751,0,0,43,43,
Tulsa,Governor,Dax Ewbank,REP,720751,0,0,39,39,
Tulsa,Governor,Chad Moody,REP,720751,0,0,42,42,
Tulsa,Governor,Mary Fallin,REP,720751,0,0,250,250,
Tulsa,Superintendent of Public Instruction,Brian Kelly,REP,720751,0,0,60,60,
Tulsa,Superintendent of Public Instruction,Janet Costello Barresi,REP,720751,0,0,50,50,
Tulsa,Superintendent of Public Instruction,Joy Hofmeister,REP,720751,0,0,227,227,
Tulsa,Insurance Commissioner,Bill Viner,REP,720751,0,0,75,75,
Tulsa,Insurance Commissioner,John Doak,REP,720751,0,0,230,230,
Tulsa,Corporation Commissioner,Todd Hiett,REP,720751,0,0,174,174,
Tulsa,Corporation Commissioner,Cliff Branan,REP,720751,0,0,145,145,
Tulsa,U.S. Senate,Evelyn Rogers,REP,720751,0,0,15,15,
Tulsa,U.S. Senate,Rob Moye,REP,720751,0,0,11,11,
Tulsa,U.S. Senate,D. Jean Mcbride-Samuels,REP,720751,0,0,6,6,
Tulsa,U.S. Senate,Jim Inhofe,REP,720751,0,0,289,289,
Tulsa,U.S. Senate,Erick Paul Wyatt,REP,720751,0,0,11,11,
Tulsa,U.S. Senate,Andy Craig,REP,720751,0,0,3,3,
Tulsa,U.S. Senate,T. Shannon,REP,720751,0,0,109,109,
Tulsa,U.S. Senate,Randy Brogdon,REP,720751,0,0,57,57,
Tulsa,U.S. Senate,Eric Mccray,REP,720751,0,0,1,1,
Tulsa,U.S. Senate,Kevin Crow,REP,720751,0,0,1,1,
Tulsa,U.S. Senate,James Lankford,REP,720751,0,0,167,167,
Tulsa,U.S. Senate,Jason Weger,REP,720751,0,0,1,1,
Tulsa,Superintendent of Public Instruction,John Cox,DEM,720752,0,0,29,29,
Tulsa,Superintendent of Public Instruction,Jack Jr.,DEM,720752,0,0,4,4,
Tulsa,Superintendent of Public Instruction,Ivan Holmes,DEM,720752,0,0,3,3,
Tulsa,Superintendent of Public Instruction,Freda Deskin,DEM,720752,0,0,29,29,
Tulsa,U.S. Senate,Patrick Michael Hayes,DEM,720752,0,0,13,13,
Tulsa,U.S. Senate,Jim Rogers,DEM,720752,0,0,16,16,
Tulsa,U.S. Senate,Connie Johnson,DEM,720752,0,0,31,31,
Tulsa,Governor,Dax Ewbank,REP,720752,0,0,18,18,
Tulsa,Governor,Chad Moody,REP,720752,0,0,27,27,
Tulsa,Governor,Mary Fallin,REP,720752,0,0,164,164,
Tulsa,Superintendent of Public Instruction,Brian Kelly,REP,720752,0,0,25,25,
Tulsa,Superintendent of Public Instruction,Janet Costello Barresi,REP,720752,0,0,27,27,
Tulsa,Superintendent of Public Instruction,Joy Hofmeister,REP,720752,0,0,156,156,
Tulsa,Insurance Commissioner,Bill Viner,REP,720752,0,0,49,49,
Tulsa,Insurance Commissioner,John Doak,REP,720752,0,0,142,142,
Tulsa,Corporation Commissioner,Todd Hiett,REP,720752,0,0,114,114,
Tulsa,Corporation Commissioner,Cliff Branan,REP,720752,0,0,77,77,
Tulsa,U.S. Senate,Evelyn Rogers,REP,720752,0,0,6,6,
Tulsa,U.S. Senate,Rob Moye,REP,720752,0,0,3,3,
Tulsa,U.S. Senate,D. Jean Mcbride-Samuels,REP,720752,0,0,3,3,
Tulsa,U.S. Senate,Jim Inhofe,REP,720752,0,0,187,187,
Tulsa,U.S. Senate,Erick Paul Wyatt,REP,720752,0,0,10,10,
Tulsa,U.S. Senate,Andy Craig,REP,720752,0,0,1,1,
Tulsa,U.S. Senate,T. Shannon,REP,720752,0,0,77,77,
Tulsa,U.S. Senate,Randy Brogdon,REP,720752,0,0,37,37,
Tulsa,U.S. Senate,Eric Mccray,REP,720752,0,0,1,1,
Tulsa,U.S. Senate,Kevin Crow,REP,720752,0,0,1,1,
Tulsa,U.S. Senate,James Lankford,REP,720752,0,0,92,92,
Tulsa,U.S. Senate,Jason Weger,REP,720752,0,0,1,1,
Tulsa,Superintendent of Public Instruction,John Cox,DEM,720753,0,0,38,38,
Tulsa,Superintendent of Public Instruction,Jack Jr.,DEM,720753,0,0,8,8,
Tulsa,Superintendent of Public Instruction,Ivan Holmes,DEM,720753,0,0,2,2,
Tulsa,Superintendent of Public Instruction,Freda Deskin,DEM,720753,0,0,27,27,
Tulsa,U.S. Senate,Patrick Michael Hayes,DEM,720753,0,0,19,19,
Tulsa,U.S. Senate,Jim Rogers,DEM,720753,0,0,24,24,
Tulsa,U.S. Senate,Connie Johnson,DEM,720753,0,0,28,28,
Tulsa,Governor,Dax Ewbank,REP,720753,0,0,11,11,
Tulsa,Governor,Chad Moody,REP,720753,0,0,35,35,
Tulsa,Governor,Mary Fallin,REP,720753,0,0,97,97,
Tulsa,Superintendent of Public Instruction,Brian Kelly,REP,720753,0,0,32,32,
Tulsa,Superintendent of Public Instruction,Janet Costello Barresi,REP,720753,0,0,15,15,
Tulsa,Superintendent of Public Instruction,Joy Hofmeister,REP,720753,0,0,100,100,
Tulsa,Insurance Commissioner,Bill Viner,REP,720753,0,0,38,38,
Tulsa,Insurance Commissioner,John Doak,REP,720753,0,0,97,97,
Tulsa,Corporation Commissioner,Todd Hiett,REP,720753,0,0,80,80,
Tulsa,Corporation Commissioner,Cliff Branan,REP,720753,0,0,53,53,
Tulsa,U.S. Senate,Evelyn Rogers,REP,720753,0,0,5,5,
Tulsa,U.S. Senate,Rob Moye,REP,720753,0,0,8,8,
Tulsa,U.S. Senate,D. Jean Mcbride-Samuels,REP,720753,0,0,1,1,
Tulsa,U.S. Senate,Jim Inhofe,REP,720753,0,0,130,130,
Tulsa,U.S. Senate,Erick Paul Wyatt,REP,720753,0,0,4,4,
Tulsa,U.S. Senate,Andy Craig,REP,720753,0,0,1,1,
Tulsa,U.S. Senate,T. Shannon,REP,720753,0,0,56,56,
Tulsa,U.S. Senate,Randy Brogdon,REP,720753,0,0,26,26,
Tulsa,U.S. Senate,Eric Mccray,REP,720753,0,0,1,1,
Tulsa,U.S. Senate,Kevin Crow,REP,720753,0,0,2,2,
Tulsa,U.S. Senate,James Lankford,REP,720753,0,0,62,62,
Tulsa,U.S. Senate,Jason Weger,REP,720753,0,0,1,1,
Tulsa,Superintendent of Public Instruction,John Cox,DEM,720754,0,0,34,34,
Tulsa,Superintendent of Public Instruction,Jack Jr.,DEM,720754,0,0,10,10,
Tulsa,Superintendent of Public Instruction,Ivan Holmes,DEM,720754,0,0,5,5,
Tulsa,Superintendent of Public Instruction,Freda Deskin,DEM,720754,0,0,42,42,
Tulsa,U.S. Senate,Patrick Michael Hayes,DEM,720754,0,0,17,17,
Tulsa,U.S. Senate,Jim Rogers,DEM,720754,0,0,27,27,
Tulsa,U.S. Senate,Connie Johnson,DEM,720754,0,0,46,46,
Tulsa,Governor,Dax Ewbank,REP,720754,0,0,35,35,
Tulsa,Governor,Chad Moody,REP,720754,0,0,51,51,
Tulsa,Governor,Mary Fallin,REP,720754,0,0,249,249,
Tulsa,Superintendent of Public Instruction,Brian Kelly,REP,720754,0,0,59,59,
Tulsa,Superintendent of Public Instruction,Janet Costello Barresi,REP,720754,0,0,39,39,
Tulsa,Superintendent of Public Instruction,Joy Hofmeister,REP,720754,0,0,238,238,
Tulsa,Insurance Commissioner,Bill Viner,REP,720754,0,0,84,84,
Tulsa,Insurance Commissioner,John Doak,REP,720754,0,0,231,231,
Tulsa,Corporation Commissioner,Todd Hiett,REP,720754,0,0,152,152,
Tulsa,Corporation Commissioner,Cliff Branan,REP,720754,0,0,159,159,
Tulsa,U.S. Senate,Evelyn Rogers,REP,720754,0,0,8,8,
Tulsa,U.S. Senate,Rob Moye,REP,720754,0,0,13,13,
Tulsa,U.S. Senate,D. Jean Mcbride-Samuels,REP,720754,0,0,8,8,
Tulsa,U.S. Senate,Jim Inhofe,REP,720754,0,0,291,291,
Tulsa,U.S. Senate,Erick Paul Wyatt,REP,720754,0,0,17,17,
Tulsa,U.S. Senate,Andy Craig,REP,720754,0,0,2,2,
Tulsa,U.S. Senate,T. Shannon,REP,720754,0,0,134,134,
Tulsa,U.S. Senate,Randy Brogdon,REP,720754,0,0,59,59,
Tulsa,U.S. Senate,Eric Mccray,REP,720754,0,0,0,0,
Tulsa,U.S. Senate,Kevin Crow,REP,720754,0,0,2,2,
Tulsa,U.S. Senate,James Lankford,REP,720754,0,0,143,143,
Tulsa,U.S. Senate,Jason Weger,REP,720754,0,0,0,0,
Tulsa,Superintendent of Public Instruction,John Cox,DEM,720755,0,0,43,43,
Tulsa,Superintendent of Public Instruction,Jack Jr.,DEM,720755,0,0,16,16,
Tulsa,Superintendent of Public Instruction,Ivan Holmes,DEM,720755,0,0,11,11,
Tulsa,Superintendent of Public Instruction,Freda Deskin,DEM,720755,0,0,50,50,
Tulsa,U.S. Senate,Patrick Michael Hayes,DEM,720755,0,0,19,19,
Tulsa,U.S. Senate,Jim Rogers,DEM,720755,0,0,38,38,
Tulsa,U.S. Senate,Connie Johnson,DEM,720755,0,0,58,58,
Tulsa,Governor,Dax Ewbank,REP,720755,0,0,39,39,
Tulsa,Governor,Chad Moody,REP,720755,0,0,66,66,
Tulsa,Governor,Mary Fallin,REP,720755,0,0,300,300,
Tulsa,Superintendent of Public Instruction,Brian Kelly,REP,720755,0,0,62,62,
Tulsa,Superintendent of Public Instruction,Janet Costello Barresi,REP,720755,0,0,49,49,
Tulsa,Superintendent of Public Instruction,Joy Hofmeister,REP,720755,0,0,294,294,
Tulsa,Insurance Commissioner,Bill Viner,REP,720755,0,0,91,91,
Tulsa,Insurance Commissioner,John Doak,REP,720755,0,0,271,271,
Tulsa,Corporation Commissioner,Todd Hiett,REP,720755,0,0,210,210,
Tulsa,Corporation Commissioner,Cliff Branan,REP,720755,0,0,157,157,
Tulsa,U.S. Senate,Evelyn Rogers,REP,720755,0,0,23,23,
Tulsa,U.S. Senate,Rob Moye,REP,720755,0,0,7,7,
Tulsa,U.S. Senate,D. Jean Mcbride-Samuels,REP,720755,0,0,7,7,
Tulsa,U.S. Senate,Jim Inhofe,REP,720755,0,0,345,345,
Tulsa,U.S. Senate,Erick Paul Wyatt,REP,720755,0,0,13,13,
Tulsa,U.S. Senate,Andy Craig,REP,720755,0,0,4,4,
Tulsa,U.S. Senate,T. Shannon,REP,720755,0,0,178,178,
Tulsa,U.S. Senate,Randy Brogdon,REP,720755,0,0,50,50,
Tulsa,U.S. Senate,Eric Mccray,REP,720755,0,0,1,1,
Tulsa,U.S. Senate,Kevin Crow,REP,720755,0,0,4,4,
Tulsa,U.S. Senate,James Lankford,REP,720755,0,0,169,169,
Tulsa,U.S. Senate,Jason Weger,REP,720755,0,0,2,2,
Tulsa,Superintendent of Public Instruction,John Cox,DEM,720756,0,0,2,2,
Tulsa,Superintendent of Public Instruction,Jack Jr.,DEM,720756,0,0,0,0,
Tulsa,Superintendent of Public Instruction,Ivan Holmes,DEM,720756,0,0,0,0,
Tulsa,Superintendent of Public Instruction,Freda Deskin,DEM,720756,0,0,3,3,
Tulsa,U.S. Senate,Patrick Michael Hayes,DEM,720756,0,0,3,3,
Tulsa,U.S. Senate,Jim Rogers,DEM,720756,0,0,2,2,
Tulsa,U.S. Senate,Connie Johnson,DEM,720756,0,0,0,0,
Tulsa,Governor,Dax Ewbank,REP,720756,0,0,1,1,
Tulsa,Governor,Chad Moody,REP,720756,0,0,2,2,
Tulsa,Governor,Mary Fallin,REP,720756,0,0,18,18,
Tulsa,Superintendent of Public Instruction,Brian Kelly,REP,720756,0,0,4,4,
Tulsa,Superintendent of Public Instruction,Janet Costello Barresi,REP,720756,0,0,2,2,
Tulsa,Superintendent of Public Instruction,Joy Hofmeister,REP,720756,0,0,16,16,
Tulsa,Insurance Commissioner,Bill Viner,REP,720756,0,0,5,5,
Tulsa,Insurance Commissioner,John Doak,REP,720756,0,0,16,16,
Tulsa,Corporation Commissioner,Todd Hiett,REP,720756,0,0,14,14,
Tulsa,Corporation Commissioner,Cliff Branan,REP,720756,0,0,6,6,
Tulsa,U.S. Senate,Evelyn Rogers,REP,720756,0,0,0,0,
Tulsa,U.S. Senate,Rob Moye,REP,720756,0,0,0,0,
Tulsa,U.S. Senate,D. Jean Mcbride-Samuels,REP,720756,0,0,1,1,
Tulsa,U.S. Senate,Jim Inhofe,REP,720756,0,0,19,19,
Tulsa,U.S. Senate,Erick Paul Wyatt,REP,720756,0,0,0,0,
Tulsa,U.S. Senate,Andy Craig,REP,720756,0,0,0,0,
Tulsa,U.S. Senate,T. Shannon,REP,720756,0,0,6,6,
Tulsa,U.S. Senate,Randy Brogdon,REP,720756,0,0,7,7,
Tulsa,U.S. Senate,Eric Mccray,REP,720756,0,0,0,0,
Tulsa,U.S. Senate,Kevin Crow,REP,720756,0,0,0,0,
Tulsa,U.S. Senate,James Lankford,REP,720756,0,0,8,8,
Tulsa,U.S. Senate,Jason Weger,REP,720756,0,0,0,0,
Tulsa,Superintendent of Public Instruction,John Cox,DEM,720757,0,0,38,38,
Tulsa,Superintendent of Public Instruction,Jack Jr.,DEM,720757,0,0,12,12,
Tulsa,Superintendent of Public Instruction,Ivan Holmes,DEM,720757,0,0,3,3,
Tulsa,Superintendent of Public Instruction,Freda Deskin,DEM,720757,0,0,22,22,
Tulsa,U.S. Senate,Patrick Michael Hayes,DEM,720757,0,0,9,9,
Tulsa,U.S. Senate,Jim Rogers,DEM,720757,0,0,22,22,
Tulsa,U.S. Senate,Connie Johnson,DEM,720757,0,0,38,38,
Tulsa,Governor,Dax Ewbank,REP,720757,0,0,33,33,
Tulsa,Governor,Chad Moody,REP,720757,0,0,79,79,
Tulsa,Governor,Mary Fallin,REP,720757,0,0,379,379,
Tulsa,Superintendent of Public Instruction,Brian Kelly,REP,720757,0,0,59,59,
Tulsa,Superintendent of Public Instruction,Janet Costello Barresi,REP,720757,0,0,74,74,
Tulsa,Superintendent of Public Instruction,Joy Hofmeister,REP,720757,0,0,361,361,
Tulsa,Insurance Commissioner,Bill Viner,REP,720757,0,0,116,116,
Tulsa,Insurance Commissioner,John Doak,REP,720757,0,0,328,328,
Tulsa,Corporation Commissioner,Todd Hiett,REP,720757,0,0,275,275,
Tulsa,Corporation Commissioner,Cliff Branan,REP,720757,0,0,181,181,
Tulsa,U.S. Senate,Evelyn Rogers,REP,720757,0,0,29,29,
Tulsa,U.S. Senate,Rob Moye,REP,720757,0,0,5,5,
Tulsa,U.S. Senate,D. Jean Mcbride-Samuels,REP,720757,0,0,6,6,
Tulsa,U.S. Senate,Jim Inhofe,REP,720757,0,0,441,441,
Tulsa,U.S. Senate,Erick Paul Wyatt,REP,720757,0,0,17,17,
Tulsa,U.S. Senate,Andy Craig,REP,720757,0,0,3,3,
Tulsa,U.S. Senate,T. Shannon,REP,720757,0,0,203,203,
Tulsa,U.S. Senate,Randy Brogdon,REP,720757,0,0,78,78,
Tulsa,U.S. Senate,Eric Mccray,REP,720757,0,0,1,1,
Tulsa,U.S. Senate,Kevin Crow,REP,720757,0,0,1,1,
Tulsa,U.S. Senate,James Lankford,REP,720757,0,0,216,216,
Tulsa,U.S. Senate,Jason Weger,REP,720757,0,0,2,2,
Tulsa,Superintendent of Public Instruction,John Cox,DEM,720758,0,0,6,6,
Tulsa,Superintendent of Public Instruction,Jack Jr.,DEM,720758,0,0,1,1,
Tulsa,Superintendent of Public Instruction,Ivan Holmes,DEM,720758,0,0,0,0,
Tulsa,Superintendent of Public Instruction,Freda Deskin,DEM,720758,0,0,5,5,
Tulsa,U.S. Senate,Patrick Michael Hayes,DEM,720758,0,0,3,3,
Tulsa,U.S. Senate,Jim Rogers,DEM,720758,0,0,2,2,
Tulsa,U.S. Senate,Connie Johnson,DEM,720758,0,0,6,6,
Tulsa,Governor,Dax Ewbank,REP,720758,0,0,6,6,
Tulsa,Governor,Chad Moody,REP,720758,0,0,11,11,
Tulsa,Governor,Mary Fallin,REP,720758,0,0,67,67,
Tulsa,Superintendent of Public Instruction,Brian Kelly,REP,720758,0,0,11,11,
Tulsa,Superintendent of Public Instruction,Janet Costello Barresi,REP,720758,0,0,11,11,
Tulsa,Superintendent of Public Instruction,Joy Hofmeister,REP,720758,0,0,63,63,
Tulsa,Insurance Commissioner,Bill Viner,REP,720758,0,0,11,11,
Tulsa,Insurance Commissioner,John Doak,REP,720758,0,0,68,68,
Tulsa,Corporation Commissioner,Todd Hiett,REP,720758,0,0,38,38,
Tulsa,Corporation Commissioner,Cliff Branan,REP,720758,0,0,41,41,
Tulsa,U.S. Senate,Evelyn Rogers,REP,720758,0,0,0,0,
Tulsa,U.S. Senate,Rob Moye,REP,720758,0,0,1,1,
Tulsa,U.S. Senate,D. Jean Mcbride-Samuels,REP,720758,0,0,0,0,
Tulsa,U.S. Senate,Jim Inhofe,REP,720758,0,0,78,78,
Tulsa,U.S. Senate,Erick Paul Wyatt,REP,720758,0,0,5,5,
Tulsa,U.S. Senate,Andy Craig,REP,720758,0,0,0,0,
Tulsa,U.S. Senate,T. Shannon,REP,720758,0,0,26,26,
Tulsa,U.S. Senate,Randy Brogdon,REP,720758,0,0,15,15,
Tulsa,U.S. Senate,Eric Mccray,REP,720758,0,0,0,0,
Tulsa,U.S. Senate,Kevin Crow,REP,720758,0,0,0,0,
Tulsa,U.S. Senate,James Lankford,REP,720758,0,0,43,43,
Tulsa,U.S. Senate,Jason Weger,REP,720758,0,0,1,1,
Tulsa,Superintendent of Public Instruction,John Cox,DEM,720759,0,0,38,38,
Tulsa,Superintendent of Public Instruction,Jack Jr.,DEM,720759,0,0,10,10,
Tulsa,Superintendent of Public Instruction,Ivan Holmes,DEM,720759,0,0,3,3,
Tulsa,Superintendent of Public Instruction,Freda Deskin,DEM,720759,0,0,25,25,
Tulsa,U.S. Senate,Patrick Michael Hayes,DEM,720759,0,0,28,28,
Tulsa,U.S. Senate,Jim Rogers,DEM,720759,0,0,27,27,
Tulsa,U.S. Senate,Connie Johnson,DEM,720759,0,0,18,18,
Tulsa,Governor,Dax Ewbank,REP,720759,0,0,22,22,
Tulsa,Governor,Chad Moody,REP,720759,0,0,47,47,
Tulsa,Governor,Mary Fallin,REP,720759,0,0,159,159,
Tulsa,Superintendent of Public Instruction,Brian Kelly,REP,720759,0,0,36,36,
Tulsa,Superintendent of Public Instruction,Janet Costello Barresi,REP,720759,0,0,21,21,
Tulsa,Superintendent of Public Instruction,Joy Hofmeister,REP,720759,0,0,169,169,
Tulsa,Insurance Commissioner,Bill Viner,REP,720759,0,0,53,53,
Tulsa,Insurance Commissioner,John Doak,REP,720759,0,0,149,149,
Tulsa,Corporation Commissioner,Todd Hiett,REP,720759,0,0,104,104,
Tulsa,Corporation Commissioner,Cliff Branan,REP,720759,0,0,94,94,
Tulsa,U.S. Senate,Evelyn Rogers,REP,720759,0,0,7,7,
Tulsa,U.S. Senate,Rob Moye,REP,720759,0,0,4,4,
Tulsa,U.S. Senate,D. Jean Mcbride-Samuels,REP,720759,0,0,7,7,
Tulsa,U.S. Senate,Jim Inhofe,REP,720759,0,0,198,198,
Tulsa,U.S. Senate,Erick Paul Wyatt,REP,720759,0,0,7,7,
Tulsa,U.S. Senate,Andy Craig,REP,720759,0,0,1,1,
Tulsa,U.S. Senate,T. Shannon,REP,720759,0,0,84,84,
Tulsa,U.S. Senate,Randy Brogdon,REP,720759,0,0,38,38,
Tulsa,U.S. Senate,Eric Mccray,REP,720759,0,0,0,0,
Tulsa,U.S. Senate,Kevin Crow,REP,720759,0,0,4,4,
Tulsa,U.S. Senate,James Lankford,REP,720759,0,0,101,101,
Tulsa,U.S. Senate,Jason Weger,REP,720759,0,0,0,0,
Tulsa,Superintendent of Public Instruction,John Cox,DEM,720760,0,0,19,19,
Tulsa,Superintendent of Public Instruction,Jack Jr.,DEM,720760,0,0,6,6,
Tulsa,Superintendent of Public Instruction,Ivan Holmes,DEM,720760,0,0,2,2,
Tulsa,Superintendent of Public Instruction,Freda Deskin,DEM,720760,0,0,23,23,
Tulsa,U.S. Senate,Patrick Michael Hayes,DEM,720760,0,0,11,11,
Tulsa,U.S. Senate,Jim Rogers,DEM,720760,0,0,13,13,
Tulsa,U.S. Senate,Connie Johnson,DEM,720760,0,0,24,24,
Tulsa,Governor,Dax Ewbank,REP,720760,0,0,25,25,
Tulsa,Governor,Chad Moody,REP,720760,0,0,36,36,
Tulsa,Governor,Mary Fallin,REP,720760,0,0,148,148,
Tulsa,Superintendent of Public Instruction,Brian Kelly,REP,720760,0,0,41,41,
Tulsa,Superintendent of Public Instruction,Janet Costello Barresi,REP,720760,0,0,22,22,
Tulsa,Superintendent of Public Instruction,Joy Hofmeister,REP,720760,0,0,148,148,
Tulsa,Insurance Commissioner,Bill Viner,REP,720760,0,0,55,55,
Tulsa,Insurance Commissioner,John Doak,REP,720760,0,0,136,136,
Tulsa,Corporation Commissioner,Todd Hiett,REP,720760,0,0,101,101,
Tulsa,Corporation Commissioner,Cliff Branan,REP,720760,0,0,96,96,
Tulsa,U.S. Senate,Evelyn Rogers,REP,720760,0,0,14,14,
Tulsa,U.S. Senate,Rob Moye,REP,720760,0,0,5,5,
Tulsa,U.S. Senate,D. Jean Mcbride-Samuels,REP,720760,0,0,2,2,
Tulsa,U.S. Senate,Jim Inhofe,REP,720760,0,0,177,177,
Tulsa,U.S. Senate,Erick Paul Wyatt,REP,720760,0,0,11,11,
Tulsa,U.S. Senate,Andy Craig,REP,720760,0,0,0,0,
Tulsa,U.S. Senate,T. Shannon,REP,720760,0,0,84,84,
Tulsa,U.S. Senate,Randy Brogdon,REP,720760,0,0,35,35,
Tulsa,U.S. Senate,Eric Mccray,REP,720760,0,0,1,1,
Tulsa,U.S. Senate,Kevin Crow,REP,720760,0,0,3,3,
Tulsa,U.S. Senate,James Lankford,REP,720760,0,0,87,87,
Tulsa,U.S. Senate,Jason Weger,REP,720760,0,0,1,1,
Tulsa,Superintendent of Public Instruction,John Cox,DEM,720801,0,0,15,15,
Tulsa,Superintendent of Public Instruction,Jack Jr.,DEM,720801,0,0,4,4,
Tulsa,Superintendent of Public Instruction,Ivan Holmes,DEM,720801,0,0,1,1,
Tulsa,Superintendent of Public Instruction,Freda Deskin,DEM,720801,0,0,20,20,
Tulsa,U.S. Senate,Patrick Michael Hayes,DEM,720801,0,0,7,7,
Tulsa,U.S. Senate,Jim Rogers,DEM,720801,0,0,14,14,
Tulsa,U.S. Senate,Connie Johnson,DEM,720801,0,0,18,18,
Tulsa,Governor,Dax Ewbank,REP,720801,0,0,23,23,
Tulsa,Governor,Chad Moody,REP,720801,0,0,53,53,
Tulsa,Governor,Mary Fallin,REP,720801,0,0,142,142,
Tulsa,Superintendent of Public Instruction,Brian Kelly,REP,720801,0,0,15,15,
Tulsa,Superintendent of Public Instruction,Janet Costello Barresi,REP,720801,0,0,16,16,
Tulsa,Superintendent of Public Instruction,Joy Hofmeister,REP,720801,0,0,192,192,
Tulsa,Insurance Commissioner,Bill Viner,REP,720801,0,0,26,26,
Tulsa,Insurance Commissioner,John Doak,REP,720801,0,0,171,171,
Tulsa,Corporation Commissioner,Todd Hiett,REP,720801,0,0,122,122,
Tulsa,Corporation Commissioner,Cliff Branan,REP,720801,0,0,65,65,
Tulsa,U.S. Senate,Evelyn Rogers,REP,720801,0,0,20,20,
Tulsa,U.S. Senate,Rob Moye,REP,720801,0,0,4,4,
Tulsa,U.S. Senate,D. Jean Mcbride-Samuels,REP,720801,0,0,3,3,
Tulsa,U.S. Senate,Jim Inhofe,REP,720801,0,0,175,175,
Tulsa,U.S. Senate,Erick Paul Wyatt,REP,720801,0,0,13,13,
Tulsa,U.S. Senate,Andy Craig,REP,720801,0,0,1,1,
Tulsa,U.S. Senate,T. Shannon,REP,720801,0,0,81,81,
Tulsa,U.S. Senate,Randy Brogdon,REP,720801,0,0,10,10,
Tulsa,U.S. Senate,Eric Mccray,REP,720801,0,0,0,0,
Tulsa,U.S. Senate,Kevin Crow,REP,720801,0,0,1,1,
Tulsa,U.S. Senate,James Lankford,REP,720801,0,0,129,129,
Tulsa,U.S. Senate,Jason Weger,REP,720801,0,0,0,0,
Tulsa,Superintendent of Public Instruction,John Cox,DEM,720802,0,0,9,9,
Tulsa,Superintendent of Public Instruction,Jack Jr.,DEM,720802,0,0,0,0,
Tulsa,Superintendent of Public Instruction,Ivan Holmes,DEM,720802,0,0,1,1,
Tulsa,Superintendent of Public Instruction,Freda Deskin,DEM,720802,0,0,9,9,
Tulsa,U.S. Senate,Patrick Michael Hayes,DEM,720802,0,0,4,4,
Tulsa,U.S. Senate,Jim Rogers,DEM,720802,0,0,7,7,
Tulsa,U.S. Senate,Connie Johnson,DEM,720802,0,0,8,8,
Tulsa,Governor,Dax Ewbank,REP,720802,0,0,13,13,
Tulsa,Governor,Chad Moody,REP,720802,0,0,9,9,
Tulsa,Governor,Mary Fallin,REP,720802,0,0,56,56,
Tulsa,Superintendent of Public Instruction,Brian Kelly,REP,720802,0,0,17,17,
Tulsa,Superintendent of Public Instruction,Janet Costello Barresi,REP,720802,0,0,10,10,
Tulsa,Superintendent of Public Instruction,Joy Hofmeister,REP,720802,0,0,52,52,
Tulsa,Insurance Commissioner,Bill Viner,REP,720802,0,0,12,12,
Tulsa,Insurance Commissioner,John Doak,REP,720802,0,0,59,59,
Tulsa,Corporation Commissioner,Todd Hiett,REP,720802,0,0,38,38,
Tulsa,Corporation Commissioner,Cliff Branan,REP,720802,0,0,33,33,
Tulsa,U.S. Senate,Evelyn Rogers,REP,720802,0,0,1,1,
Tulsa,U.S. Senate,Rob Moye,REP,720802,0,0,1,1,
Tulsa,U.S. Senate,D. Jean Mcbride-Samuels,REP,720802,0,0,2,2,
Tulsa,U.S. Senate,Jim Inhofe,REP,720802,0,0,69,69,
Tulsa,U.S. Senate,Erick Paul Wyatt,REP,720802,0,0,4,4,
Tulsa,U.S. Senate,Andy Craig,REP,720802,0,0,1,1,
Tulsa,U.S. Senate,T. Shannon,REP,720802,0,0,30,30,
Tulsa,U.S. Senate,Randy Brogdon,REP,720802,0,0,4,4,
Tulsa,U.S. Senate,Eric Mccray,REP,720802,0,0,1,1,
Tulsa,U.S. Senate,Kevin Crow,REP,720802,0,0,0,0,
Tulsa,U.S. Senate,James Lankford,REP,720802,0,0,39,39,
Tulsa,U.S. Senate,Jason Weger,REP,720802,0,0,0,0,
Tulsa,Superintendent of Public Instruction,John Cox,DEM,720851,0,0,31,31,
Tulsa,Superintendent of Public Instruction,Jack Jr.,DEM,720851,0,0,7,7,
Tulsa,Superintendent of Public Instruction,Ivan Holmes,DEM,720851,0,0,2,2,
Tulsa,Superintendent of Public Instruction,Freda Deskin,DEM,720851,0,0,36,36,
Tulsa,U.S. Senate,Patrick Michael Hayes,DEM,720851,0,0,16,16,
Tulsa,U.S. Senate,Jim Rogers,DEM,720851,0,0,18,18,
Tulsa,U.S. Senate,Connie Johnson,DEM,720851,0,0,35,35,
Tulsa,Governor,Dax Ewbank,REP,720851,0,0,8,8,
Tulsa,Governor,Chad Moody,REP,720851,0,0,47,47,
Tulsa,Governor,Mary Fallin,REP,720851,0,0,148,148,
Tulsa,Superintendent of Public Instruction,Brian Kelly,REP,720851,0,0,16,16,
Tulsa,Superintendent of Public Instruction,Janet Costello Barresi,REP,720851,0,0,35,35,
Tulsa,Superintendent of Public Instruction,Joy Hofmeister,REP,720851,0,0,159,159,
Tulsa,Insurance Commissioner,Bill Viner,REP,720851,0,0,40,40,
Tulsa,Insurance Commissioner,John Doak,REP,720851,0,0,147,147,
Tulsa,Corporation Commissioner,Todd Hiett,REP,720851,0,0,107,107,
Tulsa,Corporation Commissioner,Cliff Branan,REP,720851,0,0,81,81,
Tulsa,U.S. Senate,Evelyn Rogers,REP,720851,0,0,9,9,
Tulsa,U.S. Senate,Rob Moye,REP,720851,0,0,2,2,
Tulsa,U.S. Senate,D. Jean Mcbride-Samuels,REP,720851,0,0,2,2,
Tulsa,U.S. Senate,Jim Inhofe,REP,720851,0,0,186,186,
Tulsa,U.S. Senate,Erick Paul Wyatt,REP,720851,0,0,7,7,
Tulsa,U.S. Senate,Andy Craig,REP,720851,0,0,0,0,
Tulsa,U.S. Senate,T. Shannon,REP,720851,0,0,74,74,
Tulsa,U.S. Senate,Randy Brogdon,REP,720851,0,0,10,10,
Tulsa,U.S. Senate,Eric Mccray,REP,720851,0,0,1,1,
Tulsa,U.S. Senate,Kevin Crow,REP,720851,0,0,3,3,
Tulsa,U.S. Senate,James Lankford,REP,720851,0,0,123,123,
Tulsa,U.S. Senate,Jason Weger,REP,720851,0,0,0,0,
Tulsa,Superintendent of Public Instruction,John Cox,DEM,720852,0,0,19,19,
Tulsa,Superintendent of Public Instruction,Jack Jr.,DEM,720852,0,0,7,7,
Tulsa,Superintendent of Public Instruction,Ivan Holmes,DEM,720852,0,0,3,3,
Tulsa,Superintendent of Public Instruction,Freda Deskin,DEM,720852,0,0,25,25,
Tulsa,U.S. Senate,Patrick Michael Hayes,DEM,720852,0,0,12,12,
Tulsa,U.S. Senate,Jim Rogers,DEM,720852,0,0,14,14,
Tulsa,U.S. Senate,Connie Johnson,DEM,720852,0,0,28,28,
Tulsa,Governor,Dax Ewbank,REP,720852,0,0,14,14,
Tulsa,Governor,Chad Moody,REP,720852,0,0,22,22,
Tulsa,Governor,Mary Fallin,REP,720852,0,0,65,65,
Tulsa,Superintendent of Public Instruction,Brian Kelly,REP,720852,0,0,15,15,
Tulsa,Superintendent of Public Instruction,Janet Costello Barresi,REP,720852,0,0,19,19,
Tulsa,Superintendent of Public Instruction,Joy Hofmeister,REP,720852,0,0,68,68,
Tulsa,Insurance Commissioner,Bill Viner,REP,720852,0,0,24,24,
Tulsa,Insurance Commissioner,John Doak,REP,720852,0,0,68,68,
Tulsa,Corporation Commissioner,Todd Hiett,REP,720852,0,0,48,48,
Tulsa,Corporation Commissioner,Cliff Branan,REP,720852,0,0,45,45,
Tulsa,U.S. Senate,Evelyn Rogers,REP,720852,0,0,5,5,
Tulsa,U.S. Senate,Rob Moye,REP,720852,0,0,4,4,
Tulsa,U.S. Senate,D. Jean Mcbride-Samuels,REP,720852,0,0,2,2,
Tulsa,U.S. Senate,Jim Inhofe,REP,720852,0,0,78,78,
Tulsa,U.S. Senate,Erick Paul Wyatt,REP,720852,0,0,10,10,
Tulsa,U.S. Senate,Andy Craig,REP,720852,0,0,3,3,
Tulsa,U.S. Senate,T. Shannon,REP,720852,0,0,40,40,
Tulsa,U.S. Senate,Randy Brogdon,REP,720852,0,0,8,8,
Tulsa,U.S. Senate,Eric Mccray,REP,720852,0,0,2,2,
Tulsa,U.S. Senate,Kevin Crow,REP,720852,0,0,2,2,
Tulsa,U.S. Senate,James Lankford,REP,720852,0,0,44,44,
Tulsa,U.S. Senate,Jason Weger,REP,720852,0,0,2,2,
Tulsa,Superintendent of Public Instruction,John Cox,DEM,720853,0,0,20,20,
Tulsa,Superintendent of Public Instruction,Jack Jr.,DEM,720853,0,0,10,10,
Tulsa,Superintendent of Public Instruction,Ivan Holmes,DEM,720853,0,0,3,3,
Tulsa,Superintendent of Public Instruction,Freda Deskin,DEM,720853,0,0,26,26,
Tulsa,U.S. Senate,Patrick Michael Hayes,DEM,720853,0,0,13,13,
Tulsa,U.S. Senate,Jim Rogers,DEM,720853,0,0,19,19,
Tulsa,U.S. Senate,Connie Johnson,DEM,720853,0,0,25,25,
Tulsa,Governor,Dax Ewbank,REP,720853,0,0,12,12,
Tulsa,Governor,Chad Moody,REP,720853,0,0,29,29,
Tulsa,Governor,Mary Fallin,REP,720853,0,0,87,87,
Tulsa,Superintendent of Public Instruction,Brian Kelly,REP,720853,0,0,18,18,
Tulsa,Superintendent of Public Instruction,Janet Costello Barresi,REP,720853,0,0,16,16,
Tulsa,Superintendent of Public Instruction,Joy Hofmeister,REP,720853,0,0,100,100,
Tulsa,Insurance Commissioner,Bill Viner,REP,720853,0,0,28,28,
Tulsa,Insurance Commissioner,John Doak,REP,720853,0,0,101,101,
Tulsa,Corporation Commissioner,Todd Hiett,REP,720853,0,0,78,78,
Tulsa,Corporation Commissioner,Cliff Branan,REP,720853,0,0,50,50,
Tulsa,U.S. Senate,Evelyn Rogers,REP,720853,0,0,5,5,
Tulsa,U.S. Senate,Rob Moye,REP,720853,0,0,1,1,
Tulsa,U.S. Senate,D. Jean Mcbride-Samuels,REP,720853,0,0,4,4,
Tulsa,U.S. Senate,Jim Inhofe,REP,720853,0,0,113,113,
Tulsa,U.S. Senate,Erick Paul Wyatt,REP,720853,0,0,7,7,
Tulsa,U.S. Senate,Andy Craig,REP,720853,0,0,0,0,
Tulsa,U.S. Senate,T. Shannon,REP,720853,0,0,47,47,
Tulsa,U.S. Senate,Randy Brogdon,REP,720853,0,0,10,10,
Tulsa,U.S. Senate,Eric Mccray,REP,720853,0,0,1,1,
Tulsa,U.S. Senate,Kevin Crow,REP,720853,0,0,1,1,
Tulsa,U.S. Senate,James Lankford,REP,720853,0,0,77,77,
Tulsa,U.S. Senate,Jason Weger,REP,720853,0,0,0,0,
Tulsa,Superintendent of Public Instruction,John Cox,DEM,720854,0,0,46,46,
Tulsa,Superintendent of Public Instruction,Jack Jr.,DEM,720854,0,0,13,13,
Tulsa,Superintendent of Public Instruction,Ivan Holmes,DEM,720854,0,0,5,5,
Tulsa,Superintendent of Public Instruction,Freda Deskin,DEM,720854,0,0,34,34,
Tulsa,U.S. Senate,Patrick Michael Hayes,DEM,720854,0,0,18,18,
Tulsa,U.S. Senate,Jim Rogers,DEM,720854,0,0,41,41,
Tulsa,U.S. Senate,Connie Johnson,DEM,720854,0,0,35,35,
Tulsa,Governor,Dax Ewbank,REP,720854,0,0,41,41,
Tulsa,Governor,Chad Moody,REP,720854,0,0,110,110,
Tulsa,Governor,Mary Fallin,REP,720854,0,0,227,227,
Tulsa,Superintendent of Public Instruction,Brian Kelly,REP,720854,0,0,32,32,
Tulsa,Superintendent of Public Instruction,Janet Costello Barresi,REP,720854,0,0,43,43,
Tulsa,Superintendent of Public Instruction,Joy Hofmeister,REP,720854,0,0,312,312,
Tulsa,Insurance Commissioner,Bill Viner,REP,720854,0,0,72,72,
Tulsa,Insurance Commissioner,John Doak,REP,720854,0,0,276,276,
Tulsa,Corporation Commissioner,Todd Hiett,REP,720854,0,0,212,212,
Tulsa,Corporation Commissioner,Cliff Branan,REP,720854,0,0,139,139,
Tulsa,U.S. Senate,Evelyn Rogers,REP,720854,0,0,20,20,
Tulsa,U.S. Senate,Rob Moye,REP,720854,0,0,9,9,
Tulsa,U.S. Senate,D. Jean Mcbride-Samuels,REP,720854,0,0,7,7,
Tulsa,U.S. Senate,Jim Inhofe,REP,720854,0,0,323,323,
Tulsa,U.S. Senate,Erick Paul Wyatt,REP,720854,0,0,17,17,
Tulsa,U.S. Senate,Andy Craig,REP,720854,0,0,3,3,
Tulsa,U.S. Senate,T. Shannon,REP,720854,0,0,138,138,
Tulsa,U.S. Senate,Randy Brogdon,REP,720854,0,0,22,22,
Tulsa,U.S. Senate,Eric Mccray,REP,720854,0,0,6,6,
Tulsa,U.S. Senate,Kevin Crow,REP,720854,0,0,3,3,
Tulsa,U.S. Senate,James Lankford,REP,720854,0,0,209,209,
Tulsa,U.S. Senate,Jason Weger,REP,720854,0,0,0,0,
Tulsa,Superintendent of Public Instruction,John Cox,DEM,720855,0,0,52,52,
Tulsa,Superintendent of Public Instruction,Jack Jr.,DEM,720855,0,0,11,11,
Tulsa,Superintendent of Public Instruction,Ivan Holmes,DEM,720855,0,0,6,6,
Tulsa,Superintendent of Public Instruction,Freda Deskin,DEM,720855,0,0,49,49,
Tulsa,U.S. Senate,Patrick Michael Hayes,DEM,720855,0,0,18,18,
Tulsa,U.S. Senate,Jim Rogers,DEM,720855,0,0,47,47,
Tulsa,U.S. Senate,Connie Johnson,DEM,720855,0,0,48,48,
Tulsa,Governor,Dax Ewbank,REP,720855,0,0,39,39,
Tulsa,Governor,Chad Moody,REP,720855,0,0,54,54,
Tulsa,Governor,Mary Fallin,REP,720855,0,0,234,234,
Tulsa,Superintendent of Public Instruction,Brian Kelly,REP,720855,0,0,36,36,
Tulsa,Superintendent of Public Instruction,Janet Costello Barresi,REP,720855,0,0,41,41,
Tulsa,Superintendent of Public Instruction,Joy Hofmeister,REP,720855,0,0,256,256,
Tulsa,Insurance Commissioner,Bill Viner,REP,720855,0,0,57,57,
Tulsa,Insurance Commissioner,John Doak,REP,720855,0,0,251,251,
Tulsa,Corporation Commissioner,Todd Hiett,REP,720855,0,0,196,196,
Tulsa,Corporation Commissioner,Cliff Branan,REP,720855,0,0,115,115,
Tulsa,U.S. Senate,Evelyn Rogers,REP,720855,0,0,15,15,
Tulsa,U.S. Senate,Rob Moye,REP,720855,0,0,5,5,
Tulsa,U.S. Senate,D. Jean Mcbride-Samuels,REP,720855,0,0,0,0,
Tulsa,U.S. Senate,Jim Inhofe,REP,720855,0,0,297,297,
Tulsa,U.S. Senate,Erick Paul Wyatt,REP,720855,0,0,11,11,
Tulsa,U.S. Senate,Andy Craig,REP,720855,0,0,0,0,
Tulsa,U.S. Senate,T. Shannon,REP,720855,0,0,137,137,
Tulsa,U.S. Senate,Randy Brogdon,REP,720855,0,0,28,28,
Tulsa,U.S. Senate,Eric Mccray,REP,720855,0,0,0,0,
Tulsa,U.S. Senate,Kevin Crow,REP,720855,0,0,3,3,
Tulsa,U.S. Senate,James Lankford,REP,720855,0,0,162,162,
Tulsa,U.S. Senate,Jason Weger,REP,720855,0,0,1,1,
Tulsa,Superintendent of Public Instruction,John Cox,DEM,720856,0,0,39,39,
Tulsa,Superintendent of Public Instruction,Jack Jr.,DEM,720856,0,0,9,9,
Tulsa,Superintendent of Public Instruction,Ivan Holmes,DEM,720856,0,0,4,4,
Tulsa,Superintendent of Public Instruction,Freda Deskin,DEM,720856,0,0,36,36,
Tulsa,U.S. Senate,Patrick Michael Hayes,DEM,720856,0,0,15,15,
Tulsa,U.S. Senate,Jim Rogers,DEM,720856,0,0,24,24,
Tulsa,U.S. Senate,Connie Johnson,DEM,720856,0,0,46,46,
Tulsa,Governor,Dax Ewbank,REP,720856,0,0,33,33,
Tulsa,Governor,Chad Moody,REP,720856,0,0,72,72,
Tulsa,Governor,Mary Fallin,REP,720856,0,0,195,195,
Tulsa,Superintendent of Public Instruction,Brian Kelly,REP,720856,0,0,25,25,
Tulsa,Superintendent of Public Instruction,Janet Costello Barresi,REP,720856,0,0,37,37,
Tulsa,Superintendent of Public Instruction,Joy Hofmeister,REP,720856,0,0,245,245,
Tulsa,Insurance Commissioner,Bill Viner,REP,720856,0,0,56,56,
Tulsa,Insurance Commissioner,John Doak,REP,720856,0,0,221,221,
Tulsa,Corporation Commissioner,Todd Hiett,REP,720856,0,0,182,182,
Tulsa,Corporation Commissioner,Cliff Branan,REP,720856,0,0,99,99,
Tulsa,U.S. Senate,Evelyn Rogers,REP,720856,0,0,13,13,
Tulsa,U.S. Senate,Rob Moye,REP,720856,0,0,6,6,
Tulsa,U.S. Senate,D. Jean Mcbride-Samuels,REP,720856,0,0,8,8,
Tulsa,U.S. Senate,Jim Inhofe,REP,720856,0,0,267,267,
Tulsa,U.S. Senate,Erick Paul Wyatt,REP,720856,0,0,11,11,
Tulsa,U.S. Senate,Andy Craig,REP,720856,0,0,1,1,
Tulsa,U.S. Senate,T. Shannon,REP,720856,0,0,119,119,
Tulsa,U.S. Senate,Randy Brogdon,REP,720856,0,0,14,14,
Tulsa,U.S. Senate,Eric Mccray,REP,720856,0,0,2,2,
Tulsa,U.S. Senate,Kevin Crow,REP,720856,0,0,3,3,
Tulsa,U.S. Senate,James Lankford,REP,720856,0,0,165,165,
Tulsa,U.S. Senate,Jason Weger,REP,720856,0,0,1,1,
Tulsa,Superintendent of Public Instruction,John Cox,DEM,720857,0,0,38,38,
Tulsa,Superintendent of Public Instruction,Jack Jr.,DEM,720857,0,0,12,12,
Tulsa,Superintendent of Public Instruction,Ivan Holmes,DEM,720857,0,0,1,1,
Tulsa,Superintendent of Public Instruction,Freda Deskin,DEM,720857,0,0,28,28,
Tulsa,U.S. Senate,Patrick Michael Hayes,DEM,720857,0,0,14,14,
Tulsa,U.S. Senate,Jim Rogers,DEM,720857,0,0,30,30,
Tulsa,U.S. Senate,Connie Johnson,DEM,720857,0,0,36,36,
Tulsa,Governor,Dax Ewbank,REP,720857,0,0,16,16,
Tulsa,Governor,Chad Moody,REP,720857,0,0,33,33,
Tulsa,Governor,Mary Fallin,REP,720857,0,0,132,132,
Tulsa,Superintendent of Public Instruction,Brian Kelly,REP,720857,0,0,32,32,
Tulsa,Superintendent of Public Instruction,Janet Costello Barresi,REP,720857,0,0,30,30,
Tulsa,Superintendent of Public Instruction,Joy Hofmeister,REP,720857,0,0,122,122,
Tulsa,Insurance Commissioner,Bill Viner,REP,720857,0,0,47,47,
Tulsa,Insurance Commissioner,John Doak,REP,720857,0,0,127,127,
Tulsa,Corporation Commissioner,Todd Hiett,REP,720857,0,0,102,102,
Tulsa,Corporation Commissioner,Cliff Branan,REP,720857,0,0,68,68,
Tulsa,U.S. Senate,Evelyn Rogers,REP,720857,0,0,13,13,
Tulsa,U.S. Senate,Rob Moye,REP,720857,0,0,4,4,
Tulsa,U.S. Senate,D. Jean Mcbride-Samuels,REP,720857,0,0,2,2,
Tulsa,U.S. Senate,Jim Inhofe,REP,720857,0,0,161,161,
Tulsa,U.S. Senate,Erick Paul Wyatt,REP,720857,0,0,4,4,
Tulsa,U.S. Senate,Andy Craig,REP,720857,0,0,4,4,
Tulsa,U.S. Senate,T. Shannon,REP,720857,0,0,62,62,
Tulsa,U.S. Senate,Randy Brogdon,REP,720857,0,0,13,13,
Tulsa,U.S. Senate,Eric Mccray,REP,720857,0,0,4,4,
Tulsa,U.S. Senate,Kevin Crow,REP,720857,0,0,5,5,
Tulsa,U.S. Senate,James Lankford,REP,720857,0,0,95,95,
Tulsa,U.S. Senate,Jason Weger,REP,720857,0,0,2,2,
Tulsa,Superintendent of Public Instruction,John Cox,DEM,720858,0,0,18,18,
Tulsa,Superintendent of Public Instruction,Jack Jr.,DEM,720858,0,0,3,3,
Tulsa,Superintendent of Public Instruction,Ivan Holmes,DEM,720858,0,0,0,0,
Tulsa,Superintendent of Public Instruction,Freda Deskin,DEM,720858,0,0,22,22,
Tulsa,U.S. Senate,Patrick Michael Hayes,DEM,720858,0,0,13,13,
Tulsa,U.S. Senate,Jim Rogers,DEM,720858,0,0,10,10,
Tulsa,U.S. Senate,Connie Johnson,DEM,720858,0,0,18,18,
Tulsa,Governor,Dax Ewbank,REP,720858,0,0,13,13,
Tulsa,Governor,Chad Moody,REP,720858,0,0,21,21,
Tulsa,Governor,Mary Fallin,REP,720858,0,0,70,70,
Tulsa,Superintendent of Public Instruction,Brian Kelly,REP,720858,0,0,16,16,
Tulsa,Superintendent of Public Instruction,Janet Costello Barresi,REP,720858,0,0,14,14,
Tulsa,Superintendent of Public Instruction,Joy Hofmeister,REP,720858,0,0,77,77,
Tulsa,Insurance Commissioner,Bill Viner,REP,720858,0,0,24,24,
Tulsa,Insurance Commissioner,John Doak,REP,720858,0,0,75,75,
Tulsa,Corporation Commissioner,Todd Hiett,REP,720858,0,0,64,64,
Tulsa,Corporation Commissioner,Cliff Branan,REP,720858,0,0,39,39,
Tulsa,U.S. Senate,Evelyn Rogers,REP,720858,0,0,5,5,
Tulsa,U.S. Senate,Rob Moye,REP,720858,0,0,2,2,
Tulsa,U.S. Senate,D. Jean Mcbride-Samuels,REP,720858,0,0,0,0,
Tulsa,U.S. Senate,Jim Inhofe,REP,720858,0,0,92,92,
Tulsa,U.S. Senate,Erick Paul Wyatt,REP,720858,0,0,7,7,
Tulsa,U.S. Senate,Andy Craig,REP,720858,0,0,0,0,
Tulsa,U.S. Senate,T. Shannon,REP,720858,0,0,47,47,
Tulsa,U.S. Senate,Randy Brogdon,REP,720858,0,0,9,9,
Tulsa,U.S. Senate,Eric Mccray,REP,720858,0,0,0,0,
Tulsa,U.S. Senate,Kevin Crow,REP,720858,0,0,0,0,
Tulsa,U.S. Senate,James Lankford,REP,720858,0,0,50,50,
Tulsa,U.S. Senate,Jason Weger,REP,720858,0,0,1,1,
Tulsa,State House,James Leewright,REP,720858,0,0,41,41,29
Tulsa,State House,Clayton Mckinzie,REP,720858,0,0,2,2,29
Tulsa,State House,Dani Thompson-Fields,REP,720858,0,0,34,34,29
Tulsa,State House,Geron Ledbetter,REP,720858,0,0,19,19,29
Tulsa,Superintendent of Public Instruction,John Cox,DEM,720880,0,0,23,23,
Tulsa,Superintendent of Public Instruction,Jack Jr.,DEM,720880,0,0,3,3,
Tulsa,Superintendent of Public Instruction,Ivan Holmes,DEM,720880,0,0,4,4,
Tulsa,Superintendent of Public Instruction,Freda Deskin,DEM,720880,0,0,24,24,
Tulsa,U.S. Senate,Patrick Michael Hayes,DEM,720880,0,0,9,9,
Tulsa,U.S. Senate,Jim Rogers,DEM,720880,0,0,21,21,
Tulsa,U.S. Senate,Connie Johnson,DEM,720880,0,0,22,22,
Tulsa,Governor,Dax Ewbank,REP,720880,0,0,15,15,
Tulsa,Governor,Chad Moody,REP,720880,0,0,31,31,
Tulsa,Governor,Mary Fallin,REP,720880,0,0,176,176,
Tulsa,Superintendent of Public Instruction,Brian Kelly,REP,720880,0,0,49,49,
Tulsa,Superintendent of Public Instruction,Janet Costello Barresi,REP,720880,0,0,40,40,
Tulsa,Superintendent of Public Instruction,Joy Hofmeister,REP,720880,0,0,138,138,
Tulsa,Insurance Commissioner,Bill Viner,REP,720880,0,0,62,62,
Tulsa,Insurance Commissioner,John Doak,REP,720880,0,0,153,153,
Tulsa,Corporation Commissioner,Todd Hiett,REP,720880,0,0,129,129,
Tulsa,Corporation Commissioner,Cliff Branan,REP,720880,0,0,84,84,
Tulsa,U.S. Senate,Evelyn Rogers,REP,720880,0,0,6,6,
Tulsa,U.S. Senate,Rob Moye,REP,720880,0,0,2,2,
Tulsa,U.S. Senate,D. Jean Mcbride-Samuels,REP,720880,0,0,5,5,
Tulsa,U.S. Senate,Jim Inhofe,REP,720880,0,0,199,199,
Tulsa,U.S. Senate,Erick Paul Wyatt,REP,720880,0,0,14,14,
Tulsa,U.S. Senate,Andy Craig,REP,720880,0,0,2,2,
Tulsa,U.S. Senate,T. Shannon,REP,720880,0,0,106,106,
Tulsa,U.S. Senate,Randy Brogdon,REP,720880,0,0,13,13,
Tulsa,U.S. Senate,Eric Mccray,REP,720880,0,0,2,2,
Tulsa,U.S. Senate,Kevin Crow,REP,720880,0,0,4,4,
Tulsa,U.S. Senate,James Lankford,REP,720880,0,0,97,97,
Tulsa,U.S. Senate,Jason Weger,REP,720880,0,0,1,1,
Tulsa,State House,James Leewright,REP,720880,0,0,96,96,29
Tulsa,State House,Clayton Mckinzie,REP,720880,0,0,26,26,29
Tulsa,State House,Dani Thompson-Fields,REP,720880,0,0,67,67,29
Tulsa,State House,Geron Ledbetter,REP,720880,0,0,26,26,29
Tulsa,Superintendent of Public Instruction,John Cox,DEM,720881,0,0,28,28,
Tulsa,Superintendent of Public Instruction,Jack Jr.,DEM,720881,0,0,9,9,
Tulsa,Superintendent of Public Instruction,Ivan Holmes,DEM,720881,0,0,0,0,
Tulsa,Superintendent of Public Instruction,Freda Deskin,DEM,720881,0,0,24,24,
Tulsa,U.S. Senate,Patrick Michael Hayes,DEM,720881,0,0,15,15,
Tulsa,U.S. Senate,Jim Rogers,DEM,720881,0,0,15,15,
Tulsa,U.S. Senate,Connie Johnson,DEM,720881,0,0,29,29,
Tulsa,Governor,Dax Ewbank,REP,720881,0,0,13,13,
Tulsa,Governor,Chad Moody,REP,720881,0,0,28,28,
Tulsa,Governor,Mary Fallin,REP,720881,0,0,115,115,
Tulsa,Superintendent of Public Instruction,Brian Kelly,REP,720881,0,0,15,15,
Tulsa,Superintendent of Public Instruction,Janet Costello Barresi,REP,720881,0,0,15,15,
Tulsa,Superintendent of Public Instruction,Joy Hofmeister,REP,720881,0,0,128,128,
Tulsa,Insurance Commissioner,Bill Viner,REP,720881,0,0,35,35,
Tulsa,Insurance Commissioner,John Doak,REP,720881,0,0,114,114,
Tulsa,Corporation Commissioner,Todd Hiett,REP,720881,0,0,94,94,
Tulsa,Corporation Commissioner,Cliff Branan,REP,720881,0,0,53,53,
Tulsa,U.S. Senate,Evelyn Rogers,REP,720881,0,0,13,13,
Tulsa,U.S. Senate,Rob Moye,REP,720881,0,0,1,1,
Tulsa,U.S. Senate,D. Jean Mcbride-Samuels,REP,720881,0,0,4,4,
Tulsa,U.S. Senate,Jim Inhofe,REP,720881,0,0,134,134,
Tulsa,U.S. Senate,Erick Paul Wyatt,REP,720881,0,0,6,6,
Tulsa,U.S. Senate,Andy Craig,REP,720881,0,0,2,2,
Tulsa,U.S. Senate,T. Shannon,REP,720881,0,0,65,65,
Tulsa,U.S. Senate,Randy Brogdon,REP,720881,0,0,12,12,
Tulsa,U.S. Senate,Eric Mccray,REP,720881,0,0,0,0,
Tulsa,U.S. Senate,Kevin Crow,REP,720881,0,0,3,3,
Tulsa,U.S. Senate,James Lankford,REP,720881,0,0,76,76,
Tulsa,U.S. Senate,Jason Weger,REP,720881,0,0,2,2,
Tulsa,Superintendent of Public Instruction,John Cox,DEM,720900,0,0,52,52,
Tulsa,Superintendent of Public Instruction,Jack Jr.,DEM,720900,0,0,8,8,
Tulsa,Superintendent of Public Instruction,Ivan Holmes,DEM,720900,0,0,4,4,
Tulsa,Superintendent of Public Instruction,Freda Deskin,DEM,720900,0,0,41,41,
Tulsa,U.S. Senate,Patrick Michael Hayes,DEM,720900,0,0,21,21,
Tulsa,U.S. Senate,Jim Rogers,DEM,720900,0,0,44,44,
Tulsa,U.S. Senate,Connie Johnson,DEM,720900,0,0,39,39,
Tulsa,Governor,Dax Ewbank,REP,720900,0,0,40,40,
Tulsa,Governor,Chad Moody,REP,720900,0,0,42,42,
Tulsa,Governor,Mary Fallin,REP,720900,0,0,184,184,
Tulsa,Superintendent of Public Instruction,Brian Kelly,REP,720900,0,0,54,54,
Tulsa,Superintendent of Public Instruction,Janet Costello Barresi,REP,720900,0,0,27,27,
Tulsa,Superintendent of Public Instruction,Joy Hofmeister,REP,720900,0,0,187,187,
Tulsa,Insurance Commissioner,Bill Viner,REP,720900,0,0,76,76,
Tulsa,Insurance Commissioner,John Doak,REP,720900,0,0,180,180,
Tulsa,Corporation Commissioner,Todd Hiett,REP,720900,0,0,134,134,
Tulsa,Corporation Commissioner,Cliff Branan,REP,720900,0,0,120,120,
Tulsa,U.S. Senate,Evelyn Rogers,REP,720900,0,0,6,6,
Tulsa,U.S. Senate,Rob Moye,REP,720900,0,0,10,10,
Tulsa,U.S. Senate,D. Jean Mcbride-Samuels,REP,720900,0,0,7,7,
Tulsa,U.S. Senate,Jim Inhofe,REP,720900,0,0,233,233,
Tulsa,U.S. Senate,Erick Paul Wyatt,REP,720900,0,0,11,11,
Tulsa,U.S. Senate,Andy Craig,REP,720900,0,0,3,3,
Tulsa,U.S. Senate,T. Shannon,REP,720900,0,0,101,101,
Tulsa,U.S. Senate,Randy Brogdon,REP,720900,0,0,41,41,
Tulsa,U.S. Senate,Eric Mccray,REP,720900,0,0,2,2,
Tulsa,U.S. Senate,Kevin Crow,REP,720900,0,0,3,3,
Tulsa,U.S. Senate,James Lankford,REP,720900,0,0,117,117,
Tulsa,U.S. Senate,Jason Weger,REP,720900,0,0,0,0,
Tulsa,Superintendent of Public Instruction,John Cox,DEM,729999,214,198,0,412,
Tulsa,Superintendent of Public Instruction,Jack Jr.,DEM,729999,97,77,0,174,
Tulsa,Superintendent of Public Instruction,Ivan Holmes,DEM,729999,94,69,0,163,
Tulsa,Superintendent of Public Instruction,Freda Deskin,DEM,729999,311,250,0,561,
Tulsa,U.S. Senate,Patrick Michael Hayes,DEM,729999,126,99,0,225,
Tulsa,U.S. Senate,Jim Rogers,DEM,729999,158,117,0,275,
Tulsa,U.S. Senate,Connie Johnson,DEM,729999,438,373,0,811,
Tulsa,Governor,Dax Ewbank,REP,729999,145,126,0,271,
Tulsa,Governor,Chad Moody,REP,729999,222,221,0,443,
Tulsa,Governor,Mary Fallin,REP,729999,1315,993,0,2308,
Tulsa,Superintendent of Public Instruction,Brian Kelly,REP,729999,250,227,0,477,
Tulsa,Superintendent of Public Instruction,Janet Costello Barresi,REP,729999,367,216,0,583,
Tulsa,Superintendent of Public Instruction,Joy Hofmeister,REP,729999,1031,912,0,1943,
Tulsa,Insurance Commissioner,Bill Viner,REP,729999,309,249,0,558,
Tulsa,Insurance Commissioner,John Doak,REP,729999,1217,1026,0,2243,
Tulsa,Corporation Commissioner,Todd Hiett,REP,729999,932,700,0,1632,
Tulsa,Corporation Commissioner,Cliff Branan,REP,729999,564,547,0,1111,
Tulsa,U.S. Senate,Evelyn Rogers,REP,729999,90,79,0,169,
Tulsa,U.S. Senate,Rob Moye,REP,729999,33,19,0,52,
Tulsa,U.S. Senate,D. Jean Mcbride-Samuels,REP,729999,42,30,0,72,
Tulsa,U.S. Senate,Jim Inhofe,REP,729999,1459,1150,0,2609,
Tulsa,U.S. Senate,Erick Paul Wyatt,REP,729999,74,75,0,149,
Tulsa,U.S. Senate,Andy Craig,REP,729999,29,14,0,43,
Tulsa,U.S. Senate,T. Shannon,REP,729999,689,479,0,1168,
Tulsa,U.S. Senate,Randy Brogdon,REP,729999,175,143,0,318,
Tulsa,U.S. Senate,Eric Mccray,REP,729999,22,9,0,31,
Tulsa,U.S. Senate,Kevin Crow,REP,729999,16,11,0,27,
Tulsa,U.S. Senate,James Lankford,REP,729999,745,697,0,1442,
Tulsa,U.S. Senate,Jason Weger,REP,729999,27,10,0,37,
Tulsa,State Senate,John Knecht,REP,729999,4,0,0,4,12
Tulsa,State Senate,Brian Bingman,REP,729999,9,5,0,14,12
Tulsa,State House,James Leewright,REP,729999,1,7,0,8,29
Tulsa,State House,Clayton Mckinzie,REP,729999,2,1,0,3,29
Tulsa,State House,Dani Thompson-Fields,REP,729999,5,1,0,6,29
Tulsa,State House,Geron Ledbetter,REP,729999,1,1,0,2,29
Tulsa,State House,Melissa Abdo,REP,729999,93,79,0,172,69
Tulsa,State House,Paul Bowman,REP,729999,42,37,0,79,69
Tulsa,State House,Chuck Strohm,REP,729999,51,34,0,85,69
Tulsa,State House,David Brumbaugh,REP,729999,75,57,0,132,76
Tulsa,State House,Cliff Johns,REP,729999,12,20,0,32,76
Tulsa,State House,Weldon Watson,REP,729999,110,84,0,194,79
Tulsa,State House,Lois Jacobs,REP,729999,43,25,0,68,79
Tulsa,State House,Michael Rogers,REP,729999,17,6,0,23,98
Tulsa,State House,Terri Cleveland,REP,729999,7,5,0,12,98
Wagoner,Superintendent of Public Instruction,John Cox,DEM,730101,0,0,26,26,
Wagoner,Superintendent of Public Instruction,Jack Jr.,DEM,730101,2,0,11,13,
Wagoner,Superintendent of Public Instruction,Ivan Holmes,DEM,730101,0,0,2,2,
Wagoner,Superintendent of Public Instruction,Freda Deskin,DEM,730101,0,0,23,23,
Wagoner,U.S. Senate,Patrick Michael Hayes,DEM,730101,0,0,17,17,
Wagoner,U.S. Senate,Jim Rogers,DEM,730101,2,0,22,24,
Wagoner,U.S. Senate,Connie Johnson,DEM,730101,0,0,24,24,
Wagoner,Governor,Dax Ewbank,REP,730101,1,0,9,10,
Wagoner,Governor,Chad Moody,REP,730101,0,0,18,18,
Wagoner,Governor,Mary Fallin,REP,730101,2,2,95,99,
Wagoner,Superintendent of Public Instruction,Brian Kelly,REP,730101,0,1,27,28,
Wagoner,Superintendent of Public Instruction,Janet Costello Barresi,REP,730101,1,0,29,30,
Wagoner,Superintendent of Public Instruction,Joy Hofmeister,REP,730101,2,1,66,69,
Wagoner,Insurance Commissioner,Bill Viner,REP,730101,0,0,25,25,
Wagoner,Insurance Commissioner,John Doak,REP,730101,3,2,91,96,
Wagoner,Corporation Commissioner,Todd Hiett,REP,730101,2,1,67,70,
Wagoner,Corporation Commissioner,Cliff Branan,REP,730101,1,1,48,50,
Wagoner,U.S. Senate,Evelyn Rogers,REP,730101,0,0,5,5,
Wagoner,U.S. Senate,Rob Moye,REP,730101,0,0,0,0,
Wagoner,U.S. Senate,D. Jean Mcbride-Samuels,REP,730101,0,0,2,2,
Wagoner,U.S. Senate,Jim Inhofe,REP,730101,3,2,106,111,
Wagoner,U.S. Senate,Erick Paul Wyatt,REP,730101,0,0,7,7,
Wagoner,U.S. Senate,Andy Craig,REP,730101,0,0,1,1,
Wagoner,U.S. Senate,T. Shannon,REP,730101,2,2,65,69,
Wagoner,U.S. Senate,Randy Brogdon,REP,730101,1,0,6,7,
Wagoner,U.S. Senate,Eric Mccray,REP,730101,0,0,0,0,
Wagoner,U.S. Senate,Kevin Crow,REP,730101,0,0,1,1,
Wagoner,U.S. Senate,James Lankford,REP,730101,0,0,47,47,
Wagoner,U.S. Senate,Jason Weger,REP,730101,0,0,2,2,
Wagoner,Superintendent of Public Instruction,John Cox,DEM,730102,0,0,5,5,
Wagoner,Superintendent of Public Instruction,Jack Jr.,DEM,730102,0,0,1,1,
Wagoner,Superintendent of Public Instruction,Ivan Holmes,DEM,730102,0,0,0,0,
Wagoner,Superintendent of Public Instruction,Freda Deskin,DEM,730102,1,0,6,7,
Wagoner,U.S. Senate,Patrick Michael Hayes,DEM,730102,0,0,5,5,
Wagoner,U.S. Senate,Jim Rogers,DEM,730102,0,0,3,3,
Wagoner,U.S. Senate,Connie Johnson,DEM,730102,1,0,4,5,
Wagoner,Governor,Dax Ewbank,REP,730102,0,0,10,10,
Wagoner,Governor,Chad Moody,REP,730102,0,0,30,30,
Wagoner,Governor,Mary Fallin,REP,730102,4,0,155,159,
Wagoner,Superintendent of Public Instruction,Brian Kelly,REP,730102,1,0,44,45,
Wagoner,Superintendent of Public Instruction,Janet Costello Barresi,REP,730102,1,0,30,31,
Wagoner,Superintendent of Public Instruction,Joy Hofmeister,REP,730102,1,0,117,118,
Wagoner,Insurance Commissioner,Bill Viner,REP,730102,0,0,47,47,
Wagoner,Insurance Commissioner,John Doak,REP,730102,4,0,131,135,
Wagoner,Corporation Commissioner,Todd Hiett,REP,730102,3,0,113,116,
Wagoner,Corporation Commissioner,Cliff Branan,REP,730102,1,0,63,64,
Wagoner,U.S. Senate,Evelyn Rogers,REP,730102,0,0,10,10,
Wagoner,U.S. Senate,Rob Moye,REP,730102,0,0,2,2,
Wagoner,U.S. Senate,D. Jean Mcbride-Samuels,REP,730102,0,0,3,3,
Wagoner,U.S. Senate,Jim Inhofe,REP,730102,4,0,174,178,
Wagoner,U.S. Senate,Erick Paul Wyatt,REP,730102,0,0,6,6,
Wagoner,U.S. Senate,Andy Craig,REP,730102,0,0,4,4,
Wagoner,U.S. Senate,T. Shannon,REP,730102,2,0,93,95,
Wagoner,U.S. Senate,Randy Brogdon,REP,730102,2,0,18,20,
Wagoner,U.S. Senate,Eric Mccray,REP,730102,0,0,0,0,
Wagoner,U.S. Senate,Kevin Crow,REP,730102,0,0,3,3,
Wagoner,U.S. Senate,James Lankford,REP,730102,0,0,75,75,
Wagoner,U.S. Senate,Jason Weger,REP,730102,0,0,0,0,
Wagoner,Superintendent of Public Instruction,John Cox,DEM,730103,0,0,23,23,
Wagoner,Superintendent of Public Instruction,Jack Jr.,DEM,730103,0,0,9,9,
Wagoner,Superintendent of Public Instruction,Ivan Holmes,DEM,730103,0,0,7,7,
Wagoner,Superintendent of Public Instruction,Freda Deskin,DEM,730103,0,0,27,27,
Wagoner,U.S. Senate,Patrick Michael Hayes,DEM,730103,0,0,12,12,
Wagoner,U.S. Senate,Jim Rogers,DEM,730103,0,0,17,17,
Wagoner,U.S. Senate,Connie Johnson,DEM,730103,0,0,35,35,
Wagoner,Governor,Dax Ewbank,REP,730103,0,0,42,42,
Wagoner,Governor,Chad Moody,REP,730103,0,0,40,40,
Wagoner,Governor,Mary Fallin,REP,730103,3,0,233,236,
Wagoner,Superintendent of Public Instruction,Brian Kelly,REP,730103,0,0,58,58,
Wagoner,Superintendent of Public Instruction,Janet Costello Barresi,REP,730103,1,0,67,68,
Wagoner,Superintendent of Public Instruction,Joy Hofmeister,REP,730103,1,0,183,184,
Wagoner,Insurance Commissioner,Bill Viner,REP,730103,1,0,63,64,
Wagoner,Insurance Commissioner,John Doak,REP,730103,1,0,224,225,
Wagoner,Corporation Commissioner,Todd Hiett,REP,730103,2,0,178,180,
Wagoner,Corporation Commissioner,Cliff Branan,REP,730103,0,0,107,107,
Wagoner,U.S. Senate,Evelyn Rogers,REP,730103,0,0,16,16,
Wagoner,U.S. Senate,Rob Moye,REP,730103,0,0,6,6,
Wagoner,U.S. Senate,D. Jean Mcbride-Samuels,REP,730103,0,0,6,6,
Wagoner,U.S. Senate,Jim Inhofe,REP,730103,2,0,277,279,
Wagoner,U.S. Senate,Erick Paul Wyatt,REP,730103,0,0,13,13,
Wagoner,U.S. Senate,Andy Craig,REP,730103,0,0,4,4,
Wagoner,U.S. Senate,T. Shannon,REP,730103,1,0,169,170,
Wagoner,U.S. Senate,Randy Brogdon,REP,730103,0,0,32,32,
Wagoner,U.S. Senate,Eric Mccray,REP,730103,0,0,2,2,
Wagoner,U.S. Senate,Kevin Crow,REP,730103,0,0,1,1,
Wagoner,U.S. Senate,James Lankford,REP,730103,2,0,110,112,
Wagoner,U.S. Senate,Jason Weger,REP,730103,0,0,2,2,
Wagoner,State House,Michael Rogers,REP,730103,1,0,197,198,98
Wagoner,State House,Terri Cleveland,REP,730103,1,0,100,101,98
Wagoner,Superintendent of Public Instruction,John Cox,DEM,730104,0,0,0,0,
Wagoner,Superintendent of Public Instruction,Jack Jr.,DEM,730104,0,0,0,0,
Wagoner,Superintendent of Public Instruction,Ivan Holmes,DEM,730104,0,0,0,0,
Wagoner,Superintendent of Public Instruction,Freda Deskin,DEM,730104,0,0,0,0,
Wagoner,U.S. Senate,Patrick Michael Hayes,DEM,730104,0,0,0,0,
Wagoner,U.S. Senate,Jim Rogers,DEM,730104,0,0,0,0,
Wagoner,U.S. Senate,Connie Johnson,DEM,730104,0,0,0,0,
Wagoner,Governor,Dax Ewbank,REP,730104,0,0,0,0,
Wagoner,Governor,Chad Moody,REP,730104,0,0,0,0,
Wagoner,Governor,Mary Fallin,REP,730104,0,0,0,0,
Wagoner,Superintendent of Public Instruction,Brian Kelly,REP,730104,0,0,0,0,
Wagoner,Superintendent of Public Instruction,Janet Costello Barresi,REP,730104,0,0,0,0,
Wagoner,Superintendent of Public Instruction,Joy Hofmeister,REP,730104,0,0,0,0,
Wagoner,Insurance Commissioner,Bill Viner,REP,730104,0,0,0,0,
Wagoner,Insurance Commissioner,John Doak,REP,730104,0,0,0,0,
Wagoner,Corporation Commissioner,Todd Hiett,REP,730104,0,0,0,0,
Wagoner,Corporation Commissioner,Cliff Branan,REP,730104,0,0,0,0,
Wagoner,U.S. Senate,Evelyn Rogers,REP,730104,0,0,0,0,
Wagoner,U.S. Senate,Rob Moye,REP,730104,0,0,0,0,
Wagoner,U.S. Senate,D. Jean Mcbride-Samuels,REP,730104,0,0,0,0,
Wagoner,U.S. Senate,Jim Inhofe,REP,730104,0,0,0,0,
Wagoner,U.S. Senate,Erick Paul Wyatt,REP,730104,0,0,0,0,
Wagoner,U.S. Senate,Andy Craig,REP,730104,0,0,0,0,
Wagoner,U.S. Senate,T. Shannon,REP,730104,0,0,0,0,
Wagoner,U.S. Senate,Randy Brogdon,REP,730104,0,0,0,0,
Wagoner,U.S. Senate,Eric Mccray,REP,730104,0,0,0,0,
Wagoner,U.S. Senate,Kevin Crow,REP,730104,0,0,0,0,
Wagoner,U.S. Senate,James Lankford,REP,730104,0,0,0,0,
Wagoner,U.S. Senate,Jason Weger,REP,730104,0,0,0,0,
Wagoner,Superintendent of Public Instruction,John Cox,DEM,730105,0,0,14,14,
Wagoner,Superintendent of Public Instruction,Jack Jr.,DEM,730105,0,0,6,6,
Wagoner,Superintendent of Public Instruction,Ivan Holmes,DEM,730105,0,0,5,5,
Wagoner,Superintendent of Public Instruction,Freda Deskin,DEM,730105,0,0,25,25,
Wagoner,U.S. Senate,Patrick Michael Hayes,DEM,730105,0,0,10,10,
Wagoner,U.S. Senate,Jim Rogers,DEM,730105,0,0,15,15,
Wagoner,U.S. Senate,Connie Johnson,DEM,730105,0,0,25,25,
Wagoner,Governor,Dax Ewbank,REP,730105,0,0,2,2,
Wagoner,Governor,Chad Moody,REP,730105,0,0,4,4,
Wagoner,Governor,Mary Fallin,REP,730105,0,0,13,13,
Wagoner,Superintendent of Public Instruction,Brian Kelly,REP,730105,0,0,3,3,
Wagoner,Superintendent of Public Instruction,Janet Costello Barresi,REP,730105,0,0,5,5,
Wagoner,Superintendent of Public Instruction,Joy Hofmeister,REP,730105,0,0,11,11,
Wagoner,Insurance Commissioner,Bill Viner,REP,730105,0,0,3,3,
Wagoner,Insurance Commissioner,John Doak,REP,730105,0,0,15,15,
Wagoner,Corporation Commissioner,Todd Hiett,REP,730105,0,0,11,11,
Wagoner,Corporation Commissioner,Cliff Branan,REP,730105,0,0,7,7,
Wagoner,U.S. Senate,Evelyn Rogers,REP,730105,0,0,0,0,
Wagoner,U.S. Senate,Rob Moye,REP,730105,0,0,0,0,
Wagoner,U.S. Senate,D. Jean Mcbride-Samuels,REP,730105,0,0,1,1,
Wagoner,U.S. Senate,Jim Inhofe,REP,730105,0,0,16,16,
Wagoner,U.S. Senate,Erick Paul Wyatt,REP,730105,0,0,2,2,
Wagoner,U.S. Senate,Andy Craig,REP,730105,0,0,0,0,
Wagoner,U.S. Senate,T. Shannon,REP,730105,0,0,14,14,
Wagoner,U.S. Senate,Randy Brogdon,REP,730105,0,0,1,1,
Wagoner,U.S. Senate,Eric Mccray,REP,730105,0,0,0,0,
Wagoner,U.S. Senate,Kevin Crow,REP,730105,0,0,0,0,
Wagoner,U.S. Senate,James Lankford,REP,730105,0,0,4,4,
Wagoner,U.S. Senate,Jason Weger,REP,730105,0,0,0,0,
Wagoner,Superintendent of Public Instruction,John Cox,DEM,730106,0,0,29,29,
Wagoner,Superintendent of Public Instruction,Jack Jr.,DEM,730106,0,0,10,10,
Wagoner,Superintendent of Public Instruction,Ivan Holmes,DEM,730106,0,0,2,2,
Wagoner,Superintendent of Public Instruction,Freda Deskin,DEM,730106,2,0,41,43,
Wagoner,U.S. Senate,Patrick Michael Hayes,DEM,730106,1,0,19,20,
Wagoner,U.S. Senate,Jim Rogers,DEM,730106,1,0,24,25,
Wagoner,U.S. Senate,Connie Johnson,DEM,730106,0,0,37,37,
Wagoner,Governor,Dax Ewbank,REP,730106,1,0,41,42,
Wagoner,Governor,Chad Moody,REP,730106,3,0,69,72,
Wagoner,Governor,Mary Fallin,REP,730106,6,4,250,260,
Wagoner,Superintendent of Public Instruction,Brian Kelly,REP,730106,0,1,51,52,
Wagoner,Superintendent of Public Instruction,Janet Costello Barresi,REP,730106,2,1,52,55,
Wagoner,Superintendent of Public Instruction,Joy Hofmeister,REP,730106,7,3,252,262,
Wagoner,Insurance Commissioner,Bill Viner,REP,730106,1,0,77,78,
Wagoner,Insurance Commissioner,John Doak,REP,730106,9,4,246,259,
Wagoner,Corporation Commissioner,Todd Hiett,REP,730106,9,2,199,210,
Wagoner,Corporation Commissioner,Cliff Branan,REP,730106,1,1,128,130,
Wagoner,U.S. Senate,Evelyn Rogers,REP,730106,1,0,18,19,
Wagoner,U.S. Senate,Rob Moye,REP,730106,0,0,4,4,
Wagoner,U.S. Senate,D. Jean Mcbride-Samuels,REP,730106,0,0,5,5,
Wagoner,U.S. Senate,Jim Inhofe,REP,730106,9,5,311,325,
Wagoner,U.S. Senate,Erick Paul Wyatt,REP,730106,0,0,14,14,
Wagoner,U.S. Senate,Andy Craig,REP,730106,0,0,6,6,
Wagoner,U.S. Senate,T. Shannon,REP,730106,5,2,155,162,
Wagoner,U.S. Senate,Randy Brogdon,REP,730106,2,0,30,32,
Wagoner,U.S. Senate,Eric Mccray,REP,730106,0,0,4,4,
Wagoner,U.S. Senate,Kevin Crow,REP,730106,0,0,6,6,
Wagoner,U.S. Senate,James Lankford,REP,730106,3,3,154,160,
Wagoner,U.S. Senate,Jason Weger,REP,730106,0,0,4,4,
Wagoner,State House,Michael Rogers,REP,730106,7,2,236,245,98
Wagoner,State House,Terri Cleveland,REP,730106,3,1,102,106,98
Wagoner,Superintendent of Public Instruction,John Cox,DEM,730107,1,0,39,40,
Wagoner,Superintendent of Public Instruction,Jack Jr.,DEM,730107,2,0,16,18,
Wagoner,Superintendent of Public Instruction,Ivan Holmes,DEM,730107,0,0,4,4,
Wagoner,Superintendent of Public Instruction,Freda Deskin,DEM,730107,1,0,49,50,
Wagoner,U.S. Senate,Patrick Michael Hayes,DEM,730107,0,0,18,18,
Wagoner,U.S. Senate,Jim Rogers,DEM,730107,3,0,48,51,
Wagoner,U.S. Senate,Connie Johnson,DEM,730107,1,0,39,40,
Wagoner,Governor,Dax Ewbank,REP,730107,0,0,24,24,
Wagoner,Governor,Chad Moody,REP,730107,1,0,47,48,
Wagoner,Governor,Mary Fallin,REP,730107,14,5,276,295,
Wagoner,Superintendent of Public Instruction,Brian Kelly,REP,730107,3,1,64,68,
Wagoner,Superintendent of Public Instruction,Janet Costello Barresi,REP,730107,3,1,59,63,
Wagoner,Superintendent of Public Instruction,Joy Hofmeister,REP,730107,9,3,225,237,
Wagoner,Insurance Commissioner,Bill Viner,REP,730107,1,1,70,72,
Wagoner,Insurance Commissioner,John Doak,REP,730107,13,4,264,281,
Wagoner,Corporation Commissioner,Todd Hiett,REP,730107,11,5,196,212,
Wagoner,Corporation Commissioner,Cliff Branan,REP,730107,4,0,122,126,
Wagoner,U.S. Senate,Evelyn Rogers,REP,730107,2,0,18,20,
Wagoner,U.S. Senate,Rob Moye,REP,730107,0,0,8,8,
Wagoner,U.S. Senate,D. Jean Mcbride-Samuels,REP,730107,1,0,2,3,
Wagoner,U.S. Senate,Jim Inhofe,REP,730107,12,5,304,321,
Wagoner,U.S. Senate,Erick Paul Wyatt,REP,730107,0,0,19,19,
Wagoner,U.S. Senate,Andy Craig,REP,730107,1,0,2,3,
Wagoner,U.S. Senate,T. Shannon,REP,730107,4,2,156,162,
Wagoner,U.S. Senate,Randy Brogdon,REP,730107,0,0,34,34,
Wagoner,U.S. Senate,Eric Mccray,REP,730107,0,0,1,1,
Wagoner,U.S. Senate,Kevin Crow,REP,730107,0,0,3,3,
Wagoner,U.S. Senate,James Lankford,REP,730107,10,3,158,171,
Wagoner,U.S. Senate,Jason Weger,REP,730107,0,0,1,1,
Wagoner,State House,Michael Rogers,REP,730107,13,3,179,195,98
Wagoner,State House,Terri Cleveland,REP,730107,1,2,152,155,98
Wagoner,Superintendent of Public Instruction,John Cox,DEM,730108,0,1,20,21,
Wagoner,Superintendent of Public Instruction,Jack Jr.,DEM,730108,0,0,5,5,
Wagoner,Superintendent of Public Instruction,Ivan Holmes,DEM,730108,0,0,4,4,
Wagoner,Superintendent of Public Instruction,Freda Deskin,DEM,730108,0,0,22,22,
Wagoner,U.S. Senate,Patrick Michael Hayes,DEM,730108,0,1,8,9,
Wagoner,U.S. Senate,Jim Rogers,DEM,730108,0,0,16,16,
Wagoner,U.S. Senate,Connie Johnson,DEM,730108,0,0,27,27,
Wagoner,Governor,Dax Ewbank,REP,730108,0,0,14,14,
Wagoner,Governor,Chad Moody,REP,730108,0,1,29,30,
Wagoner,Governor,Mary Fallin,REP,730108,2,3,135,140,
Wagoner,Superintendent of Public Instruction,Brian Kelly,REP,730108,1,0,30,31,
Wagoner,Superintendent of Public Instruction,Janet Costello Barresi,REP,730108,0,1,21,22,
Wagoner,Superintendent of Public Instruction,Joy Hofmeister,REP,730108,1,3,121,125,
Wagoner,Insurance Commissioner,Bill Viner,REP,730108,0,0,31,31,
Wagoner,Insurance Commissioner,John Doak,REP,730108,2,4,130,136,
Wagoner,Corporation Commissioner,Todd Hiett,REP,730108,1,3,97,101,
Wagoner,Corporation Commissioner,Cliff Branan,REP,730108,1,1,67,69,
Wagoner,U.S. Senate,Evelyn Rogers,REP,730108,0,0,11,11,
Wagoner,U.S. Senate,Rob Moye,REP,730108,0,0,3,3,
Wagoner,U.S. Senate,D. Jean Mcbride-Samuels,REP,730108,0,0,2,2,
Wagoner,U.S. Senate,Jim Inhofe,REP,730108,2,4,156,162,
Wagoner,U.S. Senate,Erick Paul Wyatt,REP,730108,0,0,7,7,
Wagoner,U.S. Senate,Andy Craig,REP,730108,0,0,1,1,
Wagoner,U.S. Senate,T. Shannon,REP,730108,1,1,81,83,
Wagoner,U.S. Senate,Randy Brogdon,REP,730108,0,0,15,15,
Wagoner,U.S. Senate,Eric Mccray,REP,730108,0,0,1,1,
Wagoner,U.S. Senate,Kevin Crow,REP,730108,0,0,1,1,
Wagoner,U.S. Senate,James Lankford,REP,730108,1,3,79,83,
Wagoner,U.S. Senate,Jason Weger,REP,730108,0,0,1,1,
Wagoner,Superintendent of Public Instruction,John Cox,DEM,730109,0,2,10,12,
Wagoner,Superintendent of Public Instruction,Jack Jr.,DEM,730109,0,0,4,4,
Wagoner,Superintendent of Public Instruction,Ivan Holmes,DEM,730109,0,0,6,6,
Wagoner,Superintendent of Public Instruction,Freda Deskin,DEM,730109,0,2,21,23,
Wagoner,U.S. Senate,Patrick Michael Hayes,DEM,730109,0,0,11,11,
Wagoner,U.S. Senate,Jim Rogers,DEM,730109,0,3,14,17,
Wagoner,U.S. Senate,Connie Johnson,DEM,730109,0,1,16,17,
Wagoner,Governor,Dax Ewbank,REP,730109,0,0,18,18,
Wagoner,Governor,Chad Moody,REP,730109,0,0,27,27,
Wagoner,Governor,Mary Fallin,REP,730109,2,9,200,211,
Wagoner,Superintendent of Public Instruction,Brian Kelly,REP,730109,0,1,56,57,
Wagoner,Superintendent of Public Instruction,Janet Costello Barresi,REP,730109,0,0,41,41,
Wagoner,Superintendent of Public Instruction,Joy Hofmeister,REP,730109,2,8,149,159,
Wagoner,Insurance Commissioner,Bill Viner,REP,730109,0,1,37,38,
Wagoner,Insurance Commissioner,John Doak,REP,730109,2,8,181,191,
Wagoner,Corporation Commissioner,Todd Hiett,REP,730109,0,3,135,138,
Wagoner,Corporation Commissioner,Cliff Branan,REP,730109,2,6,81,89,
Wagoner,U.S. Senate,Evelyn Rogers,REP,730109,0,0,10,10,
Wagoner,U.S. Senate,Rob Moye,REP,730109,0,0,5,5,
Wagoner,U.S. Senate,D. Jean Mcbride-Samuels,REP,730109,0,0,6,6,
Wagoner,U.S. Senate,Jim Inhofe,REP,730109,2,8,219,229,
Wagoner,U.S. Senate,Erick Paul Wyatt,REP,730109,0,0,8,8,
Wagoner,U.S. Senate,Andy Craig,REP,730109,0,0,0,0,
Wagoner,U.S. Senate,T. Shannon,REP,730109,2,7,116,125,
Wagoner,U.S. Senate,Randy Brogdon,REP,730109,0,0,24,24,
Wagoner,U.S. Senate,Eric Mccray,REP,730109,0,0,1,1,
Wagoner,U.S. Senate,Kevin Crow,REP,730109,0,0,2,2,
Wagoner,U.S. Senate,James Lankford,REP,730109,0,2,107,109,
Wagoner,U.S. Senate,Jason Weger,REP,730109,0,0,0,0,
Wagoner,Superintendent of Public Instruction,John Cox,DEM,730201,0,1,26,27,
Wagoner,Superintendent of Public Instruction,Jack Jr.,DEM,730201,0,0,4,4,
Wagoner,Superintendent of Public Instruction,Ivan Holmes,DEM,730201,0,0,8,8,
Wagoner,Superintendent of Public Instruction,Freda Deskin,DEM,730201,0,0,24,24,
Wagoner,U.S. Senate,Patrick Michael Hayes,DEM,730201,0,0,13,13,
Wagoner,U.S. Senate,Jim Rogers,DEM,730201,0,0,22,22,
Wagoner,U.S. Senate,Connie Johnson,DEM,730201,0,1,28,29,
Wagoner,Governor,Dax Ewbank,REP,730201,0,0,20,20,
Wagoner,Governor,Chad Moody,REP,730201,0,3,30,33,
Wagoner,Governor,Mary Fallin,REP,730201,5,4,156,165,
Wagoner,Superintendent of Public Instruction,Brian Kelly,REP,730201,1,1,44,46,
Wagoner,Superintendent of Public Instruction,Janet Costello Barresi,REP,730201,3,0,36,39,
Wagoner,Superintendent of Public Instruction,Joy Hofmeister,REP,730201,1,6,131,138,
Wagoner,Insurance Commissioner,Bill Viner,REP,730201,1,0,51,52,
Wagoner,Insurance Commissioner,John Doak,REP,730201,3,6,148,157,
Wagoner,Corporation Commissioner,Todd Hiett,REP,730201,3,5,119,127,
Wagoner,Corporation Commissioner,Cliff Branan,REP,730201,1,1,80,82,
Wagoner,U.S. Senate,Evelyn Rogers,REP,730201,0,0,3,3,
Wagoner,U.S. Senate,Rob Moye,REP,730201,0,0,3,3,
Wagoner,U.S. Senate,D. Jean Mcbride-Samuels,REP,730201,0,0,3,3,
Wagoner,U.S. Senate,Jim Inhofe,REP,730201,5,6,194,205,
Wagoner,U.S. Senate,Erick Paul Wyatt,REP,730201,0,0,9,9,
Wagoner,U.S. Senate,Andy Craig,REP,730201,0,0,0,0,
Wagoner,U.S. Senate,T. Shannon,REP,730201,1,1,93,95,
Wagoner,U.S. Senate,Randy Brogdon,REP,730201,0,1,33,34,
Wagoner,U.S. Senate,Eric Mccray,REP,730201,0,0,1,1,
Wagoner,U.S. Senate,Kevin Crow,REP,730201,0,0,0,0,
Wagoner,U.S. Senate,James Lankford,REP,730201,4,4,83,91,
Wagoner,U.S. Senate,Jason Weger,REP,730201,0,0,1,1,
Wagoner,Superintendent of Public Instruction,John Cox,DEM,730202,0,3,33,36,
Wagoner,Superintendent of Public Instruction,Jack Jr.,DEM,730202,0,1,12,13,
Wagoner,Superintendent of Public Instruction,Ivan Holmes,DEM,730202,0,1,6,7,
Wagoner,Superintendent of Public Instruction,Freda Deskin,DEM,730202,1,0,33,34,
Wagoner,U.S. Senate,Patrick Michael Hayes,DEM,730202,0,2,16,18,
Wagoner,U.S. Senate,Jim Rogers,DEM,730202,1,2,39,42,
Wagoner,U.S. Senate,Connie Johnson,DEM,730202,1,1,26,28,
Wagoner,Governor,Dax Ewbank,REP,730202,2,0,23,25,
Wagoner,Governor,Chad Moody,REP,730202,1,0,42,43,
Wagoner,Governor,Mary Fallin,REP,730202,0,2,180,182,
Wagoner,Superintendent of Public Instruction,Brian Kelly,REP,730202,0,1,51,52,
Wagoner,Superintendent of Public Instruction,Janet Costello Barresi,REP,730202,0,1,36,37,
Wagoner,Superintendent of Public Instruction,Joy Hofmeister,REP,730202,3,0,156,159,
Wagoner,Insurance Commissioner,Bill Viner,REP,730202,1,0,56,57,
Wagoner,Insurance Commissioner,John Doak,REP,730202,2,2,179,183,
Wagoner,Corporation Commissioner,Todd Hiett,REP,730202,0,2,135,137,
Wagoner,Corporation Commissioner,Cliff Branan,REP,730202,3,0,97,100,
Wagoner,U.S. Senate,Evelyn Rogers,REP,730202,0,0,14,14,
Wagoner,U.S. Senate,Rob Moye,REP,730202,0,0,9,9,
Wagoner,U.S. Senate,D. Jean Mcbride-Samuels,REP,730202,0,0,4,4,
Wagoner,U.S. Senate,Jim Inhofe,REP,730202,3,2,212,217,
Wagoner,U.S. Senate,Erick Paul Wyatt,REP,730202,0,0,7,7,
Wagoner,U.S. Senate,Andy Craig,REP,730202,0,0,3,3,
Wagoner,U.S. Senate,T. Shannon,REP,730202,0,0,115,115,
Wagoner,U.S. Senate,Randy Brogdon,REP,730202,0,0,18,18,
Wagoner,U.S. Senate,Eric Mccray,REP,730202,0,0,3,3,
Wagoner,U.S. Senate,Kevin Crow,REP,730202,0,0,2,2,
Wagoner,U.S. Senate,James Lankford,REP,730202,3,2,105,110,
Wagoner,U.S. Senate,Jason Weger,REP,730202,0,0,0,0,
Wagoner,Superintendent of Public Instruction,John Cox,DEM,730203,0,4,127,131,
Wagoner,Superintendent of Public Instruction,Jack Jr.,DEM,730203,0,1,10,11,
Wagoner,Superintendent of Public Instruction,Ivan Holmes,DEM,730203,0,1,5,6,
Wagoner,Superintendent of Public Instruction,Freda Deskin,DEM,730203,1,1,60,62,
Wagoner,U.S. Senate,Patrick Michael Hayes,DEM,730203,1,1,52,54,
Wagoner,U.S. Senate,Jim Rogers,DEM,730203,0,2,76,78,
Wagoner,U.S. Senate,Connie Johnson,DEM,730203,0,4,69,73,
Wagoner,Governor,Dax Ewbank,REP,730203,0,2,15,17,
Wagoner,Governor,Chad Moody,REP,730203,2,5,42,49,
Wagoner,Governor,Mary Fallin,REP,730203,2,9,131,142,
Wagoner,Superintendent of Public Instruction,Brian Kelly,REP,730203,1,2,46,49,
Wagoner,Superintendent of Public Instruction,Janet Costello Barresi,REP,730203,0,0,25,25,
Wagoner,Superintendent of Public Instruction,Joy Hofmeister,REP,730203,3,15,116,134,
Wagoner,Insurance Commissioner,Bill Viner,REP,730203,1,3,28,32,
Wagoner,Insurance Commissioner,John Doak,REP,730203,3,13,144,160,
Wagoner,Corporation Commissioner,Todd Hiett,REP,730203,1,9,100,110,
Wagoner,Corporation Commissioner,Cliff Branan,REP,730203,1,7,75,83,
Wagoner,U.S. Senate,Evelyn Rogers,REP,730203,1,1,17,19,
Wagoner,U.S. Senate,Rob Moye,REP,730203,0,0,3,3,
Wagoner,U.S. Senate,D. Jean Mcbride-Samuels,REP,730203,0,0,5,5,
Wagoner,U.S. Senate,Jim Inhofe,REP,730203,2,15,158,175,
Wagoner,U.S. Senate,Erick Paul Wyatt,REP,730203,1,1,6,8,
Wagoner,U.S. Senate,Andy Craig,REP,730203,0,0,1,1,
Wagoner,U.S. Senate,T. Shannon,REP,730203,2,7,85,94,
Wagoner,U.S. Senate,Randy Brogdon,REP,730203,0,1,12,13,
Wagoner,U.S. Senate,Eric Mccray,REP,730203,0,0,1,1,
Wagoner,U.S. Senate,Kevin Crow,REP,730203,0,1,0,1,
Wagoner,U.S. Senate,James Lankford,REP,730203,2,8,91,101,
Wagoner,U.S. Senate,Jason Weger,REP,730203,0,0,1,1,
Wagoner,Superintendent of Public Instruction,John Cox,DEM,730204,1,1,36,38,
Wagoner,Superintendent of Public Instruction,Jack Jr.,DEM,730204,0,0,4,4,
Wagoner,Superintendent of Public Instruction,Ivan Holmes,DEM,730204,0,0,5,5,
Wagoner,Superintendent of Public Instruction,Freda Deskin,DEM,730204,0,0,32,32,
Wagoner,U.S. Senate,Patrick Michael Hayes,DEM,730204,0,0,13,13,
Wagoner,U.S. Senate,Jim Rogers,DEM,730204,1,1,38,40,
Wagoner,U.S. Senate,Connie Johnson,DEM,730204,0,0,24,24,
Wagoner,Governor,Dax Ewbank,REP,730204,0,0,2,2,
Wagoner,Governor,Chad Moody,REP,730204,1,1,11,13,
Wagoner,Governor,Mary Fallin,REP,730204,1,3,83,87,
Wagoner,Superintendent of Public Instruction,Brian Kelly,REP,730204,1,1,22,24,
Wagoner,Superintendent of Public Instruction,Janet Costello Barresi,REP,730204,0,0,17,17,
Wagoner,Superintendent of Public Instruction,Joy Hofmeister,REP,730204,1,3,57,61,
Wagoner,Insurance Commissioner,Bill Viner,REP,730204,2,0,19,21,
Wagoner,Insurance Commissioner,John Doak,REP,730204,0,3,75,78,
Wagoner,Corporation Commissioner,Todd Hiett,REP,730204,1,1,46,48,
Wagoner,Corporation Commissioner,Cliff Branan,REP,730204,1,2,44,47,
Wagoner,U.S. Senate,Evelyn Rogers,REP,730204,1,0,5,6,
Wagoner,U.S. Senate,Rob Moye,REP,730204,0,0,0,0,
Wagoner,U.S. Senate,D. Jean Mcbride-Samuels,REP,730204,0,0,3,3,
Wagoner,U.S. Senate,Jim Inhofe,REP,730204,1,4,88,93,
Wagoner,U.S. Senate,Erick Paul Wyatt,REP,730204,0,0,3,3,
Wagoner,U.S. Senate,Andy Craig,REP,730204,0,0,0,0,
Wagoner,U.S. Senate,T. Shannon,REP,730204,0,2,44,46,
Wagoner,U.S. Senate,Randy Brogdon,REP,730204,0,0,1,1,
Wagoner,U.S. Senate,Eric Mccray,REP,730204,0,0,0,0,
Wagoner,U.S. Senate,Kevin Crow,REP,730204,1,0,1,2,
Wagoner,U.S. Senate,James Lankford,REP,730204,0,2,52,54,
Wagoner,U.S. Senate,Jason Weger,REP,730204,1,0,1,2,
Wagoner,Superintendent of Public Instruction,John Cox,DEM,730205,1,0,3,4,
Wagoner,Superintendent of Public Instruction,Jack Jr.,DEM,730205,0,0,1,1,
Wagoner,Superintendent of Public Instruction,Ivan Holmes,DEM,730205,0,0,0,0,
Wagoner,Superintendent of Public Instruction,Freda Deskin,DEM,730205,0,0,5,5,
Wagoner,U.S. Senate,Patrick Michael Hayes,DEM,730205,0,0,1,1,
Wagoner,U.S. Senate,Jim Rogers,DEM,730205,0,0,1,1,
Wagoner,U.S. Senate,Connie Johnson,DEM,730205,1,0,7,8,
Wagoner,Governor,Dax Ewbank,REP,730205,0,0,0,0,
Wagoner,Governor,Chad Moody,REP,730205,0,0,5,5,
Wagoner,Governor,Mary Fallin,REP,730205,1,0,26,27,
Wagoner,Superintendent of Public Instruction,Brian Kelly,REP,730205,0,0,3,3,
Wagoner,Superintendent of Public Instruction,Janet Costello Barresi,REP,730205,0,0,8,8,
Wagoner,Superintendent of Public Instruction,Joy Hofmeister,REP,730205,1,0,21,22,
Wagoner,Insurance Commissioner,Bill Viner,REP,730205,0,0,6,6,
Wagoner,Insurance Commissioner,John Doak,REP,730205,1,0,25,26,
Wagoner,Corporation Commissioner,Todd Hiett,REP,730205,1,0,18,19,
Wagoner,Corporation Commissioner,Cliff Branan,REP,730205,0,0,12,12,
Wagoner,U.S. Senate,Evelyn Rogers,REP,730205,0,0,2,2,
Wagoner,U.S. Senate,Rob Moye,REP,730205,0,0,1,1,
Wagoner,U.S. Senate,D. Jean Mcbride-Samuels,REP,730205,0,0,0,0,
Wagoner,U.S. Senate,Jim Inhofe,REP,730205,1,0,28,29,
Wagoner,U.S. Senate,Erick Paul Wyatt,REP,730205,0,0,0,0,
Wagoner,U.S. Senate,Andy Craig,REP,730205,0,0,0,0,
Wagoner,U.S. Senate,T. Shannon,REP,730205,0,0,20,20,
Wagoner,U.S. Senate,Randy Brogdon,REP,730205,0,0,2,2,
Wagoner,U.S. Senate,Eric Mccray,REP,730205,0,0,0,0,
Wagoner,U.S. Senate,Kevin Crow,REP,730205,0,0,0,0,
Wagoner,U.S. Senate,James Lankford,REP,730205,1,0,10,11,
Wagoner,U.S. Senate,Jason Weger,REP,730205,0,0,0,0,
Wagoner,Superintendent of Public Instruction,John Cox,DEM,730206,0,0,5,5,
Wagoner,Superintendent of Public Instruction,Jack Jr.,DEM,730206,0,0,0,0,
Wagoner,Superintendent of Public Instruction,Ivan Holmes,DEM,730206,0,0,1,1,
Wagoner,Superintendent of Public Instruction,Freda Deskin,DEM,730206,0,1,1,2,
Wagoner,U.S. Senate,Patrick Michael Hayes,DEM,730206,0,0,4,4,
Wagoner,U.S. Senate,Jim Rogers,DEM,730206,0,0,2,2,
Wagoner,U.S. Senate,Connie Johnson,DEM,730206,0,1,1,2,
Wagoner,Governor,Dax Ewbank,REP,730206,0,0,2,2,
Wagoner,Governor,Chad Moody,REP,730206,0,0,0,0,
Wagoner,Governor,Mary Fallin,REP,730206,0,1,5,6,
Wagoner,Superintendent of Public Instruction,Brian Kelly,REP,730206,0,0,2,2,
Wagoner,Superintendent of Public Instruction,Janet Costello Barresi,REP,730206,0,0,2,2,
Wagoner,Superintendent of Public Instruction,Joy Hofmeister,REP,730206,0,1,3,4,
Wagoner,Insurance Commissioner,Bill Viner,REP,730206,0,0,3,3,
Wagoner,Insurance Commissioner,John Doak,REP,730206,0,1,4,5,
Wagoner,Corporation Commissioner,Todd Hiett,REP,730206,0,0,5,5,
Wagoner,Corporation Commissioner,Cliff Branan,REP,730206,0,0,2,2,
Wagoner,U.S. Senate,Evelyn Rogers,REP,730206,0,0,0,0,
Wagoner,U.S. Senate,Rob Moye,REP,730206,0,0,0,0,
Wagoner,U.S. Senate,D. Jean Mcbride-Samuels,REP,730206,0,0,0,0,
Wagoner,U.S. Senate,Jim Inhofe,REP,730206,0,1,5,6,
Wagoner,U.S. Senate,Erick Paul Wyatt,REP,730206,0,0,2,2,
Wagoner,U.S. Senate,Andy Craig,REP,730206,0,0,1,1,
Wagoner,U.S. Senate,T. Shannon,REP,730206,0,0,3,3,
Wagoner,U.S. Senate,Randy Brogdon,REP,730206,0,0,1,1,
Wagoner,U.S. Senate,Eric Mccray,REP,730206,0,0,0,0,
Wagoner,U.S. Senate,Kevin Crow,REP,730206,0,0,0,0,
Wagoner,U.S. Senate,James Lankford,REP,730206,0,0,1,1,
Wagoner,U.S. Senate,Jason Weger,REP,730206,0,1,1,2,
Wagoner,Superintendent of Public Instruction,John Cox,DEM,730207,0,1,42,43,
Wagoner,Superintendent of Public Instruction,Jack Jr.,DEM,730207,0,0,6,6,
Wagoner,Superintendent of Public Instruction,Ivan Holmes,DEM,730207,0,0,5,5,
Wagoner,Superintendent of Public Instruction,Freda Deskin,DEM,730207,0,2,18,20,
Wagoner,U.S. Senate,Patrick Michael Hayes,DEM,730207,0,0,18,18,
Wagoner,U.S. Senate,Jim Rogers,DEM,730207,0,0,29,29,
Wagoner,U.S. Senate,Connie Johnson,DEM,730207,0,2,22,24,
Wagoner,Governor,Dax Ewbank,REP,730207,0,0,3,3,
Wagoner,Governor,Chad Moody,REP,730207,0,0,4,4,
Wagoner,Governor,Mary Fallin,REP,730207,0,2,13,15,
Wagoner,Superintendent of Public Instruction,Brian Kelly,REP,730207,0,1,8,9,
Wagoner,Superintendent of Public Instruction,Janet Costello Barresi,REP,730207,0,0,3,3,
Wagoner,Superintendent of Public Instruction,Joy Hofmeister,REP,730207,0,1,10,11,
Wagoner,Insurance Commissioner,Bill Viner,REP,730207,0,0,4,4,
Wagoner,Insurance Commissioner,John Doak,REP,730207,0,2,16,18,
Wagoner,Corporation Commissioner,Todd Hiett,REP,730207,0,2,12,14,
Wagoner,Corporation Commissioner,Cliff Branan,REP,730207,0,0,8,8,
Wagoner,U.S. Senate,Evelyn Rogers,REP,730207,0,0,0,0,
Wagoner,U.S. Senate,Rob Moye,REP,730207,0,0,0,0,
Wagoner,U.S. Senate,D. Jean Mcbride-Samuels,REP,730207,0,0,0,0,
Wagoner,U.S. Senate,Jim Inhofe,REP,730207,0,2,19,21,
Wagoner,U.S. Senate,Erick Paul Wyatt,REP,730207,0,0,1,1,
Wagoner,U.S. Senate,Andy Craig,REP,730207,0,0,0,0,
Wagoner,U.S. Senate,T. Shannon,REP,730207,0,2,12,14,
Wagoner,U.S. Senate,Randy Brogdon,REP,730207,0,0,1,1,
Wagoner,U.S. Senate,Eric Mccray,REP,730207,0,0,0,0,
Wagoner,U.S. Senate,Kevin Crow,REP,730207,0,0,0,0,
Wagoner,U.S. Senate,James Lankford,REP,730207,0,0,6,6,
Wagoner,U.S. Senate,Jason Weger,REP,730207,0,0,1,1,
Wagoner,Superintendent of Public Instruction,John Cox,DEM,730208,0,16,172,188,
Wagoner,Superintendent of Public Instruction,Jack Jr.,DEM,730208,0,0,18,18,
Wagoner,Superintendent of Public Instruction,Ivan Holmes,DEM,730208,0,0,16,16,
Wagoner,Superintendent of Public Instruction,Freda Deskin,DEM,730208,0,8,88,96,
Wagoner,U.S. Senate,Patrick Michael Hayes,DEM,730208,0,5,78,83,
Wagoner,U.S. Senate,Jim Rogers,DEM,730208,0,12,112,124,
Wagoner,U.S. Senate,Connie Johnson,DEM,730208,0,7,92,99,
Wagoner,Governor,Dax Ewbank,REP,730208,0,2,13,15,
Wagoner,Governor,Chad Moody,REP,730208,0,8,39,47,
Wagoner,Governor,Mary Fallin,REP,730208,7,14,145,166,
Wagoner,Superintendent of Public Instruction,Brian Kelly,REP,730208,0,7,41,48,
Wagoner,Superintendent of Public Instruction,Janet Costello Barresi,REP,730208,3,2,37,42,
Wagoner,Superintendent of Public Instruction,Joy Hofmeister,REP,730208,4,15,121,140,
Wagoner,Insurance Commissioner,Bill Viner,REP,730208,1,6,56,63,
Wagoner,Insurance Commissioner,John Doak,REP,730208,5,14,135,154,
Wagoner,Corporation Commissioner,Todd Hiett,REP,730208,2,11,95,108,
Wagoner,Corporation Commissioner,Cliff Branan,REP,730208,1,6,93,100,
Wagoner,U.S. Senate,Evelyn Rogers,REP,730208,0,2,8,10,
Wagoner,U.S. Senate,Rob Moye,REP,730208,0,0,6,6,
Wagoner,U.S. Senate,D. Jean Mcbride-Samuels,REP,730208,0,0,10,10,
Wagoner,U.S. Senate,Jim Inhofe,REP,730208,7,21,160,188,
Wagoner,U.S. Senate,Erick Paul Wyatt,REP,730208,0,1,11,12,
Wagoner,U.S. Senate,Andy Craig,REP,730208,0,1,3,4,
Wagoner,U.S. Senate,T. Shannon,REP,730208,5,9,104,118,
Wagoner,U.S. Senate,Randy Brogdon,REP,730208,0,0,11,11,
Wagoner,U.S. Senate,Eric Mccray,REP,730208,0,0,2,2,
Wagoner,U.S. Senate,Kevin Crow,REP,730208,0,0,4,4,
Wagoner,U.S. Senate,James Lankford,REP,730208,2,14,72,88,
Wagoner,U.S. Senate,Jason Weger,REP,730208,0,0,1,1,
Wagoner,Superintendent of Public Instruction,John Cox,DEM,730209,0,0,24,24,
Wagoner,Superintendent of Public Instruction,Jack Jr.,DEM,730209,0,0,2,2,
Wagoner,Superintendent of Public Instruction,Ivan Holmes,DEM,730209,0,0,0,0,
Wagoner,Superintendent of Public Instruction,Freda Deskin,DEM,730209,0,1,11,12,
Wagoner,U.S. Senate,Patrick Michael Hayes,DEM,730209,0,0,11,11,
Wagoner,U.S. Senate,Jim Rogers,DEM,730209,0,0,13,13,
Wagoner,U.S. Senate,Connie Johnson,DEM,730209,0,0,13,13,
Wagoner,Governor,Dax Ewbank,REP,730209,0,1,4,5,
Wagoner,Governor,Chad Moody,REP,730209,1,2,4,7,
Wagoner,Governor,Mary Fallin,REP,730209,3,0,54,57,
Wagoner,Superintendent of Public Instruction,Brian Kelly,REP,730209,0,0,13,13,
Wagoner,Superintendent of Public Instruction,Janet Costello Barresi,REP,730209,0,0,6,6,
Wagoner,Superintendent of Public Instruction,Joy Hofmeister,REP,730209,4,3,40,47,
Wagoner,Insurance Commissioner,Bill Viner,REP,730209,4,0,12,16,
Wagoner,Insurance Commissioner,John Doak,REP,730209,0,3,49,52,
Wagoner,Corporation Commissioner,Todd Hiett,REP,730209,3,0,37,40,
Wagoner,Corporation Commissioner,Cliff Branan,REP,730209,1,2,23,26,
Wagoner,U.S. Senate,Evelyn Rogers,REP,730209,0,0,2,2,
Wagoner,U.S. Senate,Rob Moye,REP,730209,0,1,0,1,
Wagoner,U.S. Senate,D. Jean Mcbride-Samuels,REP,730209,0,0,2,2,
Wagoner,U.S. Senate,Jim Inhofe,REP,730209,4,2,49,55,
Wagoner,U.S. Senate,Erick Paul Wyatt,REP,730209,0,0,9,9,
Wagoner,U.S. Senate,Andy Craig,REP,730209,0,0,1,1,
Wagoner,U.S. Senate,T. Shannon,REP,730209,4,0,40,44,
Wagoner,U.S. Senate,Randy Brogdon,REP,730209,0,0,0,0,
Wagoner,U.S. Senate,Eric Mccray,REP,730209,0,0,0,0,
Wagoner,U.S. Senate,Kevin Crow,REP,730209,0,0,0,0,
Wagoner,U.S. Senate,James Lankford,REP,730209,0,3,21,24,
Wagoner,U.S. Senate,Jason Weger,REP,730209,0,0,0,0,
Wagoner,Superintendent of Public Instruction,John Cox,DEM,730210,0,2,90,92,
Wagoner,Superintendent of Public Instruction,Jack Jr.,DEM,730210,0,0,19,19,
Wagoner,Superintendent of Public Instruction,Ivan Holmes,DEM,730210,0,0,19,19,
Wagoner,Superintendent of Public Instruction,Freda Deskin,DEM,730210,0,1,58,59,
Wagoner,U.S. Senate,Patrick Michael Hayes,DEM,730210,0,2,48,50,
Wagoner,U.S. Senate,Jim Rogers,DEM,730210,0,0,79,79,
Wagoner,U.S. Senate,Connie Johnson,DEM,730210,0,0,59,59,
Wagoner,Governor,Dax Ewbank,REP,730210,0,0,8,8,
Wagoner,Governor,Chad Moody,REP,730210,0,1,17,18,
Wagoner,Governor,Mary Fallin,REP,730210,4,7,109,120,
Wagoner,Superintendent of Public Instruction,Brian Kelly,REP,730210,0,2,40,42,
Wagoner,Superintendent of Public Instruction,Janet Costello Barresi,REP,730210,0,1,16,17,
Wagoner,Superintendent of Public Instruction,Joy Hofmeister,REP,730210,4,5,79,88,
Wagoner,Insurance Commissioner,Bill Viner,REP,730210,0,2,25,27,
Wagoner,Insurance Commissioner,John Doak,REP,730210,4,6,100,110,
Wagoner,Corporation Commissioner,Todd Hiett,REP,730210,0,7,67,74,
Wagoner,Corporation Commissioner,Cliff Branan,REP,730210,4,1,57,62,
Wagoner,U.S. Senate,Evelyn Rogers,REP,730210,0,0,9,9,
Wagoner,U.S. Senate,Rob Moye,REP,730210,0,0,0,0,
Wagoner,U.S. Senate,D. Jean Mcbride-Samuels,REP,730210,0,0,1,1,
Wagoner,U.S. Senate,Jim Inhofe,REP,730210,4,8,119,131,
Wagoner,U.S. Senate,Erick Paul Wyatt,REP,730210,0,0,7,7,
Wagoner,U.S. Senate,Andy Craig,REP,730210,0,0,0,0,
Wagoner,U.S. Senate,T. Shannon,REP,730210,4,3,57,64,
Wagoner,U.S. Senate,Randy Brogdon,REP,730210,0,2,6,8,
Wagoner,U.S. Senate,Eric Mccray,REP,730210,0,1,0,1,
Wagoner,U.S. Senate,Kevin Crow,REP,730210,0,0,1,1,
Wagoner,U.S. Senate,James Lankford,REP,730210,0,2,68,70,
Wagoner,U.S. Senate,Jason Weger,REP,730210,0,0,2,2,
Wagoner,Superintendent of Public Instruction,John Cox,DEM,730301,0,1,13,14,
Wagoner,Superintendent of Public Instruction,Jack Jr.,DEM,730301,0,0,1,1,
Wagoner,Superintendent of Public Instruction,Ivan Holmes,DEM,730301,1,0,1,2,
Wagoner,Superintendent of Public Instruction,Freda Deskin,DEM,730301,0,0,12,12,
Wagoner,U.S. Senate,Patrick Michael Hayes,DEM,730301,1,0,9,10,
Wagoner,U.S. Senate,Jim Rogers,DEM,730301,0,1,6,7,
Wagoner,U.S. Senate,Connie Johnson,DEM,730301,0,0,12,12,
Wagoner,Governor,Dax Ewbank,REP,730301,0,0,22,22,
Wagoner,Governor,Chad Moody,REP,730301,2,0,44,46,
Wagoner,Governor,Mary Fallin,REP,730301,9,5,213,227,
Wagoner,Superintendent of Public Instruction,Brian Kelly,REP,730301,3,1,33,37,
Wagoner,Superintendent of Public Instruction,Janet Costello Barresi,REP,730301,4,1,50,55,
Wagoner,Superintendent of Public Instruction,Joy Hofmeister,REP,730301,4,1,197,202,
Wagoner,Insurance Commissioner,Bill Viner,REP,730301,3,0,52,55,
Wagoner,Insurance Commissioner,John Doak,REP,730301,8,2,205,215,
Wagoner,Corporation Commissioner,Todd Hiett,REP,730301,8,0,147,155,
Wagoner,Corporation Commissioner,Cliff Branan,REP,730301,3,2,111,116,
Wagoner,U.S. Senate,Evelyn Rogers,REP,730301,0,0,12,12,
Wagoner,U.S. Senate,Rob Moye,REP,730301,1,1,9,11,
Wagoner,U.S. Senate,D. Jean Mcbride-Samuels,REP,730301,0,0,2,2,
Wagoner,U.S. Senate,Jim Inhofe,REP,730301,9,3,246,258,
Wagoner,U.S. Senate,Erick Paul Wyatt,REP,730301,1,0,13,14,
Wagoner,U.S. Senate,Andy Craig,REP,730301,0,0,0,0,
Wagoner,U.S. Senate,T. Shannon,REP,730301,3,2,117,122,
Wagoner,U.S. Senate,Randy Brogdon,REP,730301,0,0,16,16,
Wagoner,U.S. Senate,Eric Mccray,REP,730301,1,0,1,2,
Wagoner,U.S. Senate,Kevin Crow,REP,730301,0,0,3,3,
Wagoner,U.S. Senate,James Lankford,REP,730301,6,3,145,154,
Wagoner,U.S. Senate,Jason Weger,REP,730301,0,0,0,0,
Wagoner,State House,Michael Rogers,REP,730301,9,3,176,188,98
Wagoner,State House,Terri Cleveland,REP,730301,2,0,84,86,98
Wagoner,Superintendent of Public Instruction,John Cox,DEM,730302,0,0,27,27,
Wagoner,Superintendent of Public Instruction,Jack Jr.,DEM,730302,0,0,10,10,
Wagoner,Superintendent of Public Instruction,Ivan Holmes,DEM,730302,0,0,5,5,
Wagoner,Superintendent of Public Instruction,Freda Deskin,DEM,730302,1,0,42,43,
Wagoner,U.S. Senate,Patrick Michael Hayes,DEM,730302,0,0,11,11,
Wagoner,U.S. Senate,Jim Rogers,DEM,730302,1,0,47,48,
Wagoner,U.S. Senate,Connie Johnson,DEM,730302,0,0,25,25,
Wagoner,Governor,Dax Ewbank,REP,730302,0,0,25,25,
Wagoner,Governor,Chad Moody,REP,730302,1,0,59,60,
Wagoner,Governor,Mary Fallin,REP,730302,9,4,406,419,
Wagoner,Superintendent of Public Instruction,Brian Kelly,REP,730302,1,0,60,61,
Wagoner,Superintendent of Public Instruction,Janet Costello Barresi,REP,730302,1,1,86,88,
Wagoner,Superintendent of Public Instruction,Joy Hofmeister,REP,730302,7,3,342,352,
Wagoner,Insurance Commissioner,Bill Viner,REP,730302,0,0,95,95,
Wagoner,Insurance Commissioner,John Doak,REP,730302,10,4,356,370,
Wagoner,Corporation Commissioner,Todd Hiett,REP,730302,10,1,286,297,
Wagoner,Corporation Commissioner,Cliff Branan,REP,730302,0,3,174,177,
Wagoner,U.S. Senate,Evelyn Rogers,REP,730302,0,0,21,21,
Wagoner,U.S. Senate,Rob Moye,REP,730302,0,0,4,4,
Wagoner,U.S. Senate,D. Jean Mcbride-Samuels,REP,730302,0,0,6,6,
Wagoner,U.S. Senate,Jim Inhofe,REP,730302,8,4,441,453,
Wagoner,U.S. Senate,Erick Paul Wyatt,REP,730302,2,0,19,21,
Wagoner,U.S. Senate,Andy Craig,REP,730302,0,0,6,6,
Wagoner,U.S. Senate,T. Shannon,REP,730302,5,2,183,190,
Wagoner,U.S. Senate,Randy Brogdon,REP,730302,1,0,40,41,
Wagoner,U.S. Senate,Eric Mccray,REP,730302,0,0,6,6,
Wagoner,U.S. Senate,Kevin Crow,REP,730302,0,0,5,5,
Wagoner,U.S. Senate,James Lankford,REP,730302,4,2,251,257,
Wagoner,U.S. Senate,Jason Weger,REP,730302,0,0,2,2,
Wagoner,State House,Michael Rogers,REP,730302,9,3,307,319,98
Wagoner,State House,Terri Cleveland,REP,730302,1,1,151,153,98
Wagoner,Superintendent of Public Instruction,John Cox,DEM,730303,0,0,9,9,
Wagoner,Superintendent of Public Instruction,Jack Jr.,DEM,730303,0,1,1,2,
Wagoner,Superintendent of Public Instruction,Ivan Holmes,DEM,730303,0,0,2,2,
Wagoner,Superintendent of Public Instruction,Freda Deskin,DEM,730303,0,1,12,13,
Wagoner,U.S. Senate,Patrick Michael Hayes,DEM,730303,0,0,4,4,
Wagoner,U.S. Senate,Jim Rogers,DEM,730303,0,1,7,8,
Wagoner,U.S. Senate,Connie Johnson,DEM,730303,0,1,12,13,
Wagoner,Governor,Dax Ewbank,REP,730303,1,0,6,7,
Wagoner,Governor,Chad Moody,REP,730303,0,1,12,13,
Wagoner,Governor,Mary Fallin,REP,730303,0,1,105,106,
Wagoner,Superintendent of Public Instruction,Brian Kelly,REP,730303,0,2,20,22,
Wagoner,Superintendent of Public Instruction,Janet Costello Barresi,REP,730303,0,0,22,22,
Wagoner,Superintendent of Public Instruction,Joy Hofmeister,REP,730303,1,0,85,86,
Wagoner,Insurance Commissioner,Bill Viner,REP,730303,0,1,28,29,
Wagoner,Insurance Commissioner,John Doak,REP,730303,1,1,84,86,
Wagoner,Corporation Commissioner,Todd Hiett,REP,730303,1,2,75,78,
Wagoner,Corporation Commissioner,Cliff Branan,REP,730303,0,0,40,40,
Wagoner,U.S. Senate,Evelyn Rogers,REP,730303,0,0,6,6,
Wagoner,U.S. Senate,Rob Moye,REP,730303,0,0,1,1,
Wagoner,U.S. Senate,D. Jean Mcbride-Samuels,REP,730303,0,0,4,4,
Wagoner,U.S. Senate,Jim Inhofe,REP,730303,1,2,109,112,
Wagoner,U.S. Senate,Erick Paul Wyatt,REP,730303,0,0,6,6,
Wagoner,U.S. Senate,Andy Craig,REP,730303,0,0,3,3,
Wagoner,U.S. Senate,T. Shannon,REP,730303,1,1,63,65,
Wagoner,U.S. Senate,Randy Brogdon,REP,730303,0,1,11,12,
Wagoner,U.S. Senate,Eric Mccray,REP,730303,0,0,1,1,
Wagoner,U.S. Senate,Kevin Crow,REP,730303,0,0,0,0,
Wagoner,U.S. Senate,James Lankford,REP,730303,0,0,51,51,
Wagoner,U.S. Senate,Jason Weger,REP,730303,0,0,0,0,
Wagoner,Superintendent of Public Instruction,John Cox,DEM,730304,0,0,19,19,
Wagoner,Superintendent of Public Instruction,Jack Jr.,DEM,730304,2,0,6,8,
Wagoner,Superintendent of Public Instruction,Ivan Holmes,DEM,730304,0,0,1,1,
Wagoner,Superintendent of Public Instruction,Freda Deskin,DEM,730304,0,0,30,30,
Wagoner,U.S. Senate,Patrick Michael Hayes,DEM,730304,2,0,15,17,
Wagoner,U.S. Senate,Jim Rogers,DEM,730304,0,0,17,17,
Wagoner,U.S. Senate,Connie Johnson,DEM,730304,0,0,24,24,
Wagoner,Governor,Dax Ewbank,REP,730304,0,2,18,20,
Wagoner,Governor,Chad Moody,REP,730304,0,0,28,28,
Wagoner,Governor,Mary Fallin,REP,730304,0,0,166,166,
Wagoner,Superintendent of Public Instruction,Brian Kelly,REP,730304,0,0,34,34,
Wagoner,Superintendent of Public Instruction,Janet Costello Barresi,REP,730304,0,0,45,45,
Wagoner,Superintendent of Public Instruction,Joy Hofmeister,REP,730304,0,2,130,132,
Wagoner,Insurance Commissioner,Bill Viner,REP,730304,0,0,49,49,
Wagoner,Insurance Commissioner,John Doak,REP,730304,0,2,147,149,
Wagoner,Corporation Commissioner,Todd Hiett,REP,730304,0,2,122,124,
Wagoner,Corporation Commissioner,Cliff Branan,REP,730304,0,0,78,78,
Wagoner,U.S. Senate,Evelyn Rogers,REP,730304,0,0,8,8,
Wagoner,U.S. Senate,Rob Moye,REP,730304,0,0,3,3,
Wagoner,U.S. Senate,D. Jean Mcbride-Samuels,REP,730304,0,0,3,3,
Wagoner,U.S. Senate,Jim Inhofe,REP,730304,0,1,197,198,
Wagoner,U.S. Senate,Erick Paul Wyatt,REP,730304,0,0,3,3,
Wagoner,U.S. Senate,Andy Craig,REP,730304,0,0,1,1,
Wagoner,U.S. Senate,T. Shannon,REP,730304,0,0,92,92,
Wagoner,U.S. Senate,Randy Brogdon,REP,730304,0,0,14,14,
Wagoner,U.S. Senate,Eric Mccray,REP,730304,0,0,2,2,
Wagoner,U.S. Senate,Kevin Crow,REP,730304,0,0,3,3,
Wagoner,U.S. Senate,James Lankford,REP,730304,0,2,97,99,
Wagoner,U.S. Senate,Jason Weger,REP,730304,0,0,4,4,
Wagoner,State House,Michael Rogers,REP,730304,0,2,115,117,98
Wagoner,State House,Terri Cleveland,REP,730304,0,0,82,82,98
Wagoner,Superintendent of Public Instruction,John Cox,DEM,730305,0,0,1,1,
Wagoner,Superintendent of Public Instruction,Jack Jr.,DEM,730305,0,0,0,0,
Wagoner,Superintendent of Public Instruction,Ivan Holmes,DEM,730305,0,0,0,0,
Wagoner,Superintendent of Public Instruction,Freda Deskin,DEM,730305,0,0,3,3,
Wagoner,U.S. Senate,Patrick Michael Hayes,DEM,730305,0,0,1,1,
Wagoner,U.S. Senate,Jim Rogers,DEM,730305,0,0,0,0,
Wagoner,U.S. Senate,Connie Johnson,DEM,730305,0,0,3,3,
Wagoner,Governor,Dax Ewbank,REP,730305,0,0,2,2,
Wagoner,Governor,Chad Moody,REP,730305,0,0,5,5,
Wagoner,Governor,Mary Fallin,REP,730305,0,1,13,14,
Wagoner,Superintendent of Public Instruction,Brian Kelly,REP,730305,0,0,3,3,
Wagoner,Superintendent of Public Instruction,Janet Costello Barresi,REP,730305,0,0,3,3,
Wagoner,Superintendent of Public Instruction,Joy Hofmeister,REP,730305,0,1,14,15,
Wagoner,Insurance Commissioner,Bill Viner,REP,730305,0,1,2,3,
Wagoner,Insurance Commissioner,John Doak,REP,730305,0,0,17,17,
Wagoner,Corporation Commissioner,Todd Hiett,REP,730305,0,1,13,14,
Wagoner,Corporation Commissioner,Cliff Branan,REP,730305,0,0,4,4,
Wagoner,U.S. Senate,Evelyn Rogers,REP,730305,0,0,1,1,
Wagoner,U.S. Senate,Rob Moye,REP,730305,0,0,0,0,
Wagoner,U.S. Senate,D. Jean Mcbride-Samuels,REP,730305,0,0,1,1,
Wagoner,U.S. Senate,Jim Inhofe,REP,730305,0,1,17,18,
Wagoner,U.S. Senate,Erick Paul Wyatt,REP,730305,0,0,0,0,
Wagoner,U.S. Senate,Andy Craig,REP,730305,0,0,0,0,
Wagoner,U.S. Senate,T. Shannon,REP,730305,0,1,8,9,
Wagoner,U.S. Senate,Randy Brogdon,REP,730305,0,0,5,5,
Wagoner,U.S. Senate,Eric Mccray,REP,730305,0,0,0,0,
Wagoner,U.S. Senate,Kevin Crow,REP,730305,0,0,0,0,
Wagoner,U.S. Senate,James Lankford,REP,730305,0,0,7,7,
Wagoner,U.S. Senate,Jason Weger,REP,730305,0,0,0,0,
Wagoner,Superintendent of Public Instruction,John Cox,DEM,730306,0,0,31,31,
Wagoner,Superintendent of Public Instruction,Jack Jr.,DEM,730306,0,0,7,7,
Wagoner,Superintendent of Public Instruction,Ivan Holmes,DEM,730306,0,0,7,7,
Wagoner,Superintendent of Public Instruction,Freda Deskin,DEM,730306,1,0,34,35,
Wagoner,U.S. Senate,Patrick Michael Hayes,DEM,730306,0,0,8,8,
Wagoner,U.S. Senate,Jim Rogers,DEM,730306,0,0,30,30,
Wagoner,U.S. Senate,Connie Johnson,DEM,730306,1,0,40,41,
Wagoner,Governor,Dax Ewbank,REP,730306,0,0,23,23,
Wagoner,Governor,Chad Moody,REP,730306,0,1,43,44,
Wagoner,Governor,Mary Fallin,REP,730306,5,3,258,266,
Wagoner,Superintendent of Public Instruction,Brian Kelly,REP,730306,0,2,50,52,
Wagoner,Superintendent of Public Instruction,Janet Costello Barresi,REP,730306,1,0,61,62,
Wagoner,Superintendent of Public Instruction,Joy Hofmeister,REP,730306,4,2,213,219,
Wagoner,Insurance Commissioner,Bill Viner,REP,730306,2,1,75,78,
Wagoner,Insurance Commissioner,John Doak,REP,730306,3,3,225,231,
Wagoner,Corporation Commissioner,Todd Hiett,REP,730306,4,2,185,191,
Wagoner,Corporation Commissioner,Cliff Branan,REP,730306,1,2,125,128,
Wagoner,U.S. Senate,Evelyn Rogers,REP,730306,0,0,11,11,
Wagoner,U.S. Senate,Rob Moye,REP,730306,0,0,10,10,
Wagoner,U.S. Senate,D. Jean Mcbride-Samuels,REP,730306,0,0,7,7,
Wagoner,U.S. Senate,Jim Inhofe,REP,730306,5,4,284,293,
Wagoner,U.S. Senate,Erick Paul Wyatt,REP,730306,0,0,14,14,
Wagoner,U.S. Senate,Andy Craig,REP,730306,0,0,2,2,
Wagoner,U.S. Senate,T. Shannon,REP,730306,3,2,138,143,
Wagoner,U.S. Senate,Randy Brogdon,REP,730306,0,1,44,45,
Wagoner,U.S. Senate,Eric Mccray,REP,730306,0,0,3,3,
Wagoner,U.S. Senate,Kevin Crow,REP,730306,0,0,1,1,
Wagoner,U.S. Senate,James Lankford,REP,730306,2,1,141,144,
Wagoner,U.S. Senate,Jason Weger,REP,730306,0,0,2,2,
Wagoner,Superintendent of Public Instruction,John Cox,DEM,730307,0,0,13,13,
Wagoner,Superintendent of Public Instruction,Jack Jr.,DEM,730307,0,0,8,8,
Wagoner,Superintendent of Public Instruction,Ivan Holmes,DEM,730307,0,0,5,5,
Wagoner,Superintendent of Public Instruction,Freda Deskin,DEM,730307,0,1,30,31,
Wagoner,U.S. Senate,Patrick Michael Hayes,DEM,730307,0,0,19,19,
Wagoner,U.S. Senate,Jim Rogers,DEM,730307,0,0,20,20,
Wagoner,U.S. Senate,Connie Johnson,DEM,730307,0,1,16,17,
Wagoner,Governor,Dax Ewbank,REP,730307,0,0,9,9,
Wagoner,Governor,Chad Moody,REP,730307,1,0,40,41,
Wagoner,Governor,Mary Fallin,REP,730307,5,4,192,201,
Wagoner,Superintendent of Public Instruction,Brian Kelly,REP,730307,1,2,50,53,
Wagoner,Superintendent of Public Instruction,Janet Costello Barresi,REP,730307,4,0,54,58,
Wagoner,Superintendent of Public Instruction,Joy Hofmeister,REP,730307,1,2,134,137,
Wagoner,Insurance Commissioner,Bill Viner,REP,730307,1,1,46,48,
Wagoner,Insurance Commissioner,John Doak,REP,730307,5,3,182,190,
Wagoner,Corporation Commissioner,Todd Hiett,REP,730307,5,2,138,145,
Wagoner,Corporation Commissioner,Cliff Branan,REP,730307,0,1,86,87,
Wagoner,U.S. Senate,Evelyn Rogers,REP,730307,0,1,5,6,
Wagoner,U.S. Senate,Rob Moye,REP,730307,0,0,6,6,
Wagoner,U.S. Senate,D. Jean Mcbride-Samuels,REP,730307,0,0,5,5,
Wagoner,U.S. Senate,Jim Inhofe,REP,730307,6,3,218,227,
Wagoner,U.S. Senate,Erick Paul Wyatt,REP,730307,0,0,9,9,
Wagoner,U.S. Senate,Andy Craig,REP,730307,0,0,1,1,
Wagoner,U.S. Senate,T. Shannon,REP,730307,5,4,123,132,
Wagoner,U.S. Senate,Randy Brogdon,REP,730307,0,0,24,24,
Wagoner,U.S. Senate,Eric Mccray,REP,730307,0,0,1,1,
Wagoner,U.S. Senate,Kevin Crow,REP,730307,0,0,3,3,
Wagoner,U.S. Senate,James Lankford,REP,730307,1,0,91,92,
Wagoner,U.S. Senate,Jason Weger,REP,730307,0,0,1,1,
Wagoner,Superintendent of Public Instruction,John Cox,DEM,730308,3,0,19,22,
Wagoner,Superintendent of Public Instruction,Jack Jr.,DEM,730308,0,0,5,5,
Wagoner,Superintendent of Public Instruction,Ivan Holmes,DEM,730308,0,0,3,3,
Wagoner,Superintendent of Public Instruction,Freda Deskin,DEM,730308,0,0,17,17,
Wagoner,U.S. Senate,Patrick Michael Hayes,DEM,730308,0,0,6,6,
Wagoner,U.S. Senate,Jim Rogers,DEM,730308,1,0,18,19,
Wagoner,U.S. Senate,Connie Johnson,DEM,730308,0,0,18,18,
Wagoner,Governor,Dax Ewbank,REP,730308,0,0,14,14,
Wagoner,Governor,Chad Moody,REP,730308,0,1,33,34,
Wagoner,Governor,Mary Fallin,REP,730308,4,6,102,112,
Wagoner,Superintendent of Public Instruction,Brian Kelly,REP,730308,1,2,31,34,
Wagoner,Superintendent of Public Instruction,Janet Costello Barresi,REP,730308,1,1,21,23,
Wagoner,Superintendent of Public Instruction,Joy Hofmeister,REP,730308,2,4,99,105,
Wagoner,Insurance Commissioner,Bill Viner,REP,730308,0,3,31,34,
Wagoner,Insurance Commissioner,John Doak,REP,730308,4,4,112,120,
Wagoner,Corporation Commissioner,Todd Hiett,REP,730308,2,4,80,86,
Wagoner,Corporation Commissioner,Cliff Branan,REP,730308,1,3,61,65,
Wagoner,U.S. Senate,Evelyn Rogers,REP,730308,0,0,5,5,
Wagoner,U.S. Senate,Rob Moye,REP,730308,0,0,3,3,
Wagoner,U.S. Senate,D. Jean Mcbride-Samuels,REP,730308,0,0,1,1,
Wagoner,U.S. Senate,Jim Inhofe,REP,730308,4,7,138,149,
Wagoner,U.S. Senate,Erick Paul Wyatt,REP,730308,0,0,4,4,
Wagoner,U.S. Senate,Andy Craig,REP,730308,0,0,1,1,
Wagoner,U.S. Senate,T. Shannon,REP,730308,3,3,56,62,
Wagoner,U.S. Senate,Randy Brogdon,REP,730308,0,0,23,23,
Wagoner,U.S. Senate,Eric Mccray,REP,730308,0,0,0,0,
Wagoner,U.S. Senate,Kevin Crow,REP,730308,0,0,2,2,
Wagoner,U.S. Senate,James Lankford,REP,730308,1,4,69,74,
Wagoner,U.S. Senate,Jason Weger,REP,730308,0,0,0,0,
Wagoner,Superintendent of Public Instruction,John Cox,DEM,730309,4,0,39,43,
Wagoner,Superintendent of Public Instruction,Jack Jr.,DEM,730309,1,0,9,10,
Wagoner,Superintendent of Public Instruction,Ivan Holmes,DEM,730309,0,0,7,7,
Wagoner,Superintendent of Public Instruction,Freda Deskin,DEM,730309,3,1,26,30,
Wagoner,U.S. Senate,Patrick Michael Hayes,DEM,730309,1,0,20,21,
Wagoner,U.S. Senate,Jim Rogers,DEM,730309,3,1,27,31,
Wagoner,U.S. Senate,Connie Johnson,DEM,730309,3,0,32,35,
Wagoner,Governor,Dax Ewbank,REP,730309,0,0,15,15,
Wagoner,Governor,Chad Moody,REP,730309,0,0,30,30,
Wagoner,Governor,Mary Fallin,REP,730309,3,0,121,124,
Wagoner,Superintendent of Public Instruction,Brian Kelly,REP,730309,2,0,45,47,
Wagoner,Superintendent of Public Instruction,Janet Costello Barresi,REP,730309,0,0,20,20,
Wagoner,Superintendent of Public Instruction,Joy Hofmeister,REP,730309,1,0,100,101,
Wagoner,Insurance Commissioner,Bill Viner,REP,730309,2,0,42,44,
Wagoner,Insurance Commissioner,John Doak,REP,730309,0,0,114,114,
Wagoner,Corporation Commissioner,Todd Hiett,REP,730309,2,0,82,84,
Wagoner,Corporation Commissioner,Cliff Branan,REP,730309,1,0,74,75,
Wagoner,U.S. Senate,Evelyn Rogers,REP,730309,0,0,5,5,
Wagoner,U.S. Senate,Rob Moye,REP,730309,0,0,6,6,
Wagoner,U.S. Senate,D. Jean Mcbride-Samuels,REP,730309,0,0,6,6,
Wagoner,U.S. Senate,Jim Inhofe,REP,730309,3,0,142,145,
Wagoner,U.S. Senate,Erick Paul Wyatt,REP,730309,0,0,7,7,
Wagoner,U.S. Senate,Andy Craig,REP,730309,0,0,1,1,
Wagoner,U.S. Senate,T. Shannon,REP,730309,1,0,86,87,
Wagoner,U.S. Senate,Randy Brogdon,REP,730309,0,0,8,8,
Wagoner,U.S. Senate,Eric Mccray,REP,730309,0,0,3,3,
Wagoner,U.S. Senate,Kevin Crow,REP,730309,0,0,1,1,
Wagoner,U.S. Senate,James Lankford,REP,730309,2,0,66,68,
Wagoner,U.S. Senate,Jason Weger,REP,730309,0,0,0,0,
Wagoner,Superintendent of Public Instruction,John Cox,DEM,730310,0,1,12,13,
Wagoner,Superintendent of Public Instruction,Jack Jr.,DEM,730310,0,0,2,2,
Wagoner,Superintendent of Public Instruction,Ivan Holmes,DEM,730310,0,0,1,1,
Wagoner,Superintendent of Public Instruction,Freda Deskin,DEM,730310,1,0,14,15,
Wagoner,U.S. Senate,Patrick Michael Hayes,DEM,730310,0,0,4,4,
Wagoner,U.S. Senate,Jim Rogers,DEM,730310,0,0,16,16,
Wagoner,U.S. Senate,Connie Johnson,DEM,730310,0,1,9,10,
Wagoner,Governor,Dax Ewbank,REP,730310,0,0,14,14,
Wagoner,Governor,Chad Moody,REP,730310,0,0,9,9,
Wagoner,Governor,Mary Fallin,REP,730310,2,2,65,69,
Wagoner,Superintendent of Public Instruction,Brian Kelly,REP,730310,0,0,16,16,
Wagoner,Superintendent of Public Instruction,Janet Costello Barresi,REP,730310,0,1,19,20,
Wagoner,Superintendent of Public Instruction,Joy Hofmeister,REP,730310,2,1,56,59,
Wagoner,Insurance Commissioner,Bill Viner,REP,730310,0,0,20,20,
Wagoner,Insurance Commissioner,John Doak,REP,730310,2,2,66,70,
Wagoner,Corporation Commissioner,Todd Hiett,REP,730310,0,1,52,53,
Wagoner,Corporation Commissioner,Cliff Branan,REP,730310,2,1,35,38,
Wagoner,U.S. Senate,Evelyn Rogers,REP,730310,0,0,2,2,
Wagoner,U.S. Senate,Rob Moye,REP,730310,0,0,2,2,
Wagoner,U.S. Senate,D. Jean Mcbride-Samuels,REP,730310,0,0,5,5,
Wagoner,U.S. Senate,Jim Inhofe,REP,730310,2,2,81,85,
Wagoner,U.S. Senate,Erick Paul Wyatt,REP,730310,0,0,0,0,
Wagoner,U.S. Senate,Andy Craig,REP,730310,0,0,0,0,
Wagoner,U.S. Senate,T. Shannon,REP,730310,1,2,43,46,
Wagoner,U.S. Senate,Randy Brogdon,REP,730310,1,0,9,10,
Wagoner,U.S. Senate,Eric Mccray,REP,730310,0,0,1,1,
Wagoner,U.S. Senate,Kevin Crow,REP,730310,0,0,2,2,
Wagoner,U.S. Senate,James Lankford,REP,730310,0,0,35,35,
Wagoner,U.S. Senate,Jason Weger,REP,730310,0,0,0,0,
Wagoner,Superintendent of Public Instruction,John Cox,DEM,730311,0,1,13,14,
Wagoner,Superintendent of Public Instruction,Jack Jr.,DEM,730311,0,0,3,3,
Wagoner,Superintendent of Public Instruction,Ivan Holmes,DEM,730311,0,0,6,6,
Wagoner,Superintendent of Public Instruction,Freda Deskin,DEM,730311,0,0,8,8,
Wagoner,U.S. Senate,Patrick Michael Hayes,DEM,730311,0,0,4,4,
Wagoner,U.S. Senate,Jim Rogers,DEM,730311,0,1,16,17,
Wagoner,U.S. Senate,Connie Johnson,DEM,730311,0,0,9,9,
Wagoner,Governor,Dax Ewbank,REP,730311,0,0,3,3,
Wagoner,Governor,Chad Moody,REP,730311,1,0,2,3,
Wagoner,Governor,Mary Fallin,REP,730311,2,1,40,43,
Wagoner,Superintendent of Public Instruction,Brian Kelly,REP,730311,0,0,9,9,
Wagoner,Superintendent of Public Instruction,Janet Costello Barresi,REP,730311,1,0,5,6,
Wagoner,Superintendent of Public Instruction,Joy Hofmeister,REP,730311,1,1,31,33,
Wagoner,Insurance Commissioner,Bill Viner,REP,730311,0,0,8,8,
Wagoner,Insurance Commissioner,John Doak,REP,730311,2,1,30,33,
Wagoner,Corporation Commissioner,Todd Hiett,REP,730311,1,0,27,28,
Wagoner,Corporation Commissioner,Cliff Branan,REP,730311,1,1,14,16,
Wagoner,U.S. Senate,Evelyn Rogers,REP,730311,0,0,1,1,
Wagoner,U.S. Senate,Rob Moye,REP,730311,0,0,1,1,
Wagoner,U.S. Senate,D. Jean Mcbride-Samuels,REP,730311,0,0,1,1,
Wagoner,U.S. Senate,Jim Inhofe,REP,730311,3,1,44,48,
Wagoner,U.S. Senate,Erick Paul Wyatt,REP,730311,0,0,0,0,
Wagoner,U.S. Senate,Andy Craig,REP,730311,0,0,0,0,
Wagoner,U.S. Senate,T. Shannon,REP,730311,2,0,19,21,
Wagoner,U.S. Senate,Randy Brogdon,REP,730311,0,0,4,4,
Wagoner,U.S. Senate,Eric Mccray,REP,730311,0,0,1,1,
Wagoner,U.S. Senate,Kevin Crow,REP,730311,0,0,0,0,
Wagoner,U.S. Senate,James Lankford,REP,730311,1,1,23,25,
Wagoner,U.S. Senate,Jason Weger,REP,730311,0,0,0,0,
Wagoner,Superintendent of Public Instruction,John Cox,DEM,730312,0,0,29,29,
Wagoner,Superintendent of Public Instruction,Jack Jr.,DEM,730312,0,1,7,8,
Wagoner,Superintendent of Public Instruction,Ivan Holmes,DEM,730312,0,0,9,9,
Wagoner,Superintendent of Public Instruction,Freda Deskin,DEM,730312,0,0,27,27,
Wagoner,U.S. Senate,Patrick Michael Hayes,DEM,730312,0,0,15,15,
Wagoner,U.S. Senate,Jim Rogers,DEM,730312,0,1,35,36,
Wagoner,U.S. Senate,Connie Johnson,DEM,730312,0,0,21,21,
Wagoner,Governor,Dax Ewbank,REP,730312,0,0,12,12,
Wagoner,Governor,Chad Moody,REP,730312,0,0,16,16,
Wagoner,Governor,Mary Fallin,REP,730312,1,7,56,64,
Wagoner,Superintendent of Public Instruction,Brian Kelly,REP,730312,0,0,25,25,
Wagoner,Superintendent of Public Instruction,Janet Costello Barresi,REP,730312,0,1,7,8,
Wagoner,Superintendent of Public Instruction,Joy Hofmeister,REP,730312,1,7,53,61,
Wagoner,Insurance Commissioner,Bill Viner,REP,730312,0,0,16,16,
Wagoner,Insurance Commissioner,John Doak,REP,730312,0,8,70,78,
Wagoner,Corporation Commissioner,Todd Hiett,REP,730312,0,5,43,48,
Wagoner,Corporation Commissioner,Cliff Branan,REP,730312,0,3,40,43,
Wagoner,U.S. Senate,Evelyn Rogers,REP,730312,0,0,4,4,
Wagoner,U.S. Senate,Rob Moye,REP,730312,0,0,1,1,
Wagoner,U.S. Senate,D. Jean Mcbride-Samuels,REP,730312,0,0,3,3,
Wagoner,U.S. Senate,Jim Inhofe,REP,730312,1,7,72,80,
Wagoner,U.S. Senate,Erick Paul Wyatt,REP,730312,0,1,6,7,
Wagoner,U.S. Senate,Andy Craig,REP,730312,0,0,1,1,
Wagoner,U.S. Senate,T. Shannon,REP,730312,1,1,44,46,
Wagoner,U.S. Senate,Randy Brogdon,REP,730312,0,1,3,4,
Wagoner,U.S. Senate,Eric Mccray,REP,730312,0,1,1,2,
Wagoner,U.S. Senate,Kevin Crow,REP,730312,0,0,1,1,
Wagoner,U.S. Senate,James Lankford,REP,730312,0,5,34,39,
Wagoner,U.S. Senate,Jason Weger,REP,730312,0,0,1,1,
Wagoner,Superintendent of Public Instruction,John Cox,DEM,730313,0,0,23,23,
Wagoner,Superintendent of Public Instruction,Jack Jr.,DEM,730313,0,0,3,3,
Wagoner,Superintendent of Public Instruction,Ivan Holmes,DEM,730313,0,0,2,2,
Wagoner,Superintendent of Public Instruction,Freda Deskin,DEM,730313,0,0,24,24,
Wagoner,U.S. Senate,Patrick Michael Hayes,DEM,730313,0,0,10,10,
Wagoner,U.S. Senate,Jim Rogers,DEM,730313,0,0,24,24,
Wagoner,U.S. Senate,Connie Johnson,DEM,730313,0,0,18,18,
Wagoner,Governor,Dax Ewbank,REP,730313,0,0,5,5,
Wagoner,Governor,Chad Moody,REP,730313,0,0,8,8,
Wagoner,Governor,Mary Fallin,REP,730313,0,1,30,31,
Wagoner,Superintendent of Public Instruction,Brian Kelly,REP,730313,0,0,8,8,
Wagoner,Superintendent of Public Instruction,Janet Costello Barresi,REP,730313,0,0,10,10,
Wagoner,Superintendent of Public Instruction,Joy Hofmeister,REP,730313,0,1,25,26,
Wagoner,Insurance Commissioner,Bill Viner,REP,730313,0,0,6,6,
Wagoner,Insurance Commissioner,John Doak,REP,730313,0,1,32,33,
Wagoner,Corporation Commissioner,Todd Hiett,REP,730313,0,1,18,19,
Wagoner,Corporation Commissioner,Cliff Branan,REP,730313,0,0,20,20,
Wagoner,U.S. Senate,Evelyn Rogers,REP,730313,0,0,0,0,
Wagoner,U.S. Senate,Rob Moye,REP,730313,0,0,1,1,
Wagoner,U.S. Senate,D. Jean Mcbride-Samuels,REP,730313,0,0,0,0,
Wagoner,U.S. Senate,Jim Inhofe,REP,730313,1,1,37,39,
Wagoner,U.S. Senate,Erick Paul Wyatt,REP,730313,0,0,5,5,
Wagoner,U.S. Senate,Andy Craig,REP,730313,0,0,0,0,
Wagoner,U.S. Senate,T. Shannon,REP,730313,0,0,24,24,
Wagoner,U.S. Senate,Randy Brogdon,REP,730313,1,0,2,3,
Wagoner,U.S. Senate,Eric Mccray,REP,730313,0,0,0,0,
Wagoner,U.S. Senate,Kevin Crow,REP,730313,0,0,0,0,
Wagoner,U.S. Senate,James Lankford,REP,730313,0,1,18,19,
Wagoner,U.S. Senate,Jason Weger,REP,730313,0,0,0,0,
Washington,Superintendent of Public Instruction,John Cox,DEM,740011,0,0,8,8,
Washington,Superintendent of Public Instruction,Jack Jr.,DEM,740011,0,1,8,9,
Washington,Superintendent of Public Instruction,Ivan Holmes,DEM,740011,0,0,3,3,
Washington,Superintendent of Public Instruction,Freda Deskin,DEM,740011,1,0,28,29,
Washington,U.S. Senate,Patrick Michael Hayes,DEM,740011,0,0,7,7,
Washington,U.S. Senate,Jim Rogers,DEM,740011,0,1,11,12,
Washington,U.S. Senate,Connie Johnson,DEM,740011,1,0,24,25,
Washington,Governor,Dax Ewbank,REP,740011,0,0,25,25,
Washington,Governor,Chad Moody,REP,740011,2,4,25,31,
Washington,Governor,Mary Fallin,REP,740011,5,9,211,225,
Washington,Superintendent of Public Instruction,Brian Kelly,REP,740011,0,1,48,49,
Washington,Superintendent of Public Instruction,Janet Costello Barresi,REP,740011,1,1,53,55,
Washington,Superintendent of Public Instruction,Joy Hofmeister,REP,740011,6,11,158,175,
Washington,Insurance Commissioner,Bill Viner,REP,740011,1,4,53,58,
Washington,Insurance Commissioner,John Doak,REP,740011,6,8,180,194,
Washington,Corporation Commissioner,Todd Hiett,REP,740011,4,9,134,147,
Washington,Corporation Commissioner,Cliff Branan,REP,740011,3,4,112,119,
Washington,U.S. Senate,Evelyn Rogers,REP,740011,1,1,9,11,
Washington,U.S. Senate,Rob Moye,REP,740011,0,0,4,4,
Washington,U.S. Senate,D. Jean Mcbride-Samuels,REP,740011,0,0,8,8,
Washington,U.S. Senate,Jim Inhofe,REP,740011,6,11,234,251,
Washington,U.S. Senate,Erick Paul Wyatt,REP,740011,0,1,8,9,
Washington,U.S. Senate,Andy Craig,REP,740011,0,0,2,2,
Washington,U.S. Senate,T. Shannon,REP,740011,6,5,83,94,
Washington,U.S. Senate,Randy Brogdon,REP,740011,0,0,11,11,
Washington,U.S. Senate,Eric Mccray,REP,740011,1,0,2,3,
Washington,U.S. Senate,Kevin Crow,REP,740011,0,0,3,3,
Washington,U.S. Senate,James Lankford,REP,740011,0,8,163,171,
Washington,U.S. Senate,Jason Weger,REP,740011,0,0,3,3,
Washington,Superintendent of Public Instruction,John Cox,DEM,740012,0,0,1,1,
Washington,Superintendent of Public Instruction,Jack Jr.,DEM,740012,0,0,3,3,
Washington,Superintendent of Public Instruction,Ivan Holmes,DEM,740012,0,0,0,0,
Washington,Superintendent of Public Instruction,Freda Deskin,DEM,740012,0,0,3,3,
Washington,U.S. Senate,Patrick Michael Hayes,DEM,740012,0,0,1,1,
Washington,U.S. Senate,Jim Rogers,DEM,740012,0,0,1,1,
Washington,U.S. Senate,Connie Johnson,DEM,740012,0,0,5,5,
Washington,Governor,Dax Ewbank,REP,740012,0,0,4,4,
Washington,Governor,Chad Moody,REP,740012,0,0,10,10,
Washington,Governor,Mary Fallin,REP,740012,3,3,45,51,
Washington,Superintendent of Public Instruction,Brian Kelly,REP,740012,1,1,8,10,
Washington,Superintendent of Public Instruction,Janet Costello Barresi,REP,740012,0,2,14,16,
Washington,Superintendent of Public Instruction,Joy Hofmeister,REP,740012,2,0,36,38,
Washington,Insurance Commissioner,Bill Viner,REP,740012,0,1,11,12,
Washington,Insurance Commissioner,John Doak,REP,740012,3,2,45,50,
Washington,Corporation Commissioner,Todd Hiett,REP,740012,3,1,34,38,
Washington,Corporation Commissioner,Cliff Branan,REP,740012,0,2,24,26,
Washington,U.S. Senate,Evelyn Rogers,REP,740012,0,0,5,5,
Washington,U.S. Senate,Rob Moye,REP,740012,0,0,0,0,
Washington,U.S. Senate,D. Jean Mcbride-Samuels,REP,740012,0,0,1,1,
Washington,U.S. Senate,Jim Inhofe,REP,740012,3,3,51,57,
Washington,U.S. Senate,Erick Paul Wyatt,REP,740012,0,0,2,2,
Washington,U.S. Senate,Andy Craig,REP,740012,0,0,0,0,
Washington,U.S. Senate,T. Shannon,REP,740012,0,2,20,22,
Washington,U.S. Senate,Randy Brogdon,REP,740012,0,1,0,1,
Washington,U.S. Senate,Eric Mccray,REP,740012,0,0,0,0,
Washington,U.S. Senate,Kevin Crow,REP,740012,0,0,0,0,
Washington,U.S. Senate,James Lankford,REP,740012,3,0,40,43,
Washington,U.S. Senate,Jason Weger,REP,740012,0,0,0,0,
Washington,Superintendent of Public Instruction,John Cox,DEM,740013,0,3,16,19,
Washington,Superintendent of Public Instruction,Jack Jr.,DEM,740013,0,0,12,12,
Washington,Superintendent of Public Instruction,Ivan Holmes,DEM,740013,0,0,5,5,
Washington,Superintendent of Public Instruction,Freda Deskin,DEM,740013,0,0,31,31,
Washington,U.S. Senate,Patrick Michael Hayes,DEM,740013,0,0,16,16,
Washington,U.S. Senate,Jim Rogers,DEM,740013,0,2,19,21,
Washington,U.S. Senate,Connie Johnson,DEM,740013,0,1,28,29,
Washington,Governor,Dax Ewbank,REP,740013,1,2,27,30,
Washington,Governor,Chad Moody,REP,740013,1,1,35,37,
Washington,Governor,Mary Fallin,REP,740013,1,12,171,184,
Washington,Superintendent of Public Instruction,Brian Kelly,REP,740013,1,0,61,62,
Washington,Superintendent of Public Instruction,Janet Costello Barresi,REP,740013,1,4,41,46,
Washington,Superintendent of Public Instruction,Joy Hofmeister,REP,740013,1,11,130,142,
Washington,Insurance Commissioner,Bill Viner,REP,740013,1,4,57,62,
Washington,Insurance Commissioner,John Doak,REP,740013,2,11,159,172,
Washington,Corporation Commissioner,Todd Hiett,REP,740013,2,6,117,125,
Washington,Corporation Commissioner,Cliff Branan,REP,740013,1,9,97,107,
Washington,U.S. Senate,Evelyn Rogers,REP,740013,0,0,11,11,
Washington,U.S. Senate,Rob Moye,REP,740013,0,1,5,6,
Washington,U.S. Senate,D. Jean Mcbride-Samuels,REP,740013,1,1,5,7,
Washington,U.S. Senate,Jim Inhofe,REP,740013,2,13,196,211,
Washington,U.S. Senate,Erick Paul Wyatt,REP,740013,0,0,16,16,
Washington,U.S. Senate,Andy Craig,REP,740013,0,0,1,1,
Washington,U.S. Senate,T. Shannon,REP,740013,1,5,91,97,
Washington,U.S. Senate,Randy Brogdon,REP,740013,1,1,25,27,
Washington,U.S. Senate,Eric Mccray,REP,740013,0,0,3,3,
Washington,U.S. Senate,Kevin Crow,REP,740013,0,0,4,4,
Washington,U.S. Senate,James Lankford,REP,740013,1,9,106,116,
Washington,U.S. Senate,Jason Weger,REP,740013,0,0,3,3,
Washington,State House,Randy Barnett,REP,740013,1,0,82,83,10
Washington,State House,Travis Dunlap,REP,740013,2,15,150,167,10
Washington,Superintendent of Public Instruction,John Cox,DEM,740015,0,2,19,21,
Washington,Superintendent of Public Instruction,Jack Jr.,DEM,740015,0,1,9,10,
Washington,Superintendent of Public Instruction,Ivan Holmes,DEM,740015,0,0,2,2,
Washington,Superintendent of Public Instruction,Freda Deskin,DEM,740015,0,0,30,30,
Washington,U.S. Senate,Patrick Michael Hayes,DEM,740015,0,1,16,17,
Washington,U.S. Senate,Jim Rogers,DEM,740015,0,1,18,19,
Washington,U.S. Senate,Connie Johnson,DEM,740015,0,1,25,26,
Washington,Governor,Dax Ewbank,REP,740015,0,0,16,16,
Washington,Governor,Chad Moody,REP,740015,0,4,25,29,
Washington,Governor,Mary Fallin,REP,740015,4,16,200,220,
Washington,Superintendent of Public Instruction,Brian Kelly,REP,740015,2,2,55,59,
Washington,Superintendent of Public Instruction,Janet Costello Barresi,REP,740015,0,1,45,46,
Washington,Superintendent of Public Instruction,Joy Hofmeister,REP,740015,2,13,130,145,
Washington,Insurance Commissioner,Bill Viner,REP,740015,3,5,65,73,
Washington,Insurance Commissioner,John Doak,REP,740015,1,11,156,168,
Washington,Corporation Commissioner,Todd Hiett,REP,740015,1,5,115,121,
Washington,Corporation Commissioner,Cliff Branan,REP,740015,2,12,108,122,
Washington,U.S. Senate,Evelyn Rogers,REP,740015,0,1,4,5,
Washington,U.S. Senate,Rob Moye,REP,740015,1,1,6,8,
Washington,U.S. Senate,D. Jean Mcbride-Samuels,REP,740015,0,0,3,3,
Washington,U.S. Senate,Jim Inhofe,REP,740015,3,16,215,234,
Washington,U.S. Senate,Erick Paul Wyatt,REP,740015,0,1,13,14,
Washington,U.S. Senate,Andy Craig,REP,740015,0,0,2,2,
Washington,U.S. Senate,T. Shannon,REP,740015,0,8,107,115,
Washington,U.S. Senate,Randy Brogdon,REP,740015,2,3,11,16,
Washington,U.S. Senate,Eric Mccray,REP,740015,0,0,8,8,
Washington,U.S. Senate,Kevin Crow,REP,740015,1,0,2,3,
Washington,U.S. Senate,James Lankford,REP,740015,1,8,113,122,
Washington,U.S. Senate,Jason Weger,REP,740015,0,1,1,2,
Washington,State House,Randy Barnett,REP,740015,1,5,83,89,10
Washington,State House,Travis Dunlap,REP,740015,3,13,155,171,10
Washington,Superintendent of Public Instruction,John Cox,DEM,740022,1,1,32,34,
Washington,Superintendent of Public Instruction,Jack Jr.,DEM,740022,0,0,6,6,
Washington,Superintendent of Public Instruction,Ivan Holmes,DEM,740022,1,0,4,5,
Washington,Superintendent of Public Instruction,Freda Deskin,DEM,740022,3,1,33,37,
Washington,U.S. Senate,Patrick Michael Hayes,DEM,740022,1,0,11,12,
Washington,U.S. Senate,Jim Rogers,DEM,740022,0,0,20,20,
Washington,U.S. Senate,Connie Johnson,DEM,740022,4,2,43,49,
Washington,Governor,Dax Ewbank,REP,740022,1,1,42,44,
Washington,Governor,Chad Moody,REP,740022,1,3,64,68,
Washington,Governor,Mary Fallin,REP,740022,13,34,557,604,
Washington,Superintendent of Public Instruction,Brian Kelly,REP,740022,1,5,135,141,
Washington,Superintendent of Public Instruction,Janet Costello Barresi,REP,740022,4,12,136,152,
Washington,Superintendent of Public Instruction,Joy Hofmeister,REP,740022,11,19,385,415,
Washington,Insurance Commissioner,Bill Viner,REP,740022,0,5,118,123,
Washington,Insurance Commissioner,John Doak,REP,740022,16,28,461,505,
Washington,Corporation Commissioner,Todd Hiett,REP,740022,9,17,298,324,
Washington,Corporation Commissioner,Cliff Branan,REP,740022,5,15,299,319,
Washington,U.S. Senate,Evelyn Rogers,REP,740022,0,3,33,36,
Washington,U.S. Senate,Rob Moye,REP,740022,0,0,6,6,
Washington,U.S. Senate,D. Jean Mcbride-Samuels,REP,740022,0,0,7,7,
Washington,U.S. Senate,Jim Inhofe,REP,740022,16,33,589,638,
Washington,U.S. Senate,Erick Paul Wyatt,REP,740022,0,2,23,25,
Washington,U.S. Senate,Andy Craig,REP,740022,0,0,4,4,
Washington,U.S. Senate,T. Shannon,REP,740022,6,14,213,233,
Washington,U.S. Senate,Randy Brogdon,REP,740022,2,3,18,23,
Washington,U.S. Senate,Eric Mccray,REP,740022,0,0,2,2,
Washington,U.S. Senate,Kevin Crow,REP,740022,0,1,4,5,
Washington,U.S. Senate,James Lankford,REP,740022,8,21,426,455,
Washington,U.S. Senate,Jason Weger,REP,740022,0,0,5,5,
Washington,Superintendent of Public Instruction,John Cox,DEM,740027,0,1,13,14,
Washington,Superintendent of Public Instruction,Jack Jr.,DEM,740027,0,0,3,3,
Washington,Superintendent of Public Instruction,Ivan Holmes,DEM,740027,0,0,2,2,
Washington,Superintendent of Public Instruction,Freda Deskin,DEM,740027,0,1,11,12,
Washington,U.S. Senate,Patrick Michael Hayes,DEM,740027,0,0,2,2,
Washington,U.S. Senate,Jim Rogers,DEM,740027,0,1,11,12,
Washington,U.S. Senate,Connie Johnson,DEM,740027,0,1,16,17,
Washington,Governor,Dax Ewbank,REP,740027,0,2,6,8,
Washington,Governor,Chad Moody,REP,740027,0,0,16,16,
Washington,Governor,Mary Fallin,REP,740027,0,3,88,91,
Washington,Superintendent of Public Instruction,Brian Kelly,REP,740027,0,0,36,36,
Washington,Superintendent of Public Instruction,Janet Costello Barresi,REP,740027,0,1,19,20,
Washington,Superintendent of Public Instruction,Joy Hofmeister,REP,740027,0,3,55,58,
Washington,Insurance Commissioner,Bill Viner,REP,740027,0,1,32,33,
Washington,Insurance Commissioner,John Doak,REP,740027,0,2,65,67,
Washington,Corporation Commissioner,Todd Hiett,REP,740027,0,1,51,52,
Washington,Corporation Commissioner,Cliff Branan,REP,740027,0,2,47,49,
Washington,U.S. Senate,Evelyn Rogers,REP,740027,0,0,6,6,
Washington,U.S. Senate,Rob Moye,REP,740027,0,0,0,0,
Washington,U.S. Senate,D. Jean Mcbride-Samuels,REP,740027,0,0,3,3,
Washington,U.S. Senate,Jim Inhofe,REP,740027,0,5,98,103,
Washington,U.S. Senate,Erick Paul Wyatt,REP,740027,0,0,3,3,
Washington,U.S. Senate,Andy Craig,REP,740027,0,0,0,0,
Washington,U.S. Senate,T. Shannon,REP,740027,0,2,35,37,
Washington,U.S. Senate,Randy Brogdon,REP,740027,0,0,5,5,
Washington,U.S. Senate,Eric Mccray,REP,740027,0,0,0,0,
Washington,U.S. Senate,Kevin Crow,REP,740027,0,0,1,1,
Washington,U.S. Senate,James Lankford,REP,740027,0,2,72,74,
Washington,U.S. Senate,Jason Weger,REP,740027,0,0,0,0,
Washington,State House,Randy Barnett,REP,740027,0,2,46,48,10
Washington,State House,Travis Dunlap,REP,740027,0,3,67,70,10
Washington,Superintendent of Public Instruction,John Cox,DEM,740028,0,1,24,25,
Washington,Superintendent of Public Instruction,Jack Jr.,DEM,740028,0,1,21,22,
Washington,Superintendent of Public Instruction,Ivan Holmes,DEM,740028,0,2,4,6,
Washington,Superintendent of Public Instruction,Freda Deskin,DEM,740028,0,1,62,63,
Washington,U.S. Senate,Patrick Michael Hayes,DEM,740028,0,0,23,23,
Washington,U.S. Senate,Jim Rogers,DEM,740028,0,0,25,25,
Washington,U.S. Senate,Connie Johnson,DEM,740028,0,5,61,66,
Washington,Governor,Dax Ewbank,REP,740028,2,2,47,51,
Washington,Governor,Chad Moody,REP,740028,0,5,60,65,
Washington,Governor,Mary Fallin,REP,740028,4,23,401,428,
Washington,Superintendent of Public Instruction,Brian Kelly,REP,740028,2,8,122,132,
Washington,Superintendent of Public Instruction,Janet Costello Barresi,REP,740028,0,6,93,99,
Washington,Superintendent of Public Instruction,Joy Hofmeister,REP,740028,4,16,295,315,
Washington,Insurance Commissioner,Bill Viner,REP,740028,1,7,112,120,
Washington,Insurance Commissioner,John Doak,REP,740028,3,23,348,374,
Washington,Corporation Commissioner,Todd Hiett,REP,740028,4,13,268,285,
Washington,Corporation Commissioner,Cliff Branan,REP,740028,0,14,213,227,
Washington,U.S. Senate,Evelyn Rogers,REP,740028,0,1,23,24,
Washington,U.S. Senate,Rob Moye,REP,740028,0,3,11,14,
Washington,U.S. Senate,D. Jean Mcbride-Samuels,REP,740028,0,0,7,7,
Washington,U.S. Senate,Jim Inhofe,REP,740028,6,26,448,480,
Washington,U.S. Senate,Erick Paul Wyatt,REP,740028,0,0,21,21,
Washington,U.S. Senate,Andy Craig,REP,740028,1,0,3,4,
Washington,U.S. Senate,T. Shannon,REP,740028,1,14,213,228,
Washington,U.S. Senate,Randy Brogdon,REP,740028,3,2,19,24,
Washington,U.S. Senate,Eric Mccray,REP,740028,0,1,3,4,
Washington,U.S. Senate,Kevin Crow,REP,740028,0,0,3,3,
Washington,U.S. Senate,James Lankford,REP,740028,1,13,274,288,
Washington,U.S. Senate,Jason Weger,REP,740028,0,0,2,2,
Washington,Superintendent of Public Instruction,John Cox,DEM,740031,0,1,21,22,
Washington,Superintendent of Public Instruction,Jack Jr.,DEM,740031,0,0,7,7,
Washington,Superintendent of Public Instruction,Ivan Holmes,DEM,740031,0,0,3,3,
Washington,Superintendent of Public Instruction,Freda Deskin,DEM,740031,0,2,33,35,
Washington,U.S. Senate,Patrick Michael Hayes,DEM,740031,0,0,11,11,
Washington,U.S. Senate,Jim Rogers,DEM,740031,0,0,11,11,
Washington,U.S. Senate,Connie Johnson,DEM,740031,0,3,41,44,
Washington,Governor,Dax Ewbank,REP,740031,2,1,30,33,
Washington,Governor,Chad Moody,REP,740031,0,3,55,58,
Washington,Governor,Mary Fallin,REP,740031,2,15,239,256,
Washington,Superintendent of Public Instruction,Brian Kelly,REP,740031,0,1,93,94,
Washington,Superintendent of Public Instruction,Janet Costello Barresi,REP,740031,3,3,59,65,
Washington,Superintendent of Public Instruction,Joy Hofmeister,REP,740031,1,12,168,181,
Washington,Insurance Commissioner,Bill Viner,REP,740031,2,0,75,77,
Washington,Insurance Commissioner,John Doak,REP,740031,2,15,218,235,
Washington,Corporation Commissioner,Todd Hiett,REP,740031,3,11,161,175,
Washington,Corporation Commissioner,Cliff Branan,REP,740031,1,5,142,148,
Washington,U.S. Senate,Evelyn Rogers,REP,740031,1,1,23,25,
Washington,U.S. Senate,Rob Moye,REP,740031,0,0,11,11,
Washington,U.S. Senate,D. Jean Mcbride-Samuels,REP,740031,0,0,4,4,
Washington,U.S. Senate,Jim Inhofe,REP,740031,3,15,272,290,
Washington,U.S. Senate,Erick Paul Wyatt,REP,740031,0,1,15,16,
Washington,U.S. Senate,Andy Craig,REP,740031,0,0,7,7,
Washington,U.S. Senate,T. Shannon,REP,740031,2,6,112,120,
Washington,U.S. Senate,Randy Brogdon,REP,740031,0,1,27,28,
Washington,U.S. Senate,Eric Mccray,REP,740031,0,0,1,1,
Washington,U.S. Senate,Kevin Crow,REP,740031,0,0,4,4,
Washington,U.S. Senate,James Lankford,REP,740031,2,11,173,186,
Washington,U.S. Senate,Jason Weger,REP,740031,0,0,7,7,
Washington,Superintendent of Public Instruction,John Cox,DEM,740033,0,2,9,11,
Washington,Superintendent of Public Instruction,Jack Jr.,DEM,740033,0,0,3,3,
Washington,Superintendent of Public Instruction,Ivan Holmes,DEM,740033,0,0,0,0,
Washington,Superintendent of Public Instruction,Freda Deskin,DEM,740033,1,1,19,21,
Washington,U.S. Senate,Patrick Michael Hayes,DEM,740033,0,0,4,4,
Washington,U.S. Senate,Jim Rogers,DEM,740033,0,1,8,9,
Washington,U.S. Senate,Connie Johnson,DEM,740033,1,2,18,21,
Washington,Governor,Dax Ewbank,REP,740033,0,0,3,3,
Washington,Governor,Chad Moody,REP,740033,0,0,10,10,
Washington,Governor,Mary Fallin,REP,740033,0,2,37,39,
Washington,Superintendent of Public Instruction,Brian Kelly,REP,740033,0,2,21,23,
Washington,Superintendent of Public Instruction,Janet Costello Barresi,REP,740033,0,0,9,9,
Washington,Superintendent of Public Instruction,Joy Hofmeister,REP,740033,0,0,18,18,
Washington,Insurance Commissioner,Bill Viner,REP,740033,0,0,16,16,
Washington,Insurance Commissioner,John Doak,REP,740033,0,2,31,33,
Washington,Corporation Commissioner,Todd Hiett,REP,740033,0,1,21,22,
Washington,Corporation Commissioner,Cliff Branan,REP,740033,0,1,26,27,
Washington,U.S. Senate,Evelyn Rogers,REP,740033,0,0,3,3,
Washington,U.S. Senate,Rob Moye,REP,740033,0,1,0,1,
Washington,U.S. Senate,D. Jean Mcbride-Samuels,REP,740033,0,0,2,2,
Washington,U.S. Senate,Jim Inhofe,REP,740033,0,1,40,41,
Washington,U.S. Senate,Erick Paul Wyatt,REP,740033,0,0,5,5,
Washington,U.S. Senate,Andy Craig,REP,740033,0,0,0,0,
Washington,U.S. Senate,T. Shannon,REP,740033,0,2,28,30,
Washington,U.S. Senate,Randy Brogdon,REP,740033,0,0,2,2,
Washington,U.S. Senate,Eric Mccray,REP,740033,0,0,0,0,
Washington,U.S. Senate,Kevin Crow,REP,740033,0,0,1,1,
Washington,U.S. Senate,James Lankford,REP,740033,0,0,18,18,
Washington,U.S. Senate,Jason Weger,REP,740033,0,0,0,0,
Washington,Superintendent of Public Instruction,John Cox,DEM,740046,0,1,20,21,
Washington,Superintendent of Public Instruction,Jack Jr.,DEM,740046,0,1,1,2,
Washington,Superintendent of Public Instruction,Ivan Holmes,DEM,740046,0,0,6,6,
Washington,Superintendent of Public Instruction,Freda Deskin,DEM,740046,0,0,13,13,
Washington,U.S. Senate,Patrick Michael Hayes,DEM,740046,0,0,12,12,
Washington,U.S. Senate,Jim Rogers,DEM,740046,0,1,13,14,
Washington,U.S. Senate,Connie Johnson,DEM,740046,0,1,15,16,
Washington,Governor,Dax Ewbank,REP,740046,0,0,12,12,
Washington,Governor,Chad Moody,REP,740046,0,3,8,11,
Washington,Governor,Mary Fallin,REP,740046,0,3,72,75,
Washington,Superintendent of Public Instruction,Brian Kelly,REP,740046,0,1,22,23,
Washington,Superintendent of Public Instruction,Janet Costello Barresi,REP,740046,0,2,16,18,
Washington,Superintendent of Public Instruction,Joy Hofmeister,REP,740046,0,3,51,54,
Washington,Insurance Commissioner,Bill Viner,REP,740046,0,2,25,27,
Washington,Insurance Commissioner,John Doak,REP,740046,0,4,58,62,
Washington,Corporation Commissioner,Todd Hiett,REP,740046,0,2,43,45,
Washington,Corporation Commissioner,Cliff Branan,REP,740046,0,4,44,48,
Washington,U.S. Senate,Evelyn Rogers,REP,740046,0,2,8,10,
Washington,U.S. Senate,Rob Moye,REP,740046,0,0,2,2,
Washington,U.S. Senate,D. Jean Mcbride-Samuels,REP,740046,0,0,1,1,
Washington,U.S. Senate,Jim Inhofe,REP,740046,0,3,76,79,
Washington,U.S. Senate,Erick Paul Wyatt,REP,740046,0,1,5,6,
Washington,U.S. Senate,Andy Craig,REP,740046,0,0,3,3,
Washington,U.S. Senate,T. Shannon,REP,740046,0,2,38,40,
Washington,U.S. Senate,Randy Brogdon,REP,740046,0,0,3,3,
Washington,U.S. Senate,Eric Mccray,REP,740046,0,0,1,1,
Washington,U.S. Senate,Kevin Crow,REP,740046,0,0,3,3,
Washington,U.S. Senate,James Lankford,REP,740046,0,4,45,49,
Washington,U.S. Senate,Jason Weger,REP,740046,0,0,0,0,
Washington,State House,Randy Barnett,REP,740046,0,1,31,32,10
Washington,State House,Travis Dunlap,REP,740046,0,5,61,66,10
Washington,Superintendent of Public Instruction,John Cox,DEM,740048,1,1,18,20,
Washington,Superintendent of Public Instruction,Jack Jr.,DEM,740048,2,0,12,14,
Washington,Superintendent of Public Instruction,Ivan Holmes,DEM,740048,1,0,5,6,
Washington,Superintendent of Public Instruction,Freda Deskin,DEM,740048,1,0,18,19,
Washington,U.S. Senate,Patrick Michael Hayes,DEM,740048,1,0,11,12,
Washington,U.S. Senate,Jim Rogers,DEM,740048,2,0,17,19,
Washington,U.S. Senate,Connie Johnson,DEM,740048,2,1,24,27,
Washington,Governor,Dax Ewbank,REP,740048,1,0,18,19,
Washington,Governor,Chad Moody,REP,740048,1,0,25,26,
Washington,Governor,Mary Fallin,REP,740048,5,7,121,133,
Washington,Superintendent of Public Instruction,Brian Kelly,REP,740048,4,2,41,47,
Washington,Superintendent of Public Instruction,Janet Costello Barresi,REP,740048,2,2,24,28,
Washington,Superintendent of Public Instruction,Joy Hofmeister,REP,740048,1,3,101,105,
Washington,Insurance Commissioner,Bill Viner,REP,740048,1,0,46,47,
Washington,Insurance Commissioner,John Doak,REP,740048,6,7,109,122,
Washington,Corporation Commissioner,Todd Hiett,REP,740048,3,5,83,91,
Washington,Corporation Commissioner,Cliff Branan,REP,740048,4,2,74,80,
Washington,U.S. Senate,Evelyn Rogers,REP,740048,0,0,9,9,
Washington,U.S. Senate,Rob Moye,REP,740048,0,0,4,4,
Washington,U.S. Senate,D. Jean Mcbride-Samuels,REP,740048,0,0,7,7,
Washington,U.S. Senate,Jim Inhofe,REP,740048,6,7,132,145,
Washington,U.S. Senate,Erick Paul Wyatt,REP,740048,1,0,14,15,
Washington,U.S. Senate,Andy Craig,REP,740048,0,0,0,0,
Washington,U.S. Senate,T. Shannon,REP,740048,4,2,83,89,
Washington,U.S. Senate,Randy Brogdon,REP,740048,0,0,11,11,
Washington,U.S. Senate,Eric Mccray,REP,740048,0,0,1,1,
Washington,U.S. Senate,Kevin Crow,REP,740048,0,0,2,2,
Washington,U.S. Senate,James Lankford,REP,740048,2,5,67,74,
Washington,U.S. Senate,Jason Weger,REP,740048,1,0,2,3,
Washington,State House,Randy Barnett,REP,740048,1,1,58,60,10
Washington,State House,Travis Dunlap,REP,740048,6,6,106,118,10
Washington,Superintendent of Public Instruction,John Cox,DEM,740051,1,0,23,24,
Washington,Superintendent of Public Instruction,Jack Jr.,DEM,740051,0,0,8,8,
Washington,Superintendent of Public Instruction,Ivan Holmes,DEM,740051,0,0,1,1,
Washington,Superintendent of Public Instruction,Freda Deskin,DEM,740051,0,0,33,33,
Washington,U.S. Senate,Patrick Michael Hayes,DEM,740051,0,0,16,16,
Washington,U.S. Senate,Jim Rogers,DEM,740051,0,0,20,20,
Washington,U.S. Senate,Connie Johnson,DEM,740051,1,0,27,28,
Washington,Governor,Dax Ewbank,REP,740051,0,2,29,31,
Washington,Governor,Chad Moody,REP,740051,0,4,38,42,
Washington,Governor,Mary Fallin,REP,740051,5,30,269,304,
Washington,Superintendent of Public Instruction,Brian Kelly,REP,740051,5,5,85,95,
Washington,Superintendent of Public Instruction,Janet Costello Barresi,REP,740051,0,4,63,67,
Washington,Superintendent of Public Instruction,Joy Hofmeister,REP,740051,0,29,195,224,
Washington,Insurance Commissioner,Bill Viner,REP,740051,2,6,80,88,
Washington,Insurance Commissioner,John Doak,REP,740051,3,26,221,250,
Washington,Corporation Commissioner,Todd Hiett,REP,740051,0,15,173,188,
Washington,Corporation Commissioner,Cliff Branan,REP,740051,3,20,139,162,
Washington,U.S. Senate,Evelyn Rogers,REP,740051,0,2,12,14,
Washington,U.S. Senate,Rob Moye,REP,740051,0,1,5,6,
Washington,U.S. Senate,D. Jean Mcbride-Samuels,REP,740051,0,1,4,5,
Washington,U.S. Senate,Jim Inhofe,REP,740051,5,32,307,344,
Washington,U.S. Senate,Erick Paul Wyatt,REP,740051,0,0,10,10,
Washington,U.S. Senate,Andy Craig,REP,740051,0,1,1,2,
Washington,U.S. Senate,T. Shannon,REP,740051,2,17,111,130,
Washington,U.S. Senate,Randy Brogdon,REP,740051,0,0,20,20,
Washington,U.S. Senate,Eric Mccray,REP,740051,0,0,2,2,
Washington,U.S. Senate,Kevin Crow,REP,740051,0,0,2,2,
Washington,U.S. Senate,James Lankford,REP,740051,3,19,206,228,
Washington,U.S. Senate,Jason Weger,REP,740051,0,0,1,1,
Washington,State House,Randy Barnett,REP,740051,0,4,100,104,10
Washington,State House,Travis Dunlap,REP,740051,5,33,239,277,10
Washington,Superintendent of Public Instruction,John Cox,DEM,740054,0,2,24,26,
Washington,Superintendent of Public Instruction,Jack Jr.,DEM,740054,0,0,14,14,
Washington,Superintendent of Public Instruction,Ivan Holmes,DEM,740054,0,0,3,3,
Washington,Superintendent of Public Instruction,Freda Deskin,DEM,740054,2,2,30,34,
Washington,U.S. Senate,Patrick Michael Hayes,DEM,740054,1,0,12,13,
Washington,U.S. Senate,Jim Rogers,DEM,740054,0,1,20,21,
Washington,U.S. Senate,Connie Johnson,DEM,740054,1,3,39,43,
Washington,Governor,Dax Ewbank,REP,740054,0,2,24,26,
Washington,Governor,Chad Moody,REP,740054,0,4,43,47,
Washington,Governor,Mary Fallin,REP,740054,11,5,343,359,
Washington,Superintendent of Public Instruction,Brian Kelly,REP,740054,1,2,95,98,
Washington,Superintendent of Public Instruction,Janet Costello Barresi,REP,740054,3,1,77,81,
Washington,Superintendent of Public Instruction,Joy Hofmeister,REP,740054,7,8,228,243,
Washington,Insurance Commissioner,Bill Viner,REP,740054,2,1,82,85,
Washington,Insurance Commissioner,John Doak,REP,740054,9,10,283,302,
Washington,Corporation Commissioner,Todd Hiett,REP,740054,10,6,194,210,
Washington,Corporation Commissioner,Cliff Branan,REP,740054,1,5,189,195,
Washington,U.S. Senate,Evelyn Rogers,REP,740054,1,1,14,16,
Washington,U.S. Senate,Rob Moye,REP,740054,0,0,3,3,
Washington,U.S. Senate,D. Jean Mcbride-Samuels,REP,740054,0,0,9,9,
Washington,U.S. Senate,Jim Inhofe,REP,740054,10,9,371,390,
Washington,U.S. Senate,Erick Paul Wyatt,REP,740054,0,1,12,13,
Washington,U.S. Senate,Andy Craig,REP,740054,0,0,0,0,
Washington,U.S. Senate,T. Shannon,REP,740054,4,2,162,168,
Washington,U.S. Senate,Randy Brogdon,REP,740054,1,1,17,19,
Washington,U.S. Senate,Eric Mccray,REP,740054,0,1,2,3,
Washington,U.S. Senate,Kevin Crow,REP,740054,0,1,1,2,
Washington,U.S. Senate,James Lankford,REP,740054,6,6,233,245,
Washington,U.S. Senate,Jason Weger,REP,740054,0,0,1,1,
Washington,Superintendent of Public Instruction,John Cox,DEM,740062,0,3,29,32,
Washington,Superintendent of Public Instruction,Jack Jr.,DEM,740062,0,1,21,22,
Washington,Superintendent of Public Instruction,Ivan Holmes,DEM,740062,0,0,3,3,
Washington,Superintendent of Public Instruction,Freda Deskin,DEM,740062,0,0,29,29,
Washington,U.S. Senate,Patrick Michael Hayes,DEM,740062,0,0,27,27,
Washington,U.S. Senate,Jim Rogers,DEM,740062,0,3,28,31,
Washington,U.S. Senate,Connie Johnson,DEM,740062,0,1,29,30,
Washington,Governor,Dax Ewbank,REP,740062,1,0,9,10,
Washington,Governor,Chad Moody,REP,740062,0,1,30,31,
Washington,Governor,Mary Fallin,REP,740062,1,4,177,182,
Washington,Superintendent of Public Instruction,Brian Kelly,REP,740062,0,2,60,62,
Washington,Superintendent of Public Instruction,Janet Costello Barresi,REP,740062,1,1,26,28,
Washington,Superintendent of Public Instruction,Joy Hofmeister,REP,740062,1,2,128,131,
Washington,Insurance Commissioner,Bill Viner,REP,740062,0,1,53,54,
Washington,Insurance Commissioner,John Doak,REP,740062,2,4,149,155,
Washington,Corporation Commissioner,Todd Hiett,REP,740062,1,2,100,103,
Washington,Corporation Commissioner,Cliff Branan,REP,740062,1,3,105,109,
Washington,U.S. Senate,Evelyn Rogers,REP,740062,0,0,8,8,
Washington,U.S. Senate,Rob Moye,REP,740062,0,0,2,2,
Washington,U.S. Senate,D. Jean Mcbride-Samuels,REP,740062,0,1,5,6,
Washington,U.S. Senate,Jim Inhofe,REP,740062,2,3,185,190,
Washington,U.S. Senate,Erick Paul Wyatt,REP,740062,0,1,17,18,
Washington,U.S. Senate,Andy Craig,REP,740062,0,0,2,2,
Washington,U.S. Senate,T. Shannon,REP,740062,1,2,92,95,
Washington,U.S. Senate,Randy Brogdon,REP,740062,0,0,6,6,
Washington,U.S. Senate,Eric Mccray,REP,740062,0,0,1,1,
Washington,U.S. Senate,Kevin Crow,REP,740062,0,0,2,2,
Washington,U.S. Senate,James Lankford,REP,740062,1,3,113,117,
Washington,U.S. Senate,Jason Weger,REP,740062,0,0,1,1,
Washington,State House,Randy Barnett,REP,740062,0,0,88,88,10
Washington,State House,Travis Dunlap,REP,740062,2,5,123,130,10
Washington,Superintendent of Public Instruction,John Cox,DEM,740071,0,0,26,26,
Washington,Superintendent of Public Instruction,Jack Jr.,DEM,740071,0,0,6,6,
Washington,Superintendent of Public Instruction,Ivan Holmes,DEM,740071,0,0,3,3,
Washington,Superintendent of Public Instruction,Freda Deskin,DEM,740071,0,0,18,18,
Washington,U.S. Senate,Patrick Michael Hayes,DEM,740071,0,0,10,10,
Washington,U.S. Senate,Jim Rogers,DEM,740071,0,0,21,21,
Washington,U.S. Senate,Connie Johnson,DEM,740071,0,0,22,22,
Washington,Governor,Dax Ewbank,REP,740071,0,1,10,11,
Washington,Governor,Chad Moody,REP,740071,0,2,32,34,
Washington,Governor,Mary Fallin,REP,740071,0,2,121,123,
Washington,Superintendent of Public Instruction,Brian Kelly,REP,740071,0,2,42,44,
Washington,Superintendent of Public Instruction,Janet Costello Barresi,REP,740071,0,0,31,31,
Washington,Superintendent of Public Instruction,Joy Hofmeister,REP,740071,0,3,89,92,
Washington,Insurance Commissioner,Bill Viner,REP,740071,0,3,29,32,
Washington,Insurance Commissioner,John Doak,REP,740071,0,2,127,129,
Washington,Corporation Commissioner,Todd Hiett,REP,740071,0,3,92,95,
Washington,Corporation Commissioner,Cliff Branan,REP,740071,0,2,65,67,
Washington,U.S. Senate,Evelyn Rogers,REP,740071,0,0,13,13,
Washington,U.S. Senate,Rob Moye,REP,740071,0,0,3,3,
Washington,U.S. Senate,D. Jean Mcbride-Samuels,REP,740071,0,0,1,1,
Washington,U.S. Senate,Jim Inhofe,REP,740071,0,3,140,143,
Washington,U.S. Senate,Erick Paul Wyatt,REP,740071,0,2,6,8,
Washington,U.S. Senate,Andy Craig,REP,740071,0,0,1,1,
Washington,U.S. Senate,T. Shannon,REP,740071,0,3,78,81,
Washington,U.S. Senate,Randy Brogdon,REP,740071,0,0,1,1,
Washington,U.S. Senate,Eric Mccray,REP,740071,0,0,1,1,
Washington,U.S. Senate,Kevin Crow,REP,740071,0,0,4,4,
Washington,U.S. Senate,James Lankford,REP,740071,0,2,77,79,
Washington,U.S. Senate,Jason Weger,REP,740071,0,0,2,2,
Washington,State House,Randy Barnett,REP,740071,0,1,84,85,10
Washington,State House,Travis Dunlap,REP,740071,0,4,78,82,10
Washington,Superintendent of Public Instruction,John Cox,DEM,740073,0,1,8,9,
Washington,Superintendent of Public Instruction,Jack Jr.,DEM,740073,0,0,3,3,
Washington,Superintendent of Public Instruction,Ivan Holmes,DEM,740073,0,0,0,0,
Washington,Superintendent of Public Instruction,Freda Deskin,DEM,740073,0,0,13,13,
Washington,U.S. Senate,Patrick Michael Hayes,DEM,740073,0,1,7,8,
Washington,U.S. Senate,Jim Rogers,DEM,740073,0,0,10,10,
Washington,U.S. Senate,Connie Johnson,DEM,740073,0,0,8,8,
Washington,Governor,Dax Ewbank,REP,740073,0,0,5,5,
Washington,Governor,Chad Moody,REP,740073,1,1,11,13,
Washington,Governor,Mary Fallin,REP,740073,2,5,94,101,
Washington,Superintendent of Public Instruction,Brian Kelly,REP,740073,0,1,35,36,
Washington,Superintendent of Public Instruction,Janet Costello Barresi,REP,740073,0,0,25,25,
Washington,Superintendent of Public Instruction,Joy Hofmeister,REP,740073,3,5,50,58,
Washington,Insurance Commissioner,Bill Viner,REP,740073,3,1,29,33,
Washington,Insurance Commissioner,John Doak,REP,740073,0,4,71,75,
Washington,Corporation Commissioner,Todd Hiett,REP,740073,0,3,52,55,
Washington,Corporation Commissioner,Cliff Branan,REP,740073,3,3,48,54,
Washington,U.S. Senate,Evelyn Rogers,REP,740073,1,0,4,5,
Washington,U.S. Senate,Rob Moye,REP,740073,0,1,3,4,
Washington,U.S. Senate,D. Jean Mcbride-Samuels,REP,740073,0,0,1,1,
Washington,U.S. Senate,Jim Inhofe,REP,740073,2,5,99,106,
Washington,U.S. Senate,Erick Paul Wyatt,REP,740073,0,0,5,5,
Washington,U.S. Senate,Andy Craig,REP,740073,0,0,1,1,
Washington,U.S. Senate,T. Shannon,REP,740073,0,3,48,51,
Washington,U.S. Senate,Randy Brogdon,REP,740073,0,0,3,3,
Washington,U.S. Senate,Eric Mccray,REP,740073,0,0,0,0,
Washington,U.S. Senate,Kevin Crow,REP,740073,0,0,1,1,
Washington,U.S. Senate,James Lankford,REP,740073,3,3,55,61,
Washington,U.S. Senate,Jason Weger,REP,740073,0,0,3,3,
Washington,State House,Randy Barnett,REP,740073,0,1,45,46,10
Washington,State House,Travis Dunlap,REP,740073,3,5,63,71,10
Washington,Superintendent of Public Instruction,John Cox,DEM,740074,2,0,5,7,
Washington,Superintendent of Public Instruction,Jack Jr.,DEM,740074,0,0,1,1,
Washington,Superintendent of Public Instruction,Ivan Holmes,DEM,740074,0,0,2,2,
Washington,Superintendent of Public Instruction,Freda Deskin,DEM,740074,0,0,10,10,
Washington,U.S. Senate,Patrick Michael Hayes,DEM,740074,2,0,6,8,
Washington,U.S. Senate,Jim Rogers,DEM,740074,0,0,4,4,
Washington,U.S. Senate,Connie Johnson,DEM,740074,0,0,8,8,
Washington,Governor,Dax Ewbank,REP,740074,0,0,3,3,
Washington,Governor,Chad Moody,REP,740074,0,0,8,8,
Washington,Governor,Mary Fallin,REP,740074,6,5,68,79,
Washington,Superintendent of Public Instruction,Brian Kelly,REP,740074,1,1,26,28,
Washington,Superintendent of Public Instruction,Janet Costello Barresi,REP,740074,0,0,15,15,
Washington,Superintendent of Public Instruction,Joy Hofmeister,REP,740074,0,4,39,43,
Washington,Insurance Commissioner,Bill Viner,REP,740074,0,0,16,16,
Washington,Insurance Commissioner,John Doak,REP,740074,1,5,59,65,
Washington,Corporation Commissioner,Todd Hiett,REP,740074,6,3,33,42,
Washington,Corporation Commissioner,Cliff Branan,REP,740074,0,2,41,43,
Washington,U.S. Senate,Evelyn Rogers,REP,740074,0,0,2,2,
Washington,U.S. Senate,Rob Moye,REP,740074,0,0,1,1,
Washington,U.S. Senate,D. Jean Mcbride-Samuels,REP,740074,0,0,1,1,
Washington,U.S. Senate,Jim Inhofe,REP,740074,6,5,71,82,
Washington,U.S. Senate,Erick Paul Wyatt,REP,740074,0,0,5,5,
Washington,U.S. Senate,Andy Craig,REP,740074,0,0,2,2,
Washington,U.S. Senate,T. Shannon,REP,740074,3,2,43,48,
Washington,U.S. Senate,Randy Brogdon,REP,740074,2,0,2,4,
Washington,U.S. Senate,Eric Mccray,REP,740074,0,0,0,0,
Washington,U.S. Senate,Kevin Crow,REP,740074,0,1,3,4,
Washington,U.S. Senate,James Lankford,REP,740074,0,2,30,32,
Washington,U.S. Senate,Jason Weger,REP,740074,0,0,0,0,
Washington,State House,Randy Barnett,REP,740074,1,1,32,34,10
Washington,State House,Travis Dunlap,REP,740074,3,4,47,54,10
Washington,Superintendent of Public Instruction,John Cox,DEM,740075,0,0,11,11,
Washington,Superintendent of Public Instruction,Jack Jr.,DEM,740075,1,0,3,4,
Washington,Superintendent of Public Instruction,Ivan Holmes,DEM,740075,1,0,1,2,
Washington,Superintendent of Public Instruction,Freda Deskin,DEM,740075,0,0,13,13,
Washington,U.S. Senate,Patrick Michael Hayes,DEM,740075,1,0,3,4,
Washington,U.S. Senate,Jim Rogers,DEM,740075,0,0,12,12,
Washington,U.S. Senate,Connie Johnson,DEM,740075,1,0,13,14,
Washington,Governor,Dax Ewbank,REP,740075,0,0,8,8,
Washington,Governor,Chad Moody,REP,740075,0,0,16,16,
Washington,Governor,Mary Fallin,REP,740075,0,3,139,142,
Washington,Superintendent of Public Instruction,Brian Kelly,REP,740075,0,2,36,38,
Washington,Superintendent of Public Instruction,Janet Costello Barresi,REP,740075,0,0,40,40,
Washington,Superintendent of Public Instruction,Joy Hofmeister,REP,740075,0,1,84,85,
Washington,Insurance Commissioner,Bill Viner,REP,740075,0,0,25,25,
Washington,Insurance Commissioner,John Doak,REP,740075,0,3,128,131,
Washington,Corporation Commissioner,Todd Hiett,REP,740075,0,3,96,99,
Washington,Corporation Commissioner,Cliff Branan,REP,740075,0,0,57,57,
Washington,U.S. Senate,Evelyn Rogers,REP,740075,0,0,3,3,
Washington,U.S. Senate,Rob Moye,REP,740075,0,0,2,2,
Washington,U.S. Senate,D. Jean Mcbride-Samuels,REP,740075,0,0,2,2,
Washington,U.S. Senate,Jim Inhofe,REP,740075,0,3,149,152,
Washington,U.S. Senate,Erick Paul Wyatt,REP,740075,0,0,6,6,
Washington,U.S. Senate,Andy Craig,REP,740075,0,0,1,1,
Washington,U.S. Senate,T. Shannon,REP,740075,0,2,70,72,
Washington,U.S. Senate,Randy Brogdon,REP,740075,0,0,3,3,
Washington,U.S. Senate,Eric Mccray,REP,740075,0,0,0,0,
Washington,U.S. Senate,Kevin Crow,REP,740075,0,0,0,0,
Washington,U.S. Senate,James Lankford,REP,740075,0,1,90,91,
Washington,U.S. Senate,Jason Weger,REP,740075,0,0,1,1,
Washington,Superintendent of Public Instruction,John Cox,DEM,740076,0,0,17,17,
Washington,Superintendent of Public Instruction,Jack Jr.,DEM,740076,0,1,1,2,
Washington,Superintendent of Public Instruction,Ivan Holmes,DEM,740076,0,0,2,2,
Washington,Superintendent of Public Instruction,Freda Deskin,DEM,740076,1,0,8,9,
Washington,U.S. Senate,Patrick Michael Hayes,DEM,740076,0,0,5,5,
Washington,U.S. Senate,Jim Rogers,DEM,740076,0,1,14,15,
Washington,U.S. Senate,Connie Johnson,DEM,740076,1,0,8,9,
Washington,Governor,Dax Ewbank,REP,740076,0,1,6,7,
Washington,Governor,Chad Moody,REP,740076,0,1,14,15,
Washington,Governor,Mary Fallin,REP,740076,2,0,61,63,
Washington,Superintendent of Public Instruction,Brian Kelly,REP,740076,2,0,21,23,
Washington,Superintendent of Public Instruction,Janet Costello Barresi,REP,740076,0,0,12,12,
Washington,Superintendent of Public Instruction,Joy Hofmeister,REP,740076,0,2,47,49,
Washington,Insurance Commissioner,Bill Viner,REP,740076,1,0,17,18,
Washington,Insurance Commissioner,John Doak,REP,740076,1,0,60,61,
Washington,Corporation Commissioner,Todd Hiett,REP,740076,0,0,40,40,
Washington,Corporation Commissioner,Cliff Branan,REP,740076,2,1,37,40,
Washington,U.S. Senate,Evelyn Rogers,REP,740076,0,0,3,3,
Washington,U.S. Senate,Rob Moye,REP,740076,0,1,1,2,
Washington,U.S. Senate,D. Jean Mcbride-Samuels,REP,740076,0,0,1,1,
Washington,U.S. Senate,Jim Inhofe,REP,740076,2,0,72,74,
Washington,U.S. Senate,Erick Paul Wyatt,REP,740076,0,0,4,4,
Washington,U.S. Senate,Andy Craig,REP,740076,0,0,3,3,
Washington,U.S. Senate,T. Shannon,REP,740076,1,0,38,39,
Washington,U.S. Senate,Randy Brogdon,REP,740076,0,0,3,3,
Washington,U.S. Senate,Eric Mccray,REP,740076,0,0,0,0,
Washington,U.S. Senate,Kevin Crow,REP,740076,0,0,1,1,
Washington,U.S. Senate,James Lankford,REP,740076,1,2,35,38,
Washington,U.S. Senate,Jason Weger,REP,740076,0,0,0,0,
Washington,Superintendent of Public Instruction,John Cox,DEM,740077,0,1,17,18,
Washington,Superintendent of Public Instruction,Jack Jr.,DEM,740077,0,0,5,5,
Washington,Superintendent of Public Instruction,Ivan Holmes,DEM,740077,0,0,4,4,
Washington,Superintendent of Public Instruction,Freda Deskin,DEM,740077,0,0,14,14,
Washington,U.S. Senate,Patrick Michael Hayes,DEM,740077,0,0,12,12,
Washington,U.S. Senate,Jim Rogers,DEM,740077,0,0,9,9,
Washington,U.S. Senate,Connie Johnson,DEM,740077,0,1,17,18,
Washington,Governor,Dax Ewbank,REP,740077,1,0,11,12,
Washington,Governor,Chad Moody,REP,740077,0,0,19,19,
Washington,Governor,Mary Fallin,REP,740077,0,0,113,113,
Washington,Superintendent of Public Instruction,Brian Kelly,REP,740077,0,0,31,31,
Washington,Superintendent of Public Instruction,Janet Costello Barresi,REP,740077,0,0,27,27,
Washington,Superintendent of Public Instruction,Joy Hofmeister,REP,740077,1,0,85,86,
Washington,Insurance Commissioner,Bill Viner,REP,740077,1,0,38,39,
Washington,Insurance Commissioner,John Doak,REP,740077,0,0,94,94,
Washington,Corporation Commissioner,Todd Hiett,REP,740077,0,0,64,64,
Washington,Corporation Commissioner,Cliff Branan,REP,740077,1,0,73,74,
Washington,U.S. Senate,Evelyn Rogers,REP,740077,0,0,4,4,
Washington,U.S. Senate,Rob Moye,REP,740077,0,0,2,2,
Washington,U.S. Senate,D. Jean Mcbride-Samuels,REP,740077,0,0,1,1,
Washington,U.S. Senate,Jim Inhofe,REP,740077,1,0,132,133,
Washington,U.S. Senate,Erick Paul Wyatt,REP,740077,0,0,5,5,
Washington,U.S. Senate,Andy Craig,REP,740077,0,0,2,2,
Washington,U.S. Senate,T. Shannon,REP,740077,0,0,64,64,
Washington,U.S. Senate,Randy Brogdon,REP,740077,0,0,18,18,
Washington,U.S. Senate,Eric Mccray,REP,740077,0,0,1,1,
Washington,U.S. Senate,Kevin Crow,REP,740077,0,0,1,1,
Washington,U.S. Senate,James Lankford,REP,740077,1,0,58,59,
Washington,U.S. Senate,Jason Weger,REP,740077,0,0,0,0,
Washington,Superintendent of Public Instruction,John Cox,DEM,740078,0,0,25,25,
Washington,Superintendent of Public Instruction,Jack Jr.,DEM,740078,0,0,6,6,
Washington,Superintendent of Public Instruction,Ivan Holmes,DEM,740078,0,0,5,5,
Washington,Superintendent of Public Instruction,Freda Deskin,DEM,740078,0,0,23,23,
Washington,U.S. Senate,Patrick Michael Hayes,DEM,740078,0,0,7,7,
Washington,U.S. Senate,Jim Rogers,DEM,740078,0,0,23,23,
Washington,U.S. Senate,Connie Johnson,DEM,740078,0,0,25,25,
Washington,Governor,Dax Ewbank,REP,740078,0,2,8,10,
Washington,Governor,Chad Moody,REP,740078,0,0,19,19,
Washington,Governor,Mary Fallin,REP,740078,2,0,76,78,
Washington,Superintendent of Public Instruction,Brian Kelly,REP,740078,0,0,17,17,
Washington,Superintendent of Public Instruction,Janet Costello Barresi,REP,740078,0,2,11,13,
Washington,Superintendent of Public Instruction,Joy Hofmeister,REP,740078,2,0,76,78,
Washington,Insurance Commissioner,Bill Viner,REP,740078,0,2,28,30,
Washington,Insurance Commissioner,John Doak,REP,740078,2,0,69,71,
Washington,Corporation Commissioner,Todd Hiett,REP,740078,2,2,49,53,
Washington,Corporation Commissioner,Cliff Branan,REP,740078,0,0,51,51,
Washington,U.S. Senate,Evelyn Rogers,REP,740078,0,0,2,2,
Washington,U.S. Senate,Rob Moye,REP,740078,0,0,1,1,
Washington,U.S. Senate,D. Jean Mcbride-Samuels,REP,740078,0,0,0,0,
Washington,U.S. Senate,Jim Inhofe,REP,740078,2,2,93,97,
Washington,U.S. Senate,Erick Paul Wyatt,REP,740078,0,0,7,7,
Washington,U.S. Senate,Andy Craig,REP,740078,0,0,1,1,
Washington,U.S. Senate,T. Shannon,REP,740078,0,0,50,50,
Washington,U.S. Senate,Randy Brogdon,REP,740078,0,2,5,7,
Washington,U.S. Senate,Eric Mccray,REP,740078,0,0,0,0,
Washington,U.S. Senate,Kevin Crow,REP,740078,0,0,0,0,
Washington,U.S. Senate,James Lankford,REP,740078,2,0,48,50,
Washington,U.S. Senate,Jason Weger,REP,740078,0,0,1,1,
Washington,State House,Randy Barnett,REP,740078,1,0,36,37,10
Washington,State House,Travis Dunlap,REP,740078,1,2,62,65,10
Washington,Superintendent of Public Instruction,John Cox,DEM,740079,0,0,16,16,
Washington,Superintendent of Public Instruction,Jack Jr.,DEM,740079,0,0,3,3,
Washington,Superintendent of Public Instruction,Ivan Holmes,DEM,740079,0,0,1,1,
Washington,Superintendent of Public Instruction,Freda Deskin,DEM,740079,0,0,15,15,
Washington,U.S. Senate,Patrick Michael Hayes,DEM,740079,0,0,6,6,
Washington,U.S. Senate,Jim Rogers,DEM,740079,0,0,13,13,
Washington,U.S. Senate,Connie Johnson,DEM,740079,0,0,15,15,
Washington,Governor,Dax Ewbank,REP,740079,0,1,16,17,
Washington,Governor,Chad Moody,REP,740079,0,0,10,10,
Washington,Governor,Mary Fallin,REP,740079,1,3,92,96,
Washington,Superintendent of Public Instruction,Brian Kelly,REP,740079,0,0,21,21,
Washington,Superintendent of Public Instruction,Janet Costello Barresi,REP,740079,0,1,18,19,
Washington,Superintendent of Public Instruction,Joy Hofmeister,REP,740079,1,2,81,84,
Washington,Insurance Commissioner,Bill Viner,REP,740079,0,0,30,30,
Washington,Insurance Commissioner,John Doak,REP,740079,1,1,83,85,
Washington,Corporation Commissioner,Todd Hiett,REP,740079,1,2,59,62,
Washington,Corporation Commissioner,Cliff Branan,REP,740079,0,1,54,55,
Washington,U.S. Senate,Evelyn Rogers,REP,740079,0,0,6,6,
Washington,U.S. Senate,Rob Moye,REP,740079,0,0,1,1,
Washington,U.S. Senate,D. Jean Mcbride-Samuels,REP,740079,0,0,0,0,
Washington,U.S. Senate,Jim Inhofe,REP,740079,1,4,104,109,
Washington,U.S. Senate,Erick Paul Wyatt,REP,740079,0,0,7,7,
Washington,U.S. Senate,Andy Craig,REP,740079,0,0,1,1,
Washington,U.S. Senate,T. Shannon,REP,740079,1,4,55,60,
Washington,U.S. Senate,Randy Brogdon,REP,740079,0,0,5,5,
Washington,U.S. Senate,Eric Mccray,REP,740079,0,0,1,1,
Washington,U.S. Senate,Kevin Crow,REP,740079,0,0,6,6,
Washington,U.S. Senate,James Lankford,REP,740079,0,0,52,52,
Washington,U.S. Senate,Jason Weger,REP,740079,0,0,0,0,
Washington,State House,Randy Barnett,REP,740079,1,1,40,42,10
Washington,State House,Travis Dunlap,REP,740079,0,2,77,79,10
Washington,Superintendent of Public Instruction,John Cox,DEM,740711,0,0,1,1,
Washington,Superintendent of Public Instruction,Jack Jr.,DEM,740711,0,0,1,1,
Washington,Superintendent of Public Instruction,Ivan Holmes,DEM,740711,0,0,0,0,
Washington,Superintendent of Public Instruction,Freda Deskin,DEM,740711,2,0,1,3,
Washington,U.S. Senate,Patrick Michael Hayes,DEM,740711,0,0,1,1,
Washington,U.S. Senate,Jim Rogers,DEM,740711,0,0,2,2,
Washington,U.S. Senate,Connie Johnson,DEM,740711,2,0,0,2,
Washington,Governor,Dax Ewbank,REP,740711,0,0,3,3,
Washington,Governor,Chad Moody,REP,740711,0,0,5,5,
Washington,Governor,Mary Fallin,REP,740711,2,3,36,41,
Washington,Superintendent of Public Instruction,Brian Kelly,REP,740711,0,0,6,6,
Washington,Superintendent of Public Instruction,Janet Costello Barresi,REP,740711,2,1,12,15,
Washington,Superintendent of Public Instruction,Joy Hofmeister,REP,740711,0,2,25,27,
Washington,Insurance Commissioner,Bill Viner,REP,740711,0,0,5,5,
Washington,Insurance Commissioner,John Doak,REP,740711,2,3,36,41,
Washington,Corporation Commissioner,Todd Hiett,REP,740711,2,1,19,22,
Washington,Corporation Commissioner,Cliff Branan,REP,740711,0,2,23,25,
Washington,U.S. Senate,Evelyn Rogers,REP,740711,0,0,1,1,
Washington,U.S. Senate,Rob Moye,REP,740711,0,0,0,0,
Washington,U.S. Senate,D. Jean Mcbride-Samuels,REP,740711,0,0,2,2,
Washington,U.S. Senate,Jim Inhofe,REP,740711,2,3,37,42,
Washington,U.S. Senate,Erick Paul Wyatt,REP,740711,0,0,2,2,
Washington,U.S. Senate,Andy Craig,REP,740711,0,0,0,0,
Washington,U.S. Senate,T. Shannon,REP,740711,0,0,13,13,
Washington,U.S. Senate,Randy Brogdon,REP,740711,0,0,2,2,
Washington,U.S. Senate,Eric Mccray,REP,740711,0,0,0,0,
Washington,U.S. Senate,Kevin Crow,REP,740711,0,0,0,0,
Washington,U.S. Senate,James Lankford,REP,740711,2,3,29,34,
Washington,U.S. Senate,Jason Weger,REP,740711,0,0,0,0,
Washington,State House,Randy Barnett,REP,740711,2,0,10,12,10
Washington,State House,Travis Dunlap,REP,740711,0,3,33,36,10
Washita,Superintendent of Public Instruction,John Cox,DEM,750003,0,0,21,21,
Washita,Superintendent of Public Instruction,Jack Jr.,DEM,750003,1,0,2,3,
Washita,Superintendent of Public Instruction,Ivan Holmes,DEM,750003,0,0,0,0,
Washita,Superintendent of Public Instruction,Freda Deskin,DEM,750003,4,0,7,11,
Washita,U.S. Senate,Patrick Michael Hayes,DEM,750003,1,0,8,9,
Washita,U.S. Senate,Jim Rogers,DEM,750003,0,0,13,13,
Washita,U.S. Senate,Connie Johnson,DEM,750003,4,0,10,14,
Washita,Governor,Dax Ewbank,REP,750003,0,0,2,2,
Washita,Governor,Chad Moody,REP,750003,1,0,7,8,
Washita,Governor,Mary Fallin,REP,750003,1,2,22,25,
Washita,Superintendent of Public Instruction,Brian Kelly,REP,750003,0,0,7,7,
Washita,Superintendent of Public Instruction,Janet Costello Barresi,REP,750003,0,0,2,2,
Washita,Superintendent of Public Instruction,Joy Hofmeister,REP,750003,3,2,22,27,
Washita,Insurance Commissioner,Bill Viner,REP,750003,0,1,11,12,
Washita,Insurance Commissioner,John Doak,REP,750003,3,1,20,24,
Washita,Corporation Commissioner,Todd Hiett,REP,750003,2,0,20,22,
Washita,Corporation Commissioner,Cliff Branan,REP,750003,1,2,10,13,
Washita,U.S. Senate,Evelyn Rogers,REP,750003,0,0,1,1,
Washita,U.S. Senate,Rob Moye,REP,750003,0,0,1,1,
Washita,U.S. Senate,D. Jean Mcbride-Samuels,REP,750003,0,0,0,0,
Washita,U.S. Senate,Jim Inhofe,REP,750003,3,2,28,33,
Washita,U.S. Senate,Erick Paul Wyatt,REP,750003,0,0,1,1,
Washita,U.S. Senate,Andy Craig,REP,750003,0,0,1,1,
Washita,U.S. Senate,T. Shannon,REP,750003,1,0,12,13,
Washita,U.S. Senate,Randy Brogdon,REP,750003,0,0,0,0,
Washita,U.S. Senate,Eric Mccray,REP,750003,0,0,0,0,
Washita,U.S. Senate,Kevin Crow,REP,750003,0,0,0,0,
Washita,U.S. Senate,James Lankford,REP,750003,2,2,19,23,
Washita,U.S. Senate,Jason Weger,REP,750003,0,0,0,0,
Washita,U.S. House,Timothy Ray Murray,REP,750003,0,0,3,3,03
Washita,U.S. House,Robert Hubbard,REP,750003,0,0,3,3,03
Washita,U.S. House,Frank Lucas,REP,750003,3,2,24,29,03
Washita,Superintendent of Public Instruction,John Cox,DEM,750004,2,9,128,139,
Washita,Superintendent of Public Instruction,Jack Jr.,DEM,750004,5,5,71,81,
Washita,Superintendent of Public Instruction,Ivan Holmes,DEM,750004,1,3,18,22,
Washita,Superintendent of Public Instruction,Freda Deskin,DEM,750004,2,6,85,93,
Washita,U.S. Senate,Patrick Michael Hayes,DEM,750004,0,5,67,72,
Washita,U.S. Senate,Jim Rogers,DEM,750004,4,7,131,142,
Washita,U.S. Senate,Connie Johnson,DEM,750004,3,9,89,101,
Washita,Governor,Dax Ewbank,REP,750004,0,1,9,10,
Washita,Governor,Chad Moody,REP,750004,1,2,28,31,
Washita,Governor,Mary Fallin,REP,750004,6,7,151,164,
Washita,Superintendent of Public Instruction,Brian Kelly,REP,750004,3,4,46,53,
Washita,Superintendent of Public Instruction,Janet Costello Barresi,REP,750004,1,0,16,17,
Washita,Superintendent of Public Instruction,Joy Hofmeister,REP,750004,2,5,116,123,
Washita,Insurance Commissioner,Bill Viner,REP,750004,3,2,35,40,
Washita,Insurance Commissioner,John Doak,REP,750004,3,8,135,146,
Washita,Corporation Commissioner,Todd Hiett,REP,750004,2,3,94,99,
Washita,Corporation Commissioner,Cliff Branan,REP,750004,4,6,81,91,
Washita,U.S. Senate,Evelyn Rogers,REP,750004,0,0,14,14,
Washita,U.S. Senate,Rob Moye,REP,750004,2,0,2,4,
Washita,U.S. Senate,D. Jean Mcbride-Samuels,REP,750004,1,0,1,2,
Washita,U.S. Senate,Jim Inhofe,REP,750004,4,10,159,173,
Washita,U.S. Senate,Erick Paul Wyatt,REP,750004,0,0,8,8,
Washita,U.S. Senate,Andy Craig,REP,750004,0,0,2,2,
Washita,U.S. Senate,T. Shannon,REP,750004,0,4,78,82,
Washita,U.S. Senate,Randy Brogdon,REP,750004,0,0,3,3,
Washita,U.S. Senate,Eric Mccray,REP,750004,1,0,2,3,
Washita,U.S. Senate,Kevin Crow,REP,750004,0,0,1,1,
Washita,U.S. Senate,James Lankford,REP,750004,6,6,100,112,
Washita,U.S. Senate,Jason Weger,REP,750004,0,0,1,1,
Washita,U.S. House,Timothy Ray Murray,REP,750004,0,0,6,6,03
Washita,U.S. House,Robert Hubbard,REP,750004,1,4,13,18,03
Washita,U.S. House,Frank Lucas,REP,750004,6,6,166,178,03
Washita,Superintendent of Public Instruction,John Cox,DEM,750007,1,2,31,34,
Washita,Superintendent of Public Instruction,Jack Jr.,DEM,750007,0,0,11,11,
Washita,Superintendent of Public Instruction,Ivan Holmes,DEM,750007,0,1,9,10,
Washita,Superintendent of Public Instruction,Freda Deskin,DEM,750007,0,0,19,19,
Washita,U.S. Senate,Patrick Michael Hayes,DEM,750007,1,0,12,13,
Washita,U.S. Senate,Jim Rogers,DEM,750007,0,3,33,36,
Washita,U.S. Senate,Connie Johnson,DEM,750007,0,0,21,21,
Washita,Governor,Dax Ewbank,REP,750007,0,0,3,3,
Washita,Governor,Chad Moody,REP,750007,0,1,5,6,
Washita,Governor,Mary Fallin,REP,750007,1,11,104,116,
Washita,Superintendent of Public Instruction,Brian Kelly,REP,750007,1,7,28,36,
Washita,Superintendent of Public Instruction,Janet Costello Barresi,REP,750007,0,0,12,12,
Washita,Superintendent of Public Instruction,Joy Hofmeister,REP,750007,0,5,69,74,
Washita,Insurance Commissioner,Bill Viner,REP,750007,1,1,26,28,
Washita,Insurance Commissioner,John Doak,REP,750007,0,9,59,68,
Washita,Corporation Commissioner,Todd Hiett,REP,750007,0,6,56,62,
Washita,Corporation Commissioner,Cliff Branan,REP,750007,0,5,37,42,
Washita,U.S. Senate,Evelyn Rogers,REP,750007,0,0,5,5,
Washita,U.S. Senate,Rob Moye,REP,750007,0,0,1,1,
Washita,U.S. Senate,D. Jean Mcbride-Samuels,REP,750007,0,0,0,0,
Washita,U.S. Senate,Jim Inhofe,REP,750007,2,12,97,111,
Washita,U.S. Senate,Erick Paul Wyatt,REP,750007,0,0,7,7,
Washita,U.S. Senate,Andy Craig,REP,750007,0,0,0,0,
Washita,U.S. Senate,T. Shannon,REP,750007,1,4,39,44,
Washita,U.S. Senate,Randy Brogdon,REP,750007,0,0,1,1,
Washita,U.S. Senate,Eric Mccray,REP,750007,0,0,0,0,
Washita,U.S. Senate,Kevin Crow,REP,750007,0,0,1,1,
Washita,U.S. Senate,James Lankford,REP,750007,0,8,68,76,
Washita,U.S. Senate,Jason Weger,REP,750007,0,0,1,1,
Washita,U.S. House,Timothy Ray Murray,REP,750007,0,0,1,1,03
Washita,U.S. House,Robert Hubbard,REP,750007,0,0,2,2,03
Washita,U.S. House,Frank Lucas,REP,750007,2,12,110,124,03
Washita,Superintendent of Public Instruction,John Cox,DEM,750009,2,3,15,20,
Washita,Superintendent of Public Instruction,Jack Jr.,DEM,750009,0,0,13,13,
Washita,Superintendent of Public Instruction,Ivan Holmes,DEM,750009,0,0,6,6,
Washita,Superintendent of Public Instruction,Freda Deskin,DEM,750009,0,1,26,27,
Washita,U.S. Senate,Patrick Michael Hayes,DEM,750009,1,0,25,26,
Washita,U.S. Senate,Jim Rogers,DEM,750009,1,1,11,13,
Washita,U.S. Senate,Connie Johnson,DEM,750009,0,2,20,22,
Washita,Governor,Dax Ewbank,REP,750009,0,0,7,7,
Washita,Governor,Chad Moody,REP,750009,0,0,6,6,
Washita,Governor,Mary Fallin,REP,750009,0,3,21,24,
Washita,Superintendent of Public Instruction,Brian Kelly,REP,750009,0,1,6,7,
Washita,Superintendent of Public Instruction,Janet Costello Barresi,REP,750009,0,1,7,8,
Washita,Superintendent of Public Instruction,Joy Hofmeister,REP,750009,0,1,21,22,
Washita,Insurance Commissioner,Bill Viner,REP,750009,0,0,7,7,
Washita,Insurance Commissioner,John Doak,REP,750009,0,3,25,28,
Washita,Corporation Commissioner,Todd Hiett,REP,750009,0,3,17,20,
Washita,Corporation Commissioner,Cliff Branan,REP,750009,0,0,15,15,
Washita,U.S. Senate,Evelyn Rogers,REP,750009,0,0,3,3,
Washita,U.S. Senate,Rob Moye,REP,750009,0,0,1,1,
Washita,U.S. Senate,D. Jean Mcbride-Samuels,REP,750009,0,0,1,1,
Washita,U.S. Senate,Jim Inhofe,REP,750009,0,3,28,31,
Washita,U.S. Senate,Erick Paul Wyatt,REP,750009,0,0,2,2,
Washita,U.S. Senate,Andy Craig,REP,750009,0,0,0,0,
Washita,U.S. Senate,T. Shannon,REP,750009,0,1,12,13,
Washita,U.S. Senate,Randy Brogdon,REP,750009,0,0,0,0,
Washita,U.S. Senate,Eric Mccray,REP,750009,0,0,1,1,
Washita,U.S. Senate,Kevin Crow,REP,750009,0,0,0,0,
Washita,U.S. Senate,James Lankford,REP,750009,0,2,21,23,
Washita,U.S. Senate,Jason Weger,REP,750009,0,0,0,0,
Washita,U.S. House,Timothy Ray Murray,REP,750009,0,0,2,2,03
Washita,U.S. House,Robert Hubbard,REP,750009,0,1,5,6,03
Washita,U.S. House,Frank Lucas,REP,750009,0,2,28,30,03
Washita,Superintendent of Public Instruction,John Cox,DEM,750012,0,0,25,25,
Washita,Superintendent of Public Instruction,Jack Jr.,DEM,750012,0,0,6,6,
Washita,Superintendent of Public Instruction,Ivan Holmes,DEM,750012,0,0,2,2,
Washita,Superintendent of Public Instruction,Freda Deskin,DEM,750012,1,0,17,18,
Washita,U.S. Senate,Patrick Michael Hayes,DEM,750012,0,0,10,10,
Washita,U.S. Senate,Jim Rogers,DEM,750012,1,0,22,23,
Washita,U.S. Senate,Connie Johnson,DEM,750012,0,0,15,15,
Washita,Governor,Dax Ewbank,REP,750012,0,0,7,7,
Washita,Governor,Chad Moody,REP,750012,0,1,9,10,
Washita,Governor,Mary Fallin,REP,750012,1,2,54,57,
Washita,Superintendent of Public Instruction,Brian Kelly,REP,750012,0,0,19,19,
Washita,Superintendent of Public Instruction,Janet Costello Barresi,REP,750012,0,1,11,12,
Washita,Superintendent of Public Instruction,Joy Hofmeister,REP,750012,1,2,39,42,
Washita,Insurance Commissioner,Bill Viner,REP,750012,0,1,18,19,
Washita,Insurance Commissioner,John Doak,REP,750012,1,2,49,52,
Washita,Corporation Commissioner,Todd Hiett,REP,750012,1,3,37,41,
Washita,Corporation Commissioner,Cliff Branan,REP,750012,0,0,28,28,
Washita,U.S. Senate,Evelyn Rogers,REP,750012,0,0,1,1,
Washita,U.S. Senate,Rob Moye,REP,750012,1,0,0,1,
Washita,U.S. Senate,D. Jean Mcbride-Samuels,REP,750012,0,0,1,1,
Washita,U.S. Senate,Jim Inhofe,REP,750012,0,3,61,64,
Washita,U.S. Senate,Erick Paul Wyatt,REP,750012,0,0,4,4,
Washita,U.S. Senate,Andy Craig,REP,750012,0,0,1,1,
Washita,U.S. Senate,T. Shannon,REP,750012,0,0,25,25,
Washita,U.S. Senate,Randy Brogdon,REP,750012,0,0,0,0,
Washita,U.S. Senate,Eric Mccray,REP,750012,0,1,0,1,
Washita,U.S. Senate,Kevin Crow,REP,750012,0,0,0,0,
Washita,U.S. Senate,James Lankford,REP,750012,1,2,43,46,
Washita,U.S. Senate,Jason Weger,REP,750012,0,0,0,0,
Washita,U.S. House,Timothy Ray Murray,REP,750012,0,0,1,1,03
Washita,U.S. House,Robert Hubbard,REP,750012,0,1,7,8,03
Washita,U.S. House,Frank Lucas,REP,750012,1,2,60,63,03
Washita,Superintendent of Public Instruction,John Cox,DEM,750014,0,0,76,76,
Washita,Superintendent of Public Instruction,Jack Jr.,DEM,750014,0,0,16,16,
Washita,Superintendent of Public Instruction,Ivan Holmes,DEM,750014,0,0,15,15,
Washita,Superintendent of Public Instruction,Freda Deskin,DEM,750014,0,0,40,40,
Washita,U.S. Senate,Patrick Michael Hayes,DEM,750014,0,0,37,37,
Washita,U.S. Senate,Jim Rogers,DEM,750014,0,0,57,57,
Washita,U.S. Senate,Connie Johnson,DEM,750014,0,0,44,44,
Washita,Governor,Dax Ewbank,REP,750014,0,0,10,10,
Washita,Governor,Chad Moody,REP,750014,2,0,10,12,
Washita,Governor,Mary Fallin,REP,750014,0,3,62,65,
Washita,Superintendent of Public Instruction,Brian Kelly,REP,750014,1,1,25,27,
Washita,Superintendent of Public Instruction,Janet Costello Barresi,REP,750014,0,0,11,11,
Washita,Superintendent of Public Instruction,Joy Hofmeister,REP,750014,1,2,49,52,
Washita,Insurance Commissioner,Bill Viner,REP,750014,1,0,15,16,
Washita,Insurance Commissioner,John Doak,REP,750014,1,3,64,68,
Washita,Corporation Commissioner,Todd Hiett,REP,750014,1,1,38,40,
Washita,Corporation Commissioner,Cliff Branan,REP,750014,1,2,42,45,
Washita,U.S. Senate,Evelyn Rogers,REP,750014,0,0,3,3,
Washita,U.S. Senate,Rob Moye,REP,750014,0,0,3,3,
Washita,U.S. Senate,D. Jean Mcbride-Samuels,REP,750014,0,0,1,1,
Washita,U.S. Senate,Jim Inhofe,REP,750014,2,2,72,76,
Washita,U.S. Senate,Erick Paul Wyatt,REP,750014,0,1,5,6,
Washita,U.S. Senate,Andy Craig,REP,750014,0,0,1,1,
Washita,U.S. Senate,T. Shannon,REP,750014,0,1,29,30,
Washita,U.S. Senate,Randy Brogdon,REP,750014,0,0,0,0,
Washita,U.S. Senate,Eric Mccray,REP,750014,0,0,0,0,
Washita,U.S. Senate,Kevin Crow,REP,750014,1,0,1,2,
Washita,U.S. Senate,James Lankford,REP,750014,1,2,52,55,
Washita,U.S. Senate,Jason Weger,REP,750014,0,0,2,2,
Washita,U.S. House,Timothy Ray Murray,REP,750014,0,0,7,7,03
Washita,U.S. House,Robert Hubbard,REP,750014,0,1,7,8,03
Washita,U.S. House,Frank Lucas,REP,750014,2,2,71,75,03
Washita,Superintendent of Public Instruction,John Cox,DEM,750016,2,0,51,53,
Washita,Superintendent of Public Instruction,Jack Jr.,DEM,750016,1,0,20,21,
Washita,Superintendent of Public Instruction,Ivan Holmes,DEM,750016,1,0,13,14,
Washita,Superintendent of Public Instruction,Freda Deskin,DEM,750016,1,1,47,49,
Washita,U.S. Senate,Patrick Michael Hayes,DEM,750016,2,1,28,31,
Washita,U.S. Senate,Jim Rogers,DEM,750016,2,0,42,44,
Washita,U.S. Senate,Connie Johnson,DEM,750016,1,0,54,55,
Washita,Governor,Dax Ewbank,REP,750016,0,1,7,8,
Washita,Governor,Chad Moody,REP,750016,0,1,19,20,
Washita,Governor,Mary Fallin,REP,750016,7,1,46,54,
Washita,Superintendent of Public Instruction,Brian Kelly,REP,750016,0,0,12,12,
Washita,Superintendent of Public Instruction,Janet Costello Barresi,REP,750016,2,0,11,13,
Washita,Superintendent of Public Instruction,Joy Hofmeister,REP,750016,5,3,49,57,
Washita,Insurance Commissioner,Bill Viner,REP,750016,2,0,13,15,
Washita,Insurance Commissioner,John Doak,REP,750016,5,3,54,62,
Washita,Corporation Commissioner,Todd Hiett,REP,750016,7,0,34,41,
Washita,Corporation Commissioner,Cliff Branan,REP,750016,0,2,33,35,
Washita,U.S. Senate,Evelyn Rogers,REP,750016,0,0,7,7,
Washita,U.S. Senate,Rob Moye,REP,750016,0,0,4,4,
Washita,U.S. Senate,D. Jean Mcbride-Samuels,REP,750016,0,0,1,1,
Washita,U.S. Senate,Jim Inhofe,REP,750016,7,3,57,67,
Washita,U.S. Senate,Erick Paul Wyatt,REP,750016,0,0,3,3,
Washita,U.S. Senate,Andy Craig,REP,750016,0,0,0,0,
Washita,U.S. Senate,T. Shannon,REP,750016,2,0,33,35,
Washita,U.S. Senate,Randy Brogdon,REP,750016,0,0,1,1,
Washita,U.S. Senate,Eric Mccray,REP,750016,0,0,0,0,
Washita,U.S. Senate,Kevin Crow,REP,750016,0,0,2,2,
Washita,U.S. Senate,James Lankford,REP,750016,5,3,36,44,
Washita,U.S. Senate,Jason Weger,REP,750016,0,0,1,1,
Washita,U.S. House,Timothy Ray Murray,REP,750016,0,0,5,5,03
Washita,U.S. House,Robert Hubbard,REP,750016,0,0,7,7,03
Washita,U.S. House,Frank Lucas,REP,750016,7,3,59,69,03
Washita,Superintendent of Public Instruction,John Cox,DEM,750017,0,3,28,31,
Washita,Superintendent of Public Instruction,Jack Jr.,DEM,750017,0,0,11,11,
Washita,Superintendent of Public Instruction,Ivan Holmes,DEM,750017,0,0,5,5,
Washita,Superintendent of Public Instruction,Freda Deskin,DEM,750017,0,2,28,30,
Washita,U.S. Senate,Patrick Michael Hayes,DEM,750017,0,2,22,24,
Washita,U.S. Senate,Jim Rogers,DEM,750017,0,1,24,25,
Washita,U.S. Senate,Connie Johnson,DEM,750017,0,2,21,23,
Washita,Governor,Dax Ewbank,REP,750017,0,0,9,9,
Washita,Governor,Chad Moody,REP,750017,0,1,6,7,
Washita,Governor,Mary Fallin,REP,750017,0,1,23,24,
Washita,Superintendent of Public Instruction,Brian Kelly,REP,750017,0,0,8,8,
Washita,Superintendent of Public Instruction,Janet Costello Barresi,REP,750017,0,0,0,0,
Washita,Superintendent of Public Instruction,Joy Hofmeister,REP,750017,0,2,29,31,
Washita,Insurance Commissioner,Bill Viner,REP,750017,0,1,6,7,
Washita,Insurance Commissioner,John Doak,REP,750017,0,1,27,28,
Washita,Corporation Commissioner,Todd Hiett,REP,750017,0,2,20,22,
Washita,Corporation Commissioner,Cliff Branan,REP,750017,0,0,13,13,
Washita,U.S. Senate,Evelyn Rogers,REP,750017,0,0,3,3,
Washita,U.S. Senate,Rob Moye,REP,750017,0,0,1,1,
Washita,U.S. Senate,D. Jean Mcbride-Samuels,REP,750017,0,0,0,0,
Washita,U.S. Senate,Jim Inhofe,REP,750017,0,2,25,27,
Washita,U.S. Senate,Erick Paul Wyatt,REP,750017,0,0,6,6,
Washita,U.S. Senate,Andy Craig,REP,750017,0,0,0,0,
Washita,U.S. Senate,T. Shannon,REP,750017,0,2,13,15,
Washita,U.S. Senate,Randy Brogdon,REP,750017,0,0,2,2,
Washita,U.S. Senate,Eric Mccray,REP,750017,0,0,0,0,
Washita,U.S. Senate,Kevin Crow,REP,750017,0,0,1,1,
Washita,U.S. Senate,James Lankford,REP,750017,0,0,17,17,
Washita,U.S. Senate,Jason Weger,REP,750017,0,0,2,2,
Washita,U.S. House,Timothy Ray Murray,REP,750017,0,0,3,3,03
Washita,U.S. House,Robert Hubbard,REP,750017,0,1,3,4,03
Washita,U.S. House,Frank Lucas,REP,750017,0,1,30,31,03
Washita,Superintendent of Public Instruction,John Cox,DEM,750018,1,1,56,58,
Washita,Superintendent of Public Instruction,Jack Jr.,DEM,750018,0,0,6,6,
Washita,Superintendent of Public Instruction,Ivan Holmes,DEM,750018,0,0,8,8,
Washita,Superintendent of Public Instruction,Freda Deskin,DEM,750018,0,0,60,60,
Washita,U.S. Senate,Patrick Michael Hayes,DEM,750018,0,1,34,35,
Washita,U.S. Senate,Jim Rogers,DEM,750018,0,0,54,54,
Washita,U.S. Senate,Connie Johnson,DEM,750018,1,0,36,37,
Washita,Governor,Dax Ewbank,REP,750018,0,1,30,31,
Washita,Governor,Chad Moody,REP,750018,0,2,24,26,
Washita,Governor,Mary Fallin,REP,750018,4,2,92,98,
Washita,Superintendent of Public Instruction,Brian Kelly,REP,750018,0,1,40,41,
Washita,Superintendent of Public Instruction,Janet Costello Barresi,REP,750018,0,0,2,2,
Washita,Superintendent of Public Instruction,Joy Hofmeister,REP,750018,5,4,104,113,
Washita,Insurance Commissioner,Bill Viner,REP,750018,2,0,26,28,
Washita,Insurance Commissioner,John Doak,REP,750018,2,5,112,119,
Washita,Corporation Commissioner,Todd Hiett,REP,750018,1,3,68,72,
Washita,Corporation Commissioner,Cliff Branan,REP,750018,3,2,72,77,
Washita,U.S. Senate,Evelyn Rogers,REP,750018,0,0,8,8,
Washita,U.S. Senate,Rob Moye,REP,750018,0,0,6,6,
Washita,U.S. Senate,D. Jean Mcbride-Samuels,REP,750018,0,0,2,2,
Washita,U.S. Senate,Jim Inhofe,REP,750018,5,4,120,129,
Washita,U.S. Senate,Erick Paul Wyatt,REP,750018,0,1,8,9,
Washita,U.S. Senate,Andy Craig,REP,750018,0,0,0,0,
Washita,U.S. Senate,T. Shannon,REP,750018,1,2,64,67,
Washita,U.S. Senate,Randy Brogdon,REP,750018,1,0,2,3,
Washita,U.S. Senate,Eric Mccray,REP,750018,0,0,8,8,
Washita,U.S. Senate,Kevin Crow,REP,750018,0,0,2,2,
Washita,U.S. Senate,James Lankford,REP,750018,3,3,72,78,
Washita,U.S. Senate,Jason Weger,REP,750018,0,0,0,0,
Washita,U.S. House,Timothy Ray Murray,REP,750018,0,0,10,10,03
Washita,U.S. House,Robert Hubbard,REP,750018,0,1,6,7,03
Washita,U.S. House,Frank Lucas,REP,750018,5,4,124,133,03
Washita,Superintendent of Public Instruction,John Cox,DEM,750019,0,0,47,47,
Washita,Superintendent of Public Instruction,Jack Jr.,DEM,750019,0,0,27,27,
Washita,Superintendent of Public Instruction,Ivan Holmes,DEM,750019,0,1,16,17,
Washita,Superintendent of Public Instruction,Freda Deskin,DEM,750019,0,0,46,46,
Washita,U.S. Senate,Patrick Michael Hayes,DEM,750019,0,0,28,28,
Washita,U.S. Senate,Jim Rogers,DEM,750019,0,1,59,60,
Washita,U.S. Senate,Connie Johnson,DEM,750019,0,0,45,45,
Washita,Governor,Dax Ewbank,REP,750019,1,1,9,11,
Washita,Governor,Chad Moody,REP,750019,1,1,23,25,
Washita,Governor,Mary Fallin,REP,750019,3,2,48,53,
Washita,Superintendent of Public Instruction,Brian Kelly,REP,750019,2,0,12,14,
Washita,Superintendent of Public Instruction,Janet Costello Barresi,REP,750019,0,0,5,5,
Washita,Superintendent of Public Instruction,Joy Hofmeister,REP,750019,3,4,63,70,
Washita,Insurance Commissioner,Bill Viner,REP,750019,1,0,19,20,
Washita,Insurance Commissioner,John Doak,REP,750019,2,4,57,63,
Washita,Corporation Commissioner,Todd Hiett,REP,750019,1,3,38,42,
Washita,Corporation Commissioner,Cliff Branan,REP,750019,2,1,35,38,
Washita,U.S. Senate,Evelyn Rogers,REP,750019,0,0,4,4,
Washita,U.S. Senate,Rob Moye,REP,750019,0,0,2,2,
Washita,U.S. Senate,D. Jean Mcbride-Samuels,REP,750019,0,0,2,2,
Washita,U.S. Senate,Jim Inhofe,REP,750019,5,4,66,75,
Washita,U.S. Senate,Erick Paul Wyatt,REP,750019,0,0,5,5,
Washita,U.S. Senate,Andy Craig,REP,750019,0,0,1,1,
Washita,U.S. Senate,T. Shannon,REP,750019,4,0,24,28,
Washita,U.S. Senate,Randy Brogdon,REP,750019,0,0,0,0,
Washita,U.S. Senate,Eric Mccray,REP,750019,0,0,1,1,
Washita,U.S. Senate,Kevin Crow,REP,750019,0,0,0,0,
Washita,U.S. Senate,James Lankford,REP,750019,1,4,51,56,
Washita,U.S. Senate,Jason Weger,REP,750019,0,0,1,1,
Washita,U.S. House,Timothy Ray Murray,REP,750019,0,0,4,4,03
Washita,U.S. House,Robert Hubbard,REP,750019,0,1,3,4,03
Washita,U.S. House,Frank Lucas,REP,750019,5,3,70,78,03
Washita,Superintendent of Public Instruction,John Cox,DEM,750020,0,1,33,34,
Washita,Superintendent of Public Instruction,Jack Jr.,DEM,750020,0,0,9,9,
Washita,Superintendent of Public Instruction,Ivan Holmes,DEM,750020,0,0,5,5,
Washita,Superintendent of Public Instruction,Freda Deskin,DEM,750020,4,1,30,35,
Washita,U.S. Senate,Patrick Michael Hayes,DEM,750020,0,0,7,7,
Washita,U.S. Senate,Jim Rogers,DEM,750020,0,1,30,31,
Washita,U.S. Senate,Connie Johnson,DEM,750020,4,0,31,35,
Washita,Governor,Dax Ewbank,REP,750020,0,0,3,3,
Washita,Governor,Chad Moody,REP,750020,0,0,7,7,
Washita,Governor,Mary Fallin,REP,750020,0,0,29,29,
Washita,Superintendent of Public Instruction,Brian Kelly,REP,750020,0,0,9,9,
Washita,Superintendent of Public Instruction,Janet Costello Barresi,REP,750020,0,0,6,6,
Washita,Superintendent of Public Instruction,Joy Hofmeister,REP,750020,0,0,24,24,
Washita,Insurance Commissioner,Bill Viner,REP,750020,0,0,13,13,
Washita,Insurance Commissioner,John Doak,REP,750020,0,0,24,24,
Washita,Corporation Commissioner,Todd Hiett,REP,750020,0,0,19,19,
Washita,Corporation Commissioner,Cliff Branan,REP,750020,0,0,19,19,
Washita,U.S. Senate,Evelyn Rogers,REP,750020,0,0,1,1,
Washita,U.S. Senate,Rob Moye,REP,750020,0,0,0,0,
Washita,U.S. Senate,D. Jean Mcbride-Samuels,REP,750020,0,0,1,1,
Washita,U.S. Senate,Jim Inhofe,REP,750020,0,0,36,36,
Washita,U.S. Senate,Erick Paul Wyatt,REP,750020,0,0,1,1,
Washita,U.S. Senate,Andy Craig,REP,750020,0,0,1,1,
Washita,U.S. Senate,T. Shannon,REP,750020,0,0,15,15,
Washita,U.S. Senate,Randy Brogdon,REP,750020,0,0,0,0,
Washita,U.S. Senate,Eric Mccray,REP,750020,0,0,0,0,
Washita,U.S. Senate,Kevin Crow,REP,750020,0,0,1,1,
Washita,U.S. Senate,James Lankford,REP,750020,0,0,24,24,
Washita,U.S. Senate,Jason Weger,REP,750020,0,0,0,0,
Washita,U.S. House,Timothy Ray Murray,REP,750020,0,0,2,2,03
Washita,U.S. House,Robert Hubbard,REP,750020,0,0,5,5,03
Washita,U.S. House,Frank Lucas,REP,750020,0,0,33,33,03
Washita,Superintendent of Public Instruction,John Cox,DEM,750030,0,2,62,64,
Washita,Superintendent of Public Instruction,Jack Jr.,DEM,750030,0,1,27,28,
Washita,Superintendent of Public Instruction,Ivan Holmes,DEM,750030,0,0,11,11,
Washita,Superintendent of Public Instruction,Freda Deskin,DEM,750030,0,1,44,45,
Washita,U.S. Senate,Patrick Michael Hayes,DEM,750030,0,1,25,26,
Washita,U.S. Senate,Jim Rogers,DEM,750030,1,3,64,68,
Washita,U.S. Senate,Connie Johnson,DEM,750030,0,0,50,50,
Washita,Governor,Dax Ewbank,REP,750030,0,1,8,9,
Washita,Governor,Chad Moody,REP,750030,0,1,10,11,
Washita,Governor,Mary Fallin,REP,750030,2,7,38,47,
Washita,Superintendent of Public Instruction,Brian Kelly,REP,750030,0,2,10,12,
Washita,Superintendent of Public Instruction,Janet Costello Barresi,REP,750030,0,3,5,8,
Washita,Superintendent of Public Instruction,Joy Hofmeister,REP,750030,2,4,42,48,
Washita,Insurance Commissioner,Bill Viner,REP,750030,0,1,8,9,
Washita,Insurance Commissioner,John Doak,REP,750030,2,7,45,54,
Washita,Corporation Commissioner,Todd Hiett,REP,750030,1,7,36,44,
Washita,Corporation Commissioner,Cliff Branan,REP,750030,1,2,17,20,
Washita,U.S. Senate,Evelyn Rogers,REP,750030,0,0,4,4,
Washita,U.S. Senate,Rob Moye,REP,750030,0,0,0,0,
Washita,U.S. Senate,D. Jean Mcbride-Samuels,REP,750030,0,0,0,0,
Washita,U.S. Senate,Jim Inhofe,REP,750030,2,9,49,60,
Washita,U.S. Senate,Erick Paul Wyatt,REP,750030,0,0,3,3,
Washita,U.S. Senate,Andy Craig,REP,750030,0,0,1,1,
Washita,U.S. Senate,T. Shannon,REP,750030,0,5,12,17,
Washita,U.S. Senate,Randy Brogdon,REP,750030,0,0,1,1,
Washita,U.S. Senate,Eric Mccray,REP,750030,0,0,0,0,
Washita,U.S. Senate,Kevin Crow,REP,750030,0,0,1,1,
Washita,U.S. Senate,James Lankford,REP,750030,2,4,42,48,
Washita,U.S. Senate,Jason Weger,REP,750030,0,0,0,0,
Washita,U.S. House,Timothy Ray Murray,REP,750030,0,0,3,3,03
Washita,U.S. House,Robert Hubbard,REP,750030,0,0,3,3,03
Washita,U.S. House,Frank Lucas,REP,750030,2,9,50,61,03
Woods,Superintendent of Public Instruction,John Cox,DEM,760001,0,14,47,61,
Woods,Superintendent of Public Instruction,Jack Jr.,DEM,760001,1,3,16,20,
Woods,Superintendent of Public Instruction,Ivan Holmes,DEM,760001,0,4,18,22,
Woods,Superintendent of Public Instruction,Freda Deskin,DEM,760001,3,6,32,41,
Woods,U.S. Senate,Patrick Michael Hayes,DEM,760001,0,9,25,34,
Woods,U.S. Senate,Jim Rogers,DEM,760001,2,9,48,59,
Woods,U.S. Senate,Connie Johnson,DEM,760001,2,9,39,50,
Woods,Governor,Dax Ewbank,REP,760001,1,13,105,119,
Woods,Governor,Chad Moody,REP,760001,0,4,51,55,
Woods,Governor,Mary Fallin,REP,760001,2,32,169,203,
Woods,Superintendent of Public Instruction,Brian Kelly,REP,760001,0,13,80,93,
Woods,Superintendent of Public Instruction,Janet Costello Barresi,REP,760001,1,6,39,46,
Woods,Superintendent of Public Instruction,Joy Hofmeister,REP,760001,2,30,203,235,
Woods,Insurance Commissioner,Bill Viner,REP,760001,0,12,85,97,
Woods,Insurance Commissioner,John Doak,REP,760001,3,37,226,266,
Woods,Corporation Commissioner,Todd Hiett,REP,760001,2,28,184,214,
Woods,Corporation Commissioner,Cliff Branan,REP,760001,1,21,128,150,
Woods,U.S. Senate,Evelyn Rogers,REP,760001,0,4,11,15,
Woods,U.S. Senate,Rob Moye,REP,760001,0,1,7,8,
Woods,U.S. Senate,D. Jean Mcbride-Samuels,REP,760001,0,0,6,6,
Woods,U.S. Senate,Jim Inhofe,REP,760001,3,43,270,316,
Woods,U.S. Senate,Erick Paul Wyatt,REP,760001,0,2,28,30,
Woods,U.S. Senate,Andy Craig,REP,760001,0,0,1,1,
Woods,U.S. Senate,T. Shannon,REP,760001,1,17,102,120,
Woods,U.S. Senate,Randy Brogdon,REP,760001,0,2,14,16,
Woods,U.S. Senate,Eric Mccray,REP,760001,0,0,9,9,
Woods,U.S. Senate,Kevin Crow,REP,760001,0,0,7,7,
Woods,U.S. Senate,James Lankford,REP,760001,2,30,191,223,
Woods,U.S. Senate,Jason Weger,REP,760001,0,0,2,2,
Woods,U.S. House,Timothy Ray Murray,REP,760001,0,2,21,23,03
Woods,U.S. House,Robert Hubbard,REP,760001,1,8,40,49,03
Woods,U.S. House,Frank Lucas,REP,760001,2,40,264,306,03
Woods,Superintendent of Public Instruction,John Cox,DEM,760002,0,1,32,33,
Woods,Superintendent of Public Instruction,Jack Jr.,DEM,760002,0,0,13,13,
Woods,Superintendent of Public Instruction,Ivan Holmes,DEM,760002,1,0,5,6,
Woods,Superintendent of Public Instruction,Freda Deskin,DEM,760002,0,0,32,32,
Woods,U.S. Senate,Patrick Michael Hayes,DEM,760002,0,0,20,20,
Woods,U.S. Senate,Jim Rogers,DEM,760002,1,0,31,32,
Woods,U.S. Senate,Connie Johnson,DEM,760002,0,1,32,33,
Woods,Governor,Dax Ewbank,REP,760002,1,2,32,35,
Woods,Governor,Chad Moody,REP,760002,0,2,35,37,
Woods,Governor,Mary Fallin,REP,760002,3,12,182,197,
Woods,Superintendent of Public Instruction,Brian Kelly,REP,760002,0,6,65,71,
Woods,Superintendent of Public Instruction,Janet Costello Barresi,REP,760002,0,0,29,29,
Woods,Superintendent of Public Instruction,Joy Hofmeister,REP,760002,4,10,148,162,
Woods,Insurance Commissioner,Bill Viner,REP,760002,2,2,49,53,
Woods,Insurance Commissioner,John Doak,REP,760002,2,14,188,204,
Woods,Corporation Commissioner,Todd Hiett,REP,760002,2,12,136,150,
Woods,Corporation Commissioner,Cliff Branan,REP,760002,2,4,98,104,
Woods,U.S. Senate,Evelyn Rogers,REP,760002,1,0,5,6,
Woods,U.S. Senate,Rob Moye,REP,760002,0,0,3,3,
Woods,U.S. Senate,D. Jean Mcbride-Samuels,REP,760002,0,0,2,2,
Woods,U.S. Senate,Jim Inhofe,REP,760002,3,15,222,240,
Woods,U.S. Senate,Erick Paul Wyatt,REP,760002,0,1,15,16,
Woods,U.S. Senate,Andy Craig,REP,760002,0,0,0,0,
Woods,U.S. Senate,T. Shannon,REP,760002,2,5,104,111,
Woods,U.S. Senate,Randy Brogdon,REP,760002,0,1,1,2,
Woods,U.S. Senate,Eric Mccray,REP,760002,0,0,8,8,
Woods,U.S. Senate,Kevin Crow,REP,760002,0,0,11,11,
Woods,U.S. Senate,James Lankford,REP,760002,2,10,119,131,
Woods,U.S. Senate,Jason Weger,REP,760002,0,0,0,0,
Woods,U.S. House,Timothy Ray Murray,REP,760002,0,1,11,12,03
Woods,U.S. House,Robert Hubbard,REP,760002,0,3,21,24,03
Woods,U.S. House,Frank Lucas,REP,760002,4,12,214,230,03
Woods,Superintendent of Public Instruction,John Cox,DEM,760003,1,2,18,21,
Woods,Superintendent of Public Instruction,Jack Jr.,DEM,760003,0,0,11,11,
Woods,Superintendent of Public Instruction,Ivan Holmes,DEM,760003,0,2,4,6,
Woods,Superintendent of Public Instruction,Freda Deskin,DEM,760003,2,2,23,27,
Woods,U.S. Senate,Patrick Michael Hayes,DEM,760003,0,0,9,9,
Woods,U.S. Senate,Jim Rogers,DEM,760003,3,2,20,25,
Woods,U.S. Senate,Connie Johnson,DEM,760003,0,4,25,29,
Woods,Governor,Dax Ewbank,REP,760003,2,1,33,36,
Woods,Governor,Chad Moody,REP,760003,0,0,22,22,
Woods,Governor,Mary Fallin,REP,760003,8,4,75,87,
Woods,Superintendent of Public Instruction,Brian Kelly,REP,760003,7,1,36,44,
Woods,Superintendent of Public Instruction,Janet Costello Barresi,REP,760003,0,0,14,14,
Woods,Superintendent of Public Instruction,Joy Hofmeister,REP,760003,3,4,81,88,
Woods,Insurance Commissioner,Bill Viner,REP,760003,2,1,19,22,
Woods,Insurance Commissioner,John Doak,REP,760003,7,4,105,116,
Woods,Corporation Commissioner,Todd Hiett,REP,760003,4,3,64,71,
Woods,Corporation Commissioner,Cliff Branan,REP,760003,5,2,63,70,
Woods,U.S. Senate,Evelyn Rogers,REP,760003,0,0,7,7,
Woods,U.S. Senate,Rob Moye,REP,760003,0,0,3,3,
Woods,U.S. Senate,D. Jean Mcbride-Samuels,REP,760003,0,0,2,2,
Woods,U.S. Senate,Jim Inhofe,REP,760003,9,4,113,126,
Woods,U.S. Senate,Erick Paul Wyatt,REP,760003,1,1,5,7,
Woods,U.S. Senate,Andy Craig,REP,760003,1,1,3,5,
Woods,U.S. Senate,T. Shannon,REP,760003,1,1,50,52,
Woods,U.S. Senate,Randy Brogdon,REP,760003,0,0,1,1,
Woods,U.S. Senate,Eric Mccray,REP,760003,0,0,2,2,
Woods,U.S. Senate,Kevin Crow,REP,760003,0,0,2,2,
Woods,U.S. Senate,James Lankford,REP,760003,8,3,72,83,
Woods,U.S. Senate,Jason Weger,REP,760003,0,0,2,2,
Woods,U.S. House,Timothy Ray Murray,REP,760003,1,0,12,13,03
Woods,U.S. House,Robert Hubbard,REP,760003,1,1,14,16,03
Woods,U.S. House,Frank Lucas,REP,760003,8,4,105,117,03
Woods,Superintendent of Public Instruction,John Cox,DEM,760004,1,1,6,8,
Woods,Superintendent of Public Instruction,Jack Jr.,DEM,760004,0,0,4,4,
Woods,Superintendent of Public Instruction,Ivan Holmes,DEM,760004,0,0,2,2,
Woods,Superintendent of Public Instruction,Freda Deskin,DEM,760004,0,0,6,6,
Woods,U.S. Senate,Patrick Michael Hayes,DEM,760004,0,0,4,4,
Woods,U.S. Senate,Jim Rogers,DEM,760004,1,0,5,6,
Woods,U.S. Senate,Connie Johnson,DEM,760004,0,1,9,10,
Woods,Governor,Dax Ewbank,REP,760004,0,1,9,10,
Woods,Governor,Chad Moody,REP,760004,0,1,3,4,
Woods,Governor,Mary Fallin,REP,760004,0,0,19,19,
Woods,Superintendent of Public Instruction,Brian Kelly,REP,760004,0,0,5,5,
Woods,Superintendent of Public Instruction,Janet Costello Barresi,REP,760004,0,0,2,2,
Woods,Superintendent of Public Instruction,Joy Hofmeister,REP,760004,0,2,24,26,
Woods,Insurance Commissioner,Bill Viner,REP,760004,0,0,3,3,
Woods,Insurance Commissioner,John Doak,REP,760004,0,2,28,30,
Woods,Corporation Commissioner,Todd Hiett,REP,760004,0,2,18,20,
Woods,Corporation Commissioner,Cliff Branan,REP,760004,0,0,13,13,
Woods,U.S. Senate,Evelyn Rogers,REP,760004,0,0,2,2,
Woods,U.S. Senate,Rob Moye,REP,760004,0,0,1,1,
Woods,U.S. Senate,D. Jean Mcbride-Samuels,REP,760004,0,0,2,2,
Woods,U.S. Senate,Jim Inhofe,REP,760004,0,2,21,23,
Woods,U.S. Senate,Erick Paul Wyatt,REP,760004,0,0,4,4,
Woods,U.S. Senate,Andy Craig,REP,760004,0,0,1,1,
Woods,U.S. Senate,T. Shannon,REP,760004,0,1,8,9,
Woods,U.S. Senate,Randy Brogdon,REP,760004,0,0,1,1,
Woods,U.S. Senate,Eric Mccray,REP,760004,0,0,1,1,
Woods,U.S. Senate,Kevin Crow,REP,760004,0,0,1,1,
Woods,U.S. Senate,James Lankford,REP,760004,0,1,18,19,
Woods,U.S. Senate,Jason Weger,REP,760004,0,0,1,1,
Woods,U.S. House,Timothy Ray Murray,REP,760004,0,0,3,3,03
Woods,U.S. House,Robert Hubbard,REP,760004,0,0,3,3,03
Woods,U.S. House,Frank Lucas,REP,760004,0,2,25,27,03
Woods,Superintendent of Public Instruction,John Cox,DEM,760005,3,12,71,86,
Woods,Superintendent of Public Instruction,Jack Jr.,DEM,760005,2,7,8,17,
Woods,Superintendent of Public Instruction,Ivan Holmes,DEM,760005,0,5,14,19,
Woods,Superintendent of Public Instruction,Freda Deskin,DEM,760005,0,3,36,39,
Woods,U.S. Senate,Patrick Michael Hayes,DEM,760005,2,10,31,43,
Woods,U.S. Senate,Jim Rogers,DEM,760005,4,9,48,61,
Woods,U.S. Senate,Connie Johnson,DEM,760005,0,8,49,57,
Woods,Governor,Dax Ewbank,REP,760005,1,11,77,89,
Woods,Governor,Chad Moody,REP,760005,0,5,52,57,
Woods,Governor,Mary Fallin,REP,760005,5,25,169,199,
Woods,Superintendent of Public Instruction,Brian Kelly,REP,760005,1,10,77,88,
Woods,Superintendent of Public Instruction,Janet Costello Barresi,REP,760005,1,6,41,48,
Woods,Superintendent of Public Instruction,Joy Hofmeister,REP,760005,4,24,181,209,
Woods,Insurance Commissioner,Bill Viner,REP,760005,2,4,56,62,
Woods,Insurance Commissioner,John Doak,REP,760005,4,36,233,273,
Woods,Corporation Commissioner,Todd Hiett,REP,760005,2,26,166,194,
Woods,Corporation Commissioner,Cliff Branan,REP,760005,4,14,130,148,
Woods,U.S. Senate,Evelyn Rogers,REP,760005,0,2,14,16,
Woods,U.S. Senate,Rob Moye,REP,760005,0,0,7,7,
Woods,U.S. Senate,D. Jean Mcbride-Samuels,REP,760005,0,0,5,5,
Woods,U.S. Senate,Jim Inhofe,REP,760005,6,37,262,305,
Woods,U.S. Senate,Erick Paul Wyatt,REP,760005,0,1,11,12,
Woods,U.S. Senate,Andy Craig,REP,760005,0,0,5,5,
Woods,U.S. Senate,T. Shannon,REP,760005,1,14,91,106,
Woods,U.S. Senate,Randy Brogdon,REP,760005,0,0,13,13,
Woods,U.S. Senate,Eric Mccray,REP,760005,0,2,7,9,
Woods,U.S. Senate,Kevin Crow,REP,760005,0,1,2,3,
Woods,U.S. Senate,James Lankford,REP,760005,4,23,179,206,
Woods,U.S. Senate,Jason Weger,REP,760005,1,0,0,1,
Woods,U.S. House,Timothy Ray Murray,REP,760005,0,0,13,13,03
Woods,U.S. House,Robert Hubbard,REP,760005,0,7,35,42,03
Woods,U.S. House,Frank Lucas,REP,760005,6,33,251,290,03
Woods,Superintendent of Public Instruction,John Cox,DEM,760007,0,0,13,13,
Woods,Superintendent of Public Instruction,Jack Jr.,DEM,760007,0,0,1,1,
Woods,Superintendent of Public Instruction,Ivan Holmes,DEM,760007,0,0,1,1,
Woods,Superintendent of Public Instruction,Freda Deskin,DEM,760007,0,0,8,8,
Woods,U.S. Senate,Patrick Michael Hayes,DEM,760007,0,0,8,8,
Woods,U.S. Senate,Jim Rogers,DEM,760007,0,0,9,9,
Woods,U.S. Senate,Connie Johnson,DEM,760007,0,0,6,6,
Woods,Governor,Dax Ewbank,REP,760007,0,1,13,14,
Woods,Governor,Chad Moody,REP,760007,0,0,5,5,
Woods,Governor,Mary Fallin,REP,760007,1,0,23,24,
Woods,Superintendent of Public Instruction,Brian Kelly,REP,760007,0,0,14,14,
Woods,Superintendent of Public Instruction,Janet Costello Barresi,REP,760007,0,0,3,3,
Woods,Superintendent of Public Instruction,Joy Hofmeister,REP,760007,1,1,23,25,
Woods,Insurance Commissioner,Bill Viner,REP,760007,0,0,5,5,
Woods,Insurance Commissioner,John Doak,REP,760007,1,0,35,36,
Woods,Corporation Commissioner,Todd Hiett,REP,760007,1,0,16,17,
Woods,Corporation Commissioner,Cliff Branan,REP,760007,0,0,25,25,
Woods,U.S. Senate,Evelyn Rogers,REP,760007,0,1,2,3,
Woods,U.S. Senate,Rob Moye,REP,760007,0,0,3,3,
Woods,U.S. Senate,D. Jean Mcbride-Samuels,REP,760007,0,0,0,0,
Woods,U.S. Senate,Jim Inhofe,REP,760007,1,0,32,33,
Woods,U.S. Senate,Erick Paul Wyatt,REP,760007,0,0,2,2,
Woods,U.S. Senate,Andy Craig,REP,760007,0,0,0,0,
Woods,U.S. Senate,T. Shannon,REP,760007,1,1,17,19,
Woods,U.S. Senate,Randy Brogdon,REP,760007,0,0,2,2,
Woods,U.S. Senate,Eric Mccray,REP,760007,0,0,1,1,
Woods,U.S. Senate,Kevin Crow,REP,760007,0,0,0,0,
Woods,U.S. Senate,James Lankford,REP,760007,0,0,19,19,
Woods,U.S. Senate,Jason Weger,REP,760007,0,0,0,0,
Woods,U.S. House,Timothy Ray Murray,REP,760007,0,0,4,4,03
Woods,U.S. House,Robert Hubbard,REP,760007,0,0,1,1,03
Woods,U.S. House,Frank Lucas,REP,760007,1,1,36,38,03
Woods,Superintendent of Public Instruction,John Cox,DEM,760008,0,0,6,6,
Woods,Superintendent of Public Instruction,Jack Jr.,DEM,760008,0,0,2,2,
Woods,Superintendent of Public Instruction,Ivan Holmes,DEM,760008,0,0,1,1,
Woods,Superintendent of Public Instruction,Freda Deskin,DEM,760008,1,0,9,10,
Woods,U.S. Senate,Patrick Michael Hayes,DEM,760008,0,0,4,4,
Woods,U.S. Senate,Jim Rogers,DEM,760008,0,0,7,7,
Woods,U.S. Senate,Connie Johnson,DEM,760008,1,0,7,8,
Woods,Governor,Dax Ewbank,REP,760008,0,0,12,12,
Woods,Governor,Chad Moody,REP,760008,0,0,11,11,
Woods,Governor,Mary Fallin,REP,760008,2,2,80,84,
Woods,Superintendent of Public Instruction,Brian Kelly,REP,760008,0,1,25,26,
Woods,Superintendent of Public Instruction,Janet Costello Barresi,REP,760008,0,1,21,22,
Woods,Superintendent of Public Instruction,Joy Hofmeister,REP,760008,2,0,54,56,
Woods,Insurance Commissioner,Bill Viner,REP,760008,0,0,24,24,
Woods,Insurance Commissioner,John Doak,REP,760008,2,2,73,77,
Woods,Corporation Commissioner,Todd Hiett,REP,760008,2,0,56,58,
Woods,Corporation Commissioner,Cliff Branan,REP,760008,0,2,43,45,
Woods,U.S. Senate,Evelyn Rogers,REP,760008,0,0,3,3,
Woods,U.S. Senate,Rob Moye,REP,760008,0,0,0,0,
Woods,U.S. Senate,D. Jean Mcbride-Samuels,REP,760008,0,0,0,0,
Woods,U.S. Senate,Jim Inhofe,REP,760008,2,1,95,98,
Woods,U.S. Senate,Erick Paul Wyatt,REP,760008,0,1,5,6,
Woods,U.S. Senate,Andy Craig,REP,760008,0,0,2,2,
Woods,U.S. Senate,T. Shannon,REP,760008,1,0,45,46,
Woods,U.S. Senate,Randy Brogdon,REP,760008,0,0,2,2,
Woods,U.S. Senate,Eric Mccray,REP,760008,0,0,0,0,
Woods,U.S. Senate,Kevin Crow,REP,760008,0,0,0,0,
Woods,U.S. Senate,James Lankford,REP,760008,1,2,53,56,
Woods,U.S. Senate,Jason Weger,REP,760008,0,0,0,0,
Woods,U.S. House,Timothy Ray Murray,REP,760008,0,0,4,4,03
Woods,U.S. House,Robert Hubbard,REP,760008,0,0,8,8,03
Woods,U.S. House,Frank Lucas,REP,760008,2,2,91,95,03
Woodward,Superintendent of Public Instruction,John Cox,DEM,770101,0,3,25,28,
Woodward,Superintendent of Public Instruction,Jack Jr.,DEM,770101,0,0,3,3,
Woodward,Superintendent of Public Instruction,Ivan Holmes,DEM,770101,0,3,1,4,
Woodward,Superintendent of Public Instruction,Freda Deskin,DEM,770101,0,2,22,24,
Woodward,U.S. Senate,Patrick Michael Hayes,DEM,770101,0,2,10,12,
Woodward,U.S. Senate,Jim Rogers,DEM,770101,0,5,10,15,
Woodward,U.S. Senate,Connie Johnson,DEM,770101,0,1,31,32,
Woodward,Governor,Dax Ewbank,REP,770101,0,2,15,17,
Woodward,Governor,Chad Moody,REP,770101,0,2,31,33,
Woodward,Governor,Mary Fallin,REP,770101,2,11,103,116,
Woodward,Superintendent of Public Instruction,Brian Kelly,REP,770101,1,5,38,44,
Woodward,Superintendent of Public Instruction,Janet Costello Barresi,REP,770101,0,3,30,33,
Woodward,Superintendent of Public Instruction,Joy Hofmeister,REP,770101,0,7,81,88,
Woodward,Insurance Commissioner,Bill Viner,REP,770101,0,1,29,30,
Woodward,Insurance Commissioner,John Doak,REP,770101,2,12,109,123,
Woodward,Corporation Commissioner,Todd Hiett,REP,770101,1,7,76,84,
Woodward,Corporation Commissioner,Cliff Branan,REP,770101,0,7,64,71,
Woodward,U.S. Senate,Evelyn Rogers,REP,770101,0,0,10,10,
Woodward,U.S. Senate,Rob Moye,REP,770101,0,0,6,6,
Woodward,U.S. Senate,D. Jean Mcbride-Samuels,REP,770101,0,0,3,3,
Woodward,U.S. Senate,Jim Inhofe,REP,770101,2,14,127,143,
Woodward,U.S. Senate,Erick Paul Wyatt,REP,770101,0,1,3,4,
Woodward,U.S. Senate,Andy Craig,REP,770101,0,0,0,0,
Woodward,U.S. Senate,T. Shannon,REP,770101,1,6,65,72,
Woodward,U.S. Senate,Randy Brogdon,REP,770101,0,0,3,3,
Woodward,U.S. Senate,Eric Mccray,REP,770101,0,0,5,5,
Woodward,U.S. Senate,Kevin Crow,REP,770101,0,0,0,0,
Woodward,U.S. Senate,James Lankford,REP,770101,1,9,75,85,
Woodward,U.S. Senate,Jason Weger,REP,770101,0,0,2,2,
Woodward,U.S. House,Timothy Ray Murray,REP,770101,0,1,3,4,03
Woodward,U.S. House,Robert Hubbard,REP,770101,0,1,9,10,03
Woodward,U.S. House,Frank Lucas,REP,770101,2,13,137,152,03
Woodward,Superintendent of Public Instruction,John Cox,DEM,770102,0,3,20,23,
Woodward,Superintendent of Public Instruction,Jack Jr.,DEM,770102,0,1,5,6,
Woodward,Superintendent of Public Instruction,Ivan Holmes,DEM,770102,0,0,5,5,
Woodward,Superintendent of Public Instruction,Freda Deskin,DEM,770102,0,0,12,12,
Woodward,U.S. Senate,Patrick Michael Hayes,DEM,770102,0,2,10,12,
Woodward,U.S. Senate,Jim Rogers,DEM,770102,0,1,18,19,
Woodward,U.S. Senate,Connie Johnson,DEM,770102,0,1,13,14,
Woodward,Governor,Dax Ewbank,REP,770102,0,1,5,6,
Woodward,Governor,Chad Moody,REP,770102,0,2,22,24,
Woodward,Governor,Mary Fallin,REP,770102,2,9,79,90,
Woodward,Superintendent of Public Instruction,Brian Kelly,REP,770102,0,5,34,39,
Woodward,Superintendent of Public Instruction,Janet Costello Barresi,REP,770102,1,3,14,18,
Woodward,Superintendent of Public Instruction,Joy Hofmeister,REP,770102,1,4,59,64,
Woodward,Insurance Commissioner,Bill Viner,REP,770102,1,1,33,35,
Woodward,Insurance Commissioner,John Doak,REP,770102,1,11,69,81,
Woodward,Corporation Commissioner,Todd Hiett,REP,770102,2,4,47,53,
Woodward,Corporation Commissioner,Cliff Branan,REP,770102,0,8,55,63,
Woodward,U.S. Senate,Evelyn Rogers,REP,770102,0,1,11,12,
Woodward,U.S. Senate,Rob Moye,REP,770102,0,0,0,0,
Woodward,U.S. Senate,D. Jean Mcbride-Samuels,REP,770102,0,0,3,3,
Woodward,U.S. Senate,Jim Inhofe,REP,770102,2,11,81,94,
Woodward,U.S. Senate,Erick Paul Wyatt,REP,770102,0,0,9,9,
Woodward,U.S. Senate,Andy Craig,REP,770102,0,0,0,0,
Woodward,U.S. Senate,T. Shannon,REP,770102,1,7,42,50,
Woodward,U.S. Senate,Randy Brogdon,REP,770102,0,0,5,5,
Woodward,U.S. Senate,Eric Mccray,REP,770102,0,0,0,0,
Woodward,U.S. Senate,Kevin Crow,REP,770102,0,0,3,3,
Woodward,U.S. Senate,James Lankford,REP,770102,1,5,53,59,
Woodward,U.S. Senate,Jason Weger,REP,770102,0,0,5,5,
Woodward,U.S. House,Timothy Ray Murray,REP,770102,0,1,11,12,03
Woodward,U.S. House,Robert Hubbard,REP,770102,0,1,9,10,03
Woodward,U.S. House,Frank Lucas,REP,770102,2,10,85,97,03
Woodward,Superintendent of Public Instruction,John Cox,DEM,770104,0,0,0,0,
Woodward,Superintendent of Public Instruction,Jack Jr.,DEM,770104,0,0,0,0,
Woodward,Superintendent of Public Instruction,Ivan Holmes,DEM,770104,0,0,0,0,
Woodward,Superintendent of Public Instruction,Freda Deskin,DEM,770104,0,0,0,0,
Woodward,U.S. Senate,Patrick Michael Hayes,DEM,770104,0,0,0,0,
Woodward,U.S. Senate,Jim Rogers,DEM,770104,0,0,0,0,
Woodward,U.S. Senate,Connie Johnson,DEM,770104,0,0,0,0,
Woodward,Governor,Dax Ewbank,REP,770104,0,0,0,0,
Woodward,Governor,Chad Moody,REP,770104,0,0,0,0,
Woodward,Governor,Mary Fallin,REP,770104,2,0,0,2,
Woodward,Superintendent of Public Instruction,Brian Kelly,REP,770104,0,0,0,0,
Woodward,Superintendent of Public Instruction,Janet Costello Barresi,REP,770104,0,0,0,0,
Woodward,Superintendent of Public Instruction,Joy Hofmeister,REP,770104,2,0,0,2,
Woodward,Insurance Commissioner,Bill Viner,REP,770104,0,0,0,0,
Woodward,Insurance Commissioner,John Doak,REP,770104,2,0,0,2,
Woodward,Corporation Commissioner,Todd Hiett,REP,770104,0,0,0,0,
Woodward,Corporation Commissioner,Cliff Branan,REP,770104,2,0,0,2,
Woodward,U.S. Senate,Evelyn Rogers,REP,770104,0,0,0,0,
Woodward,U.S. Senate,Rob Moye,REP,770104,0,0,0,0,
Woodward,U.S. Senate,D. Jean Mcbride-Samuels,REP,770104,0,0,0,0,
Woodward,U.S. Senate,Jim Inhofe,REP,770104,2,0,0,2,
Woodward,U.S. Senate,Erick Paul Wyatt,REP,770104,0,0,0,0,
Woodward,U.S. Senate,Andy Craig,REP,770104,0,0,0,0,
Woodward,U.S. Senate,T. Shannon,REP,770104,2,0,0,2,
Woodward,U.S. Senate,Randy Brogdon,REP,770104,0,0,0,0,
Woodward,U.S. Senate,Eric Mccray,REP,770104,0,0,0,0,
Woodward,U.S. Senate,Kevin Crow,REP,770104,0,0,0,0,
Woodward,U.S. Senate,James Lankford,REP,770104,0,0,0,0,
Woodward,U.S. Senate,Jason Weger,REP,770104,0,0,0,0,
Woodward,U.S. House,Timothy Ray Murray,REP,770104,0,0,0,0,03
Woodward,U.S. House,Robert Hubbard,REP,770104,0,0,0,0,03
Woodward,U.S. House,Frank Lucas,REP,770104,2,0,0,2,03
Woodward,Superintendent of Public Instruction,John Cox,DEM,770105,1,0,50,51,
Woodward,Superintendent of Public Instruction,Jack Jr.,DEM,770105,1,1,12,14,
Woodward,Superintendent of Public Instruction,Ivan Holmes,DEM,770105,0,0,10,10,
Woodward,Superintendent of Public Instruction,Freda Deskin,DEM,770105,5,0,46,51,
Woodward,U.S. Senate,Patrick Michael Hayes,DEM,770105,3,0,32,35,
Woodward,U.S. Senate,Jim Rogers,DEM,770105,2,0,44,46,
Woodward,U.S. Senate,Connie Johnson,DEM,770105,2,1,41,44,
Woodward,Governor,Dax Ewbank,REP,770105,0,4,10,14,
Woodward,Governor,Chad Moody,REP,770105,1,5,49,55,
Woodward,Governor,Mary Fallin,REP,770105,5,7,197,209,
Woodward,Superintendent of Public Instruction,Brian Kelly,REP,770105,1,5,55,61,
Woodward,Superintendent of Public Instruction,Janet Costello Barresi,REP,770105,0,4,37,41,
Woodward,Superintendent of Public Instruction,Joy Hofmeister,REP,770105,4,7,164,175,
Woodward,Insurance Commissioner,Bill Viner,REP,770105,1,1,38,40,
Woodward,Insurance Commissioner,John Doak,REP,770105,3,14,207,224,
Woodward,Corporation Commissioner,Todd Hiett,REP,770105,3,8,123,134,
Woodward,Corporation Commissioner,Cliff Branan,REP,770105,2,8,126,136,
Woodward,U.S. Senate,Evelyn Rogers,REP,770105,1,0,7,8,
Woodward,U.S. Senate,Rob Moye,REP,770105,0,0,3,3,
Woodward,U.S. Senate,D. Jean Mcbride-Samuels,REP,770105,0,0,2,2,
Woodward,U.S. Senate,Jim Inhofe,REP,770105,4,16,241,261,
Woodward,U.S. Senate,Erick Paul Wyatt,REP,770105,1,0,5,6,
Woodward,U.S. Senate,Andy Craig,REP,770105,1,0,0,1,
Woodward,U.S. Senate,T. Shannon,REP,770105,4,5,89,98,
Woodward,U.S. Senate,Randy Brogdon,REP,770105,0,1,3,4,
Woodward,U.S. Senate,Eric Mccray,REP,770105,0,0,3,3,
Woodward,U.S. Senate,Kevin Crow,REP,770105,0,0,3,3,
Woodward,U.S. Senate,James Lankford,REP,770105,0,10,158,168,
Woodward,U.S. Senate,Jason Weger,REP,770105,1,0,0,1,
Woodward,U.S. House,Timothy Ray Murray,REP,770105,0,1,6,7,03
Woodward,U.S. House,Robert Hubbard,REP,770105,2,1,25,28,03
Woodward,U.S. House,Frank Lucas,REP,770105,4,14,228,246,03
Woodward,Superintendent of Public Instruction,John Cox,DEM,770106,0,0,7,7,
Woodward,Superintendent of Public Instruction,Jack Jr.,DEM,770106,0,0,0,0,
Woodward,Superintendent of Public Instruction,Ivan Holmes,DEM,770106,0,0,0,0,
Woodward,Superintendent of Public Instruction,Freda Deskin,DEM,770106,1,0,2,3,
Woodward,U.S. Senate,Patrick Michael Hayes,DEM,770106,0,0,0,0,
Woodward,U.S. Senate,Jim Rogers,DEM,770106,1,0,5,6,
Woodward,U.S. Senate,Connie Johnson,DEM,770106,0,0,3,3,
Woodward,Governor,Dax Ewbank,REP,770106,4,1,4,9,
Woodward,Governor,Chad Moody,REP,770106,0,0,2,2,
Woodward,Governor,Mary Fallin,REP,770106,0,1,21,22,
Woodward,Superintendent of Public Instruction,Brian Kelly,REP,770106,1,0,10,11,
Woodward,Superintendent of Public Instruction,Janet Costello Barresi,REP,770106,0,0,3,3,
Woodward,Superintendent of Public Instruction,Joy Hofmeister,REP,770106,3,2,13,18,
Woodward,Insurance Commissioner,Bill Viner,REP,770106,0,0,4,4,
Woodward,Insurance Commissioner,John Doak,REP,770106,4,2,23,29,
Woodward,Corporation Commissioner,Todd Hiett,REP,770106,4,2,15,21,
Woodward,Corporation Commissioner,Cliff Branan,REP,770106,0,0,11,11,
Woodward,U.S. Senate,Evelyn Rogers,REP,770106,0,0,2,2,
Woodward,U.S. Senate,Rob Moye,REP,770106,0,0,0,0,
Woodward,U.S. Senate,D. Jean Mcbride-Samuels,REP,770106,0,0,0,0,
Woodward,U.S. Senate,Jim Inhofe,REP,770106,4,2,22,28,
Woodward,U.S. Senate,Erick Paul Wyatt,REP,770106,0,0,3,3,
Woodward,U.S. Senate,Andy Craig,REP,770106,0,0,0,0,
Woodward,U.S. Senate,T. Shannon,REP,770106,4,0,11,15,
Woodward,U.S. Senate,Randy Brogdon,REP,770106,0,0,0,0,
Woodward,U.S. Senate,Eric Mccray,REP,770106,0,0,0,0,
Woodward,U.S. Senate,Kevin Crow,REP,770106,0,0,1,1,
Woodward,U.S. Senate,James Lankford,REP,770106,0,2,13,15,
Woodward,U.S. Senate,Jason Weger,REP,770106,0,0,1,1,
Woodward,U.S. House,Timothy Ray Murray,REP,770106,0,0,1,1,03
Woodward,U.S. House,Robert Hubbard,REP,770106,3,0,4,7,03
Woodward,U.S. House,Frank Lucas,REP,770106,1,2,20,23,03
Woodward,Superintendent of Public Instruction,John Cox,DEM,770201,0,5,40,45,
Woodward,Superintendent of Public Instruction,Jack Jr.,DEM,770201,0,2,13,15,
Woodward,Superintendent of Public Instruction,Ivan Holmes,DEM,770201,0,1,7,8,
Woodward,Superintendent of Public Instruction,Freda Deskin,DEM,770201,3,4,41,48,
Woodward,U.S. Senate,Patrick Michael Hayes,DEM,770201,0,3,27,30,
Woodward,U.S. Senate,Jim Rogers,DEM,770201,0,6,25,31,
Woodward,U.S. Senate,Connie Johnson,DEM,770201,3,4,51,58,
Woodward,Governor,Dax Ewbank,REP,770201,0,5,25,30,
Woodward,Governor,Chad Moody,REP,770201,0,7,51,58,
Woodward,Governor,Mary Fallin,REP,770201,4,29,159,192,
Woodward,Superintendent of Public Instruction,Brian Kelly,REP,770201,3,9,66,78,
Woodward,Superintendent of Public Instruction,Janet Costello Barresi,REP,770201,0,5,29,34,
Woodward,Superintendent of Public Instruction,Joy Hofmeister,REP,770201,1,27,141,169,
Woodward,Insurance Commissioner,Bill Viner,REP,770201,2,9,58,69,
Woodward,Insurance Commissioner,John Doak,REP,770201,2,30,172,204,
Woodward,Corporation Commissioner,Todd Hiett,REP,770201,3,16,98,117,
Woodward,Corporation Commissioner,Cliff Branan,REP,770201,1,22,129,152,
Woodward,U.S. Senate,Evelyn Rogers,REP,770201,0,1,13,14,
Woodward,U.S. Senate,Rob Moye,REP,770201,0,0,5,5,
Woodward,U.S. Senate,D. Jean Mcbride-Samuels,REP,770201,0,0,1,1,
Woodward,U.S. Senate,Jim Inhofe,REP,770201,4,39,213,256,
Woodward,U.S. Senate,Erick Paul Wyatt,REP,770201,0,0,6,6,
Woodward,U.S. Senate,Andy Craig,REP,770201,0,0,1,1,
Woodward,U.S. Senate,T. Shannon,REP,770201,0,9,80,89,
Woodward,U.S. Senate,Randy Brogdon,REP,770201,0,2,3,5,
Woodward,U.S. Senate,Eric Mccray,REP,770201,0,0,3,3,
Woodward,U.S. Senate,Kevin Crow,REP,770201,0,0,1,1,
Woodward,U.S. Senate,James Lankford,REP,770201,4,29,147,180,
Woodward,U.S. Senate,Jason Weger,REP,770201,0,0,0,0,
Woodward,U.S. House,Timothy Ray Murray,REP,770201,0,0,10,10,03
Woodward,U.S. House,Robert Hubbard,REP,770201,0,1,23,24,03
Woodward,U.S. House,Frank Lucas,REP,770201,4,40,204,248,03
Woodward,Superintendent of Public Instruction,John Cox,DEM,770202,1,8,42,51,
Woodward,Superintendent of Public Instruction,Jack Jr.,DEM,770202,0,4,12,16,
Woodward,Superintendent of Public Instruction,Ivan Holmes,DEM,770202,4,1,10,15,
Woodward,Superintendent of Public Instruction,Freda Deskin,DEM,770202,0,5,68,73,
Woodward,U.S. Senate,Patrick Michael Hayes,DEM,770202,0,4,25,29,
Woodward,U.S. Senate,Jim Rogers,DEM,770202,3,7,45,55,
Woodward,U.S. Senate,Connie Johnson,DEM,770202,2,7,61,70,
Woodward,Governor,Dax Ewbank,REP,770202,0,4,36,40,
Woodward,Governor,Chad Moody,REP,770202,0,10,60,70,
Woodward,Governor,Mary Fallin,REP,770202,7,33,321,361,
Woodward,Superintendent of Public Instruction,Brian Kelly,REP,770202,0,6,81,87,
Woodward,Superintendent of Public Instruction,Janet Costello Barresi,REP,770202,2,13,66,81,
Woodward,Superintendent of Public Instruction,Joy Hofmeister,REP,770202,5,25,276,306,
Woodward,Insurance Commissioner,Bill Viner,REP,770202,0,12,74,86,
Woodward,Insurance Commissioner,John Doak,REP,770202,7,31,327,365,
Woodward,Corporation Commissioner,Todd Hiett,REP,770202,4,25,196,225,
Woodward,Corporation Commissioner,Cliff Branan,REP,770202,3,18,210,231,
Woodward,U.S. Senate,Evelyn Rogers,REP,770202,0,3,15,18,
Woodward,U.S. Senate,Rob Moye,REP,770202,0,0,7,7,
Woodward,U.S. Senate,D. Jean Mcbride-Samuels,REP,770202,0,1,3,4,
Woodward,U.S. Senate,Jim Inhofe,REP,770202,7,39,389,435,
Woodward,U.S. Senate,Erick Paul Wyatt,REP,770202,0,4,10,14,
Woodward,U.S. Senate,Andy Craig,REP,770202,0,0,6,6,
Woodward,U.S. Senate,T. Shannon,REP,770202,2,14,161,177,
Woodward,U.S. Senate,Randy Brogdon,REP,770202,0,1,3,4,
Woodward,U.S. Senate,Eric Mccray,REP,770202,0,0,0,0,
Woodward,U.S. Senate,Kevin Crow,REP,770202,0,1,5,6,
Woodward,U.S. Senate,James Lankford,REP,770202,5,29,251,285,
Woodward,U.S. Senate,Jason Weger,REP,770202,0,0,1,1,
Woodward,U.S. House,Timothy Ray Murray,REP,770202,0,3,15,18,03
Woodward,U.S. House,Robert Hubbard,REP,770202,0,7,31,38,03
Woodward,U.S. House,Frank Lucas,REP,770202,7,36,379,422,03
Woodward,Superintendent of Public Instruction,John Cox,DEM,770203,0,3,25,28,
Woodward,Superintendent of Public Instruction,Jack Jr.,DEM,770203,0,1,7,8,
Woodward,Superintendent of Public Instruction,Ivan Holmes,DEM,770203,0,1,5,6,
Woodward,Superintendent of Public Instruction,Freda Deskin,DEM,770203,0,3,15,18,
Woodward,U.S. Senate,Patrick Michael Hayes,DEM,770203,0,1,13,14,
Woodward,U.S. Senate,Jim Rogers,DEM,770203,0,1,19,20,
Woodward,U.S. Senate,Connie Johnson,DEM,770203,0,6,19,25,
Woodward,Governor,Dax Ewbank,REP,770203,2,0,5,7,
Woodward,Governor,Chad Moody,REP,770203,1,0,19,20,
Woodward,Governor,Mary Fallin,REP,770203,3,4,90,97,
Woodward,Superintendent of Public Instruction,Brian Kelly,REP,770203,1,1,35,37,
Woodward,Superintendent of Public Instruction,Janet Costello Barresi,REP,770203,0,1,11,12,
Woodward,Superintendent of Public Instruction,Joy Hofmeister,REP,770203,5,2,66,73,
Woodward,Insurance Commissioner,Bill Viner,REP,770203,4,0,23,27,
Woodward,Insurance Commissioner,John Doak,REP,770203,2,4,86,92,
Woodward,Corporation Commissioner,Todd Hiett,REP,770203,4,0,53,57,
Woodward,Corporation Commissioner,Cliff Branan,REP,770203,2,4,56,62,
Woodward,U.S. Senate,Evelyn Rogers,REP,770203,0,0,5,5,
Woodward,U.S. Senate,Rob Moye,REP,770203,1,0,4,5,
Woodward,U.S. Senate,D. Jean Mcbride-Samuels,REP,770203,0,0,4,4,
Woodward,U.S. Senate,Jim Inhofe,REP,770203,5,3,93,101,
Woodward,U.S. Senate,Erick Paul Wyatt,REP,770203,0,1,7,8,
Woodward,U.S. Senate,Andy Craig,REP,770203,0,0,0,0,
Woodward,U.S. Senate,T. Shannon,REP,770203,1,3,40,44,
Woodward,U.S. Senate,Randy Brogdon,REP,770203,1,0,1,2,
Woodward,U.S. Senate,Eric Mccray,REP,770203,0,0,0,0,
Woodward,U.S. Senate,Kevin Crow,REP,770203,0,1,7,8,
Woodward,U.S. Senate,James Lankford,REP,770203,4,0,66,70,
Woodward,U.S. Senate,Jason Weger,REP,770203,0,0,0,0,
Woodward,U.S. House,Timothy Ray Murray,REP,770203,0,0,4,4,03
Woodward,U.S. House,Robert Hubbard,REP,770203,0,1,14,15,03
Woodward,U.S. House,Frank Lucas,REP,770203,6,3,97,106,03
Woodward,Superintendent of Public Instruction,John Cox,DEM,770204,0,0,11,11,
Woodward,Superintendent of Public Instruction,Jack Jr.,DEM,770204,0,0,4,4,
Woodward,Superintendent of Public Instruction,Ivan Holmes,DEM,770204,0,1,0,1,
Woodward,Superintendent of Public Instruction,Freda Deskin,DEM,770204,0,0,8,8,
Woodward,U.S. Senate,Patrick Michael Hayes,DEM,770204,0,1,3,4,
Woodward,U.S. Senate,Jim Rogers,DEM,770204,0,0,11,11,
Woodward,U.S. Senate,Connie Johnson,DEM,770204,0,0,7,7,
Woodward,Governor,Dax Ewbank,REP,770204,0,0,9,9,
Woodward,Governor,Chad Moody,REP,770204,0,0,5,5,
Woodward,Governor,Mary Fallin,REP,770204,3,5,47,55,
Woodward,Superintendent of Public Instruction,Brian Kelly,REP,770204,0,1,10,11,
Woodward,Superintendent of Public Instruction,Janet Costello Barresi,REP,770204,0,0,12,12,
Woodward,Superintendent of Public Instruction,Joy Hofmeister,REP,770204,3,4,39,46,
Woodward,Insurance Commissioner,Bill Viner,REP,770204,0,1,7,8,
Woodward,Insurance Commissioner,John Doak,REP,770204,3,4,50,57,
Woodward,Corporation Commissioner,Todd Hiett,REP,770204,3,3,36,42,
Woodward,Corporation Commissioner,Cliff Branan,REP,770204,0,2,21,23,
Woodward,U.S. Senate,Evelyn Rogers,REP,770204,0,0,0,0,
Woodward,U.S. Senate,Rob Moye,REP,770204,0,0,0,0,
Woodward,U.S. Senate,D. Jean Mcbride-Samuels,REP,770204,0,0,0,0,
Woodward,U.S. Senate,Jim Inhofe,REP,770204,3,5,61,69,
Woodward,U.S. Senate,Erick Paul Wyatt,REP,770204,0,0,1,1,
Woodward,U.S. Senate,Andy Craig,REP,770204,0,0,0,0,
Woodward,U.S. Senate,T. Shannon,REP,770204,0,1,19,20,
Woodward,U.S. Senate,Randy Brogdon,REP,770204,1,0,0,1,
Woodward,U.S. Senate,Eric Mccray,REP,770204,0,0,0,0,
Woodward,U.S. Senate,Kevin Crow,REP,770204,0,0,1,1,
Woodward,U.S. Senate,James Lankford,REP,770204,2,4,43,49,
Woodward,U.S. Senate,Jason Weger,REP,770204,0,0,0,0,
Woodward,U.S. House,Timothy Ray Murray,REP,770204,0,0,3,3,03
Woodward,U.S. House,Robert Hubbard,REP,770204,0,1,8,9,03
Woodward,U.S. House,Frank Lucas,REP,770204,3,4,48,55,03
Woodward,Superintendent of Public Instruction,John Cox,DEM,770301,0,0,8,8,
Woodward,Superintendent of Public Instruction,Jack Jr.,DEM,770301,0,1,3,4,
Woodward,Superintendent of Public Instruction,Ivan Holmes,DEM,770301,0,0,1,1,
Woodward,Superintendent of Public Instruction,Freda Deskin,DEM,770301,0,0,12,12,
Woodward,U.S. Senate,Patrick Michael Hayes,DEM,770301,0,1,8,9,
Woodward,U.S. Senate,Jim Rogers,DEM,770301,0,0,12,12,
Woodward,U.S. Senate,Connie Johnson,DEM,770301,1,0,4,5,
Woodward,Governor,Dax Ewbank,REP,770301,0,0,7,7,
Woodward,Governor,Chad Moody,REP,770301,0,3,15,18,
Woodward,Governor,Mary Fallin,REP,770301,1,6,52,59,
Woodward,Superintendent of Public Instruction,Brian Kelly,REP,770301,0,0,15,15,
Woodward,Superintendent of Public Instruction,Janet Costello Barresi,REP,770301,0,3,15,18,
Woodward,Superintendent of Public Instruction,Joy Hofmeister,REP,770301,0,6,45,51,
Woodward,Insurance Commissioner,Bill Viner,REP,770301,0,1,16,17,
Woodward,Insurance Commissioner,John Doak,REP,770301,0,8,55,63,
Woodward,Corporation Commissioner,Todd Hiett,REP,770301,0,6,33,39,
Woodward,Corporation Commissioner,Cliff Branan,REP,770301,0,3,38,41,
Woodward,U.S. Senate,Evelyn Rogers,REP,770301,0,2,1,3,
Woodward,U.S. Senate,Rob Moye,REP,770301,0,0,2,2,
Woodward,U.S. Senate,D. Jean Mcbride-Samuels,REP,770301,0,0,2,2,
Woodward,U.S. Senate,Jim Inhofe,REP,770301,1,7,66,74,
Woodward,U.S. Senate,Erick Paul Wyatt,REP,770301,0,0,3,3,
Woodward,U.S. Senate,Andy Craig,REP,770301,0,2,1,3,
Woodward,U.S. Senate,T. Shannon,REP,770301,0,2,27,29,
Woodward,U.S. Senate,Randy Brogdon,REP,770301,0,0,2,2,
Woodward,U.S. Senate,Eric Mccray,REP,770301,0,0,0,0,
Woodward,U.S. Senate,Kevin Crow,REP,770301,0,0,0,0,
Woodward,U.S. Senate,James Lankford,REP,770301,1,5,45,51,
Woodward,U.S. Senate,Jason Weger,REP,770301,0,0,0,0,
Woodward,U.S. House,Timothy Ray Murray,REP,770301,0,1,3,4,03
Woodward,U.S. House,Robert Hubbard,REP,770301,0,2,4,6,03
Woodward,U.S. House,Frank Lucas,REP,770301,1,6,68,75,03
Woodward,Superintendent of Public Instruction,John Cox,DEM,770302,0,3,7,10,
Woodward,Superintendent of Public Instruction,Jack Jr.,DEM,770302,0,0,5,5,
Woodward,Superintendent of Public Instruction,Ivan Holmes,DEM,770302,0,0,3,3,
Woodward,Superintendent of Public Instruction,Freda Deskin,DEM,770302,0,4,8,12,
Woodward,U.S. Senate,Patrick Michael Hayes,DEM,770302,0,1,5,6,
Woodward,U.S. Senate,Jim Rogers,DEM,770302,0,4,13,17,
Woodward,U.S. Senate,Connie Johnson,DEM,770302,0,1,4,5,
Woodward,Governor,Dax Ewbank,REP,770302,0,1,4,5,
Woodward,Governor,Chad Moody,REP,770302,0,4,6,10,
Woodward,Governor,Mary Fallin,REP,770302,3,18,37,58,
Woodward,Superintendent of Public Instruction,Brian Kelly,REP,770302,0,6,17,23,
Woodward,Superintendent of Public Instruction,Janet Costello Barresi,REP,770302,1,5,5,11,
Woodward,Superintendent of Public Instruction,Joy Hofmeister,REP,770302,2,13,27,42,
Woodward,Insurance Commissioner,Bill Viner,REP,770302,2,2,10,14,
Woodward,Insurance Commissioner,John Doak,REP,770302,1,20,34,55,
Woodward,Corporation Commissioner,Todd Hiett,REP,770302,1,15,17,33,
Woodward,Corporation Commissioner,Cliff Branan,REP,770302,2,7,30,39,
Woodward,U.S. Senate,Evelyn Rogers,REP,770302,0,2,2,4,
Woodward,U.S. Senate,Rob Moye,REP,770302,0,0,0,0,
Woodward,U.S. Senate,D. Jean Mcbride-Samuels,REP,770302,0,0,0,0,
Woodward,U.S. Senate,Jim Inhofe,REP,770302,3,21,46,70,
Woodward,U.S. Senate,Erick Paul Wyatt,REP,770302,0,0,1,1,
Woodward,U.S. Senate,Andy Craig,REP,770302,0,0,1,1,
Woodward,U.S. Senate,T. Shannon,REP,770302,2,9,24,35,
Woodward,U.S. Senate,Randy Brogdon,REP,770302,1,0,0,1,
Woodward,U.S. Senate,Eric Mccray,REP,770302,0,0,1,1,
Woodward,U.S. Senate,Kevin Crow,REP,770302,0,0,0,0,
Woodward,U.S. Senate,James Lankford,REP,770302,0,15,23,38,
Woodward,U.S. Senate,Jason Weger,REP,770302,0,0,0,0,
Woodward,U.S. House,Timothy Ray Murray,REP,770302,0,1,0,1,03
Woodward,U.S. House,Robert Hubbard,REP,770302,0,1,5,6,03
Woodward,U.S. House,Frank Lucas,REP,770302,3,22,44,69,03
Woodward,Superintendent of Public Instruction,John Cox,DEM,770303,1,0,0,1,
Woodward,Superintendent of Public Instruction,Jack Jr.,DEM,770303,0,0,0,0,
Woodward,Superintendent of Public Instruction,Ivan Holmes,DEM,770303,0,0,0,0,
Woodward,Superintendent of Public Instruction,Freda Deskin,DEM,770303,0,0,0,0,
Woodward,U.S. Senate,Patrick Michael Hayes,DEM,770303,0,0,0,0,
Woodward,U.S. Senate,Jim Rogers,DEM,770303,1,0,0,1,
Woodward,U.S. Senate,Connie Johnson,DEM,770303,0,0,0,0,
Woodward,Governor,Dax Ewbank,REP,770303,0,0,0,0,
Woodward,Governor,Chad Moody,REP,770303,0,0,0,0,
Woodward,Governor,Mary Fallin,REP,770303,1,1,0,2,
Woodward,Superintendent of Public Instruction,Brian Kelly,REP,770303,0,0,0,0,
Woodward,Superintendent of Public Instruction,Janet Costello Barresi,REP,770303,0,0,0,0,
Woodward,Superintendent of Public Instruction,Joy Hofmeister,REP,770303,1,1,0,2,
Woodward,Insurance Commissioner,Bill Viner,REP,770303,0,0,0,0,
Woodward,Insurance Commissioner,John Doak,REP,770303,1,1,0,2,
Woodward,Corporation Commissioner,Todd Hiett,REP,770303,0,0,0,0,
Woodward,Corporation Commissioner,Cliff Branan,REP,770303,1,1,0,2,
Woodward,U.S. Senate,Evelyn Rogers,REP,770303,0,0,0,0,
Woodward,U.S. Senate,Rob Moye,REP,770303,0,0,0,0,
Woodward,U.S. Senate,D. Jean Mcbride-Samuels,REP,770303,0,0,0,0,
Woodward,U.S. Senate,Jim Inhofe,REP,770303,1,1,0,2,
Woodward,U.S. Senate,Erick Paul Wyatt,REP,770303,0,0,0,0,
Woodward,U.S. Senate,Andy Craig,REP,770303,0,0,0,0,
Woodward,U.S. Senate,T. Shannon,REP,770303,0,1,0,1,
Woodward,U.S. Senate,Randy Brogdon,REP,770303,0,0,0,0,
Woodward,U.S. Senate,Eric Mccray,REP,770303,0,0,0,0,
Woodward,U.S. Senate,Kevin Crow,REP,770303,0,0,0,0,
Woodward,U.S. Senate,James Lankford,REP,770303,1,0,0,1,
Woodward,U.S. Senate,Jason Weger,REP,770303,0,0,0,0,
Woodward,U.S. House,Timothy Ray Murray,REP,770303,0,0,0,0,03
Woodward,U.S. House,Robert Hubbard,REP,770303,0,0,0,0,03
Woodward,U.S. House,Frank Lucas,REP,770303,1,1,0,2,03
Woodward,Superintendent of Public Instruction,John Cox,DEM,770304,0,0,18,18,
Woodward,Superintendent of Public Instruction,Jack Jr.,DEM,770304,0,0,0,0,
Woodward,Superintendent of Public Instruction,Ivan Holmes,DEM,770304,0,0,2,2,
Woodward,Superintendent of Public Instruction,Freda Deskin,DEM,770304,0,0,10,10,
Woodward,U.S. Senate,Patrick Michael Hayes,DEM,770304,0,0,12,12,
Woodward,U.S. Senate,Jim Rogers,DEM,770304,0,0,12,12,
Woodward,U.S. Senate,Connie Johnson,DEM,770304,0,0,5,5,
Woodward,Governor,Dax Ewbank,REP,770304,0,1,3,4,
Woodward,Governor,Chad Moody,REP,770304,0,0,6,6,
Woodward,Governor,Mary Fallin,REP,770304,0,2,45,47,
Woodward,Superintendent of Public Instruction,Brian Kelly,REP,770304,0,0,19,19,
Woodward,Superintendent of Public Instruction,Janet Costello Barresi,REP,770304,0,2,5,7,
Woodward,Superintendent of Public Instruction,Joy Hofmeister,REP,770304,0,1,30,31,
Woodward,Insurance Commissioner,Bill Viner,REP,770304,0,0,14,14,
Woodward,Insurance Commissioner,John Doak,REP,770304,0,3,39,42,
Woodward,Corporation Commissioner,Todd Hiett,REP,770304,0,3,17,20,
Woodward,Corporation Commissioner,Cliff Branan,REP,770304,0,0,36,36,
Woodward,U.S. Senate,Evelyn Rogers,REP,770304,0,0,1,1,
Woodward,U.S. Senate,Rob Moye,REP,770304,0,0,1,1,
Woodward,U.S. Senate,D. Jean Mcbride-Samuels,REP,770304,0,0,0,0,
Woodward,U.S. Senate,Jim Inhofe,REP,770304,0,3,46,49,
Woodward,U.S. Senate,Erick Paul Wyatt,REP,770304,0,0,5,5,
Woodward,U.S. Senate,Andy Craig,REP,770304,0,0,0,0,
Woodward,U.S. Senate,T. Shannon,REP,770304,0,3,23,26,
Woodward,U.S. Senate,Randy Brogdon,REP,770304,0,0,1,1,
Woodward,U.S. Senate,Eric Mccray,REP,770304,0,0,0,0,
Woodward,U.S. Senate,Kevin Crow,REP,770304,0,0,1,1,
Woodward,U.S. Senate,James Lankford,REP,770304,0,0,29,29,
Woodward,U.S. Senate,Jason Weger,REP,770304,0,0,0,0,
Woodward,U.S. House,Timothy Ray Murray,REP,770304,0,2,2,4,03
Woodward,U.S. House,Robert Hubbard,REP,770304,0,0,3,3,03
Woodward,U.S. House,Frank Lucas,REP,770304,0,1,49,50,03
Woodward,Superintendent of Public Instruction,John Cox,DEM,770306,0,1,38,39,
Woodward,Superintendent of Public Instruction,Jack Jr.,DEM,770306,0,2,8,10,
Woodward,Superintendent of Public Instruction,Ivan Holmes,DEM,770306,0,3,9,12,
Woodward,Superintendent of Public Instruction,Freda Deskin,DEM,770306,0,6,41,47,
Woodward,U.S. Senate,Patrick Michael Hayes,DEM,770306,0,3,21,24,
Woodward,U.S. Senate,Jim Rogers,DEM,770306,0,3,30,33,
Woodward,U.S. Senate,Connie Johnson,DEM,770306,0,5,42,47,
Woodward,Governor,Dax Ewbank,REP,770306,1,3,38,42,
Woodward,Governor,Chad Moody,REP,770306,0,7,70,77,
Woodward,Governor,Mary Fallin,REP,770306,5,39,285,329,
Woodward,Superintendent of Public Instruction,Brian Kelly,REP,770306,2,8,107,117,
Woodward,Superintendent of Public Instruction,Janet Costello Barresi,REP,770306,0,12,41,53,
Woodward,Superintendent of Public Instruction,Joy Hofmeister,REP,770306,4,28,241,273,
Woodward,Insurance Commissioner,Bill Viner,REP,770306,1,8,84,93,
Woodward,Insurance Commissioner,John Doak,REP,770306,3,40,286,329,
Woodward,Corporation Commissioner,Todd Hiett,REP,770306,2,23,176,201,
Woodward,Corporation Commissioner,Cliff Branan,REP,770306,2,25,199,226,
Woodward,U.S. Senate,Evelyn Rogers,REP,770306,0,0,18,18,
Woodward,U.S. Senate,Rob Moye,REP,770306,0,0,11,11,
Woodward,U.S. Senate,D. Jean Mcbride-Samuels,REP,770306,0,0,2,2,
Woodward,U.S. Senate,Jim Inhofe,REP,770306,6,48,348,402,
Woodward,U.S. Senate,Erick Paul Wyatt,REP,770306,0,1,16,17,
Woodward,U.S. Senate,Andy Craig,REP,770306,0,0,0,0,
Woodward,U.S. Senate,T. Shannon,REP,770306,3,13,181,197,
Woodward,U.S. Senate,Randy Brogdon,REP,770306,1,1,5,7,
Woodward,U.S. Senate,Eric Mccray,REP,770306,0,0,2,2,
Woodward,U.S. Senate,Kevin Crow,REP,770306,0,0,3,3,
Woodward,U.S. Senate,James Lankford,REP,770306,2,33,202,237,
Woodward,U.S. Senate,Jason Weger,REP,770306,0,1,0,1,
Woodward,U.S. House,Timothy Ray Murray,REP,770306,0,1,18,19,03
Woodward,U.S. House,Robert Hubbard,REP,770306,0,3,29,32,03
Woodward,U.S. House,Frank Lucas,REP,770306,6,45,350,401,03
Woodward,Superintendent of Public Instruction,John Cox,DEM,770307,0,0,15,15,
Woodward,Superintendent of Public Instruction,Jack Jr.,DEM,770307,0,0,3,3,
Woodward,Superintendent of Public Instruction,Ivan Holmes,DEM,770307,0,0,1,1,
Woodward,Superintendent of Public Instruction,Freda Deskin,DEM,770307,0,0,2,2,
Woodward,U.S. Senate,Patrick Michael Hayes,DEM,770307,0,0,8,8,
Woodward,U.S. Senate,Jim Rogers,DEM,770307,0,0,11,11,
Woodward,U.S. Senate,Connie Johnson,DEM,770307,0,0,1,1,
Woodward,Governor,Dax Ewbank,REP,770307,0,0,6,6,
Woodward,Governor,Chad Moody,REP,770307,0,0,9,9,
Woodward,Governor,Mary Fallin,REP,770307,0,0,24,24,
Woodward,Superintendent of Public Instruction,Brian Kelly,REP,770307,0,0,11,11,
Woodward,Superintendent of Public Instruction,Janet Costello Barresi,REP,770307,0,0,2,2,
Woodward,Superintendent of Public Instruction,Joy Hofmeister,REP,770307,0,0,25,25,
Woodward,Insurance Commissioner,Bill Viner,REP,770307,0,0,11,11,
Woodward,Insurance Commissioner,John Doak,REP,770307,0,0,24,24,
Woodward,Corporation Commissioner,Todd Hiett,REP,770307,0,0,19,19,
Woodward,Corporation Commissioner,Cliff Branan,REP,770307,0,0,19,19,
Woodward,U.S. Senate,Evelyn Rogers,REP,770307,0,0,1,1,
Woodward,U.S. Senate,Rob Moye,REP,770307,0,0,3,3,
Woodward,U.S. Senate,D. Jean Mcbride-Samuels,REP,770307,0,0,0,0,
Woodward,U.S. Senate,Jim Inhofe,REP,770307,0,0,31,31,
Woodward,U.S. Senate,Erick Paul Wyatt,REP,770307,0,0,3,3,
Woodward,U.S. Senate,Andy Craig,REP,770307,0,0,2,2,
Woodward,U.S. Senate,T. Shannon,REP,770307,0,0,15,15,
Woodward,U.S. Senate,Randy Brogdon,REP,770307,0,0,1,1,
Woodward,U.S. Senate,Eric Mccray,REP,770307,0,0,1,1,
Woodward,U.S. Senate,Kevin Crow,REP,770307,0,0,0,0,
Woodward,U.S. Senate,James Lankford,REP,770307,0,0,19,19,
Woodward,U.S. Senate,Jason Weger,REP,770307,0,0,1,1,
Woodward,U.S. House,Timothy Ray Murray,REP,770307,0,0,5,5,03
Woodward,U.S. House,Robert Hubbard,REP,770307,0,0,6,6,03
Woodward,U.S. House,Frank Lucas,REP,770307,0,0,27,27,03
Woodward,State House,Casey Murdock,REP,770307,0,0,13,13,61
Woodward,State House,David Elder,REP,770307,0,0,5,5,61
Woodward,State House,Steve Moore,REP,770307,0,0,4,4,61
Woodward,State House,Kenny Bob Tapp,REP,770307,0,0,11,11,61
Woodward,State House,Larry Swager,REP,770307,0,0,5,5,61
