county,office,candidate,party,precinct,mail_votes,early_votes,elec_day_votes,total_votes,district
Adair,Superintendent of Public Instruction,John Cox,DEM,10001,5,0,33,38,
Adair,Superintendent of Public Instruction,Freda Deskin,DEM,10001,0,0,4,4,
Adair,U.S. Senate,Connie Johnson,DEM,10001,1,0,11,12,
Adair,U.S. Senate,Jim Rogers,DEM,10001,4,0,25,29,
Adair,Superintendent of Public Instruction,John Cox,DEM,10002,2,1,27,30,
Adair,Superintendent of Public Instruction,Freda Deskin,DEM,10002,0,0,7,7,
Adair,U.S. Senate,Connie Johnson,DEM,10002,1,1,11,13,
Adair,U.S. Senate,Jim Rogers,DEM,10002,1,0,23,24,
Adair,Superintendent of Public Instruction,John Cox,DEM,10003,0,0,7,7,
Adair,Superintendent of Public Instruction,Freda Deskin,DEM,10003,0,0,5,5,
Adair,U.S. Senate,Connie Johnson,DEM,10003,0,0,5,5,
Adair,U.S. Senate,Jim Rogers,DEM,10003,0,0,7,7,
Adair,Superintendent of Public Instruction,John Cox,DEM,10004,2,2,31,35,
Adair,Superintendent of Public Instruction,Freda Deskin,DEM,10004,2,0,2,4,
Adair,U.S. Senate,Connie Johnson,DEM,10004,2,1,7,10,
Adair,U.S. Senate,Jim Rogers,DEM,10004,2,1,26,29,
Adair,Superintendent of Public Instruction,John Cox,DEM,10005,0,0,23,23,
Adair,Superintendent of Public Instruction,Freda Deskin,DEM,10005,0,0,1,1,
Adair,U.S. Senate,Connie Johnson,DEM,10005,0,0,3,3,
Adair,U.S. Senate,Jim Rogers,DEM,10005,0,0,18,18,
Adair,Superintendent of Public Instruction,John Cox,DEM,10006,1,5,53,59,
Adair,Superintendent of Public Instruction,Freda Deskin,DEM,10006,0,0,4,4,
Adair,U.S. Senate,Connie Johnson,DEM,10006,0,2,19,21,
Adair,U.S. Senate,Jim Rogers,DEM,10006,1,3,38,42,
Adair,Superintendent of Public Instruction,John Cox,DEM,10007,0,12,90,102,
Adair,Superintendent of Public Instruction,Freda Deskin,DEM,10007,0,0,7,7,
Adair,U.S. Senate,Connie Johnson,DEM,10007,0,6,37,43,
Adair,U.S. Senate,Jim Rogers,DEM,10007,0,6,56,62,
Adair,Superintendent of Public Instruction,John Cox,DEM,10008,2,8,68,78,
Adair,Superintendent of Public Instruction,Freda Deskin,DEM,10008,0,0,1,1,
Adair,U.S. Senate,Connie Johnson,DEM,10008,2,5,14,21,
Adair,U.S. Senate,Jim Rogers,DEM,10008,0,3,54,57,
Adair,Superintendent of Public Instruction,John Cox,DEM,10010,0,0,14,14,
Adair,Superintendent of Public Instruction,Freda Deskin,DEM,10010,0,0,4,4,
Adair,U.S. Senate,Connie Johnson,DEM,10010,0,0,8,8,
Adair,U.S. Senate,Jim Rogers,DEM,10010,0,0,10,10,
Adair,Superintendent of Public Instruction,John Cox,DEM,10011,1,0,16,17,
Adair,Superintendent of Public Instruction,Freda Deskin,DEM,10011,2,0,0,2,
Adair,U.S. Senate,Connie Johnson,DEM,10011,3,0,3,6,
Adair,U.S. Senate,Jim Rogers,DEM,10011,0,0,12,12,
Adair,Superintendent of Public Instruction,John Cox,DEM,10012,0,2,26,28,
Adair,Superintendent of Public Instruction,Freda Deskin,DEM,10012,1,0,2,3,
Adair,U.S. Senate,Connie Johnson,DEM,10012,1,1,7,9,
Adair,U.S. Senate,Jim Rogers,DEM,10012,0,1,20,21,
Adair,Superintendent of Public Instruction,John Cox,DEM,10013,2,7,42,51,
Adair,Superintendent of Public Instruction,Freda Deskin,DEM,10013,0,0,5,5,
Adair,U.S. Senate,Connie Johnson,DEM,10013,0,5,13,18,
Adair,U.S. Senate,Jim Rogers,DEM,10013,2,1,32,35,
Adair,Superintendent of Public Instruction,John Cox,DEM,10014,2,3,41,46,
Adair,Superintendent of Public Instruction,Freda Deskin,DEM,10014,0,2,5,7,
Adair,U.S. Senate,Connie Johnson,DEM,10014,0,3,11,14,
Adair,U.S. Senate,Jim Rogers,DEM,10014,2,2,34,38,
Adair,Superintendent of Public Instruction,John Cox,DEM,10016,0,0,14,14,
Adair,Superintendent of Public Instruction,Freda Deskin,DEM,10016,0,0,2,2,
Adair,U.S. Senate,Connie Johnson,DEM,10016,0,0,8,8,
Adair,U.S. Senate,Jim Rogers,DEM,10016,0,0,8,8,
Adair,Superintendent of Public Instruction,John Cox,DEM,10017,0,0,44,44,
Adair,Superintendent of Public Instruction,Freda Deskin,DEM,10017,0,0,10,10,
Adair,U.S. Senate,Connie Johnson,DEM,10017,0,0,22,22,
Adair,U.S. Senate,Jim Rogers,DEM,10017,0,0,31,31,
Adair,Superintendent of Public Instruction,John Cox,DEM,10018,0,0,53,53,
Adair,Superintendent of Public Instruction,Freda Deskin,DEM,10018,0,0,3,3,
Adair,U.S. Senate,Connie Johnson,DEM,10018,0,0,19,19,
Adair,U.S. Senate,Jim Rogers,DEM,10018,0,0,37,37,
Adair,Superintendent of Public Instruction,John Cox,DEM,10019,0,0,56,56,
Adair,Superintendent of Public Instruction,Freda Deskin,DEM,10019,0,0,6,6,
Adair,U.S. Senate,Connie Johnson,DEM,10019,0,0,16,16,
Adair,U.S. Senate,Jim Rogers,DEM,10019,0,0,43,43,
Alfalfa,Superintendent of Public Instruction,John Cox,DEM,20110,0,0,12,12,
Alfalfa,Superintendent of Public Instruction,Freda Deskin,DEM,20110,0,1,4,5,
Alfalfa,U.S. Senate,Connie Johnson,DEM,20110,0,0,3,3,
Alfalfa,U.S. Senate,Jim Rogers,DEM,20110,0,1,11,12,
Alfalfa,Superintendent of Public Instruction,John Cox,DEM,20120,0,0,4,4,
Alfalfa,Superintendent of Public Instruction,Freda Deskin,DEM,20120,0,0,1,1,
Alfalfa,U.S. Senate,Connie Johnson,DEM,20120,0,0,3,3,
Alfalfa,U.S. Senate,Jim Rogers,DEM,20120,0,0,2,2,
Alfalfa,Superintendent of Public Instruction,John Cox,DEM,20140,0,1,6,7,
Alfalfa,Superintendent of Public Instruction,Freda Deskin,DEM,20140,0,1,4,5,
Alfalfa,U.S. Senate,Connie Johnson,DEM,20140,0,1,2,3,
Alfalfa,U.S. Senate,Jim Rogers,DEM,20140,0,1,8,9,
Alfalfa,Superintendent of Public Instruction,John Cox,DEM,20220,3,4,10,17,
Alfalfa,Superintendent of Public Instruction,Freda Deskin,DEM,20220,3,0,5,8,
Alfalfa,U.S. Senate,Connie Johnson,DEM,20220,4,4,12,20,
Alfalfa,U.S. Senate,Jim Rogers,DEM,20220,2,0,3,5,
Alfalfa,Superintendent of Public Instruction,John Cox,DEM,20230,1,1,7,9,
Alfalfa,Superintendent of Public Instruction,Freda Deskin,DEM,20230,0,0,7,7,
Alfalfa,U.S. Senate,Connie Johnson,DEM,20230,0,0,4,4,
Alfalfa,U.S. Senate,Jim Rogers,DEM,20230,1,1,10,12,
Alfalfa,Superintendent of Public Instruction,John Cox,DEM,20310,0,0,12,12,
Alfalfa,Superintendent of Public Instruction,Freda Deskin,DEM,20310,0,0,3,3,
Alfalfa,U.S. Senate,Connie Johnson,DEM,20310,0,0,2,2,
Alfalfa,U.S. Senate,Jim Rogers,DEM,20310,0,0,13,13,
Alfalfa,Superintendent of Public Instruction,John Cox,DEM,20330,0,0,10,10,
Alfalfa,Superintendent of Public Instruction,Freda Deskin,DEM,20330,0,0,3,3,
Alfalfa,U.S. Senate,Connie Johnson,DEM,20330,0,0,5,5,
Alfalfa,U.S. Senate,Jim Rogers,DEM,20330,0,0,8,8,
Atoka,Superintendent of Public Instruction,John Cox,DEM,30001,1,7,26,34,
Atoka,Superintendent of Public Instruction,Freda Deskin,DEM,30001,0,0,2,2,
Atoka,U.S. Senate,Connie Johnson,DEM,30001,0,2,9,11,
Atoka,U.S. Senate,Jim Rogers,DEM,30001,1,5,18,24,
Atoka,Superintendent of Public Instruction,John Cox,DEM,30002,3,3,16,22,
Atoka,Superintendent of Public Instruction,Freda Deskin,DEM,30002,0,4,2,6,
Atoka,U.S. Senate,Connie Johnson,DEM,30002,3,2,7,12,
Atoka,U.S. Senate,Jim Rogers,DEM,30002,0,5,11,16,
Atoka,Superintendent of Public Instruction,John Cox,DEM,30003,0,3,16,19,
Atoka,Superintendent of Public Instruction,Freda Deskin,DEM,30003,0,0,2,2,
Atoka,U.S. Senate,Connie Johnson,DEM,30003,0,2,1,3,
Atoka,U.S. Senate,Jim Rogers,DEM,30003,0,1,16,17,
Atoka,Superintendent of Public Instruction,John Cox,DEM,30006,1,6,27,34,
Atoka,Superintendent of Public Instruction,Freda Deskin,DEM,30006,0,0,3,3,
Atoka,U.S. Senate,Connie Johnson,DEM,30006,0,2,9,11,
Atoka,U.S. Senate,Jim Rogers,DEM,30006,1,3,17,21,
Atoka,Superintendent of Public Instruction,John Cox,DEM,30007,0,1,19,20,
Atoka,Superintendent of Public Instruction,Freda Deskin,DEM,30007,0,0,3,3,
Atoka,U.S. Senate,Connie Johnson,DEM,30007,0,1,5,6,
Atoka,U.S. Senate,Jim Rogers,DEM,30007,0,0,17,17,
Atoka,Superintendent of Public Instruction,John Cox,DEM,30008,2,1,20,23,
Atoka,Superintendent of Public Instruction,Freda Deskin,DEM,30008,2,0,3,5,
Atoka,U.S. Senate,Connie Johnson,DEM,30008,4,0,8,12,
Atoka,U.S. Senate,Jim Rogers,DEM,30008,0,1,13,14,
Atoka,Superintendent of Public Instruction,John Cox,DEM,30009,1,4,23,28,
Atoka,Superintendent of Public Instruction,Freda Deskin,DEM,30009,0,0,0,0,
Atoka,U.S. Senate,Connie Johnson,DEM,30009,1,3,6,10,
Atoka,U.S. Senate,Jim Rogers,DEM,30009,0,1,13,14,
Atoka,Superintendent of Public Instruction,John Cox,DEM,30010,2,0,17,19,
Atoka,Superintendent of Public Instruction,Freda Deskin,DEM,30010,1,0,4,5,
Atoka,U.S. Senate,Connie Johnson,DEM,30010,3,0,7,10,
Atoka,U.S. Senate,Jim Rogers,DEM,30010,0,0,13,13,
Atoka,Superintendent of Public Instruction,John Cox,DEM,30011,0,9,47,56,
Atoka,Superintendent of Public Instruction,Freda Deskin,DEM,30011,0,2,4,6,
Atoka,U.S. Senate,Connie Johnson,DEM,30011,0,4,10,14,
Atoka,U.S. Senate,Jim Rogers,DEM,30011,0,7,34,41,
Atoka,Superintendent of Public Instruction,John Cox,DEM,30012,0,0,28,28,
Atoka,Superintendent of Public Instruction,Freda Deskin,DEM,30012,0,0,4,4,
Atoka,U.S. Senate,Connie Johnson,DEM,30012,0,0,7,7,
Atoka,U.S. Senate,Jim Rogers,DEM,30012,0,0,25,25,
Atoka,Superintendent of Public Instruction,John Cox,DEM,30013,0,1,16,17,
Atoka,Superintendent of Public Instruction,Freda Deskin,DEM,30013,0,0,2,2,
Atoka,U.S. Senate,Connie Johnson,DEM,30013,0,0,4,4,
Atoka,U.S. Senate,Jim Rogers,DEM,30013,0,1,14,15,
Atoka,Superintendent of Public Instruction,John Cox,DEM,30014,0,0,12,12,
Atoka,Superintendent of Public Instruction,Freda Deskin,DEM,30014,0,0,2,2,
Atoka,U.S. Senate,Connie Johnson,DEM,30014,0,0,5,5,
Atoka,U.S. Senate,Jim Rogers,DEM,30014,0,0,9,9,
Atoka,Superintendent of Public Instruction,John Cox,DEM,30015,0,0,3,3,
Atoka,Superintendent of Public Instruction,Freda Deskin,DEM,30015,0,0,0,0,
Atoka,U.S. Senate,Connie Johnson,DEM,30015,0,0,1,1,
Atoka,U.S. Senate,Jim Rogers,DEM,30015,0,0,2,2,
Atoka,Superintendent of Public Instruction,John Cox,DEM,30016,0,0,0,0,
Atoka,Superintendent of Public Instruction,Freda Deskin,DEM,30016,0,0,0,0,
Atoka,U.S. Senate,Connie Johnson,DEM,30016,0,0,0,0,
Atoka,U.S. Senate,Jim Rogers,DEM,30016,0,0,0,0,
Atoka,Superintendent of Public Instruction,John Cox,DEM,30017,0,0,0,0,
Atoka,Superintendent of Public Instruction,Freda Deskin,DEM,30017,0,0,0,0,
Atoka,U.S. Senate,Connie Johnson,DEM,30017,0,0,0,0,
Atoka,U.S. Senate,Jim Rogers,DEM,30017,0,0,0,0,
Atoka,Superintendent of Public Instruction,John Cox,DEM,30018,0,0,0,0,
Atoka,Superintendent of Public Instruction,Freda Deskin,DEM,30018,0,0,0,0,
Atoka,U.S. Senate,Connie Johnson,DEM,30018,0,0,0,0,
Atoka,U.S. Senate,Jim Rogers,DEM,30018,0,0,0,0,
Atoka,Superintendent of Public Instruction,John Cox,DEM,30019,0,0,3,3,
Atoka,Superintendent of Public Instruction,Freda Deskin,DEM,30019,0,0,0,0,
Atoka,U.S. Senate,Connie Johnson,DEM,30019,0,0,0,0,
Atoka,U.S. Senate,Jim Rogers,DEM,30019,0,0,3,3,
Beaver,Superintendent of Public Instruction,John Cox,DEM,40011,0,2,8,10,
Beaver,Superintendent of Public Instruction,Freda Deskin,DEM,40011,0,0,3,3,
Beaver,U.S. Senate,Connie Johnson,DEM,40011,0,1,7,8,
Beaver,U.S. Senate,Jim Rogers,DEM,40011,0,1,4,5,
Beaver,State House,Casey Murdock,REP,40011,2,10,41,53,61
Beaver,State House,Kenny Bob Tapp,REP,40011,0,4,24,28,61
Beaver,Superintendent of Public Instruction,John Cox,DEM,40013,1,0,3,4,
Beaver,Superintendent of Public Instruction,Freda Deskin,DEM,40013,0,0,2,2,
Beaver,U.S. Senate,Connie Johnson,DEM,40013,0,0,3,3,
Beaver,U.S. Senate,Jim Rogers,DEM,40013,0,0,2,2,
Beaver,State House,Casey Murdock,REP,40013,2,0,17,19,61
Beaver,State House,Kenny Bob Tapp,REP,40013,0,0,21,21,61
Beaver,Superintendent of Public Instruction,John Cox,DEM,40023,3,2,16,21,
Beaver,Superintendent of Public Instruction,Freda Deskin,DEM,40023,0,3,3,6,
Beaver,U.S. Senate,Connie Johnson,DEM,40023,2,2,6,10,
Beaver,U.S. Senate,Jim Rogers,DEM,40023,1,3,11,15,
Beaver,State House,Casey Murdock,REP,40023,4,11,87,102,61
Beaver,State House,Kenny Bob Tapp,REP,40023,5,14,93,112,61
Beaver,Superintendent of Public Instruction,John Cox,DEM,40025,0,0,5,5,
Beaver,Superintendent of Public Instruction,Freda Deskin,DEM,40025,0,0,6,6,
Beaver,U.S. Senate,Connie Johnson,DEM,40025,0,0,6,6,
Beaver,U.S. Senate,Jim Rogers,DEM,40025,0,0,5,5,
Beaver,State House,Casey Murdock,REP,40025,0,0,20,20,61
Beaver,State House,Kenny Bob Tapp,REP,40025,4,0,13,17,61
Beaver,Superintendent of Public Instruction,John Cox,DEM,40026,0,1,0,1,
Beaver,Superintendent of Public Instruction,Freda Deskin,DEM,40026,0,0,0,0,
Beaver,U.S. Senate,Connie Johnson,DEM,40026,0,1,0,1,
Beaver,U.S. Senate,Jim Rogers,DEM,40026,0,0,0,0,
Beaver,State House,Casey Murdock,REP,40026,0,1,15,16,61
Beaver,State House,Kenny Bob Tapp,REP,40026,0,0,0,0,61
Beaver,Superintendent of Public Instruction,John Cox,DEM,40031,0,0,10,10,
Beaver,Superintendent of Public Instruction,Freda Deskin,DEM,40031,0,1,0,1,
Beaver,U.S. Senate,Connie Johnson,DEM,40031,0,0,1,1,
Beaver,U.S. Senate,Jim Rogers,DEM,40031,0,1,7,8,
Beaver,State House,Casey Murdock,REP,40031,1,2,72,75,61
Beaver,State House,Kenny Bob Tapp,REP,40031,1,2,31,34,61
Beaver,Superintendent of Public Instruction,John Cox,DEM,40033,0,1,27,28,
Beaver,Superintendent of Public Instruction,Freda Deskin,DEM,40033,0,0,18,18,
Beaver,U.S. Senate,Connie Johnson,DEM,40033,0,0,14,14,
Beaver,U.S. Senate,Jim Rogers,DEM,40033,0,1,27,28,
Beaver,State House,Casey Murdock,REP,40033,4,2,186,192,61
Beaver,State House,Kenny Bob Tapp,REP,40033,3,1,80,84,61
Beckham,Superintendent of Public Instruction,John Cox,DEM,50111,1,3,30,34,
Beckham,Superintendent of Public Instruction,Freda Deskin,DEM,50111,0,0,13,13,
Beckham,U.S. Senate,Connie Johnson,DEM,50111,1,2,22,25,
Beckham,U.S. Senate,Jim Rogers,DEM,50111,0,1,19,20,
Beckham,Superintendent of Public Instruction,John Cox,DEM,50112,0,1,8,9,
Beckham,Superintendent of Public Instruction,Freda Deskin,DEM,50112,0,1,5,6,
Beckham,U.S. Senate,Connie Johnson,DEM,50112,0,0,7,7,
Beckham,U.S. Senate,Jim Rogers,DEM,50112,0,2,6,8,
Beckham,Superintendent of Public Instruction,John Cox,DEM,50115,0,1,2,3,
Beckham,Superintendent of Public Instruction,Freda Deskin,DEM,50115,0,1,1,2,
Beckham,U.S. Senate,Connie Johnson,DEM,50115,0,2,1,3,
Beckham,U.S. Senate,Jim Rogers,DEM,50115,0,0,1,1,
Beckham,Superintendent of Public Instruction,John Cox,DEM,50141,4,0,10,14,
Beckham,Superintendent of Public Instruction,Freda Deskin,DEM,50141,0,0,5,5,
Beckham,U.S. Senate,Connie Johnson,DEM,50141,2,0,7,9,
Beckham,U.S. Senate,Jim Rogers,DEM,50141,1,0,7,8,
Beckham,Superintendent of Public Instruction,John Cox,DEM,50231,0,2,2,4,
Beckham,Superintendent of Public Instruction,Freda Deskin,DEM,50231,0,0,2,2,
Beckham,U.S. Senate,Connie Johnson,DEM,50231,0,2,3,5,
Beckham,U.S. Senate,Jim Rogers,DEM,50231,0,0,1,1,
Beckham,Superintendent of Public Instruction,John Cox,DEM,50232,0,0,2,2,
Beckham,Superintendent of Public Instruction,Freda Deskin,DEM,50232,0,0,1,1,
Beckham,U.S. Senate,Connie Johnson,DEM,50232,0,0,3,3,
Beckham,U.S. Senate,Jim Rogers,DEM,50232,0,0,0,0,
Beckham,Superintendent of Public Instruction,John Cox,DEM,50235,1,0,21,22,
Beckham,Superintendent of Public Instruction,Freda Deskin,DEM,50235,0,0,11,11,
Beckham,U.S. Senate,Connie Johnson,DEM,50235,1,0,20,21,
Beckham,U.S. Senate,Jim Rogers,DEM,50235,0,0,11,11,
Beckham,Superintendent of Public Instruction,John Cox,DEM,50242,2,0,12,14,
Beckham,Superintendent of Public Instruction,Freda Deskin,DEM,50242,0,0,5,5,
Beckham,U.S. Senate,Connie Johnson,DEM,50242,2,0,5,7,
Beckham,U.S. Senate,Jim Rogers,DEM,50242,0,0,12,12,
Beckham,Superintendent of Public Instruction,John Cox,DEM,50320,2,0,12,14,
Beckham,Superintendent of Public Instruction,Freda Deskin,DEM,50320,0,0,6,6,
Beckham,U.S. Senate,Connie Johnson,DEM,50320,1,0,8,9,
Beckham,U.S. Senate,Jim Rogers,DEM,50320,1,0,10,11,
Beckham,Superintendent of Public Instruction,John Cox,DEM,50330,0,0,4,4,
Beckham,Superintendent of Public Instruction,Freda Deskin,DEM,50330,0,0,4,4,
Beckham,U.S. Senate,Connie Johnson,DEM,50330,0,0,4,4,
Beckham,U.S. Senate,Jim Rogers,DEM,50330,0,0,4,4,
Beckham,Superintendent of Public Instruction,John Cox,DEM,50332,1,0,24,25,
Beckham,Superintendent of Public Instruction,Freda Deskin,DEM,50332,2,0,9,11,
Beckham,U.S. Senate,Connie Johnson,DEM,50332,1,0,22,23,
Beckham,U.S. Senate,Jim Rogers,DEM,50332,1,0,10,11,
Beckham,Superintendent of Public Instruction,John Cox,DEM,50333,1,0,14,15,
Beckham,Superintendent of Public Instruction,Freda Deskin,DEM,50333,1,0,11,12,
Beckham,U.S. Senate,Connie Johnson,DEM,50333,3,0,13,16,
Beckham,U.S. Senate,Jim Rogers,DEM,50333,0,0,12,12,
Beckham,Superintendent of Public Instruction,John Cox,DEM,50343,1,1,6,8,
Beckham,Superintendent of Public Instruction,Freda Deskin,DEM,50343,0,0,2,2,
Beckham,U.S. Senate,Connie Johnson,DEM,50343,0,1,3,4,
Beckham,U.S. Senate,Jim Rogers,DEM,50343,1,0,5,6,
Blaine,Superintendent of Public Instruction,John Cox,DEM,60002,1,0,58,59,
Blaine,Superintendent of Public Instruction,Freda Deskin,DEM,60002,1,2,23,26,
Blaine,U.S. Senate,Connie Johnson,DEM,60002,1,1,34,36,
Blaine,U.S. Senate,Jim Rogers,DEM,60002,1,1,45,47,
Blaine,Superintendent of Public Instruction,John Cox,DEM,60007,0,0,17,17,
Blaine,Superintendent of Public Instruction,Freda Deskin,DEM,60007,0,0,9,9,
Blaine,U.S. Senate,Connie Johnson,DEM,60007,0,0,11,11,
Blaine,U.S. Senate,Jim Rogers,DEM,60007,0,0,15,15,
Blaine,Superintendent of Public Instruction,John Cox,DEM,60010,1,0,7,8,
Blaine,Superintendent of Public Instruction,Freda Deskin,DEM,60010,0,0,0,0,
Blaine,U.S. Senate,Connie Johnson,DEM,60010,1,0,3,4,
Blaine,U.S. Senate,Jim Rogers,DEM,60010,0,0,4,4,
Blaine,Superintendent of Public Instruction,John Cox,DEM,60011,0,1,6,7,
Blaine,Superintendent of Public Instruction,Freda Deskin,DEM,60011,0,1,6,7,
Blaine,U.S. Senate,Connie Johnson,DEM,60011,0,0,5,5,
Blaine,U.S. Senate,Jim Rogers,DEM,60011,0,2,6,8,
Blaine,Superintendent of Public Instruction,John Cox,DEM,60012,4,1,43,48,
Blaine,Superintendent of Public Instruction,Freda Deskin,DEM,60012,2,2,11,15,
Blaine,U.S. Senate,Connie Johnson,DEM,60012,6,3,26,35,
Blaine,U.S. Senate,Jim Rogers,DEM,60012,0,0,28,28,
Blaine,Superintendent of Public Instruction,John Cox,DEM,60016,1,2,6,9,
Blaine,Superintendent of Public Instruction,Freda Deskin,DEM,60016,0,1,1,2,
Blaine,U.S. Senate,Connie Johnson,DEM,60016,1,3,3,7,
Blaine,U.S. Senate,Jim Rogers,DEM,60016,0,0,4,4,
Blaine,Superintendent of Public Instruction,John Cox,DEM,60017,0,0,27,27,
Blaine,Superintendent of Public Instruction,Freda Deskin,DEM,60017,0,0,11,11,
Blaine,U.S. Senate,Connie Johnson,DEM,60017,0,0,16,16,
Blaine,U.S. Senate,Jim Rogers,DEM,60017,0,0,21,21,
Blaine,Superintendent of Public Instruction,John Cox,DEM,60020,0,0,10,10,
Blaine,Superintendent of Public Instruction,Freda Deskin,DEM,60020,0,0,3,3,
Blaine,U.S. Senate,Connie Johnson,DEM,60020,0,0,8,8,
Blaine,U.S. Senate,Jim Rogers,DEM,60020,0,0,5,5,
Blaine,Superintendent of Public Instruction,John Cox,DEM,60022,0,0,4,4,
Blaine,Superintendent of Public Instruction,Freda Deskin,DEM,60022,0,0,1,1,
Blaine,U.S. Senate,Connie Johnson,DEM,60022,0,0,2,2,
Blaine,U.S. Senate,Jim Rogers,DEM,60022,0,0,3,3,
Bryan,Superintendent of Public Instruction,John Cox,DEM,70003,1,0,24,25,
Bryan,Superintendent of Public Instruction,Freda Deskin,DEM,70003,0,1,7,8,
Bryan,U.S. Senate,Connie Johnson,DEM,70003,0,0,12,12,
Bryan,U.S. Senate,Jim Rogers,DEM,70003,1,1,17,19,
Bryan,Superintendent of Public Instruction,John Cox,DEM,70004,0,3,27,30,
Bryan,Superintendent of Public Instruction,Freda Deskin,DEM,70004,3,2,5,10,
Bryan,U.S. Senate,Connie Johnson,DEM,70004,0,3,16,19,
Bryan,U.S. Senate,Jim Rogers,DEM,70004,1,2,16,19,
Bryan,Superintendent of Public Instruction,John Cox,DEM,70005,4,3,32,39,
Bryan,Superintendent of Public Instruction,Freda Deskin,DEM,70005,0,0,9,9,
Bryan,U.S. Senate,Connie Johnson,DEM,70005,2,0,21,23,
Bryan,U.S. Senate,Jim Rogers,DEM,70005,3,3,19,25,
Bryan,Superintendent of Public Instruction,John Cox,DEM,70008,3,4,33,40,
Bryan,Superintendent of Public Instruction,Freda Deskin,DEM,70008,7,0,9,16,
Bryan,U.S. Senate,Connie Johnson,DEM,70008,9,2,21,32,
Bryan,U.S. Senate,Jim Rogers,DEM,70008,1,1,19,21,
Bryan,Superintendent of Public Instruction,John Cox,DEM,70010,0,4,29,33,
Bryan,Superintendent of Public Instruction,Freda Deskin,DEM,70010,0,0,4,4,
Bryan,U.S. Senate,Connie Johnson,DEM,70010,0,2,10,12,
Bryan,U.S. Senate,Jim Rogers,DEM,70010,0,2,23,25,
Bryan,Superintendent of Public Instruction,John Cox,DEM,70011,0,0,15,15,
Bryan,Superintendent of Public Instruction,Freda Deskin,DEM,70011,0,0,7,7,
Bryan,U.S. Senate,Connie Johnson,DEM,70011,0,0,7,7,
Bryan,U.S. Senate,Jim Rogers,DEM,70011,0,0,13,13,
Bryan,Superintendent of Public Instruction,John Cox,DEM,70013,0,0,30,30,
Bryan,Superintendent of Public Instruction,Freda Deskin,DEM,70013,1,0,12,13,
Bryan,U.S. Senate,Connie Johnson,DEM,70013,1,0,7,8,
Bryan,U.S. Senate,Jim Rogers,DEM,70013,0,0,29,29,
Bryan,Superintendent of Public Instruction,John Cox,DEM,70014,0,0,30,30,
Bryan,Superintendent of Public Instruction,Freda Deskin,DEM,70014,0,0,13,13,
Bryan,U.S. Senate,Connie Johnson,DEM,70014,0,0,17,17,
Bryan,U.S. Senate,Jim Rogers,DEM,70014,0,0,26,26,
Bryan,Superintendent of Public Instruction,John Cox,DEM,70015,2,0,99,101,
Bryan,Superintendent of Public Instruction,Freda Deskin,DEM,70015,1,0,23,24,
Bryan,U.S. Senate,Connie Johnson,DEM,70015,0,0,38,38,
Bryan,U.S. Senate,Jim Rogers,DEM,70015,3,0,74,77,
Bryan,Superintendent of Public Instruction,John Cox,DEM,70017,1,0,20,21,
Bryan,Superintendent of Public Instruction,Freda Deskin,DEM,70017,0,0,6,6,
Bryan,U.S. Senate,Connie Johnson,DEM,70017,0,0,13,13,
Bryan,U.S. Senate,Jim Rogers,DEM,70017,1,0,12,13,
Bryan,Superintendent of Public Instruction,John Cox,DEM,70018,7,0,36,43,
Bryan,Superintendent of Public Instruction,Freda Deskin,DEM,70018,1,1,5,7,
Bryan,U.S. Senate,Connie Johnson,DEM,70018,4,1,17,22,
Bryan,U.S. Senate,Jim Rogers,DEM,70018,4,0,23,27,
Bryan,Superintendent of Public Instruction,John Cox,DEM,70019,0,3,18,21,
Bryan,Superintendent of Public Instruction,Freda Deskin,DEM,70019,0,1,8,9,
Bryan,U.S. Senate,Connie Johnson,DEM,70019,0,0,6,6,
Bryan,U.S. Senate,Jim Rogers,DEM,70019,0,4,20,24,
Bryan,Superintendent of Public Instruction,John Cox,DEM,70020,0,0,12,12,
Bryan,Superintendent of Public Instruction,Freda Deskin,DEM,70020,2,0,1,3,
Bryan,U.S. Senate,Connie Johnson,DEM,70020,0,0,5,5,
Bryan,U.S. Senate,Jim Rogers,DEM,70020,2,0,8,10,
Bryan,Superintendent of Public Instruction,John Cox,DEM,70021,0,0,12,12,
Bryan,Superintendent of Public Instruction,Freda Deskin,DEM,70021,0,0,10,10,
Bryan,U.S. Senate,Connie Johnson,DEM,70021,0,0,11,11,
Bryan,U.S. Senate,Jim Rogers,DEM,70021,0,0,9,9,
Bryan,Superintendent of Public Instruction,John Cox,DEM,70022,7,0,29,36,
Bryan,Superintendent of Public Instruction,Freda Deskin,DEM,70022,4,0,11,15,
Bryan,U.S. Senate,Connie Johnson,DEM,70022,6,0,16,22,
Bryan,U.S. Senate,Jim Rogers,DEM,70022,5,0,21,26,
Bryan,Superintendent of Public Instruction,John Cox,DEM,70023,0,0,19,19,
Bryan,Superintendent of Public Instruction,Freda Deskin,DEM,70023,0,0,6,6,
Bryan,U.S. Senate,Connie Johnson,DEM,70023,0,0,4,4,
Bryan,U.S. Senate,Jim Rogers,DEM,70023,0,0,19,19,
Bryan,Superintendent of Public Instruction,John Cox,DEM,70025,3,0,26,29,
Bryan,Superintendent of Public Instruction,Freda Deskin,DEM,70025,1,0,18,19,
Bryan,U.S. Senate,Connie Johnson,DEM,70025,3,0,18,21,
Bryan,U.S. Senate,Jim Rogers,DEM,70025,1,0,24,25,
Bryan,Superintendent of Public Instruction,John Cox,DEM,70026,0,0,15,15,
Bryan,Superintendent of Public Instruction,Freda Deskin,DEM,70026,0,0,4,4,
Bryan,U.S. Senate,Connie Johnson,DEM,70026,0,0,4,4,
Bryan,U.S. Senate,Jim Rogers,DEM,70026,0,0,14,14,
Bryan,Superintendent of Public Instruction,John Cox,DEM,70027,0,1,0,1,
Bryan,Superintendent of Public Instruction,Freda Deskin,DEM,70027,0,1,0,1,
Bryan,U.S. Senate,Connie Johnson,DEM,70027,0,0,0,0,
Bryan,U.S. Senate,Jim Rogers,DEM,70027,0,1,0,1,
Bryan,Superintendent of Public Instruction,John Cox,DEM,70028,0,2,29,31,
Bryan,Superintendent of Public Instruction,Freda Deskin,DEM,70028,0,0,16,16,
Bryan,U.S. Senate,Connie Johnson,DEM,70028,0,2,15,17,
Bryan,U.S. Senate,Jim Rogers,DEM,70028,0,0,29,29,
Bryan,Superintendent of Public Instruction,John Cox,DEM,70029,0,1,31,32,
Bryan,Superintendent of Public Instruction,Freda Deskin,DEM,70029,0,0,11,11,
Bryan,U.S. Senate,Connie Johnson,DEM,70029,0,0,10,10,
Bryan,U.S. Senate,Jim Rogers,DEM,70029,0,1,29,30,
Bryan,Superintendent of Public Instruction,John Cox,DEM,70033,1,4,49,54,
Bryan,Superintendent of Public Instruction,Freda Deskin,DEM,70033,3,0,12,15,
Bryan,U.S. Senate,Connie Johnson,DEM,70033,3,2,23,28,
Bryan,U.S. Senate,Jim Rogers,DEM,70033,1,2,35,38,
Caddo,Superintendent of Public Instruction,John Cox,DEM,80012,1,1,5,7,
Caddo,Superintendent of Public Instruction,Freda Deskin,DEM,80012,0,0,2,2,
Caddo,U.S. Senate,Connie Johnson,DEM,80012,0,1,6,7,
Caddo,U.S. Senate,Jim Rogers,DEM,80012,1,0,1,2,
Caddo,Superintendent of Public Instruction,John Cox,DEM,80022,5,6,23,34,
Caddo,Superintendent of Public Instruction,Freda Deskin,DEM,80022,1,0,11,12,
Caddo,U.S. Senate,Connie Johnson,DEM,80022,1,4,14,19,
Caddo,U.S. Senate,Jim Rogers,DEM,80022,5,2,20,27,
Caddo,Superintendent of Public Instruction,John Cox,DEM,80031,1,2,12,15,
Caddo,Superintendent of Public Instruction,Freda Deskin,DEM,80031,0,2,10,12,
Caddo,U.S. Senate,Connie Johnson,DEM,80031,0,2,10,12,
Caddo,U.S. Senate,Jim Rogers,DEM,80031,1,2,12,15,
Caddo,Superintendent of Public Instruction,John Cox,DEM,80041,3,5,25,33,
Caddo,Superintendent of Public Instruction,Freda Deskin,DEM,80041,1,1,20,22,
Caddo,U.S. Senate,Connie Johnson,DEM,80041,2,3,22,27,
Caddo,U.S. Senate,Jim Rogers,DEM,80041,2,3,21,26,
Caddo,Superintendent of Public Instruction,John Cox,DEM,80051,0,5,44,49,
Caddo,Superintendent of Public Instruction,Freda Deskin,DEM,80051,0,2,22,24,
Caddo,U.S. Senate,Connie Johnson,DEM,80051,0,4,39,43,
Caddo,U.S. Senate,Jim Rogers,DEM,80051,0,3,27,30,
Caddo,Superintendent of Public Instruction,John Cox,DEM,80102,4,1,42,47,
Caddo,Superintendent of Public Instruction,Freda Deskin,DEM,80102,2,0,10,12,
Caddo,U.S. Senate,Connie Johnson,DEM,80102,3,1,23,27,
Caddo,U.S. Senate,Jim Rogers,DEM,80102,3,0,28,31,
Caddo,Superintendent of Public Instruction,John Cox,DEM,80509,0,0,15,15,
Caddo,Superintendent of Public Instruction,Freda Deskin,DEM,80509,0,0,10,10,
Caddo,U.S. Senate,Connie Johnson,DEM,80509,0,0,12,12,
Caddo,U.S. Senate,Jim Rogers,DEM,80509,0,0,13,13,
Caddo,State House,Scott Hayes,REP,80509,0,0,5,5,65
Caddo,State House,Scooter Park,REP,80509,1,1,7,9,65
Caddo,Superintendent of Public Instruction,John Cox,DEM,80510,0,0,45,45,
Caddo,Superintendent of Public Instruction,Freda Deskin,DEM,80510,0,0,13,13,
Caddo,U.S. Senate,Connie Johnson,DEM,80510,0,0,15,15,
Caddo,U.S. Senate,Jim Rogers,DEM,80510,0,0,44,44,
Caddo,State House,Scott Hayes,REP,80510,2,0,24,26,65
Caddo,State House,Scooter Park,REP,80510,2,0,22,24,65
Caddo,Superintendent of Public Instruction,John Cox,DEM,80511,2,0,72,74,
Caddo,Superintendent of Public Instruction,Freda Deskin,DEM,80511,3,0,29,32,
Caddo,U.S. Senate,Connie Johnson,DEM,80511,4,0,45,49,
Caddo,U.S. Senate,Jim Rogers,DEM,80511,1,0,48,49,
Caddo,State House,Scott Hayes,REP,80511,0,0,17,17,65
Caddo,State House,Scooter Park,REP,80511,0,1,28,29,65
Caddo,Superintendent of Public Instruction,John Cox,DEM,80712,2,2,53,57,
Caddo,Superintendent of Public Instruction,Freda Deskin,DEM,80712,2,0,13,15,
Caddo,U.S. Senate,Connie Johnson,DEM,80712,3,0,30,33,
Caddo,U.S. Senate,Jim Rogers,DEM,80712,1,2,36,39,
Caddo,Superintendent of Public Instruction,John Cox,DEM,80715,1,0,9,10,
Caddo,Superintendent of Public Instruction,Freda Deskin,DEM,80715,0,0,1,1,
Caddo,U.S. Senate,Connie Johnson,DEM,80715,0,0,4,4,
Caddo,U.S. Senate,Jim Rogers,DEM,80715,1,0,6,7,
Caddo,Superintendent of Public Instruction,John Cox,DEM,80810,1,0,14,15,
Caddo,Superintendent of Public Instruction,Freda Deskin,DEM,80810,0,0,1,1,
Caddo,U.S. Senate,Connie Johnson,DEM,80810,0,0,3,3,
Caddo,U.S. Senate,Jim Rogers,DEM,80810,1,0,11,12,
Caddo,Superintendent of Public Instruction,John Cox,DEM,80811,1,0,20,21,
Caddo,Superintendent of Public Instruction,Freda Deskin,DEM,80811,0,1,9,10,
Caddo,U.S. Senate,Connie Johnson,DEM,80811,1,1,17,19,
Caddo,U.S. Senate,Jim Rogers,DEM,80811,0,0,11,11,
Caddo,Superintendent of Public Instruction,John Cox,DEM,80812,2,0,22,24,
Caddo,Superintendent of Public Instruction,Freda Deskin,DEM,80812,1,0,1,2,
Caddo,U.S. Senate,Connie Johnson,DEM,80812,2,0,5,7,
Caddo,U.S. Senate,Jim Rogers,DEM,80812,1,0,17,18,
Caddo,Superintendent of Public Instruction,John Cox,DEM,81009,0,1,17,18,
Caddo,Superintendent of Public Instruction,Freda Deskin,DEM,81009,0,1,7,8,
Caddo,U.S. Senate,Connie Johnson,DEM,81009,0,0,8,8,
Caddo,U.S. Senate,Jim Rogers,DEM,81009,0,2,15,17,
Caddo,Superintendent of Public Instruction,John Cox,DEM,81010,3,0,31,34,
Caddo,Superintendent of Public Instruction,Freda Deskin,DEM,81010,0,0,13,13,
Caddo,U.S. Senate,Connie Johnson,DEM,81010,2,0,14,16,
Caddo,U.S. Senate,Jim Rogers,DEM,81010,1,0,32,33,
Caddo,Superintendent of Public Instruction,John Cox,DEM,81011,0,0,23,23,
Caddo,Superintendent of Public Instruction,Freda Deskin,DEM,81011,0,0,6,6,
Caddo,U.S. Senate,Connie Johnson,DEM,81011,0,0,9,9,
Caddo,U.S. Senate,Jim Rogers,DEM,81011,0,0,20,20,
Caddo,Superintendent of Public Instruction,John Cox,DEM,81013,5,0,14,19,
Caddo,Superintendent of Public Instruction,Freda Deskin,DEM,81013,0,0,5,5,
Caddo,U.S. Senate,Connie Johnson,DEM,81013,2,0,1,3,
Caddo,U.S. Senate,Jim Rogers,DEM,81013,3,0,18,21,
Caddo,Superintendent of Public Instruction,John Cox,DEM,81111,1,1,37,39,
Caddo,Superintendent of Public Instruction,Freda Deskin,DEM,81111,0,0,7,7,
Caddo,U.S. Senate,Connie Johnson,DEM,81111,0,0,21,21,
Caddo,U.S. Senate,Jim Rogers,DEM,81111,1,1,23,25,
Caddo,Superintendent of Public Instruction,John Cox,DEM,81213,1,0,10,11,
Caddo,Superintendent of Public Instruction,Freda Deskin,DEM,81213,0,0,3,3,
Caddo,U.S. Senate,Connie Johnson,DEM,81213,1,0,4,5,
Caddo,U.S. Senate,Jim Rogers,DEM,81213,0,0,9,9,
Canadian,Superintendent of Public Instruction,John Cox,DEM,90100,0,1,20,21,
Canadian,Superintendent of Public Instruction,Freda Deskin,DEM,90100,0,2,8,10,
Canadian,U.S. Senate,Connie Johnson,DEM,90100,0,2,14,16,
Canadian,U.S. Senate,Jim Rogers,DEM,90100,0,1,14,15,
Canadian,Superintendent of Public Instruction,John Cox,DEM,90102,0,0,5,5,
Canadian,Superintendent of Public Instruction,Freda Deskin,DEM,90102,1,0,2,3,
Canadian,U.S. Senate,Connie Johnson,DEM,90102,1,0,4,5,
Canadian,U.S. Senate,Jim Rogers,DEM,90102,0,0,3,3,
Canadian,Superintendent of Public Instruction,John Cox,DEM,90106,0,1,20,21,
Canadian,Superintendent of Public Instruction,Freda Deskin,DEM,90106,2,2,14,18,
Canadian,U.S. Senate,Connie Johnson,DEM,90106,2,3,17,22,
Canadian,U.S. Senate,Jim Rogers,DEM,90106,0,0,16,16,
Canadian,Superintendent of Public Instruction,John Cox,DEM,90107,0,0,5,5,
Canadian,Superintendent of Public Instruction,Freda Deskin,DEM,90107,0,0,2,2,
Canadian,U.S. Senate,Connie Johnson,DEM,90107,0,0,3,3,
Canadian,U.S. Senate,Jim Rogers,DEM,90107,0,0,4,4,
Canadian,Superintendent of Public Instruction,John Cox,DEM,90109,1,0,0,1,
Canadian,Superintendent of Public Instruction,Freda Deskin,DEM,90109,1,0,2,3,
Canadian,U.S. Senate,Connie Johnson,DEM,90109,1,0,0,1,
Canadian,U.S. Senate,Jim Rogers,DEM,90109,1,0,2,3,
Canadian,Superintendent of Public Instruction,John Cox,DEM,90114,0,2,9,11,
Canadian,Superintendent of Public Instruction,Freda Deskin,DEM,90114,3,1,8,12,
Canadian,U.S. Senate,Connie Johnson,DEM,90114,3,2,9,14,
Canadian,U.S. Senate,Jim Rogers,DEM,90114,0,1,7,8,
Canadian,Superintendent of Public Instruction,John Cox,DEM,90116,1,1,11,13,
Canadian,Superintendent of Public Instruction,Freda Deskin,DEM,90116,2,1,20,23,
Canadian,U.S. Senate,Connie Johnson,DEM,90116,3,1,19,23,
Canadian,U.S. Senate,Jim Rogers,DEM,90116,0,0,11,11,
Canadian,Superintendent of Public Instruction,John Cox,DEM,90124,0,4,21,25,
Canadian,Superintendent of Public Instruction,Freda Deskin,DEM,90124,2,1,17,20,
Canadian,U.S. Senate,Connie Johnson,DEM,90124,1,3,27,31,
Canadian,U.S. Senate,Jim Rogers,DEM,90124,0,2,8,10,
Canadian,Superintendent of Public Instruction,John Cox,DEM,90200,3,0,45,48,
Canadian,Superintendent of Public Instruction,Freda Deskin,DEM,90200,2,0,26,28,
Canadian,U.S. Senate,Connie Johnson,DEM,90200,2,0,49,51,
Canadian,U.S. Senate,Jim Rogers,DEM,90200,3,0,21,24,
Canadian,State Senate,Stephanie Bice,REP,90200,11,4,176,191,22
Canadian,State Senate,Mark Thomas,REP,90200,11,3,206,220,22
Canadian,Superintendent of Public Instruction,John Cox,DEM,90201,3,0,13,16,
Canadian,Superintendent of Public Instruction,Freda Deskin,DEM,90201,3,0,9,12,
Canadian,U.S. Senate,Connie Johnson,DEM,90201,1,0,12,13,
Canadian,U.S. Senate,Jim Rogers,DEM,90201,5,0,10,15,
Canadian,Superintendent of Public Instruction,John Cox,DEM,90202,0,0,3,3,
Canadian,Superintendent of Public Instruction,Freda Deskin,DEM,90202,1,0,3,4,
Canadian,U.S. Senate,Connie Johnson,DEM,90202,1,0,3,4,
Canadian,U.S. Senate,Jim Rogers,DEM,90202,0,0,2,2,
Canadian,Superintendent of Public Instruction,John Cox,DEM,90204,2,1,11,14,
Canadian,Superintendent of Public Instruction,Freda Deskin,DEM,90204,0,0,6,6,
Canadian,U.S. Senate,Connie Johnson,DEM,90204,2,1,11,14,
Canadian,U.S. Senate,Jim Rogers,DEM,90204,0,0,6,6,
Canadian,State Senate,Stephanie Bice,REP,90204,1,0,46,47,22
Canadian,State Senate,Mark Thomas,REP,90204,1,0,84,85,22
Canadian,Superintendent of Public Instruction,John Cox,DEM,90206,0,0,22,22,
Canadian,Superintendent of Public Instruction,Freda Deskin,DEM,90206,3,0,15,18,
Canadian,U.S. Senate,Connie Johnson,DEM,90206,3,0,19,22,
Canadian,U.S. Senate,Jim Rogers,DEM,90206,0,0,17,17,
Canadian,State Senate,Stephanie Bice,REP,90206,0,0,107,107,22
Canadian,State Senate,Mark Thomas,REP,90206,4,0,107,111,22
Canadian,Superintendent of Public Instruction,John Cox,DEM,90208,4,0,39,43,
Canadian,Superintendent of Public Instruction,Freda Deskin,DEM,90208,2,0,28,30,
Canadian,U.S. Senate,Connie Johnson,DEM,90208,3,0,42,45,
Canadian,U.S. Senate,Jim Rogers,DEM,90208,3,0,24,27,
Canadian,State Senate,Stephanie Bice,REP,90208,4,1,75,80,22
Canadian,State Senate,Mark Thomas,REP,90208,4,2,93,99,22
Canadian,State House,John Paul Jordan,REP,90208,9,3,137,149,43
Canadian,State House,Jonathan Clour,REP,90208,1,0,34,35,43
Canadian,Superintendent of Public Instruction,John Cox,DEM,90209,0,0,0,0,
Canadian,Superintendent of Public Instruction,Freda Deskin,DEM,90209,0,0,1,1,
Canadian,U.S. Senate,Connie Johnson,DEM,90209,0,0,0,0,
Canadian,U.S. Senate,Jim Rogers,DEM,90209,0,0,1,1,
Canadian,State Senate,Stephanie Bice,REP,90209,0,0,0,0,22
Canadian,State Senate,Mark Thomas,REP,90209,0,0,1,1,22
Canadian,Superintendent of Public Instruction,John Cox,DEM,90210,0,0,9,9,
Canadian,Superintendent of Public Instruction,Freda Deskin,DEM,90210,0,0,4,4,
Canadian,U.S. Senate,Connie Johnson,DEM,90210,0,0,8,8,
Canadian,U.S. Senate,Jim Rogers,DEM,90210,0,0,4,4,
Canadian,State House,John Paul Jordan,REP,90210,2,4,69,75,43
Canadian,State House,Jonathan Clour,REP,90210,1,0,33,34,43
Canadian,Superintendent of Public Instruction,John Cox,DEM,90211,1,0,8,9,
Canadian,Superintendent of Public Instruction,Freda Deskin,DEM,90211,0,0,6,6,
Canadian,U.S. Senate,Connie Johnson,DEM,90211,1,0,6,7,
Canadian,U.S. Senate,Jim Rogers,DEM,90211,0,0,8,8,
Canadian,Superintendent of Public Instruction,John Cox,DEM,90214,2,0,22,24,
Canadian,Superintendent of Public Instruction,Freda Deskin,DEM,90214,0,0,18,18,
Canadian,U.S. Senate,Connie Johnson,DEM,90214,1,0,29,30,
Canadian,U.S. Senate,Jim Rogers,DEM,90214,1,0,12,13,
Canadian,State Senate,Stephanie Bice,REP,90214,5,1,66,72,22
Canadian,State Senate,Mark Thomas,REP,90214,6,3,134,143,22
Canadian,State House,John Paul Jordan,REP,90214,9,3,123,135,43
Canadian,State House,Jonathan Clour,REP,90214,2,1,75,78,43
Canadian,Superintendent of Public Instruction,John Cox,DEM,90215,1,0,12,13,
Canadian,Superintendent of Public Instruction,Freda Deskin,DEM,90215,3,0,14,17,
Canadian,U.S. Senate,Connie Johnson,DEM,90215,4,0,19,23,
Canadian,U.S. Senate,Jim Rogers,DEM,90215,0,0,7,7,
Canadian,State House,John Paul Jordan,REP,90215,7,2,109,118,43
Canadian,State House,Jonathan Clour,REP,90215,5,0,63,68,43
Canadian,Superintendent of Public Instruction,John Cox,DEM,90216,1,0,42,43,
Canadian,Superintendent of Public Instruction,Freda Deskin,DEM,90216,0,0,24,24,
Canadian,U.S. Senate,Connie Johnson,DEM,90216,1,0,35,36,
Canadian,U.S. Senate,Jim Rogers,DEM,90216,0,0,27,27,
Canadian,State Senate,Stephanie Bice,REP,90216,11,2,128,141,22
Canadian,State Senate,Mark Thomas,REP,90216,6,2,204,212,22
Canadian,State House,John Paul Jordan,REP,90216,9,4,243,256,43
Canadian,State House,Jonathan Clour,REP,90216,8,0,88,96,43
Canadian,Superintendent of Public Instruction,John Cox,DEM,90217,0,0,17,17,
Canadian,Superintendent of Public Instruction,Freda Deskin,DEM,90217,2,0,16,18,
Canadian,U.S. Senate,Connie Johnson,DEM,90217,2,0,26,28,
Canadian,U.S. Senate,Jim Rogers,DEM,90217,0,0,7,7,
Canadian,State Senate,Stephanie Bice,REP,90217,10,0,78,88,22
Canadian,State Senate,Mark Thomas,REP,90217,3,1,89,93,22
Canadian,State House,John Paul Jordan,REP,90217,2,2,106,110,43
Canadian,State House,Jonathan Clour,REP,90217,10,0,61,71,43
Canadian,Superintendent of Public Instruction,John Cox,DEM,90218,0,0,13,13,
Canadian,Superintendent of Public Instruction,Freda Deskin,DEM,90218,1,0,14,15,
Canadian,U.S. Senate,Connie Johnson,DEM,90218,0,0,18,18,
Canadian,U.S. Senate,Jim Rogers,DEM,90218,1,0,9,10,
Canadian,State Senate,Stephanie Bice,REP,90218,5,0,65,70,22
Canadian,State Senate,Mark Thomas,REP,90218,2,0,89,91,22
Canadian,State House,John Paul Jordan,REP,90218,2,0,114,116,43
Canadian,State House,Jonathan Clour,REP,90218,5,0,39,44,43
Canadian,Superintendent of Public Instruction,John Cox,DEM,90220,2,0,22,24,
Canadian,Superintendent of Public Instruction,Freda Deskin,DEM,90220,1,0,19,20,
Canadian,U.S. Senate,Connie Johnson,DEM,90220,2,0,28,30,
Canadian,U.S. Senate,Jim Rogers,DEM,90220,1,0,12,13,
Canadian,State Senate,Stephanie Bice,REP,90220,6,2,133,141,22
Canadian,State Senate,Mark Thomas,REP,90220,7,0,112,119,22
Canadian,State House,John Paul Jordan,REP,90220,10,2,141,153,43
Canadian,State House,Jonathan Clour,REP,90220,3,0,105,108,43
Canadian,Superintendent of Public Instruction,John Cox,DEM,90221,0,0,14,14,
Canadian,Superintendent of Public Instruction,Freda Deskin,DEM,90221,0,0,17,17,
Canadian,U.S. Senate,Connie Johnson,DEM,90221,0,0,25,25,
Canadian,U.S. Senate,Jim Rogers,DEM,90221,0,0,6,6,
Canadian,State House,John Paul Jordan,REP,90221,2,0,66,68,43
Canadian,State House,Jonathan Clour,REP,90221,3,2,23,28,43
Canadian,Superintendent of Public Instruction,John Cox,DEM,90223,1,0,20,21,
Canadian,Superintendent of Public Instruction,Freda Deskin,DEM,90223,1,0,21,22,
Canadian,U.S. Senate,Connie Johnson,DEM,90223,2,0,28,30,
Canadian,U.S. Senate,Jim Rogers,DEM,90223,0,0,13,13,
Canadian,State House,John Paul Jordan,REP,90223,4,1,126,131,43
Canadian,State House,Jonathan Clour,REP,90223,0,0,32,32,43
Canadian,Superintendent of Public Instruction,John Cox,DEM,90224,1,0,4,5,
Canadian,Superintendent of Public Instruction,Freda Deskin,DEM,90224,0,0,7,7,
Canadian,U.S. Senate,Connie Johnson,DEM,90224,0,0,9,9,
Canadian,U.S. Senate,Jim Rogers,DEM,90224,1,0,2,3,
Canadian,State House,John Paul Jordan,REP,90224,0,0,18,18,43
Canadian,State House,Jonathan Clour,REP,90224,0,0,5,5,43
Canadian,Superintendent of Public Instruction,John Cox,DEM,90225,1,0,23,24,
Canadian,Superintendent of Public Instruction,Freda Deskin,DEM,90225,1,0,8,9,
Canadian,U.S. Senate,Connie Johnson,DEM,90225,1,0,25,26,
Canadian,U.S. Senate,Jim Rogers,DEM,90225,1,0,6,7,
Canadian,Superintendent of Public Instruction,John Cox,DEM,90226,1,0,2,3,
Canadian,Superintendent of Public Instruction,Freda Deskin,DEM,90226,0,0,3,3,
Canadian,U.S. Senate,Connie Johnson,DEM,90226,1,0,4,5,
Canadian,U.S. Senate,Jim Rogers,DEM,90226,0,0,1,1,
Canadian,Superintendent of Public Instruction,John Cox,DEM,90227,3,0,16,19,
Canadian,Superintendent of Public Instruction,Freda Deskin,DEM,90227,3,0,8,11,
Canadian,U.S. Senate,Connie Johnson,DEM,90227,3,0,17,20,
Canadian,U.S. Senate,Jim Rogers,DEM,90227,3,0,9,12,
Canadian,Superintendent of Public Instruction,John Cox,DEM,90228,0,0,2,2,
Canadian,Superintendent of Public Instruction,Freda Deskin,DEM,90228,0,0,4,4,
Canadian,U.S. Senate,Connie Johnson,DEM,90228,0,0,5,5,
Canadian,U.S. Senate,Jim Rogers,DEM,90228,0,0,1,1,
Canadian,State House,John Paul Jordan,REP,90228,1,0,12,13,43
Canadian,State House,Jonathan Clour,REP,90228,2,0,4,6,43
Canadian,Superintendent of Public Instruction,John Cox,DEM,90300,1,0,16,17,
Canadian,Superintendent of Public Instruction,Freda Deskin,DEM,90300,0,0,12,12,
Canadian,U.S. Senate,Connie Johnson,DEM,90300,1,0,14,15,
Canadian,U.S. Senate,Jim Rogers,DEM,90300,0,0,13,13,
Canadian,Superintendent of Public Instruction,John Cox,DEM,90301,1,0,17,18,
Canadian,Superintendent of Public Instruction,Freda Deskin,DEM,90301,4,0,14,18,
Canadian,U.S. Senate,Connie Johnson,DEM,90301,4,0,19,23,
Canadian,U.S. Senate,Jim Rogers,DEM,90301,1,0,12,13,
Canadian,Superintendent of Public Instruction,John Cox,DEM,90302,0,0,13,13,
Canadian,Superintendent of Public Instruction,Freda Deskin,DEM,90302,1,0,13,14,
Canadian,U.S. Senate,Connie Johnson,DEM,90302,1,0,19,20,
Canadian,U.S. Senate,Jim Rogers,DEM,90302,0,0,7,7,
Canadian,Superintendent of Public Instruction,John Cox,DEM,90303,1,0,16,17,
Canadian,Superintendent of Public Instruction,Freda Deskin,DEM,90303,0,1,14,15,
Canadian,U.S. Senate,Connie Johnson,DEM,90303,1,1,21,23,
Canadian,U.S. Senate,Jim Rogers,DEM,90303,0,0,9,9,
Canadian,Superintendent of Public Instruction,John Cox,DEM,90304,0,0,13,13,
Canadian,Superintendent of Public Instruction,Freda Deskin,DEM,90304,0,0,6,6,
Canadian,U.S. Senate,Connie Johnson,DEM,90304,0,0,10,10,
Canadian,U.S. Senate,Jim Rogers,DEM,90304,0,0,8,8,
Canadian,Superintendent of Public Instruction,John Cox,DEM,90306,5,1,13,19,
Canadian,Superintendent of Public Instruction,Freda Deskin,DEM,90306,5,0,17,22,
Canadian,U.S. Senate,Connie Johnson,DEM,90306,5,1,17,23,
Canadian,U.S. Senate,Jim Rogers,DEM,90306,5,0,11,16,
Canadian,Superintendent of Public Instruction,John Cox,DEM,90308,0,0,1,1,
Canadian,Superintendent of Public Instruction,Freda Deskin,DEM,90308,0,0,2,2,
Canadian,U.S. Senate,Connie Johnson,DEM,90308,0,0,1,1,
Canadian,U.S. Senate,Jim Rogers,DEM,90308,0,0,2,2,
Canadian,Superintendent of Public Instruction,John Cox,DEM,90309,0,0,0,0,
Canadian,Superintendent of Public Instruction,Freda Deskin,DEM,90309,0,0,2,2,
Canadian,U.S. Senate,Connie Johnson,DEM,90309,0,0,0,0,
Canadian,U.S. Senate,Jim Rogers,DEM,90309,0,0,2,2,
Canadian,Superintendent of Public Instruction,John Cox,DEM,90398,0,0,0,0,
Canadian,Superintendent of Public Instruction,Freda Deskin,DEM,90398,0,0,0,0,
Canadian,U.S. Senate,Connie Johnson,DEM,90398,0,0,0,0,
Canadian,U.S. Senate,Jim Rogers,DEM,90398,0,0,0,0,
Canadian,Superintendent of Public Instruction,John Cox,DEM,90399,0,0,0,0,
Canadian,Superintendent of Public Instruction,Freda Deskin,DEM,90399,0,0,0,0,
Canadian,U.S. Senate,Connie Johnson,DEM,90399,0,0,0,0,
Canadian,U.S. Senate,Jim Rogers,DEM,90399,0,0,0,0,
Canadian,Superintendent of Public Instruction,John Cox,DEM,90400,0,1,43,44,
Canadian,Superintendent of Public Instruction,Freda Deskin,DEM,90400,0,0,27,27,
Canadian,U.S. Senate,Connie Johnson,DEM,90400,0,1,31,32,
Canadian,U.S. Senate,Jim Rogers,DEM,90400,0,0,40,40,
Canadian,Superintendent of Public Instruction,John Cox,DEM,90403,0,0,5,5,
Canadian,Superintendent of Public Instruction,Freda Deskin,DEM,90403,0,0,0,0,
Canadian,U.S. Senate,Connie Johnson,DEM,90403,0,0,3,3,
Canadian,U.S. Senate,Jim Rogers,DEM,90403,0,0,2,2,
Canadian,Superintendent of Public Instruction,John Cox,DEM,90404,0,0,10,10,
Canadian,Superintendent of Public Instruction,Freda Deskin,DEM,90404,0,0,0,0,
Canadian,U.S. Senate,Connie Johnson,DEM,90404,0,0,3,3,
Canadian,U.S. Senate,Jim Rogers,DEM,90404,0,0,7,7,
Canadian,Superintendent of Public Instruction,John Cox,DEM,90406,0,0,6,6,
Canadian,Superintendent of Public Instruction,Freda Deskin,DEM,90406,0,0,3,3,
Canadian,U.S. Senate,Connie Johnson,DEM,90406,0,0,4,4,
Canadian,U.S. Senate,Jim Rogers,DEM,90406,0,0,5,5,
Canadian,Superintendent of Public Instruction,John Cox,DEM,90408,0,0,17,17,
Canadian,Superintendent of Public Instruction,Freda Deskin,DEM,90408,0,0,5,5,
Canadian,U.S. Senate,Connie Johnson,DEM,90408,0,0,7,7,
Canadian,U.S. Senate,Jim Rogers,DEM,90408,0,0,15,15,
Canadian,Superintendent of Public Instruction,John Cox,DEM,90409,0,0,3,3,
Canadian,Superintendent of Public Instruction,Freda Deskin,DEM,90409,0,0,1,1,
Canadian,U.S. Senate,Connie Johnson,DEM,90409,0,0,1,1,
Canadian,U.S. Senate,Jim Rogers,DEM,90409,0,0,3,3,
Canadian,Superintendent of Public Instruction,John Cox,DEM,90502,0,0,12,12,
Canadian,Superintendent of Public Instruction,Freda Deskin,DEM,90502,0,1,6,7,
Canadian,U.S. Senate,Connie Johnson,DEM,90502,0,0,11,11,
Canadian,U.S. Senate,Jim Rogers,DEM,90502,0,1,7,8,
Canadian,Superintendent of Public Instruction,John Cox,DEM,90503,0,0,4,4,
Canadian,Superintendent of Public Instruction,Freda Deskin,DEM,90503,1,0,4,5,
Canadian,U.S. Senate,Connie Johnson,DEM,90503,1,0,1,2,
Canadian,U.S. Senate,Jim Rogers,DEM,90503,0,0,8,8,
Canadian,State Senate,Stephanie Bice,REP,90503,0,0,26,26,22
Canadian,State Senate,Mark Thomas,REP,90503,1,0,21,22,22
Canadian,Superintendent of Public Instruction,John Cox,DEM,90504,0,0,30,30,
Canadian,Superintendent of Public Instruction,Freda Deskin,DEM,90504,0,0,20,20,
Canadian,U.S. Senate,Connie Johnson,DEM,90504,0,0,32,32,
Canadian,U.S. Senate,Jim Rogers,DEM,90504,0,0,17,17,
Canadian,State Senate,Stephanie Bice,REP,90504,2,2,149,153,22
Canadian,State Senate,Mark Thomas,REP,90504,5,0,130,135,22
Canadian,Superintendent of Public Instruction,John Cox,DEM,90506,1,0,20,21,
Canadian,Superintendent of Public Instruction,Freda Deskin,DEM,90506,0,0,16,16,
Canadian,U.S. Senate,Connie Johnson,DEM,90506,0,0,28,28,
Canadian,U.S. Senate,Jim Rogers,DEM,90506,1,0,7,8,
Canadian,State Senate,Stephanie Bice,REP,90506,2,0,124,126,22
Canadian,State Senate,Mark Thomas,REP,90506,3,3,108,114,22
Carter,Superintendent of Public Instruction,John Cox,DEM,100001,3,2,6,11,
Carter,Superintendent of Public Instruction,Freda Deskin,DEM,100001,0,0,3,3,
Carter,U.S. Senate,Connie Johnson,DEM,100001,2,2,6,10,
Carter,U.S. Senate,Jim Rogers,DEM,100001,0,0,2,2,
Carter,Superintendent of Public Instruction,John Cox,DEM,100002,7,0,11,18,
Carter,Superintendent of Public Instruction,Freda Deskin,DEM,100002,3,0,17,20,
Carter,U.S. Senate,Connie Johnson,DEM,100002,4,0,16,20,
Carter,U.S. Senate,Jim Rogers,DEM,100002,6,0,12,18,
Carter,Superintendent of Public Instruction,John Cox,DEM,100007,2,0,8,10,
Carter,Superintendent of Public Instruction,Freda Deskin,DEM,100007,1,1,9,11,
Carter,U.S. Senate,Connie Johnson,DEM,100007,2,1,15,18,
Carter,U.S. Senate,Jim Rogers,DEM,100007,1,0,2,3,
Carter,Superintendent of Public Instruction,John Cox,DEM,100011,1,3,10,14,
Carter,Superintendent of Public Instruction,Freda Deskin,DEM,100011,0,1,4,5,
Carter,U.S. Senate,Connie Johnson,DEM,100011,0,3,9,12,
Carter,U.S. Senate,Jim Rogers,DEM,100011,1,1,5,7,
Carter,Superintendent of Public Instruction,John Cox,DEM,100014,4,0,7,11,
Carter,Superintendent of Public Instruction,Freda Deskin,DEM,100014,0,0,4,4,
Carter,U.S. Senate,Connie Johnson,DEM,100014,2,0,8,10,
Carter,U.S. Senate,Jim Rogers,DEM,100014,2,0,5,7,
Carter,Superintendent of Public Instruction,John Cox,DEM,100015,8,2,20,30,
Carter,Superintendent of Public Instruction,Freda Deskin,DEM,100015,5,2,12,19,
Carter,U.S. Senate,Connie Johnson,DEM,100015,6,1,14,21,
Carter,U.S. Senate,Jim Rogers,DEM,100015,7,3,16,26,
Carter,Superintendent of Public Instruction,John Cox,DEM,100017,0,2,10,12,
Carter,Superintendent of Public Instruction,Freda Deskin,DEM,100017,2,1,7,10,
Carter,U.S. Senate,Connie Johnson,DEM,100017,1,3,13,17,
Carter,U.S. Senate,Jim Rogers,DEM,100017,1,0,4,5,
Carter,Superintendent of Public Instruction,John Cox,DEM,100019,1,0,26,27,
Carter,Superintendent of Public Instruction,Freda Deskin,DEM,100019,0,5,39,44,
Carter,U.S. Senate,Connie Johnson,DEM,100019,0,5,40,45,
Carter,U.S. Senate,Jim Rogers,DEM,100019,1,0,21,22,
Carter,Superintendent of Public Instruction,John Cox,DEM,100020,1,0,19,20,
Carter,Superintendent of Public Instruction,Freda Deskin,DEM,100020,0,0,12,12,
Carter,U.S. Senate,Connie Johnson,DEM,100020,0,0,14,14,
Carter,U.S. Senate,Jim Rogers,DEM,100020,1,0,18,19,
Carter,Superintendent of Public Instruction,John Cox,DEM,100024,0,0,22,22,
Carter,Superintendent of Public Instruction,Freda Deskin,DEM,100024,1,2,17,20,
Carter,U.S. Senate,Connie Johnson,DEM,100024,1,2,20,23,
Carter,U.S. Senate,Jim Rogers,DEM,100024,0,0,19,19,
Carter,Superintendent of Public Instruction,John Cox,DEM,100025,0,0,6,6,
Carter,Superintendent of Public Instruction,Freda Deskin,DEM,100025,0,0,2,2,
Carter,U.S. Senate,Connie Johnson,DEM,100025,0,0,1,1,
Carter,U.S. Senate,Jim Rogers,DEM,100025,0,0,7,7,
Carter,Superintendent of Public Instruction,John Cox,DEM,100026,0,0,8,8,
Carter,Superintendent of Public Instruction,Freda Deskin,DEM,100026,2,0,7,9,
Carter,U.S. Senate,Connie Johnson,DEM,100026,0,0,7,7,
Carter,U.S. Senate,Jim Rogers,DEM,100026,2,0,8,10,
Carter,Superintendent of Public Instruction,John Cox,DEM,100030,0,0,1,1,
Carter,Superintendent of Public Instruction,Freda Deskin,DEM,100030,0,1,2,3,
Carter,U.S. Senate,Connie Johnson,DEM,100030,0,1,2,3,
Carter,U.S. Senate,Jim Rogers,DEM,100030,0,0,1,1,
Carter,Superintendent of Public Instruction,John Cox,DEM,100031,2,0,22,24,
Carter,Superintendent of Public Instruction,Freda Deskin,DEM,100031,0,0,12,12,
Carter,U.S. Senate,Connie Johnson,DEM,100031,2,0,19,21,
Carter,U.S. Senate,Jim Rogers,DEM,100031,0,0,14,14,
Carter,Superintendent of Public Instruction,John Cox,DEM,100032,0,1,5,6,
Carter,Superintendent of Public Instruction,Freda Deskin,DEM,100032,0,0,2,2,
Carter,U.S. Senate,Connie Johnson,DEM,100032,0,0,2,2,
Carter,U.S. Senate,Jim Rogers,DEM,100032,0,1,5,6,
Carter,Superintendent of Public Instruction,John Cox,DEM,100033,1,0,18,19,
Carter,Superintendent of Public Instruction,Freda Deskin,DEM,100033,1,0,6,7,
Carter,U.S. Senate,Connie Johnson,DEM,100033,2,0,11,13,
Carter,U.S. Senate,Jim Rogers,DEM,100033,0,0,13,13,
Carter,Superintendent of Public Instruction,John Cox,DEM,100034,0,0,12,12,
Carter,Superintendent of Public Instruction,Freda Deskin,DEM,100034,0,0,10,10,
Carter,U.S. Senate,Connie Johnson,DEM,100034,0,0,10,10,
Carter,U.S. Senate,Jim Rogers,DEM,100034,0,0,12,12,
Carter,Superintendent of Public Instruction,John Cox,DEM,100039,0,0,7,7,
Carter,Superintendent of Public Instruction,Freda Deskin,DEM,100039,0,0,3,3,
Carter,U.S. Senate,Connie Johnson,DEM,100039,0,0,7,7,
Carter,U.S. Senate,Jim Rogers,DEM,100039,0,0,3,3,
Carter,Superintendent of Public Instruction,John Cox,DEM,100041,1,0,33,34,
Carter,Superintendent of Public Instruction,Freda Deskin,DEM,100041,1,0,19,20,
Carter,U.S. Senate,Connie Johnson,DEM,100041,1,0,19,20,
Carter,U.S. Senate,Jim Rogers,DEM,100041,1,0,32,33,
Carter,Superintendent of Public Instruction,John Cox,DEM,100051,0,0,7,7,
Carter,Superintendent of Public Instruction,Freda Deskin,DEM,100051,0,1,10,11,
Carter,U.S. Senate,Connie Johnson,DEM,100051,0,1,5,6,
Carter,U.S. Senate,Jim Rogers,DEM,100051,0,0,12,12,
Carter,Superintendent of Public Instruction,John Cox,DEM,100052,2,0,12,14,
Carter,Superintendent of Public Instruction,Freda Deskin,DEM,100052,0,0,7,7,
Carter,U.S. Senate,Connie Johnson,DEM,100052,0,0,2,2,
Carter,U.S. Senate,Jim Rogers,DEM,100052,2,0,16,18,
Carter,Superintendent of Public Instruction,John Cox,DEM,100061,0,0,3,3,
Carter,Superintendent of Public Instruction,Freda Deskin,DEM,100061,0,0,2,2,
Carter,U.S. Senate,Connie Johnson,DEM,100061,0,0,3,3,
Carter,U.S. Senate,Jim Rogers,DEM,100061,0,0,1,1,
Carter,Superintendent of Public Instruction,John Cox,DEM,100062,1,1,23,25,
Carter,Superintendent of Public Instruction,Freda Deskin,DEM,100062,0,2,4,6,
Carter,U.S. Senate,Connie Johnson,DEM,100062,0,0,5,5,
Carter,U.S. Senate,Jim Rogers,DEM,100062,1,3,22,26,
Carter,Superintendent of Public Instruction,John Cox,DEM,100063,0,0,22,22,
Carter,Superintendent of Public Instruction,Freda Deskin,DEM,100063,0,0,6,6,
Carter,U.S. Senate,Connie Johnson,DEM,100063,0,0,14,14,
Carter,U.S. Senate,Jim Rogers,DEM,100063,0,0,12,12,
Carter,Superintendent of Public Instruction,John Cox,DEM,100071,3,0,22,25,
Carter,Superintendent of Public Instruction,Freda Deskin,DEM,100071,3,0,6,9,
Carter,U.S. Senate,Connie Johnson,DEM,100071,1,0,7,8,
Carter,U.S. Senate,Jim Rogers,DEM,100071,6,0,20,26,
Cherokee,Superintendent of Public Instruction,John Cox,DEM,110001,2,6,83,91,
Cherokee,Superintendent of Public Instruction,Freda Deskin,DEM,110001,3,0,21,24,
Cherokee,U.S. Senate,Connie Johnson,DEM,110001,2,2,58,62,
Cherokee,U.S. Senate,Jim Rogers,DEM,110001,2,3,44,49,
Cherokee,Superintendent of Public Instruction,John Cox,DEM,110002,11,38,227,276,
Cherokee,Superintendent of Public Instruction,Freda Deskin,DEM,110002,6,6,42,54,
Cherokee,U.S. Senate,Connie Johnson,DEM,110002,4,20,105,129,
Cherokee,U.S. Senate,Jim Rogers,DEM,110002,13,21,155,189,
Cherokee,Superintendent of Public Instruction,John Cox,DEM,110003,2,32,77,111,
Cherokee,Superintendent of Public Instruction,Freda Deskin,DEM,110003,2,11,20,33,
Cherokee,U.S. Senate,Connie Johnson,DEM,110003,2,23,55,80,
Cherokee,U.S. Senate,Jim Rogers,DEM,110003,3,18,41,62,
Cherokee,Superintendent of Public Instruction,John Cox,DEM,110004,2,13,105,120,
Cherokee,Superintendent of Public Instruction,Freda Deskin,DEM,110004,3,3,23,29,
Cherokee,U.S. Senate,Connie Johnson,DEM,110004,2,10,61,73,
Cherokee,U.S. Senate,Jim Rogers,DEM,110004,3,7,60,70,
Cherokee,Superintendent of Public Instruction,John Cox,DEM,110005,0,1,26,27,
Cherokee,Superintendent of Public Instruction,Freda Deskin,DEM,110005,0,0,11,11,
Cherokee,U.S. Senate,Connie Johnson,DEM,110005,0,0,17,17,
Cherokee,U.S. Senate,Jim Rogers,DEM,110005,0,1,19,20,
Cherokee,Superintendent of Public Instruction,John Cox,DEM,110006,9,3,94,106,
Cherokee,Superintendent of Public Instruction,Freda Deskin,DEM,110006,0,1,27,28,
Cherokee,U.S. Senate,Connie Johnson,DEM,110006,1,1,39,41,
Cherokee,U.S. Senate,Jim Rogers,DEM,110006,8,3,78,89,
Cherokee,Superintendent of Public Instruction,John Cox,DEM,110007,0,0,3,3,
Cherokee,Superintendent of Public Instruction,Freda Deskin,DEM,110007,0,0,2,2,
Cherokee,U.S. Senate,Connie Johnson,DEM,110007,0,0,2,2,
Cherokee,U.S. Senate,Jim Rogers,DEM,110007,0,0,3,3,
Cherokee,Superintendent of Public Instruction,John Cox,DEM,110008,0,2,30,32,
Cherokee,Superintendent of Public Instruction,Freda Deskin,DEM,110008,0,0,5,5,
Cherokee,U.S. Senate,Connie Johnson,DEM,110008,0,1,15,16,
Cherokee,U.S. Senate,Jim Rogers,DEM,110008,0,1,20,21,
Cherokee,Superintendent of Public Instruction,John Cox,DEM,110009,2,3,68,73,
Cherokee,Superintendent of Public Instruction,Freda Deskin,DEM,110009,0,1,38,39,
Cherokee,U.S. Senate,Connie Johnson,DEM,110009,2,4,43,49,
Cherokee,U.S. Senate,Jim Rogers,DEM,110009,0,0,60,60,
Cherokee,Superintendent of Public Instruction,John Cox,DEM,110010,26,13,310,349,
Cherokee,Superintendent of Public Instruction,Freda Deskin,DEM,110010,6,4,77,87,
Cherokee,U.S. Senate,Connie Johnson,DEM,110010,15,6,137,158,
Cherokee,U.S. Senate,Jim Rogers,DEM,110010,17,11,247,275,
Cherokee,Superintendent of Public Instruction,John Cox,DEM,110011,0,4,61,65,
Cherokee,Superintendent of Public Instruction,Freda Deskin,DEM,110011,2,0,2,4,
Cherokee,U.S. Senate,Connie Johnson,DEM,110011,0,0,19,19,
Cherokee,U.S. Senate,Jim Rogers,DEM,110011,2,4,44,50,
Cherokee,Superintendent of Public Instruction,John Cox,DEM,110012,1,11,120,132,
Cherokee,Superintendent of Public Instruction,Freda Deskin,DEM,110012,0,2,16,18,
Cherokee,U.S. Senate,Connie Johnson,DEM,110012,0,3,49,52,
Cherokee,U.S. Senate,Jim Rogers,DEM,110012,0,9,86,95,
Cherokee,Superintendent of Public Instruction,John Cox,DEM,110013,0,5,69,74,
Cherokee,Superintendent of Public Instruction,Freda Deskin,DEM,110013,2,0,6,8,
Cherokee,U.S. Senate,Connie Johnson,DEM,110013,2,2,19,23,
Cherokee,U.S. Senate,Jim Rogers,DEM,110013,0,3,52,55,
Cherokee,Superintendent of Public Instruction,John Cox,DEM,110014,0,0,68,68,
Cherokee,Superintendent of Public Instruction,Freda Deskin,DEM,110014,0,0,9,9,
Cherokee,U.S. Senate,Connie Johnson,DEM,110014,0,0,29,29,
Cherokee,U.S. Senate,Jim Rogers,DEM,110014,0,0,46,46,
Cherokee,Superintendent of Public Instruction,John Cox,DEM,110015,0,4,63,67,
Cherokee,Superintendent of Public Instruction,Freda Deskin,DEM,110015,0,0,13,13,
Cherokee,U.S. Senate,Connie Johnson,DEM,110015,0,2,39,41,
Cherokee,U.S. Senate,Jim Rogers,DEM,110015,0,2,36,38,
Cherokee,Superintendent of Public Instruction,John Cox,DEM,110016,4,5,79,88,
Cherokee,Superintendent of Public Instruction,Freda Deskin,DEM,110016,0,0,10,10,
Cherokee,U.S. Senate,Connie Johnson,DEM,110016,3,4,24,31,
Cherokee,U.S. Senate,Jim Rogers,DEM,110016,1,1,61,63,
Cherokee,Superintendent of Public Instruction,John Cox,DEM,110017,0,1,20,21,
Cherokee,Superintendent of Public Instruction,Freda Deskin,DEM,110017,0,0,7,7,
Cherokee,U.S. Senate,Connie Johnson,DEM,110017,0,0,12,12,
Cherokee,U.S. Senate,Jim Rogers,DEM,110017,0,1,14,15,
Cherokee,Superintendent of Public Instruction,John Cox,DEM,110018,0,0,7,7,
Cherokee,Superintendent of Public Instruction,Freda Deskin,DEM,110018,0,2,2,4,
Cherokee,U.S. Senate,Connie Johnson,DEM,110018,0,0,5,5,
Cherokee,U.S. Senate,Jim Rogers,DEM,110018,0,2,4,6,
Cherokee,Superintendent of Public Instruction,John Cox,DEM,110019,0,3,60,63,
Cherokee,Superintendent of Public Instruction,Freda Deskin,DEM,110019,1,1,5,7,
Cherokee,U.S. Senate,Connie Johnson,DEM,110019,0,2,31,33,
Cherokee,U.S. Senate,Jim Rogers,DEM,110019,1,2,33,36,
Cherokee,Superintendent of Public Instruction,John Cox,DEM,110020,3,7,89,99,
Cherokee,Superintendent of Public Instruction,Freda Deskin,DEM,110020,0,3,13,16,
Cherokee,U.S. Senate,Connie Johnson,DEM,110020,1,0,49,50,
Cherokee,U.S. Senate,Jim Rogers,DEM,110020,1,10,51,62,
Cherokee,Superintendent of Public Instruction,John Cox,DEM,110021,11,4,89,104,
Cherokee,Superintendent of Public Instruction,Freda Deskin,DEM,110021,5,0,15,20,
Cherokee,U.S. Senate,Connie Johnson,DEM,110021,3,0,38,41,
Cherokee,U.S. Senate,Jim Rogers,DEM,110021,10,2,63,75,
Cherokee,Superintendent of Public Instruction,John Cox,DEM,110022,10,2,61,73,
Cherokee,Superintendent of Public Instruction,Freda Deskin,DEM,110022,1,0,14,15,
Cherokee,U.S. Senate,Connie Johnson,DEM,110022,1,0,23,24,
Cherokee,U.S. Senate,Jim Rogers,DEM,110022,9,2,52,63,
Cherokee,Superintendent of Public Instruction,John Cox,DEM,110023,0,13,33,46,
Cherokee,Superintendent of Public Instruction,Freda Deskin,DEM,110023,0,0,2,2,
Cherokee,U.S. Senate,Connie Johnson,DEM,110023,0,7,5,12,
Cherokee,U.S. Senate,Jim Rogers,DEM,110023,0,6,29,35,
Cherokee,Superintendent of Public Instruction,John Cox,DEM,110025,4,15,69,88,
Cherokee,Superintendent of Public Instruction,Freda Deskin,DEM,110025,0,1,10,11,
Cherokee,U.S. Senate,Connie Johnson,DEM,110025,1,8,35,44,
Cherokee,U.S. Senate,Jim Rogers,DEM,110025,3,8,41,52,
Choctaw,Superintendent of Public Instruction,John Cox,DEM,120101,0,0,20,20,
Choctaw,Superintendent of Public Instruction,Freda Deskin,DEM,120101,1,0,3,4,
Choctaw,U.S. Senate,Connie Johnson,DEM,120101,1,0,2,3,
Choctaw,U.S. Senate,Jim Rogers,DEM,120101,0,0,20,20,
Choctaw,Superintendent of Public Instruction,John Cox,DEM,120104,0,0,23,23,
Choctaw,Superintendent of Public Instruction,Freda Deskin,DEM,120104,0,0,6,6,
Choctaw,U.S. Senate,Connie Johnson,DEM,120104,0,0,9,9,
Choctaw,U.S. Senate,Jim Rogers,DEM,120104,0,0,16,16,
Choctaw,Superintendent of Public Instruction,John Cox,DEM,120105,0,2,2,4,
Choctaw,Superintendent of Public Instruction,Freda Deskin,DEM,120105,0,0,10,10,
Choctaw,U.S. Senate,Connie Johnson,DEM,120105,0,1,7,8,
Choctaw,U.S. Senate,Jim Rogers,DEM,120105,0,1,5,6,
Choctaw,Superintendent of Public Instruction,John Cox,DEM,120106,0,0,5,5,
Choctaw,Superintendent of Public Instruction,Freda Deskin,DEM,120106,0,0,3,3,
Choctaw,U.S. Senate,Connie Johnson,DEM,120106,0,0,2,2,
Choctaw,U.S. Senate,Jim Rogers,DEM,120106,0,0,6,6,
Choctaw,Superintendent of Public Instruction,John Cox,DEM,120207,0,0,5,5,
Choctaw,Superintendent of Public Instruction,Freda Deskin,DEM,120207,0,0,3,3,
Choctaw,U.S. Senate,Connie Johnson,DEM,120207,0,0,5,5,
Choctaw,U.S. Senate,Jim Rogers,DEM,120207,0,0,4,4,
Choctaw,Superintendent of Public Instruction,John Cox,DEM,120208,0,6,12,18,
Choctaw,Superintendent of Public Instruction,Freda Deskin,DEM,120208,0,2,6,8,
Choctaw,U.S. Senate,Connie Johnson,DEM,120208,0,2,7,9,
Choctaw,U.S. Senate,Jim Rogers,DEM,120208,0,6,9,15,
Choctaw,Superintendent of Public Instruction,John Cox,DEM,120209,0,1,7,8,
Choctaw,Superintendent of Public Instruction,Freda Deskin,DEM,120209,0,0,5,5,
Choctaw,U.S. Senate,Connie Johnson,DEM,120209,0,0,5,5,
Choctaw,U.S. Senate,Jim Rogers,DEM,120209,0,1,7,8,
Choctaw,Superintendent of Public Instruction,John Cox,DEM,120210,0,3,13,16,
Choctaw,Superintendent of Public Instruction,Freda Deskin,DEM,120210,0,3,3,6,
Choctaw,U.S. Senate,Connie Johnson,DEM,120210,0,3,10,13,
Choctaw,U.S. Senate,Jim Rogers,DEM,120210,0,3,6,9,
Choctaw,Superintendent of Public Instruction,John Cox,DEM,120211,1,1,17,19,
Choctaw,Superintendent of Public Instruction,Freda Deskin,DEM,120211,0,0,7,7,
Choctaw,U.S. Senate,Connie Johnson,DEM,120211,0,0,13,13,
Choctaw,U.S. Senate,Jim Rogers,DEM,120211,1,1,11,13,
Choctaw,Superintendent of Public Instruction,John Cox,DEM,120214,0,0,8,8,
Choctaw,Superintendent of Public Instruction,Freda Deskin,DEM,120214,1,2,5,8,
Choctaw,U.S. Senate,Connie Johnson,DEM,120214,0,2,7,9,
Choctaw,U.S. Senate,Jim Rogers,DEM,120214,1,0,6,7,
Choctaw,Superintendent of Public Instruction,John Cox,DEM,120215,0,1,4,5,
Choctaw,Superintendent of Public Instruction,Freda Deskin,DEM,120215,1,1,3,5,
Choctaw,U.S. Senate,Connie Johnson,DEM,120215,1,0,4,5,
Choctaw,U.S. Senate,Jim Rogers,DEM,120215,0,2,3,5,
Choctaw,Superintendent of Public Instruction,John Cox,DEM,120316,2,3,13,18,
Choctaw,Superintendent of Public Instruction,Freda Deskin,DEM,120316,5,3,3,11,
Choctaw,U.S. Senate,Connie Johnson,DEM,120316,4,3,4,11,
Choctaw,U.S. Senate,Jim Rogers,DEM,120316,3,3,12,18,
Choctaw,Superintendent of Public Instruction,John Cox,DEM,120318,0,2,16,18,
Choctaw,Superintendent of Public Instruction,Freda Deskin,DEM,120318,0,0,3,3,
Choctaw,U.S. Senate,Connie Johnson,DEM,120318,0,1,2,3,
Choctaw,U.S. Senate,Jim Rogers,DEM,120318,0,1,16,17,
Choctaw,Superintendent of Public Instruction,John Cox,DEM,120319,0,2,40,42,
Choctaw,Superintendent of Public Instruction,Freda Deskin,DEM,120319,3,0,10,13,
Choctaw,U.S. Senate,Connie Johnson,DEM,120319,2,0,17,19,
Choctaw,U.S. Senate,Jim Rogers,DEM,120319,1,2,31,34,
Choctaw,Superintendent of Public Instruction,John Cox,DEM,120320,0,1,22,23,
Choctaw,Superintendent of Public Instruction,Freda Deskin,DEM,120320,0,0,6,6,
Choctaw,U.S. Senate,Connie Johnson,DEM,120320,0,1,3,4,
Choctaw,U.S. Senate,Jim Rogers,DEM,120320,0,0,21,21,
Choctaw,Superintendent of Public Instruction,John Cox,DEM,120321,3,2,52,57,
Choctaw,Superintendent of Public Instruction,Freda Deskin,DEM,120321,0,0,25,25,
Choctaw,U.S. Senate,Connie Johnson,DEM,120321,0,0,27,27,
Choctaw,U.S. Senate,Jim Rogers,DEM,120321,3,1,49,53,
Choctaw,Superintendent of Public Instruction,John Cox,DEM,120322,0,0,13,13,
Choctaw,Superintendent of Public Instruction,Freda Deskin,DEM,120322,0,0,2,2,
Choctaw,U.S. Senate,Connie Johnson,DEM,120322,0,0,5,5,
Choctaw,U.S. Senate,Jim Rogers,DEM,120322,0,0,8,8,
Cimarron,Superintendent of Public Instruction,John Cox,DEM,130002,1,1,5,7,
Cimarron,Superintendent of Public Instruction,Freda Deskin,DEM,130002,1,0,3,4,
Cimarron,U.S. Senate,Connie Johnson,DEM,130002,0,1,3,4,
Cimarron,U.S. Senate,Jim Rogers,DEM,130002,2,0,5,7,
Cimarron,State House,Casey Murdock,REP,130002,2,6,28,36,61
Cimarron,State House,Kenny Bob Tapp,REP,130002,6,3,20,29,61
Cimarron,Superintendent of Public Instruction,John Cox,DEM,130003,0,3,5,8,
Cimarron,Superintendent of Public Instruction,Freda Deskin,DEM,130003,0,1,2,3,
Cimarron,U.S. Senate,Connie Johnson,DEM,130003,0,1,2,3,
Cimarron,U.S. Senate,Jim Rogers,DEM,130003,0,3,5,8,
Cimarron,State House,Casey Murdock,REP,130003,2,5,15,22,61
Cimarron,State House,Kenny Bob Tapp,REP,130003,0,1,55,56,61
Cimarron,Superintendent of Public Instruction,John Cox,DEM,130004,0,0,9,9,
Cimarron,Superintendent of Public Instruction,Freda Deskin,DEM,130004,0,0,4,4,
Cimarron,U.S. Senate,Connie Johnson,DEM,130004,0,0,5,5,
Cimarron,U.S. Senate,Jim Rogers,DEM,130004,0,0,8,8,
Cimarron,State House,Casey Murdock,REP,130004,0,10,24,34,61
Cimarron,State House,Kenny Bob Tapp,REP,130004,1,9,41,51,61
Cimarron,Superintendent of Public Instruction,John Cox,DEM,130005,0,4,3,7,
Cimarron,Superintendent of Public Instruction,Freda Deskin,DEM,130005,0,1,2,3,
Cimarron,U.S. Senate,Connie Johnson,DEM,130005,0,1,2,3,
Cimarron,U.S. Senate,Jim Rogers,DEM,130005,0,4,3,7,
Cimarron,State House,Casey Murdock,REP,130005,0,4,13,17,61
Cimarron,State House,Kenny Bob Tapp,REP,130005,4,6,25,35,61
Cimarron,Superintendent of Public Instruction,John Cox,DEM,130006,0,3,10,13,
Cimarron,Superintendent of Public Instruction,Freda Deskin,DEM,130006,0,0,3,3,
Cimarron,U.S. Senate,Connie Johnson,DEM,130006,0,0,6,6,
Cimarron,U.S. Senate,Jim Rogers,DEM,130006,0,2,7,9,
Cimarron,State House,Casey Murdock,REP,130006,2,12,46,60,61
Cimarron,State House,Kenny Bob Tapp,REP,130006,2,14,32,48,61
Cimarron,Superintendent of Public Instruction,John Cox,DEM,130007,0,0,9,9,
Cimarron,Superintendent of Public Instruction,Freda Deskin,DEM,130007,0,0,5,5,
Cimarron,U.S. Senate,Connie Johnson,DEM,130007,0,0,8,8,
Cimarron,U.S. Senate,Jim Rogers,DEM,130007,0,0,6,6,
Cimarron,State House,Casey Murdock,REP,130007,0,2,10,12,61
Cimarron,State House,Kenny Bob Tapp,REP,130007,1,2,7,10,61
Cleveland,Superintendent of Public Instruction,John Cox,DEM,140002,0,1,13,14,
Cleveland,Superintendent of Public Instruction,Freda Deskin,DEM,140002,2,1,27,30,
Cleveland,U.S. Senate,Connie Johnson,DEM,140002,2,2,30,34,
Cleveland,U.S. Senate,Jim Rogers,DEM,140002,0,0,10,10,
Cleveland,Superintendent of Public Instruction,John Cox,DEM,140003,0,1,26,27,
Cleveland,Superintendent of Public Instruction,Freda Deskin,DEM,140003,1,1,30,32,
Cleveland,U.S. Senate,Connie Johnson,DEM,140003,1,2,42,45,
Cleveland,U.S. Senate,Jim Rogers,DEM,140003,0,0,14,14,
Cleveland,Superintendent of Public Instruction,John Cox,DEM,140004,2,0,25,27,
Cleveland,Superintendent of Public Instruction,Freda Deskin,DEM,140004,4,2,32,38,
Cleveland,U.S. Senate,Connie Johnson,DEM,140004,4,2,43,49,
Cleveland,U.S. Senate,Jim Rogers,DEM,140004,2,0,14,16,
Cleveland,Superintendent of Public Instruction,John Cox,DEM,140005,3,2,34,39,
Cleveland,Superintendent of Public Instruction,Freda Deskin,DEM,140005,4,1,14,19,
Cleveland,U.S. Senate,Connie Johnson,DEM,140005,4,3,40,47,
Cleveland,U.S. Senate,Jim Rogers,DEM,140005,3,0,7,10,
Cleveland,Superintendent of Public Instruction,John Cox,DEM,140006,0,0,35,35,
Cleveland,Superintendent of Public Instruction,Freda Deskin,DEM,140006,4,3,73,80,
Cleveland,U.S. Senate,Connie Johnson,DEM,140006,3,2,97,102,
Cleveland,U.S. Senate,Jim Rogers,DEM,140006,1,0,11,12,
Cleveland,Superintendent of Public Instruction,John Cox,DEM,140007,0,0,10,10,
Cleveland,Superintendent of Public Instruction,Freda Deskin,DEM,140007,0,0,3,3,
Cleveland,U.S. Senate,Connie Johnson,DEM,140007,0,0,12,12,
Cleveland,U.S. Senate,Jim Rogers,DEM,140007,0,0,1,1,
Cleveland,Superintendent of Public Instruction,John Cox,DEM,140008,0,0,24,24,
Cleveland,Superintendent of Public Instruction,Freda Deskin,DEM,140008,1,2,56,59,
Cleveland,U.S. Senate,Connie Johnson,DEM,140008,1,1,72,74,
Cleveland,U.S. Senate,Jim Rogers,DEM,140008,0,0,8,8,
Cleveland,Superintendent of Public Instruction,John Cox,DEM,140009,0,0,16,16,
Cleveland,Superintendent of Public Instruction,Freda Deskin,DEM,140009,2,0,8,10,
Cleveland,U.S. Senate,Connie Johnson,DEM,140009,2,0,16,18,
Cleveland,U.S. Senate,Jim Rogers,DEM,140009,0,0,7,7,
Cleveland,Superintendent of Public Instruction,John Cox,DEM,140010,2,0,23,25,
Cleveland,Superintendent of Public Instruction,Freda Deskin,DEM,140010,1,0,17,18,
Cleveland,U.S. Senate,Connie Johnson,DEM,140010,0,0,27,27,
Cleveland,U.S. Senate,Jim Rogers,DEM,140010,3,0,11,14,
Cleveland,Superintendent of Public Instruction,John Cox,DEM,140011,1,0,30,31,
Cleveland,Superintendent of Public Instruction,Freda Deskin,DEM,140011,3,4,64,71,
Cleveland,U.S. Senate,Connie Johnson,DEM,140011,3,3,75,81,
Cleveland,U.S. Senate,Jim Rogers,DEM,140011,1,1,17,19,
Cleveland,Superintendent of Public Instruction,John Cox,DEM,140012,1,2,28,31,
Cleveland,Superintendent of Public Instruction,Freda Deskin,DEM,140012,1,1,29,31,
Cleveland,U.S. Senate,Connie Johnson,DEM,140012,2,2,44,48,
Cleveland,U.S. Senate,Jim Rogers,DEM,140012,0,0,12,12,
Cleveland,Superintendent of Public Instruction,John Cox,DEM,140013,0,0,3,3,
Cleveland,Superintendent of Public Instruction,Freda Deskin,DEM,140013,2,0,4,6,
Cleveland,U.S. Senate,Connie Johnson,DEM,140013,2,0,7,9,
Cleveland,U.S. Senate,Jim Rogers,DEM,140013,0,0,0,0,
Cleveland,Superintendent of Public Instruction,John Cox,DEM,140014,0,1,12,13,
Cleveland,Superintendent of Public Instruction,Freda Deskin,DEM,140014,1,1,18,20,
Cleveland,U.S. Senate,Connie Johnson,DEM,140014,1,1,28,30,
Cleveland,U.S. Senate,Jim Rogers,DEM,140014,0,1,4,5,
Cleveland,Superintendent of Public Instruction,John Cox,DEM,140015,0,2,24,26,
Cleveland,Superintendent of Public Instruction,Freda Deskin,DEM,140015,7,3,61,71,
Cleveland,U.S. Senate,Connie Johnson,DEM,140015,7,5,73,85,
Cleveland,U.S. Senate,Jim Rogers,DEM,140015,0,0,10,10,
Cleveland,Superintendent of Public Instruction,John Cox,DEM,140016,3,0,22,25,
Cleveland,Superintendent of Public Instruction,Freda Deskin,DEM,140016,4,0,15,19,
Cleveland,U.S. Senate,Connie Johnson,DEM,140016,3,0,28,31,
Cleveland,U.S. Senate,Jim Rogers,DEM,140016,4,0,9,13,
Cleveland,Superintendent of Public Instruction,John Cox,DEM,140017,0,0,2,2,
Cleveland,Superintendent of Public Instruction,Freda Deskin,DEM,140017,0,0,3,3,
Cleveland,U.S. Senate,Connie Johnson,DEM,140017,0,0,4,4,
Cleveland,U.S. Senate,Jim Rogers,DEM,140017,0,0,1,1,
Cleveland,Superintendent of Public Instruction,John Cox,DEM,140018,1,1,22,24,
Cleveland,Superintendent of Public Instruction,Freda Deskin,DEM,140018,1,1,29,31,
Cleveland,U.S. Senate,Connie Johnson,DEM,140018,2,2,38,42,
Cleveland,U.S. Senate,Jim Rogers,DEM,140018,0,0,14,14,
Cleveland,Superintendent of Public Instruction,John Cox,DEM,140019,0,1,51,52,
Cleveland,Superintendent of Public Instruction,Freda Deskin,DEM,140019,4,4,78,86,
Cleveland,U.S. Senate,Connie Johnson,DEM,140019,4,5,106,115,
Cleveland,U.S. Senate,Jim Rogers,DEM,140019,0,0,22,22,
Cleveland,Superintendent of Public Instruction,John Cox,DEM,140020,7,1,30,38,
Cleveland,Superintendent of Public Instruction,Freda Deskin,DEM,140020,3,0,31,34,
Cleveland,U.S. Senate,Connie Johnson,DEM,140020,6,1,42,49,
Cleveland,U.S. Senate,Jim Rogers,DEM,140020,4,0,19,23,
Cleveland,Superintendent of Public Instruction,John Cox,DEM,140021,0,0,9,9,
Cleveland,Superintendent of Public Instruction,Freda Deskin,DEM,140021,2,0,12,14,
Cleveland,U.S. Senate,Connie Johnson,DEM,140021,0,0,16,16,
Cleveland,U.S. Senate,Jim Rogers,DEM,140021,2,0,7,9,
Cleveland,Superintendent of Public Instruction,John Cox,DEM,140022,2,1,19,22,
Cleveland,Superintendent of Public Instruction,Freda Deskin,DEM,140022,5,0,25,30,
Cleveland,U.S. Senate,Connie Johnson,DEM,140022,4,0,28,32,
Cleveland,U.S. Senate,Jim Rogers,DEM,140022,3,1,15,19,
Cleveland,Superintendent of Public Instruction,John Cox,DEM,140024,3,0,27,30,
Cleveland,Superintendent of Public Instruction,Freda Deskin,DEM,140024,1,1,21,23,
Cleveland,U.S. Senate,Connie Johnson,DEM,140024,4,1,33,38,
Cleveland,U.S. Senate,Jim Rogers,DEM,140024,0,0,15,15,
Cleveland,Superintendent of Public Instruction,John Cox,DEM,140025,0,1,20,21,
Cleveland,Superintendent of Public Instruction,Freda Deskin,DEM,140025,0,1,14,15,
Cleveland,U.S. Senate,Connie Johnson,DEM,140025,0,0,20,20,
Cleveland,U.S. Senate,Jim Rogers,DEM,140025,0,2,11,13,
Cleveland,Superintendent of Public Instruction,John Cox,DEM,140026,1,0,35,36,
Cleveland,Superintendent of Public Instruction,Freda Deskin,DEM,140026,1,6,66,73,
Cleveland,U.S. Senate,Connie Johnson,DEM,140026,1,7,79,87,
Cleveland,U.S. Senate,Jim Rogers,DEM,140026,1,0,21,22,
Cleveland,Superintendent of Public Instruction,John Cox,DEM,140027,4,3,32,39,
Cleveland,Superintendent of Public Instruction,Freda Deskin,DEM,140027,3,2,62,67,
Cleveland,U.S. Senate,Connie Johnson,DEM,140027,6,5,69,80,
Cleveland,U.S. Senate,Jim Rogers,DEM,140027,1,0,18,19,
Cleveland,Superintendent of Public Instruction,John Cox,DEM,140028,2,1,35,38,
Cleveland,Superintendent of Public Instruction,Freda Deskin,DEM,140028,7,2,45,54,
Cleveland,U.S. Senate,Connie Johnson,DEM,140028,9,3,67,79,
Cleveland,U.S. Senate,Jim Rogers,DEM,140028,0,0,12,12,
Cleveland,Superintendent of Public Instruction,John Cox,DEM,140029,0,0,33,33,
Cleveland,Superintendent of Public Instruction,Freda Deskin,DEM,140029,4,1,27,32,
Cleveland,U.S. Senate,Connie Johnson,DEM,140029,4,1,27,32,
Cleveland,U.S. Senate,Jim Rogers,DEM,140029,0,0,32,32,
Cleveland,Superintendent of Public Instruction,John Cox,DEM,140030,0,0,15,15,
Cleveland,Superintendent of Public Instruction,Freda Deskin,DEM,140030,1,1,35,37,
Cleveland,U.S. Senate,Connie Johnson,DEM,140030,1,1,44,46,
Cleveland,U.S. Senate,Jim Rogers,DEM,140030,0,0,9,9,
Cleveland,Superintendent of Public Instruction,John Cox,DEM,140032,2,1,15,18,
Cleveland,Superintendent of Public Instruction,Freda Deskin,DEM,140032,3,3,31,37,
Cleveland,U.S. Senate,Connie Johnson,DEM,140032,4,4,33,41,
Cleveland,U.S. Senate,Jim Rogers,DEM,140032,1,0,13,14,
Cleveland,Superintendent of Public Instruction,John Cox,DEM,140034,2,0,29,31,
Cleveland,Superintendent of Public Instruction,Freda Deskin,DEM,140034,3,1,74,78,
Cleveland,U.S. Senate,Connie Johnson,DEM,140034,4,1,55,60,
Cleveland,U.S. Senate,Jim Rogers,DEM,140034,1,0,45,46,
Cleveland,Superintendent of Public Instruction,John Cox,DEM,140035,1,0,25,26,
Cleveland,Superintendent of Public Instruction,Freda Deskin,DEM,140035,2,1,53,56,
Cleveland,U.S. Senate,Connie Johnson,DEM,140035,3,1,60,64,
Cleveland,U.S. Senate,Jim Rogers,DEM,140035,0,0,16,16,
Cleveland,Superintendent of Public Instruction,John Cox,DEM,140036,1,1,5,7,
Cleveland,Superintendent of Public Instruction,Freda Deskin,DEM,140036,3,0,13,16,
Cleveland,U.S. Senate,Connie Johnson,DEM,140036,3,0,12,15,
Cleveland,U.S. Senate,Jim Rogers,DEM,140036,1,1,6,8,
Cleveland,Superintendent of Public Instruction,John Cox,DEM,140037,0,0,8,8,
Cleveland,Superintendent of Public Instruction,Freda Deskin,DEM,140037,1,0,7,8,
Cleveland,U.S. Senate,Connie Johnson,DEM,140037,1,0,14,15,
Cleveland,U.S. Senate,Jim Rogers,DEM,140037,0,0,1,1,
Cleveland,Superintendent of Public Instruction,John Cox,DEM,140038,0,1,24,25,
Cleveland,Superintendent of Public Instruction,Freda Deskin,DEM,140038,1,1,17,19,
Cleveland,U.S. Senate,Connie Johnson,DEM,140038,0,0,34,34,
Cleveland,U.S. Senate,Jim Rogers,DEM,140038,1,2,7,10,
Cleveland,Superintendent of Public Instruction,John Cox,DEM,140039,0,3,23,26,
Cleveland,Superintendent of Public Instruction,Freda Deskin,DEM,140039,2,1,31,34,
Cleveland,U.S. Senate,Connie Johnson,DEM,140039,2,3,40,45,
Cleveland,U.S. Senate,Jim Rogers,DEM,140039,0,1,13,14,
Cleveland,Superintendent of Public Instruction,John Cox,DEM,140040,1,0,20,21,
Cleveland,Superintendent of Public Instruction,Freda Deskin,DEM,140040,3,0,15,18,
Cleveland,U.S. Senate,Connie Johnson,DEM,140040,2,0,28,30,
Cleveland,U.S. Senate,Jim Rogers,DEM,140040,1,0,6,7,
Cleveland,Superintendent of Public Instruction,John Cox,DEM,140041,1,0,9,10,
Cleveland,Superintendent of Public Instruction,Freda Deskin,DEM,140041,0,0,9,9,
Cleveland,U.S. Senate,Connie Johnson,DEM,140041,0,0,12,12,
Cleveland,U.S. Senate,Jim Rogers,DEM,140041,1,0,6,7,
Cleveland,Superintendent of Public Instruction,John Cox,DEM,140042,1,0,40,41,
Cleveland,Superintendent of Public Instruction,Freda Deskin,DEM,140042,1,2,56,59,
Cleveland,U.S. Senate,Connie Johnson,DEM,140042,3,2,79,84,
Cleveland,U.S. Senate,Jim Rogers,DEM,140042,0,0,12,12,
Cleveland,Superintendent of Public Instruction,John Cox,DEM,140043,1,0,13,14,
Cleveland,Superintendent of Public Instruction,Freda Deskin,DEM,140043,1,0,19,20,
Cleveland,U.S. Senate,Connie Johnson,DEM,140043,2,0,27,29,
Cleveland,U.S. Senate,Jim Rogers,DEM,140043,0,0,5,5,
Cleveland,Superintendent of Public Instruction,John Cox,DEM,140044,2,1,18,21,
Cleveland,Superintendent of Public Instruction,Freda Deskin,DEM,140044,1,0,16,17,
Cleveland,U.S. Senate,Connie Johnson,DEM,140044,2,1,26,29,
Cleveland,U.S. Senate,Jim Rogers,DEM,140044,1,0,7,8,
Cleveland,Superintendent of Public Instruction,John Cox,DEM,140045,0,0,12,12,
Cleveland,Superintendent of Public Instruction,Freda Deskin,DEM,140045,0,0,20,20,
Cleveland,U.S. Senate,Connie Johnson,DEM,140045,0,0,27,27,
Cleveland,U.S. Senate,Jim Rogers,DEM,140045,0,0,5,5,
Cleveland,Superintendent of Public Instruction,John Cox,DEM,140047,0,0,18,18,
Cleveland,Superintendent of Public Instruction,Freda Deskin,DEM,140047,1,0,18,19,
Cleveland,U.S. Senate,Connie Johnson,DEM,140047,1,0,17,18,
Cleveland,U.S. Senate,Jim Rogers,DEM,140047,0,0,18,18,
Cleveland,Superintendent of Public Instruction,John Cox,DEM,140048,1,1,5,7,
Cleveland,Superintendent of Public Instruction,Freda Deskin,DEM,140048,0,0,6,6,
Cleveland,U.S. Senate,Connie Johnson,DEM,140048,0,1,7,8,
Cleveland,U.S. Senate,Jim Rogers,DEM,140048,1,0,3,4,
Cleveland,Superintendent of Public Instruction,John Cox,DEM,140049,0,0,16,16,
Cleveland,Superintendent of Public Instruction,Freda Deskin,DEM,140049,1,0,9,10,
Cleveland,U.S. Senate,Connie Johnson,DEM,140049,0,0,18,18,
Cleveland,U.S. Senate,Jim Rogers,DEM,140049,1,0,9,10,
Cleveland,Superintendent of Public Instruction,John Cox,DEM,140050,1,2,21,24,
Cleveland,Superintendent of Public Instruction,Freda Deskin,DEM,140050,0,0,19,19,
Cleveland,U.S. Senate,Connie Johnson,DEM,140050,0,2,27,29,
Cleveland,U.S. Senate,Jim Rogers,DEM,140050,1,0,11,12,
Cleveland,Superintendent of Public Instruction,John Cox,DEM,140051,0,0,25,25,
Cleveland,Superintendent of Public Instruction,Freda Deskin,DEM,140051,2,1,37,40,
Cleveland,U.S. Senate,Connie Johnson,DEM,140051,2,1,50,53,
Cleveland,U.S. Senate,Jim Rogers,DEM,140051,0,0,12,12,
Cleveland,Superintendent of Public Instruction,John Cox,DEM,140053,2,0,35,37,
Cleveland,Superintendent of Public Instruction,Freda Deskin,DEM,140053,6,6,73,85,
Cleveland,U.S. Senate,Connie Johnson,DEM,140053,6,5,86,97,
Cleveland,U.S. Senate,Jim Rogers,DEM,140053,0,1,20,21,
Cleveland,Superintendent of Public Instruction,John Cox,DEM,140054,0,1,10,11,
Cleveland,Superintendent of Public Instruction,Freda Deskin,DEM,140054,1,0,3,4,
Cleveland,U.S. Senate,Connie Johnson,DEM,140054,1,1,9,11,
Cleveland,U.S. Senate,Jim Rogers,DEM,140054,0,0,4,4,
Cleveland,Superintendent of Public Instruction,John Cox,DEM,140055,2,1,54,57,
Cleveland,Superintendent of Public Instruction,Freda Deskin,DEM,140055,3,10,75,88,
Cleveland,U.S. Senate,Connie Johnson,DEM,140055,3,11,109,123,
Cleveland,U.S. Senate,Jim Rogers,DEM,140055,2,0,20,22,
Cleveland,Superintendent of Public Instruction,John Cox,DEM,140056,1,5,44,50,
Cleveland,Superintendent of Public Instruction,Freda Deskin,DEM,140056,9,1,82,92,
Cleveland,U.S. Senate,Connie Johnson,DEM,140056,8,5,99,112,
Cleveland,U.S. Senate,Jim Rogers,DEM,140056,1,1,24,26,
Cleveland,Superintendent of Public Instruction,John Cox,DEM,140057,1,0,30,31,
Cleveland,Superintendent of Public Instruction,Freda Deskin,DEM,140057,1,1,38,40,
Cleveland,U.S. Senate,Connie Johnson,DEM,140057,2,0,41,43,
Cleveland,U.S. Senate,Jim Rogers,DEM,140057,0,1,27,28,
Cleveland,Superintendent of Public Instruction,John Cox,DEM,140058,4,0,18,22,
Cleveland,Superintendent of Public Instruction,Freda Deskin,DEM,140058,4,0,8,12,
Cleveland,U.S. Senate,Connie Johnson,DEM,140058,1,0,16,17,
Cleveland,U.S. Senate,Jim Rogers,DEM,140058,7,0,9,16,
Cleveland,Superintendent of Public Instruction,John Cox,DEM,140059,5,0,20,25,
Cleveland,Superintendent of Public Instruction,Freda Deskin,DEM,140059,5,2,25,32,
Cleveland,U.S. Senate,Connie Johnson,DEM,140059,6,1,32,39,
Cleveland,U.S. Senate,Jim Rogers,DEM,140059,4,1,12,17,
Cleveland,Superintendent of Public Instruction,John Cox,DEM,140060,1,0,29,30,
Cleveland,Superintendent of Public Instruction,Freda Deskin,DEM,140060,2,2,17,21,
Cleveland,U.S. Senate,Connie Johnson,DEM,140060,3,2,25,30,
Cleveland,U.S. Senate,Jim Rogers,DEM,140060,0,0,21,21,
Cleveland,Superintendent of Public Instruction,John Cox,DEM,140061,2,1,13,16,
Cleveland,Superintendent of Public Instruction,Freda Deskin,DEM,140061,6,2,13,21,
Cleveland,U.S. Senate,Connie Johnson,DEM,140061,6,2,18,26,
Cleveland,U.S. Senate,Jim Rogers,DEM,140061,2,1,8,11,
Cleveland,Superintendent of Public Instruction,John Cox,DEM,140063,1,0,1,2,
Cleveland,Superintendent of Public Instruction,Freda Deskin,DEM,140063,0,0,5,5,
Cleveland,U.S. Senate,Connie Johnson,DEM,140063,1,0,6,7,
Cleveland,U.S. Senate,Jim Rogers,DEM,140063,0,0,0,0,
Cleveland,Superintendent of Public Instruction,John Cox,DEM,140064,0,0,12,12,
Cleveland,Superintendent of Public Instruction,Freda Deskin,DEM,140064,5,0,20,25,
Cleveland,U.S. Senate,Connie Johnson,DEM,140064,5,0,21,26,
Cleveland,U.S. Senate,Jim Rogers,DEM,140064,0,0,11,11,
Cleveland,Superintendent of Public Instruction,John Cox,DEM,140065,0,0,10,10,
Cleveland,Superintendent of Public Instruction,Freda Deskin,DEM,140065,1,1,10,12,
Cleveland,U.S. Senate,Connie Johnson,DEM,140065,1,1,10,12,
Cleveland,U.S. Senate,Jim Rogers,DEM,140065,0,0,9,9,
Cleveland,Superintendent of Public Instruction,John Cox,DEM,140067,0,2,16,18,
Cleveland,Superintendent of Public Instruction,Freda Deskin,DEM,140067,0,1,17,18,
Cleveland,U.S. Senate,Connie Johnson,DEM,140067,0,3,20,23,
Cleveland,U.S. Senate,Jim Rogers,DEM,140067,0,0,13,13,
Cleveland,Superintendent of Public Instruction,John Cox,DEM,140068,0,1,23,24,
Cleveland,Superintendent of Public Instruction,Freda Deskin,DEM,140068,1,2,25,28,
Cleveland,U.S. Senate,Connie Johnson,DEM,140068,1,1,32,34,
Cleveland,U.S. Senate,Jim Rogers,DEM,140068,0,2,16,18,
Cleveland,Superintendent of Public Instruction,John Cox,DEM,140069,4,0,38,42,
Cleveland,Superintendent of Public Instruction,Freda Deskin,DEM,140069,1,2,19,22,
Cleveland,U.S. Senate,Connie Johnson,DEM,140069,4,2,37,43,
Cleveland,U.S. Senate,Jim Rogers,DEM,140069,1,0,19,20,
Cleveland,Superintendent of Public Instruction,John Cox,DEM,140070,2,0,22,24,
Cleveland,Superintendent of Public Instruction,Freda Deskin,DEM,140070,0,0,17,17,
Cleveland,U.S. Senate,Connie Johnson,DEM,140070,0,0,28,28,
Cleveland,U.S. Senate,Jim Rogers,DEM,140070,2,0,11,13,
Cleveland,Superintendent of Public Instruction,John Cox,DEM,140071,1,0,15,16,
Cleveland,Superintendent of Public Instruction,Freda Deskin,DEM,140071,4,3,27,34,
Cleveland,U.S. Senate,Connie Johnson,DEM,140071,3,3,35,41,
Cleveland,U.S. Senate,Jim Rogers,DEM,140071,2,0,5,7,
Cleveland,Superintendent of Public Instruction,John Cox,DEM,140072,0,1,9,10,
Cleveland,Superintendent of Public Instruction,Freda Deskin,DEM,140072,2,1,14,17,
Cleveland,U.S. Senate,Connie Johnson,DEM,140072,1,2,16,19,
Cleveland,U.S. Senate,Jim Rogers,DEM,140072,1,0,7,8,
Cleveland,Superintendent of Public Instruction,John Cox,DEM,140073,1,0,57,58,
Cleveland,Superintendent of Public Instruction,Freda Deskin,DEM,140073,10,1,62,73,
Cleveland,U.S. Senate,Connie Johnson,DEM,140073,10,1,86,97,
Cleveland,U.S. Senate,Jim Rogers,DEM,140073,1,0,27,28,
Cleveland,Superintendent of Public Instruction,John Cox,DEM,140074,1,0,9,10,
Cleveland,Superintendent of Public Instruction,Freda Deskin,DEM,140074,3,0,32,35,
Cleveland,U.S. Senate,Connie Johnson,DEM,140074,4,0,34,38,
Cleveland,U.S. Senate,Jim Rogers,DEM,140074,0,0,7,7,
Cleveland,Superintendent of Public Instruction,John Cox,DEM,140076,0,0,18,18,
Cleveland,Superintendent of Public Instruction,Freda Deskin,DEM,140076,3,1,26,30,
Cleveland,U.S. Senate,Connie Johnson,DEM,140076,3,1,33,37,
Cleveland,U.S. Senate,Jim Rogers,DEM,140076,0,0,11,11,
Cleveland,Superintendent of Public Instruction,John Cox,DEM,140077,1,0,8,9,
Cleveland,Superintendent of Public Instruction,Freda Deskin,DEM,140077,0,0,11,11,
Cleveland,U.S. Senate,Connie Johnson,DEM,140077,0,0,12,12,
Cleveland,U.S. Senate,Jim Rogers,DEM,140077,1,0,7,8,
Cleveland,Superintendent of Public Instruction,John Cox,DEM,140078,3,0,15,18,
Cleveland,Superintendent of Public Instruction,Freda Deskin,DEM,140078,0,0,11,11,
Cleveland,U.S. Senate,Connie Johnson,DEM,140078,3,0,16,19,
Cleveland,U.S. Senate,Jim Rogers,DEM,140078,0,0,8,8,
Cleveland,Superintendent of Public Instruction,John Cox,DEM,140080,2,0,1,3,
Cleveland,Superintendent of Public Instruction,Freda Deskin,DEM,140080,0,0,5,5,
Cleveland,U.S. Senate,Connie Johnson,DEM,140080,2,0,5,7,
Cleveland,U.S. Senate,Jim Rogers,DEM,140080,0,0,1,1,
Cleveland,Superintendent of Public Instruction,John Cox,DEM,140081,6,2,26,34,
Cleveland,Superintendent of Public Instruction,Freda Deskin,DEM,140081,8,3,43,54,
Cleveland,U.S. Senate,Connie Johnson,DEM,140081,5,5,52,62,
Cleveland,U.S. Senate,Jim Rogers,DEM,140081,8,0,17,25,
Cleveland,Superintendent of Public Instruction,John Cox,DEM,140082,0,4,28,32,
Cleveland,Superintendent of Public Instruction,Freda Deskin,DEM,140082,3,4,38,45,
Cleveland,U.S. Senate,Connie Johnson,DEM,140082,3,7,61,71,
Cleveland,U.S. Senate,Jim Rogers,DEM,140082,0,1,7,8,
Cleveland,Superintendent of Public Instruction,John Cox,DEM,140083,0,0,17,17,
Cleveland,Superintendent of Public Instruction,Freda Deskin,DEM,140083,1,1,27,29,
Cleveland,U.S. Senate,Connie Johnson,DEM,140083,1,1,29,31,
Cleveland,U.S. Senate,Jim Rogers,DEM,140083,0,0,13,13,
Cleveland,Superintendent of Public Instruction,John Cox,DEM,140086,1,0,30,31,
Cleveland,Superintendent of Public Instruction,Freda Deskin,DEM,140086,1,0,8,9,
Cleveland,U.S. Senate,Connie Johnson,DEM,140086,2,0,23,25,
Cleveland,U.S. Senate,Jim Rogers,DEM,140086,0,0,15,15,
Cleveland,Superintendent of Public Instruction,John Cox,DEM,140087,2,0,2,4,
Cleveland,Superintendent of Public Instruction,Freda Deskin,DEM,140087,0,0,2,2,
Cleveland,U.S. Senate,Connie Johnson,DEM,140087,1,0,4,5,
Cleveland,U.S. Senate,Jim Rogers,DEM,140087,1,0,0,1,
Cleveland,Superintendent of Public Instruction,John Cox,DEM,140088,2,0,24,26,
Cleveland,Superintendent of Public Instruction,Freda Deskin,DEM,140088,2,0,11,13,
Cleveland,U.S. Senate,Connie Johnson,DEM,140088,1,0,24,25,
Cleveland,U.S. Senate,Jim Rogers,DEM,140088,3,0,10,13,
Cleveland,Superintendent of Public Instruction,John Cox,DEM,140089,1,0,23,24,
Cleveland,Superintendent of Public Instruction,Freda Deskin,DEM,140089,4,0,7,11,
Cleveland,U.S. Senate,Connie Johnson,DEM,140089,4,0,20,24,
Cleveland,U.S. Senate,Jim Rogers,DEM,140089,1,0,10,11,
Cleveland,Superintendent of Public Instruction,John Cox,DEM,140090,0,0,0,0,
Cleveland,Superintendent of Public Instruction,Freda Deskin,DEM,140090,0,0,0,0,
Cleveland,U.S. Senate,Connie Johnson,DEM,140090,0,0,0,0,
Cleveland,U.S. Senate,Jim Rogers,DEM,140090,0,0,0,0,
Cleveland,Superintendent of Public Instruction,John Cox,DEM,140091,0,0,2,2,
Cleveland,Superintendent of Public Instruction,Freda Deskin,DEM,140091,1,0,3,4,
Cleveland,U.S. Senate,Connie Johnson,DEM,140091,1,0,3,4,
Cleveland,U.S. Senate,Jim Rogers,DEM,140091,0,0,2,2,
Cleveland,Superintendent of Public Instruction,John Cox,DEM,140092,0,0,0,0,
Cleveland,Superintendent of Public Instruction,Freda Deskin,DEM,140092,0,0,0,0,
Cleveland,U.S. Senate,Connie Johnson,DEM,140092,0,0,0,0,
Cleveland,U.S. Senate,Jim Rogers,DEM,140092,0,0,0,0,
Cleveland,Superintendent of Public Instruction,John Cox,DEM,140093,0,0,14,14,
Cleveland,Superintendent of Public Instruction,Freda Deskin,DEM,140093,4,2,28,34,
Cleveland,U.S. Senate,Connie Johnson,DEM,140093,3,0,34,37,
Cleveland,U.S. Senate,Jim Rogers,DEM,140093,1,2,8,11,
Cleveland,Superintendent of Public Instruction,John Cox,DEM,140094,1,0,4,5,
Cleveland,Superintendent of Public Instruction,Freda Deskin,DEM,140094,0,1,13,14,
Cleveland,U.S. Senate,Connie Johnson,DEM,140094,1,0,12,13,
Cleveland,U.S. Senate,Jim Rogers,DEM,140094,0,1,5,6,
Cleveland,Superintendent of Public Instruction,John Cox,DEM,140095,0,0,11,11,
Cleveland,Superintendent of Public Instruction,Freda Deskin,DEM,140095,0,0,8,8,
Cleveland,U.S. Senate,Connie Johnson,DEM,140095,0,0,12,12,
Cleveland,U.S. Senate,Jim Rogers,DEM,140095,0,0,8,8,
Coal,Superintendent of Public Instruction,John Cox,DEM,150002,0,0,17,17,
Coal,Superintendent of Public Instruction,Freda Deskin,DEM,150002,0,0,5,5,
Coal,U.S. Senate,Connie Johnson,DEM,150002,0,0,7,7,
Coal,U.S. Senate,Jim Rogers,DEM,150002,0,0,14,14,
Coal,Superintendent of Public Instruction,John Cox,DEM,150003,2,1,16,19,
Coal,Superintendent of Public Instruction,Freda Deskin,DEM,150003,0,1,10,11,
Coal,U.S. Senate,Connie Johnson,DEM,150003,0,0,11,11,
Coal,U.S. Senate,Jim Rogers,DEM,150003,2,2,15,19,
Coal,Superintendent of Public Instruction,John Cox,DEM,150004,0,4,25,29,
Coal,Superintendent of Public Instruction,Freda Deskin,DEM,150004,0,3,6,9,
Coal,U.S. Senate,Connie Johnson,DEM,150004,0,1,8,9,
Coal,U.S. Senate,Jim Rogers,DEM,150004,0,6,18,24,
Coal,Superintendent of Public Instruction,John Cox,DEM,150005,3,4,36,43,
Coal,Superintendent of Public Instruction,Freda Deskin,DEM,150005,1,1,4,6,
Coal,U.S. Senate,Connie Johnson,DEM,150005,1,2,8,11,
Coal,U.S. Senate,Jim Rogers,DEM,150005,3,3,31,37,
Coal,Superintendent of Public Instruction,John Cox,DEM,150006,1,1,12,14,
Coal,Superintendent of Public Instruction,Freda Deskin,DEM,150006,1,0,3,4,
Coal,U.S. Senate,Connie Johnson,DEM,150006,0,0,8,8,
Coal,U.S. Senate,Jim Rogers,DEM,150006,2,1,7,10,
Coal,Superintendent of Public Instruction,John Cox,DEM,150007,2,6,12,20,
Coal,Superintendent of Public Instruction,Freda Deskin,DEM,150007,0,1,7,8,
Coal,U.S. Senate,Connie Johnson,DEM,150007,0,1,5,6,
Coal,U.S. Senate,Jim Rogers,DEM,150007,1,6,14,21,
Coal,Superintendent of Public Instruction,John Cox,DEM,150009,0,0,16,16,
Coal,Superintendent of Public Instruction,Freda Deskin,DEM,150009,0,0,2,2,
Coal,U.S. Senate,Connie Johnson,DEM,150009,0,0,3,3,
Coal,U.S. Senate,Jim Rogers,DEM,150009,0,0,14,14,
Coal,Superintendent of Public Instruction,John Cox,DEM,150010,0,1,8,9,
Coal,Superintendent of Public Instruction,Freda Deskin,DEM,150010,0,0,3,3,
Coal,U.S. Senate,Connie Johnson,DEM,150010,0,0,6,6,
Coal,U.S. Senate,Jim Rogers,DEM,150010,0,1,5,6,
Coal,Superintendent of Public Instruction,John Cox,DEM,150011,5,4,19,28,
Coal,Superintendent of Public Instruction,Freda Deskin,DEM,150011,0,1,6,7,
Coal,U.S. Senate,Connie Johnson,DEM,150011,3,2,9,14,
Coal,U.S. Senate,Jim Rogers,DEM,150011,2,3,16,21,
Comanche,Superintendent of Public Instruction,John Cox,DEM,160001,9,6,70,85,
Comanche,Superintendent of Public Instruction,Freda Deskin,DEM,160001,8,5,71,84,
Comanche,U.S. Senate,Connie Johnson,DEM,160001,8,4,92,104,
Comanche,U.S. Senate,Jim Rogers,DEM,160001,8,6,50,64,
Comanche,Superintendent of Public Instruction,John Cox,DEM,160002,1,5,63,69,
Comanche,Superintendent of Public Instruction,Freda Deskin,DEM,160002,4,3,63,70,
Comanche,U.S. Senate,Connie Johnson,DEM,160002,4,7,98,109,
Comanche,U.S. Senate,Jim Rogers,DEM,160002,1,1,30,32,
Comanche,Superintendent of Public Instruction,John Cox,DEM,160003,1,1,29,31,
Comanche,Superintendent of Public Instruction,Freda Deskin,DEM,160003,1,1,46,48,
Comanche,U.S. Senate,Connie Johnson,DEM,160003,1,1,51,53,
Comanche,U.S. Senate,Jim Rogers,DEM,160003,0,1,23,24,
Comanche,Superintendent of Public Instruction,John Cox,DEM,160007,1,3,50,54,
Comanche,Superintendent of Public Instruction,Freda Deskin,DEM,160007,3,3,57,63,
Comanche,U.S. Senate,Connie Johnson,DEM,160007,3,4,81,88,
Comanche,U.S. Senate,Jim Rogers,DEM,160007,1,2,25,28,
Comanche,Superintendent of Public Instruction,John Cox,DEM,160008,2,7,80,89,
Comanche,Superintendent of Public Instruction,Freda Deskin,DEM,160008,2,7,82,91,
Comanche,U.S. Senate,Connie Johnson,DEM,160008,2,6,107,115,
Comanche,U.S. Senate,Jim Rogers,DEM,160008,2,8,55,65,
Comanche,Superintendent of Public Instruction,John Cox,DEM,160009,0,8,62,70,
Comanche,Superintendent of Public Instruction,Freda Deskin,DEM,160009,1,5,52,58,
Comanche,U.S. Senate,Connie Johnson,DEM,160009,1,8,90,99,
Comanche,U.S. Senate,Jim Rogers,DEM,160009,0,5,25,30,
Comanche,Superintendent of Public Instruction,John Cox,DEM,160011,1,3,35,39,
Comanche,Superintendent of Public Instruction,Freda Deskin,DEM,160011,0,1,37,38,
Comanche,U.S. Senate,Connie Johnson,DEM,160011,0,2,56,58,
Comanche,U.S. Senate,Jim Rogers,DEM,160011,1,2,14,17,
Comanche,Superintendent of Public Instruction,John Cox,DEM,160013,8,7,63,78,
Comanche,Superintendent of Public Instruction,Freda Deskin,DEM,160013,5,3,44,52,
Comanche,U.S. Senate,Connie Johnson,DEM,160013,7,4,69,80,
Comanche,U.S. Senate,Jim Rogers,DEM,160013,4,6,39,49,
Comanche,Superintendent of Public Instruction,John Cox,DEM,160014,0,0,0,0,
Comanche,Superintendent of Public Instruction,Freda Deskin,DEM,160014,0,0,2,2,
Comanche,U.S. Senate,Connie Johnson,DEM,160014,0,0,2,2,
Comanche,U.S. Senate,Jim Rogers,DEM,160014,0,0,0,0,
Comanche,State House,Scott Hayes,REP,160014,1,0,3,4,65
Comanche,State House,Scooter Park,REP,160014,0,0,0,0,65
Comanche,Superintendent of Public Instruction,John Cox,DEM,160015,2,11,59,72,
Comanche,Superintendent of Public Instruction,Freda Deskin,DEM,160015,5,3,63,71,
Comanche,U.S. Senate,Connie Johnson,DEM,160015,4,6,91,101,
Comanche,U.S. Senate,Jim Rogers,DEM,160015,3,6,31,40,
Comanche,Superintendent of Public Instruction,John Cox,DEM,160017,2,7,78,87,
Comanche,Superintendent of Public Instruction,Freda Deskin,DEM,160017,3,6,75,84,
Comanche,U.S. Senate,Connie Johnson,DEM,160017,3,9,104,116,
Comanche,U.S. Senate,Jim Rogers,DEM,160017,2,4,47,53,
Comanche,Superintendent of Public Instruction,John Cox,DEM,160019,0,5,55,60,
Comanche,Superintendent of Public Instruction,Freda Deskin,DEM,160019,1,4,41,46,
Comanche,U.S. Senate,Connie Johnson,DEM,160019,1,8,63,72,
Comanche,U.S. Senate,Jim Rogers,DEM,160019,0,1,34,35,
Comanche,Superintendent of Public Instruction,John Cox,DEM,160020,0,2,45,47,
Comanche,Superintendent of Public Instruction,Freda Deskin,DEM,160020,2,3,25,30,
Comanche,U.S. Senate,Connie Johnson,DEM,160020,2,3,45,50,
Comanche,U.S. Senate,Jim Rogers,DEM,160020,0,2,27,29,
Comanche,Superintendent of Public Instruction,John Cox,DEM,160021,1,3,32,36,
Comanche,Superintendent of Public Instruction,Freda Deskin,DEM,160021,1,0,37,38,
Comanche,U.S. Senate,Connie Johnson,DEM,160021,1,2,47,50,
Comanche,U.S. Senate,Jim Rogers,DEM,160021,1,1,23,25,
Comanche,Superintendent of Public Instruction,John Cox,DEM,160025,0,0,24,24,
Comanche,Superintendent of Public Instruction,Freda Deskin,DEM,160025,1,0,24,25,
Comanche,U.S. Senate,Connie Johnson,DEM,160025,1,0,47,48,
Comanche,U.S. Senate,Jim Rogers,DEM,160025,0,0,3,3,
Comanche,Superintendent of Public Instruction,John Cox,DEM,160026,0,1,26,27,
Comanche,Superintendent of Public Instruction,Freda Deskin,DEM,160026,0,3,21,24,
Comanche,U.S. Senate,Connie Johnson,DEM,160026,0,4,28,32,
Comanche,U.S. Senate,Jim Rogers,DEM,160026,0,0,19,19,
Comanche,Superintendent of Public Instruction,John Cox,DEM,160027,2,1,15,18,
Comanche,Superintendent of Public Instruction,Freda Deskin,DEM,160027,0,1,20,21,
Comanche,U.S. Senate,Connie Johnson,DEM,160027,0,2,20,22,
Comanche,U.S. Senate,Jim Rogers,DEM,160027,2,0,15,17,
Comanche,Superintendent of Public Instruction,John Cox,DEM,160029,0,2,43,45,
Comanche,Superintendent of Public Instruction,Freda Deskin,DEM,160029,0,0,24,24,
Comanche,U.S. Senate,Connie Johnson,DEM,160029,0,2,66,68,
Comanche,U.S. Senate,Jim Rogers,DEM,160029,0,0,3,3,
Comanche,Superintendent of Public Instruction,John Cox,DEM,160030,0,1,17,18,
Comanche,Superintendent of Public Instruction,Freda Deskin,DEM,160030,0,3,21,24,
Comanche,U.S. Senate,Connie Johnson,DEM,160030,0,4,29,33,
Comanche,U.S. Senate,Jim Rogers,DEM,160030,0,0,11,11,
Comanche,State House,Scott Hayes,REP,160030,0,1,7,8,65
Comanche,State House,Scooter Park,REP,160030,0,0,15,15,65
Comanche,Superintendent of Public Instruction,John Cox,DEM,160031,5,17,107,129,
Comanche,Superintendent of Public Instruction,Freda Deskin,DEM,160031,3,15,83,101,
Comanche,U.S. Senate,Connie Johnson,DEM,160031,5,23,131,159,
Comanche,U.S. Senate,Jim Rogers,DEM,160031,3,9,58,70,
Comanche,Superintendent of Public Instruction,John Cox,DEM,160032,0,0,15,15,
Comanche,Superintendent of Public Instruction,Freda Deskin,DEM,160032,0,0,10,10,
Comanche,U.S. Senate,Connie Johnson,DEM,160032,0,0,24,24,
Comanche,U.S. Senate,Jim Rogers,DEM,160032,0,0,1,1,
Comanche,Superintendent of Public Instruction,John Cox,DEM,160033,3,1,13,17,
Comanche,Superintendent of Public Instruction,Freda Deskin,DEM,160033,4,1,19,24,
Comanche,U.S. Senate,Connie Johnson,DEM,160033,1,3,20,24,
Comanche,U.S. Senate,Jim Rogers,DEM,160033,5,0,15,20,
Comanche,Superintendent of Public Instruction,John Cox,DEM,160034,0,8,81,89,
Comanche,Superintendent of Public Instruction,Freda Deskin,DEM,160034,4,8,68,80,
Comanche,U.S. Senate,Connie Johnson,DEM,160034,3,10,103,116,
Comanche,U.S. Senate,Jim Rogers,DEM,160034,1,7,45,53,
Comanche,Superintendent of Public Instruction,John Cox,DEM,160035,0,1,12,13,
Comanche,Superintendent of Public Instruction,Freda Deskin,DEM,160035,0,0,14,14,
Comanche,U.S. Senate,Connie Johnson,DEM,160035,0,0,21,21,
Comanche,U.S. Senate,Jim Rogers,DEM,160035,0,1,5,6,
Comanche,Superintendent of Public Instruction,John Cox,DEM,160036,0,0,16,16,
Comanche,Superintendent of Public Instruction,Freda Deskin,DEM,160036,0,0,9,9,
Comanche,U.S. Senate,Connie Johnson,DEM,160036,0,0,13,13,
Comanche,U.S. Senate,Jim Rogers,DEM,160036,0,0,12,12,
Comanche,Superintendent of Public Instruction,John Cox,DEM,160037,0,0,14,14,
Comanche,Superintendent of Public Instruction,Freda Deskin,DEM,160037,0,0,10,10,
Comanche,U.S. Senate,Connie Johnson,DEM,160037,0,0,13,13,
Comanche,U.S. Senate,Jim Rogers,DEM,160037,0,0,11,11,
Comanche,Superintendent of Public Instruction,John Cox,DEM,160038,3,2,73,78,
Comanche,Superintendent of Public Instruction,Freda Deskin,DEM,160038,1,4,47,52,
Comanche,U.S. Senate,Connie Johnson,DEM,160038,3,4,70,77,
Comanche,U.S. Senate,Jim Rogers,DEM,160038,1,2,47,50,
Comanche,State House,Scott Hayes,REP,160038,2,13,190,205,65
Comanche,State House,Scooter Park,REP,160038,1,6,62,69,65
Comanche,Superintendent of Public Instruction,John Cox,DEM,160039,0,1,27,28,
Comanche,Superintendent of Public Instruction,Freda Deskin,DEM,160039,0,0,27,27,
Comanche,U.S. Senate,Connie Johnson,DEM,160039,0,0,36,36,
Comanche,U.S. Senate,Jim Rogers,DEM,160039,0,1,18,19,
Comanche,State House,Scott Hayes,REP,160039,1,4,81,86,65
Comanche,State House,Scooter Park,REP,160039,0,0,40,40,65
Comanche,Superintendent of Public Instruction,John Cox,DEM,160040,0,1,50,51,
Comanche,Superintendent of Public Instruction,Freda Deskin,DEM,160040,2,1,30,33,
Comanche,U.S. Senate,Connie Johnson,DEM,160040,2,0,47,49,
Comanche,U.S. Senate,Jim Rogers,DEM,160040,0,2,33,35,
Comanche,State House,Scott Hayes,REP,160040,0,2,45,47,65
Comanche,State House,Scooter Park,REP,160040,0,0,25,25,65
Comanche,Superintendent of Public Instruction,John Cox,DEM,160041,0,2,34,36,
Comanche,Superintendent of Public Instruction,Freda Deskin,DEM,160041,0,0,18,18,
Comanche,U.S. Senate,Connie Johnson,DEM,160041,0,2,30,32,
Comanche,U.S. Senate,Jim Rogers,DEM,160041,0,0,22,22,
Comanche,Superintendent of Public Instruction,John Cox,DEM,160042,3,10,59,72,
Comanche,Superintendent of Public Instruction,Freda Deskin,DEM,160042,1,1,30,32,
Comanche,U.S. Senate,Connie Johnson,DEM,160042,1,10,56,67,
Comanche,U.S. Senate,Jim Rogers,DEM,160042,3,1,33,37,
Comanche,Superintendent of Public Instruction,John Cox,DEM,160043,0,2,13,15,
Comanche,Superintendent of Public Instruction,Freda Deskin,DEM,160043,0,2,11,13,
Comanche,U.S. Senate,Connie Johnson,DEM,160043,0,1,9,10,
Comanche,U.S. Senate,Jim Rogers,DEM,160043,0,3,15,18,
Comanche,Superintendent of Public Instruction,John Cox,DEM,160045,1,7,22,30,
Comanche,Superintendent of Public Instruction,Freda Deskin,DEM,160045,3,0,13,16,
Comanche,U.S. Senate,Connie Johnson,DEM,160045,2,4,17,23,
Comanche,U.S. Senate,Jim Rogers,DEM,160045,2,3,18,23,
Comanche,Superintendent of Public Instruction,John Cox,DEM,160046,0,1,10,11,
Comanche,Superintendent of Public Instruction,Freda Deskin,DEM,160046,0,0,7,7,
Comanche,U.S. Senate,Connie Johnson,DEM,160046,0,1,6,7,
Comanche,U.S. Senate,Jim Rogers,DEM,160046,0,0,10,10,
Comanche,Superintendent of Public Instruction,John Cox,DEM,160048,1,1,27,29,
Comanche,Superintendent of Public Instruction,Freda Deskin,DEM,160048,0,2,15,17,
Comanche,U.S. Senate,Connie Johnson,DEM,160048,0,2,20,22,
Comanche,U.S. Senate,Jim Rogers,DEM,160048,1,1,22,24,
Comanche,Superintendent of Public Instruction,John Cox,DEM,160049,0,8,27,35,
Comanche,Superintendent of Public Instruction,Freda Deskin,DEM,160049,0,1,21,22,
Comanche,U.S. Senate,Connie Johnson,DEM,160049,0,5,30,35,
Comanche,U.S. Senate,Jim Rogers,DEM,160049,0,4,17,21,
Comanche,State House,Scott Hayes,REP,160049,0,0,14,14,65
Comanche,State House,Scooter Park,REP,160049,0,2,44,46,65
Comanche,Superintendent of Public Instruction,John Cox,DEM,160050,2,11,103,116,
Comanche,Superintendent of Public Instruction,Freda Deskin,DEM,160050,3,8,87,98,
Comanche,U.S. Senate,Connie Johnson,DEM,160050,2,11,133,146,
Comanche,U.S. Senate,Jim Rogers,DEM,160050,3,7,54,64,
Comanche,Superintendent of Public Instruction,John Cox,DEM,160051,0,2,26,28,
Comanche,Superintendent of Public Instruction,Freda Deskin,DEM,160051,0,0,20,20,
Comanche,U.S. Senate,Connie Johnson,DEM,160051,0,1,26,27,
Comanche,U.S. Senate,Jim Rogers,DEM,160051,0,1,19,20,
Comanche,Superintendent of Public Instruction,John Cox,DEM,160053,0,0,0,0,
Comanche,Superintendent of Public Instruction,Freda Deskin,DEM,160053,0,0,0,0,
Comanche,U.S. Senate,Connie Johnson,DEM,160053,0,0,0,0,
Comanche,U.S. Senate,Jim Rogers,DEM,160053,0,0,0,0,
Comanche,State House,Scott Hayes,REP,160053,0,0,0,0,65
Comanche,State House,Scooter Park,REP,160053,0,0,0,0,65
Cotton,Superintendent of Public Instruction,John Cox,DEM,170001,0,1,6,7,
Cotton,Superintendent of Public Instruction,Freda Deskin,DEM,170001,1,0,4,5,
Cotton,U.S. Senate,Connie Johnson,DEM,170001,1,0,5,6,
Cotton,U.S. Senate,Jim Rogers,DEM,170001,0,1,5,6,
Cotton,State House,Scott Hayes,REP,170001,0,0,0,0,65
Cotton,State House,Scooter Park,REP,170001,1,0,8,9,65
Cotton,Superintendent of Public Instruction,John Cox,DEM,170003,0,2,12,14,
Cotton,Superintendent of Public Instruction,Freda Deskin,DEM,170003,0,1,19,20,
Cotton,U.S. Senate,Connie Johnson,DEM,170003,0,2,19,21,
Cotton,U.S. Senate,Jim Rogers,DEM,170003,0,1,12,13,
Cotton,State House,Scott Hayes,REP,170003,2,2,4,8,65
Cotton,State House,Scooter Park,REP,170003,4,5,20,29,65
Cotton,Superintendent of Public Instruction,John Cox,DEM,170004,2,2,19,23,
Cotton,Superintendent of Public Instruction,Freda Deskin,DEM,170004,1,3,16,20,
Cotton,U.S. Senate,Connie Johnson,DEM,170004,1,3,19,23,
Cotton,U.S. Senate,Jim Rogers,DEM,170004,2,2,16,20,
Cotton,State House,Scott Hayes,REP,170004,0,1,2,3,65
Cotton,State House,Scooter Park,REP,170004,0,7,25,32,65
Cotton,Superintendent of Public Instruction,John Cox,DEM,170005,3,9,105,117,
Cotton,Superintendent of Public Instruction,Freda Deskin,DEM,170005,4,1,65,70,
Cotton,U.S. Senate,Connie Johnson,DEM,170005,5,5,92,102,
Cotton,U.S. Senate,Jim Rogers,DEM,170005,1,6,76,83,
Cotton,State House,Scott Hayes,REP,170005,0,0,9,9,65
Cotton,State House,Scooter Park,REP,170005,1,1,49,51,65
Cotton,Superintendent of Public Instruction,John Cox,DEM,170007,2,2,15,19,
Cotton,Superintendent of Public Instruction,Freda Deskin,DEM,170007,1,0,21,22,
Cotton,U.S. Senate,Connie Johnson,DEM,170007,2,1,20,23,
Cotton,U.S. Senate,Jim Rogers,DEM,170007,1,1,14,16,
Cotton,State House,Scott Hayes,REP,170007,0,0,7,7,65
Cotton,State House,Scooter Park,REP,170007,1,2,22,25,65
Cotton,Superintendent of Public Instruction,John Cox,DEM,170008,0,0,6,6,
Cotton,Superintendent of Public Instruction,Freda Deskin,DEM,170008,0,0,7,7,
Cotton,U.S. Senate,Connie Johnson,DEM,170008,0,0,6,6,
Cotton,U.S. Senate,Jim Rogers,DEM,170008,0,0,7,7,
Cotton,State House,Scott Hayes,REP,170008,0,0,0,0,65
Cotton,State House,Scooter Park,REP,170008,2,0,6,8,65
Cotton,Superintendent of Public Instruction,John Cox,DEM,170009,3,4,9,16,
Cotton,Superintendent of Public Instruction,Freda Deskin,DEM,170009,0,0,7,7,
Cotton,U.S. Senate,Connie Johnson,DEM,170009,0,2,6,8,
Cotton,U.S. Senate,Jim Rogers,DEM,170009,3,2,10,15,
Cotton,State House,Scott Hayes,REP,170009,0,0,2,2,65
Cotton,State House,Scooter Park,REP,170009,3,8,11,22,65
Cotton,Superintendent of Public Instruction,John Cox,DEM,170010,0,0,9,9,
Cotton,Superintendent of Public Instruction,Freda Deskin,DEM,170010,0,0,3,3,
Cotton,U.S. Senate,Connie Johnson,DEM,170010,0,0,6,6,
Cotton,U.S. Senate,Jim Rogers,DEM,170010,0,0,6,6,
Cotton,State House,Scott Hayes,REP,170010,0,0,2,2,65
Cotton,State House,Scooter Park,REP,170010,0,3,29,32,65
Cotton,Superintendent of Public Instruction,John Cox,DEM,170011,0,0,10,10,
Cotton,Superintendent of Public Instruction,Freda Deskin,DEM,170011,0,0,4,4,
Cotton,U.S. Senate,Connie Johnson,DEM,170011,0,0,5,5,
Cotton,U.S. Senate,Jim Rogers,DEM,170011,0,0,9,9,
Cotton,State House,Scott Hayes,REP,170011,0,0,8,8,65
Cotton,State House,Scooter Park,REP,170011,0,5,56,61,65
Craig,Superintendent of Public Instruction,John Cox,DEM,180140,1,1,47,49,
Craig,Superintendent of Public Instruction,Freda Deskin,DEM,180140,0,0,5,5,
Craig,U.S. Senate,Connie Johnson,DEM,180140,1,1,21,23,
Craig,U.S. Senate,Jim Rogers,DEM,180140,0,0,30,30,
Craig,Superintendent of Public Instruction,John Cox,DEM,180320,0,1,17,18,
Craig,Superintendent of Public Instruction,Freda Deskin,DEM,180320,0,0,4,4,
Craig,U.S. Senate,Connie Johnson,DEM,180320,0,0,11,11,
Craig,U.S. Senate,Jim Rogers,DEM,180320,0,1,10,11,
Craig,Superintendent of Public Instruction,John Cox,DEM,180410,0,4,24,28,
Craig,Superintendent of Public Instruction,Freda Deskin,DEM,180410,0,0,6,6,
Craig,U.S. Senate,Connie Johnson,DEM,180410,0,1,8,9,
Craig,U.S. Senate,Jim Rogers,DEM,180410,0,3,23,26,
Craig,Superintendent of Public Instruction,John Cox,DEM,180520,0,1,34,35,
Craig,Superintendent of Public Instruction,Freda Deskin,DEM,180520,0,2,3,5,
Craig,U.S. Senate,Connie Johnson,DEM,180520,0,0,14,14,
Craig,U.S. Senate,Jim Rogers,DEM,180520,0,3,22,25,
Craig,Superintendent of Public Instruction,John Cox,DEM,180611,0,0,29,29,
Craig,Superintendent of Public Instruction,Freda Deskin,DEM,180611,1,1,7,9,
Craig,U.S. Senate,Connie Johnson,DEM,180611,1,1,22,24,
Craig,U.S. Senate,Jim Rogers,DEM,180611,0,0,14,14,
Craig,Superintendent of Public Instruction,John Cox,DEM,180612,1,0,17,18,
Craig,Superintendent of Public Instruction,Freda Deskin,DEM,180612,0,0,11,11,
Craig,U.S. Senate,Connie Johnson,DEM,180612,1,0,11,12,
Craig,U.S. Senate,Jim Rogers,DEM,180612,0,0,15,15,
Craig,Superintendent of Public Instruction,John Cox,DEM,180621,2,5,53,60,
Craig,Superintendent of Public Instruction,Freda Deskin,DEM,180621,1,1,7,9,
Craig,U.S. Senate,Connie Johnson,DEM,180621,2,3,34,39,
Craig,U.S. Senate,Jim Rogers,DEM,180621,1,3,24,28,
Craig,Superintendent of Public Instruction,John Cox,DEM,180622,1,0,29,30,
Craig,Superintendent of Public Instruction,Freda Deskin,DEM,180622,1,0,4,5,
Craig,U.S. Senate,Connie Johnson,DEM,180622,1,0,15,16,
Craig,U.S. Senate,Jim Rogers,DEM,180622,1,0,17,18,
Craig,Superintendent of Public Instruction,John Cox,DEM,180710,0,0,19,19,
Craig,Superintendent of Public Instruction,Freda Deskin,DEM,180710,0,1,7,8,
Craig,U.S. Senate,Connie Johnson,DEM,180710,0,1,13,14,
Craig,U.S. Senate,Jim Rogers,DEM,180710,0,0,13,13,
Craig,Superintendent of Public Instruction,John Cox,DEM,180810,0,2,22,24,
Craig,Superintendent of Public Instruction,Freda Deskin,DEM,180810,0,0,2,2,
Craig,U.S. Senate,Connie Johnson,DEM,180810,0,0,8,8,
Craig,U.S. Senate,Jim Rogers,DEM,180810,0,2,15,17,
Craig,Superintendent of Public Instruction,John Cox,DEM,180820,0,1,18,19,
Craig,Superintendent of Public Instruction,Freda Deskin,DEM,180820,0,0,4,4,
Craig,U.S. Senate,Connie Johnson,DEM,180820,0,1,8,9,
Craig,U.S. Senate,Jim Rogers,DEM,180820,0,0,14,14,
Craig,Superintendent of Public Instruction,John Cox,DEM,180910,0,1,26,27,
Craig,Superintendent of Public Instruction,Freda Deskin,DEM,180910,0,0,4,4,
Craig,U.S. Senate,Connie Johnson,DEM,180910,0,1,13,14,
Craig,U.S. Senate,Jim Rogers,DEM,180910,0,0,15,15,
Creek,Superintendent of Public Instruction,John Cox,DEM,190111,2,1,38,41,
Creek,Superintendent of Public Instruction,Freda Deskin,DEM,190111,2,3,16,21,
Creek,U.S. Senate,Connie Johnson,DEM,190111,3,2,27,32,
Creek,U.S. Senate,Jim Rogers,DEM,190111,1,2,25,28,
Creek,Superintendent of Public Instruction,John Cox,DEM,190112,1,0,19,20,
Creek,Superintendent of Public Instruction,Freda Deskin,DEM,190112,0,0,6,6,
Creek,U.S. Senate,Connie Johnson,DEM,190112,0,0,14,14,
Creek,U.S. Senate,Jim Rogers,DEM,190112,1,0,11,12,
Creek,Superintendent of Public Instruction,John Cox,DEM,190121,3,5,27,35,
Creek,Superintendent of Public Instruction,Freda Deskin,DEM,190121,0,0,16,16,
Creek,U.S. Senate,Connie Johnson,DEM,190121,3,2,19,24,
Creek,U.S. Senate,Jim Rogers,DEM,190121,0,3,24,27,
Creek,State House,James Leewright,REP,190121,2,6,86,94,29
Creek,State House,Dani Thompson-Fields,REP,190121,2,5,54,61,29
Creek,Superintendent of Public Instruction,John Cox,DEM,190122,0,0,26,26,
Creek,Superintendent of Public Instruction,Freda Deskin,DEM,190122,0,0,24,24,
Creek,U.S. Senate,Connie Johnson,DEM,190122,0,0,29,29,
Creek,U.S. Senate,Jim Rogers,DEM,190122,0,0,20,20,
Creek,Superintendent of Public Instruction,John Cox,DEM,190131,0,4,34,38,
Creek,Superintendent of Public Instruction,Freda Deskin,DEM,190131,0,5,26,31,
Creek,U.S. Senate,Connie Johnson,DEM,190131,0,6,30,36,
Creek,U.S. Senate,Jim Rogers,DEM,190131,0,3,28,31,
Creek,Superintendent of Public Instruction,John Cox,DEM,190132,1,4,63,68,
Creek,Superintendent of Public Instruction,Freda Deskin,DEM,190132,0,2,27,29,
Creek,U.S. Senate,Connie Johnson,DEM,190132,0,1,37,38,
Creek,U.S. Senate,Jim Rogers,DEM,190132,1,5,52,58,
Creek,Superintendent of Public Instruction,John Cox,DEM,190142,5,22,132,159,
Creek,Superintendent of Public Instruction,Freda Deskin,DEM,190142,3,21,66,90,
Creek,U.S. Senate,Connie Johnson,DEM,190142,1,27,103,131,
Creek,U.S. Senate,Jim Rogers,DEM,190142,6,15,92,113,
Creek,Superintendent of Public Instruction,John Cox,DEM,190143,5,11,42,58,
Creek,Superintendent of Public Instruction,Freda Deskin,DEM,190143,2,1,44,47,
Creek,U.S. Senate,Connie Johnson,DEM,190143,4,6,42,52,
Creek,U.S. Senate,Jim Rogers,DEM,190143,2,5,43,50,
Creek,Superintendent of Public Instruction,John Cox,DEM,190211,2,0,35,37,
Creek,Superintendent of Public Instruction,Freda Deskin,DEM,190211,1,0,8,9,
Creek,U.S. Senate,Connie Johnson,DEM,190211,3,0,21,24,
Creek,U.S. Senate,Jim Rogers,DEM,190211,0,0,22,22,
Creek,State House,James Leewright,REP,190211,1,0,20,21,29
Creek,State House,Dani Thompson-Fields,REP,190211,2,0,20,22,29
Creek,Superintendent of Public Instruction,John Cox,DEM,190221,0,0,22,22,
Creek,Superintendent of Public Instruction,Freda Deskin,DEM,190221,1,0,9,10,
Creek,U.S. Senate,Connie Johnson,DEM,190221,1,0,14,15,
Creek,U.S. Senate,Jim Rogers,DEM,190221,0,0,17,17,
Creek,State House,James Leewright,REP,190221,0,1,21,22,29
Creek,State House,Dani Thompson-Fields,REP,190221,0,0,7,7,29
Creek,Superintendent of Public Instruction,John Cox,DEM,190231,2,0,29,31,
Creek,Superintendent of Public Instruction,Freda Deskin,DEM,190231,0,0,5,5,
Creek,U.S. Senate,Connie Johnson,DEM,190231,2,0,16,18,
Creek,U.S. Senate,Jim Rogers,DEM,190231,0,0,18,18,
Creek,State House,James Leewright,REP,190231,0,0,13,13,29
Creek,State House,Dani Thompson-Fields,REP,190231,1,1,27,29,29
Creek,Superintendent of Public Instruction,John Cox,DEM,190241,0,0,37,37,
Creek,Superintendent of Public Instruction,Freda Deskin,DEM,190241,0,0,16,16,
Creek,U.S. Senate,Connie Johnson,DEM,190241,1,0,35,36,
Creek,U.S. Senate,Jim Rogers,DEM,190241,0,0,18,18,
Creek,State House,James Leewright,REP,190241,1,0,36,37,29
Creek,State House,Dani Thompson-Fields,REP,190241,0,2,39,41,29
Creek,Superintendent of Public Instruction,John Cox,DEM,190311,0,0,22,22,
Creek,Superintendent of Public Instruction,Freda Deskin,DEM,190311,1,0,8,9,
Creek,U.S. Senate,Connie Johnson,DEM,190311,0,0,17,17,
Creek,U.S. Senate,Jim Rogers,DEM,190311,1,0,13,14,
Creek,Superintendent of Public Instruction,John Cox,DEM,190401,4,2,16,22,
Creek,Superintendent of Public Instruction,Freda Deskin,DEM,190401,0,3,13,16,
Creek,U.S. Senate,Connie Johnson,DEM,190401,0,3,15,18,
Creek,U.S. Senate,Jim Rogers,DEM,190401,4,2,14,20,
Creek,State House,James Leewright,REP,190401,3,1,32,36,29
Creek,State House,Dani Thompson-Fields,REP,190401,2,2,55,59,29
Creek,Superintendent of Public Instruction,John Cox,DEM,190402,1,3,47,51,
Creek,Superintendent of Public Instruction,Freda Deskin,DEM,190402,0,3,19,22,
Creek,U.S. Senate,Connie Johnson,DEM,190402,1,3,28,32,
Creek,U.S. Senate,Jim Rogers,DEM,190402,0,2,35,37,
Creek,State House,James Leewright,REP,190402,4,6,63,73,29
Creek,State House,Dani Thompson-Fields,REP,190402,0,4,65,69,29
Creek,Superintendent of Public Instruction,John Cox,DEM,190403,0,1,26,27,
Creek,Superintendent of Public Instruction,Freda Deskin,DEM,190403,0,0,11,11,
Creek,U.S. Senate,Connie Johnson,DEM,190403,0,1,19,20,
Creek,U.S. Senate,Jim Rogers,DEM,190403,0,0,18,18,
Creek,State House,James Leewright,REP,190403,0,5,30,35,29
Creek,State House,Dani Thompson-Fields,REP,190403,0,0,48,48,29
Creek,Superintendent of Public Instruction,John Cox,DEM,190404,2,0,43,45,
Creek,Superintendent of Public Instruction,Freda Deskin,DEM,190404,0,0,14,14,
Creek,U.S. Senate,Connie Johnson,DEM,190404,0,0,32,32,
Creek,U.S. Senate,Jim Rogers,DEM,190404,2,0,25,27,
Creek,State House,James Leewright,REP,190404,3,1,87,91,29
Creek,State House,Dani Thompson-Fields,REP,190404,3,0,90,93,29
Creek,Superintendent of Public Instruction,John Cox,DEM,190405,1,0,18,19,
Creek,Superintendent of Public Instruction,Freda Deskin,DEM,190405,0,0,4,4,
Creek,U.S. Senate,Connie Johnson,DEM,190405,1,0,9,10,
Creek,U.S. Senate,Jim Rogers,DEM,190405,0,0,13,13,
Creek,Superintendent of Public Instruction,John Cox,DEM,190406,1,0,23,24,
Creek,Superintendent of Public Instruction,Freda Deskin,DEM,190406,0,0,11,11,
Creek,U.S. Senate,Connie Johnson,DEM,190406,1,0,16,17,
Creek,U.S. Senate,Jim Rogers,DEM,190406,0,0,18,18,
Creek,Superintendent of Public Instruction,John Cox,DEM,190407,0,0,16,16,
Creek,Superintendent of Public Instruction,Freda Deskin,DEM,190407,0,0,7,7,
Creek,U.S. Senate,Connie Johnson,DEM,190407,0,0,10,10,
Creek,U.S. Senate,Jim Rogers,DEM,190407,0,0,13,13,
Creek,Superintendent of Public Instruction,John Cox,DEM,190408,0,0,10,10,
Creek,Superintendent of Public Instruction,Freda Deskin,DEM,190408,0,0,8,8,
Creek,U.S. Senate,Connie Johnson,DEM,190408,0,0,13,13,
Creek,U.S. Senate,Jim Rogers,DEM,190408,0,0,5,5,
Creek,State House,James Leewright,REP,190408,1,0,17,18,29
Creek,State House,Dani Thompson-Fields,REP,190408,4,3,29,36,29
Creek,Superintendent of Public Instruction,John Cox,DEM,190409,1,1,33,35,
Creek,Superintendent of Public Instruction,Freda Deskin,DEM,190409,1,0,9,10,
Creek,U.S. Senate,Connie Johnson,DEM,190409,1,1,15,17,
Creek,U.S. Senate,Jim Rogers,DEM,190409,1,0,26,27,
Creek,State House,James Leewright,REP,190409,0,1,62,63,29
Creek,State House,Dani Thompson-Fields,REP,190409,0,0,70,70,29
Creek,Superintendent of Public Instruction,John Cox,DEM,190410,0,0,12,12,
Creek,Superintendent of Public Instruction,Freda Deskin,DEM,190410,0,0,6,6,
Creek,U.S. Senate,Connie Johnson,DEM,190410,0,0,7,7,
Creek,U.S. Senate,Jim Rogers,DEM,190410,0,0,11,11,
Creek,State House,James Leewright,REP,190410,0,0,7,7,29
Creek,State House,Dani Thompson-Fields,REP,190410,0,0,10,10,29
Creek,Superintendent of Public Instruction,John Cox,DEM,190411,0,0,34,34,
Creek,Superintendent of Public Instruction,Freda Deskin,DEM,190411,0,0,12,12,
Creek,U.S. Senate,Connie Johnson,DEM,190411,0,0,19,19,
Creek,U.S. Senate,Jim Rogers,DEM,190411,0,0,24,24,
Creek,State House,James Leewright,REP,190411,0,0,44,44,29
Creek,State House,Dani Thompson-Fields,REP,190411,0,0,51,51,29
Creek,Superintendent of Public Instruction,John Cox,DEM,190412,0,0,24,24,
Creek,Superintendent of Public Instruction,Freda Deskin,DEM,190412,0,0,11,11,
Creek,U.S. Senate,Connie Johnson,DEM,190412,0,0,14,14,
Creek,U.S. Senate,Jim Rogers,DEM,190412,0,0,20,20,
Creek,State House,James Leewright,REP,190412,0,0,46,46,29
Creek,State House,Dani Thompson-Fields,REP,190412,0,1,38,39,29
Creek,Superintendent of Public Instruction,John Cox,DEM,190413,0,0,45,45,
Creek,Superintendent of Public Instruction,Freda Deskin,DEM,190413,0,0,22,22,
Creek,U.S. Senate,Connie Johnson,DEM,190413,0,0,33,33,
Creek,U.S. Senate,Jim Rogers,DEM,190413,0,0,31,31,
Creek,State House,James Leewright,REP,190413,0,2,68,70,29
Creek,State House,Dani Thompson-Fields,REP,190413,0,0,64,64,29
Creek,Superintendent of Public Instruction,John Cox,DEM,190414,1,2,39,42,
Creek,Superintendent of Public Instruction,Freda Deskin,DEM,190414,2,1,22,25,
Creek,U.S. Senate,Connie Johnson,DEM,190414,3,1,25,29,
Creek,U.S. Senate,Jim Rogers,DEM,190414,0,2,36,38,
Creek,State House,James Leewright,REP,190414,4,0,110,114,29
Creek,State House,Dani Thompson-Fields,REP,190414,1,4,57,62,29
Creek,Superintendent of Public Instruction,John Cox,DEM,190415,0,0,6,6,
Creek,Superintendent of Public Instruction,Freda Deskin,DEM,190415,0,0,2,2,
Creek,U.S. Senate,Connie Johnson,DEM,190415,0,0,3,3,
Creek,U.S. Senate,Jim Rogers,DEM,190415,0,0,5,5,
Creek,State House,James Leewright,REP,190415,1,0,20,21,29
Creek,State House,Dani Thompson-Fields,REP,190415,1,0,19,20,29
Creek,Superintendent of Public Instruction,John Cox,DEM,190416,0,1,15,16,
Creek,Superintendent of Public Instruction,Freda Deskin,DEM,190416,0,0,14,14,
Creek,U.S. Senate,Connie Johnson,DEM,190416,0,0,14,14,
Creek,U.S. Senate,Jim Rogers,DEM,190416,0,1,15,16,
Creek,Superintendent of Public Instruction,John Cox,DEM,190417,0,5,52,57,
Creek,Superintendent of Public Instruction,Freda Deskin,DEM,190417,0,1,21,22,
Creek,U.S. Senate,Connie Johnson,DEM,190417,0,3,36,39,
Creek,U.S. Senate,Jim Rogers,DEM,190417,0,3,35,38,
Creek,Superintendent of Public Instruction,John Cox,DEM,190418,3,4,71,78,
Creek,Superintendent of Public Instruction,Freda Deskin,DEM,190418,0,9,43,52,
Creek,U.S. Senate,Connie Johnson,DEM,190418,0,12,61,73,
Creek,U.S. Senate,Jim Rogers,DEM,190418,3,1,50,54,
Creek,Superintendent of Public Instruction,John Cox,DEM,190419,0,2,55,57,
Creek,Superintendent of Public Instruction,Freda Deskin,DEM,190419,0,3,22,25,
Creek,U.S. Senate,Connie Johnson,DEM,190419,0,5,44,49,
Creek,U.S. Senate,Jim Rogers,DEM,190419,0,0,32,32,
Creek,Superintendent of Public Instruction,John Cox,DEM,190420,0,0,9,9,
Creek,Superintendent of Public Instruction,Freda Deskin,DEM,190420,0,0,7,7,
Creek,U.S. Senate,Connie Johnson,DEM,190420,0,0,10,10,
Creek,U.S. Senate,Jim Rogers,DEM,190420,0,0,6,6,
Creek,Superintendent of Public Instruction,John Cox,DEM,190421,0,0,19,19,
Creek,Superintendent of Public Instruction,Freda Deskin,DEM,190421,1,0,13,14,
Creek,U.S. Senate,Connie Johnson,DEM,190421,1,0,17,18,
Creek,U.S. Senate,Jim Rogers,DEM,190421,0,0,13,13,
Creek,Superintendent of Public Instruction,John Cox,DEM,190422,0,0,12,12,
Creek,Superintendent of Public Instruction,Freda Deskin,DEM,190422,0,0,6,6,
Creek,U.S. Senate,Connie Johnson,DEM,190422,0,0,6,6,
Creek,U.S. Senate,Jim Rogers,DEM,190422,0,0,12,12,
Creek,State House,James Leewright,REP,190422,8,1,35,44,29
Creek,State House,Dani Thompson-Fields,REP,190422,5,0,26,31,29
Custer,Superintendent of Public Instruction,John Cox,DEM,200001,2,0,9,11,
Custer,Superintendent of Public Instruction,Freda Deskin,DEM,200001,0,0,4,4,
Custer,U.S. Senate,Connie Johnson,DEM,200001,1,0,1,2,
Custer,U.S. Senate,Jim Rogers,DEM,200001,1,0,12,13,
Custer,Superintendent of Public Instruction,John Cox,DEM,200003,0,3,18,21,
Custer,Superintendent of Public Instruction,Freda Deskin,DEM,200003,1,0,6,7,
Custer,U.S. Senate,Connie Johnson,DEM,200003,1,1,16,18,
Custer,U.S. Senate,Jim Rogers,DEM,200003,0,2,8,10,
Custer,Superintendent of Public Instruction,John Cox,DEM,200005,4,1,23,28,
Custer,Superintendent of Public Instruction,Freda Deskin,DEM,200005,2,3,9,14,
Custer,U.S. Senate,Connie Johnson,DEM,200005,4,4,15,23,
Custer,U.S. Senate,Jim Rogers,DEM,200005,2,0,16,18,
Custer,Superintendent of Public Instruction,John Cox,DEM,200007,2,2,2,6,
Custer,Superintendent of Public Instruction,Freda Deskin,DEM,200007,0,0,0,0,
Custer,U.S. Senate,Connie Johnson,DEM,200007,1,0,1,2,
Custer,U.S. Senate,Jim Rogers,DEM,200007,1,2,1,4,
Custer,Superintendent of Public Instruction,John Cox,DEM,200012,0,0,11,11,
Custer,Superintendent of Public Instruction,Freda Deskin,DEM,200012,0,0,9,9,
Custer,U.S. Senate,Connie Johnson,DEM,200012,0,0,8,8,
Custer,U.S. Senate,Jim Rogers,DEM,200012,0,0,12,12,
Custer,Superintendent of Public Instruction,John Cox,DEM,200013,0,0,13,13,
Custer,Superintendent of Public Instruction,Freda Deskin,DEM,200013,0,1,10,11,
Custer,U.S. Senate,Connie Johnson,DEM,200013,0,0,8,8,
Custer,U.S. Senate,Jim Rogers,DEM,200013,0,1,14,15,
Custer,Superintendent of Public Instruction,John Cox,DEM,200018,0,1,26,27,
Custer,Superintendent of Public Instruction,Freda Deskin,DEM,200018,0,2,18,20,
Custer,U.S. Senate,Connie Johnson,DEM,200018,0,2,26,28,
Custer,U.S. Senate,Jim Rogers,DEM,200018,0,1,18,19,
Custer,Superintendent of Public Instruction,John Cox,DEM,200019,4,0,22,26,
Custer,Superintendent of Public Instruction,Freda Deskin,DEM,200019,2,0,17,19,
Custer,U.S. Senate,Connie Johnson,DEM,200019,4,0,31,35,
Custer,U.S. Senate,Jim Rogers,DEM,200019,2,0,7,9,
Custer,Superintendent of Public Instruction,John Cox,DEM,200020,0,0,32,32,
Custer,Superintendent of Public Instruction,Freda Deskin,DEM,200020,0,0,9,9,
Custer,U.S. Senate,Connie Johnson,DEM,200020,0,0,26,26,
Custer,U.S. Senate,Jim Rogers,DEM,200020,0,0,13,13,
Custer,Superintendent of Public Instruction,John Cox,DEM,200021,2,0,19,21,
Custer,Superintendent of Public Instruction,Freda Deskin,DEM,200021,1,0,14,15,
Custer,U.S. Senate,Connie Johnson,DEM,200021,1,0,27,28,
Custer,U.S. Senate,Jim Rogers,DEM,200021,2,0,6,8,
Custer,Superintendent of Public Instruction,John Cox,DEM,200022,0,0,4,4,
Custer,Superintendent of Public Instruction,Freda Deskin,DEM,200022,0,0,0,0,
Custer,U.S. Senate,Connie Johnson,DEM,200022,0,0,4,4,
Custer,U.S. Senate,Jim Rogers,DEM,200022,0,0,0,0,
Custer,Superintendent of Public Instruction,John Cox,DEM,200023,0,0,20,20,
Custer,Superintendent of Public Instruction,Freda Deskin,DEM,200023,1,0,11,12,
Custer,U.S. Senate,Connie Johnson,DEM,200023,1,0,12,13,
Custer,U.S. Senate,Jim Rogers,DEM,200023,0,0,20,20,
Custer,Superintendent of Public Instruction,John Cox,DEM,200026,5,0,10,15,
Custer,Superintendent of Public Instruction,Freda Deskin,DEM,200026,2,0,10,12,
Custer,U.S. Senate,Connie Johnson,DEM,200026,3,0,8,11,
Custer,U.S. Senate,Jim Rogers,DEM,200026,2,0,12,14,
Delaware,Superintendent of Public Instruction,John Cox,DEM,210001,1,0,23,24,
Delaware,Superintendent of Public Instruction,Freda Deskin,DEM,210001,2,0,8,10,
Delaware,U.S. Senate,Connie Johnson,DEM,210001,1,0,19,20,
Delaware,U.S. Senate,Jim Rogers,DEM,210001,2,0,10,12,
Delaware,Superintendent of Public Instruction,John Cox,DEM,210002,1,0,23,24,
Delaware,Superintendent of Public Instruction,Freda Deskin,DEM,210002,0,0,9,9,
Delaware,U.S. Senate,Connie Johnson,DEM,210002,1,0,15,16,
Delaware,U.S. Senate,Jim Rogers,DEM,210002,0,0,16,16,
Delaware,Superintendent of Public Instruction,John Cox,DEM,210003,1,1,20,22,
Delaware,Superintendent of Public Instruction,Freda Deskin,DEM,210003,1,0,11,12,
Delaware,U.S. Senate,Connie Johnson,DEM,210003,1,1,18,20,
Delaware,U.S. Senate,Jim Rogers,DEM,210003,1,0,12,13,
Delaware,Superintendent of Public Instruction,John Cox,DEM,210004,0,0,31,31,
Delaware,Superintendent of Public Instruction,Freda Deskin,DEM,210004,0,0,4,4,
Delaware,U.S. Senate,Connie Johnson,DEM,210004,0,0,20,20,
Delaware,U.S. Senate,Jim Rogers,DEM,210004,0,0,15,15,
Delaware,Superintendent of Public Instruction,John Cox,DEM,210005,1,2,24,27,
Delaware,Superintendent of Public Instruction,Freda Deskin,DEM,210005,0,0,8,8,
Delaware,U.S. Senate,Connie Johnson,DEM,210005,1,0,21,22,
Delaware,U.S. Senate,Jim Rogers,DEM,210005,0,2,9,11,
Delaware,Superintendent of Public Instruction,John Cox,DEM,210006,2,2,17,21,
Delaware,Superintendent of Public Instruction,Freda Deskin,DEM,210006,0,0,3,3,
Delaware,U.S. Senate,Connie Johnson,DEM,210006,0,0,10,10,
Delaware,U.S. Senate,Jim Rogers,DEM,210006,2,2,7,11,
Delaware,Superintendent of Public Instruction,John Cox,DEM,210007,5,0,44,49,
Delaware,Superintendent of Public Instruction,Freda Deskin,DEM,210007,1,0,11,12,
Delaware,U.S. Senate,Connie Johnson,DEM,210007,1,0,38,39,
Delaware,U.S. Senate,Jim Rogers,DEM,210007,5,0,16,21,
Delaware,Superintendent of Public Instruction,John Cox,DEM,210008,1,2,17,20,
Delaware,Superintendent of Public Instruction,Freda Deskin,DEM,210008,0,0,7,7,
Delaware,U.S. Senate,Connie Johnson,DEM,210008,0,1,11,12,
Delaware,U.S. Senate,Jim Rogers,DEM,210008,1,0,11,12,
Delaware,Superintendent of Public Instruction,John Cox,DEM,210009,5,2,54,61,
Delaware,Superintendent of Public Instruction,Freda Deskin,DEM,210009,4,0,12,16,
Delaware,U.S. Senate,Connie Johnson,DEM,210009,7,2,38,47,
Delaware,U.S. Senate,Jim Rogers,DEM,210009,2,0,26,28,
Delaware,Superintendent of Public Instruction,John Cox,DEM,210010,2,1,8,11,
Delaware,Superintendent of Public Instruction,Freda Deskin,DEM,210010,0,1,0,1,
Delaware,U.S. Senate,Connie Johnson,DEM,210010,0,2,2,4,
Delaware,U.S. Senate,Jim Rogers,DEM,210010,2,0,6,8,
Delaware,Superintendent of Public Instruction,John Cox,DEM,210011,0,0,14,14,
Delaware,Superintendent of Public Instruction,Freda Deskin,DEM,210011,0,0,3,3,
Delaware,U.S. Senate,Connie Johnson,DEM,210011,0,0,6,6,
Delaware,U.S. Senate,Jim Rogers,DEM,210011,0,0,10,10,
Delaware,Superintendent of Public Instruction,John Cox,DEM,210012,2,4,54,60,
Delaware,Superintendent of Public Instruction,Freda Deskin,DEM,210012,0,2,7,9,
Delaware,U.S. Senate,Connie Johnson,DEM,210012,0,0,21,21,
Delaware,U.S. Senate,Jim Rogers,DEM,210012,2,5,34,41,
Delaware,Superintendent of Public Instruction,John Cox,DEM,210014,4,35,175,214,
Delaware,Superintendent of Public Instruction,Freda Deskin,DEM,210014,2,0,9,11,
Delaware,U.S. Senate,Connie Johnson,DEM,210014,2,9,60,71,
Delaware,U.S. Senate,Jim Rogers,DEM,210014,4,21,119,144,
Delaware,Superintendent of Public Instruction,John Cox,DEM,210015,2,13,88,103,
Delaware,Superintendent of Public Instruction,Freda Deskin,DEM,210015,1,0,17,18,
Delaware,U.S. Senate,Connie Johnson,DEM,210015,2,8,43,53,
Delaware,U.S. Senate,Jim Rogers,DEM,210015,1,5,55,61,
Delaware,Superintendent of Public Instruction,John Cox,DEM,210016,8,24,118,150,
Delaware,Superintendent of Public Instruction,Freda Deskin,DEM,210016,1,1,16,18,
Delaware,U.S. Senate,Connie Johnson,DEM,210016,1,10,56,67,
Delaware,U.S. Senate,Jim Rogers,DEM,210016,7,13,73,93,
Delaware,Superintendent of Public Instruction,John Cox,DEM,210017,0,20,76,96,
Delaware,Superintendent of Public Instruction,Freda Deskin,DEM,210017,3,0,6,9,
Delaware,U.S. Senate,Connie Johnson,DEM,210017,2,8,27,37,
Delaware,U.S. Senate,Jim Rogers,DEM,210017,1,9,41,51,
Delaware,Superintendent of Public Instruction,John Cox,DEM,210018,0,11,65,76,
Delaware,Superintendent of Public Instruction,Freda Deskin,DEM,210018,0,1,10,11,
Delaware,U.S. Senate,Connie Johnson,DEM,210018,0,4,20,24,
Delaware,U.S. Senate,Jim Rogers,DEM,210018,0,4,51,55,
Delaware,Superintendent of Public Instruction,John Cox,DEM,210019,9,6,151,166,
Delaware,Superintendent of Public Instruction,Freda Deskin,DEM,210019,0,1,13,14,
Delaware,U.S. Senate,Connie Johnson,DEM,210019,5,0,60,65,
Delaware,U.S. Senate,Jim Rogers,DEM,210019,4,6,96,106,
Delaware,Superintendent of Public Instruction,John Cox,DEM,210020,0,0,33,33,
Delaware,Superintendent of Public Instruction,Freda Deskin,DEM,210020,0,0,1,1,
Delaware,U.S. Senate,Connie Johnson,DEM,210020,0,0,10,10,
Delaware,U.S. Senate,Jim Rogers,DEM,210020,0,0,23,23,
Delaware,Superintendent of Public Instruction,John Cox,DEM,210021,1,0,21,22,
Delaware,Superintendent of Public Instruction,Freda Deskin,DEM,210021,0,0,0,0,
Delaware,U.S. Senate,Connie Johnson,DEM,210021,0,0,7,7,
Delaware,U.S. Senate,Jim Rogers,DEM,210021,1,0,14,15,
Delaware,Superintendent of Public Instruction,John Cox,DEM,210022,4,3,135,142,
Delaware,Superintendent of Public Instruction,Freda Deskin,DEM,210022,2,0,10,12,
Delaware,U.S. Senate,Connie Johnson,DEM,210022,2,1,49,52,
Delaware,U.S. Senate,Jim Rogers,DEM,210022,4,2,95,101,
Delaware,Superintendent of Public Instruction,John Cox,DEM,210023,7,1,39,47,
Delaware,Superintendent of Public Instruction,Freda Deskin,DEM,210023,0,0,4,4,
Delaware,U.S. Senate,Connie Johnson,DEM,210023,3,1,8,12,
Delaware,U.S. Senate,Jim Rogers,DEM,210023,4,0,32,36,
Dewey,Superintendent of Public Instruction,John Cox,DEM,220001,0,0,22,22,
Dewey,Superintendent of Public Instruction,Freda Deskin,DEM,220001,2,1,8,11,
Dewey,U.S. Senate,Connie Johnson,DEM,220001,2,1,11,14,
Dewey,U.S. Senate,Jim Rogers,DEM,220001,0,0,19,19,
Dewey,Superintendent of Public Instruction,John Cox,DEM,220002,2,0,7,9,
Dewey,Superintendent of Public Instruction,Freda Deskin,DEM,220002,0,0,2,2,
Dewey,U.S. Senate,Connie Johnson,DEM,220002,2,0,3,5,
Dewey,U.S. Senate,Jim Rogers,DEM,220002,0,0,6,6,
Dewey,Superintendent of Public Instruction,John Cox,DEM,220003,1,0,24,25,
Dewey,Superintendent of Public Instruction,Freda Deskin,DEM,220003,0,0,6,6,
Dewey,U.S. Senate,Connie Johnson,DEM,220003,0,0,9,9,
Dewey,U.S. Senate,Jim Rogers,DEM,220003,1,0,21,22,
Dewey,Superintendent of Public Instruction,John Cox,DEM,220004,0,0,8,8,
Dewey,Superintendent of Public Instruction,Freda Deskin,DEM,220004,0,0,5,5,
Dewey,U.S. Senate,Connie Johnson,DEM,220004,0,0,7,7,
Dewey,U.S. Senate,Jim Rogers,DEM,220004,0,0,7,7,
Dewey,Superintendent of Public Instruction,John Cox,DEM,220005,1,0,18,19,
Dewey,Superintendent of Public Instruction,Freda Deskin,DEM,220005,1,0,8,9,
Dewey,U.S. Senate,Connie Johnson,DEM,220005,2,0,6,8,
Dewey,U.S. Senate,Jim Rogers,DEM,220005,0,0,20,20,
Dewey,Superintendent of Public Instruction,John Cox,DEM,220007,0,0,2,2,
Dewey,Superintendent of Public Instruction,Freda Deskin,DEM,220007,0,0,0,0,
Dewey,U.S. Senate,Connie Johnson,DEM,220007,0,0,1,1,
Dewey,U.S. Senate,Jim Rogers,DEM,220007,0,0,1,1,
Dewey,Superintendent of Public Instruction,John Cox,DEM,220008,4,0,18,22,
Dewey,Superintendent of Public Instruction,Freda Deskin,DEM,220008,1,0,4,5,
Dewey,U.S. Senate,Connie Johnson,DEM,220008,4,0,7,11,
Dewey,U.S. Senate,Jim Rogers,DEM,220008,1,0,15,16,
Dewey,Superintendent of Public Instruction,John Cox,DEM,220009,0,0,8,8,
Dewey,Superintendent of Public Instruction,Freda Deskin,DEM,220009,2,0,3,5,
Dewey,U.S. Senate,Connie Johnson,DEM,220009,2,0,6,8,
Dewey,U.S. Senate,Jim Rogers,DEM,220009,0,0,5,5,
Dewey,Superintendent of Public Instruction,John Cox,DEM,220010,0,0,7,7,
Dewey,Superintendent of Public Instruction,Freda Deskin,DEM,220010,0,0,4,4,
Dewey,U.S. Senate,Connie Johnson,DEM,220010,0,0,5,5,
Dewey,U.S. Senate,Jim Rogers,DEM,220010,0,0,6,6,
Ellis,Superintendent of Public Instruction,John Cox,DEM,230001,0,4,18,22,
Ellis,Superintendent of Public Instruction,Freda Deskin,DEM,230001,0,1,11,12,
Ellis,U.S. Senate,Connie Johnson,DEM,230001,0,2,17,19,
Ellis,U.S. Senate,Jim Rogers,DEM,230001,0,3,12,15,
Ellis,State House,Casey Murdock,REP,230001,2,7,30,39,61
Ellis,State House,Kenny Bob Tapp,REP,230001,7,7,24,38,61
Ellis,Superintendent of Public Instruction,John Cox,DEM,230003,1,0,22,23,
Ellis,Superintendent of Public Instruction,Freda Deskin,DEM,230003,1,0,8,9,
Ellis,U.S. Senate,Connie Johnson,DEM,230003,2,0,18,20,
Ellis,U.S. Senate,Jim Rogers,DEM,230003,0,0,12,12,
Ellis,State House,Casey Murdock,REP,230003,3,1,81,85,61
Ellis,State House,Kenny Bob Tapp,REP,230003,2,0,48,50,61
Ellis,Superintendent of Public Instruction,John Cox,DEM,230004,0,0,3,3,
Ellis,Superintendent of Public Instruction,Freda Deskin,DEM,230004,0,0,2,2,
Ellis,U.S. Senate,Connie Johnson,DEM,230004,0,0,3,3,
Ellis,U.S. Senate,Jim Rogers,DEM,230004,0,0,2,2,
Ellis,State House,Casey Murdock,REP,230004,0,0,11,11,61
Ellis,State House,Kenny Bob Tapp,REP,230004,0,0,12,12,61
Ellis,Superintendent of Public Instruction,John Cox,DEM,230006,0,0,0,0,
Ellis,Superintendent of Public Instruction,Freda Deskin,DEM,230006,4,0,0,4,
Ellis,U.S. Senate,Connie Johnson,DEM,230006,3,0,0,3,
Ellis,U.S. Senate,Jim Rogers,DEM,230006,1,0,0,1,
Ellis,State House,Casey Murdock,REP,230006,1,0,6,7,61
Ellis,State House,Kenny Bob Tapp,REP,230006,0,0,1,1,61
Ellis,Superintendent of Public Instruction,John Cox,DEM,230007,1,1,14,16,
Ellis,Superintendent of Public Instruction,Freda Deskin,DEM,230007,0,0,8,8,
Ellis,U.S. Senate,Connie Johnson,DEM,230007,0,1,9,10,
Ellis,U.S. Senate,Jim Rogers,DEM,230007,1,0,13,14,
Ellis,State House,Casey Murdock,REP,230007,0,3,38,41,61
Ellis,State House,Kenny Bob Tapp,REP,230007,0,1,27,28,61
Ellis,Superintendent of Public Instruction,John Cox,DEM,230008,0,0,8,8,
Ellis,Superintendent of Public Instruction,Freda Deskin,DEM,230008,0,0,3,3,
Ellis,U.S. Senate,Connie Johnson,DEM,230008,0,0,6,6,
Ellis,U.S. Senate,Jim Rogers,DEM,230008,0,0,3,3,
Ellis,State House,Casey Murdock,REP,230008,1,0,27,28,61
Ellis,State House,Kenny Bob Tapp,REP,230008,0,0,14,14,61
Ellis,Superintendent of Public Instruction,John Cox,DEM,230009,0,0,5,5,
Ellis,Superintendent of Public Instruction,Freda Deskin,DEM,230009,0,0,4,4,
Ellis,U.S. Senate,Connie Johnson,DEM,230009,0,0,6,6,
Ellis,U.S. Senate,Jim Rogers,DEM,230009,0,0,3,3,
Ellis,State House,Casey Murdock,REP,230009,0,0,6,6,61
Ellis,State House,Kenny Bob Tapp,REP,230009,0,1,6,7,61
Garfield,Superintendent of Public Instruction,John Cox,DEM,240101,0,0,6,6,
Garfield,Superintendent of Public Instruction,Freda Deskin,DEM,240101,0,0,2,2,
Garfield,U.S. Senate,Connie Johnson,DEM,240101,0,0,5,5,
Garfield,U.S. Senate,Jim Rogers,DEM,240101,0,0,3,3,
Garfield,Superintendent of Public Instruction,John Cox,DEM,240102,1,0,6,7,
Garfield,Superintendent of Public Instruction,Freda Deskin,DEM,240102,1,0,9,10,
Garfield,U.S. Senate,Connie Johnson,DEM,240102,0,0,15,15,
Garfield,U.S. Senate,Jim Rogers,DEM,240102,2,0,0,2,
Garfield,Superintendent of Public Instruction,John Cox,DEM,240103,3,0,10,13,
Garfield,Superintendent of Public Instruction,Freda Deskin,DEM,240103,1,1,9,11,
Garfield,U.S. Senate,Connie Johnson,DEM,240103,2,0,14,16,
Garfield,U.S. Senate,Jim Rogers,DEM,240103,2,0,5,7,
Garfield,Superintendent of Public Instruction,John Cox,DEM,240104,1,0,12,13,
Garfield,Superintendent of Public Instruction,Freda Deskin,DEM,240104,2,1,14,17,
Garfield,U.S. Senate,Connie Johnson,DEM,240104,3,1,15,19,
Garfield,U.S. Senate,Jim Rogers,DEM,240104,0,0,11,11,
Garfield,Superintendent of Public Instruction,John Cox,DEM,240105,0,0,7,7,
Garfield,Superintendent of Public Instruction,Freda Deskin,DEM,240105,1,1,7,9,
Garfield,U.S. Senate,Connie Johnson,DEM,240105,1,1,9,11,
Garfield,U.S. Senate,Jim Rogers,DEM,240105,0,0,4,4,
Garfield,Superintendent of Public Instruction,John Cox,DEM,240106,0,0,14,14,
Garfield,Superintendent of Public Instruction,Freda Deskin,DEM,240106,0,0,1,1,
Garfield,U.S. Senate,Connie Johnson,DEM,240106,0,0,7,7,
Garfield,U.S. Senate,Jim Rogers,DEM,240106,0,0,8,8,
Garfield,State House,John Pfeiffer,REP,240106,0,0,51,51,38
Garfield,State House,Harold Levalley,REP,240106,0,0,27,27,38
Garfield,Superintendent of Public Instruction,John Cox,DEM,240107,0,0,1,1,
Garfield,Superintendent of Public Instruction,Freda Deskin,DEM,240107,0,0,0,0,
Garfield,U.S. Senate,Connie Johnson,DEM,240107,0,0,1,1,
Garfield,U.S. Senate,Jim Rogers,DEM,240107,0,0,0,0,
Garfield,Superintendent of Public Instruction,John Cox,DEM,240108,0,1,2,3,
Garfield,Superintendent of Public Instruction,Freda Deskin,DEM,240108,0,0,0,0,
Garfield,U.S. Senate,Connie Johnson,DEM,240108,0,1,2,3,
Garfield,U.S. Senate,Jim Rogers,DEM,240108,0,0,0,0,
Garfield,State House,John Pfeiffer,REP,240108,0,1,17,18,38
Garfield,State House,Harold Levalley,REP,240108,0,0,0,0,38
Garfield,Superintendent of Public Instruction,John Cox,DEM,240109,1,0,12,13,
Garfield,Superintendent of Public Instruction,Freda Deskin,DEM,240109,1,2,11,14,
Garfield,U.S. Senate,Connie Johnson,DEM,240109,2,2,13,17,
Garfield,U.S. Senate,Jim Rogers,DEM,240109,0,0,9,9,
Garfield,State House,John Pfeiffer,REP,240109,1,2,40,43,38
Garfield,State House,Harold Levalley,REP,240109,0,0,18,18,38
Garfield,Superintendent of Public Instruction,John Cox,DEM,240110,0,0,8,8,
Garfield,Superintendent of Public Instruction,Freda Deskin,DEM,240110,1,0,12,13,
Garfield,U.S. Senate,Connie Johnson,DEM,240110,1,0,10,11,
Garfield,U.S. Senate,Jim Rogers,DEM,240110,0,0,10,10,
Garfield,Superintendent of Public Instruction,John Cox,DEM,240201,1,2,15,18,
Garfield,Superintendent of Public Instruction,Freda Deskin,DEM,240201,1,3,15,19,
Garfield,U.S. Senate,Connie Johnson,DEM,240201,1,6,21,28,
Garfield,U.S. Senate,Jim Rogers,DEM,240201,1,0,8,9,
Garfield,Superintendent of Public Instruction,John Cox,DEM,240202,5,3,21,29,
Garfield,Superintendent of Public Instruction,Freda Deskin,DEM,240202,5,2,22,29,
Garfield,U.S. Senate,Connie Johnson,DEM,240202,6,4,27,37,
Garfield,U.S. Senate,Jim Rogers,DEM,240202,4,1,15,20,
Garfield,Superintendent of Public Instruction,John Cox,DEM,240203,4,0,7,11,
Garfield,Superintendent of Public Instruction,Freda Deskin,DEM,240203,0,0,7,7,
Garfield,U.S. Senate,Connie Johnson,DEM,240203,2,1,14,17,
Garfield,U.S. Senate,Jim Rogers,DEM,240203,2,0,1,3,
Garfield,Superintendent of Public Instruction,John Cox,DEM,240204,0,1,23,24,
Garfield,Superintendent of Public Instruction,Freda Deskin,DEM,240204,0,2,15,17,
Garfield,U.S. Senate,Connie Johnson,DEM,240204,0,2,28,30,
Garfield,U.S. Senate,Jim Rogers,DEM,240204,0,1,10,11,
Garfield,Superintendent of Public Instruction,John Cox,DEM,240206,0,0,5,5,
Garfield,Superintendent of Public Instruction,Freda Deskin,DEM,240206,0,0,14,14,
Garfield,U.S. Senate,Connie Johnson,DEM,240206,0,0,11,11,
Garfield,U.S. Senate,Jim Rogers,DEM,240206,0,0,8,8,
Garfield,Superintendent of Public Instruction,John Cox,DEM,240207,0,0,7,7,
Garfield,Superintendent of Public Instruction,Freda Deskin,DEM,240207,0,1,8,9,
Garfield,U.S. Senate,Connie Johnson,DEM,240207,0,0,10,10,
Garfield,U.S. Senate,Jim Rogers,DEM,240207,0,1,5,6,
Garfield,Superintendent of Public Instruction,John Cox,DEM,240208,0,0,7,7,
Garfield,Superintendent of Public Instruction,Freda Deskin,DEM,240208,0,0,8,8,
Garfield,U.S. Senate,Connie Johnson,DEM,240208,0,0,10,10,
Garfield,U.S. Senate,Jim Rogers,DEM,240208,0,0,4,4,
Garfield,Superintendent of Public Instruction,John Cox,DEM,240210,0,0,50,50,
Garfield,Superintendent of Public Instruction,Freda Deskin,DEM,240210,0,0,26,26,
Garfield,U.S. Senate,Connie Johnson,DEM,240210,0,0,34,34,
Garfield,U.S. Senate,Jim Rogers,DEM,240210,0,0,41,41,
Garfield,State House,John Pfeiffer,REP,240210,0,0,89,89,38
Garfield,State House,Harold Levalley,REP,240210,2,0,48,50,38
Garfield,Superintendent of Public Instruction,John Cox,DEM,240211,0,3,48,51,
Garfield,Superintendent of Public Instruction,Freda Deskin,DEM,240211,0,0,24,24,
Garfield,U.S. Senate,Connie Johnson,DEM,240211,0,0,39,39,
Garfield,U.S. Senate,Jim Rogers,DEM,240211,0,2,34,36,
Garfield,State House,John Pfeiffer,REP,240211,4,0,141,145,38
Garfield,State House,Harold Levalley,REP,240211,0,0,57,57,38
Garfield,Superintendent of Public Instruction,John Cox,DEM,240212,2,2,15,19,
Garfield,Superintendent of Public Instruction,Freda Deskin,DEM,240212,1,0,3,4,
Garfield,U.S. Senate,Connie Johnson,DEM,240212,1,1,6,8,
Garfield,U.S. Senate,Jim Rogers,DEM,240212,2,1,12,15,
Garfield,State House,John Pfeiffer,REP,240212,0,0,41,41,38
Garfield,State House,Harold Levalley,REP,240212,2,0,37,39,38
Garfield,Superintendent of Public Instruction,John Cox,DEM,240301,0,1,9,10,
Garfield,Superintendent of Public Instruction,Freda Deskin,DEM,240301,0,2,7,9,
Garfield,U.S. Senate,Connie Johnson,DEM,240301,0,3,7,10,
Garfield,U.S. Senate,Jim Rogers,DEM,240301,0,0,9,9,
Garfield,Superintendent of Public Instruction,John Cox,DEM,240302,0,0,20,20,
Garfield,Superintendent of Public Instruction,Freda Deskin,DEM,240302,1,0,14,15,
Garfield,U.S. Senate,Connie Johnson,DEM,240302,1,0,22,23,
Garfield,U.S. Senate,Jim Rogers,DEM,240302,0,0,12,12,
Garfield,Superintendent of Public Instruction,John Cox,DEM,240304,0,1,18,19,
Garfield,Superintendent of Public Instruction,Freda Deskin,DEM,240304,2,0,11,13,
Garfield,U.S. Senate,Connie Johnson,DEM,240304,0,1,22,23,
Garfield,U.S. Senate,Jim Rogers,DEM,240304,2,0,8,10,
Garfield,Superintendent of Public Instruction,John Cox,DEM,240305,1,5,28,34,
Garfield,Superintendent of Public Instruction,Freda Deskin,DEM,240305,1,1,10,12,
Garfield,U.S. Senate,Connie Johnson,DEM,240305,2,4,24,30,
Garfield,U.S. Senate,Jim Rogers,DEM,240305,0,2,9,11,
Garfield,Superintendent of Public Instruction,John Cox,DEM,240306,3,0,5,8,
Garfield,Superintendent of Public Instruction,Freda Deskin,DEM,240306,1,1,4,6,
Garfield,U.S. Senate,Connie Johnson,DEM,240306,3,0,6,9,
Garfield,U.S. Senate,Jim Rogers,DEM,240306,1,1,3,5,
Garfield,Superintendent of Public Instruction,John Cox,DEM,240307,3,0,3,6,
Garfield,Superintendent of Public Instruction,Freda Deskin,DEM,240307,0,0,4,4,
Garfield,U.S. Senate,Connie Johnson,DEM,240307,3,0,4,7,
Garfield,U.S. Senate,Jim Rogers,DEM,240307,0,0,3,3,
Garfield,Superintendent of Public Instruction,John Cox,DEM,240308,0,0,7,7,
Garfield,Superintendent of Public Instruction,Freda Deskin,DEM,240308,1,2,6,9,
Garfield,U.S. Senate,Connie Johnson,DEM,240308,1,2,5,8,
Garfield,U.S. Senate,Jim Rogers,DEM,240308,0,0,8,8,
Garfield,Superintendent of Public Instruction,John Cox,DEM,240309,0,0,7,7,
Garfield,Superintendent of Public Instruction,Freda Deskin,DEM,240309,0,0,3,3,
Garfield,U.S. Senate,Connie Johnson,DEM,240309,0,0,8,8,
Garfield,U.S. Senate,Jim Rogers,DEM,240309,0,0,2,2,
Garfield,Superintendent of Public Instruction,John Cox,DEM,240310,2,0,12,14,
Garfield,Superintendent of Public Instruction,Freda Deskin,DEM,240310,0,0,7,7,
Garfield,U.S. Senate,Connie Johnson,DEM,240310,2,0,7,9,
Garfield,U.S. Senate,Jim Rogers,DEM,240310,0,0,12,12,
Garfield,Superintendent of Public Instruction,John Cox,DEM,240311,1,0,13,14,
Garfield,Superintendent of Public Instruction,Freda Deskin,DEM,240311,0,0,7,7,
Garfield,U.S. Senate,Connie Johnson,DEM,240311,1,0,10,11,
Garfield,U.S. Senate,Jim Rogers,DEM,240311,0,0,10,10,
Garvin,Superintendent of Public Instruction,John Cox,DEM,250001,0,0,16,16,
Garvin,Superintendent of Public Instruction,Freda Deskin,DEM,250001,2,0,9,11,
Garvin,U.S. Senate,Connie Johnson,DEM,250001,2,0,10,12,
Garvin,U.S. Senate,Jim Rogers,DEM,250001,0,0,15,15,
Garvin,Superintendent of Public Instruction,John Cox,DEM,250002,1,0,21,22,
Garvin,Superintendent of Public Instruction,Freda Deskin,DEM,250002,0,0,6,6,
Garvin,U.S. Senate,Connie Johnson,DEM,250002,1,0,11,12,
Garvin,U.S. Senate,Jim Rogers,DEM,250002,0,0,16,16,
Garvin,Superintendent of Public Instruction,John Cox,DEM,250003,0,1,12,13,
Garvin,Superintendent of Public Instruction,Freda Deskin,DEM,250003,0,0,6,6,
Garvin,U.S. Senate,Connie Johnson,DEM,250003,0,1,6,7,
Garvin,U.S. Senate,Jim Rogers,DEM,250003,0,0,10,10,
Garvin,Superintendent of Public Instruction,John Cox,DEM,250005,1,3,48,52,
Garvin,Superintendent of Public Instruction,Freda Deskin,DEM,250005,1,1,19,21,
Garvin,U.S. Senate,Connie Johnson,DEM,250005,0,3,21,24,
Garvin,U.S. Senate,Jim Rogers,DEM,250005,2,1,43,46,
Garvin,Superintendent of Public Instruction,John Cox,DEM,250006,0,1,15,16,
Garvin,Superintendent of Public Instruction,Freda Deskin,DEM,250006,0,0,25,25,
Garvin,U.S. Senate,Connie Johnson,DEM,250006,0,0,14,14,
Garvin,U.S. Senate,Jim Rogers,DEM,250006,0,1,23,24,
Garvin,Superintendent of Public Instruction,John Cox,DEM,250007,0,0,12,12,
Garvin,Superintendent of Public Instruction,Freda Deskin,DEM,250007,2,2,35,39,
Garvin,U.S. Senate,Connie Johnson,DEM,250007,2,0,18,20,
Garvin,U.S. Senate,Jim Rogers,DEM,250007,0,2,27,29,
Garvin,Superintendent of Public Instruction,John Cox,DEM,250008,0,3,16,19,
Garvin,Superintendent of Public Instruction,Freda Deskin,DEM,250008,0,1,28,29,
Garvin,U.S. Senate,Connie Johnson,DEM,250008,0,2,23,25,
Garvin,U.S. Senate,Jim Rogers,DEM,250008,0,2,21,23,
Garvin,Superintendent of Public Instruction,John Cox,DEM,250009,1,6,172,179,
Garvin,Superintendent of Public Instruction,Freda Deskin,DEM,250009,3,5,114,122,
Garvin,U.S. Senate,Connie Johnson,DEM,250009,3,6,139,148,
Garvin,U.S. Senate,Jim Rogers,DEM,250009,1,5,143,149,
Garvin,Superintendent of Public Instruction,John Cox,DEM,250013,0,1,39,40,
Garvin,Superintendent of Public Instruction,Freda Deskin,DEM,250013,0,0,30,30,
Garvin,U.S. Senate,Connie Johnson,DEM,250013,0,0,28,28,
Garvin,U.S. Senate,Jim Rogers,DEM,250013,0,1,42,43,
Garvin,Superintendent of Public Instruction,John Cox,DEM,250015,0,4,18,22,
Garvin,Superintendent of Public Instruction,Freda Deskin,DEM,250015,3,1,48,52,
Garvin,U.S. Senate,Connie Johnson,DEM,250015,3,3,39,45,
Garvin,U.S. Senate,Jim Rogers,DEM,250015,0,2,23,25,
Garvin,Superintendent of Public Instruction,John Cox,DEM,250016,0,3,30,33,
Garvin,Superintendent of Public Instruction,Freda Deskin,DEM,250016,0,6,30,36,
Garvin,U.S. Senate,Connie Johnson,DEM,250016,0,7,29,36,
Garvin,U.S. Senate,Jim Rogers,DEM,250016,0,2,31,33,
Garvin,Superintendent of Public Instruction,John Cox,DEM,250017,6,0,8,14,
Garvin,Superintendent of Public Instruction,Freda Deskin,DEM,250017,3,4,45,52,
Garvin,U.S. Senate,Connie Johnson,DEM,250017,6,3,33,42,
Garvin,U.S. Senate,Jim Rogers,DEM,250017,3,1,18,22,
Garvin,Superintendent of Public Instruction,John Cox,DEM,250018,8,1,28,37,
Garvin,Superintendent of Public Instruction,Freda Deskin,DEM,250018,2,11,50,63,
Garvin,U.S. Senate,Connie Johnson,DEM,250018,3,9,43,55,
Garvin,U.S. Senate,Jim Rogers,DEM,250018,6,3,33,42,
Garvin,Superintendent of Public Instruction,John Cox,DEM,250020,4,3,43,50,
Garvin,Superintendent of Public Instruction,Freda Deskin,DEM,250020,1,1,33,35,
Garvin,U.S. Senate,Connie Johnson,DEM,250020,2,3,37,42,
Garvin,U.S. Senate,Jim Rogers,DEM,250020,3,1,39,43,
Garvin,Superintendent of Public Instruction,John Cox,DEM,250021,0,0,0,0,
Garvin,Superintendent of Public Instruction,Freda Deskin,DEM,250021,0,0,0,0,
Garvin,U.S. Senate,Connie Johnson,DEM,250021,0,0,0,0,
Garvin,U.S. Senate,Jim Rogers,DEM,250021,0,0,0,0,
Garvin,Superintendent of Public Instruction,John Cox,DEM,250024,1,0,17,18,
Garvin,Superintendent of Public Instruction,Freda Deskin,DEM,250024,0,1,10,11,
Garvin,U.S. Senate,Connie Johnson,DEM,250024,0,0,8,8,
Garvin,U.S. Senate,Jim Rogers,DEM,250024,1,1,19,21,
Garvin,Superintendent of Public Instruction,John Cox,DEM,250025,0,2,13,15,
Garvin,Superintendent of Public Instruction,Freda Deskin,DEM,250025,7,0,15,22,
Garvin,U.S. Senate,Connie Johnson,DEM,250025,5,1,11,17,
Garvin,U.S. Senate,Jim Rogers,DEM,250025,2,1,19,22,
Grady,Superintendent of Public Instruction,John Cox,DEM,260001,0,1,17,18,
Grady,Superintendent of Public Instruction,Freda Deskin,DEM,260001,2,0,12,14,
Grady,U.S. Senate,Connie Johnson,DEM,260001,2,0,17,19,
Grady,U.S. Senate,Jim Rogers,DEM,260001,0,1,11,12,
Grady,Superintendent of Public Instruction,John Cox,DEM,260002,1,3,28,32,
Grady,Superintendent of Public Instruction,Freda Deskin,DEM,260002,0,2,12,14,
Grady,U.S. Senate,Connie Johnson,DEM,260002,1,3,17,21,
Grady,U.S. Senate,Jim Rogers,DEM,260002,0,2,20,22,
Grady,Superintendent of Public Instruction,John Cox,DEM,260003,1,1,19,21,
Grady,Superintendent of Public Instruction,Freda Deskin,DEM,260003,0,0,15,15,
Grady,U.S. Senate,Connie Johnson,DEM,260003,1,0,14,15,
Grady,U.S. Senate,Jim Rogers,DEM,260003,0,1,20,21,
Grady,Superintendent of Public Instruction,John Cox,DEM,260005,2,2,16,20,
Grady,Superintendent of Public Instruction,Freda Deskin,DEM,260005,2,1,12,15,
Grady,U.S. Senate,Connie Johnson,DEM,260005,4,3,23,30,
Grady,U.S. Senate,Jim Rogers,DEM,260005,0,0,5,5,
Grady,Superintendent of Public Instruction,John Cox,DEM,260006,1,0,16,17,
Grady,Superintendent of Public Instruction,Freda Deskin,DEM,260006,2,0,19,21,
Grady,U.S. Senate,Connie Johnson,DEM,260006,2,0,19,21,
Grady,U.S. Senate,Jim Rogers,DEM,260006,1,0,16,17,
Grady,Superintendent of Public Instruction,John Cox,DEM,260008,0,0,12,12,
Grady,Superintendent of Public Instruction,Freda Deskin,DEM,260008,2,0,10,12,
Grady,U.S. Senate,Connie Johnson,DEM,260008,1,0,17,18,
Grady,U.S. Senate,Jim Rogers,DEM,260008,1,0,5,6,
Grady,Superintendent of Public Instruction,John Cox,DEM,260009,1,5,31,37,
Grady,Superintendent of Public Instruction,Freda Deskin,DEM,260009,3,3,22,28,
Grady,U.S. Senate,Connie Johnson,DEM,260009,1,4,31,36,
Grady,U.S. Senate,Jim Rogers,DEM,260009,3,4,22,29,
Grady,Superintendent of Public Instruction,John Cox,DEM,260011,1,0,16,17,
Grady,Superintendent of Public Instruction,Freda Deskin,DEM,260011,0,0,1,1,
Grady,U.S. Senate,Connie Johnson,DEM,260011,0,0,6,6,
Grady,U.S. Senate,Jim Rogers,DEM,260011,1,0,11,12,
Grady,Superintendent of Public Instruction,John Cox,DEM,260016,0,2,16,18,
Grady,Superintendent of Public Instruction,Freda Deskin,DEM,260016,3,0,9,12,
Grady,U.S. Senate,Connie Johnson,DEM,260016,3,2,7,12,
Grady,U.S. Senate,Jim Rogers,DEM,260016,0,0,16,16,
Grady,Superintendent of Public Instruction,John Cox,DEM,260017,1,0,12,13,
Grady,Superintendent of Public Instruction,Freda Deskin,DEM,260017,0,0,6,6,
Grady,U.S. Senate,Connie Johnson,DEM,260017,0,0,7,7,
Grady,U.S. Senate,Jim Rogers,DEM,260017,1,0,10,11,
Grady,Superintendent of Public Instruction,John Cox,DEM,260020,1,0,31,32,
Grady,Superintendent of Public Instruction,Freda Deskin,DEM,260020,2,0,19,21,
Grady,U.S. Senate,Connie Johnson,DEM,260020,0,0,16,16,
Grady,U.S. Senate,Jim Rogers,DEM,260020,3,0,33,36,
Grady,Superintendent of Public Instruction,John Cox,DEM,260021,0,0,12,12,
Grady,Superintendent of Public Instruction,Freda Deskin,DEM,260021,0,0,9,9,
Grady,U.S. Senate,Connie Johnson,DEM,260021,0,0,11,11,
Grady,U.S. Senate,Jim Rogers,DEM,260021,0,0,10,10,
Grady,Superintendent of Public Instruction,John Cox,DEM,260023,0,0,6,6,
Grady,Superintendent of Public Instruction,Freda Deskin,DEM,260023,0,0,4,4,
Grady,U.S. Senate,Connie Johnson,DEM,260023,0,0,4,4,
Grady,U.S. Senate,Jim Rogers,DEM,260023,0,0,6,6,
Grady,Superintendent of Public Instruction,John Cox,DEM,260025,0,0,15,15,
Grady,Superintendent of Public Instruction,Freda Deskin,DEM,260025,0,1,7,8,
Grady,U.S. Senate,Connie Johnson,DEM,260025,0,0,9,9,
Grady,U.S. Senate,Jim Rogers,DEM,260025,0,1,12,13,
Grady,Superintendent of Public Instruction,John Cox,DEM,260026,2,0,12,14,
Grady,Superintendent of Public Instruction,Freda Deskin,DEM,260026,0,0,7,7,
Grady,U.S. Senate,Connie Johnson,DEM,260026,0,0,7,7,
Grady,U.S. Senate,Jim Rogers,DEM,260026,2,0,12,14,
Grady,Superintendent of Public Instruction,John Cox,DEM,260027,0,0,15,15,
Grady,Superintendent of Public Instruction,Freda Deskin,DEM,260027,0,1,7,8,
Grady,U.S. Senate,Connie Johnson,DEM,260027,0,1,11,12,
Grady,U.S. Senate,Jim Rogers,DEM,260027,0,0,10,10,
Grady,Superintendent of Public Instruction,John Cox,DEM,260028,5,0,28,33,
Grady,Superintendent of Public Instruction,Freda Deskin,DEM,260028,1,1,3,5,
Grady,U.S. Senate,Connie Johnson,DEM,260028,5,0,10,15,
Grady,U.S. Senate,Jim Rogers,DEM,260028,1,1,19,21,
Grady,Superintendent of Public Instruction,John Cox,DEM,260029,1,0,47,48,
Grady,Superintendent of Public Instruction,Freda Deskin,DEM,260029,0,1,17,18,
Grady,U.S. Senate,Connie Johnson,DEM,260029,0,1,32,33,
Grady,U.S. Senate,Jim Rogers,DEM,260029,1,0,32,33,
Grady,Superintendent of Public Instruction,John Cox,DEM,260031,0,0,15,15,
Grady,Superintendent of Public Instruction,Freda Deskin,DEM,260031,1,0,17,18,
Grady,U.S. Senate,Connie Johnson,DEM,260031,1,0,14,15,
Grady,U.S. Senate,Jim Rogers,DEM,260031,0,0,17,17,
Grady,Superintendent of Public Instruction,John Cox,DEM,260032,0,1,25,26,
Grady,Superintendent of Public Instruction,Freda Deskin,DEM,260032,2,0,16,18,
Grady,U.S. Senate,Connie Johnson,DEM,260032,0,1,22,23,
Grady,U.S. Senate,Jim Rogers,DEM,260032,2,0,17,19,
Grady,Superintendent of Public Instruction,John Cox,DEM,260033,0,0,12,12,
Grady,Superintendent of Public Instruction,Freda Deskin,DEM,260033,0,0,3,3,
Grady,U.S. Senate,Connie Johnson,DEM,260033,0,0,3,3,
Grady,U.S. Senate,Jim Rogers,DEM,260033,0,0,12,12,
Grady,Superintendent of Public Instruction,John Cox,DEM,260035,0,0,2,2,
Grady,Superintendent of Public Instruction,Freda Deskin,DEM,260035,0,0,3,3,
Grady,U.S. Senate,Connie Johnson,DEM,260035,0,0,1,1,
Grady,U.S. Senate,Jim Rogers,DEM,260035,0,0,3,3,
Grady,Superintendent of Public Instruction,John Cox,DEM,260036,3,2,245,250,
Grady,Superintendent of Public Instruction,Freda Deskin,DEM,260036,3,2,116,121,
Grady,U.S. Senate,Connie Johnson,DEM,260036,2,0,165,167,
Grady,U.S. Senate,Jim Rogers,DEM,260036,4,4,198,206,
Grady,State House,Scott Hayes,REP,260036,2,2,80,84,65
Grady,State House,Scooter Park,REP,260036,2,0,69,71,65
Grady,Superintendent of Public Instruction,John Cox,DEM,260037,7,0,46,53,
Grady,Superintendent of Public Instruction,Freda Deskin,DEM,260037,7,0,21,28,
Grady,U.S. Senate,Connie Johnson,DEM,260037,8,0,29,37,
Grady,U.S. Senate,Jim Rogers,DEM,260037,6,0,38,44,
Grady,Superintendent of Public Instruction,John Cox,DEM,260038,4,0,51,55,
Grady,Superintendent of Public Instruction,Freda Deskin,DEM,260038,6,1,60,67,
Grady,U.S. Senate,Connie Johnson,DEM,260038,4,1,43,48,
Grady,U.S. Senate,Jim Rogers,DEM,260038,6,0,66,72,
Grady,Superintendent of Public Instruction,John Cox,DEM,260039,1,0,27,28,
Grady,Superintendent of Public Instruction,Freda Deskin,DEM,260039,1,0,15,16,
Grady,U.S. Senate,Connie Johnson,DEM,260039,0,0,18,18,
Grady,U.S. Senate,Jim Rogers,DEM,260039,2,0,20,22,
Grady,Superintendent of Public Instruction,John Cox,DEM,260040,1,1,31,33,
Grady,Superintendent of Public Instruction,Freda Deskin,DEM,260040,6,0,7,13,
Grady,U.S. Senate,Connie Johnson,DEM,260040,4,0,18,22,
Grady,U.S. Senate,Jim Rogers,DEM,260040,3,1,18,22,
Grady,Superintendent of Public Instruction,John Cox,DEM,260041,2,0,19,21,
Grady,Superintendent of Public Instruction,Freda Deskin,DEM,260041,1,0,16,17,
Grady,U.S. Senate,Connie Johnson,DEM,260041,0,0,20,20,
Grady,U.S. Senate,Jim Rogers,DEM,260041,3,0,15,18,
Grant,Superintendent of Public Instruction,John Cox,DEM,270011,0,0,10,10,
Grant,Superintendent of Public Instruction,Freda Deskin,DEM,270011,0,0,4,4,
Grant,U.S. Senate,Connie Johnson,DEM,270011,0,0,6,6,
Grant,U.S. Senate,Jim Rogers,DEM,270011,0,0,8,8,
Grant,State House,John Pfeiffer,REP,270011,2,0,14,16,38
Grant,State House,Harold Levalley,REP,270011,0,1,16,17,38
Grant,Superintendent of Public Instruction,John Cox,DEM,270017,2,0,6,8,
Grant,Superintendent of Public Instruction,Freda Deskin,DEM,270017,0,0,4,4,
Grant,U.S. Senate,Connie Johnson,DEM,270017,2,0,4,6,
Grant,U.S. Senate,Jim Rogers,DEM,270017,0,0,6,6,
Grant,State House,John Pfeiffer,REP,270017,4,0,29,33,38
Grant,State House,Harold Levalley,REP,270017,2,0,29,31,38
Grant,Superintendent of Public Instruction,John Cox,DEM,270023,1,1,20,22,
Grant,Superintendent of Public Instruction,Freda Deskin,DEM,270023,1,1,11,13,
Grant,U.S. Senate,Connie Johnson,DEM,270023,1,1,15,17,
Grant,U.S. Senate,Jim Rogers,DEM,270023,1,1,16,18,
Grant,State House,John Pfeiffer,REP,270023,1,0,42,43,38
Grant,State House,Harold Levalley,REP,270023,1,2,36,39,38
Grant,Superintendent of Public Instruction,John Cox,DEM,270025,4,1,12,17,
Grant,Superintendent of Public Instruction,Freda Deskin,DEM,270025,4,0,9,13,
Grant,U.S. Senate,Connie Johnson,DEM,270025,6,0,13,19,
Grant,U.S. Senate,Jim Rogers,DEM,270025,2,1,8,11,
Grant,State House,John Pfeiffer,REP,270025,2,1,27,30,38
Grant,State House,Harold Levalley,REP,270025,3,0,25,28,38
Grant,Superintendent of Public Instruction,John Cox,DEM,270026,1,0,7,8,
Grant,Superintendent of Public Instruction,Freda Deskin,DEM,270026,0,0,4,4,
Grant,U.S. Senate,Connie Johnson,DEM,270026,0,0,5,5,
Grant,U.S. Senate,Jim Rogers,DEM,270026,1,0,6,7,
Grant,State House,John Pfeiffer,REP,270026,1,1,26,28,38
Grant,State House,Harold Levalley,REP,270026,0,0,13,13,38
Grant,Superintendent of Public Instruction,John Cox,DEM,270029,0,1,5,6,
Grant,Superintendent of Public Instruction,Freda Deskin,DEM,270029,0,4,2,6,
Grant,U.S. Senate,Connie Johnson,DEM,270029,0,2,6,8,
Grant,U.S. Senate,Jim Rogers,DEM,270029,0,3,1,4,
Grant,State House,John Pfeiffer,REP,270029,0,3,20,23,38
Grant,State House,Harold Levalley,REP,270029,1,3,10,14,38
Grant,Superintendent of Public Instruction,John Cox,DEM,270030,3,2,15,20,
Grant,Superintendent of Public Instruction,Freda Deskin,DEM,270030,1,1,11,13,
Grant,U.S. Senate,Connie Johnson,DEM,270030,4,2,12,18,
Grant,U.S. Senate,Jim Rogers,DEM,270030,0,1,13,14,
Grant,State House,John Pfeiffer,REP,270030,0,4,43,47,38
Grant,State House,Harold Levalley,REP,270030,1,4,19,24,38
Greer,Superintendent of Public Instruction,John Cox,DEM,280101,8,15,94,117,
Greer,Superintendent of Public Instruction,Freda Deskin,DEM,280101,2,9,51,62,
Greer,U.S. Senate,Connie Johnson,DEM,280101,2,9,56,67,
Greer,U.S. Senate,Jim Rogers,DEM,280101,8,16,81,105,
Greer,Superintendent of Public Instruction,John Cox,DEM,280102,0,5,39,44,
Greer,Superintendent of Public Instruction,Freda Deskin,DEM,280102,0,4,26,30,
Greer,U.S. Senate,Connie Johnson,DEM,280102,0,7,28,35,
Greer,U.S. Senate,Jim Rogers,DEM,280102,0,2,37,39,
Greer,Superintendent of Public Instruction,John Cox,DEM,280103,0,1,3,4,
Greer,Superintendent of Public Instruction,Freda Deskin,DEM,280103,0,1,2,3,
Greer,U.S. Senate,Connie Johnson,DEM,280103,0,1,1,2,
Greer,U.S. Senate,Jim Rogers,DEM,280103,0,1,4,5,
Greer,Superintendent of Public Instruction,John Cox,DEM,280105,0,4,28,32,
Greer,Superintendent of Public Instruction,Freda Deskin,DEM,280105,0,0,19,19,
Greer,U.S. Senate,Connie Johnson,DEM,280105,0,1,13,14,
Greer,U.S. Senate,Jim Rogers,DEM,280105,0,3,32,35,
Greer,Superintendent of Public Instruction,John Cox,DEM,280106,0,1,24,25,
Greer,Superintendent of Public Instruction,Freda Deskin,DEM,280106,0,0,7,7,
Greer,U.S. Senate,Connie Johnson,DEM,280106,0,0,9,9,
Greer,U.S. Senate,Jim Rogers,DEM,280106,0,1,22,23,
Greer,Superintendent of Public Instruction,John Cox,DEM,280202,0,0,52,52,
Greer,Superintendent of Public Instruction,Freda Deskin,DEM,280202,0,2,12,14,
Greer,U.S. Senate,Connie Johnson,DEM,280202,0,1,27,28,
Greer,U.S. Senate,Jim Rogers,DEM,280202,0,1,34,35,
Greer,Superintendent of Public Instruction,John Cox,DEM,280203,1,0,18,19,
Greer,Superintendent of Public Instruction,Freda Deskin,DEM,280203,2,0,14,16,
Greer,U.S. Senate,Connie Johnson,DEM,280203,0,0,9,9,
Greer,U.S. Senate,Jim Rogers,DEM,280203,3,0,21,24,
Greer,Superintendent of Public Instruction,John Cox,DEM,280302,0,1,5,6,
Greer,Superintendent of Public Instruction,Freda Deskin,DEM,280302,0,0,3,3,
Greer,U.S. Senate,Connie Johnson,DEM,280302,0,0,6,6,
Greer,U.S. Senate,Jim Rogers,DEM,280302,0,1,2,3,
Harmon,Superintendent of Public Instruction,John Cox,DEM,290101,0,2,11,13,
Harmon,Superintendent of Public Instruction,Freda Deskin,DEM,290101,0,0,3,3,
Harmon,U.S. Senate,Connie Johnson,DEM,290101,0,0,3,3,
Harmon,U.S. Senate,Jim Rogers,DEM,290101,0,1,11,12,
Harmon,Superintendent of Public Instruction,John Cox,DEM,290102,2,5,14,21,
Harmon,Superintendent of Public Instruction,Freda Deskin,DEM,290102,0,1,3,4,
Harmon,U.S. Senate,Connie Johnson,DEM,290102,0,1,5,6,
Harmon,U.S. Senate,Jim Rogers,DEM,290102,2,4,9,15,
Harmon,Superintendent of Public Instruction,John Cox,DEM,290201,0,0,8,8,
Harmon,Superintendent of Public Instruction,Freda Deskin,DEM,290201,0,0,1,1,
Harmon,U.S. Senate,Connie Johnson,DEM,290201,0,0,6,6,
Harmon,U.S. Senate,Jim Rogers,DEM,290201,0,0,4,4,
Harmon,Superintendent of Public Instruction,John Cox,DEM,290203,0,0,2,2,
Harmon,Superintendent of Public Instruction,Freda Deskin,DEM,290203,0,0,0,0,
Harmon,U.S. Senate,Connie Johnson,DEM,290203,0,0,2,2,
Harmon,U.S. Senate,Jim Rogers,DEM,290203,0,0,0,0,
Harmon,Superintendent of Public Instruction,John Cox,DEM,290204,0,0,1,1,
Harmon,Superintendent of Public Instruction,Freda Deskin,DEM,290204,0,0,0,0,
Harmon,U.S. Senate,Connie Johnson,DEM,290204,0,0,1,1,
Harmon,U.S. Senate,Jim Rogers,DEM,290204,0,0,0,0,
Harmon,Superintendent of Public Instruction,John Cox,DEM,290301,0,0,2,2,
Harmon,Superintendent of Public Instruction,Freda Deskin,DEM,290301,1,0,0,1,
Harmon,U.S. Senate,Connie Johnson,DEM,290301,1,0,0,1,
Harmon,U.S. Senate,Jim Rogers,DEM,290301,0,0,2,2,
Harmon,Superintendent of Public Instruction,John Cox,DEM,290302,0,0,13,13,
Harmon,Superintendent of Public Instruction,Freda Deskin,DEM,290302,0,0,2,2,
Harmon,U.S. Senate,Connie Johnson,DEM,290302,0,0,7,7,
Harmon,U.S. Senate,Jim Rogers,DEM,290302,0,0,6,6,
Harper,Superintendent of Public Instruction,John Cox,DEM,300201,3,0,38,41,
Harper,Superintendent of Public Instruction,Freda Deskin,DEM,300201,1,0,11,12,
Harper,U.S. Senate,Connie Johnson,DEM,300201,2,0,19,21,
Harper,U.S. Senate,Jim Rogers,DEM,300201,1,0,29,30,
Harper,State House,Casey Murdock,REP,300201,2,0,53,55,61
Harper,State House,Kenny Bob Tapp,REP,300201,1,1,48,50,61
Harper,Superintendent of Public Instruction,John Cox,DEM,300203,0,0,4,4,
Harper,Superintendent of Public Instruction,Freda Deskin,DEM,300203,0,1,2,3,
Harper,U.S. Senate,Connie Johnson,DEM,300203,0,0,3,3,
Harper,U.S. Senate,Jim Rogers,DEM,300203,0,1,3,4,
Harper,State House,Casey Murdock,REP,300203,0,1,17,18,61
Harper,State House,Kenny Bob Tapp,REP,300203,0,0,6,6,61
Harper,Superintendent of Public Instruction,John Cox,DEM,300301,0,3,19,22,
Harper,Superintendent of Public Instruction,Freda Deskin,DEM,300301,0,1,2,3,
Harper,U.S. Senate,Connie Johnson,DEM,300301,0,1,5,6,
Harper,U.S. Senate,Jim Rogers,DEM,300301,0,3,16,19,
Harper,State House,Casey Murdock,REP,300301,0,1,26,27,61
Harper,State House,Kenny Bob Tapp,REP,300301,1,1,18,20,61
Harper,Superintendent of Public Instruction,John Cox,DEM,300302,0,0,1,1,
Harper,Superintendent of Public Instruction,Freda Deskin,DEM,300302,0,0,1,1,
Harper,U.S. Senate,Connie Johnson,DEM,300302,0,0,1,1,
Harper,U.S. Senate,Jim Rogers,DEM,300302,0,0,1,1,
Harper,State House,Casey Murdock,REP,300302,0,0,11,11,61
Harper,State House,Kenny Bob Tapp,REP,300302,0,0,7,7,61
Harper,Superintendent of Public Instruction,John Cox,DEM,300303,0,0,11,11,
Harper,Superintendent of Public Instruction,Freda Deskin,DEM,300303,0,0,2,2,
Harper,U.S. Senate,Connie Johnson,DEM,300303,0,0,8,8,
Harper,U.S. Senate,Jim Rogers,DEM,300303,0,0,5,5,
Harper,State House,Casey Murdock,REP,300303,1,0,6,7,61
Harper,State House,Kenny Bob Tapp,REP,300303,1,0,14,15,61
Harper,Superintendent of Public Instruction,John Cox,DEM,300402,0,4,14,18,
Harper,Superintendent of Public Instruction,Freda Deskin,DEM,300402,1,0,5,6,
Harper,U.S. Senate,Connie Johnson,DEM,300402,1,0,6,7,
Harper,U.S. Senate,Jim Rogers,DEM,300402,0,4,13,17,
Harper,State House,Casey Murdock,REP,300402,2,6,36,44,61
Harper,State House,Kenny Bob Tapp,REP,300402,3,1,23,27,61
Haskell,Superintendent of Public Instruction,John Cox,DEM,310007,0,0,33,33,
Haskell,Superintendent of Public Instruction,Freda Deskin,DEM,310007,0,0,1,1,
Haskell,U.S. Senate,Connie Johnson,DEM,310007,0,0,7,7,
Haskell,U.S. Senate,Jim Rogers,DEM,310007,0,0,25,25,
Haskell,Superintendent of Public Instruction,John Cox,DEM,310009,1,1,23,25,
Haskell,Superintendent of Public Instruction,Freda Deskin,DEM,310009,0,0,2,2,
Haskell,U.S. Senate,Connie Johnson,DEM,310009,0,1,8,9,
Haskell,U.S. Senate,Jim Rogers,DEM,310009,1,0,15,16,
Haskell,Superintendent of Public Instruction,John Cox,DEM,310011,0,1,4,5,
Haskell,Superintendent of Public Instruction,Freda Deskin,DEM,310011,0,0,4,4,
Haskell,U.S. Senate,Connie Johnson,DEM,310011,0,1,2,3,
Haskell,U.S. Senate,Jim Rogers,DEM,310011,0,0,6,6,
Haskell,Superintendent of Public Instruction,John Cox,DEM,310015,0,7,23,30,
Haskell,Superintendent of Public Instruction,Freda Deskin,DEM,310015,1,0,4,5,
Haskell,U.S. Senate,Connie Johnson,DEM,310015,0,1,4,5,
Haskell,U.S. Senate,Jim Rogers,DEM,310015,1,5,23,29,
Haskell,Superintendent of Public Instruction,John Cox,DEM,310016,2,5,26,33,
Haskell,Superintendent of Public Instruction,Freda Deskin,DEM,310016,0,3,4,7,
Haskell,U.S. Senate,Connie Johnson,DEM,310016,0,6,12,18,
Haskell,U.S. Senate,Jim Rogers,DEM,310016,2,2,18,22,
Haskell,Superintendent of Public Instruction,John Cox,DEM,310019,3,7,63,73,
Haskell,Superintendent of Public Instruction,Freda Deskin,DEM,310019,0,2,1,3,
Haskell,U.S. Senate,Connie Johnson,DEM,310019,2,4,15,21,
Haskell,U.S. Senate,Jim Rogers,DEM,310019,1,5,47,53,
Haskell,Superintendent of Public Instruction,John Cox,DEM,310023,2,2,66,70,
Haskell,Superintendent of Public Instruction,Freda Deskin,DEM,310023,1,0,15,16,
Haskell,U.S. Senate,Connie Johnson,DEM,310023,1,2,27,30,
Haskell,U.S. Senate,Jim Rogers,DEM,310023,2,0,50,52,
Haskell,Superintendent of Public Instruction,John Cox,DEM,310027,2,9,53,64,
Haskell,Superintendent of Public Instruction,Freda Deskin,DEM,310027,1,1,2,4,
Haskell,U.S. Senate,Connie Johnson,DEM,310027,2,6,14,22,
Haskell,U.S. Senate,Jim Rogers,DEM,310027,1,4,37,42,
Haskell,Superintendent of Public Instruction,John Cox,DEM,310030,2,0,44,46,
Haskell,Superintendent of Public Instruction,Freda Deskin,DEM,310030,0,1,4,5,
Haskell,U.S. Senate,Connie Johnson,DEM,310030,0,1,14,15,
Haskell,U.S. Senate,Jim Rogers,DEM,310030,2,0,34,36,
Haskell,Superintendent of Public Instruction,John Cox,DEM,310031,6,3,52,61,
Haskell,Superintendent of Public Instruction,Freda Deskin,DEM,310031,3,0,11,14,
Haskell,U.S. Senate,Connie Johnson,DEM,310031,8,2,16,26,
Haskell,U.S. Senate,Jim Rogers,DEM,310031,1,1,46,48,
Haskell,Superintendent of Public Instruction,John Cox,DEM,310032,1,7,95,103,
Haskell,Superintendent of Public Instruction,Freda Deskin,DEM,310032,0,0,19,19,
Haskell,U.S. Senate,Connie Johnson,DEM,310032,0,4,29,33,
Haskell,U.S. Senate,Jim Rogers,DEM,310032,1,3,83,87,
Hughes,Superintendent of Public Instruction,John Cox,DEM,320010,0,0,0,0,
Hughes,Superintendent of Public Instruction,Freda Deskin,DEM,320010,0,0,0,0,
Hughes,U.S. Senate,Connie Johnson,DEM,320010,0,0,0,0,
Hughes,U.S. Senate,Jim Rogers,DEM,320010,0,0,0,0,
Hughes,Superintendent of Public Instruction,John Cox,DEM,320011,5,6,73,84,
Hughes,Superintendent of Public Instruction,Freda Deskin,DEM,320011,6,9,45,60,
Hughes,U.S. Senate,Connie Johnson,DEM,320011,6,7,61,74,
Hughes,U.S. Senate,Jim Rogers,DEM,320011,5,8,56,69,
Hughes,Superintendent of Public Instruction,John Cox,DEM,320012,7,6,56,69,
Hughes,Superintendent of Public Instruction,Freda Deskin,DEM,320012,6,2,28,36,
Hughes,U.S. Senate,Connie Johnson,DEM,320012,7,3,29,39,
Hughes,U.S. Senate,Jim Rogers,DEM,320012,6,5,53,64,
Hughes,Superintendent of Public Instruction,John Cox,DEM,320016,1,2,23,26,
Hughes,Superintendent of Public Instruction,Freda Deskin,DEM,320016,1,1,11,13,
Hughes,U.S. Senate,Connie Johnson,DEM,320016,2,1,15,18,
Hughes,U.S. Senate,Jim Rogers,DEM,320016,0,2,20,22,
Hughes,Superintendent of Public Instruction,John Cox,DEM,320018,0,4,48,52,
Hughes,Superintendent of Public Instruction,Freda Deskin,DEM,320018,1,0,20,21,
Hughes,U.S. Senate,Connie Johnson,DEM,320018,1,0,25,26,
Hughes,U.S. Senate,Jim Rogers,DEM,320018,0,5,41,46,
Hughes,Superintendent of Public Instruction,John Cox,DEM,320019,0,0,20,20,
Hughes,Superintendent of Public Instruction,Freda Deskin,DEM,320019,0,1,11,12,
Hughes,U.S. Senate,Connie Johnson,DEM,320019,0,1,18,19,
Hughes,U.S. Senate,Jim Rogers,DEM,320019,0,0,13,13,
Hughes,Superintendent of Public Instruction,John Cox,DEM,320020,1,2,43,46,
Hughes,Superintendent of Public Instruction,Freda Deskin,DEM,320020,0,0,11,11,
Hughes,U.S. Senate,Connie Johnson,DEM,320020,0,2,27,29,
Hughes,U.S. Senate,Jim Rogers,DEM,320020,0,0,26,26,
Hughes,Superintendent of Public Instruction,John Cox,DEM,320021,0,4,34,38,
Hughes,Superintendent of Public Instruction,Freda Deskin,DEM,320021,5,1,18,24,
Hughes,U.S. Senate,Connie Johnson,DEM,320021,5,4,23,32,
Hughes,U.S. Senate,Jim Rogers,DEM,320021,0,1,29,30,
Hughes,Superintendent of Public Instruction,John Cox,DEM,320022,0,0,27,27,
Hughes,Superintendent of Public Instruction,Freda Deskin,DEM,320022,0,0,6,6,
Hughes,U.S. Senate,Connie Johnson,DEM,320022,0,0,22,22,
Hughes,U.S. Senate,Jim Rogers,DEM,320022,0,0,10,10,
Hughes,Superintendent of Public Instruction,John Cox,DEM,320023,0,0,15,15,
Hughes,Superintendent of Public Instruction,Freda Deskin,DEM,320023,0,0,1,1,
Hughes,U.S. Senate,Connie Johnson,DEM,320023,0,0,3,3,
Hughes,U.S. Senate,Jim Rogers,DEM,320023,0,0,12,12,
Hughes,Superintendent of Public Instruction,John Cox,DEM,320030,0,0,14,14,
Hughes,Superintendent of Public Instruction,Freda Deskin,DEM,320030,0,0,11,11,
Hughes,U.S. Senate,Connie Johnson,DEM,320030,0,0,16,16,
Hughes,U.S. Senate,Jim Rogers,DEM,320030,0,0,9,9,
Hughes,Superintendent of Public Instruction,John Cox,DEM,320031,0,0,29,29,
Hughes,Superintendent of Public Instruction,Freda Deskin,DEM,320031,0,0,13,13,
Hughes,U.S. Senate,Connie Johnson,DEM,320031,0,0,12,12,
Hughes,U.S. Senate,Jim Rogers,DEM,320031,0,0,30,30,
Hughes,Superintendent of Public Instruction,John Cox,DEM,320032,0,0,39,39,
Hughes,Superintendent of Public Instruction,Freda Deskin,DEM,320032,3,0,3,6,
Hughes,U.S. Senate,Connie Johnson,DEM,320032,1,0,19,20,
Hughes,U.S. Senate,Jim Rogers,DEM,320032,2,0,23,25,
Hughes,Superintendent of Public Instruction,John Cox,DEM,320033,0,1,12,13,
Hughes,Superintendent of Public Instruction,Freda Deskin,DEM,320033,2,0,6,8,
Hughes,U.S. Senate,Connie Johnson,DEM,320033,2,0,5,7,
Hughes,U.S. Senate,Jim Rogers,DEM,320033,0,1,13,14,
Hughes,Superintendent of Public Instruction,John Cox,DEM,320034,0,0,9,9,
Hughes,Superintendent of Public Instruction,Freda Deskin,DEM,320034,0,0,7,7,
Hughes,U.S. Senate,Connie Johnson,DEM,320034,0,0,8,8,
Hughes,U.S. Senate,Jim Rogers,DEM,320034,0,0,8,8,
Hughes,Superintendent of Public Instruction,John Cox,DEM,320035,2,2,52,56,
Hughes,Superintendent of Public Instruction,Freda Deskin,DEM,320035,3,5,34,42,
Hughes,U.S. Senate,Connie Johnson,DEM,320035,5,6,49,60,
Hughes,U.S. Senate,Jim Rogers,DEM,320035,0,1,36,37,
Jackson,Superintendent of Public Instruction,John Cox,DEM,330001,0,1,13,14,
Jackson,Superintendent of Public Instruction,Freda Deskin,DEM,330001,0,2,6,8,
Jackson,U.S. Senate,Connie Johnson,DEM,330001,0,0,8,8,
Jackson,U.S. Senate,Jim Rogers,DEM,330001,0,3,10,13,
Jackson,Superintendent of Public Instruction,John Cox,DEM,330002,0,0,3,3,
Jackson,Superintendent of Public Instruction,Freda Deskin,DEM,330002,0,1,5,6,
Jackson,U.S. Senate,Connie Johnson,DEM,330002,0,1,6,7,
Jackson,U.S. Senate,Jim Rogers,DEM,330002,0,0,2,2,
Jackson,Superintendent of Public Instruction,John Cox,DEM,330003,0,0,1,1,
Jackson,Superintendent of Public Instruction,Freda Deskin,DEM,330003,0,0,9,9,
Jackson,U.S. Senate,Connie Johnson,DEM,330003,0,0,10,10,
Jackson,U.S. Senate,Jim Rogers,DEM,330003,0,0,0,0,
Jackson,Superintendent of Public Instruction,John Cox,DEM,330006,1,2,11,14,
Jackson,Superintendent of Public Instruction,Freda Deskin,DEM,330006,3,2,9,14,
Jackson,U.S. Senate,Connie Johnson,DEM,330006,4,3,13,20,
Jackson,U.S. Senate,Jim Rogers,DEM,330006,0,1,7,8,
Jackson,Superintendent of Public Instruction,John Cox,DEM,330007,0,0,6,6,
Jackson,Superintendent of Public Instruction,Freda Deskin,DEM,330007,0,1,6,7,
Jackson,U.S. Senate,Connie Johnson,DEM,330007,0,0,8,8,
Jackson,U.S. Senate,Jim Rogers,DEM,330007,0,1,4,5,
Jackson,Superintendent of Public Instruction,John Cox,DEM,330010,1,2,9,12,
Jackson,Superintendent of Public Instruction,Freda Deskin,DEM,330010,0,3,4,7,
Jackson,U.S. Senate,Connie Johnson,DEM,330010,0,1,8,9,
Jackson,U.S. Senate,Jim Rogers,DEM,330010,1,4,5,10,
Jackson,Superintendent of Public Instruction,John Cox,DEM,330014,0,3,16,19,
Jackson,Superintendent of Public Instruction,Freda Deskin,DEM,330014,1,2,13,16,
Jackson,U.S. Senate,Connie Johnson,DEM,330014,1,1,15,17,
Jackson,U.S. Senate,Jim Rogers,DEM,330014,0,4,13,17,
Jackson,Superintendent of Public Instruction,John Cox,DEM,330016,1,0,10,11,
Jackson,Superintendent of Public Instruction,Freda Deskin,DEM,330016,0,0,5,5,
Jackson,U.S. Senate,Connie Johnson,DEM,330016,1,0,6,7,
Jackson,U.S. Senate,Jim Rogers,DEM,330016,0,0,9,9,
Jackson,Superintendent of Public Instruction,John Cox,DEM,330017,1,1,7,9,
Jackson,Superintendent of Public Instruction,Freda Deskin,DEM,330017,0,0,3,3,
Jackson,U.S. Senate,Connie Johnson,DEM,330017,0,1,3,4,
Jackson,U.S. Senate,Jim Rogers,DEM,330017,1,0,6,7,
Jackson,Superintendent of Public Instruction,John Cox,DEM,330018,0,0,8,8,
Jackson,Superintendent of Public Instruction,Freda Deskin,DEM,330018,0,0,7,7,
Jackson,U.S. Senate,Connie Johnson,DEM,330018,0,0,6,6,
Jackson,U.S. Senate,Jim Rogers,DEM,330018,0,0,8,8,
Jackson,Superintendent of Public Instruction,John Cox,DEM,330019,0,1,1,2,
Jackson,Superintendent of Public Instruction,Freda Deskin,DEM,330019,0,0,4,4,
Jackson,U.S. Senate,Connie Johnson,DEM,330019,0,0,4,4,
Jackson,U.S. Senate,Jim Rogers,DEM,330019,0,1,1,2,
Jackson,Superintendent of Public Instruction,John Cox,DEM,330020,0,0,5,5,
Jackson,Superintendent of Public Instruction,Freda Deskin,DEM,330020,0,0,3,3,
Jackson,U.S. Senate,Connie Johnson,DEM,330020,0,0,5,5,
Jackson,U.S. Senate,Jim Rogers,DEM,330020,0,0,3,3,
Jackson,Superintendent of Public Instruction,John Cox,DEM,330021,0,0,2,2,
Jackson,Superintendent of Public Instruction,Freda Deskin,DEM,330021,0,0,5,5,
Jackson,U.S. Senate,Connie Johnson,DEM,330021,0,0,5,5,
Jackson,U.S. Senate,Jim Rogers,DEM,330021,0,0,2,2,
Jackson,Superintendent of Public Instruction,John Cox,DEM,330023,0,4,2,6,
Jackson,Superintendent of Public Instruction,Freda Deskin,DEM,330023,0,2,4,6,
Jackson,U.S. Senate,Connie Johnson,DEM,330023,0,2,5,7,
Jackson,U.S. Senate,Jim Rogers,DEM,330023,0,3,1,4,
Jackson,Superintendent of Public Instruction,John Cox,DEM,330024,0,0,9,9,
Jackson,Superintendent of Public Instruction,Freda Deskin,DEM,330024,0,0,3,3,
Jackson,U.S. Senate,Connie Johnson,DEM,330024,0,0,6,6,
Jackson,U.S. Senate,Jim Rogers,DEM,330024,0,0,6,6,
Jefferson,Superintendent of Public Instruction,John Cox,DEM,340001,1,3,10,14,
Jefferson,Superintendent of Public Instruction,Freda Deskin,DEM,340001,1,0,3,4,
Jefferson,U.S. Senate,Connie Johnson,DEM,340001,1,2,7,10,
Jefferson,U.S. Senate,Jim Rogers,DEM,340001,1,1,6,8,
Jefferson,Superintendent of Public Instruction,John Cox,DEM,340002,0,1,6,7,
Jefferson,Superintendent of Public Instruction,Freda Deskin,DEM,340002,0,2,0,2,
Jefferson,U.S. Senate,Connie Johnson,DEM,340002,0,2,3,5,
Jefferson,U.S. Senate,Jim Rogers,DEM,340002,0,1,2,3,
Jefferson,Superintendent of Public Instruction,John Cox,DEM,340003,0,4,9,13,
Jefferson,Superintendent of Public Instruction,Freda Deskin,DEM,340003,0,1,1,2,
Jefferson,U.S. Senate,Connie Johnson,DEM,340003,0,1,1,2,
Jefferson,U.S. Senate,Jim Rogers,DEM,340003,0,4,9,13,
Jefferson,Superintendent of Public Instruction,John Cox,DEM,340004,1,0,5,6,
Jefferson,Superintendent of Public Instruction,Freda Deskin,DEM,340004,0,0,1,1,
Jefferson,U.S. Senate,Connie Johnson,DEM,340004,1,0,2,3,
Jefferson,U.S. Senate,Jim Rogers,DEM,340004,0,0,4,4,
Jefferson,Superintendent of Public Instruction,John Cox,DEM,340005,1,0,4,5,
Jefferson,Superintendent of Public Instruction,Freda Deskin,DEM,340005,0,0,0,0,
Jefferson,U.S. Senate,Connie Johnson,DEM,340005,0,0,2,2,
Jefferson,U.S. Senate,Jim Rogers,DEM,340005,1,0,2,3,
Jefferson,Superintendent of Public Instruction,John Cox,DEM,340006,1,1,18,20,
Jefferson,Superintendent of Public Instruction,Freda Deskin,DEM,340006,0,0,7,7,
Jefferson,U.S. Senate,Connie Johnson,DEM,340006,1,0,8,9,
Jefferson,U.S. Senate,Jim Rogers,DEM,340006,0,1,16,17,
Jefferson,Superintendent of Public Instruction,John Cox,DEM,340007,0,1,18,19,
Jefferson,Superintendent of Public Instruction,Freda Deskin,DEM,340007,0,1,7,8,
Jefferson,U.S. Senate,Connie Johnson,DEM,340007,0,1,13,14,
Jefferson,U.S. Senate,Jim Rogers,DEM,340007,0,1,9,10,
Jefferson,Superintendent of Public Instruction,John Cox,DEM,340008,0,1,1,2,
Jefferson,Superintendent of Public Instruction,Freda Deskin,DEM,340008,0,0,0,0,
Jefferson,U.S. Senate,Connie Johnson,DEM,340008,0,0,0,0,
Jefferson,U.S. Senate,Jim Rogers,DEM,340008,0,0,1,1,
Jefferson,Superintendent of Public Instruction,John Cox,DEM,340009,0,1,13,14,
Jefferson,Superintendent of Public Instruction,Freda Deskin,DEM,340009,0,0,7,7,
Jefferson,U.S. Senate,Connie Johnson,DEM,340009,0,1,7,8,
Jefferson,U.S. Senate,Jim Rogers,DEM,340009,0,0,13,13,
Jefferson,Superintendent of Public Instruction,John Cox,DEM,340010,0,0,3,3,
Jefferson,Superintendent of Public Instruction,Freda Deskin,DEM,340010,0,0,1,1,
Jefferson,U.S. Senate,Connie Johnson,DEM,340010,0,0,2,2,
Jefferson,U.S. Senate,Jim Rogers,DEM,340010,0,0,2,2,
Johnston,Superintendent of Public Instruction,John Cox,DEM,350001,0,6,21,27,
Johnston,Superintendent of Public Instruction,Freda Deskin,DEM,350001,0,2,4,6,
Johnston,U.S. Senate,Connie Johnson,DEM,350001,0,3,8,11,
Johnston,U.S. Senate,Jim Rogers,DEM,350001,0,5,17,22,
Johnston,Superintendent of Public Instruction,John Cox,DEM,350002,0,2,18,20,
Johnston,Superintendent of Public Instruction,Freda Deskin,DEM,350002,0,1,11,12,
Johnston,U.S. Senate,Connie Johnson,DEM,350002,0,1,13,14,
Johnston,U.S. Senate,Jim Rogers,DEM,350002,0,2,15,17,
Johnston,Superintendent of Public Instruction,John Cox,DEM,350003,1,2,11,14,
Johnston,Superintendent of Public Instruction,Freda Deskin,DEM,350003,0,3,2,5,
Johnston,U.S. Senate,Connie Johnson,DEM,350003,1,3,4,8,
Johnston,U.S. Senate,Jim Rogers,DEM,350003,0,2,9,11,
Johnston,Superintendent of Public Instruction,John Cox,DEM,350004,1,17,29,47,
Johnston,Superintendent of Public Instruction,Freda Deskin,DEM,350004,2,2,12,16,
Johnston,U.S. Senate,Connie Johnson,DEM,350004,2,6,15,23,
Johnston,U.S. Senate,Jim Rogers,DEM,350004,1,11,25,37,
Johnston,Superintendent of Public Instruction,John Cox,DEM,350005,0,0,28,28,
Johnston,Superintendent of Public Instruction,Freda Deskin,DEM,350005,0,1,11,12,
Johnston,U.S. Senate,Connie Johnson,DEM,350005,0,0,10,10,
Johnston,U.S. Senate,Jim Rogers,DEM,350005,0,1,27,28,
Johnston,Superintendent of Public Instruction,John Cox,DEM,350006,0,2,17,19,
Johnston,Superintendent of Public Instruction,Freda Deskin,DEM,350006,0,1,4,5,
Johnston,U.S. Senate,Connie Johnson,DEM,350006,0,1,4,5,
Johnston,U.S. Senate,Jim Rogers,DEM,350006,0,2,17,19,
Johnston,Superintendent of Public Instruction,John Cox,DEM,350007,0,0,0,0,
Johnston,Superintendent of Public Instruction,Freda Deskin,DEM,350007,0,0,0,0,
Johnston,U.S. Senate,Connie Johnson,DEM,350007,0,0,0,0,
Johnston,U.S. Senate,Jim Rogers,DEM,350007,0,0,0,0,
Johnston,Superintendent of Public Instruction,John Cox,DEM,350008,0,1,31,32,
Johnston,Superintendent of Public Instruction,Freda Deskin,DEM,350008,0,1,11,12,
Johnston,U.S. Senate,Connie Johnson,DEM,350008,0,1,12,13,
Johnston,U.S. Senate,Jim Rogers,DEM,350008,0,1,28,29,
Johnston,Superintendent of Public Instruction,John Cox,DEM,350009,2,0,16,18,
Johnston,Superintendent of Public Instruction,Freda Deskin,DEM,350009,0,0,4,4,
Johnston,U.S. Senate,Connie Johnson,DEM,350009,0,0,6,6,
Johnston,U.S. Senate,Jim Rogers,DEM,350009,2,0,13,15,
Johnston,Superintendent of Public Instruction,John Cox,DEM,350010,0,0,12,12,
Johnston,Superintendent of Public Instruction,Freda Deskin,DEM,350010,0,0,6,6,
Johnston,U.S. Senate,Connie Johnson,DEM,350010,0,0,3,3,
Johnston,U.S. Senate,Jim Rogers,DEM,350010,0,0,12,12,
Johnston,Superintendent of Public Instruction,John Cox,DEM,350011,1,0,50,51,
Johnston,Superintendent of Public Instruction,Freda Deskin,DEM,350011,0,0,11,11,
Johnston,U.S. Senate,Connie Johnson,DEM,350011,0,0,20,20,
Johnston,U.S. Senate,Jim Rogers,DEM,350011,1,0,38,39,
Johnston,Superintendent of Public Instruction,John Cox,DEM,350012,0,0,23,23,
Johnston,Superintendent of Public Instruction,Freda Deskin,DEM,350012,0,0,2,2,
Johnston,U.S. Senate,Connie Johnson,DEM,350012,0,0,4,4,
Johnston,U.S. Senate,Jim Rogers,DEM,350012,0,0,18,18,
Johnston,Superintendent of Public Instruction,John Cox,DEM,350013,2,2,34,38,
Johnston,Superintendent of Public Instruction,Freda Deskin,DEM,350013,0,4,12,16,
Johnston,U.S. Senate,Connie Johnson,DEM,350013,2,1,10,13,
Johnston,U.S. Senate,Jim Rogers,DEM,350013,0,5,33,38,
Johnston,Superintendent of Public Instruction,John Cox,DEM,350014,0,2,9,11,
Johnston,Superintendent of Public Instruction,Freda Deskin,DEM,350014,0,0,1,1,
Johnston,U.S. Senate,Connie Johnson,DEM,350014,0,1,5,6,
Johnston,U.S. Senate,Jim Rogers,DEM,350014,0,0,5,5,
Kay,Superintendent of Public Instruction,John Cox,DEM,360001,0,3,68,71,
Kay,Superintendent of Public Instruction,Freda Deskin,DEM,360001,2,3,70,75,
Kay,U.S. Senate,Connie Johnson,DEM,360001,1,4,63,68,
Kay,U.S. Senate,Jim Rogers,DEM,360001,1,2,78,81,
Kay,State House,John Pfeiffer,REP,360001,1,16,120,137,38
Kay,State House,Harold Levalley,REP,360001,5,15,120,140,38
Kay,Superintendent of Public Instruction,John Cox,DEM,360101,0,2,27,29,
Kay,Superintendent of Public Instruction,Freda Deskin,DEM,360101,0,2,19,21,
Kay,U.S. Senate,Connie Johnson,DEM,360101,0,4,25,29,
Kay,U.S. Senate,Jim Rogers,DEM,360101,0,0,21,21,
Kay,State House,John Pfeiffer,REP,360101,5,0,57,62,38
Kay,State House,Harold Levalley,REP,360101,1,0,78,79,38
Kay,Superintendent of Public Instruction,John Cox,DEM,360103,0,0,27,27,
Kay,Superintendent of Public Instruction,Freda Deskin,DEM,360103,0,0,20,20,
Kay,U.S. Senate,Connie Johnson,DEM,360103,0,0,21,21,
Kay,U.S. Senate,Jim Rogers,DEM,360103,0,0,24,24,
Kay,State House,John Pfeiffer,REP,360103,4,2,74,80,38
Kay,State House,Harold Levalley,REP,360103,3,1,60,64,38
Kay,Superintendent of Public Instruction,John Cox,DEM,360202,0,0,45,45,
Kay,Superintendent of Public Instruction,Freda Deskin,DEM,360202,2,1,29,32,
Kay,U.S. Senate,Connie Johnson,DEM,360202,0,1,38,39,
Kay,U.S. Senate,Jim Rogers,DEM,360202,2,0,37,39,
Kay,State House,John Pfeiffer,REP,360202,3,2,100,105,38
Kay,State House,Harold Levalley,REP,360202,7,3,92,102,38
Kay,Superintendent of Public Instruction,John Cox,DEM,360205,1,0,35,36,
Kay,Superintendent of Public Instruction,Freda Deskin,DEM,360205,0,0,25,25,
Kay,U.S. Senate,Connie Johnson,DEM,360205,0,0,24,24,
Kay,U.S. Senate,Jim Rogers,DEM,360205,1,0,37,38,
Kay,State House,John Pfeiffer,REP,360205,2,1,81,84,38
Kay,State House,Harold Levalley,REP,360205,1,1,72,74,38
Kay,Superintendent of Public Instruction,John Cox,DEM,360206,1,1,60,62,
Kay,Superintendent of Public Instruction,Freda Deskin,DEM,360206,2,0,34,36,
Kay,U.S. Senate,Connie Johnson,DEM,360206,2,1,40,43,
Kay,U.S. Senate,Jim Rogers,DEM,360206,1,0,54,55,
Kay,State House,John Pfeiffer,REP,360206,4,2,187,193,38
Kay,State House,Harold Levalley,REP,360206,8,2,161,171,38
Kay,Superintendent of Public Instruction,John Cox,DEM,360400,0,0,2,2,
Kay,Superintendent of Public Instruction,Freda Deskin,DEM,360400,0,0,2,2,
Kay,U.S. Senate,Connie Johnson,DEM,360400,0,0,1,1,
Kay,U.S. Senate,Jim Rogers,DEM,360400,0,0,3,3,
Kay,Superintendent of Public Instruction,John Cox,DEM,360401,0,1,1,2,
Kay,Superintendent of Public Instruction,Freda Deskin,DEM,360401,0,1,0,1,
Kay,U.S. Senate,Connie Johnson,DEM,360401,0,0,0,0,
Kay,U.S. Senate,Jim Rogers,DEM,360401,0,2,1,3,
Kay,Superintendent of Public Instruction,John Cox,DEM,360403,0,0,21,21,
Kay,Superintendent of Public Instruction,Freda Deskin,DEM,360403,0,1,14,15,
Kay,U.S. Senate,Connie Johnson,DEM,360403,0,1,22,23,
Kay,U.S. Senate,Jim Rogers,DEM,360403,0,0,13,13,
Kay,State House,John Pfeiffer,REP,360403,1,9,46,56,38
Kay,State House,Harold Levalley,REP,360403,0,2,27,29,38
Kay,Superintendent of Public Instruction,John Cox,DEM,360404,0,1,8,9,
Kay,Superintendent of Public Instruction,Freda Deskin,DEM,360404,0,0,1,1,
Kay,U.S. Senate,Connie Johnson,DEM,360404,0,1,6,7,
Kay,U.S. Senate,Jim Rogers,DEM,360404,0,0,3,3,
Kay,State House,John Pfeiffer,REP,360404,0,1,22,23,38
Kay,State House,Harold Levalley,REP,360404,0,1,22,23,38
Kay,Superintendent of Public Instruction,John Cox,DEM,360406,0,1,10,11,
Kay,Superintendent of Public Instruction,Freda Deskin,DEM,360406,0,0,10,10,
Kay,U.S. Senate,Connie Johnson,DEM,360406,0,0,13,13,
Kay,U.S. Senate,Jim Rogers,DEM,360406,0,1,7,8,
Kay,State House,John Pfeiffer,REP,360406,0,0,30,30,38
Kay,State House,Harold Levalley,REP,360406,5,1,73,79,38
Kay,Superintendent of Public Instruction,John Cox,DEM,360407,0,0,1,1,
Kay,Superintendent of Public Instruction,Freda Deskin,DEM,360407,0,0,1,1,
Kay,U.S. Senate,Connie Johnson,DEM,360407,0,0,2,2,
Kay,U.S. Senate,Jim Rogers,DEM,360407,0,0,0,0,
Kay,State House,John Pfeiffer,REP,360407,0,1,3,4,38
Kay,State House,Harold Levalley,REP,360407,0,0,1,1,38
Kay,Superintendent of Public Instruction,John Cox,DEM,360409,0,0,3,3,
Kay,Superintendent of Public Instruction,Freda Deskin,DEM,360409,1,0,2,3,
Kay,U.S. Senate,Connie Johnson,DEM,360409,1,0,4,5,
Kay,U.S. Senate,Jim Rogers,DEM,360409,0,0,1,1,
Kay,State House,John Pfeiffer,REP,360409,0,0,12,12,38
Kay,State House,Harold Levalley,REP,360409,0,0,8,8,38
Kay,Superintendent of Public Instruction,John Cox,DEM,360411,0,0,4,4,
Kay,Superintendent of Public Instruction,Freda Deskin,DEM,360411,0,0,1,1,
Kay,U.S. Senate,Connie Johnson,DEM,360411,0,0,4,4,
Kay,U.S. Senate,Jim Rogers,DEM,360411,0,0,1,1,
Kay,Superintendent of Public Instruction,John Cox,DEM,360412,0,0,2,2,
Kay,Superintendent of Public Instruction,Freda Deskin,DEM,360412,0,0,5,5,
Kay,U.S. Senate,Connie Johnson,DEM,360412,0,0,3,3,
Kay,U.S. Senate,Jim Rogers,DEM,360412,0,0,4,4,
Kay,Superintendent of Public Instruction,John Cox,DEM,360413,2,0,20,22,
Kay,Superintendent of Public Instruction,Freda Deskin,DEM,360413,0,0,9,9,
Kay,U.S. Senate,Connie Johnson,DEM,360413,2,0,17,19,
Kay,U.S. Senate,Jim Rogers,DEM,360413,0,0,11,11,
Kay,Superintendent of Public Instruction,John Cox,DEM,360419,0,1,12,13,
Kay,Superintendent of Public Instruction,Freda Deskin,DEM,360419,1,0,8,9,
Kay,U.S. Senate,Connie Johnson,DEM,360419,1,0,10,11,
Kay,U.S. Senate,Jim Rogers,DEM,360419,0,1,10,11,
Kay,Superintendent of Public Instruction,John Cox,DEM,360420,0,0,10,10,
Kay,Superintendent of Public Instruction,Freda Deskin,DEM,360420,0,0,6,6,
Kay,U.S. Senate,Connie Johnson,DEM,360420,0,0,14,14,
Kay,U.S. Senate,Jim Rogers,DEM,360420,0,0,2,2,
Kay,State House,John Pfeiffer,REP,360420,1,2,17,20,38
Kay,State House,Harold Levalley,REP,360420,0,0,10,10,38
Kay,Superintendent of Public Instruction,John Cox,DEM,360503,0,0,20,20,
Kay,Superintendent of Public Instruction,Freda Deskin,DEM,360503,0,0,16,16,
Kay,U.S. Senate,Connie Johnson,DEM,360503,0,0,30,30,
Kay,U.S. Senate,Jim Rogers,DEM,360503,0,0,7,7,
Kay,Superintendent of Public Instruction,John Cox,DEM,360507,0,0,0,0,
Kay,Superintendent of Public Instruction,Freda Deskin,DEM,360507,1,1,5,7,
Kay,U.S. Senate,Connie Johnson,DEM,360507,1,1,4,6,
Kay,U.S. Senate,Jim Rogers,DEM,360507,0,0,1,1,
Kay,Superintendent of Public Instruction,John Cox,DEM,360516,0,0,6,6,
Kay,Superintendent of Public Instruction,Freda Deskin,DEM,360516,0,0,8,8,
Kay,U.S. Senate,Connie Johnson,DEM,360516,0,0,6,6,
Kay,U.S. Senate,Jim Rogers,DEM,360516,0,0,8,8,
Kay,Superintendent of Public Instruction,John Cox,DEM,360517,0,0,15,15,
Kay,Superintendent of Public Instruction,Freda Deskin,DEM,360517,1,1,13,15,
Kay,U.S. Senate,Connie Johnson,DEM,360517,1,1,19,21,
Kay,U.S. Senate,Jim Rogers,DEM,360517,0,0,10,10,
Kay,Superintendent of Public Instruction,John Cox,DEM,360527,1,0,15,16,
Kay,Superintendent of Public Instruction,Freda Deskin,DEM,360527,0,0,8,8,
Kay,U.S. Senate,Connie Johnson,DEM,360527,0,0,10,10,
Kay,U.S. Senate,Jim Rogers,DEM,360527,1,0,13,14,
Kay,Superintendent of Public Instruction,John Cox,DEM,360530,0,0,19,19,
Kay,Superintendent of Public Instruction,Freda Deskin,DEM,360530,0,0,9,9,
Kay,U.S. Senate,Connie Johnson,DEM,360530,0,0,15,15,
Kay,U.S. Senate,Jim Rogers,DEM,360530,0,0,13,13,
Kay,Superintendent of Public Instruction,John Cox,DEM,360532,0,0,14,14,
Kay,Superintendent of Public Instruction,Freda Deskin,DEM,360532,0,1,18,19,
Kay,U.S. Senate,Connie Johnson,DEM,360532,0,1,21,22,
Kay,U.S. Senate,Jim Rogers,DEM,360532,0,0,12,12,
Kay,Superintendent of Public Instruction,John Cox,DEM,360533,0,0,10,10,
Kay,Superintendent of Public Instruction,Freda Deskin,DEM,360533,0,0,14,14,
Kay,U.S. Senate,Connie Johnson,DEM,360533,0,0,15,15,
Kay,U.S. Senate,Jim Rogers,DEM,360533,0,0,9,9,
Kay,Superintendent of Public Instruction,John Cox,DEM,360534,0,1,19,20,
Kay,Superintendent of Public Instruction,Freda Deskin,DEM,360534,0,0,22,22,
Kay,U.S. Senate,Connie Johnson,DEM,360534,0,0,26,26,
Kay,U.S. Senate,Jim Rogers,DEM,360534,0,1,15,16,
Kay,Superintendent of Public Instruction,John Cox,DEM,360535,0,0,14,14,
Kay,Superintendent of Public Instruction,Freda Deskin,DEM,360535,0,0,9,9,
Kay,U.S. Senate,Connie Johnson,DEM,360535,0,0,19,19,
Kay,U.S. Senate,Jim Rogers,DEM,360535,0,0,4,4,
Kingfisher,Superintendent of Public Instruction,John Cox,DEM,370101,6,1,12,19,
Kingfisher,Superintendent of Public Instruction,Freda Deskin,DEM,370101,1,2,4,7,
Kingfisher,U.S. Senate,Connie Johnson,DEM,370101,2,1,8,11,
Kingfisher,U.S. Senate,Jim Rogers,DEM,370101,5,2,7,14,
Kingfisher,Superintendent of Public Instruction,John Cox,DEM,370102,0,0,3,3,
Kingfisher,Superintendent of Public Instruction,Freda Deskin,DEM,370102,0,0,2,2,
Kingfisher,U.S. Senate,Connie Johnson,DEM,370102,0,0,1,1,
Kingfisher,U.S. Senate,Jim Rogers,DEM,370102,0,0,4,4,
Kingfisher,Superintendent of Public Instruction,John Cox,DEM,370103,0,0,5,5,
Kingfisher,Superintendent of Public Instruction,Freda Deskin,DEM,370103,0,3,1,4,
Kingfisher,U.S. Senate,Connie Johnson,DEM,370103,0,1,3,4,
Kingfisher,U.S. Senate,Jim Rogers,DEM,370103,0,2,2,4,
Kingfisher,Superintendent of Public Instruction,John Cox,DEM,370105,0,2,12,14,
Kingfisher,Superintendent of Public Instruction,Freda Deskin,DEM,370105,0,1,8,9,
Kingfisher,U.S. Senate,Connie Johnson,DEM,370105,1,1,6,8,
Kingfisher,U.S. Senate,Jim Rogers,DEM,370105,0,2,13,15,
Kingfisher,Superintendent of Public Instruction,John Cox,DEM,370106,0,0,0,0,
Kingfisher,Superintendent of Public Instruction,Freda Deskin,DEM,370106,0,0,0,0,
Kingfisher,U.S. Senate,Connie Johnson,DEM,370106,0,0,0,0,
Kingfisher,U.S. Senate,Jim Rogers,DEM,370106,0,0,0,0,
Kingfisher,Superintendent of Public Instruction,John Cox,DEM,370201,2,0,18,20,
Kingfisher,Superintendent of Public Instruction,Freda Deskin,DEM,370201,1,0,14,15,
Kingfisher,U.S. Senate,Connie Johnson,DEM,370201,2,0,21,23,
Kingfisher,U.S. Senate,Jim Rogers,DEM,370201,1,0,11,12,
Kingfisher,Superintendent of Public Instruction,John Cox,DEM,370203,1,0,3,4,
Kingfisher,Superintendent of Public Instruction,Freda Deskin,DEM,370203,0,0,3,3,
Kingfisher,U.S. Senate,Connie Johnson,DEM,370203,0,0,1,1,
Kingfisher,U.S. Senate,Jim Rogers,DEM,370203,1,0,5,6,
Kingfisher,Superintendent of Public Instruction,John Cox,DEM,370204,0,0,13,13,
Kingfisher,Superintendent of Public Instruction,Freda Deskin,DEM,370204,0,2,9,11,
Kingfisher,U.S. Senate,Connie Johnson,DEM,370204,0,1,9,10,
Kingfisher,U.S. Senate,Jim Rogers,DEM,370204,0,1,13,14,
Kingfisher,Superintendent of Public Instruction,John Cox,DEM,370301,0,3,14,17,
Kingfisher,Superintendent of Public Instruction,Freda Deskin,DEM,370301,1,0,13,14,
Kingfisher,U.S. Senate,Connie Johnson,DEM,370301,0,0,19,19,
Kingfisher,U.S. Senate,Jim Rogers,DEM,370301,1,3,8,12,
Kingfisher,Superintendent of Public Instruction,John Cox,DEM,370302,1,0,27,28,
Kingfisher,Superintendent of Public Instruction,Freda Deskin,DEM,370302,0,0,23,23,
Kingfisher,U.S. Senate,Connie Johnson,DEM,370302,0,0,26,26,
Kingfisher,U.S. Senate,Jim Rogers,DEM,370302,1,0,23,24,
Kingfisher,Superintendent of Public Instruction,John Cox,DEM,370303,0,0,0,0,
Kingfisher,Superintendent of Public Instruction,Freda Deskin,DEM,370303,0,0,1,1,
Kingfisher,U.S. Senate,Connie Johnson,DEM,370303,0,0,0,0,
Kingfisher,U.S. Senate,Jim Rogers,DEM,370303,0,0,1,1,
Kingfisher,Superintendent of Public Instruction,John Cox,DEM,370304,0,0,8,8,
Kingfisher,Superintendent of Public Instruction,Freda Deskin,DEM,370304,0,0,0,0,
Kingfisher,U.S. Senate,Connie Johnson,DEM,370304,0,0,6,6,
Kingfisher,U.S. Senate,Jim Rogers,DEM,370304,0,0,2,2,
Kingfisher,Superintendent of Public Instruction,John Cox,DEM,370305,0,1,2,3,
Kingfisher,Superintendent of Public Instruction,Freda Deskin,DEM,370305,0,0,1,1,
Kingfisher,U.S. Senate,Connie Johnson,DEM,370305,0,1,1,2,
Kingfisher,U.S. Senate,Jim Rogers,DEM,370305,0,0,2,2,
Kingfisher,Superintendent of Public Instruction,John Cox,DEM,370306,0,0,1,1,
Kingfisher,Superintendent of Public Instruction,Freda Deskin,DEM,370306,0,0,3,3,
Kingfisher,U.S. Senate,Connie Johnson,DEM,370306,0,0,2,2,
Kingfisher,U.S. Senate,Jim Rogers,DEM,370306,0,0,2,2,
Kiowa,Superintendent of Public Instruction,John Cox,DEM,380001,6,4,30,40,
Kiowa,Superintendent of Public Instruction,Freda Deskin,DEM,380001,4,1,9,14,
Kiowa,U.S. Senate,Connie Johnson,DEM,380001,2,4,18,24,
Kiowa,U.S. Senate,Jim Rogers,DEM,380001,8,1,21,30,
Kiowa,Superintendent of Public Instruction,John Cox,DEM,380002,0,1,3,4,
Kiowa,Superintendent of Public Instruction,Freda Deskin,DEM,380002,0,0,1,1,
Kiowa,U.S. Senate,Connie Johnson,DEM,380002,0,1,3,4,
Kiowa,U.S. Senate,Jim Rogers,DEM,380002,0,0,1,1,
Kiowa,Superintendent of Public Instruction,John Cox,DEM,380004,0,6,24,30,
Kiowa,Superintendent of Public Instruction,Freda Deskin,DEM,380004,1,0,6,7,
Kiowa,U.S. Senate,Connie Johnson,DEM,380004,0,3,15,18,
Kiowa,U.S. Senate,Jim Rogers,DEM,380004,0,3,14,17,
Kiowa,Superintendent of Public Instruction,John Cox,DEM,380005,0,0,1,1,
Kiowa,Superintendent of Public Instruction,Freda Deskin,DEM,380005,0,1,0,1,
Kiowa,U.S. Senate,Connie Johnson,DEM,380005,0,1,0,1,
Kiowa,U.S. Senate,Jim Rogers,DEM,380005,0,0,1,1,
Kiowa,Superintendent of Public Instruction,John Cox,DEM,380006,3,0,17,20,
Kiowa,Superintendent of Public Instruction,Freda Deskin,DEM,380006,1,1,7,9,
Kiowa,U.S. Senate,Connie Johnson,DEM,380006,2,1,13,16,
Kiowa,U.S. Senate,Jim Rogers,DEM,380006,2,0,10,12,
Kiowa,Superintendent of Public Instruction,John Cox,DEM,380007,0,0,0,0,
Kiowa,Superintendent of Public Instruction,Freda Deskin,DEM,380007,0,0,0,0,
Kiowa,U.S. Senate,Connie Johnson,DEM,380007,0,0,0,0,
Kiowa,U.S. Senate,Jim Rogers,DEM,380007,0,0,0,0,
Kiowa,Superintendent of Public Instruction,John Cox,DEM,380008,1,0,16,17,
Kiowa,Superintendent of Public Instruction,Freda Deskin,DEM,380008,0,0,6,6,
Kiowa,U.S. Senate,Connie Johnson,DEM,380008,0,0,13,13,
Kiowa,U.S. Senate,Jim Rogers,DEM,380008,1,0,9,10,
Kiowa,Superintendent of Public Instruction,John Cox,DEM,380009,0,0,4,4,
Kiowa,Superintendent of Public Instruction,Freda Deskin,DEM,380009,0,0,1,1,
Kiowa,U.S. Senate,Connie Johnson,DEM,380009,0,0,3,3,
Kiowa,U.S. Senate,Jim Rogers,DEM,380009,0,0,2,2,
Kiowa,Superintendent of Public Instruction,John Cox,DEM,380010,2,0,44,46,
Kiowa,Superintendent of Public Instruction,Freda Deskin,DEM,380010,0,0,8,8,
Kiowa,U.S. Senate,Connie Johnson,DEM,380010,1,0,31,32,
Kiowa,U.S. Senate,Jim Rogers,DEM,380010,1,0,23,24,
Kiowa,Superintendent of Public Instruction,John Cox,DEM,380011,0,0,2,2,
Kiowa,Superintendent of Public Instruction,Freda Deskin,DEM,380011,0,0,4,4,
Kiowa,U.S. Senate,Connie Johnson,DEM,380011,0,0,1,1,
Kiowa,U.S. Senate,Jim Rogers,DEM,380011,0,0,6,6,
Kiowa,Superintendent of Public Instruction,John Cox,DEM,380014,0,0,41,41,
Kiowa,Superintendent of Public Instruction,Freda Deskin,DEM,380014,0,0,10,10,
Kiowa,U.S. Senate,Connie Johnson,DEM,380014,0,0,21,21,
Kiowa,U.S. Senate,Jim Rogers,DEM,380014,0,0,30,30,
Kiowa,Superintendent of Public Instruction,John Cox,DEM,380015,0,1,9,10,
Kiowa,Superintendent of Public Instruction,Freda Deskin,DEM,380015,0,0,2,2,
Kiowa,U.S. Senate,Connie Johnson,DEM,380015,0,0,3,3,
Kiowa,U.S. Senate,Jim Rogers,DEM,380015,0,1,8,9,
Kiowa,Superintendent of Public Instruction,John Cox,DEM,380016,2,0,3,5,
Kiowa,Superintendent of Public Instruction,Freda Deskin,DEM,380016,0,0,2,2,
Kiowa,U.S. Senate,Connie Johnson,DEM,380016,0,0,2,2,
Kiowa,U.S. Senate,Jim Rogers,DEM,380016,2,0,3,5,
Kiowa,Superintendent of Public Instruction,John Cox,DEM,380022,1,1,42,44,
Kiowa,Superintendent of Public Instruction,Freda Deskin,DEM,380022,0,1,12,13,
Kiowa,U.S. Senate,Connie Johnson,DEM,380022,1,1,20,22,
Kiowa,U.S. Senate,Jim Rogers,DEM,380022,0,1,36,37,
Latimer,Superintendent of Public Instruction,John Cox,DEM,390001,0,4,35,39,
Latimer,Superintendent of Public Instruction,Freda Deskin,DEM,390001,0,3,13,16,
Latimer,U.S. Senate,Connie Johnson,DEM,390001,0,5,31,36,
Latimer,U.S. Senate,Jim Rogers,DEM,390001,0,2,17,19,
Latimer,Superintendent of Public Instruction,John Cox,DEM,390002,7,13,59,79,
Latimer,Superintendent of Public Instruction,Freda Deskin,DEM,390002,1,1,11,13,
Latimer,U.S. Senate,Connie Johnson,DEM,390002,7,8,50,65,
Latimer,U.S. Senate,Jim Rogers,DEM,390002,1,6,20,27,
Latimer,Superintendent of Public Instruction,John Cox,DEM,390003,0,17,31,48,
Latimer,Superintendent of Public Instruction,Freda Deskin,DEM,390003,0,3,5,8,
Latimer,U.S. Senate,Connie Johnson,DEM,390003,0,8,12,20,
Latimer,U.S. Senate,Jim Rogers,DEM,390003,0,12,18,30,
Latimer,Superintendent of Public Instruction,John Cox,DEM,390004,0,6,16,22,
Latimer,Superintendent of Public Instruction,Freda Deskin,DEM,390004,0,1,5,6,
Latimer,U.S. Senate,Connie Johnson,DEM,390004,0,4,8,12,
Latimer,U.S. Senate,Jim Rogers,DEM,390004,0,3,11,14,
Latimer,Superintendent of Public Instruction,John Cox,DEM,390005,1,2,47,50,
Latimer,Superintendent of Public Instruction,Freda Deskin,DEM,390005,0,1,9,10,
Latimer,U.S. Senate,Connie Johnson,DEM,390005,0,2,27,29,
Latimer,U.S. Senate,Jim Rogers,DEM,390005,1,1,28,30,
Latimer,Superintendent of Public Instruction,John Cox,DEM,390006,0,0,14,14,
Latimer,Superintendent of Public Instruction,Freda Deskin,DEM,390006,0,0,4,4,
Latimer,U.S. Senate,Connie Johnson,DEM,390006,0,0,8,8,
Latimer,U.S. Senate,Jim Rogers,DEM,390006,0,0,10,10,
Latimer,Superintendent of Public Instruction,John Cox,DEM,390007,0,1,6,7,
Latimer,Superintendent of Public Instruction,Freda Deskin,DEM,390007,0,0,6,6,
Latimer,U.S. Senate,Connie Johnson,DEM,390007,0,1,6,7,
Latimer,U.S. Senate,Jim Rogers,DEM,390007,0,0,6,6,
Latimer,Superintendent of Public Instruction,John Cox,DEM,390008,0,1,58,59,
Latimer,Superintendent of Public Instruction,Freda Deskin,DEM,390008,0,0,6,6,
Latimer,U.S. Senate,Connie Johnson,DEM,390008,0,0,36,36,
Latimer,U.S. Senate,Jim Rogers,DEM,390008,0,1,28,29,
Latimer,Superintendent of Public Instruction,John Cox,DEM,390009,2,1,28,31,
Latimer,Superintendent of Public Instruction,Freda Deskin,DEM,390009,0,0,4,4,
Latimer,U.S. Senate,Connie Johnson,DEM,390009,2,1,20,23,
Latimer,U.S. Senate,Jim Rogers,DEM,390009,0,0,11,11,
Latimer,Superintendent of Public Instruction,John Cox,DEM,390010,2,4,36,42,
Latimer,Superintendent of Public Instruction,Freda Deskin,DEM,390010,0,0,4,4,
Latimer,U.S. Senate,Connie Johnson,DEM,390010,0,2,21,23,
Latimer,U.S. Senate,Jim Rogers,DEM,390010,2,2,17,21,
Latimer,Superintendent of Public Instruction,John Cox,DEM,390011,8,4,106,118,
Latimer,Superintendent of Public Instruction,Freda Deskin,DEM,390011,3,0,9,12,
Latimer,U.S. Senate,Connie Johnson,DEM,390011,4,4,55,63,
Latimer,U.S. Senate,Jim Rogers,DEM,390011,7,0,56,63,
Latimer,Superintendent of Public Instruction,John Cox,DEM,390012,1,0,17,18,
Latimer,Superintendent of Public Instruction,Freda Deskin,DEM,390012,3,0,2,5,
Latimer,U.S. Senate,Connie Johnson,DEM,390012,3,0,9,12,
Latimer,U.S. Senate,Jim Rogers,DEM,390012,1,0,9,10,
Leflore,Superintendent of Public Instruction,John Cox,DEM,400101,0,1,45,46,
Leflore,Superintendent of Public Instruction,Freda Deskin,DEM,400101,0,3,14,17,
Leflore,U.S. Senate,Connie Johnson,DEM,400101,0,3,24,27,
Leflore,U.S. Senate,Jim Rogers,DEM,400101,0,1,32,33,
Leflore,Superintendent of Public Instruction,John Cox,DEM,400102,2,1,64,67,
Leflore,Superintendent of Public Instruction,Freda Deskin,DEM,400102,0,0,9,9,
Leflore,U.S. Senate,Connie Johnson,DEM,400102,2,0,25,27,
Leflore,U.S. Senate,Jim Rogers,DEM,400102,0,1,49,50,
Leflore,Superintendent of Public Instruction,John Cox,DEM,400103,2,0,96,98,
Leflore,Superintendent of Public Instruction,Freda Deskin,DEM,400103,0,1,18,19,
Leflore,U.S. Senate,Connie Johnson,DEM,400103,1,1,45,47,
Leflore,U.S. Senate,Jim Rogers,DEM,400103,2,0,65,67,
Leflore,Superintendent of Public Instruction,John Cox,DEM,400104,0,1,46,47,
Leflore,Superintendent of Public Instruction,Freda Deskin,DEM,400104,0,0,23,23,
Leflore,U.S. Senate,Connie Johnson,DEM,400104,0,0,41,41,
Leflore,U.S. Senate,Jim Rogers,DEM,400104,0,1,26,27,
Leflore,Superintendent of Public Instruction,John Cox,DEM,400105,0,1,90,91,
Leflore,Superintendent of Public Instruction,Freda Deskin,DEM,400105,0,1,26,27,
Leflore,U.S. Senate,Connie Johnson,DEM,400105,0,1,39,40,
Leflore,U.S. Senate,Jim Rogers,DEM,400105,0,1,74,75,
Leflore,Superintendent of Public Instruction,John Cox,DEM,400106,0,1,54,55,
Leflore,Superintendent of Public Instruction,Freda Deskin,DEM,400106,0,0,16,16,
Leflore,U.S. Senate,Connie Johnson,DEM,400106,0,0,19,19,
Leflore,U.S. Senate,Jim Rogers,DEM,400106,0,1,50,51,
Leflore,Superintendent of Public Instruction,John Cox,DEM,400107,3,2,93,98,
Leflore,Superintendent of Public Instruction,Freda Deskin,DEM,400107,0,0,43,43,
Leflore,U.S. Senate,Connie Johnson,DEM,400107,0,0,57,57,
Leflore,U.S. Senate,Jim Rogers,DEM,400107,3,2,76,81,
Leflore,Superintendent of Public Instruction,John Cox,DEM,400108,0,0,42,42,
Leflore,Superintendent of Public Instruction,Freda Deskin,DEM,400108,1,0,10,11,
Leflore,U.S. Senate,Connie Johnson,DEM,400108,1,0,19,20,
Leflore,U.S. Senate,Jim Rogers,DEM,400108,0,0,33,33,
Leflore,Superintendent of Public Instruction,John Cox,DEM,400109,2,6,134,142,
Leflore,Superintendent of Public Instruction,Freda Deskin,DEM,400109,0,3,48,51,
Leflore,U.S. Senate,Connie Johnson,DEM,400109,0,4,67,71,
Leflore,U.S. Senate,Jim Rogers,DEM,400109,0,4,112,116,
Leflore,Superintendent of Public Instruction,John Cox,DEM,400110,0,3,162,165,
Leflore,Superintendent of Public Instruction,Freda Deskin,DEM,400110,1,2,74,77,
Leflore,U.S. Senate,Connie Johnson,DEM,400110,1,3,94,98,
Leflore,U.S. Senate,Jim Rogers,DEM,400110,0,2,143,145,
Leflore,Superintendent of Public Instruction,John Cox,DEM,400111,1,9,121,131,
Leflore,Superintendent of Public Instruction,Freda Deskin,DEM,400111,1,3,59,63,
Leflore,U.S. Senate,Connie Johnson,DEM,400111,1,6,84,91,
Leflore,U.S. Senate,Jim Rogers,DEM,400111,1,6,91,98,
Leflore,Superintendent of Public Instruction,John Cox,DEM,400112,0,1,26,27,
Leflore,Superintendent of Public Instruction,Freda Deskin,DEM,400112,0,0,16,16,
Leflore,U.S. Senate,Connie Johnson,DEM,400112,0,0,16,16,
Leflore,U.S. Senate,Jim Rogers,DEM,400112,0,1,26,27,
Leflore,Superintendent of Public Instruction,John Cox,DEM,400113,2,2,47,51,
Leflore,Superintendent of Public Instruction,Freda Deskin,DEM,400113,1,3,14,18,
Leflore,U.S. Senate,Connie Johnson,DEM,400113,3,3,28,34,
Leflore,U.S. Senate,Jim Rogers,DEM,400113,0,1,29,30,
Leflore,Superintendent of Public Instruction,John Cox,DEM,400114,0,1,32,33,
Leflore,Superintendent of Public Instruction,Freda Deskin,DEM,400114,0,0,13,13,
Leflore,U.S. Senate,Connie Johnson,DEM,400114,0,0,19,19,
Leflore,U.S. Senate,Jim Rogers,DEM,400114,0,1,23,24,
Leflore,Superintendent of Public Instruction,John Cox,DEM,400201,0,0,22,22,
Leflore,Superintendent of Public Instruction,Freda Deskin,DEM,400201,0,0,11,11,
Leflore,U.S. Senate,Connie Johnson,DEM,400201,0,0,13,13,
Leflore,U.S. Senate,Jim Rogers,DEM,400201,0,0,19,19,
Leflore,Superintendent of Public Instruction,John Cox,DEM,400202,4,11,44,59,
Leflore,Superintendent of Public Instruction,Freda Deskin,DEM,400202,2,1,17,20,
Leflore,U.S. Senate,Connie Johnson,DEM,400202,1,4,19,24,
Leflore,U.S. Senate,Jim Rogers,DEM,400202,5,8,43,56,
Leflore,Superintendent of Public Instruction,John Cox,DEM,400203,1,57,269,327,
Leflore,Superintendent of Public Instruction,Freda Deskin,DEM,400203,1,10,118,129,
Leflore,U.S. Senate,Connie Johnson,DEM,400203,0,23,159,182,
Leflore,U.S. Senate,Jim Rogers,DEM,400203,1,42,221,264,
Leflore,Superintendent of Public Instruction,John Cox,DEM,400204,1,14,172,187,
Leflore,Superintendent of Public Instruction,Freda Deskin,DEM,400204,0,7,88,95,
Leflore,U.S. Senate,Connie Johnson,DEM,400204,0,11,113,124,
Leflore,U.S. Senate,Jim Rogers,DEM,400204,1,9,142,152,
Leflore,Superintendent of Public Instruction,John Cox,DEM,400205,7,16,71,94,
Leflore,Superintendent of Public Instruction,Freda Deskin,DEM,400205,0,3,37,40,
Leflore,U.S. Senate,Connie Johnson,DEM,400205,1,9,39,49,
Leflore,U.S. Senate,Jim Rogers,DEM,400205,4,8,69,81,
Leflore,Superintendent of Public Instruction,John Cox,DEM,400207,4,18,133,155,
Leflore,Superintendent of Public Instruction,Freda Deskin,DEM,400207,1,8,70,79,
Leflore,U.S. Senate,Connie Johnson,DEM,400207,3,12,82,97,
Leflore,U.S. Senate,Jim Rogers,DEM,400207,2,14,117,133,
Leflore,Superintendent of Public Instruction,John Cox,DEM,400208,7,6,147,160,
Leflore,Superintendent of Public Instruction,Freda Deskin,DEM,400208,2,3,73,78,
Leflore,U.S. Senate,Connie Johnson,DEM,400208,1,2,97,100,
Leflore,U.S. Senate,Jim Rogers,DEM,400208,8,7,122,137,
Leflore,Superintendent of Public Instruction,John Cox,DEM,400210,2,24,171,197,
Leflore,Superintendent of Public Instruction,Freda Deskin,DEM,400210,0,10,47,57,
Leflore,U.S. Senate,Connie Johnson,DEM,400210,1,13,83,97,
Leflore,U.S. Senate,Jim Rogers,DEM,400210,1,21,123,145,
Leflore,Superintendent of Public Instruction,John Cox,DEM,400211,1,8,152,161,
Leflore,Superintendent of Public Instruction,Freda Deskin,DEM,400211,0,0,31,31,
Leflore,U.S. Senate,Connie Johnson,DEM,400211,1,4,53,58,
Leflore,U.S. Senate,Jim Rogers,DEM,400211,0,4,125,129,
Leflore,Superintendent of Public Instruction,John Cox,DEM,400212,31,18,296,345,
Leflore,Superintendent of Public Instruction,Freda Deskin,DEM,400212,1,5,108,114,
Leflore,U.S. Senate,Connie Johnson,DEM,400212,12,10,133,155,
Leflore,U.S. Senate,Jim Rogers,DEM,400212,15,12,257,284,
Leflore,Superintendent of Public Instruction,John Cox,DEM,400213,0,0,30,30,
Leflore,Superintendent of Public Instruction,Freda Deskin,DEM,400213,0,0,6,6,
Leflore,U.S. Senate,Connie Johnson,DEM,400213,0,0,12,12,
Leflore,U.S. Senate,Jim Rogers,DEM,400213,0,0,23,23,
Leflore,Superintendent of Public Instruction,John Cox,DEM,400214,2,1,44,47,
Leflore,Superintendent of Public Instruction,Freda Deskin,DEM,400214,0,0,2,2,
Leflore,U.S. Senate,Connie Johnson,DEM,400214,2,0,19,21,
Leflore,U.S. Senate,Jim Rogers,DEM,400214,0,1,27,28,
Leflore,Superintendent of Public Instruction,John Cox,DEM,400215,2,0,80,82,
Leflore,Superintendent of Public Instruction,Freda Deskin,DEM,400215,0,1,16,17,
Leflore,U.S. Senate,Connie Johnson,DEM,400215,0,0,26,26,
Leflore,U.S. Senate,Jim Rogers,DEM,400215,2,1,64,67,
Leflore,Superintendent of Public Instruction,John Cox,DEM,400301,1,0,53,54,
Leflore,Superintendent of Public Instruction,Freda Deskin,DEM,400301,0,0,19,19,
Leflore,U.S. Senate,Connie Johnson,DEM,400301,1,0,33,34,
Leflore,U.S. Senate,Jim Rogers,DEM,400301,0,0,35,35,
Leflore,Superintendent of Public Instruction,John Cox,DEM,400302,4,0,79,83,
Leflore,Superintendent of Public Instruction,Freda Deskin,DEM,400302,0,0,23,23,
Leflore,U.S. Senate,Connie Johnson,DEM,400302,0,0,29,29,
Leflore,U.S. Senate,Jim Rogers,DEM,400302,4,0,68,72,
Leflore,Superintendent of Public Instruction,John Cox,DEM,400303,0,0,23,23,
Leflore,Superintendent of Public Instruction,Freda Deskin,DEM,400303,0,0,12,12,
Leflore,U.S. Senate,Connie Johnson,DEM,400303,0,0,13,13,
Leflore,U.S. Senate,Jim Rogers,DEM,400303,0,0,20,20,
Leflore,Superintendent of Public Instruction,John Cox,DEM,400304,0,0,18,18,
Leflore,Superintendent of Public Instruction,Freda Deskin,DEM,400304,0,0,5,5,
Leflore,U.S. Senate,Connie Johnson,DEM,400304,0,0,4,4,
Leflore,U.S. Senate,Jim Rogers,DEM,400304,0,0,15,15,
Leflore,Superintendent of Public Instruction,John Cox,DEM,400305,1,4,47,52,
Leflore,Superintendent of Public Instruction,Freda Deskin,DEM,400305,0,2,13,15,
Leflore,U.S. Senate,Connie Johnson,DEM,400305,0,2,21,23,
Leflore,U.S. Senate,Jim Rogers,DEM,400305,1,2,39,42,
Leflore,Superintendent of Public Instruction,John Cox,DEM,400306,1,2,28,31,
Leflore,Superintendent of Public Instruction,Freda Deskin,DEM,400306,0,0,3,3,
Leflore,U.S. Senate,Connie Johnson,DEM,400306,0,1,2,3,
Leflore,U.S. Senate,Jim Rogers,DEM,400306,1,1,25,27,
Leflore,Superintendent of Public Instruction,John Cox,DEM,400309,0,0,20,20,
Leflore,Superintendent of Public Instruction,Freda Deskin,DEM,400309,0,0,10,10,
Leflore,U.S. Senate,Connie Johnson,DEM,400309,0,0,7,7,
Leflore,U.S. Senate,Jim Rogers,DEM,400309,0,0,22,22,
Leflore,Superintendent of Public Instruction,John Cox,DEM,400310,2,16,198,216,
Leflore,Superintendent of Public Instruction,Freda Deskin,DEM,400310,0,4,49,53,
Leflore,U.S. Senate,Connie Johnson,DEM,400310,0,10,73,83,
Leflore,U.S. Senate,Jim Rogers,DEM,400310,2,8,163,173,
Leflore,Superintendent of Public Instruction,John Cox,DEM,400311,3,4,120,127,
Leflore,Superintendent of Public Instruction,Freda Deskin,DEM,400311,2,0,51,53,
Leflore,U.S. Senate,Connie Johnson,DEM,400311,2,1,46,49,
Leflore,U.S. Senate,Jim Rogers,DEM,400311,2,3,116,121,
Leflore,Superintendent of Public Instruction,John Cox,DEM,400312,0,6,100,106,
Leflore,Superintendent of Public Instruction,Freda Deskin,DEM,400312,0,1,29,30,
Leflore,U.S. Senate,Connie Johnson,DEM,400312,0,4,29,33,
Leflore,U.S. Senate,Jim Rogers,DEM,400312,0,2,99,101,
Lincoln,Superintendent of Public Instruction,John Cox,DEM,410001,5,0,12,17,
Lincoln,Superintendent of Public Instruction,Freda Deskin,DEM,410001,0,0,10,10,
Lincoln,U.S. Senate,Connie Johnson,DEM,410001,1,0,14,15,
Lincoln,U.S. Senate,Jim Rogers,DEM,410001,4,0,8,12,
Lincoln,Superintendent of Public Instruction,John Cox,DEM,410002,1,1,19,21,
Lincoln,Superintendent of Public Instruction,Freda Deskin,DEM,410002,2,0,12,14,
Lincoln,U.S. Senate,Connie Johnson,DEM,410002,3,1,9,13,
Lincoln,U.S. Senate,Jim Rogers,DEM,410002,0,0,21,21,
Lincoln,Superintendent of Public Instruction,John Cox,DEM,410003,2,3,21,26,
Lincoln,Superintendent of Public Instruction,Freda Deskin,DEM,410003,1,2,8,11,
Lincoln,U.S. Senate,Connie Johnson,DEM,410003,2,4,12,18,
Lincoln,U.S. Senate,Jim Rogers,DEM,410003,1,1,17,19,
Lincoln,Superintendent of Public Instruction,John Cox,DEM,410004,0,0,8,8,
Lincoln,Superintendent of Public Instruction,Freda Deskin,DEM,410004,0,0,3,3,
Lincoln,U.S. Senate,Connie Johnson,DEM,410004,0,0,4,4,
Lincoln,U.S. Senate,Jim Rogers,DEM,410004,0,0,7,7,
Lincoln,Superintendent of Public Instruction,John Cox,DEM,410005,0,1,27,28,
Lincoln,Superintendent of Public Instruction,Freda Deskin,DEM,410005,1,1,9,11,
Lincoln,U.S. Senate,Connie Johnson,DEM,410005,0,1,19,20,
Lincoln,U.S. Senate,Jim Rogers,DEM,410005,1,1,16,18,
Lincoln,Superintendent of Public Instruction,John Cox,DEM,410006,0,0,21,21,
Lincoln,Superintendent of Public Instruction,Freda Deskin,DEM,410006,0,0,7,7,
Lincoln,U.S. Senate,Connie Johnson,DEM,410006,0,0,21,21,
Lincoln,U.S. Senate,Jim Rogers,DEM,410006,0,0,7,7,
Lincoln,Superintendent of Public Instruction,John Cox,DEM,410007,3,0,9,12,
Lincoln,Superintendent of Public Instruction,Freda Deskin,DEM,410007,2,0,6,8,
Lincoln,U.S. Senate,Connie Johnson,DEM,410007,0,0,5,5,
Lincoln,U.S. Senate,Jim Rogers,DEM,410007,3,0,9,12,
Lincoln,Superintendent of Public Instruction,John Cox,DEM,410008,2,1,26,29,
Lincoln,Superintendent of Public Instruction,Freda Deskin,DEM,410008,0,1,16,17,
Lincoln,U.S. Senate,Connie Johnson,DEM,410008,2,1,21,24,
Lincoln,U.S. Senate,Jim Rogers,DEM,410008,0,1,21,22,
Lincoln,Superintendent of Public Instruction,John Cox,DEM,410009,0,1,17,18,
Lincoln,Superintendent of Public Instruction,Freda Deskin,DEM,410009,1,0,9,10,
Lincoln,U.S. Senate,Connie Johnson,DEM,410009,1,0,12,13,
Lincoln,U.S. Senate,Jim Rogers,DEM,410009,0,1,13,14,
Lincoln,Superintendent of Public Instruction,John Cox,DEM,410010,0,2,19,21,
Lincoln,Superintendent of Public Instruction,Freda Deskin,DEM,410010,0,2,8,10,
Lincoln,U.S. Senate,Connie Johnson,DEM,410010,0,1,12,13,
Lincoln,U.S. Senate,Jim Rogers,DEM,410010,0,3,15,18,
Lincoln,Superintendent of Public Instruction,John Cox,DEM,410011,0,4,15,19,
Lincoln,Superintendent of Public Instruction,Freda Deskin,DEM,410011,0,1,16,17,
Lincoln,U.S. Senate,Connie Johnson,DEM,410011,0,3,22,25,
Lincoln,U.S. Senate,Jim Rogers,DEM,410011,0,2,9,11,
Lincoln,Superintendent of Public Instruction,John Cox,DEM,410012,0,2,21,23,
Lincoln,Superintendent of Public Instruction,Freda Deskin,DEM,410012,1,0,10,11,
Lincoln,U.S. Senate,Connie Johnson,DEM,410012,1,2,16,19,
Lincoln,U.S. Senate,Jim Rogers,DEM,410012,0,0,15,15,
Lincoln,Superintendent of Public Instruction,John Cox,DEM,410013,0,0,5,5,
Lincoln,Superintendent of Public Instruction,Freda Deskin,DEM,410013,0,0,2,2,
Lincoln,U.S. Senate,Connie Johnson,DEM,410013,0,0,2,2,
Lincoln,U.S. Senate,Jim Rogers,DEM,410013,0,0,5,5,
Lincoln,Superintendent of Public Instruction,John Cox,DEM,410015,1,0,25,26,
Lincoln,Superintendent of Public Instruction,Freda Deskin,DEM,410015,0,0,15,15,
Lincoln,U.S. Senate,Connie Johnson,DEM,410015,1,0,16,17,
Lincoln,U.S. Senate,Jim Rogers,DEM,410015,0,0,24,24,
Lincoln,Superintendent of Public Instruction,John Cox,DEM,410016,1,0,31,32,
Lincoln,Superintendent of Public Instruction,Freda Deskin,DEM,410016,0,0,11,11,
Lincoln,U.S. Senate,Connie Johnson,DEM,410016,1,0,27,28,
Lincoln,U.S. Senate,Jim Rogers,DEM,410016,0,0,11,11,
Lincoln,Superintendent of Public Instruction,John Cox,DEM,410017,0,1,13,14,
Lincoln,Superintendent of Public Instruction,Freda Deskin,DEM,410017,2,1,4,7,
Lincoln,U.S. Senate,Connie Johnson,DEM,410017,2,1,8,11,
Lincoln,U.S. Senate,Jim Rogers,DEM,410017,0,1,9,10,
Lincoln,Superintendent of Public Instruction,John Cox,DEM,410018,0,1,22,23,
Lincoln,Superintendent of Public Instruction,Freda Deskin,DEM,410018,0,1,11,12,
Lincoln,U.S. Senate,Connie Johnson,DEM,410018,0,1,17,18,
Lincoln,U.S. Senate,Jim Rogers,DEM,410018,0,1,16,17,
Lincoln,Superintendent of Public Instruction,John Cox,DEM,410019,3,0,35,38,
Lincoln,Superintendent of Public Instruction,Freda Deskin,DEM,410019,0,0,11,11,
Lincoln,U.S. Senate,Connie Johnson,DEM,410019,1,0,24,25,
Lincoln,U.S. Senate,Jim Rogers,DEM,410019,1,0,21,22,
Lincoln,Superintendent of Public Instruction,John Cox,DEM,410020,0,0,11,11,
Lincoln,Superintendent of Public Instruction,Freda Deskin,DEM,410020,1,0,6,7,
Lincoln,U.S. Senate,Connie Johnson,DEM,410020,1,0,11,12,
Lincoln,U.S. Senate,Jim Rogers,DEM,410020,0,0,6,6,
Lincoln,Superintendent of Public Instruction,John Cox,DEM,410021,2,1,16,19,
Lincoln,Superintendent of Public Instruction,Freda Deskin,DEM,410021,0,0,11,11,
Lincoln,U.S. Senate,Connie Johnson,DEM,410021,2,1,16,19,
Lincoln,U.S. Senate,Jim Rogers,DEM,410021,0,0,10,10,
Lincoln,Superintendent of Public Instruction,John Cox,DEM,410022,2,0,39,41,
Lincoln,Superintendent of Public Instruction,Freda Deskin,DEM,410022,1,0,12,13,
Lincoln,U.S. Senate,Connie Johnson,DEM,410022,2,0,20,22,
Lincoln,U.S. Senate,Jim Rogers,DEM,410022,1,0,30,31,
Logan,Superintendent of Public Instruction,John Cox,DEM,420101,1,0,4,5,
Logan,Superintendent of Public Instruction,Freda Deskin,DEM,420101,1,0,4,5,
Logan,U.S. Senate,Connie Johnson,DEM,420101,2,0,3,5,
Logan,U.S. Senate,Jim Rogers,DEM,420101,0,0,5,5,
Logan,Superintendent of Public Instruction,John Cox,DEM,420102,1,2,17,20,
Logan,Superintendent of Public Instruction,Freda Deskin,DEM,420102,3,3,20,26,
Logan,U.S. Senate,Connie Johnson,DEM,420102,3,4,24,31,
Logan,U.S. Senate,Jim Rogers,DEM,420102,1,1,13,15,
Logan,Superintendent of Public Instruction,John Cox,DEM,420103,3,0,15,18,
Logan,Superintendent of Public Instruction,Freda Deskin,DEM,420103,6,2,9,17,
Logan,U.S. Senate,Connie Johnson,DEM,420103,9,2,15,26,
Logan,U.S. Senate,Jim Rogers,DEM,420103,1,0,8,9,
Logan,Superintendent of Public Instruction,John Cox,DEM,420104,1,1,18,20,
Logan,Superintendent of Public Instruction,Freda Deskin,DEM,420104,0,1,15,16,
Logan,U.S. Senate,Connie Johnson,DEM,420104,1,1,24,26,
Logan,U.S. Senate,Jim Rogers,DEM,420104,0,1,7,8,
Logan,Superintendent of Public Instruction,John Cox,DEM,420105,0,4,27,31,
Logan,Superintendent of Public Instruction,Freda Deskin,DEM,420105,1,1,14,16,
Logan,U.S. Senate,Connie Johnson,DEM,420105,0,4,17,21,
Logan,U.S. Senate,Jim Rogers,DEM,420105,1,1,23,25,
Logan,Superintendent of Public Instruction,John Cox,DEM,420106,0,1,11,12,
Logan,Superintendent of Public Instruction,Freda Deskin,DEM,420106,2,1,16,19,
Logan,U.S. Senate,Connie Johnson,DEM,420106,2,2,18,22,
Logan,U.S. Senate,Jim Rogers,DEM,420106,0,0,7,7,
Logan,Superintendent of Public Instruction,John Cox,DEM,420201,0,0,6,6,
Logan,Superintendent of Public Instruction,Freda Deskin,DEM,420201,0,0,11,11,
Logan,U.S. Senate,Connie Johnson,DEM,420201,0,0,12,12,
Logan,U.S. Senate,Jim Rogers,DEM,420201,0,0,5,5,
Logan,Superintendent of Public Instruction,John Cox,DEM,420203,2,0,13,15,
Logan,Superintendent of Public Instruction,Freda Deskin,DEM,420203,2,0,14,16,
Logan,U.S. Senate,Connie Johnson,DEM,420203,4,0,14,18,
Logan,U.S. Senate,Jim Rogers,DEM,420203,0,0,11,11,
Logan,Superintendent of Public Instruction,John Cox,DEM,420204,1,1,50,52,
Logan,Superintendent of Public Instruction,Freda Deskin,DEM,420204,0,4,21,25,
Logan,U.S. Senate,Connie Johnson,DEM,420204,1,3,43,47,
Logan,U.S. Senate,Jim Rogers,DEM,420204,1,2,23,26,
Logan,Superintendent of Public Instruction,John Cox,DEM,420205,1,6,48,55,
Logan,Superintendent of Public Instruction,Freda Deskin,DEM,420205,3,2,30,35,
Logan,U.S. Senate,Connie Johnson,DEM,420205,3,4,40,47,
Logan,U.S. Senate,Jim Rogers,DEM,420205,1,3,36,40,
Logan,Superintendent of Public Instruction,John Cox,DEM,420206,0,0,32,32,
Logan,Superintendent of Public Instruction,Freda Deskin,DEM,420206,0,0,20,20,
Logan,U.S. Senate,Connie Johnson,DEM,420206,0,0,35,35,
Logan,U.S. Senate,Jim Rogers,DEM,420206,0,0,17,17,
Logan,Superintendent of Public Instruction,John Cox,DEM,420207,3,0,26,29,
Logan,Superintendent of Public Instruction,Freda Deskin,DEM,420207,5,1,22,28,
Logan,U.S. Senate,Connie Johnson,DEM,420207,4,1,27,32,
Logan,U.S. Senate,Jim Rogers,DEM,420207,4,0,20,24,
Logan,Superintendent of Public Instruction,John Cox,DEM,420301,0,0,4,4,
Logan,Superintendent of Public Instruction,Freda Deskin,DEM,420301,0,0,3,3,
Logan,U.S. Senate,Connie Johnson,DEM,420301,0,0,3,3,
Logan,U.S. Senate,Jim Rogers,DEM,420301,0,0,4,4,
Logan,State House,John Pfeiffer,REP,420301,3,0,47,50,38
Logan,State House,Harold Levalley,REP,420301,0,0,3,3,38
Logan,Superintendent of Public Instruction,John Cox,DEM,420302,0,0,9,9,
Logan,Superintendent of Public Instruction,Freda Deskin,DEM,420302,0,0,9,9,
Logan,U.S. Senate,Connie Johnson,DEM,420302,0,0,10,10,
Logan,U.S. Senate,Jim Rogers,DEM,420302,0,0,8,8,
Logan,State House,John Pfeiffer,REP,420302,1,0,27,28,38
Logan,State House,Harold Levalley,REP,420302,0,0,2,2,38
Logan,Superintendent of Public Instruction,John Cox,DEM,420303,0,3,37,40,
Logan,Superintendent of Public Instruction,Freda Deskin,DEM,420303,4,0,25,29,
Logan,U.S. Senate,Connie Johnson,DEM,420303,3,2,31,36,
Logan,U.S. Senate,Jim Rogers,DEM,420303,0,1,33,34,
Logan,State House,John Pfeiffer,REP,420303,3,1,171,175,38
Logan,State House,Harold Levalley,REP,420303,2,2,30,34,38
Logan,Superintendent of Public Instruction,John Cox,DEM,420304,1,0,22,23,
Logan,Superintendent of Public Instruction,Freda Deskin,DEM,420304,0,0,9,9,
Logan,U.S. Senate,Connie Johnson,DEM,420304,1,0,10,11,
Logan,U.S. Senate,Jim Rogers,DEM,420304,0,0,20,20,
Logan,State House,John Pfeiffer,REP,420304,3,1,72,76,38
Logan,State House,Harold Levalley,REP,420304,0,1,13,14,38
Logan,Superintendent of Public Instruction,John Cox,DEM,420305,0,2,29,31,
Logan,Superintendent of Public Instruction,Freda Deskin,DEM,420305,0,5,32,37,
Logan,U.S. Senate,Connie Johnson,DEM,420305,0,4,27,31,
Logan,U.S. Senate,Jim Rogers,DEM,420305,0,3,34,37,
Logan,State House,John Pfeiffer,REP,420305,12,3,132,147,38
Logan,State House,Harold Levalley,REP,420305,2,1,13,16,38
Logan,Superintendent of Public Instruction,John Cox,DEM,420306,1,0,19,20,
Logan,Superintendent of Public Instruction,Freda Deskin,DEM,420306,3,1,15,19,
Logan,U.S. Senate,Connie Johnson,DEM,420306,3,1,22,26,
Logan,U.S. Senate,Jim Rogers,DEM,420306,1,0,13,14,
Logan,Superintendent of Public Instruction,John Cox,DEM,420307,7,6,50,63,
Logan,Superintendent of Public Instruction,Freda Deskin,DEM,420307,3,3,53,59,
Logan,U.S. Senate,Connie Johnson,DEM,420307,6,6,62,74,
Logan,U.S. Senate,Jim Rogers,DEM,420307,4,3,37,44,
Logan,Superintendent of Public Instruction,John Cox,DEM,420308,0,3,56,59,
Logan,Superintendent of Public Instruction,Freda Deskin,DEM,420308,4,3,36,43,
Logan,U.S. Senate,Connie Johnson,DEM,420308,4,5,67,76,
Logan,U.S. Senate,Jim Rogers,DEM,420308,0,1,24,25,
Logan,Superintendent of Public Instruction,John Cox,DEM,420309,0,1,5,6,
Logan,Superintendent of Public Instruction,Freda Deskin,DEM,420309,0,0,2,2,
Logan,U.S. Senate,Connie Johnson,DEM,420309,0,1,4,5,
Logan,U.S. Senate,Jim Rogers,DEM,420309,0,0,3,3,
Logan,Superintendent of Public Instruction,John Cox,DEM,420310,2,0,15,17,
Logan,Superintendent of Public Instruction,Freda Deskin,DEM,420310,0,1,18,19,
Logan,U.S. Senate,Connie Johnson,DEM,420310,2,1,29,32,
Logan,U.S. Senate,Jim Rogers,DEM,420310,0,0,4,4,
Love,Superintendent of Public Instruction,John Cox,DEM,430101,1,5,41,47,
Love,Superintendent of Public Instruction,Freda Deskin,DEM,430101,1,5,22,28,
Love,U.S. Senate,Connie Johnson,DEM,430101,2,8,31,41,
Love,U.S. Senate,Jim Rogers,DEM,430101,0,2,31,33,
Love,Superintendent of Public Instruction,John Cox,DEM,430102,0,0,20,20,
Love,Superintendent of Public Instruction,Freda Deskin,DEM,430102,0,1,13,14,
Love,U.S. Senate,Connie Johnson,DEM,430102,0,0,15,15,
Love,U.S. Senate,Jim Rogers,DEM,430102,1,1,17,19,
Love,Superintendent of Public Instruction,John Cox,DEM,430103,0,0,2,2,
Love,Superintendent of Public Instruction,Freda Deskin,DEM,430103,0,1,3,4,
Love,U.S. Senate,Connie Johnson,DEM,430103,0,1,1,2,
Love,U.S. Senate,Jim Rogers,DEM,430103,0,0,4,4,
Love,Superintendent of Public Instruction,John Cox,DEM,430204,0,3,26,29,
Love,Superintendent of Public Instruction,Freda Deskin,DEM,430204,0,1,21,22,
Love,U.S. Senate,Connie Johnson,DEM,430204,0,2,19,21,
Love,U.S. Senate,Jim Rogers,DEM,430204,0,2,29,31,
Love,Superintendent of Public Instruction,John Cox,DEM,430205,0,2,13,15,
Love,Superintendent of Public Instruction,Freda Deskin,DEM,430205,1,0,5,6,
Love,U.S. Senate,Connie Johnson,DEM,430205,1,1,12,14,
Love,U.S. Senate,Jim Rogers,DEM,430205,0,0,4,4,
Love,Superintendent of Public Instruction,John Cox,DEM,430206,0,2,10,12,
Love,Superintendent of Public Instruction,Freda Deskin,DEM,430206,0,0,8,8,
Love,U.S. Senate,Connie Johnson,DEM,430206,0,1,5,6,
Love,U.S. Senate,Jim Rogers,DEM,430206,0,1,13,14,
Love,Superintendent of Public Instruction,John Cox,DEM,430207,0,4,2,6,
Love,Superintendent of Public Instruction,Freda Deskin,DEM,430207,0,0,5,5,
Love,U.S. Senate,Connie Johnson,DEM,430207,0,1,7,8,
Love,U.S. Senate,Jim Rogers,DEM,430207,0,3,1,4,
Love,Superintendent of Public Instruction,John Cox,DEM,430208,0,2,8,10,
Love,Superintendent of Public Instruction,Freda Deskin,DEM,430208,0,0,0,0,
Love,U.S. Senate,Connie Johnson,DEM,430208,0,0,1,1,
Love,U.S. Senate,Jim Rogers,DEM,430208,0,2,7,9,
Love,Superintendent of Public Instruction,John Cox,DEM,430310,2,2,31,35,
Love,Superintendent of Public Instruction,Freda Deskin,DEM,430310,0,3,23,26,
Love,U.S. Senate,Connie Johnson,DEM,430310,1,1,23,25,
Love,U.S. Senate,Jim Rogers,DEM,430310,1,4,31,36,
Love,Superintendent of Public Instruction,John Cox,DEM,430311,0,0,15,15,
Love,Superintendent of Public Instruction,Freda Deskin,DEM,430311,1,0,3,4,
Love,U.S. Senate,Connie Johnson,DEM,430311,1,0,8,9,
Love,U.S. Senate,Jim Rogers,DEM,430311,0,0,10,10,
Love,Superintendent of Public Instruction,John Cox,DEM,430312,0,1,7,8,
Love,Superintendent of Public Instruction,Freda Deskin,DEM,430312,0,0,3,3,
Love,U.S. Senate,Connie Johnson,DEM,430312,0,0,4,4,
Love,U.S. Senate,Jim Rogers,DEM,430312,0,1,6,7,
Love,Superintendent of Public Instruction,John Cox,DEM,430313,0,0,7,7,
Love,Superintendent of Public Instruction,Freda Deskin,DEM,430313,0,0,6,6,
Love,U.S. Senate,Connie Johnson,DEM,430313,0,0,3,3,
Love,U.S. Senate,Jim Rogers,DEM,430313,0,0,9,9,
Mcclain,Superintendent of Public Instruction,John Cox,DEM,440001,0,0,12,12,
Mcclain,Superintendent of Public Instruction,Freda Deskin,DEM,440001,0,0,6,6,
Mcclain,U.S. Senate,Connie Johnson,DEM,440001,0,0,9,9,
Mcclain,U.S. Senate,Jim Rogers,DEM,440001,0,0,10,10,
Mcclain,Superintendent of Public Instruction,John Cox,DEM,440002,4,0,12,16,
Mcclain,Superintendent of Public Instruction,Freda Deskin,DEM,440002,1,0,8,9,
Mcclain,U.S. Senate,Connie Johnson,DEM,440002,5,0,3,8,
Mcclain,U.S. Senate,Jim Rogers,DEM,440002,0,0,14,14,
Mcclain,Superintendent of Public Instruction,John Cox,DEM,440003,0,0,11,11,
Mcclain,Superintendent of Public Instruction,Freda Deskin,DEM,440003,0,0,8,8,
Mcclain,U.S. Senate,Connie Johnson,DEM,440003,0,0,7,7,
Mcclain,U.S. Senate,Jim Rogers,DEM,440003,0,0,11,11,
Mcclain,Superintendent of Public Instruction,John Cox,DEM,440004,1,0,14,15,
Mcclain,Superintendent of Public Instruction,Freda Deskin,DEM,440004,0,2,13,15,
Mcclain,U.S. Senate,Connie Johnson,DEM,440004,0,0,16,16,
Mcclain,U.S. Senate,Jim Rogers,DEM,440004,1,2,10,13,
Mcclain,Superintendent of Public Instruction,John Cox,DEM,440005,2,1,7,10,
Mcclain,Superintendent of Public Instruction,Freda Deskin,DEM,440005,0,0,4,4,
Mcclain,U.S. Senate,Connie Johnson,DEM,440005,0,1,3,4,
Mcclain,U.S. Senate,Jim Rogers,DEM,440005,2,0,8,10,
Mcclain,Superintendent of Public Instruction,John Cox,DEM,440006,1,3,14,18,
Mcclain,Superintendent of Public Instruction,Freda Deskin,DEM,440006,2,7,18,27,
Mcclain,U.S. Senate,Connie Johnson,DEM,440006,1,5,15,21,
Mcclain,U.S. Senate,Jim Rogers,DEM,440006,1,5,17,23,
Mcclain,Superintendent of Public Instruction,John Cox,DEM,440007,0,0,15,15,
Mcclain,Superintendent of Public Instruction,Freda Deskin,DEM,440007,2,0,8,10,
Mcclain,U.S. Senate,Connie Johnson,DEM,440007,2,0,12,14,
Mcclain,U.S. Senate,Jim Rogers,DEM,440007,0,0,11,11,
Mcclain,Superintendent of Public Instruction,John Cox,DEM,440008,1,1,14,16,
Mcclain,Superintendent of Public Instruction,Freda Deskin,DEM,440008,0,0,17,17,
Mcclain,U.S. Senate,Connie Johnson,DEM,440008,1,0,13,14,
Mcclain,U.S. Senate,Jim Rogers,DEM,440008,0,1,17,18,
Mcclain,Superintendent of Public Instruction,John Cox,DEM,440009,0,0,15,15,
Mcclain,Superintendent of Public Instruction,Freda Deskin,DEM,440009,2,0,6,8,
Mcclain,U.S. Senate,Connie Johnson,DEM,440009,1,0,19,20,
Mcclain,U.S. Senate,Jim Rogers,DEM,440009,1,0,1,2,
Mcclain,Superintendent of Public Instruction,John Cox,DEM,440010,0,0,6,6,
Mcclain,Superintendent of Public Instruction,Freda Deskin,DEM,440010,0,0,4,4,
Mcclain,U.S. Senate,Connie Johnson,DEM,440010,0,0,1,1,
Mcclain,U.S. Senate,Jim Rogers,DEM,440010,0,0,8,8,
Mcclain,Superintendent of Public Instruction,John Cox,DEM,440011,0,0,4,4,
Mcclain,Superintendent of Public Instruction,Freda Deskin,DEM,440011,0,0,7,7,
Mcclain,U.S. Senate,Connie Johnson,DEM,440011,0,0,4,4,
Mcclain,U.S. Senate,Jim Rogers,DEM,440011,0,0,7,7,
Mcclain,Superintendent of Public Instruction,John Cox,DEM,440012,2,0,33,35,
Mcclain,Superintendent of Public Instruction,Freda Deskin,DEM,440012,5,1,8,14,
Mcclain,U.S. Senate,Connie Johnson,DEM,440012,3,0,22,25,
Mcclain,U.S. Senate,Jim Rogers,DEM,440012,4,1,19,24,
Mcclain,Superintendent of Public Instruction,John Cox,DEM,440013,4,0,28,32,
Mcclain,Superintendent of Public Instruction,Freda Deskin,DEM,440013,3,2,7,12,
Mcclain,U.S. Senate,Connie Johnson,DEM,440013,4,2,18,24,
Mcclain,U.S. Senate,Jim Rogers,DEM,440013,3,0,16,19,
Mcclain,Superintendent of Public Instruction,John Cox,DEM,440014,0,0,2,2,
Mcclain,Superintendent of Public Instruction,Freda Deskin,DEM,440014,1,0,6,7,
Mcclain,U.S. Senate,Connie Johnson,DEM,440014,1,0,5,6,
Mcclain,U.S. Senate,Jim Rogers,DEM,440014,0,0,3,3,
Mcclain,Superintendent of Public Instruction,John Cox,DEM,440015,1,0,22,23,
Mcclain,Superintendent of Public Instruction,Freda Deskin,DEM,440015,2,0,8,10,
Mcclain,U.S. Senate,Connie Johnson,DEM,440015,3,0,13,16,
Mcclain,U.S. Senate,Jim Rogers,DEM,440015,0,0,14,14,
Mcclain,Superintendent of Public Instruction,John Cox,DEM,440016,3,0,48,51,
Mcclain,Superintendent of Public Instruction,Freda Deskin,DEM,440016,4,0,16,20,
Mcclain,U.S. Senate,Connie Johnson,DEM,440016,3,0,37,40,
Mcclain,U.S. Senate,Jim Rogers,DEM,440016,4,0,27,31,
Mcclain,Superintendent of Public Instruction,John Cox,DEM,440017,1,0,7,8,
Mcclain,Superintendent of Public Instruction,Freda Deskin,DEM,440017,0,0,1,1,
Mcclain,U.S. Senate,Connie Johnson,DEM,440017,0,0,4,4,
Mcclain,U.S. Senate,Jim Rogers,DEM,440017,1,0,4,5,
Mcclain,Superintendent of Public Instruction,John Cox,DEM,440018,2,0,16,18,
Mcclain,Superintendent of Public Instruction,Freda Deskin,DEM,440018,1,0,4,5,
Mcclain,U.S. Senate,Connie Johnson,DEM,440018,2,0,13,15,
Mcclain,U.S. Senate,Jim Rogers,DEM,440018,1,0,7,8,
Mcclain,Superintendent of Public Instruction,John Cox,DEM,440019,2,0,10,12,
Mcclain,Superintendent of Public Instruction,Freda Deskin,DEM,440019,9,0,8,17,
Mcclain,U.S. Senate,Connie Johnson,DEM,440019,2,0,9,11,
Mcclain,U.S. Senate,Jim Rogers,DEM,440019,8,0,9,17,
Mcclain,Superintendent of Public Instruction,John Cox,DEM,440020,0,0,11,11,
Mcclain,Superintendent of Public Instruction,Freda Deskin,DEM,440020,0,0,5,5,
Mcclain,U.S. Senate,Connie Johnson,DEM,440020,0,0,6,6,
Mcclain,U.S. Senate,Jim Rogers,DEM,440020,0,0,10,10,
Mcclain,Superintendent of Public Instruction,John Cox,DEM,440021,0,1,12,13,
Mcclain,Superintendent of Public Instruction,Freda Deskin,DEM,440021,0,4,19,23,
Mcclain,U.S. Senate,Connie Johnson,DEM,440021,0,3,17,20,
Mcclain,U.S. Senate,Jim Rogers,DEM,440021,0,2,14,16,
Mcclain,Superintendent of Public Instruction,John Cox,DEM,440023,2,1,11,14,
Mcclain,Superintendent of Public Instruction,Freda Deskin,DEM,440023,0,2,21,23,
Mcclain,U.S. Senate,Connie Johnson,DEM,440023,0,0,15,15,
Mcclain,U.S. Senate,Jim Rogers,DEM,440023,2,3,17,22,
Mcclain,Superintendent of Public Instruction,John Cox,DEM,440024,3,0,21,24,
Mcclain,Superintendent of Public Instruction,Freda Deskin,DEM,440024,5,3,31,39,
Mcclain,U.S. Senate,Connie Johnson,DEM,440024,7,1,26,34,
Mcclain,U.S. Senate,Jim Rogers,DEM,440024,2,2,26,30,
Mcclain,Superintendent of Public Instruction,John Cox,DEM,440026,0,0,4,4,
Mcclain,Superintendent of Public Instruction,Freda Deskin,DEM,440026,0,1,4,5,
Mcclain,U.S. Senate,Connie Johnson,DEM,440026,0,1,1,2,
Mcclain,U.S. Senate,Jim Rogers,DEM,440026,0,0,7,7,
Mcclain,Superintendent of Public Instruction,John Cox,DEM,440027,0,0,6,6,
Mcclain,Superintendent of Public Instruction,Freda Deskin,DEM,440027,3,0,3,6,
Mcclain,U.S. Senate,Connie Johnson,DEM,440027,1,0,3,4,
Mcclain,U.S. Senate,Jim Rogers,DEM,440027,2,0,5,7,
Mcclain,Superintendent of Public Instruction,John Cox,DEM,440028,2,0,3,5,
Mcclain,Superintendent of Public Instruction,Freda Deskin,DEM,440028,1,0,4,5,
Mcclain,U.S. Senate,Connie Johnson,DEM,440028,3,0,4,7,
Mcclain,U.S. Senate,Jim Rogers,DEM,440028,0,0,3,3,
Mccurtain,Superintendent of Public Instruction,John Cox,DEM,450002,0,0,10,10,
Mccurtain,Superintendent of Public Instruction,Freda Deskin,DEM,450002,0,0,0,0,
Mccurtain,U.S. Senate,Connie Johnson,DEM,450002,0,0,3,3,
Mccurtain,U.S. Senate,Jim Rogers,DEM,450002,0,0,8,8,
Mccurtain,Superintendent of Public Instruction,John Cox,DEM,450004,0,4,20,24,
Mccurtain,Superintendent of Public Instruction,Freda Deskin,DEM,450004,0,0,6,6,
Mccurtain,U.S. Senate,Connie Johnson,DEM,450004,1,4,11,16,
Mccurtain,U.S. Senate,Jim Rogers,DEM,450004,0,0,14,14,
Mccurtain,Superintendent of Public Instruction,John Cox,DEM,450005,1,0,10,11,
Mccurtain,Superintendent of Public Instruction,Freda Deskin,DEM,450005,1,0,7,8,
Mccurtain,U.S. Senate,Connie Johnson,DEM,450005,1,0,16,17,
Mccurtain,U.S. Senate,Jim Rogers,DEM,450005,1,0,1,2,
Mccurtain,Superintendent of Public Instruction,John Cox,DEM,450006,5,1,21,27,
Mccurtain,Superintendent of Public Instruction,Freda Deskin,DEM,450006,1,0,6,7,
Mccurtain,U.S. Senate,Connie Johnson,DEM,450006,2,1,11,14,
Mccurtain,U.S. Senate,Jim Rogers,DEM,450006,4,0,12,16,
Mccurtain,Superintendent of Public Instruction,John Cox,DEM,450008,3,0,19,22,
Mccurtain,Superintendent of Public Instruction,Freda Deskin,DEM,450008,0,2,2,4,
Mccurtain,U.S. Senate,Connie Johnson,DEM,450008,3,1,6,10,
Mccurtain,U.S. Senate,Jim Rogers,DEM,450008,0,1,13,14,
Mccurtain,Superintendent of Public Instruction,John Cox,DEM,450009,0,2,17,19,
Mccurtain,Superintendent of Public Instruction,Freda Deskin,DEM,450009,0,0,1,1,
Mccurtain,U.S. Senate,Connie Johnson,DEM,450009,0,1,9,10,
Mccurtain,U.S. Senate,Jim Rogers,DEM,450009,0,1,9,10,
Mccurtain,Superintendent of Public Instruction,John Cox,DEM,450011,0,0,20,20,
Mccurtain,Superintendent of Public Instruction,Freda Deskin,DEM,450011,0,0,2,2,
Mccurtain,U.S. Senate,Connie Johnson,DEM,450011,0,0,2,2,
Mccurtain,U.S. Senate,Jim Rogers,DEM,450011,0,0,15,15,
Mccurtain,Superintendent of Public Instruction,John Cox,DEM,450012,0,0,11,11,
Mccurtain,Superintendent of Public Instruction,Freda Deskin,DEM,450012,0,0,2,2,
Mccurtain,U.S. Senate,Connie Johnson,DEM,450012,0,0,1,1,
Mccurtain,U.S. Senate,Jim Rogers,DEM,450012,0,0,12,12,
Mccurtain,Superintendent of Public Instruction,John Cox,DEM,450013,0,4,16,20,
Mccurtain,Superintendent of Public Instruction,Freda Deskin,DEM,450013,0,0,4,4,
Mccurtain,U.S. Senate,Connie Johnson,DEM,450013,0,1,7,8,
Mccurtain,U.S. Senate,Jim Rogers,DEM,450013,0,2,12,14,
Mccurtain,Superintendent of Public Instruction,John Cox,DEM,450014,0,0,11,11,
Mccurtain,Superintendent of Public Instruction,Freda Deskin,DEM,450014,0,0,0,0,
Mccurtain,U.S. Senate,Connie Johnson,DEM,450014,0,0,6,6,
Mccurtain,U.S. Senate,Jim Rogers,DEM,450014,0,0,4,4,
Mccurtain,Superintendent of Public Instruction,John Cox,DEM,450015,0,0,9,9,
Mccurtain,Superintendent of Public Instruction,Freda Deskin,DEM,450015,0,0,3,3,
Mccurtain,U.S. Senate,Connie Johnson,DEM,450015,0,0,4,4,
Mccurtain,U.S. Senate,Jim Rogers,DEM,450015,0,0,8,8,
Mccurtain,Superintendent of Public Instruction,John Cox,DEM,450017,1,0,8,9,
Mccurtain,Superintendent of Public Instruction,Freda Deskin,DEM,450017,0,0,5,5,
Mccurtain,U.S. Senate,Connie Johnson,DEM,450017,1,0,8,9,
Mccurtain,U.S. Senate,Jim Rogers,DEM,450017,0,0,5,5,
Mccurtain,Superintendent of Public Instruction,John Cox,DEM,450018,5,0,32,37,
Mccurtain,Superintendent of Public Instruction,Freda Deskin,DEM,450018,3,0,11,14,
Mccurtain,U.S. Senate,Connie Johnson,DEM,450018,6,0,17,23,
Mccurtain,U.S. Senate,Jim Rogers,DEM,450018,3,0,25,28,
Mccurtain,Superintendent of Public Instruction,John Cox,DEM,450019,0,0,22,22,
Mccurtain,Superintendent of Public Instruction,Freda Deskin,DEM,450019,2,0,4,6,
Mccurtain,U.S. Senate,Connie Johnson,DEM,450019,1,0,6,7,
Mccurtain,U.S. Senate,Jim Rogers,DEM,450019,1,0,18,19,
Mccurtain,Superintendent of Public Instruction,John Cox,DEM,450020,2,1,16,19,
Mccurtain,Superintendent of Public Instruction,Freda Deskin,DEM,450020,0,0,3,3,
Mccurtain,U.S. Senate,Connie Johnson,DEM,450020,1,1,6,8,
Mccurtain,U.S. Senate,Jim Rogers,DEM,450020,1,0,12,13,
Mccurtain,Superintendent of Public Instruction,John Cox,DEM,450022,2,0,9,11,
Mccurtain,Superintendent of Public Instruction,Freda Deskin,DEM,450022,0,1,1,2,
Mccurtain,U.S. Senate,Connie Johnson,DEM,450022,2,0,4,6,
Mccurtain,U.S. Senate,Jim Rogers,DEM,450022,0,1,6,7,
Mccurtain,Superintendent of Public Instruction,John Cox,DEM,450023,1,0,15,16,
Mccurtain,Superintendent of Public Instruction,Freda Deskin,DEM,450023,0,0,1,1,
Mccurtain,U.S. Senate,Connie Johnson,DEM,450023,1,0,5,6,
Mccurtain,U.S. Senate,Jim Rogers,DEM,450023,0,0,11,11,
Mccurtain,Superintendent of Public Instruction,John Cox,DEM,450024,2,0,12,14,
Mccurtain,Superintendent of Public Instruction,Freda Deskin,DEM,450024,0,0,0,0,
Mccurtain,U.S. Senate,Connie Johnson,DEM,450024,0,0,3,3,
Mccurtain,U.S. Senate,Jim Rogers,DEM,450024,2,0,9,11,
Mccurtain,Superintendent of Public Instruction,John Cox,DEM,450025,0,0,15,15,
Mccurtain,Superintendent of Public Instruction,Freda Deskin,DEM,450025,0,0,2,2,
Mccurtain,U.S. Senate,Connie Johnson,DEM,450025,0,0,9,9,
Mccurtain,U.S. Senate,Jim Rogers,DEM,450025,0,0,7,7,
Mccurtain,Superintendent of Public Instruction,John Cox,DEM,450026,0,0,14,14,
Mccurtain,Superintendent of Public Instruction,Freda Deskin,DEM,450026,0,0,2,2,
Mccurtain,U.S. Senate,Connie Johnson,DEM,450026,0,0,6,6,
Mccurtain,U.S. Senate,Jim Rogers,DEM,450026,0,0,10,10,
Mccurtain,Superintendent of Public Instruction,John Cox,DEM,450027,0,0,17,17,
Mccurtain,Superintendent of Public Instruction,Freda Deskin,DEM,450027,0,0,0,0,
Mccurtain,U.S. Senate,Connie Johnson,DEM,450027,0,0,1,1,
Mccurtain,U.S. Senate,Jim Rogers,DEM,450027,0,0,15,15,
Mccurtain,Superintendent of Public Instruction,John Cox,DEM,450028,0,0,2,2,
Mccurtain,Superintendent of Public Instruction,Freda Deskin,DEM,450028,0,0,1,1,
Mccurtain,U.S. Senate,Connie Johnson,DEM,450028,0,0,1,1,
Mccurtain,U.S. Senate,Jim Rogers,DEM,450028,0,0,2,2,
Mccurtain,Superintendent of Public Instruction,John Cox,DEM,450029,1,0,19,20,
Mccurtain,Superintendent of Public Instruction,Freda Deskin,DEM,450029,0,0,2,2,
Mccurtain,U.S. Senate,Connie Johnson,DEM,450029,0,0,5,5,
Mccurtain,U.S. Senate,Jim Rogers,DEM,450029,1,0,16,17,
Mccurtain,Superintendent of Public Instruction,John Cox,DEM,450031,2,0,22,24,
Mccurtain,Superintendent of Public Instruction,Freda Deskin,DEM,450031,0,1,1,2,
Mccurtain,U.S. Senate,Connie Johnson,DEM,450031,0,1,6,7,
Mccurtain,U.S. Senate,Jim Rogers,DEM,450031,2,0,16,18,
Mccurtain,Superintendent of Public Instruction,John Cox,DEM,450033,1,1,34,36,
Mccurtain,Superintendent of Public Instruction,Freda Deskin,DEM,450033,0,0,0,0,
Mccurtain,U.S. Senate,Connie Johnson,DEM,450033,1,1,9,11,
Mccurtain,U.S. Senate,Jim Rogers,DEM,450033,0,0,23,23,
Mccurtain,Superintendent of Public Instruction,John Cox,DEM,450034,0,0,11,11,
Mccurtain,Superintendent of Public Instruction,Freda Deskin,DEM,450034,0,0,7,7,
Mccurtain,U.S. Senate,Connie Johnson,DEM,450034,0,0,9,9,
Mccurtain,U.S. Senate,Jim Rogers,DEM,450034,0,0,8,8,
Mccurtain,Superintendent of Public Instruction,John Cox,DEM,450035,0,0,42,42,
Mccurtain,Superintendent of Public Instruction,Freda Deskin,DEM,450035,0,0,6,6,
Mccurtain,U.S. Senate,Connie Johnson,DEM,450035,0,0,24,24,
Mccurtain,U.S. Senate,Jim Rogers,DEM,450035,0,0,24,24,
Mccurtain,Superintendent of Public Instruction,John Cox,DEM,450036,1,1,11,13,
Mccurtain,Superintendent of Public Instruction,Freda Deskin,DEM,450036,0,0,4,4,
Mccurtain,U.S. Senate,Connie Johnson,DEM,450036,0,0,5,5,
Mccurtain,U.S. Senate,Jim Rogers,DEM,450036,1,1,10,12,
Mccurtain,Superintendent of Public Instruction,John Cox,DEM,450037,1,0,12,13,
Mccurtain,Superintendent of Public Instruction,Freda Deskin,DEM,450037,0,0,3,3,
Mccurtain,U.S. Senate,Connie Johnson,DEM,450037,1,0,4,5,
Mccurtain,U.S. Senate,Jim Rogers,DEM,450037,0,0,11,11,
Mccurtain,Superintendent of Public Instruction,John Cox,DEM,450038,2,0,38,40,
Mccurtain,Superintendent of Public Instruction,Freda Deskin,DEM,450038,0,0,7,7,
Mccurtain,U.S. Senate,Connie Johnson,DEM,450038,2,0,13,15,
Mccurtain,U.S. Senate,Jim Rogers,DEM,450038,0,0,30,30,
Mcintosh,Superintendent of Public Instruction,John Cox,DEM,460102,10,4,198,212,
Mcintosh,Superintendent of Public Instruction,Freda Deskin,DEM,460102,1,5,75,81,
Mcintosh,U.S. Senate,Connie Johnson,DEM,460102,7,6,109,122,
Mcintosh,U.S. Senate,Jim Rogers,DEM,460102,5,3,158,166,
Mcintosh,State Senate,Selina Jayne-Dornan,DEM,460102,7,8,184,199,8
Mcintosh,State Senate,Gary Clason,DEM,460102,5,1,99,105,8
Mcintosh,Superintendent of Public Instruction,John Cox,DEM,460103,3,8,282,293,
Mcintosh,Superintendent of Public Instruction,Freda Deskin,DEM,460103,6,0,93,99,
Mcintosh,U.S. Senate,Connie Johnson,DEM,460103,4,2,142,148,
Mcintosh,U.S. Senate,Jim Rogers,DEM,460103,4,7,219,230,
Mcintosh,State Senate,Selina Jayne-Dornan,DEM,460103,8,2,236,246,8
Mcintosh,State Senate,Gary Clason,DEM,460103,1,7,135,143,8
Mcintosh,Superintendent of Public Instruction,John Cox,DEM,460104,10,3,182,195,
Mcintosh,Superintendent of Public Instruction,Freda Deskin,DEM,460104,1,2,68,71,
Mcintosh,U.S. Senate,Connie Johnson,DEM,460104,7,1,76,84,
Mcintosh,U.S. Senate,Jim Rogers,DEM,460104,4,4,168,176,
Mcintosh,State Senate,Selina Jayne-Dornan,DEM,460104,4,1,148,153,8
Mcintosh,State Senate,Gary Clason,DEM,460104,7,4,104,115,8
Mcintosh,Superintendent of Public Instruction,John Cox,DEM,460201,4,8,134,146,
Mcintosh,Superintendent of Public Instruction,Freda Deskin,DEM,460201,2,11,63,76,
Mcintosh,U.S. Senate,Connie Johnson,DEM,460201,3,14,104,121,
Mcintosh,U.S. Senate,Jim Rogers,DEM,460201,3,5,91,99,
Mcintosh,State Senate,Selina Jayne-Dornan,DEM,460201,6,15,123,144,8
Mcintosh,State Senate,Gary Clason,DEM,460201,1,4,77,82,8
Mcintosh,Superintendent of Public Instruction,John Cox,DEM,460203,2,1,63,66,
Mcintosh,Superintendent of Public Instruction,Freda Deskin,DEM,460203,2,4,34,40,
Mcintosh,U.S. Senate,Connie Johnson,DEM,460203,2,3,37,42,
Mcintosh,U.S. Senate,Jim Rogers,DEM,460203,2,2,56,60,
Mcintosh,State Senate,Selina Jayne-Dornan,DEM,460203,2,4,54,60,8
Mcintosh,State Senate,Gary Clason,DEM,460203,2,2,46,50,8
Mcintosh,Superintendent of Public Instruction,John Cox,DEM,460205,0,3,45,48,
Mcintosh,Superintendent of Public Instruction,Freda Deskin,DEM,460205,0,1,17,18,
Mcintosh,U.S. Senate,Connie Johnson,DEM,460205,0,3,25,28,
Mcintosh,U.S. Senate,Jim Rogers,DEM,460205,0,1,36,37,
Mcintosh,State Senate,Selina Jayne-Dornan,DEM,460205,0,2,40,42,8
Mcintosh,State Senate,Gary Clason,DEM,460205,0,2,22,24,8
Mcintosh,Superintendent of Public Instruction,John Cox,DEM,460307,1,7,68,76,
Mcintosh,Superintendent of Public Instruction,Freda Deskin,DEM,460307,1,1,16,18,
Mcintosh,U.S. Senate,Connie Johnson,DEM,460307,0,2,25,27,
Mcintosh,U.S. Senate,Jim Rogers,DEM,460307,2,6,56,64,
Mcintosh,State Senate,Selina Jayne-Dornan,DEM,460307,0,3,48,51,8
Mcintosh,State Senate,Gary Clason,DEM,460307,2,6,38,46,8
Mcintosh,Superintendent of Public Instruction,John Cox,DEM,460310,1,2,38,41,
Mcintosh,Superintendent of Public Instruction,Freda Deskin,DEM,460310,0,1,6,7,
Mcintosh,U.S. Senate,Connie Johnson,DEM,460310,0,1,14,15,
Mcintosh,U.S. Senate,Jim Rogers,DEM,460310,1,2,30,33,
Mcintosh,State Senate,Selina Jayne-Dornan,DEM,460310,1,0,34,35,8
Mcintosh,State Senate,Gary Clason,DEM,460310,0,3,12,15,8
Mcintosh,Superintendent of Public Instruction,John Cox,DEM,460311,1,1,38,40,
Mcintosh,Superintendent of Public Instruction,Freda Deskin,DEM,460311,0,1,19,20,
Mcintosh,U.S. Senate,Connie Johnson,DEM,460311,0,1,23,24,
Mcintosh,U.S. Senate,Jim Rogers,DEM,460311,1,1,34,36,
Mcintosh,State Senate,Selina Jayne-Dornan,DEM,460311,0,0,34,34,8
Mcintosh,State Senate,Gary Clason,DEM,460311,1,2,24,27,8
Mcintosh,Superintendent of Public Instruction,John Cox,DEM,460312,0,0,10,10,
Mcintosh,Superintendent of Public Instruction,Freda Deskin,DEM,460312,0,0,6,6,
Mcintosh,U.S. Senate,Connie Johnson,DEM,460312,0,0,5,5,
Mcintosh,U.S. Senate,Jim Rogers,DEM,460312,0,0,11,11,
Mcintosh,State Senate,Selina Jayne-Dornan,DEM,460312,0,0,12,12,8
Mcintosh,State Senate,Gary Clason,DEM,460312,0,0,5,5,8
Mcintosh,Superintendent of Public Instruction,John Cox,DEM,460313,0,0,11,11,
Mcintosh,Superintendent of Public Instruction,Freda Deskin,DEM,460313,0,0,3,3,
Mcintosh,U.S. Senate,Connie Johnson,DEM,460313,0,0,3,3,
Mcintosh,U.S. Senate,Jim Rogers,DEM,460313,0,0,11,11,
Mcintosh,State Senate,Selina Jayne-Dornan,DEM,460313,0,0,3,3,8
Mcintosh,State Senate,Gary Clason,DEM,460313,0,0,11,11,8
Mcintosh,Superintendent of Public Instruction,John Cox,DEM,460314,3,5,54,62,
Mcintosh,Superintendent of Public Instruction,Freda Deskin,DEM,460314,0,1,24,25,
Mcintosh,U.S. Senate,Connie Johnson,DEM,460314,1,3,41,45,
Mcintosh,U.S. Senate,Jim Rogers,DEM,460314,2,2,36,40,
Mcintosh,State Senate,Selina Jayne-Dornan,DEM,460314,4,5,45,54,8
Mcintosh,State Senate,Gary Clason,DEM,460314,0,1,32,33,8
Mcintosh,Superintendent of Public Instruction,John Cox,DEM,460315,0,0,48,48,
Mcintosh,Superintendent of Public Instruction,Freda Deskin,DEM,460315,2,0,5,7,
Mcintosh,U.S. Senate,Connie Johnson,DEM,460315,2,0,18,20,
Mcintosh,U.S. Senate,Jim Rogers,DEM,460315,0,0,32,32,
Mcintosh,State Senate,Selina Jayne-Dornan,DEM,460315,0,0,30,30,8
Mcintosh,State Senate,Gary Clason,DEM,460315,2,0,23,25,8
Mcintosh,Superintendent of Public Instruction,John Cox,DEM,460316,0,1,26,27,
Mcintosh,Superintendent of Public Instruction,Freda Deskin,DEM,460316,0,0,8,8,
Mcintosh,U.S. Senate,Connie Johnson,DEM,460316,0,1,15,16,
Mcintosh,U.S. Senate,Jim Rogers,DEM,460316,0,0,17,17,
Mcintosh,State Senate,Selina Jayne-Dornan,DEM,460316,0,1,24,25,8
Mcintosh,State Senate,Gary Clason,DEM,460316,0,0,11,11,8
Major,Superintendent of Public Instruction,John Cox,DEM,470002,2,1,12,15,
Major,Superintendent of Public Instruction,Freda Deskin,DEM,470002,0,1,4,5,
Major,U.S. Senate,Connie Johnson,DEM,470002,0,2,10,12,
Major,U.S. Senate,Jim Rogers,DEM,470002,2,0,6,8,
Major,Superintendent of Public Instruction,John Cox,DEM,470004,0,0,5,5,
Major,Superintendent of Public Instruction,Freda Deskin,DEM,470004,0,1,9,10,
Major,U.S. Senate,Connie Johnson,DEM,470004,0,1,7,8,
Major,U.S. Senate,Jim Rogers,DEM,470004,0,0,7,7,
Major,Superintendent of Public Instruction,John Cox,DEM,470009,0,0,2,2,
Major,Superintendent of Public Instruction,Freda Deskin,DEM,470009,0,0,1,1,
Major,U.S. Senate,Connie Johnson,DEM,470009,0,0,1,1,
Major,U.S. Senate,Jim Rogers,DEM,470009,0,0,2,2,
Major,Superintendent of Public Instruction,John Cox,DEM,470010,2,0,6,8,
Major,Superintendent of Public Instruction,Freda Deskin,DEM,470010,0,0,1,1,
Major,U.S. Senate,Connie Johnson,DEM,470010,0,0,2,2,
Major,U.S. Senate,Jim Rogers,DEM,470010,2,0,5,7,
Major,Superintendent of Public Instruction,John Cox,DEM,470015,0,0,2,2,
Major,Superintendent of Public Instruction,Freda Deskin,DEM,470015,0,0,2,2,
Major,U.S. Senate,Connie Johnson,DEM,470015,0,0,2,2,
Major,U.S. Senate,Jim Rogers,DEM,470015,0,0,2,2,
Major,Superintendent of Public Instruction,John Cox,DEM,470016,0,0,2,2,
Major,Superintendent of Public Instruction,Freda Deskin,DEM,470016,0,0,4,4,
Major,U.S. Senate,Connie Johnson,DEM,470016,0,0,6,6,
Major,U.S. Senate,Jim Rogers,DEM,470016,0,0,0,0,
Major,Superintendent of Public Instruction,John Cox,DEM,470020,3,0,27,30,
Major,Superintendent of Public Instruction,Freda Deskin,DEM,470020,5,0,14,19,
Major,U.S. Senate,Connie Johnson,DEM,470020,7,0,14,21,
Major,U.S. Senate,Jim Rogers,DEM,470020,1,0,26,27,
Major,Superintendent of Public Instruction,John Cox,DEM,470022,2,0,21,23,
Major,Superintendent of Public Instruction,Freda Deskin,DEM,470022,0,4,15,19,
Major,U.S. Senate,Connie Johnson,DEM,470022,0,3,16,19,
Major,U.S. Senate,Jim Rogers,DEM,470022,2,1,20,23,
Marshall,Superintendent of Public Instruction,John Cox,DEM,480101,2,2,29,33,
Marshall,Superintendent of Public Instruction,Freda Deskin,DEM,480101,0,1,12,13,
Marshall,U.S. Senate,Connie Johnson,DEM,480101,2,1,15,18,
Marshall,U.S. Senate,Jim Rogers,DEM,480101,0,2,24,26,
Marshall,Superintendent of Public Instruction,John Cox,DEM,480102,3,3,19,25,
Marshall,Superintendent of Public Instruction,Freda Deskin,DEM,480102,1,1,5,7,
Marshall,U.S. Senate,Connie Johnson,DEM,480102,4,4,9,17,
Marshall,U.S. Senate,Jim Rogers,DEM,480102,0,0,12,12,
Marshall,Superintendent of Public Instruction,John Cox,DEM,480105,0,3,7,10,
Marshall,Superintendent of Public Instruction,Freda Deskin,DEM,480105,2,1,6,9,
Marshall,U.S. Senate,Connie Johnson,DEM,480105,2,3,3,8,
Marshall,U.S. Senate,Jim Rogers,DEM,480105,0,1,10,11,
Marshall,Superintendent of Public Instruction,John Cox,DEM,480106,0,0,2,2,
Marshall,Superintendent of Public Instruction,Freda Deskin,DEM,480106,0,0,2,2,
Marshall,U.S. Senate,Connie Johnson,DEM,480106,0,0,2,2,
Marshall,U.S. Senate,Jim Rogers,DEM,480106,0,0,2,2,
Marshall,Superintendent of Public Instruction,John Cox,DEM,480201,0,0,13,13,
Marshall,Superintendent of Public Instruction,Freda Deskin,DEM,480201,0,1,3,4,
Marshall,U.S. Senate,Connie Johnson,DEM,480201,0,1,7,8,
Marshall,U.S. Senate,Jim Rogers,DEM,480201,0,0,9,9,
Marshall,Superintendent of Public Instruction,John Cox,DEM,480202,1,1,26,28,
Marshall,Superintendent of Public Instruction,Freda Deskin,DEM,480202,3,0,6,9,
Marshall,U.S. Senate,Connie Johnson,DEM,480202,3,0,12,15,
Marshall,U.S. Senate,Jim Rogers,DEM,480202,1,1,20,22,
Marshall,Superintendent of Public Instruction,John Cox,DEM,480204,2,2,27,31,
Marshall,Superintendent of Public Instruction,Freda Deskin,DEM,480204,1,1,1,3,
Marshall,U.S. Senate,Connie Johnson,DEM,480204,2,3,11,16,
Marshall,U.S. Senate,Jim Rogers,DEM,480204,1,0,16,17,
Marshall,Superintendent of Public Instruction,John Cox,DEM,480206,1,1,10,12,
Marshall,Superintendent of Public Instruction,Freda Deskin,DEM,480206,0,0,4,4,
Marshall,U.S. Senate,Connie Johnson,DEM,480206,1,1,8,10,
Marshall,U.S. Senate,Jim Rogers,DEM,480206,0,0,7,7,
Marshall,Superintendent of Public Instruction,John Cox,DEM,480302,2,1,19,22,
Marshall,Superintendent of Public Instruction,Freda Deskin,DEM,480302,0,0,1,1,
Marshall,U.S. Senate,Connie Johnson,DEM,480302,1,0,6,7,
Marshall,U.S. Senate,Jim Rogers,DEM,480302,1,0,15,16,
Marshall,Superintendent of Public Instruction,John Cox,DEM,480303,0,1,20,21,
Marshall,Superintendent of Public Instruction,Freda Deskin,DEM,480303,2,1,12,15,
Marshall,U.S. Senate,Connie Johnson,DEM,480303,1,1,16,18,
Marshall,U.S. Senate,Jim Rogers,DEM,480303,1,1,15,17,
Marshall,Superintendent of Public Instruction,John Cox,DEM,480304,0,1,28,29,
Marshall,Superintendent of Public Instruction,Freda Deskin,DEM,480304,1,0,5,6,
Marshall,U.S. Senate,Connie Johnson,DEM,480304,1,0,16,17,
Marshall,U.S. Senate,Jim Rogers,DEM,480304,0,1,16,17,
Mayes,Superintendent of Public Instruction,John Cox,DEM,490011,0,1,55,56,
Mayes,Superintendent of Public Instruction,Freda Deskin,DEM,490011,0,0,9,9,
Mayes,U.S. Senate,Connie Johnson,DEM,490011,0,1,17,18,
Mayes,U.S. Senate,Jim Rogers,DEM,490011,0,0,47,47,
Mayes,Superintendent of Public Instruction,John Cox,DEM,490012,3,8,72,83,
Mayes,Superintendent of Public Instruction,Freda Deskin,DEM,490012,1,0,14,15,
Mayes,U.S. Senate,Connie Johnson,DEM,490012,2,1,24,27,
Mayes,U.S. Senate,Jim Rogers,DEM,490012,2,6,60,68,
Mayes,Superintendent of Public Instruction,John Cox,DEM,490014,0,1,23,24,
Mayes,Superintendent of Public Instruction,Freda Deskin,DEM,490014,0,0,7,7,
Mayes,U.S. Senate,Connie Johnson,DEM,490014,0,1,11,12,
Mayes,U.S. Senate,Jim Rogers,DEM,490014,0,0,19,19,
Mayes,Superintendent of Public Instruction,John Cox,DEM,490015,0,10,50,60,
Mayes,Superintendent of Public Instruction,Freda Deskin,DEM,490015,0,0,6,6,
Mayes,U.S. Senate,Connie Johnson,DEM,490015,0,5,24,29,
Mayes,U.S. Senate,Jim Rogers,DEM,490015,0,2,31,33,
Mayes,Superintendent of Public Instruction,John Cox,DEM,490016,3,14,57,74,
Mayes,Superintendent of Public Instruction,Freda Deskin,DEM,490016,1,2,2,5,
Mayes,U.S. Senate,Connie Johnson,DEM,490016,2,4,30,36,
Mayes,U.S. Senate,Jim Rogers,DEM,490016,2,10,25,37,
Mayes,Superintendent of Public Instruction,John Cox,DEM,490020,2,17,113,132,
Mayes,Superintendent of Public Instruction,Freda Deskin,DEM,490020,0,3,13,16,
Mayes,U.S. Senate,Connie Johnson,DEM,490020,2,9,62,73,
Mayes,U.S. Senate,Jim Rogers,DEM,490020,0,10,59,69,
Mayes,Superintendent of Public Instruction,John Cox,DEM,490021,2,4,35,41,
Mayes,Superintendent of Public Instruction,Freda Deskin,DEM,490021,0,0,5,5,
Mayes,U.S. Senate,Connie Johnson,DEM,490021,2,1,21,24,
Mayes,U.S. Senate,Jim Rogers,DEM,490021,0,3,18,21,
Mayes,Superintendent of Public Instruction,John Cox,DEM,490022,2,2,78,82,
Mayes,Superintendent of Public Instruction,Freda Deskin,DEM,490022,0,2,16,18,
Mayes,U.S. Senate,Connie Johnson,DEM,490022,2,1,25,28,
Mayes,U.S. Senate,Jim Rogers,DEM,490022,0,3,65,68,
Mayes,Superintendent of Public Instruction,John Cox,DEM,490023,0,2,89,91,
Mayes,Superintendent of Public Instruction,Freda Deskin,DEM,490023,0,2,18,20,
Mayes,U.S. Senate,Connie Johnson,DEM,490023,0,1,45,46,
Mayes,U.S. Senate,Jim Rogers,DEM,490023,0,3,58,61,
Mayes,Superintendent of Public Instruction,John Cox,DEM,490024,0,1,30,31,
Mayes,Superintendent of Public Instruction,Freda Deskin,DEM,490024,2,0,9,11,
Mayes,U.S. Senate,Connie Johnson,DEM,490024,2,0,13,15,
Mayes,U.S. Senate,Jim Rogers,DEM,490024,0,0,24,24,
Mayes,Superintendent of Public Instruction,John Cox,DEM,490025,2,1,40,43,
Mayes,Superintendent of Public Instruction,Freda Deskin,DEM,490025,0,2,4,6,
Mayes,U.S. Senate,Connie Johnson,DEM,490025,1,2,16,19,
Mayes,U.S. Senate,Jim Rogers,DEM,490025,1,0,24,25,
Mayes,Superintendent of Public Instruction,John Cox,DEM,490026,0,0,2,2,
Mayes,Superintendent of Public Instruction,Freda Deskin,DEM,490026,0,0,1,1,
Mayes,U.S. Senate,Connie Johnson,DEM,490026,0,0,2,2,
Mayes,U.S. Senate,Jim Rogers,DEM,490026,0,0,1,1,
Mayes,Superintendent of Public Instruction,John Cox,DEM,490027,0,0,5,5,
Mayes,Superintendent of Public Instruction,Freda Deskin,DEM,490027,0,0,1,1,
Mayes,U.S. Senate,Connie Johnson,DEM,490027,0,0,2,2,
Mayes,U.S. Senate,Jim Rogers,DEM,490027,0,0,4,4,
Mayes,Superintendent of Public Instruction,John Cox,DEM,490031,2,1,55,58,
Mayes,Superintendent of Public Instruction,Freda Deskin,DEM,490031,1,0,12,13,
Mayes,U.S. Senate,Connie Johnson,DEM,490031,2,1,30,33,
Mayes,U.S. Senate,Jim Rogers,DEM,490031,1,0,34,35,
Mayes,Superintendent of Public Instruction,John Cox,DEM,490034,2,4,38,44,
Mayes,Superintendent of Public Instruction,Freda Deskin,DEM,490034,2,0,6,8,
Mayes,U.S. Senate,Connie Johnson,DEM,490034,2,2,9,13,
Mayes,U.S. Senate,Jim Rogers,DEM,490034,2,2,34,38,
Mayes,Superintendent of Public Instruction,John Cox,DEM,490036,1,7,189,197,
Mayes,Superintendent of Public Instruction,Freda Deskin,DEM,490036,3,0,21,24,
Mayes,U.S. Senate,Connie Johnson,DEM,490036,2,4,77,83,
Mayes,U.S. Senate,Jim Rogers,DEM,490036,2,3,122,127,
Mayes,Superintendent of Public Instruction,John Cox,DEM,490037,0,1,86,87,
Mayes,Superintendent of Public Instruction,Freda Deskin,DEM,490037,0,1,15,16,
Mayes,U.S. Senate,Connie Johnson,DEM,490037,0,1,32,33,
Mayes,U.S. Senate,Jim Rogers,DEM,490037,0,1,62,63,
Mayes,Superintendent of Public Instruction,John Cox,DEM,490038,0,0,30,30,
Mayes,Superintendent of Public Instruction,Freda Deskin,DEM,490038,0,1,3,4,
Mayes,U.S. Senate,Connie Johnson,DEM,490038,0,0,11,11,
Mayes,U.S. Senate,Jim Rogers,DEM,490038,0,1,19,20,
Mayes,Superintendent of Public Instruction,John Cox,DEM,490039,2,2,168,172,
Mayes,Superintendent of Public Instruction,Freda Deskin,DEM,490039,0,0,14,14,
Mayes,U.S. Senate,Connie Johnson,DEM,490039,1,1,55,57,
Mayes,U.S. Senate,Jim Rogers,DEM,490039,1,1,116,118,
Mayes,Superintendent of Public Instruction,John Cox,DEM,490101,1,5,71,77,
Mayes,Superintendent of Public Instruction,Freda Deskin,DEM,490101,1,2,11,14,
Mayes,U.S. Senate,Connie Johnson,DEM,490101,2,3,23,28,
Mayes,U.S. Senate,Jim Rogers,DEM,490101,0,4,51,55,
Mayes,Superintendent of Public Instruction,John Cox,DEM,490121,5,21,119,145,
Mayes,Superintendent of Public Instruction,Freda Deskin,DEM,490121,0,1,10,11,
Mayes,U.S. Senate,Connie Johnson,DEM,490121,4,8,47,59,
Mayes,U.S. Senate,Jim Rogers,DEM,490121,1,12,76,89,
Mayes,Superintendent of Public Instruction,John Cox,DEM,490122,0,1,12,13,
Mayes,Superintendent of Public Instruction,Freda Deskin,DEM,490122,0,0,2,2,
Mayes,U.S. Senate,Connie Johnson,DEM,490122,0,0,7,7,
Mayes,U.S. Senate,Jim Rogers,DEM,490122,0,1,7,8,
Mayes,Superintendent of Public Instruction,John Cox,DEM,490130,3,7,58,68,
Mayes,Superintendent of Public Instruction,Freda Deskin,DEM,490130,0,1,4,5,
Mayes,U.S. Senate,Connie Johnson,DEM,490130,3,3,27,33,
Mayes,U.S. Senate,Jim Rogers,DEM,490130,0,5,32,37,
Mayes,Superintendent of Public Instruction,John Cox,DEM,490132,4,19,103,126,
Mayes,Superintendent of Public Instruction,Freda Deskin,DEM,490132,0,1,21,22,
Mayes,U.S. Senate,Connie Johnson,DEM,490132,2,9,46,57,
Mayes,U.S. Senate,Jim Rogers,DEM,490132,2,9,73,84,
Mayes,Superintendent of Public Instruction,John Cox,DEM,490241,3,23,231,257,
Mayes,Superintendent of Public Instruction,Freda Deskin,DEM,490241,2,6,40,48,
Mayes,U.S. Senate,Connie Johnson,DEM,490241,4,15,114,133,
Mayes,U.S. Senate,Jim Rogers,DEM,490241,1,13,141,155,
Mayes,Superintendent of Public Instruction,John Cox,DEM,490242,1,17,115,133,
Mayes,Superintendent of Public Instruction,Freda Deskin,DEM,490242,0,0,13,13,
Mayes,U.S. Senate,Connie Johnson,DEM,490242,1,9,51,61,
Mayes,U.S. Senate,Jim Rogers,DEM,490242,0,8,71,79,
Mayes,Superintendent of Public Instruction,John Cox,DEM,490311,0,1,63,64,
Mayes,Superintendent of Public Instruction,Freda Deskin,DEM,490311,0,0,5,5,
Mayes,U.S. Senate,Connie Johnson,DEM,490311,0,0,20,20,
Mayes,U.S. Senate,Jim Rogers,DEM,490311,0,1,44,45,
Murray,Superintendent of Public Instruction,John Cox,DEM,500004,2,11,80,93,
Murray,Superintendent of Public Instruction,Freda Deskin,DEM,500004,1,10,63,74,
Murray,U.S. Senate,Connie Johnson,DEM,500004,2,11,73,86,
Murray,U.S. Senate,Jim Rogers,DEM,500004,1,9,67,77,
Murray,Superintendent of Public Instruction,John Cox,DEM,500005,1,3,55,59,
Murray,Superintendent of Public Instruction,Freda Deskin,DEM,500005,0,3,35,38,
Murray,U.S. Senate,Connie Johnson,DEM,500005,0,3,57,60,
Murray,U.S. Senate,Jim Rogers,DEM,500005,1,3,32,36,
Murray,Superintendent of Public Instruction,John Cox,DEM,500007,0,0,25,25,
Murray,Superintendent of Public Instruction,Freda Deskin,DEM,500007,0,0,10,10,
Murray,U.S. Senate,Connie Johnson,DEM,500007,0,0,17,17,
Murray,U.S. Senate,Jim Rogers,DEM,500007,0,0,17,17,
Murray,Superintendent of Public Instruction,John Cox,DEM,500009,0,1,22,23,
Murray,Superintendent of Public Instruction,Freda Deskin,DEM,500009,1,0,11,12,
Murray,U.S. Senate,Connie Johnson,DEM,500009,0,0,11,11,
Murray,U.S. Senate,Jim Rogers,DEM,500009,1,1,22,24,
Murray,Superintendent of Public Instruction,John Cox,DEM,500012,1,0,10,11,
Murray,Superintendent of Public Instruction,Freda Deskin,DEM,500012,1,0,10,11,
Murray,U.S. Senate,Connie Johnson,DEM,500012,0,0,6,6,
Murray,U.S. Senate,Jim Rogers,DEM,500012,2,0,14,16,
Murray,Superintendent of Public Instruction,John Cox,DEM,500014,0,4,49,53,
Murray,Superintendent of Public Instruction,Freda Deskin,DEM,500014,3,2,26,31,
Murray,U.S. Senate,Connie Johnson,DEM,500014,3,2,23,28,
Murray,U.S. Senate,Jim Rogers,DEM,500014,0,4,52,56,
Murray,Superintendent of Public Instruction,John Cox,DEM,500015,0,27,117,144,
Murray,Superintendent of Public Instruction,Freda Deskin,DEM,500015,3,20,63,86,
Murray,U.S. Senate,Connie Johnson,DEM,500015,3,20,81,104,
Murray,U.S. Senate,Jim Rogers,DEM,500015,0,24,99,123,
Murray,Superintendent of Public Instruction,John Cox,DEM,500017,0,0,15,15,
Murray,Superintendent of Public Instruction,Freda Deskin,DEM,500017,0,0,3,3,
Murray,U.S. Senate,Connie Johnson,DEM,500017,0,0,2,2,
Murray,U.S. Senate,Jim Rogers,DEM,500017,0,0,16,16,
Murray,Superintendent of Public Instruction,John Cox,DEM,500018,0,4,22,26,
Murray,Superintendent of Public Instruction,Freda Deskin,DEM,500018,1,5,18,24,
Murray,U.S. Senate,Connie Johnson,DEM,500018,1,4,19,24,
Murray,U.S. Senate,Jim Rogers,DEM,500018,0,4,19,23,
Murray,Superintendent of Public Instruction,John Cox,DEM,500020,2,4,26,32,
Murray,Superintendent of Public Instruction,Freda Deskin,DEM,500020,2,6,27,35,
Murray,U.S. Senate,Connie Johnson,DEM,500020,3,5,25,33,
Murray,U.S. Senate,Jim Rogers,DEM,500020,1,4,27,32,
Muskogee,Superintendent of Public Instruction,John Cox,DEM,510005,2,11,170,183,
Muskogee,Superintendent of Public Instruction,Freda Deskin,DEM,510005,3,6,93,102,
Muskogee,U.S. Senate,Connie Johnson,DEM,510005,3,7,109,119,
Muskogee,U.S. Senate,Jim Rogers,DEM,510005,2,9,154,165,
Muskogee,Superintendent of Public Instruction,John Cox,DEM,510007,4,18,233,255,
Muskogee,Superintendent of Public Instruction,Freda Deskin,DEM,510007,8,9,173,190,
Muskogee,U.S. Senate,Connie Johnson,DEM,510007,8,15,176,199,
Muskogee,U.S. Senate,Jim Rogers,DEM,510007,4,11,225,240,
Muskogee,Superintendent of Public Instruction,John Cox,DEM,510009,2,17,237,256,
Muskogee,Superintendent of Public Instruction,Freda Deskin,DEM,510009,2,7,135,144,
Muskogee,U.S. Senate,Connie Johnson,DEM,510009,2,8,170,180,
Muskogee,U.S. Senate,Jim Rogers,DEM,510009,2,16,194,212,
Muskogee,Superintendent of Public Instruction,John Cox,DEM,510011,0,0,62,62,
Muskogee,Superintendent of Public Instruction,Freda Deskin,DEM,510011,1,3,56,60,
Muskogee,U.S. Senate,Connie Johnson,DEM,510011,1,3,59,63,
Muskogee,U.S. Senate,Jim Rogers,DEM,510011,0,0,60,60,
Muskogee,Superintendent of Public Instruction,John Cox,DEM,510013,0,8,127,135,
Muskogee,Superintendent of Public Instruction,Freda Deskin,DEM,510013,2,6,68,76,
Muskogee,U.S. Senate,Connie Johnson,DEM,510013,2,4,97,103,
Muskogee,U.S. Senate,Jim Rogers,DEM,510013,0,10,98,108,
Muskogee,Superintendent of Public Instruction,John Cox,DEM,510017,0,4,57,61,
Muskogee,Superintendent of Public Instruction,Freda Deskin,DEM,510017,0,0,54,54,
Muskogee,U.S. Senate,Connie Johnson,DEM,510017,0,2,78,80,
Muskogee,U.S. Senate,Jim Rogers,DEM,510017,0,2,34,36,
Muskogee,Superintendent of Public Instruction,John Cox,DEM,510021,0,5,98,103,
Muskogee,Superintendent of Public Instruction,Freda Deskin,DEM,510021,1,5,67,73,
Muskogee,U.S. Senate,Connie Johnson,DEM,510021,1,8,102,111,
Muskogee,U.S. Senate,Jim Rogers,DEM,510021,0,2,60,62,
Muskogee,Superintendent of Public Instruction,John Cox,DEM,510022,9,14,147,170,
Muskogee,Superintendent of Public Instruction,Freda Deskin,DEM,510022,0,15,91,106,
Muskogee,U.S. Senate,Connie Johnson,DEM,510022,2,13,123,138,
Muskogee,U.S. Senate,Jim Rogers,DEM,510022,7,15,109,131,
Muskogee,Superintendent of Public Instruction,John Cox,DEM,510023,0,6,103,109,
Muskogee,Superintendent of Public Instruction,Freda Deskin,DEM,510023,0,3,93,96,
Muskogee,U.S. Senate,Connie Johnson,DEM,510023,0,9,135,144,
Muskogee,U.S. Senate,Jim Rogers,DEM,510023,0,1,59,60,
Muskogee,Superintendent of Public Instruction,John Cox,DEM,510028,1,5,59,65,
Muskogee,Superintendent of Public Instruction,Freda Deskin,DEM,510028,1,2,45,48,
Muskogee,U.S. Senate,Connie Johnson,DEM,510028,0,2,62,64,
Muskogee,U.S. Senate,Jim Rogers,DEM,510028,2,5,44,51,
Muskogee,Superintendent of Public Instruction,John Cox,DEM,510033,3,4,159,166,
Muskogee,Superintendent of Public Instruction,Freda Deskin,DEM,510033,1,3,53,57,
Muskogee,U.S. Senate,Connie Johnson,DEM,510033,1,2,90,93,
Muskogee,U.S. Senate,Jim Rogers,DEM,510033,1,4,117,122,
Muskogee,Superintendent of Public Instruction,John Cox,DEM,510036,2,0,33,35,
Muskogee,Superintendent of Public Instruction,Freda Deskin,DEM,510036,0,0,49,49,
Muskogee,U.S. Senate,Connie Johnson,DEM,510036,0,0,53,53,
Muskogee,U.S. Senate,Jim Rogers,DEM,510036,2,0,28,30,
Muskogee,Superintendent of Public Instruction,John Cox,DEM,510037,1,7,138,146,
Muskogee,Superintendent of Public Instruction,Freda Deskin,DEM,510037,0,8,83,91,
Muskogee,U.S. Senate,Connie Johnson,DEM,510037,0,10,93,103,
Muskogee,U.S. Senate,Jim Rogers,DEM,510037,1,5,124,130,
Muskogee,Superintendent of Public Instruction,John Cox,DEM,510038,1,22,151,174,
Muskogee,Superintendent of Public Instruction,Freda Deskin,DEM,510038,3,16,114,133,
Muskogee,U.S. Senate,Connie Johnson,DEM,510038,0,15,116,131,
Muskogee,U.S. Senate,Jim Rogers,DEM,510038,3,21,143,167,
Muskogee,Superintendent of Public Instruction,John Cox,DEM,510040,0,3,43,46,
Muskogee,Superintendent of Public Instruction,Freda Deskin,DEM,510040,1,0,25,26,
Muskogee,U.S. Senate,Connie Johnson,DEM,510040,0,1,27,28,
Muskogee,U.S. Senate,Jim Rogers,DEM,510040,1,2,41,44,
Muskogee,Superintendent of Public Instruction,John Cox,DEM,510041,3,29,419,451,
Muskogee,Superintendent of Public Instruction,Freda Deskin,DEM,510041,5,12,167,184,
Muskogee,U.S. Senate,Connie Johnson,DEM,510041,6,10,260,276,
Muskogee,U.S. Senate,Jim Rogers,DEM,510041,1,31,315,347,
Muskogee,Superintendent of Public Instruction,John Cox,DEM,510044,1,0,130,131,
Muskogee,Superintendent of Public Instruction,Freda Deskin,DEM,510044,0,0,42,42,
Muskogee,U.S. Senate,Connie Johnson,DEM,510044,1,0,66,67,
Muskogee,U.S. Senate,Jim Rogers,DEM,510044,0,0,106,106,
Muskogee,Superintendent of Public Instruction,John Cox,DEM,510045,2,4,81,87,
Muskogee,Superintendent of Public Instruction,Freda Deskin,DEM,510045,0,4,67,71,
Muskogee,U.S. Senate,Connie Johnson,DEM,510045,0,5,52,57,
Muskogee,U.S. Senate,Jim Rogers,DEM,510045,2,3,94,99,
Muskogee,Superintendent of Public Instruction,John Cox,DEM,510046,1,8,141,150,
Muskogee,Superintendent of Public Instruction,Freda Deskin,DEM,510046,1,6,83,90,
Muskogee,U.S. Senate,Connie Johnson,DEM,510046,2,6,90,98,
Muskogee,U.S. Senate,Jim Rogers,DEM,510046,0,7,127,134,
Muskogee,Superintendent of Public Instruction,John Cox,DEM,510047,1,9,85,95,
Muskogee,Superintendent of Public Instruction,Freda Deskin,DEM,510047,0,2,50,52,
Muskogee,U.S. Senate,Connie Johnson,DEM,510047,1,5,54,60,
Muskogee,U.S. Senate,Jim Rogers,DEM,510047,0,6,80,86,
Muskogee,Superintendent of Public Instruction,John Cox,DEM,510049,1,4,40,45,
Muskogee,Superintendent of Public Instruction,Freda Deskin,DEM,510049,1,6,33,40,
Muskogee,U.S. Senate,Connie Johnson,DEM,510049,1,3,25,29,
Muskogee,U.S. Senate,Jim Rogers,DEM,510049,1,7,47,55,
Muskogee,Superintendent of Public Instruction,John Cox,DEM,510050,4,2,45,51,
Muskogee,Superintendent of Public Instruction,Freda Deskin,DEM,510050,0,0,28,28,
Muskogee,U.S. Senate,Connie Johnson,DEM,510050,2,1,36,39,
Muskogee,U.S. Senate,Jim Rogers,DEM,510050,2,1,37,40,
Muskogee,Superintendent of Public Instruction,John Cox,DEM,510051,0,0,22,22,
Muskogee,Superintendent of Public Instruction,Freda Deskin,DEM,510051,0,0,4,4,
Muskogee,U.S. Senate,Connie Johnson,DEM,510051,0,0,5,5,
Muskogee,U.S. Senate,Jim Rogers,DEM,510051,0,0,21,21,
Muskogee,Superintendent of Public Instruction,John Cox,DEM,510052,2,3,67,72,
Muskogee,Superintendent of Public Instruction,Freda Deskin,DEM,510052,0,0,8,8,
Muskogee,U.S. Senate,Connie Johnson,DEM,510052,1,2,19,22,
Muskogee,U.S. Senate,Jim Rogers,DEM,510052,1,1,51,53,
Muskogee,Superintendent of Public Instruction,John Cox,DEM,510053,0,2,109,111,
Muskogee,Superintendent of Public Instruction,Freda Deskin,DEM,510053,0,3,35,38,
Muskogee,U.S. Senate,Connie Johnson,DEM,510053,0,2,41,43,
Muskogee,U.S. Senate,Jim Rogers,DEM,510053,0,3,100,103,
Muskogee,Superintendent of Public Instruction,John Cox,DEM,510055,3,18,264,285,
Muskogee,Superintendent of Public Instruction,Freda Deskin,DEM,510055,0,5,139,144,
Muskogee,U.S. Senate,Connie Johnson,DEM,510055,0,9,158,167,
Muskogee,U.S. Senate,Jim Rogers,DEM,510055,2,13,238,253,
Muskogee,Superintendent of Public Instruction,John Cox,DEM,510056,0,1,27,28,
Muskogee,Superintendent of Public Instruction,Freda Deskin,DEM,510056,0,0,11,11,
Muskogee,U.S. Senate,Connie Johnson,DEM,510056,0,1,20,21,
Muskogee,U.S. Senate,Jim Rogers,DEM,510056,0,0,18,18,
Muskogee,Superintendent of Public Instruction,John Cox,DEM,510057,0,0,4,4,
Muskogee,Superintendent of Public Instruction,Freda Deskin,DEM,510057,0,0,4,4,
Muskogee,U.S. Senate,Connie Johnson,DEM,510057,0,0,5,5,
Muskogee,U.S. Senate,Jim Rogers,DEM,510057,0,0,3,3,
Muskogee,Superintendent of Public Instruction,John Cox,DEM,510058,2,2,114,118,
Muskogee,Superintendent of Public Instruction,Freda Deskin,DEM,510058,0,0,36,36,
Muskogee,U.S. Senate,Connie Johnson,DEM,510058,2,2,54,58,
Muskogee,U.S. Senate,Jim Rogers,DEM,510058,0,0,92,92,
Muskogee,State Senate,Selina Jayne-Dornan,DEM,510058,0,1,75,76,8
Muskogee,State Senate,Gary Clason,DEM,510058,2,1,73,76,8
Muskogee,Superintendent of Public Instruction,John Cox,DEM,510059,0,10,126,136,
Muskogee,Superintendent of Public Instruction,Freda Deskin,DEM,510059,0,5,42,47,
Muskogee,U.S. Senate,Connie Johnson,DEM,510059,0,10,73,83,
Muskogee,U.S. Senate,Jim Rogers,DEM,510059,0,5,86,91,
Muskogee,State Senate,Selina Jayne-Dornan,DEM,510059,0,11,105,116,8
Muskogee,State Senate,Gary Clason,DEM,510059,0,4,56,60,8
Muskogee,Superintendent of Public Instruction,John Cox,DEM,510060,5,3,44,52,
Muskogee,Superintendent of Public Instruction,Freda Deskin,DEM,510060,0,0,13,13,
Muskogee,U.S. Senate,Connie Johnson,DEM,510060,1,0,17,18,
Muskogee,U.S. Senate,Jim Rogers,DEM,510060,4,3,38,45,
Muskogee,State Senate,Selina Jayne-Dornan,DEM,510060,4,2,36,42,8
Muskogee,State Senate,Gary Clason,DEM,510060,1,1,18,20,8
Muskogee,Superintendent of Public Instruction,John Cox,DEM,510061,0,5,71,76,
Muskogee,Superintendent of Public Instruction,Freda Deskin,DEM,510061,0,3,34,37,
Muskogee,U.S. Senate,Connie Johnson,DEM,510061,0,4,44,48,
Muskogee,U.S. Senate,Jim Rogers,DEM,510061,0,4,58,62,
Muskogee,Superintendent of Public Instruction,John Cox,DEM,510064,2,4,131,137,
Muskogee,Superintendent of Public Instruction,Freda Deskin,DEM,510064,0,2,30,32,
Muskogee,U.S. Senate,Connie Johnson,DEM,510064,0,3,52,55,
Muskogee,U.S. Senate,Jim Rogers,DEM,510064,2,3,100,105,
Muskogee,State Senate,Selina Jayne-Dornan,DEM,510064,2,5,99,106,8
Muskogee,State Senate,Gary Clason,DEM,510064,0,1,60,61,8
Noble,Superintendent of Public Instruction,John Cox,DEM,520101,1,3,8,12,
Noble,Superintendent of Public Instruction,Freda Deskin,DEM,520101,1,2,3,6,
Noble,U.S. Senate,Connie Johnson,DEM,520101,1,4,2,7,
Noble,U.S. Senate,Jim Rogers,DEM,520101,1,1,9,11,
Noble,Superintendent of Public Instruction,John Cox,DEM,520102,0,2,6,8,
Noble,Superintendent of Public Instruction,Freda Deskin,DEM,520102,0,1,4,5,
Noble,U.S. Senate,Connie Johnson,DEM,520102,0,3,5,8,
Noble,U.S. Senate,Jim Rogers,DEM,520102,0,0,5,5,
Noble,State House,John Pfeiffer,REP,520102,4,7,24,35,38
Noble,State House,Harold Levalley,REP,520102,0,3,2,5,38
Noble,Superintendent of Public Instruction,John Cox,DEM,520103,2,0,13,15,
Noble,Superintendent of Public Instruction,Freda Deskin,DEM,520103,1,0,6,7,
Noble,U.S. Senate,Connie Johnson,DEM,520103,2,0,6,8,
Noble,U.S. Senate,Jim Rogers,DEM,520103,1,0,13,14,
Noble,State House,John Pfeiffer,REP,520103,4,0,27,31,38
Noble,State House,Harold Levalley,REP,520103,1,0,14,15,38
Noble,Superintendent of Public Instruction,John Cox,DEM,520104,1,2,30,33,
Noble,Superintendent of Public Instruction,Freda Deskin,DEM,520104,0,0,19,19,
Noble,U.S. Senate,Connie Johnson,DEM,520104,0,1,15,16,
Noble,U.S. Senate,Jim Rogers,DEM,520104,1,1,32,34,
Noble,State House,John Pfeiffer,REP,520104,0,4,46,50,38
Noble,State House,Harold Levalley,REP,520104,0,0,12,12,38
Noble,Superintendent of Public Instruction,John Cox,DEM,520105,0,0,29,29,
Noble,Superintendent of Public Instruction,Freda Deskin,DEM,520105,0,0,26,26,
Noble,U.S. Senate,Connie Johnson,DEM,520105,0,0,25,25,
Noble,U.S. Senate,Jim Rogers,DEM,520105,0,0,29,29,
Noble,State House,John Pfeiffer,REP,520105,0,1,48,49,38
Noble,State House,Harold Levalley,REP,520105,0,0,7,7,38
Noble,Superintendent of Public Instruction,John Cox,DEM,520106,0,0,6,6,
Noble,Superintendent of Public Instruction,Freda Deskin,DEM,520106,0,0,1,1,
Noble,U.S. Senate,Connie Johnson,DEM,520106,0,0,3,3,
Noble,U.S. Senate,Jim Rogers,DEM,520106,0,0,4,4,
Noble,State House,John Pfeiffer,REP,520106,0,3,19,22,38
Noble,State House,Harold Levalley,REP,520106,0,0,2,2,38
Noble,Superintendent of Public Instruction,John Cox,DEM,520201,0,7,12,19,
Noble,Superintendent of Public Instruction,Freda Deskin,DEM,520201,0,1,8,9,
Noble,U.S. Senate,Connie Johnson,DEM,520201,0,5,7,12,
Noble,U.S. Senate,Jim Rogers,DEM,520201,0,3,13,16,
Noble,Superintendent of Public Instruction,John Cox,DEM,520202,1,0,1,2,
Noble,Superintendent of Public Instruction,Freda Deskin,DEM,520202,1,0,10,11,
Noble,U.S. Senate,Connie Johnson,DEM,520202,1,0,7,8,
Noble,U.S. Senate,Jim Rogers,DEM,520202,2,0,4,6,
Noble,State House,John Pfeiffer,REP,520202,2,5,42,49,38
Noble,State House,Harold Levalley,REP,520202,2,1,7,10,38
Noble,Superintendent of Public Instruction,John Cox,DEM,520203,0,0,6,6,
Noble,Superintendent of Public Instruction,Freda Deskin,DEM,520203,2,0,1,3,
Noble,U.S. Senate,Connie Johnson,DEM,520203,1,0,3,4,
Noble,U.S. Senate,Jim Rogers,DEM,520203,1,0,4,5,
Noble,Superintendent of Public Instruction,John Cox,DEM,520301,0,2,15,17,
Noble,Superintendent of Public Instruction,Freda Deskin,DEM,520301,0,1,10,11,
Noble,U.S. Senate,Connie Johnson,DEM,520301,0,1,9,10,
Noble,U.S. Senate,Jim Rogers,DEM,520301,0,2,16,18,
Noble,State House,John Pfeiffer,REP,520301,5,16,44,65,38
Noble,State House,Harold Levalley,REP,520301,0,2,4,6,38
Noble,Superintendent of Public Instruction,John Cox,DEM,520305,1,0,17,18,
Noble,Superintendent of Public Instruction,Freda Deskin,DEM,520305,1,1,14,16,
Noble,U.S. Senate,Connie Johnson,DEM,520305,1,1,15,17,
Noble,U.S. Senate,Jim Rogers,DEM,520305,1,0,16,17,
Noble,Superintendent of Public Instruction,John Cox,DEM,520307,0,2,4,6,
Noble,Superintendent of Public Instruction,Freda Deskin,DEM,520307,1,0,5,6,
Noble,U.S. Senate,Connie Johnson,DEM,520307,1,2,3,6,
Noble,U.S. Senate,Jim Rogers,DEM,520307,0,0,6,6,
Nowata,Superintendent of Public Instruction,John Cox,DEM,530101,1,5,16,22,
Nowata,Superintendent of Public Instruction,Freda Deskin,DEM,530101,1,1,5,7,
Nowata,U.S. Senate,Connie Johnson,DEM,530101,1,4,9,14,
Nowata,U.S. Senate,Jim Rogers,DEM,530101,1,1,12,14,
Nowata,Superintendent of Public Instruction,John Cox,DEM,530102,3,0,42,45,
Nowata,Superintendent of Public Instruction,Freda Deskin,DEM,530102,1,0,5,6,
Nowata,U.S. Senate,Connie Johnson,DEM,530102,3,0,24,27,
Nowata,U.S. Senate,Jim Rogers,DEM,530102,1,0,23,24,
Nowata,Superintendent of Public Instruction,John Cox,DEM,530103,0,0,18,18,
Nowata,Superintendent of Public Instruction,Freda Deskin,DEM,530103,0,0,8,8,
Nowata,U.S. Senate,Connie Johnson,DEM,530103,0,0,12,12,
Nowata,U.S. Senate,Jim Rogers,DEM,530103,0,0,14,14,
Nowata,Superintendent of Public Instruction,John Cox,DEM,530201,2,0,19,21,
Nowata,Superintendent of Public Instruction,Freda Deskin,DEM,530201,0,0,3,3,
Nowata,U.S. Senate,Connie Johnson,DEM,530201,0,0,9,9,
Nowata,U.S. Senate,Jim Rogers,DEM,530201,2,0,13,15,
Nowata,Superintendent of Public Instruction,John Cox,DEM,530202,1,3,20,24,
Nowata,Superintendent of Public Instruction,Freda Deskin,DEM,530202,1,0,2,3,
Nowata,U.S. Senate,Connie Johnson,DEM,530202,0,1,7,8,
Nowata,U.S. Senate,Jim Rogers,DEM,530202,2,2,15,19,
Nowata,Superintendent of Public Instruction,John Cox,DEM,530203,1,5,36,42,
Nowata,Superintendent of Public Instruction,Freda Deskin,DEM,530203,1,1,8,10,
Nowata,U.S. Senate,Connie Johnson,DEM,530203,2,4,24,30,
Nowata,U.S. Senate,Jim Rogers,DEM,530203,0,2,19,21,
Nowata,Superintendent of Public Instruction,John Cox,DEM,530204,0,1,20,21,
Nowata,Superintendent of Public Instruction,Freda Deskin,DEM,530204,0,0,0,0,
Nowata,U.S. Senate,Connie Johnson,DEM,530204,0,1,6,7,
Nowata,U.S. Senate,Jim Rogers,DEM,530204,0,0,13,13,
Nowata,Superintendent of Public Instruction,John Cox,DEM,530301,4,1,73,78,
Nowata,Superintendent of Public Instruction,Freda Deskin,DEM,530301,1,1,40,42,
Nowata,U.S. Senate,Connie Johnson,DEM,530301,4,2,44,50,
Nowata,U.S. Senate,Jim Rogers,DEM,530301,1,0,67,68,
Nowata,Superintendent of Public Instruction,John Cox,DEM,530302,0,7,32,39,
Nowata,Superintendent of Public Instruction,Freda Deskin,DEM,530302,1,3,11,15,
Nowata,U.S. Senate,Connie Johnson,DEM,530302,0,3,16,19,
Nowata,U.S. Senate,Jim Rogers,DEM,530302,1,7,27,35,
Nowata,Superintendent of Public Instruction,John Cox,DEM,530303,0,7,51,58,
Nowata,Superintendent of Public Instruction,Freda Deskin,DEM,530303,1,0,12,13,
Nowata,U.S. Senate,Connie Johnson,DEM,530303,1,4,18,23,
Nowata,U.S. Senate,Jim Rogers,DEM,530303,0,3,45,48,
Nowata,Superintendent of Public Instruction,John Cox,DEM,530304,3,2,27,32,
Nowata,Superintendent of Public Instruction,Freda Deskin,DEM,530304,0,0,5,5,
Nowata,U.S. Senate,Connie Johnson,DEM,530304,2,2,10,14,
Nowata,U.S. Senate,Jim Rogers,DEM,530304,1,0,21,22,
Okfuskee,Superintendent of Public Instruction,John Cox,DEM,540101,2,0,146,148,
Okfuskee,Superintendent of Public Instruction,Freda Deskin,DEM,540101,0,0,28,28,
Okfuskee,U.S. Senate,Connie Johnson,DEM,540101,1,0,43,44,
Okfuskee,U.S. Senate,Jim Rogers,DEM,540101,1,0,121,122,
Okfuskee,State Senate,Selina Jayne-Dornan,DEM,540101,1,0,85,86,8
Okfuskee,State Senate,Gary Clason,DEM,540101,1,0,81,82,8
Okfuskee,Superintendent of Public Instruction,John Cox,DEM,540102,0,0,24,24,
Okfuskee,Superintendent of Public Instruction,Freda Deskin,DEM,540102,0,0,15,15,
Okfuskee,U.S. Senate,Connie Johnson,DEM,540102,0,0,32,32,
Okfuskee,U.S. Senate,Jim Rogers,DEM,540102,0,0,7,7,
Okfuskee,State Senate,Selina Jayne-Dornan,DEM,540102,0,0,26,26,8
Okfuskee,State Senate,Gary Clason,DEM,540102,0,0,12,12,8
Okfuskee,Superintendent of Public Instruction,John Cox,DEM,540103,0,0,28,28,
Okfuskee,Superintendent of Public Instruction,Freda Deskin,DEM,540103,0,0,9,9,
Okfuskee,U.S. Senate,Connie Johnson,DEM,540103,0,0,16,16,
Okfuskee,U.S. Senate,Jim Rogers,DEM,540103,0,0,21,21,
Okfuskee,State Senate,Selina Jayne-Dornan,DEM,540103,0,0,24,24,8
Okfuskee,State Senate,Gary Clason,DEM,540103,0,0,13,13,8
Okfuskee,Superintendent of Public Instruction,John Cox,DEM,540105,0,3,15,18,
Okfuskee,Superintendent of Public Instruction,Freda Deskin,DEM,540105,0,0,3,3,
Okfuskee,U.S. Senate,Connie Johnson,DEM,540105,0,2,6,8,
Okfuskee,U.S. Senate,Jim Rogers,DEM,540105,0,1,11,12,
Okfuskee,State Senate,Selina Jayne-Dornan,DEM,540105,0,2,15,17,8
Okfuskee,State Senate,Gary Clason,DEM,540105,0,1,2,3,8
Okfuskee,Superintendent of Public Instruction,John Cox,DEM,540206,0,1,28,29,
Okfuskee,Superintendent of Public Instruction,Freda Deskin,DEM,540206,0,1,11,12,
Okfuskee,U.S. Senate,Connie Johnson,DEM,540206,0,2,12,14,
Okfuskee,U.S. Senate,Jim Rogers,DEM,540206,0,0,23,23,
Okfuskee,State Senate,Selina Jayne-Dornan,DEM,540206,0,2,10,12,8
Okfuskee,State Senate,Gary Clason,DEM,540206,0,0,24,24,8
Okfuskee,Superintendent of Public Instruction,John Cox,DEM,540207,1,2,9,12,
Okfuskee,Superintendent of Public Instruction,Freda Deskin,DEM,540207,0,0,5,5,
Okfuskee,U.S. Senate,Connie Johnson,DEM,540207,1,2,7,10,
Okfuskee,U.S. Senate,Jim Rogers,DEM,540207,0,0,7,7,
Okfuskee,State Senate,Selina Jayne-Dornan,DEM,540207,1,2,6,9,8
Okfuskee,State Senate,Gary Clason,DEM,540207,0,0,8,8,8
Okfuskee,Superintendent of Public Instruction,John Cox,DEM,540208,0,2,24,26,
Okfuskee,Superintendent of Public Instruction,Freda Deskin,DEM,540208,0,4,8,12,
Okfuskee,U.S. Senate,Connie Johnson,DEM,540208,0,4,14,18,
Okfuskee,U.S. Senate,Jim Rogers,DEM,540208,0,2,17,19,
Okfuskee,State Senate,Selina Jayne-Dornan,DEM,540208,0,3,16,19,8
Okfuskee,State Senate,Gary Clason,DEM,540208,0,3,16,19,8
Okfuskee,Superintendent of Public Instruction,John Cox,DEM,540209,3,5,57,65,
Okfuskee,Superintendent of Public Instruction,Freda Deskin,DEM,540209,1,5,25,31,
Okfuskee,U.S. Senate,Connie Johnson,DEM,540209,3,1,29,33,
Okfuskee,U.S. Senate,Jim Rogers,DEM,540209,0,9,45,54,
Okfuskee,State Senate,Selina Jayne-Dornan,DEM,540209,2,6,58,66,8
Okfuskee,State Senate,Gary Clason,DEM,540209,1,4,24,29,8
Okfuskee,Superintendent of Public Instruction,John Cox,DEM,540210,2,3,16,21,
Okfuskee,Superintendent of Public Instruction,Freda Deskin,DEM,540210,1,1,6,8,
Okfuskee,U.S. Senate,Connie Johnson,DEM,540210,3,1,5,9,
Okfuskee,U.S. Senate,Jim Rogers,DEM,540210,0,3,14,17,
Okfuskee,Superintendent of Public Instruction,John Cox,DEM,540311,1,1,26,28,
Okfuskee,Superintendent of Public Instruction,Freda Deskin,DEM,540311,1,1,12,14,
Okfuskee,U.S. Senate,Connie Johnson,DEM,540311,0,1,18,19,
Okfuskee,U.S. Senate,Jim Rogers,DEM,540311,2,1,20,23,
Okfuskee,State Senate,Selina Jayne-Dornan,DEM,540311,0,1,23,24,8
Okfuskee,State Senate,Gary Clason,DEM,540311,2,1,15,18,8
Okfuskee,Superintendent of Public Instruction,John Cox,DEM,540312,3,3,19,25,
Okfuskee,Superintendent of Public Instruction,Freda Deskin,DEM,540312,5,0,7,12,
Okfuskee,U.S. Senate,Connie Johnson,DEM,540312,6,0,14,20,
Okfuskee,U.S. Senate,Jim Rogers,DEM,540312,3,2,12,17,
Okfuskee,Superintendent of Public Instruction,John Cox,DEM,540313,0,1,15,16,
Okfuskee,Superintendent of Public Instruction,Freda Deskin,DEM,540313,0,0,2,2,
Okfuskee,U.S. Senate,Connie Johnson,DEM,540313,0,0,7,7,
Okfuskee,U.S. Senate,Jim Rogers,DEM,540313,0,1,10,11,
Okfuskee,State Senate,Selina Jayne-Dornan,DEM,540313,0,1,8,9,8
Okfuskee,State Senate,Gary Clason,DEM,540313,0,0,9,9,8
Okfuskee,Superintendent of Public Instruction,John Cox,DEM,540314,3,4,30,37,
Okfuskee,Superintendent of Public Instruction,Freda Deskin,DEM,540314,0,1,6,7,
Okfuskee,U.S. Senate,Connie Johnson,DEM,540314,1,3,14,18,
Okfuskee,U.S. Senate,Jim Rogers,DEM,540314,2,2,22,26,
Okfuskee,State Senate,Selina Jayne-Dornan,DEM,540314,2,2,27,31,8
Okfuskee,State Senate,Gary Clason,DEM,540314,1,3,9,13,8
Oklahoma,Superintendent of Public Instruction,John Cox,DEM,550001,0,0,16,16,
Oklahoma,Superintendent of Public Instruction,Freda Deskin,DEM,550001,0,0,16,16,
Oklahoma,U.S. Senate,Connie Johnson,DEM,550001,0,0,21,21,
Oklahoma,U.S. Senate,Jim Rogers,DEM,550001,0,0,10,10,
Oklahoma,U.S. House,Tom Guild,DEM,550001,0,0,9,9,05
Oklahoma,U.S. House,Al Mcaffrey,DEM,550001,0,0,23,23,05
Oklahoma,U.S. House,Steve Russell,REP,550001,0,0,54,54,05
Oklahoma,U.S. House,Patrice Douglas,REP,550001,0,0,37,37,05
Oklahoma,Superintendent of Public Instruction,John Cox,DEM,550002,0,0,17,17,
Oklahoma,Superintendent of Public Instruction,Freda Deskin,DEM,550002,0,0,9,9,
Oklahoma,U.S. Senate,Connie Johnson,DEM,550002,0,0,18,18,
Oklahoma,U.S. Senate,Jim Rogers,DEM,550002,0,0,8,8,
Oklahoma,U.S. House,Tom Guild,DEM,550002,0,0,15,15,05
Oklahoma,U.S. House,Al Mcaffrey,DEM,550002,0,0,11,11,05
Oklahoma,U.S. House,Steve Russell,REP,550002,0,0,95,95,05
Oklahoma,U.S. House,Patrice Douglas,REP,550002,0,0,59,59,05
Oklahoma,Superintendent of Public Instruction,John Cox,DEM,550003,0,0,41,41,
Oklahoma,Superintendent of Public Instruction,Freda Deskin,DEM,550003,0,0,37,37,
Oklahoma,U.S. Senate,Connie Johnson,DEM,550003,0,0,53,53,
Oklahoma,U.S. Senate,Jim Rogers,DEM,550003,0,0,23,23,
Oklahoma,U.S. House,Tom Guild,DEM,550003,0,0,37,37,05
Oklahoma,U.S. House,Al Mcaffrey,DEM,550003,0,0,41,41,05
Oklahoma,U.S. House,Steve Russell,REP,550003,0,0,120,120,05
Oklahoma,U.S. House,Patrice Douglas,REP,550003,0,0,83,83,05
Oklahoma,Superintendent of Public Instruction,John Cox,DEM,550004,0,0,27,27,
Oklahoma,Superintendent of Public Instruction,Freda Deskin,DEM,550004,0,0,33,33,
Oklahoma,U.S. Senate,Connie Johnson,DEM,550004,0,0,34,34,
Oklahoma,U.S. Senate,Jim Rogers,DEM,550004,0,0,25,25,
Oklahoma,U.S. House,Tom Guild,DEM,550004,0,0,26,26,05
Oklahoma,U.S. House,Al Mcaffrey,DEM,550004,0,0,32,32,05
Oklahoma,U.S. House,Steve Russell,REP,550004,0,0,146,146,05
Oklahoma,U.S. House,Patrice Douglas,REP,550004,0,0,78,78,05
Oklahoma,Superintendent of Public Instruction,John Cox,DEM,550005,0,0,23,23,
Oklahoma,Superintendent of Public Instruction,Freda Deskin,DEM,550005,0,0,40,40,
Oklahoma,U.S. Senate,Connie Johnson,DEM,550005,0,0,41,41,
Oklahoma,U.S. Senate,Jim Rogers,DEM,550005,0,0,19,19,
Oklahoma,U.S. House,Tom Guild,DEM,550005,0,0,37,37,05
Oklahoma,U.S. House,Al Mcaffrey,DEM,550005,0,0,25,25,05
Oklahoma,U.S. House,Steve Russell,REP,550005,0,0,102,102,05
Oklahoma,U.S. House,Patrice Douglas,REP,550005,0,0,73,73,05
Oklahoma,State Senate,Ervin Yen,REP,550005,0,0,74,74,40
Oklahoma,State Senate,Steve Kern,REP,550005,0,0,100,100,40
Oklahoma,Superintendent of Public Instruction,John Cox,DEM,550006,0,0,16,16,
Oklahoma,Superintendent of Public Instruction,Freda Deskin,DEM,550006,0,0,21,21,
Oklahoma,U.S. Senate,Connie Johnson,DEM,550006,0,0,22,22,
Oklahoma,U.S. Senate,Jim Rogers,DEM,550006,0,0,15,15,
Oklahoma,U.S. House,Tom Guild,DEM,550006,0,0,20,20,05
Oklahoma,U.S. House,Al Mcaffrey,DEM,550006,0,0,17,17,05
Oklahoma,U.S. House,Steve Russell,REP,550006,0,0,66,66,05
Oklahoma,U.S. House,Patrice Douglas,REP,550006,0,0,34,34,05
Oklahoma,Superintendent of Public Instruction,John Cox,DEM,550007,0,0,26,26,
Oklahoma,Superintendent of Public Instruction,Freda Deskin,DEM,550007,0,0,35,35,
Oklahoma,U.S. Senate,Connie Johnson,DEM,550007,0,0,44,44,
Oklahoma,U.S. Senate,Jim Rogers,DEM,550007,0,0,15,15,
Oklahoma,U.S. House,Tom Guild,DEM,550007,0,0,34,34,05
Oklahoma,U.S. House,Al Mcaffrey,DEM,550007,0,0,26,26,05
Oklahoma,U.S. House,Steve Russell,REP,550007,0,0,140,140,05
Oklahoma,U.S. House,Patrice Douglas,REP,550007,0,0,72,72,05
Oklahoma,Superintendent of Public Instruction,John Cox,DEM,550008,0,0,14,14,
Oklahoma,Superintendent of Public Instruction,Freda Deskin,DEM,550008,0,0,11,11,
Oklahoma,U.S. Senate,Connie Johnson,DEM,550008,0,0,11,11,
Oklahoma,U.S. Senate,Jim Rogers,DEM,550008,0,0,14,14,
Oklahoma,U.S. House,Tom Guild,DEM,550008,0,0,9,9,05
Oklahoma,U.S. House,Al Mcaffrey,DEM,550008,0,0,15,15,05
Oklahoma,U.S. House,Steve Russell,REP,550008,0,0,70,70,05
Oklahoma,U.S. House,Patrice Douglas,REP,550008,0,0,60,60,05
Oklahoma,Superintendent of Public Instruction,John Cox,DEM,550009,0,0,5,5,
Oklahoma,Superintendent of Public Instruction,Freda Deskin,DEM,550009,0,0,6,6,
Oklahoma,U.S. Senate,Connie Johnson,DEM,550009,0,0,10,10,
Oklahoma,U.S. Senate,Jim Rogers,DEM,550009,0,0,0,0,
Oklahoma,U.S. House,Tom Guild,DEM,550009,0,0,6,6,05
Oklahoma,U.S. House,Al Mcaffrey,DEM,550009,0,0,5,5,05
Oklahoma,U.S. House,Steve Russell,REP,550009,0,0,74,74,05
Oklahoma,U.S. House,Patrice Douglas,REP,550009,0,0,27,27,05
Oklahoma,Superintendent of Public Instruction,John Cox,DEM,550010,0,0,8,8,
Oklahoma,Superintendent of Public Instruction,Freda Deskin,DEM,550010,0,0,4,4,
Oklahoma,U.S. Senate,Connie Johnson,DEM,550010,0,0,7,7,
Oklahoma,U.S. Senate,Jim Rogers,DEM,550010,0,0,5,5,
Oklahoma,U.S. House,Tom Guild,DEM,550010,0,0,6,6,05
Oklahoma,U.S. House,Al Mcaffrey,DEM,550010,0,0,6,6,05
Oklahoma,U.S. House,Steve Russell,REP,550010,0,0,28,28,05
Oklahoma,U.S. House,Patrice Douglas,REP,550010,0,0,27,27,05
Oklahoma,Superintendent of Public Instruction,John Cox,DEM,550011,0,0,28,28,
Oklahoma,Superintendent of Public Instruction,Freda Deskin,DEM,550011,0,0,17,17,
Oklahoma,U.S. Senate,Connie Johnson,DEM,550011,0,0,25,25,
Oklahoma,U.S. Senate,Jim Rogers,DEM,550011,0,0,20,20,
Oklahoma,U.S. House,Tom Guild,DEM,550011,0,0,18,18,05
Oklahoma,U.S. House,Al Mcaffrey,DEM,550011,0,0,25,25,05
Oklahoma,U.S. House,Steve Russell,REP,550011,0,0,83,83,05
Oklahoma,U.S. House,Patrice Douglas,REP,550011,0,0,49,49,05
Oklahoma,State Senate,Ervin Yen,REP,550011,0,0,57,57,40
Oklahoma,State Senate,Steve Kern,REP,550011,0,0,79,79,40
Oklahoma,Superintendent of Public Instruction,John Cox,DEM,550012,0,0,52,52,
Oklahoma,Superintendent of Public Instruction,Freda Deskin,DEM,550012,0,0,42,42,
Oklahoma,U.S. Senate,Connie Johnson,DEM,550012,0,0,72,72,
Oklahoma,U.S. Senate,Jim Rogers,DEM,550012,0,0,22,22,
Oklahoma,U.S. House,Tom Guild,DEM,550012,0,0,48,48,05
Oklahoma,U.S. House,Al Mcaffrey,DEM,550012,0,0,46,46,05
Oklahoma,U.S. House,Steve Russell,REP,550012,0,0,173,173,05
Oklahoma,U.S. House,Patrice Douglas,REP,550012,0,0,106,106,05
Oklahoma,State Senate,Ervin Yen,REP,550012,0,0,133,133,40
Oklahoma,State Senate,Steve Kern,REP,550012,0,0,145,145,40
Oklahoma,Superintendent of Public Instruction,John Cox,DEM,550013,0,0,24,24,
Oklahoma,Superintendent of Public Instruction,Freda Deskin,DEM,550013,0,0,17,17,
Oklahoma,U.S. Senate,Connie Johnson,DEM,550013,0,0,22,22,
Oklahoma,U.S. Senate,Jim Rogers,DEM,550013,0,0,19,19,
Oklahoma,U.S. House,Tom Guild,DEM,550013,0,0,24,24,05
Oklahoma,U.S. House,Al Mcaffrey,DEM,550013,0,0,16,16,05
Oklahoma,U.S. House,Steve Russell,REP,550013,0,0,66,66,05
Oklahoma,U.S. House,Patrice Douglas,REP,550013,0,0,68,68,05
Oklahoma,Superintendent of Public Instruction,John Cox,DEM,550014,0,0,27,27,
Oklahoma,Superintendent of Public Instruction,Freda Deskin,DEM,550014,0,0,37,37,
Oklahoma,U.S. Senate,Connie Johnson,DEM,550014,0,0,50,50,
Oklahoma,U.S. Senate,Jim Rogers,DEM,550014,0,0,14,14,
Oklahoma,U.S. House,Tom Guild,DEM,550014,0,0,32,32,05
Oklahoma,U.S. House,Al Mcaffrey,DEM,550014,0,0,32,32,05
Oklahoma,U.S. House,Steve Russell,REP,550014,0,0,71,71,05
Oklahoma,U.S. House,Patrice Douglas,REP,550014,0,0,76,76,05
Oklahoma,Superintendent of Public Instruction,John Cox,DEM,550015,0,0,41,41,
Oklahoma,Superintendent of Public Instruction,Freda Deskin,DEM,550015,0,0,35,35,
Oklahoma,U.S. Senate,Connie Johnson,DEM,550015,0,0,54,54,
Oklahoma,U.S. Senate,Jim Rogers,DEM,550015,0,0,19,19,
Oklahoma,U.S. House,Tom Guild,DEM,550015,0,0,32,32,05
Oklahoma,U.S. House,Al Mcaffrey,DEM,550015,0,0,41,41,05
Oklahoma,U.S. House,Steve Russell,REP,550015,0,0,124,124,05
Oklahoma,U.S. House,Patrice Douglas,REP,550015,0,0,78,78,05
Oklahoma,State Senate,Ervin Yen,REP,550015,0,0,124,124,40
Oklahoma,State Senate,Steve Kern,REP,550015,0,0,77,77,40
Oklahoma,Superintendent of Public Instruction,John Cox,DEM,550016,0,0,9,9,
Oklahoma,Superintendent of Public Instruction,Freda Deskin,DEM,550016,0,0,6,6,
Oklahoma,U.S. Senate,Connie Johnson,DEM,550016,0,0,12,12,
Oklahoma,U.S. Senate,Jim Rogers,DEM,550016,0,0,2,2,
Oklahoma,U.S. House,Tom Guild,DEM,550016,0,0,5,5,05
Oklahoma,U.S. House,Al Mcaffrey,DEM,550016,0,0,10,10,05
Oklahoma,U.S. House,Steve Russell,REP,550016,0,0,33,33,05
Oklahoma,U.S. House,Patrice Douglas,REP,550016,0,0,26,26,05
Oklahoma,State Senate,Ervin Yen,REP,550016,0,0,45,45,40
Oklahoma,State Senate,Steve Kern,REP,550016,0,0,14,14,40
Oklahoma,Superintendent of Public Instruction,John Cox,DEM,550017,0,0,0,0,
Oklahoma,Superintendent of Public Instruction,Freda Deskin,DEM,550017,0,0,0,0,
Oklahoma,U.S. Senate,Connie Johnson,DEM,550017,0,0,0,0,
Oklahoma,U.S. Senate,Jim Rogers,DEM,550017,0,0,0,0,
Oklahoma,U.S. House,Tom Guild,DEM,550017,0,0,0,0,05
Oklahoma,U.S. House,Al Mcaffrey,DEM,550017,0,0,0,0,05
Oklahoma,U.S. House,Steve Russell,REP,550017,0,0,0,0,05
Oklahoma,U.S. House,Patrice Douglas,REP,550017,0,0,0,0,05
Oklahoma,Superintendent of Public Instruction,John Cox,DEM,550018,0,0,11,11,
Oklahoma,Superintendent of Public Instruction,Freda Deskin,DEM,550018,0,0,4,4,
Oklahoma,U.S. Senate,Connie Johnson,DEM,550018,0,0,8,8,
Oklahoma,U.S. Senate,Jim Rogers,DEM,550018,0,0,7,7,
Oklahoma,U.S. House,Tom Guild,DEM,550018,0,0,10,10,05
Oklahoma,U.S. House,Al Mcaffrey,DEM,550018,0,0,4,4,05
Oklahoma,U.S. House,Steve Russell,REP,550018,0,0,28,28,05
Oklahoma,U.S. House,Patrice Douglas,REP,550018,0,0,2,2,05
Oklahoma,Superintendent of Public Instruction,John Cox,DEM,550019,0,0,32,32,
Oklahoma,Superintendent of Public Instruction,Freda Deskin,DEM,550019,0,0,7,7,
Oklahoma,U.S. Senate,Connie Johnson,DEM,550019,0,0,22,22,
Oklahoma,U.S. Senate,Jim Rogers,DEM,550019,0,0,17,17,
Oklahoma,U.S. House,Tom Guild,DEM,550019,0,0,25,25,05
Oklahoma,U.S. House,Al Mcaffrey,DEM,550019,0,0,15,15,05
Oklahoma,U.S. House,Steve Russell,REP,550019,0,0,85,85,05
Oklahoma,U.S. House,Patrice Douglas,REP,550019,0,0,35,35,05
Oklahoma,Superintendent of Public Instruction,John Cox,DEM,550020,0,0,23,23,
Oklahoma,Superintendent of Public Instruction,Freda Deskin,DEM,550020,0,0,18,18,
Oklahoma,U.S. Senate,Connie Johnson,DEM,550020,0,0,29,29,
Oklahoma,U.S. Senate,Jim Rogers,DEM,550020,0,0,12,12,
Oklahoma,U.S. House,Tom Guild,DEM,550020,0,0,23,23,05
Oklahoma,U.S. House,Al Mcaffrey,DEM,550020,0,0,17,17,05
Oklahoma,U.S. House,Steve Russell,REP,550020,0,0,115,115,05
Oklahoma,U.S. House,Patrice Douglas,REP,550020,0,0,51,51,05
Oklahoma,Superintendent of Public Instruction,John Cox,DEM,550021,0,0,35,35,
Oklahoma,Superintendent of Public Instruction,Freda Deskin,DEM,550021,0,0,25,25,
Oklahoma,U.S. Senate,Connie Johnson,DEM,550021,0,0,41,41,
Oklahoma,U.S. Senate,Jim Rogers,DEM,550021,0,0,15,15,
Oklahoma,U.S. House,Tom Guild,DEM,550021,0,0,27,27,05
Oklahoma,U.S. House,Al Mcaffrey,DEM,550021,0,0,29,29,05
Oklahoma,U.S. House,Steve Russell,REP,550021,0,0,122,122,05
Oklahoma,U.S. House,Patrice Douglas,REP,550021,0,0,39,39,05
Oklahoma,Superintendent of Public Instruction,John Cox,DEM,550022,0,0,26,26,
Oklahoma,Superintendent of Public Instruction,Freda Deskin,DEM,550022,0,0,4,4,
Oklahoma,U.S. Senate,Connie Johnson,DEM,550022,0,0,20,20,
Oklahoma,U.S. Senate,Jim Rogers,DEM,550022,0,0,10,10,
Oklahoma,Superintendent of Public Instruction,John Cox,DEM,550023,0,0,26,26,
Oklahoma,Superintendent of Public Instruction,Freda Deskin,DEM,550023,0,0,18,18,
Oklahoma,U.S. Senate,Connie Johnson,DEM,550023,0,0,32,32,
Oklahoma,U.S. Senate,Jim Rogers,DEM,550023,0,0,13,13,
Oklahoma,Superintendent of Public Instruction,John Cox,DEM,550024,0,0,3,3,
Oklahoma,Superintendent of Public Instruction,Freda Deskin,DEM,550024,0,0,2,2,
Oklahoma,U.S. Senate,Connie Johnson,DEM,550024,0,0,3,3,
Oklahoma,U.S. Senate,Jim Rogers,DEM,550024,0,0,2,2,
Oklahoma,U.S. House,Tom Guild,DEM,550024,0,0,3,3,05
Oklahoma,U.S. House,Al Mcaffrey,DEM,550024,0,0,2,2,05
Oklahoma,U.S. House,Steve Russell,REP,550024,0,0,10,10,05
Oklahoma,U.S. House,Patrice Douglas,REP,550024,0,0,0,0,05
Oklahoma,Superintendent of Public Instruction,John Cox,DEM,550025,0,0,8,8,
Oklahoma,Superintendent of Public Instruction,Freda Deskin,DEM,550025,0,0,24,24,
Oklahoma,U.S. Senate,Connie Johnson,DEM,550025,0,0,31,31,
Oklahoma,U.S. Senate,Jim Rogers,DEM,550025,0,0,4,4,
Oklahoma,U.S. House,Tom Guild,DEM,550025,0,0,12,12,05
Oklahoma,U.S. House,Al Mcaffrey,DEM,550025,0,0,22,22,05
Oklahoma,U.S. House,Steve Russell,REP,550025,0,0,16,16,05
Oklahoma,U.S. House,Patrice Douglas,REP,550025,0,0,8,8,05
Oklahoma,Superintendent of Public Instruction,John Cox,DEM,550026,0,0,15,15,
Oklahoma,Superintendent of Public Instruction,Freda Deskin,DEM,550026,0,0,10,10,
Oklahoma,U.S. Senate,Connie Johnson,DEM,550026,0,0,21,21,
Oklahoma,U.S. Senate,Jim Rogers,DEM,550026,0,0,4,4,
Oklahoma,Superintendent of Public Instruction,John Cox,DEM,550027,0,0,2,2,
Oklahoma,Superintendent of Public Instruction,Freda Deskin,DEM,550027,0,0,0,0,
Oklahoma,U.S. Senate,Connie Johnson,DEM,550027,0,0,2,2,
Oklahoma,U.S. Senate,Jim Rogers,DEM,550027,0,0,0,0,
Oklahoma,Superintendent of Public Instruction,John Cox,DEM,550028,0,0,30,30,
Oklahoma,Superintendent of Public Instruction,Freda Deskin,DEM,550028,0,0,36,36,
Oklahoma,U.S. Senate,Connie Johnson,DEM,550028,0,0,52,52,
Oklahoma,U.S. Senate,Jim Rogers,DEM,550028,0,0,14,14,
Oklahoma,U.S. House,Tom Guild,DEM,550028,0,0,37,37,05
Oklahoma,U.S. House,Al Mcaffrey,DEM,550028,0,0,29,29,05
Oklahoma,U.S. House,Steve Russell,REP,550028,0,0,61,61,05
Oklahoma,U.S. House,Patrice Douglas,REP,550028,0,0,25,25,05
Oklahoma,Superintendent of Public Instruction,John Cox,DEM,550029,0,0,33,33,
Oklahoma,Superintendent of Public Instruction,Freda Deskin,DEM,550029,0,0,25,25,
Oklahoma,U.S. Senate,Connie Johnson,DEM,550029,0,0,37,37,
Oklahoma,U.S. Senate,Jim Rogers,DEM,550029,0,0,21,21,
Oklahoma,U.S. House,Tom Guild,DEM,550029,0,0,28,28,05
Oklahoma,U.S. House,Al Mcaffrey,DEM,550029,0,0,30,30,05
Oklahoma,U.S. House,Steve Russell,REP,550029,0,0,92,92,05
Oklahoma,U.S. House,Patrice Douglas,REP,550029,0,0,36,36,05
Oklahoma,Superintendent of Public Instruction,John Cox,DEM,550030,0,0,29,29,
Oklahoma,Superintendent of Public Instruction,Freda Deskin,DEM,550030,0,0,26,26,
Oklahoma,U.S. Senate,Connie Johnson,DEM,550030,0,0,46,46,
Oklahoma,U.S. Senate,Jim Rogers,DEM,550030,0,0,10,10,
Oklahoma,U.S. House,Tom Guild,DEM,550030,0,0,24,24,05
Oklahoma,U.S. House,Al Mcaffrey,DEM,550030,0,0,30,30,05
Oklahoma,U.S. House,Steve Russell,REP,550030,0,0,55,55,05
Oklahoma,U.S. House,Patrice Douglas,REP,550030,0,0,17,17,05
Oklahoma,Superintendent of Public Instruction,John Cox,DEM,550031,0,0,38,38,
Oklahoma,Superintendent of Public Instruction,Freda Deskin,DEM,550031,0,0,33,33,
Oklahoma,U.S. Senate,Connie Johnson,DEM,550031,0,0,49,49,
Oklahoma,U.S. Senate,Jim Rogers,DEM,550031,0,0,21,21,
Oklahoma,U.S. House,Tom Guild,DEM,550031,0,0,39,39,05
Oklahoma,U.S. House,Al Mcaffrey,DEM,550031,0,0,31,31,05
Oklahoma,U.S. House,Steve Russell,REP,550031,0,0,116,116,05
Oklahoma,U.S. House,Patrice Douglas,REP,550031,0,0,32,32,05
Oklahoma,Superintendent of Public Instruction,John Cox,DEM,550032,0,0,21,21,
Oklahoma,Superintendent of Public Instruction,Freda Deskin,DEM,550032,0,0,22,22,
Oklahoma,U.S. Senate,Connie Johnson,DEM,550032,0,0,30,30,
Oklahoma,U.S. Senate,Jim Rogers,DEM,550032,0,0,12,12,
Oklahoma,U.S. House,Tom Guild,DEM,550032,0,0,25,25,05
Oklahoma,U.S. House,Al Mcaffrey,DEM,550032,0,0,17,17,05
Oklahoma,U.S. House,Steve Russell,REP,550032,0,0,96,96,05
Oklahoma,U.S. House,Patrice Douglas,REP,550032,0,0,19,19,05
Oklahoma,Superintendent of Public Instruction,John Cox,DEM,550033,0,0,60,60,
Oklahoma,Superintendent of Public Instruction,Freda Deskin,DEM,550033,0,0,51,51,
Oklahoma,U.S. Senate,Connie Johnson,DEM,550033,0,0,67,67,
Oklahoma,U.S. Senate,Jim Rogers,DEM,550033,0,0,42,42,
Oklahoma,U.S. House,Tom Guild,DEM,550033,0,0,55,55,05
Oklahoma,U.S. House,Al Mcaffrey,DEM,550033,0,0,56,56,05
Oklahoma,U.S. House,Steve Russell,REP,550033,0,0,179,179,05
Oklahoma,U.S. House,Patrice Douglas,REP,550033,0,0,41,41,05
Oklahoma,Superintendent of Public Instruction,John Cox,DEM,550034,0,0,8,8,
Oklahoma,Superintendent of Public Instruction,Freda Deskin,DEM,550034,0,0,3,3,
Oklahoma,U.S. Senate,Connie Johnson,DEM,550034,0,0,5,5,
Oklahoma,U.S. Senate,Jim Rogers,DEM,550034,0,0,6,6,
Oklahoma,U.S. House,Tom Guild,DEM,550034,0,0,4,4,05
Oklahoma,U.S. House,Al Mcaffrey,DEM,550034,0,0,7,7,05
Oklahoma,U.S. House,Steve Russell,REP,550034,0,0,77,77,05
Oklahoma,U.S. House,Patrice Douglas,REP,550034,0,0,34,34,05
Oklahoma,State Senate,Stephanie Bice,REP,550034,0,0,53,53,22
Oklahoma,State Senate,Mark Thomas,REP,550034,0,0,57,57,22
Oklahoma,Superintendent of Public Instruction,John Cox,DEM,550035,0,0,17,17,
Oklahoma,Superintendent of Public Instruction,Freda Deskin,DEM,550035,0,0,31,31,
Oklahoma,U.S. Senate,Connie Johnson,DEM,550035,0,0,41,41,
Oklahoma,U.S. Senate,Jim Rogers,DEM,550035,0,0,6,6,
Oklahoma,U.S. House,Tom Guild,DEM,550035,0,0,23,23,05
Oklahoma,U.S. House,Al Mcaffrey,DEM,550035,0,0,25,25,05
Oklahoma,U.S. House,Steve Russell,REP,550035,0,0,132,132,05
Oklahoma,U.S. House,Patrice Douglas,REP,550035,0,0,91,91,05
Oklahoma,State Senate,Stephanie Bice,REP,550035,0,0,151,151,22
Oklahoma,State Senate,Mark Thomas,REP,550035,0,0,67,67,22
Oklahoma,Superintendent of Public Instruction,John Cox,DEM,550036,0,0,23,23,
Oklahoma,Superintendent of Public Instruction,Freda Deskin,DEM,550036,0,0,13,13,
Oklahoma,U.S. Senate,Connie Johnson,DEM,550036,0,0,28,28,
Oklahoma,U.S. Senate,Jim Rogers,DEM,550036,0,0,7,7,
Oklahoma,U.S. House,Tom Guild,DEM,550036,0,0,19,19,05
Oklahoma,U.S. House,Al Mcaffrey,DEM,550036,0,0,17,17,05
Oklahoma,U.S. House,Steve Russell,REP,550036,0,0,99,99,05
Oklahoma,U.S. House,Patrice Douglas,REP,550036,0,0,79,79,05
Oklahoma,State Senate,Stephanie Bice,REP,550036,0,0,108,108,22
Oklahoma,State Senate,Mark Thomas,REP,550036,0,0,64,64,22
Oklahoma,Superintendent of Public Instruction,John Cox,DEM,550037,0,0,35,35,
Oklahoma,Superintendent of Public Instruction,Freda Deskin,DEM,550037,0,0,22,22,
Oklahoma,U.S. Senate,Connie Johnson,DEM,550037,0,0,46,46,
Oklahoma,U.S. Senate,Jim Rogers,DEM,550037,0,0,10,10,
Oklahoma,U.S. House,Tom Guild,DEM,550037,0,0,29,29,05
Oklahoma,U.S. House,Al Mcaffrey,DEM,550037,0,0,28,28,05
Oklahoma,U.S. House,Steve Russell,REP,550037,0,0,133,133,05
Oklahoma,U.S. House,Patrice Douglas,REP,550037,0,0,86,86,05
Oklahoma,State Senate,Stephanie Bice,REP,550037,0,0,107,107,22
Oklahoma,State Senate,Mark Thomas,REP,550037,0,0,109,109,22
Oklahoma,Superintendent of Public Instruction,John Cox,DEM,550038,0,0,22,22,
Oklahoma,Superintendent of Public Instruction,Freda Deskin,DEM,550038,0,0,29,29,
Oklahoma,U.S. Senate,Connie Johnson,DEM,550038,0,0,39,39,
Oklahoma,U.S. Senate,Jim Rogers,DEM,550038,0,0,9,9,
Oklahoma,U.S. House,Tom Guild,DEM,550038,0,0,25,25,05
Oklahoma,U.S. House,Al Mcaffrey,DEM,550038,0,0,25,25,05
Oklahoma,U.S. House,Steve Russell,REP,550038,0,0,105,105,05
Oklahoma,U.S. House,Patrice Douglas,REP,550038,0,0,65,65,05
Oklahoma,State Senate,Stephanie Bice,REP,550038,0,0,119,119,22
Oklahoma,State Senate,Mark Thomas,REP,550038,0,0,48,48,22
Oklahoma,Superintendent of Public Instruction,John Cox,DEM,550039,0,0,26,26,
Oklahoma,Superintendent of Public Instruction,Freda Deskin,DEM,550039,0,0,11,11,
Oklahoma,U.S. Senate,Connie Johnson,DEM,550039,0,0,30,30,
Oklahoma,U.S. Senate,Jim Rogers,DEM,550039,0,0,8,8,
Oklahoma,U.S. House,Tom Guild,DEM,550039,0,0,24,24,05
Oklahoma,U.S. House,Al Mcaffrey,DEM,550039,0,0,13,13,05
Oklahoma,U.S. House,Steve Russell,REP,550039,0,0,86,86,05
Oklahoma,U.S. House,Patrice Douglas,REP,550039,0,0,71,71,05
Oklahoma,Superintendent of Public Instruction,John Cox,DEM,550040,0,0,21,21,
Oklahoma,Superintendent of Public Instruction,Freda Deskin,DEM,550040,0,0,35,35,
Oklahoma,U.S. Senate,Connie Johnson,DEM,550040,0,0,48,48,
Oklahoma,U.S. Senate,Jim Rogers,DEM,550040,0,0,9,9,
Oklahoma,U.S. House,Tom Guild,DEM,550040,0,0,23,23,05
Oklahoma,U.S. House,Al Mcaffrey,DEM,550040,0,0,32,32,05
Oklahoma,U.S. House,Steve Russell,REP,550040,0,0,139,139,05
Oklahoma,U.S. House,Patrice Douglas,REP,550040,0,0,94,94,05
Oklahoma,State Senate,Stephanie Bice,REP,550040,0,0,141,141,22
Oklahoma,State Senate,Mark Thomas,REP,550040,0,0,91,91,22
Oklahoma,Superintendent of Public Instruction,John Cox,DEM,550041,0,0,21,21,
Oklahoma,Superintendent of Public Instruction,Freda Deskin,DEM,550041,0,0,28,28,
Oklahoma,U.S. Senate,Connie Johnson,DEM,550041,0,0,40,40,
Oklahoma,U.S. Senate,Jim Rogers,DEM,550041,0,0,8,8,
Oklahoma,U.S. House,Tom Guild,DEM,550041,0,0,23,23,05
Oklahoma,U.S. House,Al Mcaffrey,DEM,550041,0,0,27,27,05
Oklahoma,U.S. House,Steve Russell,REP,550041,0,0,81,81,05
Oklahoma,U.S. House,Patrice Douglas,REP,550041,0,0,62,62,05
Oklahoma,State Senate,Stephanie Bice,REP,550041,0,0,73,73,22
Oklahoma,State Senate,Mark Thomas,REP,550041,0,0,67,67,22
Oklahoma,Superintendent of Public Instruction,John Cox,DEM,550042,0,0,10,10,
Oklahoma,Superintendent of Public Instruction,Freda Deskin,DEM,550042,0,0,15,15,
Oklahoma,U.S. Senate,Connie Johnson,DEM,550042,0,0,17,17,
Oklahoma,U.S. Senate,Jim Rogers,DEM,550042,0,0,7,7,
Oklahoma,U.S. House,Tom Guild,DEM,550042,0,0,13,13,05
Oklahoma,U.S. House,Al Mcaffrey,DEM,550042,0,0,12,12,05
Oklahoma,U.S. House,Steve Russell,REP,550042,0,0,116,116,05
Oklahoma,U.S. House,Patrice Douglas,REP,550042,0,0,90,90,05
Oklahoma,Superintendent of Public Instruction,John Cox,DEM,550043,0,0,13,13,
Oklahoma,Superintendent of Public Instruction,Freda Deskin,DEM,550043,0,0,27,27,
Oklahoma,U.S. Senate,Connie Johnson,DEM,550043,0,0,31,31,
Oklahoma,U.S. Senate,Jim Rogers,DEM,550043,0,0,9,9,
Oklahoma,U.S. House,Tom Guild,DEM,550043,0,0,15,15,05
Oklahoma,U.S. House,Al Mcaffrey,DEM,550043,0,0,24,24,05
Oklahoma,U.S. House,Steve Russell,REP,550043,0,0,227,227,05
Oklahoma,U.S. House,Patrice Douglas,REP,550043,0,0,154,154,05
Oklahoma,Superintendent of Public Instruction,John Cox,DEM,550044,0,0,30,30,
Oklahoma,Superintendent of Public Instruction,Freda Deskin,DEM,550044,0,0,28,28,
Oklahoma,U.S. Senate,Connie Johnson,DEM,550044,0,0,41,41,
Oklahoma,U.S. Senate,Jim Rogers,DEM,550044,0,0,16,16,
Oklahoma,U.S. House,Tom Guild,DEM,550044,0,0,27,27,05
Oklahoma,U.S. House,Al Mcaffrey,DEM,550044,0,0,32,32,05
Oklahoma,U.S. House,Steve Russell,REP,550044,0,0,224,224,05
Oklahoma,U.S. House,Patrice Douglas,REP,550044,0,0,105,105,05
Oklahoma,Superintendent of Public Instruction,John Cox,DEM,550045,0,0,33,33,
Oklahoma,Superintendent of Public Instruction,Freda Deskin,DEM,550045,0,0,39,39,
Oklahoma,U.S. Senate,Connie Johnson,DEM,550045,0,0,56,56,
Oklahoma,U.S. Senate,Jim Rogers,DEM,550045,0,0,16,16,
Oklahoma,U.S. House,Tom Guild,DEM,550045,0,0,40,40,05
Oklahoma,U.S. House,Al Mcaffrey,DEM,550045,0,0,32,32,05
Oklahoma,U.S. House,Steve Russell,REP,550045,0,0,205,205,05
Oklahoma,U.S. House,Patrice Douglas,REP,550045,0,0,191,191,05
Oklahoma,Superintendent of Public Instruction,John Cox,DEM,550046,0,0,17,17,
Oklahoma,Superintendent of Public Instruction,Freda Deskin,DEM,550046,0,0,13,13,
Oklahoma,U.S. Senate,Connie Johnson,DEM,550046,0,0,20,20,
Oklahoma,U.S. Senate,Jim Rogers,DEM,550046,0,0,8,8,
Oklahoma,U.S. House,Tom Guild,DEM,550046,0,0,11,11,05
Oklahoma,U.S. House,Al Mcaffrey,DEM,550046,0,0,17,17,05
Oklahoma,U.S. House,Steve Russell,REP,550046,0,0,47,47,05
Oklahoma,U.S. House,Patrice Douglas,REP,550046,0,0,43,43,05
Oklahoma,Superintendent of Public Instruction,John Cox,DEM,550047,0,0,17,17,
Oklahoma,Superintendent of Public Instruction,Freda Deskin,DEM,550047,0,0,24,24,
Oklahoma,U.S. Senate,Connie Johnson,DEM,550047,0,0,28,28,
Oklahoma,U.S. Senate,Jim Rogers,DEM,550047,0,0,13,13,
Oklahoma,U.S. House,Tom Guild,DEM,550047,0,0,25,25,05
Oklahoma,U.S. House,Al Mcaffrey,DEM,550047,0,0,16,16,05
Oklahoma,U.S. House,Steve Russell,REP,550047,0,0,39,39,05
Oklahoma,U.S. House,Patrice Douglas,REP,550047,0,0,31,31,05
Oklahoma,Superintendent of Public Instruction,John Cox,DEM,550048,0,0,15,15,
Oklahoma,Superintendent of Public Instruction,Freda Deskin,DEM,550048,0,0,16,16,
Oklahoma,U.S. Senate,Connie Johnson,DEM,550048,0,0,24,24,
Oklahoma,U.S. Senate,Jim Rogers,DEM,550048,0,0,7,7,
Oklahoma,U.S. House,Tom Guild,DEM,550048,0,0,13,13,05
Oklahoma,U.S. House,Al Mcaffrey,DEM,550048,0,0,18,18,05
Oklahoma,U.S. House,Steve Russell,REP,550048,0,0,74,74,05
Oklahoma,U.S. House,Patrice Douglas,REP,550048,0,0,33,33,05
Oklahoma,Superintendent of Public Instruction,John Cox,DEM,550049,0,0,20,20,
Oklahoma,Superintendent of Public Instruction,Freda Deskin,DEM,550049,0,0,18,18,
Oklahoma,U.S. Senate,Connie Johnson,DEM,550049,0,0,30,30,
Oklahoma,U.S. Senate,Jim Rogers,DEM,550049,0,0,8,8,
Oklahoma,U.S. House,Tom Guild,DEM,550049,0,0,23,23,05
Oklahoma,U.S. House,Al Mcaffrey,DEM,550049,0,0,15,15,05
Oklahoma,U.S. House,Steve Russell,REP,550049,0,0,28,28,05
Oklahoma,U.S. House,Patrice Douglas,REP,550049,0,0,20,20,05
Oklahoma,Superintendent of Public Instruction,John Cox,DEM,550050,0,0,0,0,
Oklahoma,Superintendent of Public Instruction,Freda Deskin,DEM,550050,0,0,0,0,
Oklahoma,U.S. Senate,Connie Johnson,DEM,550050,0,0,0,0,
Oklahoma,U.S. Senate,Jim Rogers,DEM,550050,0,0,0,0,
Oklahoma,U.S. House,Tom Guild,DEM,550050,0,0,0,0,05
Oklahoma,U.S. House,Al Mcaffrey,DEM,550050,0,0,0,0,05
Oklahoma,U.S. House,Steve Russell,REP,550050,0,0,4,4,05
Oklahoma,U.S. House,Patrice Douglas,REP,550050,0,0,0,0,05
Oklahoma,Superintendent of Public Instruction,John Cox,DEM,550051,0,0,17,17,
Oklahoma,Superintendent of Public Instruction,Freda Deskin,DEM,550051,0,0,22,22,
Oklahoma,U.S. Senate,Connie Johnson,DEM,550051,0,0,27,27,
Oklahoma,U.S. Senate,Jim Rogers,DEM,550051,0,0,10,10,
Oklahoma,U.S. House,Tom Guild,DEM,550051,0,0,19,19,05
Oklahoma,U.S. House,Al Mcaffrey,DEM,550051,0,0,19,19,05
Oklahoma,U.S. House,Steve Russell,REP,550051,0,0,55,55,05
Oklahoma,U.S. House,Patrice Douglas,REP,550051,0,0,61,61,05
Oklahoma,Superintendent of Public Instruction,John Cox,DEM,550052,0,0,28,28,
Oklahoma,Superintendent of Public Instruction,Freda Deskin,DEM,550052,0,0,12,12,
Oklahoma,U.S. Senate,Connie Johnson,DEM,550052,0,0,29,29,
Oklahoma,U.S. Senate,Jim Rogers,DEM,550052,0,0,11,11,
Oklahoma,U.S. House,Tom Guild,DEM,550052,0,0,25,25,05
Oklahoma,U.S. House,Al Mcaffrey,DEM,550052,0,0,16,16,05
Oklahoma,U.S. House,Steve Russell,REP,550052,0,0,109,109,05
Oklahoma,U.S. House,Patrice Douglas,REP,550052,0,0,113,113,05
Oklahoma,Superintendent of Public Instruction,John Cox,DEM,550053,0,0,27,27,
Oklahoma,Superintendent of Public Instruction,Freda Deskin,DEM,550053,0,0,22,22,
Oklahoma,U.S. Senate,Connie Johnson,DEM,550053,0,0,32,32,
Oklahoma,U.S. Senate,Jim Rogers,DEM,550053,0,0,18,18,
Oklahoma,U.S. House,Tom Guild,DEM,550053,0,0,24,24,05
Oklahoma,U.S. House,Al Mcaffrey,DEM,550053,0,0,25,25,05
Oklahoma,U.S. House,Steve Russell,REP,550053,0,0,93,93,05
Oklahoma,U.S. House,Patrice Douglas,REP,550053,0,0,49,49,05
Oklahoma,Superintendent of Public Instruction,John Cox,DEM,550054,0,0,25,25,
Oklahoma,Superintendent of Public Instruction,Freda Deskin,DEM,550054,0,0,36,36,
Oklahoma,U.S. Senate,Connie Johnson,DEM,550054,0,0,45,45,
Oklahoma,U.S. Senate,Jim Rogers,DEM,550054,0,0,16,16,
Oklahoma,U.S. House,Tom Guild,DEM,550054,0,0,32,32,05
Oklahoma,U.S. House,Al Mcaffrey,DEM,550054,0,0,29,29,05
Oklahoma,U.S. House,Steve Russell,REP,550054,0,0,114,114,05
Oklahoma,U.S. House,Patrice Douglas,REP,550054,0,0,90,90,05
Oklahoma,Superintendent of Public Instruction,John Cox,DEM,550055,0,0,29,29,
Oklahoma,Superintendent of Public Instruction,Freda Deskin,DEM,550055,0,0,19,19,
Oklahoma,U.S. Senate,Connie Johnson,DEM,550055,0,0,36,36,
Oklahoma,U.S. Senate,Jim Rogers,DEM,550055,0,0,12,12,
Oklahoma,U.S. House,Tom Guild,DEM,550055,0,0,29,29,05
Oklahoma,U.S. House,Al Mcaffrey,DEM,550055,0,0,19,19,05
Oklahoma,U.S. House,Steve Russell,REP,550055,0,0,136,136,05
Oklahoma,U.S. House,Patrice Douglas,REP,550055,0,0,73,73,05
Oklahoma,Superintendent of Public Instruction,John Cox,DEM,550056,0,0,12,12,
Oklahoma,Superintendent of Public Instruction,Freda Deskin,DEM,550056,0,0,18,18,
Oklahoma,U.S. Senate,Connie Johnson,DEM,550056,0,0,25,25,
Oklahoma,U.S. Senate,Jim Rogers,DEM,550056,0,0,4,4,
Oklahoma,U.S. House,Tom Guild,DEM,550056,0,0,15,15,05
Oklahoma,U.S. House,Al Mcaffrey,DEM,550056,0,0,14,14,05
Oklahoma,U.S. House,Steve Russell,REP,550056,0,0,108,108,05
Oklahoma,U.S. House,Patrice Douglas,REP,550056,0,0,90,90,05
Oklahoma,Superintendent of Public Instruction,John Cox,DEM,550057,0,0,16,16,
Oklahoma,Superintendent of Public Instruction,Freda Deskin,DEM,550057,0,0,17,17,
Oklahoma,U.S. Senate,Connie Johnson,DEM,550057,0,0,29,29,
Oklahoma,U.S. Senate,Jim Rogers,DEM,550057,0,0,4,4,
Oklahoma,U.S. House,Tom Guild,DEM,550057,0,0,12,12,05
Oklahoma,U.S. House,Al Mcaffrey,DEM,550057,0,0,20,20,05
Oklahoma,U.S. House,Steve Russell,REP,550057,0,0,120,120,05
Oklahoma,U.S. House,Patrice Douglas,REP,550057,0,0,62,62,05
Oklahoma,Superintendent of Public Instruction,John Cox,DEM,550058,0,0,30,30,
Oklahoma,Superintendent of Public Instruction,Freda Deskin,DEM,550058,0,0,48,48,
Oklahoma,U.S. Senate,Connie Johnson,DEM,550058,0,0,67,67,
Oklahoma,U.S. Senate,Jim Rogers,DEM,550058,0,0,9,9,
Oklahoma,U.S. House,Tom Guild,DEM,550058,0,0,37,37,05
Oklahoma,U.S. House,Al Mcaffrey,DEM,550058,0,0,37,37,05
Oklahoma,U.S. House,Steve Russell,REP,550058,0,0,347,347,05
Oklahoma,U.S. House,Patrice Douglas,REP,550058,0,0,235,235,05
Oklahoma,Superintendent of Public Instruction,John Cox,DEM,550059,0,0,14,14,
Oklahoma,Superintendent of Public Instruction,Freda Deskin,DEM,550059,0,0,18,18,
Oklahoma,U.S. Senate,Connie Johnson,DEM,550059,0,0,25,25,
Oklahoma,U.S. Senate,Jim Rogers,DEM,550059,0,0,6,6,
Oklahoma,U.S. House,Tom Guild,DEM,550059,0,0,12,12,05
Oklahoma,U.S. House,Al Mcaffrey,DEM,550059,0,0,19,19,05
Oklahoma,U.S. House,Steve Russell,REP,550059,0,0,161,161,05
Oklahoma,U.S. House,Patrice Douglas,REP,550059,0,0,118,118,05
Oklahoma,Superintendent of Public Instruction,John Cox,DEM,550060,0,0,41,41,
Oklahoma,Superintendent of Public Instruction,Freda Deskin,DEM,550060,0,0,45,45,
Oklahoma,U.S. Senate,Connie Johnson,DEM,550060,0,0,65,65,
Oklahoma,U.S. Senate,Jim Rogers,DEM,550060,0,0,22,22,
Oklahoma,U.S. House,Tom Guild,DEM,550060,0,0,42,42,05
Oklahoma,U.S. House,Al Mcaffrey,DEM,550060,0,0,46,46,05
Oklahoma,U.S. House,Steve Russell,REP,550060,0,0,222,222,05
Oklahoma,U.S. House,Patrice Douglas,REP,550060,0,0,153,153,05
Oklahoma,Superintendent of Public Instruction,John Cox,DEM,550061,0,0,27,27,
Oklahoma,Superintendent of Public Instruction,Freda Deskin,DEM,550061,0,0,40,40,
Oklahoma,U.S. Senate,Connie Johnson,DEM,550061,0,0,55,55,
Oklahoma,U.S. Senate,Jim Rogers,DEM,550061,0,0,9,9,
Oklahoma,U.S. House,Tom Guild,DEM,550061,0,0,29,29,05
Oklahoma,U.S. House,Al Mcaffrey,DEM,550061,0,0,36,36,05
Oklahoma,U.S. House,Steve Russell,REP,550061,0,0,264,264,05
Oklahoma,U.S. House,Patrice Douglas,REP,550061,0,0,165,165,05
Oklahoma,Superintendent of Public Instruction,John Cox,DEM,550062,0,0,38,38,
Oklahoma,Superintendent of Public Instruction,Freda Deskin,DEM,550062,0,0,28,28,
Oklahoma,U.S. Senate,Connie Johnson,DEM,550062,0,0,51,51,
Oklahoma,U.S. Senate,Jim Rogers,DEM,550062,0,0,13,13,
Oklahoma,U.S. House,Tom Guild,DEM,550062,0,0,27,27,05
Oklahoma,U.S. House,Al Mcaffrey,DEM,550062,0,0,34,34,05
Oklahoma,U.S. House,Steve Russell,REP,550062,0,0,264,264,05
Oklahoma,U.S. House,Patrice Douglas,REP,550062,0,0,194,194,05
Oklahoma,Superintendent of Public Instruction,John Cox,DEM,550063,0,0,16,16,
Oklahoma,Superintendent of Public Instruction,Freda Deskin,DEM,550063,0,0,11,11,
Oklahoma,U.S. Senate,Connie Johnson,DEM,550063,0,0,22,22,
Oklahoma,U.S. Senate,Jim Rogers,DEM,550063,0,0,5,5,
Oklahoma,U.S. House,Tom Guild,DEM,550063,0,0,12,12,05
Oklahoma,U.S. House,Al Mcaffrey,DEM,550063,0,0,15,15,05
Oklahoma,U.S. House,Steve Russell,REP,550063,0,0,94,94,05
Oklahoma,U.S. House,Patrice Douglas,REP,550063,0,0,65,65,05
Oklahoma,Superintendent of Public Instruction,John Cox,DEM,550064,0,0,19,19,
Oklahoma,Superintendent of Public Instruction,Freda Deskin,DEM,550064,0,0,28,28,
Oklahoma,U.S. Senate,Connie Johnson,DEM,550064,0,0,40,40,
Oklahoma,U.S. Senate,Jim Rogers,DEM,550064,0,0,7,7,
Oklahoma,U.S. House,Tom Guild,DEM,550064,0,0,14,14,05
Oklahoma,U.S. House,Al Mcaffrey,DEM,550064,0,0,34,34,05
Oklahoma,U.S. House,Steve Russell,REP,550064,0,0,176,176,05
Oklahoma,U.S. House,Patrice Douglas,REP,550064,0,0,142,142,05
Oklahoma,Superintendent of Public Instruction,John Cox,DEM,550065,0,0,27,27,
Oklahoma,Superintendent of Public Instruction,Freda Deskin,DEM,550065,0,0,27,27,
Oklahoma,U.S. Senate,Connie Johnson,DEM,550065,0,0,50,50,
Oklahoma,U.S. Senate,Jim Rogers,DEM,550065,0,0,4,4,
Oklahoma,U.S. House,Tom Guild,DEM,550065,0,0,26,26,05
Oklahoma,U.S. House,Al Mcaffrey,DEM,550065,0,0,27,27,05
Oklahoma,U.S. House,Steve Russell,REP,550065,0,0,74,74,05
Oklahoma,U.S. House,Patrice Douglas,REP,550065,0,0,43,43,05
Oklahoma,Superintendent of Public Instruction,John Cox,DEM,550066,0,0,146,146,
Oklahoma,Superintendent of Public Instruction,Freda Deskin,DEM,550066,0,0,148,148,
Oklahoma,U.S. Senate,Connie Johnson,DEM,550066,0,0,273,273,
Oklahoma,U.S. Senate,Jim Rogers,DEM,550066,0,0,22,22,
Oklahoma,U.S. House,Tom Guild,DEM,550066,0,0,130,130,05
Oklahoma,U.S. House,Al Mcaffrey,DEM,550066,0,0,160,160,05
Oklahoma,U.S. House,Steve Russell,REP,550066,0,0,38,38,05
Oklahoma,U.S. House,Patrice Douglas,REP,550066,0,0,14,14,05
Oklahoma,Superintendent of Public Instruction,John Cox,DEM,550067,0,0,29,29,
Oklahoma,Superintendent of Public Instruction,Freda Deskin,DEM,550067,0,0,17,17,
Oklahoma,U.S. Senate,Connie Johnson,DEM,550067,0,0,26,26,
Oklahoma,U.S. Senate,Jim Rogers,DEM,550067,0,0,18,18,
Oklahoma,U.S. House,Tom Guild,DEM,550067,0,0,24,24,05
Oklahoma,U.S. House,Al Mcaffrey,DEM,550067,0,0,18,18,05
Oklahoma,U.S. House,Steve Russell,REP,550067,0,0,72,72,05
Oklahoma,U.S. House,Patrice Douglas,REP,550067,0,0,52,52,05
Oklahoma,Superintendent of Public Instruction,John Cox,DEM,550068,0,0,19,19,
Oklahoma,Superintendent of Public Instruction,Freda Deskin,DEM,550068,0,0,15,15,
Oklahoma,U.S. Senate,Connie Johnson,DEM,550068,0,0,24,24,
Oklahoma,U.S. Senate,Jim Rogers,DEM,550068,0,0,10,10,
Oklahoma,U.S. House,Tom Guild,DEM,550068,0,0,18,18,05
Oklahoma,U.S. House,Al Mcaffrey,DEM,550068,0,0,15,15,05
Oklahoma,U.S. House,Steve Russell,REP,550068,0,0,52,52,05
Oklahoma,U.S. House,Patrice Douglas,REP,550068,0,0,32,32,05
Oklahoma,Superintendent of Public Instruction,John Cox,DEM,550069,0,0,17,17,
Oklahoma,Superintendent of Public Instruction,Freda Deskin,DEM,550069,0,0,20,20,
Oklahoma,U.S. Senate,Connie Johnson,DEM,550069,0,0,27,27,
Oklahoma,U.S. Senate,Jim Rogers,DEM,550069,0,0,10,10,
Oklahoma,U.S. House,Tom Guild,DEM,550069,0,0,19,19,05
Oklahoma,U.S. House,Al Mcaffrey,DEM,550069,0,0,18,18,05
Oklahoma,U.S. House,Steve Russell,REP,550069,0,0,81,81,05
Oklahoma,U.S. House,Patrice Douglas,REP,550069,0,0,32,32,05
Oklahoma,Superintendent of Public Instruction,John Cox,DEM,550070,0,0,18,18,
Oklahoma,Superintendent of Public Instruction,Freda Deskin,DEM,550070,0,0,11,11,
Oklahoma,U.S. Senate,Connie Johnson,DEM,550070,0,0,18,18,
Oklahoma,U.S. Senate,Jim Rogers,DEM,550070,0,0,10,10,
Oklahoma,U.S. House,Tom Guild,DEM,550070,0,0,16,16,05
Oklahoma,U.S. House,Al Mcaffrey,DEM,550070,0,0,12,12,05
Oklahoma,U.S. House,Steve Russell,REP,550070,0,0,59,59,05
Oklahoma,U.S. House,Patrice Douglas,REP,550070,0,0,36,36,05
Oklahoma,Superintendent of Public Instruction,John Cox,DEM,550071,0,0,33,33,
Oklahoma,Superintendent of Public Instruction,Freda Deskin,DEM,550071,0,0,22,22,
Oklahoma,U.S. Senate,Connie Johnson,DEM,550071,0,0,32,32,
Oklahoma,U.S. Senate,Jim Rogers,DEM,550071,0,0,21,21,
Oklahoma,U.S. House,Tom Guild,DEM,550071,0,0,30,30,05
Oklahoma,U.S. House,Al Mcaffrey,DEM,550071,0,0,24,24,05
Oklahoma,U.S. House,Steve Russell,REP,550071,0,0,92,92,05
Oklahoma,U.S. House,Patrice Douglas,REP,550071,0,0,39,39,05
Oklahoma,Superintendent of Public Instruction,John Cox,DEM,550072,0,0,24,24,
Oklahoma,Superintendent of Public Instruction,Freda Deskin,DEM,550072,0,0,16,16,
Oklahoma,U.S. Senate,Connie Johnson,DEM,550072,0,0,24,24,
Oklahoma,U.S. Senate,Jim Rogers,DEM,550072,0,0,16,16,
Oklahoma,U.S. House,Tom Guild,DEM,550072,0,0,22,22,05
Oklahoma,U.S. House,Al Mcaffrey,DEM,550072,0,0,18,18,05
Oklahoma,U.S. House,Steve Russell,REP,550072,0,0,57,57,05
Oklahoma,U.S. House,Patrice Douglas,REP,550072,0,0,31,31,05
Oklahoma,Superintendent of Public Instruction,John Cox,DEM,550073,0,0,8,8,
Oklahoma,Superintendent of Public Instruction,Freda Deskin,DEM,550073,0,0,4,4,
Oklahoma,U.S. Senate,Connie Johnson,DEM,550073,0,0,8,8,
Oklahoma,U.S. Senate,Jim Rogers,DEM,550073,0,0,4,4,
Oklahoma,U.S. House,Tom Guild,DEM,550073,0,0,5,5,05
Oklahoma,U.S. House,Al Mcaffrey,DEM,550073,0,0,7,7,05
Oklahoma,U.S. House,Steve Russell,REP,550073,0,0,16,16,05
Oklahoma,U.S. House,Patrice Douglas,REP,550073,0,0,5,5,05
Oklahoma,Superintendent of Public Instruction,John Cox,DEM,550074,0,0,28,28,
Oklahoma,Superintendent of Public Instruction,Freda Deskin,DEM,550074,0,0,14,14,
Oklahoma,U.S. Senate,Connie Johnson,DEM,550074,0,0,42,42,
Oklahoma,U.S. Senate,Jim Rogers,DEM,550074,0,0,1,1,
Oklahoma,U.S. House,Tom Guild,DEM,550074,0,0,17,17,05
Oklahoma,U.S. House,Al Mcaffrey,DEM,550074,0,0,25,25,05
Oklahoma,U.S. House,Steve Russell,REP,550074,0,0,2,2,05
Oklahoma,U.S. House,Patrice Douglas,REP,550074,0,0,1,1,05
Oklahoma,Superintendent of Public Instruction,John Cox,DEM,550075,0,0,78,78,
Oklahoma,Superintendent of Public Instruction,Freda Deskin,DEM,550075,0,0,77,77,
Oklahoma,U.S. Senate,Connie Johnson,DEM,550075,0,0,143,143,
Oklahoma,U.S. Senate,Jim Rogers,DEM,550075,0,0,12,12,
Oklahoma,U.S. House,Tom Guild,DEM,550075,0,0,80,80,05
Oklahoma,U.S. House,Al Mcaffrey,DEM,550075,0,0,72,72,05
Oklahoma,U.S. House,Steve Russell,REP,550075,0,0,18,18,05
Oklahoma,U.S. House,Patrice Douglas,REP,550075,0,0,14,14,05
Oklahoma,Superintendent of Public Instruction,John Cox,DEM,550076,0,0,44,44,
Oklahoma,Superintendent of Public Instruction,Freda Deskin,DEM,550076,0,0,20,20,
Oklahoma,U.S. Senate,Connie Johnson,DEM,550076,0,0,36,36,
Oklahoma,U.S. Senate,Jim Rogers,DEM,550076,0,0,27,27,
Oklahoma,U.S. House,Tom Guild,DEM,550076,0,0,25,25,05
Oklahoma,U.S. House,Al Mcaffrey,DEM,550076,0,0,39,39,05
Oklahoma,U.S. House,Steve Russell,REP,550076,0,0,51,51,05
Oklahoma,U.S. House,Patrice Douglas,REP,550076,0,0,26,26,05
Oklahoma,Superintendent of Public Instruction,John Cox,DEM,550077,0,0,69,69,
Oklahoma,Superintendent of Public Instruction,Freda Deskin,DEM,550077,0,0,84,84,
Oklahoma,U.S. Senate,Connie Johnson,DEM,550077,0,0,147,147,
Oklahoma,U.S. Senate,Jim Rogers,DEM,550077,0,0,13,13,
Oklahoma,U.S. House,Tom Guild,DEM,550077,0,0,62,62,05
Oklahoma,U.S. House,Al Mcaffrey,DEM,550077,0,0,94,94,05
Oklahoma,U.S. House,Steve Russell,REP,550077,0,0,31,31,05
Oklahoma,U.S. House,Patrice Douglas,REP,550077,0,0,11,11,05
Oklahoma,Superintendent of Public Instruction,John Cox,DEM,550078,0,0,64,64,
Oklahoma,Superintendent of Public Instruction,Freda Deskin,DEM,550078,0,0,43,43,
Oklahoma,U.S. Senate,Connie Johnson,DEM,550078,0,0,103,103,
Oklahoma,U.S. Senate,Jim Rogers,DEM,550078,0,0,5,5,
Oklahoma,U.S. House,Tom Guild,DEM,550078,0,0,61,61,05
Oklahoma,U.S. House,Al Mcaffrey,DEM,550078,0,0,45,45,05
Oklahoma,U.S. House,Steve Russell,REP,550078,0,0,14,14,05
Oklahoma,U.S. House,Patrice Douglas,REP,550078,0,0,4,4,05
Oklahoma,Superintendent of Public Instruction,John Cox,DEM,550079,0,0,61,61,
Oklahoma,Superintendent of Public Instruction,Freda Deskin,DEM,550079,0,0,58,58,
Oklahoma,U.S. Senate,Connie Johnson,DEM,550079,0,0,115,115,
Oklahoma,U.S. Senate,Jim Rogers,DEM,550079,0,0,4,4,
Oklahoma,U.S. House,Tom Guild,DEM,550079,0,0,54,54,05
Oklahoma,U.S. House,Al Mcaffrey,DEM,550079,0,0,61,61,05
Oklahoma,U.S. House,Steve Russell,REP,550079,0,0,17,17,05
Oklahoma,U.S. House,Patrice Douglas,REP,550079,0,0,10,10,05
Oklahoma,Superintendent of Public Instruction,John Cox,DEM,550080,0,0,61,61,
Oklahoma,Superintendent of Public Instruction,Freda Deskin,DEM,550080,0,0,44,44,
Oklahoma,U.S. Senate,Connie Johnson,DEM,550080,0,0,78,78,
Oklahoma,U.S. Senate,Jim Rogers,DEM,550080,0,0,27,27,
Oklahoma,Superintendent of Public Instruction,John Cox,DEM,550081,0,0,24,24,
Oklahoma,Superintendent of Public Instruction,Freda Deskin,DEM,550081,0,0,21,21,
Oklahoma,U.S. Senate,Connie Johnson,DEM,550081,0,0,30,30,
Oklahoma,U.S. Senate,Jim Rogers,DEM,550081,0,0,15,15,
Oklahoma,Superintendent of Public Instruction,John Cox,DEM,550082,0,0,16,16,
Oklahoma,Superintendent of Public Instruction,Freda Deskin,DEM,550082,0,0,11,11,
Oklahoma,U.S. Senate,Connie Johnson,DEM,550082,0,0,20,20,
Oklahoma,U.S. Senate,Jim Rogers,DEM,550082,0,0,7,7,
Oklahoma,Superintendent of Public Instruction,John Cox,DEM,550083,0,0,18,18,
Oklahoma,Superintendent of Public Instruction,Freda Deskin,DEM,550083,0,0,19,19,
Oklahoma,U.S. Senate,Connie Johnson,DEM,550083,0,0,29,29,
Oklahoma,U.S. Senate,Jim Rogers,DEM,550083,0,0,8,8,
Oklahoma,Superintendent of Public Instruction,John Cox,DEM,550084,0,0,28,28,
Oklahoma,Superintendent of Public Instruction,Freda Deskin,DEM,550084,0,0,22,22,
Oklahoma,U.S. Senate,Connie Johnson,DEM,550084,0,0,38,38,
Oklahoma,U.S. Senate,Jim Rogers,DEM,550084,0,0,11,11,
Oklahoma,Superintendent of Public Instruction,John Cox,DEM,550085,0,0,37,37,
Oklahoma,Superintendent of Public Instruction,Freda Deskin,DEM,550085,0,0,27,27,
Oklahoma,U.S. Senate,Connie Johnson,DEM,550085,0,0,49,49,
Oklahoma,U.S. Senate,Jim Rogers,DEM,550085,0,0,15,15,
Oklahoma,Superintendent of Public Instruction,John Cox,DEM,550086,0,0,57,57,
Oklahoma,Superintendent of Public Instruction,Freda Deskin,DEM,550086,0,0,29,29,
Oklahoma,U.S. Senate,Connie Johnson,DEM,550086,0,0,64,64,
Oklahoma,U.S. Senate,Jim Rogers,DEM,550086,0,0,21,21,
Oklahoma,Superintendent of Public Instruction,John Cox,DEM,550087,0,0,21,21,
Oklahoma,Superintendent of Public Instruction,Freda Deskin,DEM,550087,0,0,20,20,
Oklahoma,U.S. Senate,Connie Johnson,DEM,550087,0,0,35,35,
Oklahoma,U.S. Senate,Jim Rogers,DEM,550087,0,0,6,6,
Oklahoma,Superintendent of Public Instruction,John Cox,DEM,550088,0,0,11,11,
Oklahoma,Superintendent of Public Instruction,Freda Deskin,DEM,550088,0,0,14,14,
Oklahoma,U.S. Senate,Connie Johnson,DEM,550088,0,0,22,22,
Oklahoma,U.S. Senate,Jim Rogers,DEM,550088,0,0,3,3,
Oklahoma,Superintendent of Public Instruction,John Cox,DEM,550089,0,0,39,39,
Oklahoma,Superintendent of Public Instruction,Freda Deskin,DEM,550089,0,0,43,43,
Oklahoma,U.S. Senate,Connie Johnson,DEM,550089,0,0,70,70,
Oklahoma,U.S. Senate,Jim Rogers,DEM,550089,0,0,11,11,
Oklahoma,U.S. House,Tom Guild,DEM,550089,0,0,35,35,05
Oklahoma,U.S. House,Al Mcaffrey,DEM,550089,0,0,45,45,05
Oklahoma,U.S. House,Steve Russell,REP,550089,0,0,16,16,05
Oklahoma,U.S. House,Patrice Douglas,REP,550089,0,0,8,8,05
Oklahoma,Superintendent of Public Instruction,John Cox,DEM,550090,0,0,4,4,
Oklahoma,Superintendent of Public Instruction,Freda Deskin,DEM,550090,0,0,10,10,
Oklahoma,U.S. Senate,Connie Johnson,DEM,550090,0,0,13,13,
Oklahoma,U.S. Senate,Jim Rogers,DEM,550090,0,0,1,1,
Oklahoma,U.S. House,Tom Guild,DEM,550090,0,0,7,7,05
Oklahoma,U.S. House,Al Mcaffrey,DEM,550090,0,0,7,7,05
Oklahoma,U.S. House,Steve Russell,REP,550090,0,0,7,7,05
Oklahoma,U.S. House,Patrice Douglas,REP,550090,0,0,3,3,05
Oklahoma,Superintendent of Public Instruction,John Cox,DEM,550091,0,0,8,8,
Oklahoma,Superintendent of Public Instruction,Freda Deskin,DEM,550091,0,0,6,6,
Oklahoma,U.S. Senate,Connie Johnson,DEM,550091,0,0,13,13,
Oklahoma,U.S. Senate,Jim Rogers,DEM,550091,0,0,1,1,
Oklahoma,Superintendent of Public Instruction,John Cox,DEM,550092,0,0,76,76,
Oklahoma,Superintendent of Public Instruction,Freda Deskin,DEM,550092,0,0,60,60,
Oklahoma,U.S. Senate,Connie Johnson,DEM,550092,0,0,120,120,
Oklahoma,U.S. Senate,Jim Rogers,DEM,550092,0,0,17,17,
Oklahoma,Superintendent of Public Instruction,John Cox,DEM,550093,0,0,14,14,
Oklahoma,Superintendent of Public Instruction,Freda Deskin,DEM,550093,0,0,13,13,
Oklahoma,U.S. Senate,Connie Johnson,DEM,550093,0,0,22,22,
Oklahoma,U.S. Senate,Jim Rogers,DEM,550093,0,0,5,5,
Oklahoma,Superintendent of Public Instruction,John Cox,DEM,550094,0,0,26,26,
Oklahoma,Superintendent of Public Instruction,Freda Deskin,DEM,550094,0,0,22,22,
Oklahoma,U.S. Senate,Connie Johnson,DEM,550094,0,0,41,41,
Oklahoma,U.S. Senate,Jim Rogers,DEM,550094,0,0,9,9,
Oklahoma,Superintendent of Public Instruction,John Cox,DEM,550095,0,0,42,42,
Oklahoma,Superintendent of Public Instruction,Freda Deskin,DEM,550095,0,0,21,21,
Oklahoma,U.S. Senate,Connie Johnson,DEM,550095,0,0,44,44,
Oklahoma,U.S. Senate,Jim Rogers,DEM,550095,0,0,17,17,
Oklahoma,Superintendent of Public Instruction,John Cox,DEM,550096,0,0,31,31,
Oklahoma,Superintendent of Public Instruction,Freda Deskin,DEM,550096,0,0,20,20,
Oklahoma,U.S. Senate,Connie Johnson,DEM,550096,0,0,40,40,
Oklahoma,U.S. Senate,Jim Rogers,DEM,550096,0,0,11,11,
Oklahoma,Superintendent of Public Instruction,John Cox,DEM,550097,0,0,41,41,
Oklahoma,Superintendent of Public Instruction,Freda Deskin,DEM,550097,0,0,20,20,
Oklahoma,U.S. Senate,Connie Johnson,DEM,550097,0,0,49,49,
Oklahoma,U.S. Senate,Jim Rogers,DEM,550097,0,0,12,12,
Oklahoma,Superintendent of Public Instruction,John Cox,DEM,550098,0,0,21,21,
Oklahoma,Superintendent of Public Instruction,Freda Deskin,DEM,550098,0,0,15,15,
Oklahoma,U.S. Senate,Connie Johnson,DEM,550098,0,0,26,26,
Oklahoma,U.S. Senate,Jim Rogers,DEM,550098,0,0,9,9,
Oklahoma,Superintendent of Public Instruction,John Cox,DEM,550099,0,0,17,17,
Oklahoma,Superintendent of Public Instruction,Freda Deskin,DEM,550099,0,0,43,43,
Oklahoma,U.S. Senate,Connie Johnson,DEM,550099,0,0,46,46,
Oklahoma,U.S. Senate,Jim Rogers,DEM,550099,0,0,11,11,
Oklahoma,U.S. House,Tom Guild,DEM,550099,0,0,15,15,05
Oklahoma,U.S. House,Al Mcaffrey,DEM,550099,0,0,42,42,05
Oklahoma,U.S. House,Steve Russell,REP,550099,0,0,110,110,05
Oklahoma,U.S. House,Patrice Douglas,REP,550099,0,0,127,127,05
Oklahoma,State Senate,Ervin Yen,REP,550099,0,0,206,206,40
Oklahoma,State Senate,Steve Kern,REP,550099,0,0,32,32,40
Oklahoma,Superintendent of Public Instruction,John Cox,DEM,550100,0,0,20,20,
Oklahoma,Superintendent of Public Instruction,Freda Deskin,DEM,550100,0,0,49,49,
Oklahoma,U.S. Senate,Connie Johnson,DEM,550100,0,0,54,54,
Oklahoma,U.S. Senate,Jim Rogers,DEM,550100,0,0,11,11,
Oklahoma,U.S. House,Tom Guild,DEM,550100,0,0,18,18,05
Oklahoma,U.S. House,Al Mcaffrey,DEM,550100,0,0,47,47,05
Oklahoma,U.S. House,Steve Russell,REP,550100,0,0,151,151,05
Oklahoma,U.S. House,Patrice Douglas,REP,550100,0,0,191,191,05
Oklahoma,State Senate,Ervin Yen,REP,550100,0,0,305,305,40
Oklahoma,State Senate,Steve Kern,REP,550100,0,0,37,37,40
Oklahoma,Superintendent of Public Instruction,John Cox,DEM,550101,0,0,6,6,
Oklahoma,Superintendent of Public Instruction,Freda Deskin,DEM,550101,0,0,15,15,
Oklahoma,U.S. Senate,Connie Johnson,DEM,550101,0,0,18,18,
Oklahoma,U.S. Senate,Jim Rogers,DEM,550101,0,0,3,3,
Oklahoma,U.S. House,Tom Guild,DEM,550101,0,0,6,6,05
Oklahoma,U.S. House,Al Mcaffrey,DEM,550101,0,0,15,15,05
Oklahoma,U.S. House,Steve Russell,REP,550101,0,0,86,86,05
Oklahoma,U.S. House,Patrice Douglas,REP,550101,0,0,77,77,05
Oklahoma,State Senate,Ervin Yen,REP,550101,0,0,159,159,40
Oklahoma,State Senate,Steve Kern,REP,550101,0,0,6,6,40
Oklahoma,Superintendent of Public Instruction,John Cox,DEM,550102,0,0,27,27,
Oklahoma,Superintendent of Public Instruction,Freda Deskin,DEM,550102,0,0,64,64,
Oklahoma,U.S. Senate,Connie Johnson,DEM,550102,0,0,82,82,
Oklahoma,U.S. Senate,Jim Rogers,DEM,550102,0,0,10,10,
Oklahoma,U.S. House,Tom Guild,DEM,550102,0,0,33,33,05
Oklahoma,U.S. House,Al Mcaffrey,DEM,550102,0,0,58,58,05
Oklahoma,U.S. House,Steve Russell,REP,550102,0,0,137,137,05
Oklahoma,U.S. House,Patrice Douglas,REP,550102,0,0,158,158,05
Oklahoma,State Senate,Ervin Yen,REP,550102,0,0,252,252,40
Oklahoma,State Senate,Steve Kern,REP,550102,0,0,48,48,40
Oklahoma,Superintendent of Public Instruction,John Cox,DEM,550103,0,0,19,19,
Oklahoma,Superintendent of Public Instruction,Freda Deskin,DEM,550103,0,0,25,25,
Oklahoma,U.S. Senate,Connie Johnson,DEM,550103,0,0,34,34,
Oklahoma,U.S. Senate,Jim Rogers,DEM,550103,0,0,11,11,
Oklahoma,U.S. House,Tom Guild,DEM,550103,0,0,12,12,05
Oklahoma,U.S. House,Al Mcaffrey,DEM,550103,0,0,33,33,05
Oklahoma,U.S. House,Steve Russell,REP,550103,0,0,53,53,05
Oklahoma,U.S. House,Patrice Douglas,REP,550103,0,0,55,55,05
Oklahoma,State Senate,Ervin Yen,REP,550103,0,0,75,75,40
Oklahoma,State Senate,Steve Kern,REP,550103,0,0,33,33,40
Oklahoma,Superintendent of Public Instruction,John Cox,DEM,550104,0,0,23,23,
Oklahoma,Superintendent of Public Instruction,Freda Deskin,DEM,550104,0,0,32,32,
Oklahoma,U.S. Senate,Connie Johnson,DEM,550104,0,0,44,44,
Oklahoma,U.S. Senate,Jim Rogers,DEM,550104,0,0,10,10,
Oklahoma,U.S. House,Tom Guild,DEM,550104,0,0,29,29,05
Oklahoma,U.S. House,Al Mcaffrey,DEM,550104,0,0,25,25,05
Oklahoma,U.S. House,Steve Russell,REP,550104,0,0,45,45,05
Oklahoma,U.S. House,Patrice Douglas,REP,550104,0,0,23,23,05
Oklahoma,Superintendent of Public Instruction,John Cox,DEM,550105,0,0,25,25,
Oklahoma,Superintendent of Public Instruction,Freda Deskin,DEM,550105,0,0,36,36,
Oklahoma,U.S. Senate,Connie Johnson,DEM,550105,0,0,48,48,
Oklahoma,U.S. Senate,Jim Rogers,DEM,550105,0,0,14,14,
Oklahoma,U.S. House,Tom Guild,DEM,550105,0,0,25,25,05
Oklahoma,U.S. House,Al Mcaffrey,DEM,550105,0,0,37,37,05
Oklahoma,U.S. House,Steve Russell,REP,550105,0,0,73,73,05
Oklahoma,U.S. House,Patrice Douglas,REP,550105,0,0,64,64,05
Oklahoma,Superintendent of Public Instruction,John Cox,DEM,550106,0,0,41,41,
Oklahoma,Superintendent of Public Instruction,Freda Deskin,DEM,550106,0,0,46,46,
Oklahoma,U.S. Senate,Connie Johnson,DEM,550106,0,0,59,59,
Oklahoma,U.S. Senate,Jim Rogers,DEM,550106,0,0,26,26,
Oklahoma,U.S. House,Tom Guild,DEM,550106,0,0,34,34,05
Oklahoma,U.S. House,Al Mcaffrey,DEM,550106,0,0,51,51,05
Oklahoma,U.S. House,Steve Russell,REP,550106,0,0,109,109,05
Oklahoma,U.S. House,Patrice Douglas,REP,550106,0,0,75,75,05
Oklahoma,Superintendent of Public Instruction,John Cox,DEM,550107,0,0,12,12,
Oklahoma,Superintendent of Public Instruction,Freda Deskin,DEM,550107,0,0,3,3,
Oklahoma,U.S. Senate,Connie Johnson,DEM,550107,0,0,13,13,
Oklahoma,U.S. Senate,Jim Rogers,DEM,550107,0,0,1,1,
Oklahoma,U.S. House,Tom Guild,DEM,550107,0,0,6,6,05
Oklahoma,U.S. House,Al Mcaffrey,DEM,550107,0,0,8,8,05
Oklahoma,U.S. House,Steve Russell,REP,550107,0,0,28,28,05
Oklahoma,U.S. House,Patrice Douglas,REP,550107,0,0,7,7,05
Oklahoma,Superintendent of Public Instruction,John Cox,DEM,550108,0,0,8,8,
Oklahoma,Superintendent of Public Instruction,Freda Deskin,DEM,550108,0,0,8,8,
Oklahoma,U.S. Senate,Connie Johnson,DEM,550108,0,0,15,15,
Oklahoma,U.S. Senate,Jim Rogers,DEM,550108,0,0,1,1,
Oklahoma,U.S. House,Tom Guild,DEM,550108,0,0,5,5,05
Oklahoma,U.S. House,Al Mcaffrey,DEM,550108,0,0,11,11,05
Oklahoma,U.S. House,Steve Russell,REP,550108,0,0,35,35,05
Oklahoma,U.S. House,Patrice Douglas,REP,550108,0,0,15,15,05
Oklahoma,Superintendent of Public Instruction,John Cox,DEM,550109,0,0,45,45,
Oklahoma,Superintendent of Public Instruction,Freda Deskin,DEM,550109,0,0,43,43,
Oklahoma,U.S. Senate,Connie Johnson,DEM,550109,0,0,66,66,
Oklahoma,U.S. Senate,Jim Rogers,DEM,550109,0,0,18,18,
Oklahoma,U.S. House,Tom Guild,DEM,550109,0,0,35,35,05
Oklahoma,U.S. House,Al Mcaffrey,DEM,550109,0,0,53,53,05
Oklahoma,U.S. House,Steve Russell,REP,550109,0,0,161,161,05
Oklahoma,U.S. House,Patrice Douglas,REP,550109,0,0,106,106,05
Oklahoma,Superintendent of Public Instruction,John Cox,DEM,550110,0,0,2,2,
Oklahoma,Superintendent of Public Instruction,Freda Deskin,DEM,550110,0,0,8,8,
Oklahoma,U.S. Senate,Connie Johnson,DEM,550110,0,0,9,9,
Oklahoma,U.S. Senate,Jim Rogers,DEM,550110,0,0,1,1,
Oklahoma,U.S. House,Tom Guild,DEM,550110,0,0,3,3,05
Oklahoma,U.S. House,Al Mcaffrey,DEM,550110,0,0,7,7,05
Oklahoma,U.S. House,Steve Russell,REP,550110,0,0,37,37,05
Oklahoma,U.S. House,Patrice Douglas,REP,550110,0,0,47,47,05
Oklahoma,Superintendent of Public Instruction,John Cox,DEM,550111,0,0,43,43,
Oklahoma,Superintendent of Public Instruction,Freda Deskin,DEM,550111,0,0,35,35,
Oklahoma,U.S. Senate,Connie Johnson,DEM,550111,0,0,67,67,
Oklahoma,U.S. Senate,Jim Rogers,DEM,550111,0,0,11,11,
Oklahoma,U.S. House,Tom Guild,DEM,550111,0,0,38,38,05
Oklahoma,U.S. House,Al Mcaffrey,DEM,550111,0,0,38,38,05
Oklahoma,U.S. House,Steve Russell,REP,550111,0,0,166,166,05
Oklahoma,U.S. House,Patrice Douglas,REP,550111,0,0,102,102,05
Oklahoma,Superintendent of Public Instruction,John Cox,DEM,550112,0,0,13,13,
Oklahoma,Superintendent of Public Instruction,Freda Deskin,DEM,550112,0,0,8,8,
Oklahoma,U.S. Senate,Connie Johnson,DEM,550112,0,0,18,18,
Oklahoma,U.S. Senate,Jim Rogers,DEM,550112,0,0,3,3,
Oklahoma,U.S. House,Tom Guild,DEM,550112,0,0,3,3,05
Oklahoma,U.S. House,Al Mcaffrey,DEM,550112,0,0,17,17,05
Oklahoma,U.S. House,Steve Russell,REP,550112,0,0,20,20,05
Oklahoma,U.S. House,Patrice Douglas,REP,550112,0,0,9,9,05
Oklahoma,Superintendent of Public Instruction,John Cox,DEM,550113,0,0,18,18,
Oklahoma,Superintendent of Public Instruction,Freda Deskin,DEM,550113,0,0,22,22,
Oklahoma,U.S. Senate,Connie Johnson,DEM,550113,0,0,37,37,
Oklahoma,U.S. Senate,Jim Rogers,DEM,550113,0,0,4,4,
Oklahoma,U.S. House,Tom Guild,DEM,550113,0,0,17,17,05
Oklahoma,U.S. House,Al Mcaffrey,DEM,550113,0,0,25,25,05
Oklahoma,U.S. House,Steve Russell,REP,550113,0,0,17,17,05
Oklahoma,U.S. House,Patrice Douglas,REP,550113,0,0,8,8,05
Oklahoma,Superintendent of Public Instruction,John Cox,DEM,550114,0,0,118,118,
Oklahoma,Superintendent of Public Instruction,Freda Deskin,DEM,550114,0,0,141,141,
Oklahoma,U.S. Senate,Connie Johnson,DEM,550114,0,0,261,261,
Oklahoma,U.S. Senate,Jim Rogers,DEM,550114,0,0,4,4,
Oklahoma,U.S. House,Tom Guild,DEM,550114,0,0,125,125,05
Oklahoma,U.S. House,Al Mcaffrey,DEM,550114,0,0,134,134,05
Oklahoma,U.S. House,Steve Russell,REP,550114,0,0,7,7,05
Oklahoma,U.S. House,Patrice Douglas,REP,550114,0,0,6,6,05
Oklahoma,Superintendent of Public Instruction,John Cox,DEM,550115,0,0,141,141,
Oklahoma,Superintendent of Public Instruction,Freda Deskin,DEM,550115,0,0,152,152,
Oklahoma,U.S. Senate,Connie Johnson,DEM,550115,0,0,292,292,
Oklahoma,U.S. Senate,Jim Rogers,DEM,550115,0,0,7,7,
Oklahoma,U.S. House,Tom Guild,DEM,550115,0,0,120,120,05
Oklahoma,U.S. House,Al Mcaffrey,DEM,550115,0,0,172,172,05
Oklahoma,U.S. House,Steve Russell,REP,550115,0,0,7,7,05
Oklahoma,U.S. House,Patrice Douglas,REP,550115,0,0,3,3,05
Oklahoma,Superintendent of Public Instruction,John Cox,DEM,550116,0,0,13,13,
Oklahoma,Superintendent of Public Instruction,Freda Deskin,DEM,550116,0,0,22,22,
Oklahoma,U.S. Senate,Connie Johnson,DEM,550116,0,0,34,34,
Oklahoma,U.S. Senate,Jim Rogers,DEM,550116,0,0,2,2,
Oklahoma,U.S. House,Tom Guild,DEM,550116,0,0,5,5,05
Oklahoma,U.S. House,Al Mcaffrey,DEM,550116,0,0,30,30,05
Oklahoma,State House,George Young,DEM,550116,0,0,8,8,99
Oklahoma,State House,Eleanor Darden Thompson,DEM,550116,0,0,26,26,99
Oklahoma,U.S. House,Steve Russell,REP,550116,0,0,18,18,05
Oklahoma,U.S. House,Patrice Douglas,REP,550116,0,0,7,7,05
Oklahoma,Superintendent of Public Instruction,John Cox,DEM,550117,0,0,170,170,
Oklahoma,Superintendent of Public Instruction,Freda Deskin,DEM,550117,0,0,166,166,
Oklahoma,U.S. Senate,Connie Johnson,DEM,550117,0,0,336,336,
Oklahoma,U.S. Senate,Jim Rogers,DEM,550117,0,0,8,8,
Oklahoma,U.S. House,Tom Guild,DEM,550117,0,0,162,162,05
Oklahoma,U.S. House,Al Mcaffrey,DEM,550117,0,0,172,172,05
Oklahoma,U.S. House,Steve Russell,REP,550117,0,0,20,20,05
Oklahoma,U.S. House,Patrice Douglas,REP,550117,0,0,9,9,05
Oklahoma,Superintendent of Public Instruction,John Cox,DEM,550118,0,0,68,68,
Oklahoma,Superintendent of Public Instruction,Freda Deskin,DEM,550118,0,0,104,104,
Oklahoma,U.S. Senate,Connie Johnson,DEM,550118,0,0,159,159,
Oklahoma,U.S. Senate,Jim Rogers,DEM,550118,0,0,19,19,
Oklahoma,U.S. House,Tom Guild,DEM,550118,0,0,93,93,05
Oklahoma,U.S. House,Al Mcaffrey,DEM,550118,0,0,83,83,05
Oklahoma,State House,George Young,DEM,550118,0,0,112,112,99
Oklahoma,State House,Eleanor Darden Thompson,DEM,550118,0,0,64,64,99
Oklahoma,U.S. House,Steve Russell,REP,550118,0,0,24,24,05
Oklahoma,U.S. House,Patrice Douglas,REP,550118,0,0,13,13,05
Oklahoma,Superintendent of Public Instruction,John Cox,DEM,550119,0,0,1,1,
Oklahoma,Superintendent of Public Instruction,Freda Deskin,DEM,550119,0,0,15,15,
Oklahoma,U.S. Senate,Connie Johnson,DEM,550119,0,0,14,14,
Oklahoma,U.S. Senate,Jim Rogers,DEM,550119,0,0,2,2,
Oklahoma,U.S. House,Tom Guild,DEM,550119,0,0,3,3,05
Oklahoma,U.S. House,Al Mcaffrey,DEM,550119,0,0,14,14,05
Oklahoma,U.S. House,Steve Russell,REP,550119,0,0,21,21,05
Oklahoma,U.S. House,Patrice Douglas,REP,550119,0,0,15,15,05
Oklahoma,State Senate,Ervin Yen,REP,550119,0,0,32,32,40
Oklahoma,State Senate,Steve Kern,REP,550119,0,0,3,3,40
Oklahoma,Superintendent of Public Instruction,John Cox,DEM,550120,0,0,51,51,
Oklahoma,Superintendent of Public Instruction,Freda Deskin,DEM,550120,0,0,64,64,
Oklahoma,U.S. Senate,Connie Johnson,DEM,550120,0,0,107,107,
Oklahoma,U.S. Senate,Jim Rogers,DEM,550120,0,0,9,9,
Oklahoma,U.S. House,Tom Guild,DEM,550120,0,0,55,55,05
Oklahoma,U.S. House,Al Mcaffrey,DEM,550120,0,0,61,61,05
Oklahoma,State House,George Young,DEM,550120,0,0,64,64,99
Oklahoma,State House,Eleanor Darden Thompson,DEM,550120,0,0,51,51,99
Oklahoma,U.S. House,Steve Russell,REP,550120,0,0,26,26,05
Oklahoma,U.S. House,Patrice Douglas,REP,550120,0,0,11,11,05
Oklahoma,Superintendent of Public Instruction,John Cox,DEM,550121,0,0,95,95,
Oklahoma,Superintendent of Public Instruction,Freda Deskin,DEM,550121,0,0,81,81,
Oklahoma,U.S. Senate,Connie Johnson,DEM,550121,0,0,173,173,
Oklahoma,U.S. Senate,Jim Rogers,DEM,550121,0,0,5,5,
Oklahoma,U.S. House,Tom Guild,DEM,550121,0,0,92,92,05
Oklahoma,U.S. House,Al Mcaffrey,DEM,550121,0,0,84,84,05
Oklahoma,State House,George Young,DEM,550121,0,0,105,105,99
Oklahoma,State House,Eleanor Darden Thompson,DEM,550121,0,0,72,72,99
Oklahoma,U.S. House,Steve Russell,REP,550121,0,0,11,11,05
Oklahoma,U.S. House,Patrice Douglas,REP,550121,0,0,9,9,05
Oklahoma,Superintendent of Public Instruction,John Cox,DEM,550122,0,0,51,51,
Oklahoma,Superintendent of Public Instruction,Freda Deskin,DEM,550122,0,0,64,64,
Oklahoma,U.S. Senate,Connie Johnson,DEM,550122,0,0,104,104,
Oklahoma,U.S. Senate,Jim Rogers,DEM,550122,0,0,11,11,
Oklahoma,U.S. House,Tom Guild,DEM,550122,0,0,52,52,05
Oklahoma,U.S. House,Al Mcaffrey,DEM,550122,0,0,60,60,05
Oklahoma,State House,George Young,DEM,550122,0,0,74,74,99
Oklahoma,State House,Eleanor Darden Thompson,DEM,550122,0,0,42,42,99
Oklahoma,U.S. House,Steve Russell,REP,550122,0,0,27,27,05
Oklahoma,U.S. House,Patrice Douglas,REP,550122,0,0,26,26,05
Oklahoma,Superintendent of Public Instruction,John Cox,DEM,550123,0,0,85,85,
Oklahoma,Superintendent of Public Instruction,Freda Deskin,DEM,550123,0,0,118,118,
Oklahoma,U.S. Senate,Connie Johnson,DEM,550123,0,0,196,196,
Oklahoma,U.S. Senate,Jim Rogers,DEM,550123,0,0,10,10,
Oklahoma,U.S. House,Tom Guild,DEM,550123,0,0,99,99,05
Oklahoma,U.S. House,Al Mcaffrey,DEM,550123,0,0,104,104,05
Oklahoma,State House,George Young,DEM,550123,0,0,152,152,99
Oklahoma,State House,Eleanor Darden Thompson,DEM,550123,0,0,53,53,99
Oklahoma,U.S. House,Steve Russell,REP,550123,0,0,47,47,05
Oklahoma,U.S. House,Patrice Douglas,REP,550123,0,0,28,28,05
Oklahoma,Superintendent of Public Instruction,John Cox,DEM,550124,0,0,48,48,
Oklahoma,Superintendent of Public Instruction,Freda Deskin,DEM,550124,0,0,63,63,
Oklahoma,U.S. Senate,Connie Johnson,DEM,550124,0,0,101,101,
Oklahoma,U.S. Senate,Jim Rogers,DEM,550124,0,0,13,13,
Oklahoma,U.S. House,Tom Guild,DEM,550124,0,0,49,49,05
Oklahoma,U.S. House,Al Mcaffrey,DEM,550124,0,0,62,62,05
Oklahoma,U.S. House,Steve Russell,REP,550124,0,0,77,77,05
Oklahoma,U.S. House,Patrice Douglas,REP,550124,0,0,51,51,05
Oklahoma,Superintendent of Public Instruction,John Cox,DEM,550125,0,0,6,6,
Oklahoma,Superintendent of Public Instruction,Freda Deskin,DEM,550125,0,0,15,15,
Oklahoma,U.S. Senate,Connie Johnson,DEM,550125,0,0,20,20,
Oklahoma,U.S. Senate,Jim Rogers,DEM,550125,0,0,1,1,
Oklahoma,U.S. House,Tom Guild,DEM,550125,0,0,12,12,05
Oklahoma,U.S. House,Al Mcaffrey,DEM,550125,0,0,9,9,05
Oklahoma,State House,George Young,DEM,550125,0,0,7,7,99
Oklahoma,State House,Eleanor Darden Thompson,DEM,550125,0,0,13,13,99
Oklahoma,U.S. House,Steve Russell,REP,550125,0,0,5,5,05
Oklahoma,U.S. House,Patrice Douglas,REP,550125,0,0,3,3,05
Oklahoma,Superintendent of Public Instruction,John Cox,DEM,550126,0,0,36,36,
Oklahoma,Superintendent of Public Instruction,Freda Deskin,DEM,550126,0,0,30,30,
Oklahoma,U.S. Senate,Connie Johnson,DEM,550126,0,0,59,59,
Oklahoma,U.S. Senate,Jim Rogers,DEM,550126,0,0,9,9,
Oklahoma,U.S. House,Tom Guild,DEM,550126,0,0,35,35,05
Oklahoma,U.S. House,Al Mcaffrey,DEM,550126,0,0,31,31,05
Oklahoma,U.S. House,Steve Russell,REP,550126,0,0,39,39,05
Oklahoma,U.S. House,Patrice Douglas,REP,550126,0,0,26,26,05
Oklahoma,Superintendent of Public Instruction,John Cox,DEM,550127,0,0,31,31,
Oklahoma,Superintendent of Public Instruction,Freda Deskin,DEM,550127,0,0,23,23,
Oklahoma,U.S. Senate,Connie Johnson,DEM,550127,0,0,42,42,
Oklahoma,U.S. Senate,Jim Rogers,DEM,550127,0,0,12,12,
Oklahoma,U.S. House,Tom Guild,DEM,550127,0,0,30,30,05
Oklahoma,U.S. House,Al Mcaffrey,DEM,550127,0,0,23,23,05
Oklahoma,U.S. House,Steve Russell,REP,550127,0,0,95,95,05
Oklahoma,U.S. House,Patrice Douglas,REP,550127,0,0,95,95,05
Oklahoma,Superintendent of Public Instruction,John Cox,DEM,550128,0,0,29,29,
Oklahoma,Superintendent of Public Instruction,Freda Deskin,DEM,550128,0,0,25,25,
Oklahoma,U.S. Senate,Connie Johnson,DEM,550128,0,0,48,48,
Oklahoma,U.S. Senate,Jim Rogers,DEM,550128,0,0,6,6,
Oklahoma,U.S. House,Tom Guild,DEM,550128,0,0,26,26,05
Oklahoma,U.S. House,Al Mcaffrey,DEM,550128,0,0,27,27,05
Oklahoma,U.S. House,Steve Russell,REP,550128,0,0,67,67,05
Oklahoma,U.S. House,Patrice Douglas,REP,550128,0,0,42,42,05
Oklahoma,Superintendent of Public Instruction,John Cox,DEM,550129,0,0,18,18,
Oklahoma,Superintendent of Public Instruction,Freda Deskin,DEM,550129,0,0,19,19,
Oklahoma,U.S. Senate,Connie Johnson,DEM,550129,0,0,33,33,
Oklahoma,U.S. Senate,Jim Rogers,DEM,550129,0,0,5,5,
Oklahoma,U.S. House,Tom Guild,DEM,550129,0,0,16,16,05
Oklahoma,U.S. House,Al Mcaffrey,DEM,550129,0,0,20,20,05
Oklahoma,U.S. House,Steve Russell,REP,550129,0,0,63,63,05
Oklahoma,U.S. House,Patrice Douglas,REP,550129,0,0,47,47,05
Oklahoma,Superintendent of Public Instruction,John Cox,DEM,550130,0,0,31,31,
Oklahoma,Superintendent of Public Instruction,Freda Deskin,DEM,550130,0,0,39,39,
Oklahoma,U.S. Senate,Connie Johnson,DEM,550130,0,0,67,67,
Oklahoma,U.S. Senate,Jim Rogers,DEM,550130,0,0,3,3,
Oklahoma,U.S. House,Tom Guild,DEM,550130,0,0,40,40,05
Oklahoma,U.S. House,Al Mcaffrey,DEM,550130,0,0,34,34,05
Oklahoma,U.S. House,Steve Russell,REP,550130,0,0,146,146,05
Oklahoma,U.S. House,Patrice Douglas,REP,550130,0,0,92,92,05
Oklahoma,Superintendent of Public Instruction,John Cox,DEM,550131,0,0,16,16,
Oklahoma,Superintendent of Public Instruction,Freda Deskin,DEM,550131,0,0,23,23,
Oklahoma,U.S. Senate,Connie Johnson,DEM,550131,0,0,34,34,
Oklahoma,U.S. Senate,Jim Rogers,DEM,550131,0,0,6,6,
Oklahoma,U.S. House,Tom Guild,DEM,550131,0,0,18,18,05
Oklahoma,U.S. House,Al Mcaffrey,DEM,550131,0,0,21,21,05
Oklahoma,U.S. House,Steve Russell,REP,550131,0,0,62,62,05
Oklahoma,U.S. House,Patrice Douglas,REP,550131,0,0,73,73,05
Oklahoma,Superintendent of Public Instruction,John Cox,DEM,550132,0,0,7,7,
Oklahoma,Superintendent of Public Instruction,Freda Deskin,DEM,550132,0,0,19,19,
Oklahoma,U.S. Senate,Connie Johnson,DEM,550132,0,0,20,20,
Oklahoma,U.S. Senate,Jim Rogers,DEM,550132,0,0,7,7,
Oklahoma,U.S. House,Tom Guild,DEM,550132,0,0,14,14,05
Oklahoma,U.S. House,Al Mcaffrey,DEM,550132,0,0,12,12,05
Oklahoma,U.S. House,Steve Russell,REP,550132,0,0,71,71,05
Oklahoma,U.S. House,Patrice Douglas,REP,550132,0,0,43,43,05
Oklahoma,Superintendent of Public Instruction,John Cox,DEM,550133,0,0,9,9,
Oklahoma,Superintendent of Public Instruction,Freda Deskin,DEM,550133,0,0,12,12,
Oklahoma,U.S. Senate,Connie Johnson,DEM,550133,0,0,19,19,
Oklahoma,U.S. Senate,Jim Rogers,DEM,550133,0,0,2,2,
Oklahoma,U.S. House,Tom Guild,DEM,550133,0,0,12,12,05
Oklahoma,U.S. House,Al Mcaffrey,DEM,550133,0,0,9,9,05
Oklahoma,U.S. House,Steve Russell,REP,550133,0,0,67,67,05
Oklahoma,U.S. House,Patrice Douglas,REP,550133,0,0,52,52,05
Oklahoma,State Senate,Stephanie Bice,REP,550133,0,0,71,71,22
Oklahoma,State Senate,Mark Thomas,REP,550133,0,0,47,47,22
Oklahoma,Superintendent of Public Instruction,John Cox,DEM,550134,0,0,32,32,
Oklahoma,Superintendent of Public Instruction,Freda Deskin,DEM,550134,0,0,43,43,
Oklahoma,U.S. Senate,Connie Johnson,DEM,550134,0,0,66,66,
Oklahoma,U.S. Senate,Jim Rogers,DEM,550134,0,0,8,8,
Oklahoma,U.S. House,Tom Guild,DEM,550134,0,0,25,25,05
Oklahoma,U.S. House,Al Mcaffrey,DEM,550134,0,0,49,49,05
Oklahoma,U.S. House,Steve Russell,REP,550134,0,0,173,173,05
Oklahoma,U.S. House,Patrice Douglas,REP,550134,0,0,135,135,05
Oklahoma,State Senate,Stephanie Bice,REP,550134,0,0,208,208,22
Oklahoma,State Senate,Mark Thomas,REP,550134,0,0,95,95,22
Oklahoma,Superintendent of Public Instruction,John Cox,DEM,550135,0,0,7,7,
Oklahoma,Superintendent of Public Instruction,Freda Deskin,DEM,550135,0,0,7,7,
Oklahoma,U.S. Senate,Connie Johnson,DEM,550135,0,0,14,14,
Oklahoma,U.S. Senate,Jim Rogers,DEM,550135,0,0,1,1,
Oklahoma,U.S. House,Tom Guild,DEM,550135,0,0,5,5,05
Oklahoma,U.S. House,Al Mcaffrey,DEM,550135,0,0,8,8,05
Oklahoma,U.S. House,Steve Russell,REP,550135,0,0,26,26,05
Oklahoma,U.S. House,Patrice Douglas,REP,550135,0,0,14,14,05
Oklahoma,State Senate,Stephanie Bice,REP,550135,0,0,28,28,22
Oklahoma,State Senate,Mark Thomas,REP,550135,0,0,12,12,22
Oklahoma,Superintendent of Public Instruction,John Cox,DEM,550136,0,0,33,33,
Oklahoma,Superintendent of Public Instruction,Freda Deskin,DEM,550136,0,0,24,24,
Oklahoma,U.S. Senate,Connie Johnson,DEM,550136,0,0,43,43,
Oklahoma,U.S. Senate,Jim Rogers,DEM,550136,0,0,14,14,
Oklahoma,U.S. House,Tom Guild,DEM,550136,0,0,26,26,05
Oklahoma,U.S. House,Al Mcaffrey,DEM,550136,0,0,30,30,05
Oklahoma,U.S. House,Steve Russell,REP,550136,0,0,115,115,05
Oklahoma,U.S. House,Patrice Douglas,REP,550136,0,0,111,111,05
Oklahoma,State Senate,Stephanie Bice,REP,550136,0,0,143,143,22
Oklahoma,State Senate,Mark Thomas,REP,550136,0,0,83,83,22
Oklahoma,Superintendent of Public Instruction,John Cox,DEM,550137,0,0,7,7,
Oklahoma,Superintendent of Public Instruction,Freda Deskin,DEM,550137,0,0,15,15,
Oklahoma,U.S. Senate,Connie Johnson,DEM,550137,0,0,19,19,
Oklahoma,U.S. Senate,Jim Rogers,DEM,550137,0,0,3,3,
Oklahoma,U.S. House,Tom Guild,DEM,550137,0,0,5,5,05
Oklahoma,U.S. House,Al Mcaffrey,DEM,550137,0,0,17,17,05
Oklahoma,U.S. House,Steve Russell,REP,550137,0,0,95,95,05
Oklahoma,U.S. House,Patrice Douglas,REP,550137,0,0,85,85,05
Oklahoma,State Senate,Stephanie Bice,REP,550137,0,0,98,98,22
Oklahoma,State Senate,Mark Thomas,REP,550137,0,0,75,75,22
Oklahoma,Superintendent of Public Instruction,John Cox,DEM,550138,0,0,6,6,
Oklahoma,Superintendent of Public Instruction,Freda Deskin,DEM,550138,0,0,4,4,
Oklahoma,U.S. Senate,Connie Johnson,DEM,550138,0,0,4,4,
Oklahoma,U.S. Senate,Jim Rogers,DEM,550138,0,0,5,5,
Oklahoma,U.S. House,Tom Guild,DEM,550138,0,0,7,7,05
Oklahoma,U.S. House,Al Mcaffrey,DEM,550138,0,0,2,2,05
Oklahoma,U.S. House,Steve Russell,REP,550138,0,0,54,54,05
Oklahoma,U.S. House,Patrice Douglas,REP,550138,0,0,27,27,05
Oklahoma,State Senate,Stephanie Bice,REP,550138,0,0,49,49,22
Oklahoma,State Senate,Mark Thomas,REP,550138,0,0,33,33,22
Oklahoma,Superintendent of Public Instruction,John Cox,DEM,550139,0,0,26,26,
Oklahoma,Superintendent of Public Instruction,Freda Deskin,DEM,550139,0,0,38,38,
Oklahoma,U.S. Senate,Connie Johnson,DEM,550139,0,0,49,49,
Oklahoma,U.S. Senate,Jim Rogers,DEM,550139,0,0,14,14,
Oklahoma,U.S. House,Tom Guild,DEM,550139,0,0,21,21,05
Oklahoma,U.S. House,Al Mcaffrey,DEM,550139,0,0,43,43,05
Oklahoma,U.S. House,Steve Russell,REP,550139,0,0,134,134,05
Oklahoma,U.S. House,Patrice Douglas,REP,550139,0,0,85,85,05
Oklahoma,Superintendent of Public Instruction,John Cox,DEM,550140,0,0,10,10,
Oklahoma,Superintendent of Public Instruction,Freda Deskin,DEM,550140,0,0,13,13,
Oklahoma,U.S. Senate,Connie Johnson,DEM,550140,0,0,18,18,
Oklahoma,U.S. Senate,Jim Rogers,DEM,550140,0,0,4,4,
Oklahoma,U.S. House,Tom Guild,DEM,550140,0,0,11,11,05
Oklahoma,U.S. House,Al Mcaffrey,DEM,550140,0,0,8,8,05
Oklahoma,U.S. House,Steve Russell,REP,550140,0,0,48,48,05
Oklahoma,U.S. House,Patrice Douglas,REP,550140,0,0,84,84,05
Oklahoma,Superintendent of Public Instruction,John Cox,DEM,550141,0,0,26,26,
Oklahoma,Superintendent of Public Instruction,Freda Deskin,DEM,550141,0,0,27,27,
Oklahoma,U.S. Senate,Connie Johnson,DEM,550141,0,0,38,38,
Oklahoma,U.S. Senate,Jim Rogers,DEM,550141,0,0,13,13,
Oklahoma,U.S. House,Tom Guild,DEM,550141,0,0,23,23,05
Oklahoma,U.S. House,Al Mcaffrey,DEM,550141,0,0,28,28,05
Oklahoma,U.S. House,Steve Russell,REP,550141,0,0,127,127,05
Oklahoma,U.S. House,Patrice Douglas,REP,550141,0,0,96,96,05
Oklahoma,Superintendent of Public Instruction,John Cox,DEM,550142,0,0,50,50,
Oklahoma,Superintendent of Public Instruction,Freda Deskin,DEM,550142,0,0,49,49,
Oklahoma,U.S. Senate,Connie Johnson,DEM,550142,0,0,73,73,
Oklahoma,U.S. Senate,Jim Rogers,DEM,550142,0,0,21,21,
Oklahoma,U.S. House,Tom Guild,DEM,550142,0,0,44,44,05
Oklahoma,U.S. House,Al Mcaffrey,DEM,550142,0,0,49,49,05
Oklahoma,U.S. House,Steve Russell,REP,550142,0,0,156,156,05
Oklahoma,U.S. House,Patrice Douglas,REP,550142,0,0,115,115,05
Oklahoma,Superintendent of Public Instruction,John Cox,DEM,550143,0,0,14,14,
Oklahoma,Superintendent of Public Instruction,Freda Deskin,DEM,550143,0,0,24,24,
Oklahoma,U.S. Senate,Connie Johnson,DEM,550143,0,0,30,30,
Oklahoma,U.S. Senate,Jim Rogers,DEM,550143,0,0,6,6,
Oklahoma,U.S. House,Tom Guild,DEM,550143,0,0,19,19,05
Oklahoma,U.S. House,Al Mcaffrey,DEM,550143,0,0,17,17,05
Oklahoma,U.S. House,Steve Russell,REP,550143,0,0,137,137,05
Oklahoma,U.S. House,Patrice Douglas,REP,550143,0,0,104,104,05
Oklahoma,Superintendent of Public Instruction,John Cox,DEM,550144,0,0,24,24,
Oklahoma,Superintendent of Public Instruction,Freda Deskin,DEM,550144,0,0,27,27,
Oklahoma,U.S. Senate,Connie Johnson,DEM,550144,0,0,44,44,
Oklahoma,U.S. Senate,Jim Rogers,DEM,550144,0,0,9,9,
Oklahoma,U.S. House,Tom Guild,DEM,550144,0,0,20,20,05
Oklahoma,U.S. House,Al Mcaffrey,DEM,550144,0,0,32,32,05
Oklahoma,U.S. House,Steve Russell,REP,550144,0,0,139,139,05
Oklahoma,U.S. House,Patrice Douglas,REP,550144,0,0,84,84,05
Oklahoma,Superintendent of Public Instruction,John Cox,DEM,550145,0,0,10,10,
Oklahoma,Superintendent of Public Instruction,Freda Deskin,DEM,550145,0,0,29,29,
Oklahoma,U.S. Senate,Connie Johnson,DEM,550145,0,0,32,32,
Oklahoma,U.S. Senate,Jim Rogers,DEM,550145,0,0,7,7,
Oklahoma,U.S. House,Tom Guild,DEM,550145,0,0,18,18,05
Oklahoma,U.S. House,Al Mcaffrey,DEM,550145,0,0,22,22,05
Oklahoma,U.S. House,Steve Russell,REP,550145,0,0,112,112,05
Oklahoma,U.S. House,Patrice Douglas,REP,550145,0,0,123,123,05
Oklahoma,Superintendent of Public Instruction,John Cox,DEM,550146,0,0,29,29,
Oklahoma,Superintendent of Public Instruction,Freda Deskin,DEM,550146,0,0,32,32,
Oklahoma,U.S. Senate,Connie Johnson,DEM,550146,0,0,55,55,
Oklahoma,U.S. Senate,Jim Rogers,DEM,550146,0,0,6,6,
Oklahoma,U.S. House,Tom Guild,DEM,550146,0,0,26,26,05
Oklahoma,U.S. House,Al Mcaffrey,DEM,550146,0,0,35,35,05
Oklahoma,U.S. House,Steve Russell,REP,550146,0,0,139,139,05
Oklahoma,U.S. House,Patrice Douglas,REP,550146,0,0,157,157,05
Oklahoma,Superintendent of Public Instruction,John Cox,DEM,550147,0,0,10,10,
Oklahoma,Superintendent of Public Instruction,Freda Deskin,DEM,550147,0,0,22,22,
Oklahoma,U.S. Senate,Connie Johnson,DEM,550147,0,0,29,29,
Oklahoma,U.S. Senate,Jim Rogers,DEM,550147,0,0,4,4,
Oklahoma,U.S. House,Tom Guild,DEM,550147,0,0,13,13,05
Oklahoma,U.S. House,Al Mcaffrey,DEM,550147,0,0,20,20,05
Oklahoma,U.S. House,Steve Russell,REP,550147,0,0,57,57,05
Oklahoma,U.S. House,Patrice Douglas,REP,550147,0,0,31,31,05
Oklahoma,Superintendent of Public Instruction,John Cox,DEM,550148,0,0,47,47,
Oklahoma,Superintendent of Public Instruction,Freda Deskin,DEM,550148,0,0,49,49,
Oklahoma,U.S. Senate,Connie Johnson,DEM,550148,0,0,75,75,
Oklahoma,U.S. Senate,Jim Rogers,DEM,550148,0,0,19,19,
Oklahoma,U.S. House,Tom Guild,DEM,550148,0,0,47,47,05
Oklahoma,U.S. House,Al Mcaffrey,DEM,550148,0,0,46,46,05
Oklahoma,U.S. House,Steve Russell,REP,550148,0,0,158,158,05
Oklahoma,U.S. House,Patrice Douglas,REP,550148,0,0,131,131,05
Oklahoma,Superintendent of Public Instruction,John Cox,DEM,550149,0,0,41,41,
Oklahoma,Superintendent of Public Instruction,Freda Deskin,DEM,550149,0,0,44,44,
Oklahoma,U.S. Senate,Connie Johnson,DEM,550149,0,0,59,59,
Oklahoma,U.S. Senate,Jim Rogers,DEM,550149,0,0,25,25,
Oklahoma,U.S. House,Tom Guild,DEM,550149,0,0,35,35,05
Oklahoma,U.S. House,Al Mcaffrey,DEM,550149,0,0,49,49,05
Oklahoma,U.S. House,Steve Russell,REP,550149,0,0,236,236,05
Oklahoma,U.S. House,Patrice Douglas,REP,550149,0,0,220,220,05
Oklahoma,Superintendent of Public Instruction,John Cox,DEM,550150,0,0,44,44,
Oklahoma,Superintendent of Public Instruction,Freda Deskin,DEM,550150,0,0,46,46,
Oklahoma,U.S. Senate,Connie Johnson,DEM,550150,0,0,68,68,
Oklahoma,U.S. Senate,Jim Rogers,DEM,550150,0,0,19,19,
Oklahoma,U.S. House,Tom Guild,DEM,550150,0,0,45,45,05
Oklahoma,U.S. House,Al Mcaffrey,DEM,550150,0,0,41,41,05
Oklahoma,U.S. House,Steve Russell,REP,550150,0,0,161,161,05
Oklahoma,U.S. House,Patrice Douglas,REP,550150,0,0,126,126,05
Oklahoma,Superintendent of Public Instruction,John Cox,DEM,550151,0,0,42,42,
Oklahoma,Superintendent of Public Instruction,Freda Deskin,DEM,550151,0,0,45,45,
Oklahoma,U.S. Senate,Connie Johnson,DEM,550151,0,0,69,69,
Oklahoma,U.S. Senate,Jim Rogers,DEM,550151,0,0,16,16,
Oklahoma,U.S. House,Tom Guild,DEM,550151,0,0,41,41,05
Oklahoma,U.S. House,Al Mcaffrey,DEM,550151,0,0,43,43,05
Oklahoma,U.S. House,Steve Russell,REP,550151,0,0,163,163,05
Oklahoma,U.S. House,Patrice Douglas,REP,550151,0,0,113,113,05
Oklahoma,Superintendent of Public Instruction,John Cox,DEM,550152,0,0,40,40,
Oklahoma,Superintendent of Public Instruction,Freda Deskin,DEM,550152,0,0,46,46,
Oklahoma,U.S. Senate,Connie Johnson,DEM,550152,0,0,71,71,
Oklahoma,U.S. Senate,Jim Rogers,DEM,550152,0,0,12,12,
Oklahoma,U.S. House,Tom Guild,DEM,550152,0,0,38,38,05
Oklahoma,U.S. House,Al Mcaffrey,DEM,550152,0,0,44,44,05
Oklahoma,U.S. House,Steve Russell,REP,550152,0,0,162,162,05
Oklahoma,U.S. House,Patrice Douglas,REP,550152,0,0,109,109,05
Oklahoma,Superintendent of Public Instruction,John Cox,DEM,550153,0,0,73,73,
Oklahoma,Superintendent of Public Instruction,Freda Deskin,DEM,550153,0,0,54,54,
Oklahoma,U.S. Senate,Connie Johnson,DEM,550153,0,0,96,96,
Oklahoma,U.S. Senate,Jim Rogers,DEM,550153,0,0,28,28,
Oklahoma,U.S. House,Tom Guild,DEM,550153,0,0,71,71,05
Oklahoma,U.S. House,Al Mcaffrey,DEM,550153,0,0,54,54,05
Oklahoma,U.S. House,Steve Russell,REP,550153,0,0,203,203,05
Oklahoma,U.S. House,Patrice Douglas,REP,550153,0,0,132,132,05
Oklahoma,Superintendent of Public Instruction,John Cox,DEM,550154,0,0,64,64,
Oklahoma,Superintendent of Public Instruction,Freda Deskin,DEM,550154,0,0,73,73,
Oklahoma,U.S. Senate,Connie Johnson,DEM,550154,0,0,105,105,
Oklahoma,U.S. Senate,Jim Rogers,DEM,550154,0,0,28,28,
Oklahoma,U.S. House,Tom Guild,DEM,550154,0,0,74,74,05
Oklahoma,U.S. House,Al Mcaffrey,DEM,550154,0,0,60,60,05
Oklahoma,U.S. House,Steve Russell,REP,550154,0,0,206,206,05
Oklahoma,U.S. House,Patrice Douglas,REP,550154,0,0,152,152,05
Oklahoma,Superintendent of Public Instruction,John Cox,DEM,550155,0,0,23,23,
Oklahoma,Superintendent of Public Instruction,Freda Deskin,DEM,550155,0,0,11,11,
Oklahoma,U.S. Senate,Connie Johnson,DEM,550155,0,0,26,26,
Oklahoma,U.S. Senate,Jim Rogers,DEM,550155,0,0,8,8,
Oklahoma,U.S. House,Tom Guild,DEM,550155,0,0,15,15,05
Oklahoma,U.S. House,Al Mcaffrey,DEM,550155,0,0,19,19,05
Oklahoma,U.S. House,Steve Russell,REP,550155,0,0,46,46,05
Oklahoma,U.S. House,Patrice Douglas,REP,550155,0,0,32,32,05
Oklahoma,Superintendent of Public Instruction,John Cox,DEM,550156,0,0,53,53,
Oklahoma,Superintendent of Public Instruction,Freda Deskin,DEM,550156,0,0,64,64,
Oklahoma,U.S. Senate,Connie Johnson,DEM,550156,0,0,91,91,
Oklahoma,U.S. Senate,Jim Rogers,DEM,550156,0,0,21,21,
Oklahoma,U.S. House,Tom Guild,DEM,550156,0,0,51,51,05
Oklahoma,U.S. House,Al Mcaffrey,DEM,550156,0,0,61,61,05
Oklahoma,U.S. House,Steve Russell,REP,550156,0,0,132,132,05
Oklahoma,U.S. House,Patrice Douglas,REP,550156,0,0,122,122,05
Oklahoma,Superintendent of Public Instruction,John Cox,DEM,550157,0,0,0,0,
Oklahoma,Superintendent of Public Instruction,Freda Deskin,DEM,550157,0,0,1,1,
Oklahoma,U.S. Senate,Connie Johnson,DEM,550157,0,0,1,1,
Oklahoma,U.S. Senate,Jim Rogers,DEM,550157,0,0,0,0,
Oklahoma,U.S. House,Tom Guild,DEM,550157,0,0,1,1,05
Oklahoma,U.S. House,Al Mcaffrey,DEM,550157,0,0,0,0,05
Oklahoma,U.S. House,Steve Russell,REP,550157,0,0,0,0,05
Oklahoma,U.S. House,Patrice Douglas,REP,550157,0,0,1,1,05
Oklahoma,Superintendent of Public Instruction,John Cox,DEM,550158,0,0,27,27,
Oklahoma,Superintendent of Public Instruction,Freda Deskin,DEM,550158,0,0,43,43,
Oklahoma,U.S. Senate,Connie Johnson,DEM,550158,0,0,57,57,
Oklahoma,U.S. Senate,Jim Rogers,DEM,550158,0,0,14,14,
Oklahoma,U.S. House,Tom Guild,DEM,550158,0,0,43,43,05
Oklahoma,U.S. House,Al Mcaffrey,DEM,550158,0,0,29,29,05
Oklahoma,U.S. House,Steve Russell,REP,550158,0,0,88,88,05
Oklahoma,U.S. House,Patrice Douglas,REP,550158,0,0,74,74,05
Oklahoma,Superintendent of Public Instruction,John Cox,DEM,550159,0,0,36,36,
Oklahoma,Superintendent of Public Instruction,Freda Deskin,DEM,550159,0,0,41,41,
Oklahoma,U.S. Senate,Connie Johnson,DEM,550159,0,0,62,62,
Oklahoma,U.S. Senate,Jim Rogers,DEM,550159,0,0,15,15,
Oklahoma,U.S. House,Tom Guild,DEM,550159,0,0,43,43,05
Oklahoma,U.S. House,Al Mcaffrey,DEM,550159,0,0,34,34,05
Oklahoma,U.S. House,Steve Russell,REP,550159,0,0,95,95,05
Oklahoma,U.S. House,Patrice Douglas,REP,550159,0,0,69,69,05
Oklahoma,Superintendent of Public Instruction,John Cox,DEM,550160,0,0,35,35,
Oklahoma,Superintendent of Public Instruction,Freda Deskin,DEM,550160,0,0,31,31,
Oklahoma,U.S. Senate,Connie Johnson,DEM,550160,0,0,42,42,
Oklahoma,U.S. Senate,Jim Rogers,DEM,550160,0,0,23,23,
Oklahoma,U.S. House,Tom Guild,DEM,550160,0,0,19,19,05
Oklahoma,U.S. House,Al Mcaffrey,DEM,550160,0,0,45,45,05
Oklahoma,U.S. House,Steve Russell,REP,550160,0,0,156,156,05
Oklahoma,U.S. House,Patrice Douglas,REP,550160,0,0,150,150,05
Oklahoma,Superintendent of Public Instruction,John Cox,DEM,550161,0,0,21,21,
Oklahoma,Superintendent of Public Instruction,Freda Deskin,DEM,550161,0,0,28,28,
Oklahoma,U.S. Senate,Connie Johnson,DEM,550161,0,0,43,43,
Oklahoma,U.S. Senate,Jim Rogers,DEM,550161,0,0,6,6,
Oklahoma,U.S. House,Tom Guild,DEM,550161,0,0,32,32,05
Oklahoma,U.S. House,Al Mcaffrey,DEM,550161,0,0,17,17,05
Oklahoma,U.S. House,Steve Russell,REP,550161,0,0,50,50,05
Oklahoma,U.S. House,Patrice Douglas,REP,550161,0,0,37,37,05
Oklahoma,Superintendent of Public Instruction,John Cox,DEM,550162,0,0,22,22,
Oklahoma,Superintendent of Public Instruction,Freda Deskin,DEM,550162,0,0,25,25,
Oklahoma,U.S. Senate,Connie Johnson,DEM,550162,0,0,34,34,
Oklahoma,U.S. Senate,Jim Rogers,DEM,550162,0,0,12,12,
Oklahoma,U.S. House,Tom Guild,DEM,550162,0,0,22,22,05
Oklahoma,U.S. House,Al Mcaffrey,DEM,550162,0,0,23,23,05
Oklahoma,U.S. House,Steve Russell,REP,550162,0,0,94,94,05
Oklahoma,U.S. House,Patrice Douglas,REP,550162,0,0,64,64,05
Oklahoma,Superintendent of Public Instruction,John Cox,DEM,550163,0,0,22,22,
Oklahoma,Superintendent of Public Instruction,Freda Deskin,DEM,550163,0,0,29,29,
Oklahoma,U.S. Senate,Connie Johnson,DEM,550163,0,0,40,40,
Oklahoma,U.S. Senate,Jim Rogers,DEM,550163,0,0,10,10,
Oklahoma,U.S. House,Tom Guild,DEM,550163,0,0,28,28,05
Oklahoma,U.S. House,Al Mcaffrey,DEM,550163,0,0,24,24,05
Oklahoma,U.S. House,Steve Russell,REP,550163,0,0,58,58,05
Oklahoma,U.S. House,Patrice Douglas,REP,550163,0,0,32,32,05
Oklahoma,Superintendent of Public Instruction,John Cox,DEM,550164,0,0,12,12,
Oklahoma,Superintendent of Public Instruction,Freda Deskin,DEM,550164,0,0,8,8,
Oklahoma,U.S. Senate,Connie Johnson,DEM,550164,0,0,15,15,
Oklahoma,U.S. Senate,Jim Rogers,DEM,550164,0,0,5,5,
Oklahoma,U.S. House,Tom Guild,DEM,550164,0,0,6,6,05
Oklahoma,U.S. House,Al Mcaffrey,DEM,550164,0,0,14,14,05
Oklahoma,U.S. House,Steve Russell,REP,550164,0,0,33,33,05
Oklahoma,U.S. House,Patrice Douglas,REP,550164,0,0,14,14,05
Oklahoma,Superintendent of Public Instruction,John Cox,DEM,550165,0,0,17,17,
Oklahoma,Superintendent of Public Instruction,Freda Deskin,DEM,550165,0,0,13,13,
Oklahoma,U.S. Senate,Connie Johnson,DEM,550165,0,0,18,18,
Oklahoma,U.S. Senate,Jim Rogers,DEM,550165,0,0,12,12,
Oklahoma,U.S. House,Tom Guild,DEM,550165,0,0,16,16,05
Oklahoma,U.S. House,Al Mcaffrey,DEM,550165,0,0,14,14,05
Oklahoma,U.S. House,Steve Russell,REP,550165,0,0,71,71,05
Oklahoma,U.S. House,Patrice Douglas,REP,550165,0,0,36,36,05
Oklahoma,Superintendent of Public Instruction,John Cox,DEM,550166,0,0,2,2,
Oklahoma,Superintendent of Public Instruction,Freda Deskin,DEM,550166,0,0,1,1,
Oklahoma,U.S. Senate,Connie Johnson,DEM,550166,0,0,1,1,
Oklahoma,U.S. Senate,Jim Rogers,DEM,550166,0,0,2,2,
Oklahoma,U.S. House,Tom Guild,DEM,550166,0,0,2,2,05
Oklahoma,U.S. House,Al Mcaffrey,DEM,550166,0,0,1,1,05
Oklahoma,U.S. House,Steve Russell,REP,550166,0,0,21,21,05
Oklahoma,U.S. House,Patrice Douglas,REP,550166,0,0,10,10,05
Oklahoma,Superintendent of Public Instruction,John Cox,DEM,550167,0,0,8,8,
Oklahoma,Superintendent of Public Instruction,Freda Deskin,DEM,550167,0,0,9,9,
Oklahoma,U.S. Senate,Connie Johnson,DEM,550167,0,0,9,9,
Oklahoma,U.S. Senate,Jim Rogers,DEM,550167,0,0,8,8,
Oklahoma,U.S. House,Tom Guild,DEM,550167,0,0,7,7,05
Oklahoma,U.S. House,Al Mcaffrey,DEM,550167,0,0,10,10,05
Oklahoma,U.S. House,Steve Russell,REP,550167,0,0,13,13,05
Oklahoma,U.S. House,Patrice Douglas,REP,550167,0,0,4,4,05
Oklahoma,Superintendent of Public Instruction,John Cox,DEM,550168,0,0,9,9,
Oklahoma,Superintendent of Public Instruction,Freda Deskin,DEM,550168,0,0,5,5,
Oklahoma,U.S. Senate,Connie Johnson,DEM,550168,0,0,10,10,
Oklahoma,U.S. Senate,Jim Rogers,DEM,550168,0,0,3,3,
Oklahoma,U.S. House,Tom Guild,DEM,550168,0,0,6,6,05
Oklahoma,U.S. House,Al Mcaffrey,DEM,550168,0,0,8,8,05
Oklahoma,U.S. House,Steve Russell,REP,550168,0,0,10,10,05
Oklahoma,U.S. House,Patrice Douglas,REP,550168,0,0,8,8,05
Oklahoma,Superintendent of Public Instruction,John Cox,DEM,550169,0,0,12,12,
Oklahoma,Superintendent of Public Instruction,Freda Deskin,DEM,550169,0,0,24,24,
Oklahoma,U.S. Senate,Connie Johnson,DEM,550169,0,0,29,29,
Oklahoma,U.S. Senate,Jim Rogers,DEM,550169,0,0,7,7,
Oklahoma,U.S. House,Tom Guild,DEM,550169,0,0,12,12,05
Oklahoma,U.S. House,Al Mcaffrey,DEM,550169,0,0,22,22,05
Oklahoma,U.S. House,Steve Russell,REP,550169,0,0,51,51,05
Oklahoma,U.S. House,Patrice Douglas,REP,550169,0,0,41,41,05
Oklahoma,Superintendent of Public Instruction,John Cox,DEM,550170,0,0,22,22,
Oklahoma,Superintendent of Public Instruction,Freda Deskin,DEM,550170,0,0,20,20,
Oklahoma,U.S. Senate,Connie Johnson,DEM,550170,0,0,25,25,
Oklahoma,U.S. Senate,Jim Rogers,DEM,550170,0,0,16,16,
Oklahoma,U.S. House,Tom Guild,DEM,550170,0,0,13,13,05
Oklahoma,U.S. House,Al Mcaffrey,DEM,550170,0,0,28,28,05
Oklahoma,U.S. House,Steve Russell,REP,550170,0,0,51,51,05
Oklahoma,U.S. House,Patrice Douglas,REP,550170,0,0,19,19,05
Oklahoma,Superintendent of Public Instruction,John Cox,DEM,550171,0,0,50,50,
Oklahoma,Superintendent of Public Instruction,Freda Deskin,DEM,550171,0,0,35,35,
Oklahoma,U.S. Senate,Connie Johnson,DEM,550171,0,0,69,69,
Oklahoma,U.S. Senate,Jim Rogers,DEM,550171,0,0,17,17,
Oklahoma,U.S. House,Tom Guild,DEM,550171,0,0,30,30,05
Oklahoma,U.S. House,Al Mcaffrey,DEM,550171,0,0,56,56,05
Oklahoma,U.S. House,Steve Russell,REP,550171,0,0,71,71,05
Oklahoma,U.S. House,Patrice Douglas,REP,550171,0,0,43,43,05
Oklahoma,Superintendent of Public Instruction,John Cox,DEM,550172,0,0,39,39,
Oklahoma,Superintendent of Public Instruction,Freda Deskin,DEM,550172,0,0,49,49,
Oklahoma,U.S. Senate,Connie Johnson,DEM,550172,0,0,61,61,
Oklahoma,U.S. Senate,Jim Rogers,DEM,550172,0,0,27,27,
Oklahoma,U.S. House,Tom Guild,DEM,550172,0,0,49,49,05
Oklahoma,U.S. House,Al Mcaffrey,DEM,550172,0,0,41,41,05
Oklahoma,U.S. House,Steve Russell,REP,550172,0,0,75,75,05
Oklahoma,U.S. House,Patrice Douglas,REP,550172,0,0,65,65,05
Oklahoma,State Senate,Ervin Yen,REP,550172,0,0,63,63,40
Oklahoma,State Senate,Steve Kern,REP,550172,0,0,78,78,40
Oklahoma,Superintendent of Public Instruction,John Cox,DEM,550173,0,0,50,50,
Oklahoma,Superintendent of Public Instruction,Freda Deskin,DEM,550173,0,0,49,49,
Oklahoma,U.S. Senate,Connie Johnson,DEM,550173,0,0,68,68,
Oklahoma,U.S. Senate,Jim Rogers,DEM,550173,0,0,27,27,
Oklahoma,U.S. House,Tom Guild,DEM,550173,0,0,48,48,05
Oklahoma,U.S. House,Al Mcaffrey,DEM,550173,0,0,47,47,05
Oklahoma,U.S. House,Steve Russell,REP,550173,0,0,167,167,05
Oklahoma,U.S. House,Patrice Douglas,REP,550173,0,0,118,118,05
Oklahoma,State Senate,Ervin Yen,REP,550173,0,0,141,141,40
Oklahoma,State Senate,Steve Kern,REP,550173,0,0,144,144,40
Oklahoma,Superintendent of Public Instruction,John Cox,DEM,550174,0,0,20,20,
Oklahoma,Superintendent of Public Instruction,Freda Deskin,DEM,550174,0,0,29,29,
Oklahoma,U.S. Senate,Connie Johnson,DEM,550174,0,0,35,35,
Oklahoma,U.S. Senate,Jim Rogers,DEM,550174,0,0,15,15,
Oklahoma,U.S. House,Tom Guild,DEM,550174,0,0,21,21,05
Oklahoma,U.S. House,Al Mcaffrey,DEM,550174,0,0,27,27,05
Oklahoma,U.S. House,Steve Russell,REP,550174,0,0,71,71,05
Oklahoma,U.S. House,Patrice Douglas,REP,550174,0,0,51,51,05
Oklahoma,State Senate,Ervin Yen,REP,550174,0,0,59,59,40
Oklahoma,State Senate,Steve Kern,REP,550174,0,0,64,64,40
Oklahoma,Superintendent of Public Instruction,John Cox,DEM,550175,0,0,17,17,
Oklahoma,Superintendent of Public Instruction,Freda Deskin,DEM,550175,0,0,10,10,
Oklahoma,U.S. Senate,Connie Johnson,DEM,550175,0,0,17,17,
Oklahoma,U.S. Senate,Jim Rogers,DEM,550175,0,0,8,8,
Oklahoma,U.S. House,Tom Guild,DEM,550175,0,0,9,9,05
Oklahoma,U.S. House,Al Mcaffrey,DEM,550175,0,0,16,16,05
Oklahoma,U.S. House,Steve Russell,REP,550175,0,0,31,31,05
Oklahoma,U.S. House,Patrice Douglas,REP,550175,0,0,20,20,05
Oklahoma,State Senate,Ervin Yen,REP,550175,0,0,28,28,40
Oklahoma,State Senate,Steve Kern,REP,550175,0,0,23,23,40
Oklahoma,Superintendent of Public Instruction,John Cox,DEM,550176,0,0,43,43,
Oklahoma,Superintendent of Public Instruction,Freda Deskin,DEM,550176,0,0,32,32,
Oklahoma,U.S. Senate,Connie Johnson,DEM,550176,0,0,51,51,
Oklahoma,U.S. Senate,Jim Rogers,DEM,550176,0,0,23,23,
Oklahoma,U.S. House,Tom Guild,DEM,550176,0,0,35,35,05
Oklahoma,U.S. House,Al Mcaffrey,DEM,550176,0,0,40,40,05
Oklahoma,U.S. House,Steve Russell,REP,550176,0,0,119,119,05
Oklahoma,U.S. House,Patrice Douglas,REP,550176,0,0,73,73,05
Oklahoma,State Senate,Ervin Yen,REP,550176,0,0,115,115,40
Oklahoma,State Senate,Steve Kern,REP,550176,0,0,77,77,40
Oklahoma,Superintendent of Public Instruction,John Cox,DEM,550177,0,0,31,31,
Oklahoma,Superintendent of Public Instruction,Freda Deskin,DEM,550177,0,0,38,38,
Oklahoma,U.S. Senate,Connie Johnson,DEM,550177,0,0,56,56,
Oklahoma,U.S. Senate,Jim Rogers,DEM,550177,0,0,13,13,
Oklahoma,U.S. House,Tom Guild,DEM,550177,0,0,29,29,05
Oklahoma,U.S. House,Al Mcaffrey,DEM,550177,0,0,40,40,05
Oklahoma,U.S. House,Steve Russell,REP,550177,0,0,107,107,05
Oklahoma,U.S. House,Patrice Douglas,REP,550177,0,0,75,75,05
Oklahoma,State Senate,Ervin Yen,REP,550177,0,0,90,90,40
Oklahoma,State Senate,Steve Kern,REP,550177,0,0,92,92,40
Oklahoma,Superintendent of Public Instruction,John Cox,DEM,550178,0,0,27,27,
Oklahoma,Superintendent of Public Instruction,Freda Deskin,DEM,550178,0,0,39,39,
Oklahoma,U.S. Senate,Connie Johnson,DEM,550178,0,0,54,54,
Oklahoma,U.S. Senate,Jim Rogers,DEM,550178,0,0,12,12,
Oklahoma,U.S. House,Tom Guild,DEM,550178,0,0,29,29,05
Oklahoma,U.S. House,Al Mcaffrey,DEM,550178,0,0,36,36,05
Oklahoma,U.S. House,Steve Russell,REP,550178,0,0,67,67,05
Oklahoma,U.S. House,Patrice Douglas,REP,550178,0,0,55,55,05
Oklahoma,State Senate,Ervin Yen,REP,550178,0,0,58,58,40
Oklahoma,State Senate,Steve Kern,REP,550178,0,0,64,64,40
Oklahoma,Superintendent of Public Instruction,John Cox,DEM,550179,0,0,61,61,
Oklahoma,Superintendent of Public Instruction,Freda Deskin,DEM,550179,0,0,51,51,
Oklahoma,U.S. Senate,Connie Johnson,DEM,550179,0,0,84,84,
Oklahoma,U.S. Senate,Jim Rogers,DEM,550179,0,0,26,26,
Oklahoma,U.S. House,Tom Guild,DEM,550179,0,0,49,49,05
Oklahoma,U.S. House,Al Mcaffrey,DEM,550179,0,0,60,60,05
Oklahoma,U.S. House,Steve Russell,REP,550179,0,0,117,117,05
Oklahoma,U.S. House,Patrice Douglas,REP,550179,0,0,103,103,05
Oklahoma,State Senate,Ervin Yen,REP,550179,0,0,166,166,40
Oklahoma,State Senate,Steve Kern,REP,550179,0,0,53,53,40
Oklahoma,Superintendent of Public Instruction,John Cox,DEM,550180,0,0,13,13,
Oklahoma,Superintendent of Public Instruction,Freda Deskin,DEM,550180,0,0,27,27,
Oklahoma,U.S. Senate,Connie Johnson,DEM,550180,0,0,29,29,
Oklahoma,U.S. Senate,Jim Rogers,DEM,550180,0,0,9,9,
Oklahoma,U.S. House,Tom Guild,DEM,550180,0,0,13,13,05
Oklahoma,U.S. House,Al Mcaffrey,DEM,550180,0,0,26,26,05
Oklahoma,U.S. House,Steve Russell,REP,550180,0,0,59,59,05
Oklahoma,U.S. House,Patrice Douglas,REP,550180,0,0,56,56,05
Oklahoma,State Senate,Ervin Yen,REP,550180,0,0,77,77,40
Oklahoma,State Senate,Steve Kern,REP,550180,0,0,38,38,40
Oklahoma,Superintendent of Public Instruction,John Cox,DEM,550181,0,0,17,17,
Oklahoma,Superintendent of Public Instruction,Freda Deskin,DEM,550181,0,0,15,15,
Oklahoma,U.S. Senate,Connie Johnson,DEM,550181,0,0,30,30,
Oklahoma,U.S. Senate,Jim Rogers,DEM,550181,0,0,2,2,
Oklahoma,U.S. House,Tom Guild,DEM,550181,0,0,9,9,05
Oklahoma,U.S. House,Al Mcaffrey,DEM,550181,0,0,22,22,05
Oklahoma,U.S. House,Steve Russell,REP,550181,0,0,42,42,05
Oklahoma,U.S. House,Patrice Douglas,REP,550181,0,0,44,44,05
Oklahoma,State Senate,Ervin Yen,REP,550181,0,0,59,59,40
Oklahoma,State Senate,Steve Kern,REP,550181,0,0,27,27,40
Oklahoma,Superintendent of Public Instruction,John Cox,DEM,550182,0,0,22,22,
Oklahoma,Superintendent of Public Instruction,Freda Deskin,DEM,550182,0,0,17,17,
Oklahoma,U.S. Senate,Connie Johnson,DEM,550182,0,0,32,32,
Oklahoma,U.S. Senate,Jim Rogers,DEM,550182,0,0,5,5,
Oklahoma,U.S. House,Tom Guild,DEM,550182,0,0,16,16,05
Oklahoma,U.S. House,Al Mcaffrey,DEM,550182,0,0,22,22,05
Oklahoma,U.S. House,Steve Russell,REP,550182,0,0,27,27,05
Oklahoma,U.S. House,Patrice Douglas,REP,550182,0,0,16,16,05
Oklahoma,State Senate,Ervin Yen,REP,550182,0,0,24,24,40
Oklahoma,State Senate,Steve Kern,REP,550182,0,0,19,19,40
Oklahoma,Superintendent of Public Instruction,John Cox,DEM,550183,0,0,39,39,
Oklahoma,Superintendent of Public Instruction,Freda Deskin,DEM,550183,0,0,63,63,
Oklahoma,U.S. Senate,Connie Johnson,DEM,550183,0,0,83,83,
Oklahoma,U.S. Senate,Jim Rogers,DEM,550183,0,0,17,17,
Oklahoma,U.S. House,Tom Guild,DEM,550183,0,0,40,40,05
Oklahoma,U.S. House,Al Mcaffrey,DEM,550183,0,0,61,61,05
Oklahoma,U.S. House,Steve Russell,REP,550183,0,0,88,88,05
Oklahoma,U.S. House,Patrice Douglas,REP,550183,0,0,50,50,05
Oklahoma,State Senate,Ervin Yen,REP,550183,0,0,83,83,40
Oklahoma,State Senate,Steve Kern,REP,550183,0,0,58,58,40
Oklahoma,Superintendent of Public Instruction,John Cox,DEM,550184,0,0,55,55,
Oklahoma,Superintendent of Public Instruction,Freda Deskin,DEM,550184,0,0,36,36,
Oklahoma,U.S. Senate,Connie Johnson,DEM,550184,0,0,77,77,
Oklahoma,U.S. Senate,Jim Rogers,DEM,550184,0,0,13,13,
Oklahoma,U.S. House,Tom Guild,DEM,550184,0,0,36,36,05
Oklahoma,U.S. House,Al Mcaffrey,DEM,550184,0,0,56,56,05
Oklahoma,U.S. House,Steve Russell,REP,550184,0,0,79,79,05
Oklahoma,U.S. House,Patrice Douglas,REP,550184,0,0,50,50,05
Oklahoma,State Senate,Ervin Yen,REP,550184,0,0,59,59,40
Oklahoma,State Senate,Steve Kern,REP,550184,0,0,69,69,40
Oklahoma,Superintendent of Public Instruction,John Cox,DEM,550185,0,0,25,25,
Oklahoma,Superintendent of Public Instruction,Freda Deskin,DEM,550185,0,0,37,37,
Oklahoma,U.S. Senate,Connie Johnson,DEM,550185,0,0,46,46,
Oklahoma,U.S. Senate,Jim Rogers,DEM,550185,0,0,13,13,
Oklahoma,U.S. House,Tom Guild,DEM,550185,0,0,29,29,05
Oklahoma,U.S. House,Al Mcaffrey,DEM,550185,0,0,32,32,05
Oklahoma,State House,Jason Dunnington,DEM,550185,0,0,27,27,88
Oklahoma,State House,Paula Sophia,DEM,550185,0,0,34,34,88
Oklahoma,U.S. House,Steve Russell,REP,550185,0,0,18,18,05
Oklahoma,U.S. House,Patrice Douglas,REP,550185,0,0,15,15,05
Oklahoma,State Senate,Ervin Yen,REP,550185,0,0,15,15,40
Oklahoma,State Senate,Steve Kern,REP,550185,0,0,17,17,40
Oklahoma,Superintendent of Public Instruction,John Cox,DEM,550186,0,0,36,36,
Oklahoma,Superintendent of Public Instruction,Freda Deskin,DEM,550186,0,0,71,71,
Oklahoma,U.S. Senate,Connie Johnson,DEM,550186,0,0,89,89,
Oklahoma,U.S. Senate,Jim Rogers,DEM,550186,0,0,15,15,
Oklahoma,U.S. House,Tom Guild,DEM,550186,0,0,27,27,05
Oklahoma,U.S. House,Al Mcaffrey,DEM,550186,0,0,80,80,05
Oklahoma,State House,Jason Dunnington,DEM,550186,0,0,57,57,88
Oklahoma,State House,Paula Sophia,DEM,550186,0,0,53,53,88
Oklahoma,U.S. House,Steve Russell,REP,550186,0,0,36,36,05
Oklahoma,U.S. House,Patrice Douglas,REP,550186,0,0,19,19,05
Oklahoma,Superintendent of Public Instruction,John Cox,DEM,550187,0,0,5,5,
Oklahoma,Superintendent of Public Instruction,Freda Deskin,DEM,550187,0,0,5,5,
Oklahoma,U.S. Senate,Connie Johnson,DEM,550187,0,0,9,9,
Oklahoma,U.S. Senate,Jim Rogers,DEM,550187,0,0,1,1,
Oklahoma,U.S. House,Tom Guild,DEM,550187,0,0,3,3,05
Oklahoma,U.S. House,Al Mcaffrey,DEM,550187,0,0,7,7,05
Oklahoma,U.S. House,Steve Russell,REP,550187,0,0,3,3,05
Oklahoma,U.S. House,Patrice Douglas,REP,550187,0,0,5,5,05
Oklahoma,Superintendent of Public Instruction,John Cox,DEM,550188,0,0,0,0,
Oklahoma,Superintendent of Public Instruction,Freda Deskin,DEM,550188,0,0,1,1,
Oklahoma,U.S. Senate,Connie Johnson,DEM,550188,0,0,1,1,
Oklahoma,U.S. Senate,Jim Rogers,DEM,550188,0,0,0,0,
Oklahoma,U.S. House,Tom Guild,DEM,550188,0,0,1,1,05
Oklahoma,U.S. House,Al Mcaffrey,DEM,550188,0,0,0,0,05
Oklahoma,U.S. House,Steve Russell,REP,550188,0,0,0,0,05
Oklahoma,U.S. House,Patrice Douglas,REP,550188,0,0,0,0,05
Oklahoma,Superintendent of Public Instruction,John Cox,DEM,550189,0,0,1,1,
Oklahoma,Superintendent of Public Instruction,Freda Deskin,DEM,550189,0,0,2,2,
Oklahoma,U.S. Senate,Connie Johnson,DEM,550189,0,0,0,0,
Oklahoma,U.S. Senate,Jim Rogers,DEM,550189,0,0,3,3,
Oklahoma,U.S. House,Tom Guild,DEM,550189,0,0,2,2,05
Oklahoma,U.S. House,Al Mcaffrey,DEM,550189,0,0,1,1,05
Oklahoma,U.S. House,Steve Russell,REP,550189,0,0,3,3,05
Oklahoma,U.S. House,Patrice Douglas,REP,550189,0,0,3,3,05
Oklahoma,Superintendent of Public Instruction,John Cox,DEM,550190,0,0,9,9,
Oklahoma,Superintendent of Public Instruction,Freda Deskin,DEM,550190,0,0,13,13,
Oklahoma,U.S. Senate,Connie Johnson,DEM,550190,0,0,20,20,
Oklahoma,U.S. Senate,Jim Rogers,DEM,550190,0,0,2,2,
Oklahoma,U.S. House,Tom Guild,DEM,550190,0,0,4,4,05
Oklahoma,U.S. House,Al Mcaffrey,DEM,550190,0,0,17,17,05
Oklahoma,U.S. House,Steve Russell,REP,550190,0,0,7,7,05
Oklahoma,U.S. House,Patrice Douglas,REP,550190,0,0,4,4,05
Oklahoma,Superintendent of Public Instruction,John Cox,DEM,550191,0,0,31,31,
Oklahoma,Superintendent of Public Instruction,Freda Deskin,DEM,550191,0,0,58,58,
Oklahoma,U.S. Senate,Connie Johnson,DEM,550191,0,0,73,73,
Oklahoma,U.S. Senate,Jim Rogers,DEM,550191,0,0,15,15,
Oklahoma,U.S. House,Tom Guild,DEM,550191,0,0,27,27,05
Oklahoma,U.S. House,Al Mcaffrey,DEM,550191,0,0,62,62,05
Oklahoma,State House,Jason Dunnington,DEM,550191,0,0,55,55,88
Oklahoma,State House,Paula Sophia,DEM,550191,0,0,34,34,88
Oklahoma,U.S. House,Steve Russell,REP,550191,0,0,23,23,05
Oklahoma,U.S. House,Patrice Douglas,REP,550191,0,0,13,13,05
Oklahoma,Superintendent of Public Instruction,John Cox,DEM,550192,0,0,87,87,
Oklahoma,Superintendent of Public Instruction,Freda Deskin,DEM,550192,0,0,111,111,
Oklahoma,U.S. Senate,Connie Johnson,DEM,550192,0,0,163,163,
Oklahoma,U.S. Senate,Jim Rogers,DEM,550192,0,0,33,33,
Oklahoma,U.S. House,Tom Guild,DEM,550192,0,0,64,64,05
Oklahoma,U.S. House,Al Mcaffrey,DEM,550192,0,0,141,141,05
Oklahoma,State House,Jason Dunnington,DEM,550192,0,0,119,119,88
Oklahoma,State House,Paula Sophia,DEM,550192,0,0,87,87,88
Oklahoma,U.S. House,Steve Russell,REP,550192,0,0,54,54,05
Oklahoma,U.S. House,Patrice Douglas,REP,550192,0,0,31,31,05
Oklahoma,Superintendent of Public Instruction,John Cox,DEM,550193,0,0,59,59,
Oklahoma,Superintendent of Public Instruction,Freda Deskin,DEM,550193,0,0,86,86,
Oklahoma,U.S. Senate,Connie Johnson,DEM,550193,0,0,120,120,
Oklahoma,U.S. Senate,Jim Rogers,DEM,550193,0,0,22,22,
Oklahoma,U.S. House,Tom Guild,DEM,550193,0,0,29,29,05
Oklahoma,U.S. House,Al Mcaffrey,DEM,550193,0,0,119,119,05
Oklahoma,State House,Jason Dunnington,DEM,550193,0,0,70,70,88
Oklahoma,State House,Paula Sophia,DEM,550193,0,0,80,80,88
Oklahoma,U.S. House,Steve Russell,REP,550193,0,0,42,42,05
Oklahoma,U.S. House,Patrice Douglas,REP,550193,0,0,32,32,05
Oklahoma,Superintendent of Public Instruction,John Cox,DEM,550194,0,0,49,49,
Oklahoma,Superintendent of Public Instruction,Freda Deskin,DEM,550194,0,0,71,71,
Oklahoma,U.S. Senate,Connie Johnson,DEM,550194,0,0,103,103,
Oklahoma,U.S. Senate,Jim Rogers,DEM,550194,0,0,16,16,
Oklahoma,U.S. House,Tom Guild,DEM,550194,0,0,45,45,05
Oklahoma,U.S. House,Al Mcaffrey,DEM,550194,0,0,76,76,05
Oklahoma,State House,Jason Dunnington,DEM,550194,0,0,49,49,88
Oklahoma,State House,Paula Sophia,DEM,550194,0,0,73,73,88
Oklahoma,U.S. House,Steve Russell,REP,550194,0,0,37,37,05
Oklahoma,U.S. House,Patrice Douglas,REP,550194,0,0,24,24,05
Oklahoma,State Senate,Ervin Yen,REP,550194,0,0,37,37,40
Oklahoma,State Senate,Steve Kern,REP,550194,0,0,24,24,40
Oklahoma,Superintendent of Public Instruction,John Cox,DEM,550195,0,0,53,53,
Oklahoma,Superintendent of Public Instruction,Freda Deskin,DEM,550195,0,0,94,94,
Oklahoma,U.S. Senate,Connie Johnson,DEM,550195,0,0,122,122,
Oklahoma,U.S. Senate,Jim Rogers,DEM,550195,0,0,25,25,
Oklahoma,U.S. House,Tom Guild,DEM,550195,0,0,54,54,05
Oklahoma,U.S. House,Al Mcaffrey,DEM,550195,0,0,92,92,05
Oklahoma,U.S. House,Steve Russell,REP,550195,0,0,143,143,05
Oklahoma,U.S. House,Patrice Douglas,REP,550195,0,0,69,69,05
Oklahoma,State Senate,Ervin Yen,REP,550195,0,0,125,125,40
Oklahoma,State Senate,Steve Kern,REP,550195,0,0,87,87,40
Oklahoma,Superintendent of Public Instruction,John Cox,DEM,550196,0,0,58,58,
Oklahoma,Superintendent of Public Instruction,Freda Deskin,DEM,550196,0,0,109,109,
Oklahoma,U.S. Senate,Connie Johnson,DEM,550196,0,0,141,141,
Oklahoma,U.S. Senate,Jim Rogers,DEM,550196,0,0,24,24,
Oklahoma,U.S. House,Tom Guild,DEM,550196,0,0,38,38,05
Oklahoma,U.S. House,Al Mcaffrey,DEM,550196,0,0,128,128,05
Oklahoma,U.S. House,Steve Russell,REP,550196,0,0,223,223,05
Oklahoma,U.S. House,Patrice Douglas,REP,550196,0,0,168,168,05
Oklahoma,State Senate,Ervin Yen,REP,550196,0,0,327,327,40
Oklahoma,State Senate,Steve Kern,REP,550196,0,0,64,64,40
Oklahoma,Superintendent of Public Instruction,John Cox,DEM,550197,0,0,61,61,
Oklahoma,Superintendent of Public Instruction,Freda Deskin,DEM,550197,0,0,105,105,
Oklahoma,U.S. Senate,Connie Johnson,DEM,550197,0,0,142,142,
Oklahoma,U.S. Senate,Jim Rogers,DEM,550197,0,0,26,26,
Oklahoma,U.S. House,Tom Guild,DEM,550197,0,0,40,40,05
Oklahoma,U.S. House,Al Mcaffrey,DEM,550197,0,0,127,127,05
Oklahoma,State House,Jason Dunnington,DEM,550197,0,0,90,90,88
Oklahoma,State House,Paula Sophia,DEM,550197,0,0,81,81,88
Oklahoma,U.S. House,Steve Russell,REP,550197,0,0,44,44,05
Oklahoma,U.S. House,Patrice Douglas,REP,550197,0,0,24,24,05
Oklahoma,State Senate,Ervin Yen,REP,550197,0,0,37,37,40
Oklahoma,State Senate,Steve Kern,REP,550197,0,0,32,32,40
Oklahoma,Superintendent of Public Instruction,John Cox,DEM,550198,0,0,42,42,
Oklahoma,Superintendent of Public Instruction,Freda Deskin,DEM,550198,0,0,69,69,
Oklahoma,U.S. Senate,Connie Johnson,DEM,550198,0,0,97,97,
Oklahoma,U.S. Senate,Jim Rogers,DEM,550198,0,0,11,11,
Oklahoma,U.S. House,Tom Guild,DEM,550198,0,0,20,20,05
Oklahoma,U.S. House,Al Mcaffrey,DEM,550198,0,0,90,90,05
Oklahoma,U.S. House,Steve Russell,REP,550198,0,0,32,32,05
Oklahoma,U.S. House,Patrice Douglas,REP,550198,0,0,40,40,05
Oklahoma,Superintendent of Public Instruction,John Cox,DEM,550199,0,0,53,53,
Oklahoma,Superintendent of Public Instruction,Freda Deskin,DEM,550199,0,0,88,88,
Oklahoma,U.S. Senate,Connie Johnson,DEM,550199,0,0,125,125,
Oklahoma,U.S. Senate,Jim Rogers,DEM,550199,0,0,16,16,
Oklahoma,U.S. House,Tom Guild,DEM,550199,0,0,36,36,05
Oklahoma,U.S. House,Al Mcaffrey,DEM,550199,0,0,103,103,05
Oklahoma,U.S. House,Steve Russell,REP,550199,0,0,44,44,05
Oklahoma,U.S. House,Patrice Douglas,REP,550199,0,0,41,41,05
Oklahoma,Superintendent of Public Instruction,John Cox,DEM,550200,0,0,92,92,
Oklahoma,Superintendent of Public Instruction,Freda Deskin,DEM,550200,0,0,156,156,
Oklahoma,U.S. Senate,Connie Johnson,DEM,550200,0,0,224,224,
Oklahoma,U.S. Senate,Jim Rogers,DEM,550200,0,0,29,29,
Oklahoma,U.S. House,Tom Guild,DEM,550200,0,0,60,60,05
Oklahoma,U.S. House,Al Mcaffrey,DEM,550200,0,0,198,198,05
Oklahoma,State House,Jason Dunnington,DEM,550200,0,0,104,104,88
Oklahoma,State House,Paula Sophia,DEM,550200,0,0,158,158,88
Oklahoma,U.S. House,Steve Russell,REP,550200,0,0,46,46,05
Oklahoma,U.S. House,Patrice Douglas,REP,550200,0,0,35,35,05
Oklahoma,Superintendent of Public Instruction,John Cox,DEM,550201,0,0,42,42,
Oklahoma,Superintendent of Public Instruction,Freda Deskin,DEM,550201,0,0,78,78,
Oklahoma,U.S. Senate,Connie Johnson,DEM,550201,0,0,96,96,
Oklahoma,U.S. Senate,Jim Rogers,DEM,550201,0,0,24,24,
Oklahoma,U.S. House,Tom Guild,DEM,550201,0,0,41,41,05
Oklahoma,U.S. House,Al Mcaffrey,DEM,550201,0,0,80,80,05
Oklahoma,State House,Jason Dunnington,DEM,550201,0,0,51,51,88
Oklahoma,State House,Paula Sophia,DEM,550201,0,0,71,71,88
Oklahoma,U.S. House,Steve Russell,REP,550201,0,0,43,43,05
Oklahoma,U.S. House,Patrice Douglas,REP,550201,0,0,23,23,05
Oklahoma,State Senate,Ervin Yen,REP,550201,0,0,38,38,40
Oklahoma,State Senate,Steve Kern,REP,550201,0,0,29,29,40
Oklahoma,Superintendent of Public Instruction,John Cox,DEM,550202,0,0,34,34,
Oklahoma,Superintendent of Public Instruction,Freda Deskin,DEM,550202,0,0,64,64,
Oklahoma,U.S. Senate,Connie Johnson,DEM,550202,0,0,80,80,
Oklahoma,U.S. Senate,Jim Rogers,DEM,550202,0,0,18,18,
Oklahoma,U.S. House,Tom Guild,DEM,550202,0,0,20,20,05
Oklahoma,U.S. House,Al Mcaffrey,DEM,550202,0,0,80,80,05
Oklahoma,State House,Jason Dunnington,DEM,550202,0,0,39,39,88
Oklahoma,State House,Paula Sophia,DEM,550202,0,0,62,62,88
Oklahoma,U.S. House,Steve Russell,REP,550202,0,0,40,40,05
Oklahoma,U.S. House,Patrice Douglas,REP,550202,0,0,27,27,05
Oklahoma,State Senate,Ervin Yen,REP,550202,0,0,34,34,40
Oklahoma,State Senate,Steve Kern,REP,550202,0,0,32,32,40
Oklahoma,Superintendent of Public Instruction,John Cox,DEM,550203,0,0,32,32,
Oklahoma,Superintendent of Public Instruction,Freda Deskin,DEM,550203,0,0,58,58,
Oklahoma,U.S. Senate,Connie Johnson,DEM,550203,0,0,78,78,
Oklahoma,U.S. Senate,Jim Rogers,DEM,550203,0,0,12,12,
Oklahoma,U.S. House,Tom Guild,DEM,550203,0,0,27,27,05
Oklahoma,U.S. House,Al Mcaffrey,DEM,550203,0,0,64,64,05
Oklahoma,State House,Jason Dunnington,DEM,550203,0,0,45,45,88
Oklahoma,State House,Paula Sophia,DEM,550203,0,0,46,46,88
Oklahoma,U.S. House,Steve Russell,REP,550203,0,0,27,27,05
Oklahoma,U.S. House,Patrice Douglas,REP,550203,0,0,17,17,05
Oklahoma,Superintendent of Public Instruction,John Cox,DEM,550204,0,0,106,106,
Oklahoma,Superintendent of Public Instruction,Freda Deskin,DEM,550204,0,0,195,195,
Oklahoma,U.S. Senate,Connie Johnson,DEM,550204,0,0,251,251,
Oklahoma,U.S. Senate,Jim Rogers,DEM,550204,0,0,51,51,
Oklahoma,U.S. House,Tom Guild,DEM,550204,0,0,44,44,05
Oklahoma,U.S. House,Al Mcaffrey,DEM,550204,0,0,276,276,05
Oklahoma,State House,Jason Dunnington,DEM,550204,0,0,208,208,88
Oklahoma,State House,Paula Sophia,DEM,550204,0,0,114,114,88
Oklahoma,U.S. House,Steve Russell,REP,550204,0,0,51,51,05
Oklahoma,U.S. House,Patrice Douglas,REP,550204,0,0,61,61,05
Oklahoma,Superintendent of Public Instruction,John Cox,DEM,550205,0,0,17,17,
Oklahoma,Superintendent of Public Instruction,Freda Deskin,DEM,550205,0,0,40,40,
Oklahoma,U.S. Senate,Connie Johnson,DEM,550205,0,0,52,52,
Oklahoma,U.S. Senate,Jim Rogers,DEM,550205,0,0,8,8,
Oklahoma,U.S. House,Tom Guild,DEM,550205,0,0,14,14,05
Oklahoma,U.S. House,Al Mcaffrey,DEM,550205,0,0,44,44,05
Oklahoma,U.S. House,Steve Russell,REP,550205,0,0,22,22,05
Oklahoma,U.S. House,Patrice Douglas,REP,550205,0,0,16,16,05
Oklahoma,Superintendent of Public Instruction,John Cox,DEM,550206,0,0,18,18,
Oklahoma,Superintendent of Public Instruction,Freda Deskin,DEM,550206,0,0,14,14,
Oklahoma,U.S. Senate,Connie Johnson,DEM,550206,0,0,25,25,
Oklahoma,U.S. Senate,Jim Rogers,DEM,550206,0,0,7,7,
Oklahoma,U.S. House,Tom Guild,DEM,550206,0,0,17,17,05
Oklahoma,U.S. House,Al Mcaffrey,DEM,550206,0,0,15,15,05
Oklahoma,U.S. House,Steve Russell,REP,550206,0,0,4,4,05
Oklahoma,U.S. House,Patrice Douglas,REP,550206,0,0,4,4,05
Oklahoma,Superintendent of Public Instruction,John Cox,DEM,550207,0,0,62,62,
Oklahoma,Superintendent of Public Instruction,Freda Deskin,DEM,550207,0,0,49,49,
Oklahoma,U.S. Senate,Connie Johnson,DEM,550207,0,0,79,79,
Oklahoma,U.S. Senate,Jim Rogers,DEM,550207,0,0,32,32,
Oklahoma,U.S. House,Tom Guild,DEM,550207,0,0,56,56,05
Oklahoma,U.S. House,Al Mcaffrey,DEM,550207,0,0,53,53,05
Oklahoma,State House,Mary Sosa,DEM,550207,0,0,58,58,89
Oklahoma,State House,Shane Stone,DEM,550207,0,0,53,53,89
Oklahoma,U.S. House,Steve Russell,REP,550207,0,0,21,21,05
Oklahoma,U.S. House,Patrice Douglas,REP,550207,0,0,13,13,05
Oklahoma,Superintendent of Public Instruction,John Cox,DEM,550208,0,0,0,0,
Oklahoma,Superintendent of Public Instruction,Freda Deskin,DEM,550208,0,0,1,1,
Oklahoma,U.S. Senate,Connie Johnson,DEM,550208,0,0,1,1,
Oklahoma,U.S. Senate,Jim Rogers,DEM,550208,0,0,0,0,
Oklahoma,U.S. House,Tom Guild,DEM,550208,0,0,1,1,05
Oklahoma,U.S. House,Al Mcaffrey,DEM,550208,0,0,0,0,05
Oklahoma,State House,Mary Sosa,DEM,550208,0,0,0,0,89
Oklahoma,State House,Shane Stone,DEM,550208,0,0,1,1,89
Oklahoma,U.S. House,Steve Russell,REP,550208,0,0,0,0,05
Oklahoma,U.S. House,Patrice Douglas,REP,550208,0,0,0,0,05
Oklahoma,Superintendent of Public Instruction,John Cox,DEM,550209,0,0,53,53,
Oklahoma,Superintendent of Public Instruction,Freda Deskin,DEM,550209,0,0,47,47,
Oklahoma,U.S. Senate,Connie Johnson,DEM,550209,0,0,69,69,
Oklahoma,U.S. Senate,Jim Rogers,DEM,550209,0,0,31,31,
Oklahoma,U.S. House,Tom Guild,DEM,550209,0,0,55,55,05
Oklahoma,U.S. House,Al Mcaffrey,DEM,550209,0,0,43,43,05
Oklahoma,State House,Mary Sosa,DEM,550209,0,0,48,48,89
Oklahoma,State House,Shane Stone,DEM,550209,0,0,58,58,89
Oklahoma,U.S. House,Steve Russell,REP,550209,0,0,22,22,05
Oklahoma,U.S. House,Patrice Douglas,REP,550209,0,0,9,9,05
Oklahoma,Superintendent of Public Instruction,John Cox,DEM,550210,0,0,51,51,
Oklahoma,Superintendent of Public Instruction,Freda Deskin,DEM,550210,0,0,26,26,
Oklahoma,U.S. Senate,Connie Johnson,DEM,550210,0,0,40,40,
Oklahoma,U.S. Senate,Jim Rogers,DEM,550210,0,0,36,36,
Oklahoma,U.S. House,Tom Guild,DEM,550210,0,0,37,37,05
Oklahoma,U.S. House,Al Mcaffrey,DEM,550210,0,0,40,40,05
Oklahoma,State House,Mary Sosa,DEM,550210,0,0,40,40,89
Oklahoma,State House,Shane Stone,DEM,550210,0,0,41,41,89
Oklahoma,U.S. House,Steve Russell,REP,550210,0,0,18,18,05
Oklahoma,U.S. House,Patrice Douglas,REP,550210,0,0,16,16,05
Oklahoma,Superintendent of Public Instruction,John Cox,DEM,550211,0,0,35,35,
Oklahoma,Superintendent of Public Instruction,Freda Deskin,DEM,550211,0,0,29,29,
Oklahoma,U.S. Senate,Connie Johnson,DEM,550211,0,0,37,37,
Oklahoma,U.S. Senate,Jim Rogers,DEM,550211,0,0,26,26,
Oklahoma,U.S. House,Tom Guild,DEM,550211,0,0,32,32,05
Oklahoma,U.S. House,Al Mcaffrey,DEM,550211,0,0,30,30,05
Oklahoma,State House,Mary Sosa,DEM,550211,0,0,31,31,89
Oklahoma,State House,Shane Stone,DEM,550211,0,0,38,38,89
Oklahoma,U.S. House,Steve Russell,REP,550211,0,0,14,14,05
Oklahoma,U.S. House,Patrice Douglas,REP,550211,0,0,11,11,05
Oklahoma,Superintendent of Public Instruction,John Cox,DEM,550212,0,0,39,39,
Oklahoma,Superintendent of Public Instruction,Freda Deskin,DEM,550212,0,0,27,27,
Oklahoma,U.S. Senate,Connie Johnson,DEM,550212,0,0,35,35,
Oklahoma,U.S. Senate,Jim Rogers,DEM,550212,0,0,33,33,
Oklahoma,U.S. House,Tom Guild,DEM,550212,0,0,28,28,05
Oklahoma,U.S. House,Al Mcaffrey,DEM,550212,0,0,38,38,05
Oklahoma,State House,Mary Sosa,DEM,550212,0,0,19,19,89
Oklahoma,State House,Shane Stone,DEM,550212,0,0,54,54,89
Oklahoma,U.S. House,Steve Russell,REP,550212,0,0,21,21,05
Oklahoma,U.S. House,Patrice Douglas,REP,550212,0,0,13,13,05
Oklahoma,Superintendent of Public Instruction,John Cox,DEM,550213,0,0,29,29,
Oklahoma,Superintendent of Public Instruction,Freda Deskin,DEM,550213,0,0,25,25,
Oklahoma,U.S. Senate,Connie Johnson,DEM,550213,0,0,32,32,
Oklahoma,U.S. Senate,Jim Rogers,DEM,550213,0,0,21,21,
Oklahoma,U.S. House,Tom Guild,DEM,550213,0,0,31,31,05
Oklahoma,U.S. House,Al Mcaffrey,DEM,550213,0,0,23,23,05
Oklahoma,State House,Mary Sosa,DEM,550213,0,0,30,30,89
Oklahoma,State House,Shane Stone,DEM,550213,0,0,25,25,89
Oklahoma,U.S. House,Steve Russell,REP,550213,0,0,9,9,05
Oklahoma,U.S. House,Patrice Douglas,REP,550213,0,0,8,8,05
Oklahoma,Superintendent of Public Instruction,John Cox,DEM,550214,0,0,9,9,
Oklahoma,Superintendent of Public Instruction,Freda Deskin,DEM,550214,0,0,4,4,
Oklahoma,U.S. Senate,Connie Johnson,DEM,550214,0,0,9,9,
Oklahoma,U.S. Senate,Jim Rogers,DEM,550214,0,0,4,4,
Oklahoma,U.S. House,Tom Guild,DEM,550214,0,0,11,11,05
Oklahoma,U.S. House,Al Mcaffrey,DEM,550214,0,0,2,2,05
Oklahoma,U.S. House,Steve Russell,REP,550214,0,0,22,22,05
Oklahoma,U.S. House,Patrice Douglas,REP,550214,0,0,17,17,05
Oklahoma,Superintendent of Public Instruction,John Cox,DEM,550215,0,0,12,12,
Oklahoma,Superintendent of Public Instruction,Freda Deskin,DEM,550215,0,0,12,12,
Oklahoma,U.S. Senate,Connie Johnson,DEM,550215,0,0,16,16,
Oklahoma,U.S. Senate,Jim Rogers,DEM,550215,0,0,8,8,
Oklahoma,U.S. House,Tom Guild,DEM,550215,0,0,10,10,05
Oklahoma,U.S. House,Al Mcaffrey,DEM,550215,0,0,14,14,05
Oklahoma,U.S. House,Steve Russell,REP,550215,0,0,22,22,05
Oklahoma,U.S. House,Patrice Douglas,REP,550215,0,0,10,10,05
Oklahoma,Superintendent of Public Instruction,John Cox,DEM,550216,0,0,0,0,
Oklahoma,Superintendent of Public Instruction,Freda Deskin,DEM,550216,0,0,2,2,
Oklahoma,U.S. Senate,Connie Johnson,DEM,550216,0,0,2,2,
Oklahoma,U.S. Senate,Jim Rogers,DEM,550216,0,0,0,0,
Oklahoma,U.S. House,Tom Guild,DEM,550216,0,0,0,0,05
Oklahoma,U.S. House,Al Mcaffrey,DEM,550216,0,0,2,2,05
Oklahoma,U.S. House,Steve Russell,REP,550216,0,0,0,0,05
Oklahoma,U.S. House,Patrice Douglas,REP,550216,0,0,0,0,05
Oklahoma,Superintendent of Public Instruction,John Cox,DEM,550217,0,0,13,13,
Oklahoma,Superintendent of Public Instruction,Freda Deskin,DEM,550217,0,0,20,20,
Oklahoma,U.S. Senate,Connie Johnson,DEM,550217,0,0,21,21,
Oklahoma,U.S. Senate,Jim Rogers,DEM,550217,0,0,12,12,
Oklahoma,U.S. House,Tom Guild,DEM,550217,0,0,18,18,05
Oklahoma,U.S. House,Al Mcaffrey,DEM,550217,0,0,15,15,05
Oklahoma,U.S. House,Steve Russell,REP,550217,0,0,36,36,05
Oklahoma,U.S. House,Patrice Douglas,REP,550217,0,0,15,15,05
Oklahoma,Superintendent of Public Instruction,John Cox,DEM,550218,0,0,34,34,
Oklahoma,Superintendent of Public Instruction,Freda Deskin,DEM,550218,0,0,23,23,
Oklahoma,U.S. Senate,Connie Johnson,DEM,550218,0,0,32,32,
Oklahoma,U.S. Senate,Jim Rogers,DEM,550218,0,0,25,25,
Oklahoma,U.S. House,Tom Guild,DEM,550218,0,0,28,28,05
Oklahoma,U.S. House,Al Mcaffrey,DEM,550218,0,0,29,29,05
Oklahoma,U.S. House,Steve Russell,REP,550218,0,0,52,52,05
Oklahoma,U.S. House,Patrice Douglas,REP,550218,0,0,35,35,05
Oklahoma,Superintendent of Public Instruction,John Cox,DEM,550219,0,0,14,14,
Oklahoma,Superintendent of Public Instruction,Freda Deskin,DEM,550219,0,0,11,11,
Oklahoma,U.S. Senate,Connie Johnson,DEM,550219,0,0,13,13,
Oklahoma,U.S. Senate,Jim Rogers,DEM,550219,0,0,12,12,
Oklahoma,U.S. House,Tom Guild,DEM,550219,0,0,11,11,05
Oklahoma,U.S. House,Al Mcaffrey,DEM,550219,0,0,14,14,05
Oklahoma,U.S. House,Steve Russell,REP,550219,0,0,18,18,05
Oklahoma,U.S. House,Patrice Douglas,REP,550219,0,0,8,8,05
Oklahoma,Superintendent of Public Instruction,John Cox,DEM,550220,0,0,22,22,
Oklahoma,Superintendent of Public Instruction,Freda Deskin,DEM,550220,0,0,14,14,
Oklahoma,U.S. Senate,Connie Johnson,DEM,550220,0,0,23,23,
Oklahoma,U.S. Senate,Jim Rogers,DEM,550220,0,0,13,13,
Oklahoma,U.S. House,Tom Guild,DEM,550220,0,0,21,21,05
Oklahoma,U.S. House,Al Mcaffrey,DEM,550220,0,0,15,15,05
Oklahoma,U.S. House,Steve Russell,REP,550220,0,0,34,34,05
Oklahoma,U.S. House,Patrice Douglas,REP,550220,0,0,17,17,05
Oklahoma,Superintendent of Public Instruction,John Cox,DEM,550221,0,0,39,39,
Oklahoma,Superintendent of Public Instruction,Freda Deskin,DEM,550221,0,0,37,37,
Oklahoma,U.S. Senate,Connie Johnson,DEM,550221,0,0,46,46,
Oklahoma,U.S. Senate,Jim Rogers,DEM,550221,0,0,28,28,
Oklahoma,U.S. House,Tom Guild,DEM,550221,0,0,32,32,05
Oklahoma,U.S. House,Al Mcaffrey,DEM,550221,0,0,43,43,05
Oklahoma,U.S. House,Steve Russell,REP,550221,0,0,90,90,05
Oklahoma,U.S. House,Patrice Douglas,REP,550221,0,0,39,39,05
Oklahoma,Superintendent of Public Instruction,John Cox,DEM,550222,0,0,12,12,
Oklahoma,Superintendent of Public Instruction,Freda Deskin,DEM,550222,0,0,17,17,
Oklahoma,U.S. Senate,Connie Johnson,DEM,550222,0,0,18,18,
Oklahoma,U.S. Senate,Jim Rogers,DEM,550222,0,0,12,12,
Oklahoma,U.S. House,Tom Guild,DEM,550222,0,0,14,14,05
Oklahoma,U.S. House,Al Mcaffrey,DEM,550222,0,0,14,14,05
Oklahoma,U.S. House,Steve Russell,REP,550222,0,0,23,23,05
Oklahoma,U.S. House,Patrice Douglas,REP,550222,0,0,16,16,05
Oklahoma,Superintendent of Public Instruction,John Cox,DEM,550223,0,0,17,17,
Oklahoma,Superintendent of Public Instruction,Freda Deskin,DEM,550223,0,0,18,18,
Oklahoma,U.S. Senate,Connie Johnson,DEM,550223,0,0,23,23,
Oklahoma,U.S. Senate,Jim Rogers,DEM,550223,0,0,13,13,
Oklahoma,U.S. House,Tom Guild,DEM,550223,0,0,17,17,05
Oklahoma,U.S. House,Al Mcaffrey,DEM,550223,0,0,19,19,05
Oklahoma,U.S. House,Steve Russell,REP,550223,0,0,17,17,05
Oklahoma,U.S. House,Patrice Douglas,REP,550223,0,0,7,7,05
Oklahoma,Superintendent of Public Instruction,John Cox,DEM,550224,0,0,24,24,
Oklahoma,Superintendent of Public Instruction,Freda Deskin,DEM,550224,0,0,19,19,
Oklahoma,U.S. Senate,Connie Johnson,DEM,550224,0,0,33,33,
Oklahoma,U.S. Senate,Jim Rogers,DEM,550224,0,0,10,10,
Oklahoma,U.S. House,Tom Guild,DEM,550224,0,0,21,21,05
Oklahoma,U.S. House,Al Mcaffrey,DEM,550224,0,0,21,21,05
Oklahoma,U.S. House,Steve Russell,REP,550224,0,0,34,34,05
Oklahoma,U.S. House,Patrice Douglas,REP,550224,0,0,16,16,05
Oklahoma,Superintendent of Public Instruction,John Cox,DEM,550225,0,0,12,12,
Oklahoma,Superintendent of Public Instruction,Freda Deskin,DEM,550225,0,0,13,13,
Oklahoma,U.S. Senate,Connie Johnson,DEM,550225,0,0,14,14,
Oklahoma,U.S. Senate,Jim Rogers,DEM,550225,0,0,11,11,
Oklahoma,U.S. House,Tom Guild,DEM,550225,0,0,12,12,05
Oklahoma,U.S. House,Al Mcaffrey,DEM,550225,0,0,12,12,05
Oklahoma,State House,Mary Sosa,DEM,550225,0,0,5,5,89
Oklahoma,State House,Shane Stone,DEM,550225,0,0,21,21,89
Oklahoma,U.S. House,Steve Russell,REP,550225,0,0,4,4,05
Oklahoma,U.S. House,Patrice Douglas,REP,550225,0,0,2,2,05
Oklahoma,Superintendent of Public Instruction,John Cox,DEM,550226,0,0,19,19,
Oklahoma,Superintendent of Public Instruction,Freda Deskin,DEM,550226,0,0,17,17,
Oklahoma,U.S. Senate,Connie Johnson,DEM,550226,0,0,23,23,
Oklahoma,U.S. Senate,Jim Rogers,DEM,550226,0,0,13,13,
Oklahoma,U.S. House,Tom Guild,DEM,550226,0,0,16,16,05
Oklahoma,U.S. House,Al Mcaffrey,DEM,550226,0,0,20,20,05
Oklahoma,U.S. House,Steve Russell,REP,550226,0,0,43,43,05
Oklahoma,U.S. House,Patrice Douglas,REP,550226,0,0,21,21,05
Oklahoma,Superintendent of Public Instruction,John Cox,DEM,550227,0,0,13,13,
Oklahoma,Superintendent of Public Instruction,Freda Deskin,DEM,550227,0,0,10,10,
Oklahoma,U.S. Senate,Connie Johnson,DEM,550227,0,0,16,16,
Oklahoma,U.S. Senate,Jim Rogers,DEM,550227,0,0,6,6,
Oklahoma,U.S. House,Tom Guild,DEM,550227,0,0,11,11,05
Oklahoma,U.S. House,Al Mcaffrey,DEM,550227,0,0,11,11,05
Oklahoma,U.S. House,Steve Russell,REP,550227,0,0,18,18,05
Oklahoma,U.S. House,Patrice Douglas,REP,550227,0,0,21,21,05
Oklahoma,Superintendent of Public Instruction,John Cox,DEM,550228,0,0,13,13,
Oklahoma,Superintendent of Public Instruction,Freda Deskin,DEM,550228,0,0,5,5,
Oklahoma,U.S. Senate,Connie Johnson,DEM,550228,0,0,13,13,
Oklahoma,U.S. Senate,Jim Rogers,DEM,550228,0,0,5,5,
Oklahoma,U.S. House,Tom Guild,DEM,550228,0,0,9,9,05
Oklahoma,U.S. House,Al Mcaffrey,DEM,550228,0,0,9,9,05
Oklahoma,U.S. House,Steve Russell,REP,550228,0,0,14,14,05
Oklahoma,U.S. House,Patrice Douglas,REP,550228,0,0,8,8,05
Oklahoma,Superintendent of Public Instruction,John Cox,DEM,550229,0,0,25,25,
Oklahoma,Superintendent of Public Instruction,Freda Deskin,DEM,550229,0,0,30,30,
Oklahoma,U.S. Senate,Connie Johnson,DEM,550229,0,0,36,36,
Oklahoma,U.S. Senate,Jim Rogers,DEM,550229,0,0,20,20,
Oklahoma,U.S. House,Tom Guild,DEM,550229,0,0,29,29,05
Oklahoma,U.S. House,Al Mcaffrey,DEM,550229,0,0,28,28,05
Oklahoma,U.S. House,Steve Russell,REP,550229,0,0,49,49,05
Oklahoma,U.S. House,Patrice Douglas,REP,550229,0,0,30,30,05
Oklahoma,Superintendent of Public Instruction,John Cox,DEM,550230,0,0,39,39,
Oklahoma,Superintendent of Public Instruction,Freda Deskin,DEM,550230,0,0,27,27,
Oklahoma,U.S. Senate,Connie Johnson,DEM,550230,0,0,44,44,
Oklahoma,U.S. Senate,Jim Rogers,DEM,550230,0,0,22,22,
Oklahoma,U.S. House,Tom Guild,DEM,550230,0,0,34,34,05
Oklahoma,U.S. House,Al Mcaffrey,DEM,550230,0,0,32,32,05
Oklahoma,U.S. House,Steve Russell,REP,550230,0,0,74,74,05
Oklahoma,U.S. House,Patrice Douglas,REP,550230,0,0,53,53,05
Oklahoma,Superintendent of Public Instruction,John Cox,DEM,550231,0,0,14,14,
Oklahoma,Superintendent of Public Instruction,Freda Deskin,DEM,550231,0,0,12,12,
Oklahoma,U.S. Senate,Connie Johnson,DEM,550231,0,0,19,19,
Oklahoma,U.S. Senate,Jim Rogers,DEM,550231,0,0,6,6,
Oklahoma,U.S. House,Tom Guild,DEM,550231,0,0,12,12,05
Oklahoma,U.S. House,Al Mcaffrey,DEM,550231,0,0,13,13,05
Oklahoma,U.S. House,Steve Russell,REP,550231,0,0,30,30,05
Oklahoma,U.S. House,Patrice Douglas,REP,550231,0,0,18,18,05
Oklahoma,Superintendent of Public Instruction,John Cox,DEM,550232,0,0,16,16,
Oklahoma,Superintendent of Public Instruction,Freda Deskin,DEM,550232,0,0,13,13,
Oklahoma,U.S. Senate,Connie Johnson,DEM,550232,0,0,19,19,
Oklahoma,U.S. Senate,Jim Rogers,DEM,550232,0,0,10,10,
Oklahoma,U.S. House,Tom Guild,DEM,550232,0,0,20,20,05
Oklahoma,U.S. House,Al Mcaffrey,DEM,550232,0,0,9,9,05
Oklahoma,U.S. House,Steve Russell,REP,550232,0,0,46,46,05
Oklahoma,U.S. House,Patrice Douglas,REP,550232,0,0,31,31,05
Oklahoma,Superintendent of Public Instruction,John Cox,DEM,550233,0,0,7,7,
Oklahoma,Superintendent of Public Instruction,Freda Deskin,DEM,550233,0,0,8,8,
Oklahoma,U.S. Senate,Connie Johnson,DEM,550233,0,0,8,8,
Oklahoma,U.S. Senate,Jim Rogers,DEM,550233,0,0,6,6,
Oklahoma,U.S. House,Tom Guild,DEM,550233,0,0,6,6,05
Oklahoma,U.S. House,Al Mcaffrey,DEM,550233,0,0,7,7,05
Oklahoma,U.S. House,Steve Russell,REP,550233,0,0,8,8,05
Oklahoma,U.S. House,Patrice Douglas,REP,550233,0,0,13,13,05
Oklahoma,Superintendent of Public Instruction,John Cox,DEM,550234,0,0,26,26,
Oklahoma,Superintendent of Public Instruction,Freda Deskin,DEM,550234,0,0,13,13,
Oklahoma,U.S. Senate,Connie Johnson,DEM,550234,0,0,26,26,
Oklahoma,U.S. Senate,Jim Rogers,DEM,550234,0,0,12,12,
Oklahoma,U.S. House,Tom Guild,DEM,550234,0,0,20,20,05
Oklahoma,U.S. House,Al Mcaffrey,DEM,550234,0,0,19,19,05
Oklahoma,U.S. House,Steve Russell,REP,550234,0,0,19,19,05
Oklahoma,U.S. House,Patrice Douglas,REP,550234,0,0,26,26,05
Oklahoma,Superintendent of Public Instruction,John Cox,DEM,550235,0,0,19,19,
Oklahoma,Superintendent of Public Instruction,Freda Deskin,DEM,550235,0,0,15,15,
Oklahoma,U.S. Senate,Connie Johnson,DEM,550235,0,0,26,26,
Oklahoma,U.S. Senate,Jim Rogers,DEM,550235,0,0,7,7,
Oklahoma,U.S. House,Tom Guild,DEM,550235,0,0,14,14,05
Oklahoma,U.S. House,Al Mcaffrey,DEM,550235,0,0,20,20,05
Oklahoma,U.S. House,Steve Russell,REP,550235,0,0,12,12,05
Oklahoma,U.S. House,Patrice Douglas,REP,550235,0,0,12,12,05
Oklahoma,Superintendent of Public Instruction,John Cox,DEM,550236,0,0,0,0,
Oklahoma,Superintendent of Public Instruction,Freda Deskin,DEM,550236,0,0,0,0,
Oklahoma,U.S. Senate,Connie Johnson,DEM,550236,0,0,0,0,
Oklahoma,U.S. Senate,Jim Rogers,DEM,550236,0,0,0,0,
Oklahoma,U.S. House,Tom Guild,DEM,550236,0,0,0,0,05
Oklahoma,U.S. House,Al Mcaffrey,DEM,550236,0,0,0,0,05
Oklahoma,State House,George Young,DEM,550236,0,0,0,0,99
Oklahoma,State House,Eleanor Darden Thompson,DEM,550236,0,0,0,0,99
Oklahoma,U.S. House,Steve Russell,REP,550236,0,0,0,0,05
Oklahoma,U.S. House,Patrice Douglas,REP,550236,0,0,0,0,05
Oklahoma,Superintendent of Public Instruction,John Cox,DEM,550237,0,0,0,0,
Oklahoma,Superintendent of Public Instruction,Freda Deskin,DEM,550237,0,0,0,0,
Oklahoma,U.S. Senate,Connie Johnson,DEM,550237,0,0,0,0,
Oklahoma,U.S. Senate,Jim Rogers,DEM,550237,0,0,0,0,
Oklahoma,U.S. House,Tom Guild,DEM,550237,0,0,0,0,05
Oklahoma,U.S. House,Al Mcaffrey,DEM,550237,0,0,0,0,05
Oklahoma,State House,George Young,DEM,550237,0,0,0,0,99
Oklahoma,State House,Eleanor Darden Thompson,DEM,550237,0,0,0,0,99
Oklahoma,U.S. House,Steve Russell,REP,550237,0,0,0,0,05
Oklahoma,U.S. House,Patrice Douglas,REP,550237,0,0,0,0,05
Oklahoma,Superintendent of Public Instruction,John Cox,DEM,550238,0,0,0,0,
Oklahoma,Superintendent of Public Instruction,Freda Deskin,DEM,550238,0,0,0,0,
Oklahoma,U.S. Senate,Connie Johnson,DEM,550238,0,0,0,0,
Oklahoma,U.S. Senate,Jim Rogers,DEM,550238,0,0,0,0,
Oklahoma,U.S. House,Tom Guild,DEM,550238,0,0,0,0,05
Oklahoma,U.S. House,Al Mcaffrey,DEM,550238,0,0,0,0,05
Oklahoma,State House,George Young,DEM,550238,0,0,0,0,99
Oklahoma,State House,Eleanor Darden Thompson,DEM,550238,0,0,0,0,99
Oklahoma,U.S. House,Steve Russell,REP,550238,0,0,0,0,05
Oklahoma,U.S. House,Patrice Douglas,REP,550238,0,0,0,0,05
Oklahoma,Superintendent of Public Instruction,John Cox,DEM,550239,0,0,43,43,
Oklahoma,Superintendent of Public Instruction,Freda Deskin,DEM,550239,0,0,62,62,
Oklahoma,U.S. Senate,Connie Johnson,DEM,550239,0,0,107,107,
Oklahoma,U.S. Senate,Jim Rogers,DEM,550239,0,0,2,2,
Oklahoma,U.S. House,Tom Guild,DEM,550239,0,0,50,50,05
Oklahoma,U.S. House,Al Mcaffrey,DEM,550239,0,0,57,57,05
Oklahoma,State House,George Young,DEM,550239,0,0,68,68,99
Oklahoma,State House,Eleanor Darden Thompson,DEM,550239,0,0,41,41,99
Oklahoma,U.S. House,Steve Russell,REP,550239,0,0,10,10,05
Oklahoma,U.S. House,Patrice Douglas,REP,550239,0,0,8,8,05
Oklahoma,Superintendent of Public Instruction,John Cox,DEM,550240,0,0,89,89,
Oklahoma,Superintendent of Public Instruction,Freda Deskin,DEM,550240,0,0,108,108,
Oklahoma,U.S. Senate,Connie Johnson,DEM,550240,0,0,202,202,
Oklahoma,U.S. Senate,Jim Rogers,DEM,550240,0,0,10,10,
Oklahoma,U.S. House,Tom Guild,DEM,550240,0,0,108,108,05
Oklahoma,U.S. House,Al Mcaffrey,DEM,550240,0,0,92,92,05
Oklahoma,State House,George Young,DEM,550240,0,0,98,98,99
Oklahoma,State House,Eleanor Darden Thompson,DEM,550240,0,0,110,110,99
Oklahoma,U.S. House,Steve Russell,REP,550240,0,0,6,6,05
Oklahoma,U.S. House,Patrice Douglas,REP,550240,0,0,3,3,05
Oklahoma,Superintendent of Public Instruction,John Cox,DEM,550241,0,0,40,40,
Oklahoma,Superintendent of Public Instruction,Freda Deskin,DEM,550241,0,0,68,68,
Oklahoma,U.S. Senate,Connie Johnson,DEM,550241,0,0,110,110,
Oklahoma,U.S. Senate,Jim Rogers,DEM,550241,0,0,3,3,
Oklahoma,U.S. House,Tom Guild,DEM,550241,0,0,53,53,05
Oklahoma,U.S. House,Al Mcaffrey,DEM,550241,0,0,55,55,05
Oklahoma,State House,George Young,DEM,550241,0,0,48,48,99
Oklahoma,State House,Eleanor Darden Thompson,DEM,550241,0,0,64,64,99
Oklahoma,U.S. House,Steve Russell,REP,550241,0,0,9,9,05
Oklahoma,U.S. House,Patrice Douglas,REP,550241,0,0,8,8,05
Oklahoma,Superintendent of Public Instruction,John Cox,DEM,550242,0,0,58,58,
Oklahoma,Superintendent of Public Instruction,Freda Deskin,DEM,550242,0,0,68,68,
Oklahoma,U.S. Senate,Connie Johnson,DEM,550242,0,0,127,127,
Oklahoma,U.S. Senate,Jim Rogers,DEM,550242,0,0,1,1,
Oklahoma,U.S. House,Tom Guild,DEM,550242,0,0,66,66,05
Oklahoma,U.S. House,Al Mcaffrey,DEM,550242,0,0,60,60,05
Oklahoma,U.S. House,Steve Russell,REP,550242,0,0,2,2,05
Oklahoma,U.S. House,Patrice Douglas,REP,550242,0,0,0,0,05
Oklahoma,Superintendent of Public Instruction,John Cox,DEM,550243,0,0,76,76,
Oklahoma,Superintendent of Public Instruction,Freda Deskin,DEM,550243,0,0,81,81,
Oklahoma,U.S. Senate,Connie Johnson,DEM,550243,0,0,160,160,
Oklahoma,U.S. Senate,Jim Rogers,DEM,550243,0,0,2,2,
Oklahoma,U.S. House,Tom Guild,DEM,550243,0,0,80,80,05
Oklahoma,U.S. House,Al Mcaffrey,DEM,550243,0,0,76,76,05
Oklahoma,U.S. House,Steve Russell,REP,550243,0,0,3,3,05
Oklahoma,U.S. House,Patrice Douglas,REP,550243,0,0,0,0,05
Oklahoma,Superintendent of Public Instruction,John Cox,DEM,550244,0,0,81,81,
Oklahoma,Superintendent of Public Instruction,Freda Deskin,DEM,550244,0,0,85,85,
Oklahoma,U.S. Senate,Connie Johnson,DEM,550244,0,0,179,179,
Oklahoma,U.S. Senate,Jim Rogers,DEM,550244,0,0,1,1,
Oklahoma,U.S. House,Tom Guild,DEM,550244,0,0,75,75,05
Oklahoma,U.S. House,Al Mcaffrey,DEM,550244,0,0,96,96,05
Oklahoma,State House,George Young,DEM,550244,0,0,117,117,99
Oklahoma,State House,Eleanor Darden Thompson,DEM,550244,0,0,64,64,99
Oklahoma,U.S. House,Steve Russell,REP,550244,0,0,1,1,05
Oklahoma,U.S. House,Patrice Douglas,REP,550244,0,0,3,3,05
Oklahoma,Superintendent of Public Instruction,John Cox,DEM,550245,0,0,117,117,
Oklahoma,Superintendent of Public Instruction,Freda Deskin,DEM,550245,0,0,130,130,
Oklahoma,U.S. Senate,Connie Johnson,DEM,550245,0,0,259,259,
Oklahoma,U.S. Senate,Jim Rogers,DEM,550245,0,0,7,7,
Oklahoma,U.S. House,Tom Guild,DEM,550245,0,0,119,119,05
Oklahoma,U.S. House,Al Mcaffrey,DEM,550245,0,0,125,125,05
Oklahoma,State House,George Young,DEM,550245,0,0,161,161,99
Oklahoma,State House,Eleanor Darden Thompson,DEM,550245,0,0,102,102,99
Oklahoma,U.S. House,Steve Russell,REP,550245,0,0,2,2,05
Oklahoma,U.S. House,Patrice Douglas,REP,550245,0,0,3,3,05
Oklahoma,Superintendent of Public Instruction,John Cox,DEM,550246,0,0,7,7,
Oklahoma,Superintendent of Public Instruction,Freda Deskin,DEM,550246,0,0,5,5,
Oklahoma,U.S. Senate,Connie Johnson,DEM,550246,0,0,6,6,
Oklahoma,U.S. Senate,Jim Rogers,DEM,550246,0,0,6,6,
Oklahoma,U.S. House,Tom Guild,DEM,550246,0,0,6,6,05
Oklahoma,U.S. House,Al Mcaffrey,DEM,550246,0,0,6,6,05
Oklahoma,U.S. House,Steve Russell,REP,550246,0,0,12,12,05
Oklahoma,U.S. House,Patrice Douglas,REP,550246,0,0,5,5,05
Oklahoma,Superintendent of Public Instruction,John Cox,DEM,550247,0,0,12,12,
Oklahoma,Superintendent of Public Instruction,Freda Deskin,DEM,550247,0,0,18,18,
Oklahoma,U.S. Senate,Connie Johnson,DEM,550247,0,0,25,25,
Oklahoma,U.S. Senate,Jim Rogers,DEM,550247,0,0,5,5,
Oklahoma,U.S. House,Tom Guild,DEM,550247,0,0,20,20,05
Oklahoma,U.S. House,Al Mcaffrey,DEM,550247,0,0,11,11,05
Oklahoma,U.S. House,Steve Russell,REP,550247,0,0,15,15,05
Oklahoma,U.S. House,Patrice Douglas,REP,550247,0,0,4,4,05
Oklahoma,Superintendent of Public Instruction,John Cox,DEM,550248,0,0,47,47,
Oklahoma,Superintendent of Public Instruction,Freda Deskin,DEM,550248,0,0,64,64,
Oklahoma,U.S. Senate,Connie Johnson,DEM,550248,0,0,97,97,
Oklahoma,U.S. Senate,Jim Rogers,DEM,550248,0,0,15,15,
Oklahoma,U.S. House,Tom Guild,DEM,550248,0,0,59,59,05
Oklahoma,U.S. House,Al Mcaffrey,DEM,550248,0,0,51,51,05
Oklahoma,U.S. House,Steve Russell,REP,550248,0,0,67,67,05
Oklahoma,U.S. House,Patrice Douglas,REP,550248,0,0,23,23,05
Oklahoma,Superintendent of Public Instruction,John Cox,DEM,550249,0,0,61,61,
Oklahoma,Superintendent of Public Instruction,Freda Deskin,DEM,550249,0,0,62,62,
Oklahoma,U.S. Senate,Connie Johnson,DEM,550249,0,0,102,102,
Oklahoma,U.S. Senate,Jim Rogers,DEM,550249,0,0,21,21,
Oklahoma,U.S. House,Tom Guild,DEM,550249,0,0,69,69,05
Oklahoma,U.S. House,Al Mcaffrey,DEM,550249,0,0,55,55,05
Oklahoma,U.S. House,Steve Russell,REP,550249,0,0,165,165,05
Oklahoma,U.S. House,Patrice Douglas,REP,550249,0,0,38,38,05
Oklahoma,Superintendent of Public Instruction,John Cox,DEM,550250,0,0,23,23,
Oklahoma,Superintendent of Public Instruction,Freda Deskin,DEM,550250,0,0,15,15,
Oklahoma,U.S. Senate,Connie Johnson,DEM,550250,0,0,29,29,
Oklahoma,U.S. Senate,Jim Rogers,DEM,550250,0,0,6,6,
Oklahoma,U.S. House,Tom Guild,DEM,550250,0,0,18,18,05
Oklahoma,U.S. House,Al Mcaffrey,DEM,550250,0,0,17,17,05
Oklahoma,U.S. House,Steve Russell,REP,550250,0,0,62,62,05
Oklahoma,U.S. House,Patrice Douglas,REP,550250,0,0,22,22,05
Oklahoma,Superintendent of Public Instruction,John Cox,DEM,550251,0,0,41,41,
Oklahoma,Superintendent of Public Instruction,Freda Deskin,DEM,550251,0,0,23,23,
Oklahoma,U.S. Senate,Connie Johnson,DEM,550251,0,0,56,56,
Oklahoma,U.S. Senate,Jim Rogers,DEM,550251,0,0,10,10,
Oklahoma,Superintendent of Public Instruction,John Cox,DEM,550252,0,0,39,39,
Oklahoma,Superintendent of Public Instruction,Freda Deskin,DEM,550252,0,0,32,32,
Oklahoma,U.S. Senate,Connie Johnson,DEM,550252,0,0,50,50,
Oklahoma,U.S. Senate,Jim Rogers,DEM,550252,0,0,18,18,
Oklahoma,Superintendent of Public Instruction,John Cox,DEM,550253,0,0,8,8,
Oklahoma,Superintendent of Public Instruction,Freda Deskin,DEM,550253,0,0,3,3,
Oklahoma,U.S. Senate,Connie Johnson,DEM,550253,0,0,5,5,
Oklahoma,U.S. Senate,Jim Rogers,DEM,550253,0,0,6,6,
Oklahoma,U.S. House,Tom Guild,DEM,550253,0,0,6,6,05
Oklahoma,U.S. House,Al Mcaffrey,DEM,550253,0,0,5,5,05
Oklahoma,U.S. House,Steve Russell,REP,550253,0,0,33,33,05
Oklahoma,U.S. House,Patrice Douglas,REP,550253,0,0,17,17,05
Oklahoma,Superintendent of Public Instruction,John Cox,DEM,550254,0,0,18,18,
Oklahoma,Superintendent of Public Instruction,Freda Deskin,DEM,550254,0,0,11,11,
Oklahoma,U.S. Senate,Connie Johnson,DEM,550254,0,0,20,20,
Oklahoma,U.S. Senate,Jim Rogers,DEM,550254,0,0,10,10,
Oklahoma,U.S. House,Tom Guild,DEM,550254,0,0,11,11,05
Oklahoma,U.S. House,Al Mcaffrey,DEM,550254,0,0,19,19,05
Oklahoma,U.S. House,Steve Russell,REP,550254,0,0,102,102,05
Oklahoma,U.S. House,Patrice Douglas,REP,550254,0,0,49,49,05
Oklahoma,Superintendent of Public Instruction,John Cox,DEM,550255,0,0,0,0,
Oklahoma,Superintendent of Public Instruction,Freda Deskin,DEM,550255,0,0,0,0,
Oklahoma,U.S. Senate,Connie Johnson,DEM,550255,0,0,0,0,
Oklahoma,U.S. Senate,Jim Rogers,DEM,550255,0,0,0,0,
Oklahoma,Superintendent of Public Instruction,John Cox,DEM,550256,0,0,0,0,
Oklahoma,Superintendent of Public Instruction,Freda Deskin,DEM,550256,0,0,0,0,
Oklahoma,U.S. Senate,Connie Johnson,DEM,550256,0,0,0,0,
Oklahoma,U.S. Senate,Jim Rogers,DEM,550256,0,0,0,0,
Oklahoma,U.S. House,Tom Guild,DEM,550256,0,0,0,0,05
Oklahoma,U.S. House,Al Mcaffrey,DEM,550256,0,0,0,0,05
Oklahoma,U.S. House,Steve Russell,REP,550256,0,0,0,0,05
Oklahoma,U.S. House,Patrice Douglas,REP,550256,0,0,0,0,05
Oklahoma,State Senate,Stephanie Bice,REP,550256,0,0,0,0,22
Oklahoma,State Senate,Mark Thomas,REP,550256,0,0,0,0,22
Oklahoma,Superintendent of Public Instruction,John Cox,DEM,550257,0,0,5,5,
Oklahoma,Superintendent of Public Instruction,Freda Deskin,DEM,550257,0,0,8,8,
Oklahoma,U.S. Senate,Connie Johnson,DEM,550257,0,0,13,13,
Oklahoma,U.S. Senate,Jim Rogers,DEM,550257,0,0,0,0,
Oklahoma,U.S. House,Tom Guild,DEM,550257,0,0,5,5,05
Oklahoma,U.S. House,Al Mcaffrey,DEM,550257,0,0,8,8,05
Oklahoma,State House,George Young,DEM,550257,0,0,9,9,99
Oklahoma,State House,Eleanor Darden Thompson,DEM,550257,0,0,4,4,99
Oklahoma,U.S. House,Steve Russell,REP,550257,0,0,4,4,05
Oklahoma,U.S. House,Patrice Douglas,REP,550257,0,0,3,3,05
Oklahoma,Superintendent of Public Instruction,John Cox,DEM,559999,537,287,0,824,
Oklahoma,Superintendent of Public Instruction,Freda Deskin,DEM,559999,650,298,0,948,
Oklahoma,U.S. Senate,Connie Johnson,DEM,559999,886,535,0,1421,
Oklahoma,U.S. Senate,Jim Rogers,DEM,559999,308,62,0,370,
Oklahoma,U.S. House,Tom Guild,DEM,559999,525,215,0,740,05
Oklahoma,U.S. House,Al Mcaffrey,DEM,559999,556,351,0,907,05
Oklahoma,State House,Jason Dunnington,DEM,559999,37,41,0,78,88
Oklahoma,State House,Paula Sophia,DEM,559999,31,46,0,77,88
Oklahoma,State House,Mary Sosa,DEM,559999,25,2,0,27,89
Oklahoma,State House,Shane Stone,DEM,559999,102,2,0,104,89
Oklahoma,State House,George Young,DEM,559999,35,71,0,106,99
Oklahoma,State House,Eleanor Darden Thompson,DEM,559999,29,39,0,68,99
Oklahoma,U.S. House,Steve Russell,REP,559999,1124,252,0,1376,05
Oklahoma,U.S. House,Patrice Douglas,REP,559999,912,188,0,1100,05
Oklahoma,State Senate,Stephanie Bice,REP,559999,83,19,0,102,22
Oklahoma,State Senate,Mark Thomas,REP,559999,77,11,0,88,22
Oklahoma,State Senate,Ervin Yen,REP,559999,214,77,0,291,40
Oklahoma,State Senate,Steve Kern,REP,559999,120,23,0,143,40
Okmulgee,Superintendent of Public Instruction,John Cox,DEM,560001,0,2,7,9,
Okmulgee,Superintendent of Public Instruction,Freda Deskin,DEM,560001,0,0,9,9,
Okmulgee,U.S. Senate,Connie Johnson,DEM,560001,0,1,13,14,
Okmulgee,U.S. Senate,Jim Rogers,DEM,560001,0,1,3,4,
Okmulgee,State Senate,Selina Jayne-Dornan,DEM,560001,0,0,14,14,8
Okmulgee,State Senate,Gary Clason,DEM,560001,0,2,3,5,8
Okmulgee,Superintendent of Public Instruction,John Cox,DEM,560002,4,1,22,27,
Okmulgee,Superintendent of Public Instruction,Freda Deskin,DEM,560002,4,3,17,24,
Okmulgee,U.S. Senate,Connie Johnson,DEM,560002,7,4,35,46,
Okmulgee,U.S. Senate,Jim Rogers,DEM,560002,1,0,4,5,
Okmulgee,State Senate,Selina Jayne-Dornan,DEM,560002,3,4,25,32,8
Okmulgee,State Senate,Gary Clason,DEM,560002,5,0,15,20,8
Okmulgee,Superintendent of Public Instruction,John Cox,DEM,560004,0,0,4,4,
Okmulgee,Superintendent of Public Instruction,Freda Deskin,DEM,560004,1,0,9,10,
Okmulgee,U.S. Senate,Connie Johnson,DEM,560004,1,0,7,8,
Okmulgee,U.S. Senate,Jim Rogers,DEM,560004,0,0,5,5,
Okmulgee,State Senate,Selina Jayne-Dornan,DEM,560004,0,0,8,8,8
Okmulgee,State Senate,Gary Clason,DEM,560004,1,0,5,6,8
Okmulgee,Superintendent of Public Instruction,John Cox,DEM,560005,0,1,19,20,
Okmulgee,Superintendent of Public Instruction,Freda Deskin,DEM,560005,0,1,18,19,
Okmulgee,U.S. Senate,Connie Johnson,DEM,560005,0,0,14,14,
Okmulgee,U.S. Senate,Jim Rogers,DEM,560005,0,2,23,25,
Okmulgee,State Senate,Selina Jayne-Dornan,DEM,560005,0,2,26,28,8
Okmulgee,State Senate,Gary Clason,DEM,560005,0,0,11,11,8
Okmulgee,Superintendent of Public Instruction,John Cox,DEM,560006,0,0,13,13,
Okmulgee,Superintendent of Public Instruction,Freda Deskin,DEM,560006,0,1,3,4,
Okmulgee,U.S. Senate,Connie Johnson,DEM,560006,0,1,6,7,
Okmulgee,U.S. Senate,Jim Rogers,DEM,560006,0,0,9,9,
Okmulgee,State Senate,Selina Jayne-Dornan,DEM,560006,0,1,8,9,8
Okmulgee,State Senate,Gary Clason,DEM,560006,0,0,8,8,8
Okmulgee,Superintendent of Public Instruction,John Cox,DEM,560007,1,0,13,14,
Okmulgee,Superintendent of Public Instruction,Freda Deskin,DEM,560007,1,1,19,21,
Okmulgee,U.S. Senate,Connie Johnson,DEM,560007,1,1,16,18,
Okmulgee,U.S. Senate,Jim Rogers,DEM,560007,1,0,17,18,
Okmulgee,State Senate,Selina Jayne-Dornan,DEM,560007,2,2,27,31,8
Okmulgee,State Senate,Gary Clason,DEM,560007,0,0,6,6,8
Okmulgee,Superintendent of Public Instruction,John Cox,DEM,560008,1,3,9,13,
Okmulgee,Superintendent of Public Instruction,Freda Deskin,DEM,560008,0,0,18,18,
Okmulgee,U.S. Senate,Connie Johnson,DEM,560008,0,1,11,12,
Okmulgee,U.S. Senate,Jim Rogers,DEM,560008,1,2,16,19,
Okmulgee,State Senate,Selina Jayne-Dornan,DEM,560008,1,1,19,21,8
Okmulgee,State Senate,Gary Clason,DEM,560008,0,2,8,10,8
Okmulgee,Superintendent of Public Instruction,John Cox,DEM,560009,3,1,10,14,
Okmulgee,Superintendent of Public Instruction,Freda Deskin,DEM,560009,2,3,13,18,
Okmulgee,U.S. Senate,Connie Johnson,DEM,560009,2,3,15,20,
Okmulgee,U.S. Senate,Jim Rogers,DEM,560009,3,1,8,12,
Okmulgee,State Senate,Selina Jayne-Dornan,DEM,560009,2,3,14,19,8
Okmulgee,State Senate,Gary Clason,DEM,560009,3,1,7,11,8
Okmulgee,Superintendent of Public Instruction,John Cox,DEM,560010,0,2,17,19,
Okmulgee,Superintendent of Public Instruction,Freda Deskin,DEM,560010,0,0,11,11,
Okmulgee,U.S. Senate,Connie Johnson,DEM,560010,0,2,11,13,
Okmulgee,U.S. Senate,Jim Rogers,DEM,560010,0,0,18,18,
Okmulgee,State Senate,Selina Jayne-Dornan,DEM,560010,0,1,16,17,8
Okmulgee,State Senate,Gary Clason,DEM,560010,0,1,14,15,8
Okmulgee,Superintendent of Public Instruction,John Cox,DEM,560011,4,0,23,27,
Okmulgee,Superintendent of Public Instruction,Freda Deskin,DEM,560011,0,1,13,14,
Okmulgee,U.S. Senate,Connie Johnson,DEM,560011,0,1,20,21,
Okmulgee,U.S. Senate,Jim Rogers,DEM,560011,3,0,18,21,
Okmulgee,State Senate,Selina Jayne-Dornan,DEM,560011,1,1,20,22,8
Okmulgee,State Senate,Gary Clason,DEM,560011,1,0,18,19,8
Okmulgee,Superintendent of Public Instruction,John Cox,DEM,560012,5,3,65,73,
Okmulgee,Superintendent of Public Instruction,Freda Deskin,DEM,560012,1,1,30,32,
Okmulgee,U.S. Senate,Connie Johnson,DEM,560012,2,3,53,58,
Okmulgee,U.S. Senate,Jim Rogers,DEM,560012,4,1,39,44,
Okmulgee,State Senate,Selina Jayne-Dornan,DEM,560012,1,3,73,77,8
Okmulgee,State Senate,Gary Clason,DEM,560012,5,1,25,31,8
Okmulgee,Superintendent of Public Instruction,John Cox,DEM,560013,0,0,51,51,
Okmulgee,Superintendent of Public Instruction,Freda Deskin,DEM,560013,1,0,19,20,
Okmulgee,U.S. Senate,Connie Johnson,DEM,560013,0,0,27,27,
Okmulgee,U.S. Senate,Jim Rogers,DEM,560013,1,0,42,43,
Okmulgee,State Senate,Selina Jayne-Dornan,DEM,560013,0,0,27,27,8
Okmulgee,State Senate,Gary Clason,DEM,560013,1,0,43,44,8
Okmulgee,Superintendent of Public Instruction,John Cox,DEM,560014,1,0,36,37,
Okmulgee,Superintendent of Public Instruction,Freda Deskin,DEM,560014,2,0,7,9,
Okmulgee,U.S. Senate,Connie Johnson,DEM,560014,1,0,18,19,
Okmulgee,U.S. Senate,Jim Rogers,DEM,560014,2,0,24,26,
Okmulgee,State Senate,Selina Jayne-Dornan,DEM,560014,2,0,18,20,8
Okmulgee,State Senate,Gary Clason,DEM,560014,2,0,26,28,8
Okmulgee,Superintendent of Public Instruction,John Cox,DEM,560015,5,1,87,93,
Okmulgee,Superintendent of Public Instruction,Freda Deskin,DEM,560015,3,0,33,36,
Okmulgee,U.S. Senate,Connie Johnson,DEM,560015,2,1,64,67,
Okmulgee,U.S. Senate,Jim Rogers,DEM,560015,6,0,53,59,
Okmulgee,State Senate,Selina Jayne-Dornan,DEM,560015,0,0,67,67,8
Okmulgee,State Senate,Gary Clason,DEM,560015,8,1,53,62,8
Okmulgee,Superintendent of Public Instruction,John Cox,DEM,560016,2,0,45,47,
Okmulgee,Superintendent of Public Instruction,Freda Deskin,DEM,560016,0,2,17,19,
Okmulgee,U.S. Senate,Connie Johnson,DEM,560016,2,2,24,28,
Okmulgee,U.S. Senate,Jim Rogers,DEM,560016,0,0,36,36,
Okmulgee,State Senate,Selina Jayne-Dornan,DEM,560016,0,2,22,24,8
Okmulgee,State Senate,Gary Clason,DEM,560016,2,0,40,42,8
Okmulgee,Superintendent of Public Instruction,John Cox,DEM,560018,3,2,34,39,
Okmulgee,Superintendent of Public Instruction,Freda Deskin,DEM,560018,3,0,23,26,
Okmulgee,U.S. Senate,Connie Johnson,DEM,560018,3,0,22,25,
Okmulgee,U.S. Senate,Jim Rogers,DEM,560018,1,2,33,36,
Okmulgee,State Senate,Selina Jayne-Dornan,DEM,560018,1,0,23,24,8
Okmulgee,State Senate,Gary Clason,DEM,560018,5,2,34,41,8
Okmulgee,Superintendent of Public Instruction,John Cox,DEM,560019,1,0,55,56,
Okmulgee,Superintendent of Public Instruction,Freda Deskin,DEM,560019,0,1,12,13,
Okmulgee,U.S. Senate,Connie Johnson,DEM,560019,0,0,30,30,
Okmulgee,U.S. Senate,Jim Rogers,DEM,560019,1,1,33,35,
Okmulgee,State Senate,Selina Jayne-Dornan,DEM,560019,0,0,29,29,8
Okmulgee,State Senate,Gary Clason,DEM,560019,1,1,38,40,8
Okmulgee,Superintendent of Public Instruction,John Cox,DEM,560020,0,3,182,185,
Okmulgee,Superintendent of Public Instruction,Freda Deskin,DEM,560020,0,3,103,106,
Okmulgee,U.S. Senate,Connie Johnson,DEM,560020,0,3,160,163,
Okmulgee,U.S. Senate,Jim Rogers,DEM,560020,0,3,124,127,
Okmulgee,State Senate,Selina Jayne-Dornan,DEM,560020,0,2,200,202,8
Okmulgee,State Senate,Gary Clason,DEM,560020,0,4,86,90,8
Okmulgee,Superintendent of Public Instruction,John Cox,DEM,560021,0,0,24,24,
Okmulgee,Superintendent of Public Instruction,Freda Deskin,DEM,560021,2,2,15,19,
Okmulgee,U.S. Senate,Connie Johnson,DEM,560021,2,2,24,28,
Okmulgee,U.S. Senate,Jim Rogers,DEM,560021,0,0,15,15,
Okmulgee,State Senate,Selina Jayne-Dornan,DEM,560021,2,2,20,24,8
Okmulgee,State Senate,Gary Clason,DEM,560021,0,0,18,18,8
Okmulgee,Superintendent of Public Instruction,John Cox,DEM,560026,0,2,73,75,
Okmulgee,Superintendent of Public Instruction,Freda Deskin,DEM,560026,0,1,25,26,
Okmulgee,U.S. Senate,Connie Johnson,DEM,560026,0,0,38,38,
Okmulgee,U.S. Senate,Jim Rogers,DEM,560026,0,3,53,56,
Okmulgee,State Senate,Selina Jayne-Dornan,DEM,560026,0,1,65,66,8
Okmulgee,State Senate,Gary Clason,DEM,560026,0,2,32,34,8
Okmulgee,Superintendent of Public Instruction,John Cox,DEM,560027,2,0,72,74,
Okmulgee,Superintendent of Public Instruction,Freda Deskin,DEM,560027,4,0,11,15,
Okmulgee,U.S. Senate,Connie Johnson,DEM,560027,3,0,36,39,
Okmulgee,U.S. Senate,Jim Rogers,DEM,560027,3,0,44,47,
Okmulgee,State Senate,Selina Jayne-Dornan,DEM,560027,5,0,42,47,8
Okmulgee,State Senate,Gary Clason,DEM,560027,1,0,40,41,8
Okmulgee,Superintendent of Public Instruction,John Cox,DEM,560029,1,2,51,54,
Okmulgee,Superintendent of Public Instruction,Freda Deskin,DEM,560029,0,0,23,23,
Okmulgee,U.S. Senate,Connie Johnson,DEM,560029,1,0,34,35,
Okmulgee,U.S. Senate,Jim Rogers,DEM,560029,0,2,35,37,
Okmulgee,State Senate,Selina Jayne-Dornan,DEM,560029,1,0,44,45,8
Okmulgee,State Senate,Gary Clason,DEM,560029,0,2,28,30,8
Okmulgee,Superintendent of Public Instruction,John Cox,DEM,560031,0,1,23,24,
Okmulgee,Superintendent of Public Instruction,Freda Deskin,DEM,560031,0,0,10,10,
Okmulgee,U.S. Senate,Connie Johnson,DEM,560031,0,0,12,12,
Okmulgee,U.S. Senate,Jim Rogers,DEM,560031,0,1,21,22,
Okmulgee,State Senate,Selina Jayne-Dornan,DEM,560031,0,1,20,21,8
Okmulgee,State Senate,Gary Clason,DEM,560031,0,0,13,13,8
Okmulgee,Superintendent of Public Instruction,John Cox,DEM,560032,0,1,11,12,
Okmulgee,Superintendent of Public Instruction,Freda Deskin,DEM,560032,1,3,6,10,
Okmulgee,U.S. Senate,Connie Johnson,DEM,560032,0,3,9,12,
Okmulgee,U.S. Senate,Jim Rogers,DEM,560032,1,1,8,10,
Okmulgee,State Senate,Selina Jayne-Dornan,DEM,560032,1,3,15,19,8
Okmulgee,State Senate,Gary Clason,DEM,560032,0,1,2,3,8
Okmulgee,Superintendent of Public Instruction,John Cox,DEM,560033,1,1,33,35,
Okmulgee,Superintendent of Public Instruction,Freda Deskin,DEM,560033,0,0,9,9,
Okmulgee,U.S. Senate,Connie Johnson,DEM,560033,1,0,19,20,
Okmulgee,U.S. Senate,Jim Rogers,DEM,560033,0,1,21,22,
Okmulgee,State Senate,Selina Jayne-Dornan,DEM,560033,0,0,25,25,8
Okmulgee,State Senate,Gary Clason,DEM,560033,1,1,17,19,8
Okmulgee,Superintendent of Public Instruction,John Cox,DEM,560034,1,0,26,27,
Okmulgee,Superintendent of Public Instruction,Freda Deskin,DEM,560034,0,0,2,2,
Okmulgee,U.S. Senate,Connie Johnson,DEM,560034,0,0,4,4,
Okmulgee,U.S. Senate,Jim Rogers,DEM,560034,1,0,24,25,
Okmulgee,State Senate,Selina Jayne-Dornan,DEM,560034,0,0,6,6,8
Okmulgee,State Senate,Gary Clason,DEM,560034,1,0,22,23,8
Okmulgee,Superintendent of Public Instruction,John Cox,DEM,560035,1,0,25,26,
Okmulgee,Superintendent of Public Instruction,Freda Deskin,DEM,560035,0,0,6,6,
Okmulgee,U.S. Senate,Connie Johnson,DEM,560035,0,0,10,10,
Okmulgee,U.S. Senate,Jim Rogers,DEM,560035,1,0,18,19,
Okmulgee,State Senate,Selina Jayne-Dornan,DEM,560035,0,0,8,8,8
Okmulgee,State Senate,Gary Clason,DEM,560035,1,0,23,24,8
Okmulgee,Superintendent of Public Instruction,John Cox,DEM,560036,1,2,39,42,
Okmulgee,Superintendent of Public Instruction,Freda Deskin,DEM,560036,2,1,14,17,
Okmulgee,U.S. Senate,Connie Johnson,DEM,560036,3,2,29,34,
Okmulgee,U.S. Senate,Jim Rogers,DEM,560036,0,0,24,24,
Okmulgee,State Senate,Selina Jayne-Dornan,DEM,560036,1,2,39,42,8
Okmulgee,State Senate,Gary Clason,DEM,560036,2,1,14,17,8
Okmulgee,Superintendent of Public Instruction,John Cox,DEM,560038,0,0,31,31,
Okmulgee,Superintendent of Public Instruction,Freda Deskin,DEM,560038,0,0,4,4,
Okmulgee,U.S. Senate,Connie Johnson,DEM,560038,0,0,10,10,
Okmulgee,U.S. Senate,Jim Rogers,DEM,560038,0,0,23,23,
Okmulgee,State Senate,Selina Jayne-Dornan,DEM,560038,0,0,14,14,8
Okmulgee,State Senate,Gary Clason,DEM,560038,0,0,21,21,8
Osage,Superintendent of Public Instruction,John Cox,DEM,570101,0,0,7,7,
Osage,Superintendent of Public Instruction,Freda Deskin,DEM,570101,0,0,2,2,
Osage,U.S. Senate,Connie Johnson,DEM,570101,0,0,4,4,
Osage,U.S. Senate,Jim Rogers,DEM,570101,0,0,3,3,
Osage,Superintendent of Public Instruction,John Cox,DEM,570102,4,0,4,8,
Osage,Superintendent of Public Instruction,Freda Deskin,DEM,570102,0,0,2,2,
Osage,U.S. Senate,Connie Johnson,DEM,570102,4,0,5,9,
Osage,U.S. Senate,Jim Rogers,DEM,570102,0,0,1,1,
Osage,Superintendent of Public Instruction,John Cox,DEM,570103,0,0,21,21,
Osage,Superintendent of Public Instruction,Freda Deskin,DEM,570103,0,0,9,9,
Osage,U.S. Senate,Connie Johnson,DEM,570103,0,0,13,13,
Osage,U.S. Senate,Jim Rogers,DEM,570103,0,0,17,17,
Osage,Superintendent of Public Instruction,John Cox,DEM,570105,3,0,11,14,
Osage,Superintendent of Public Instruction,Freda Deskin,DEM,570105,3,0,8,11,
Osage,U.S. Senate,Connie Johnson,DEM,570105,1,0,11,12,
Osage,U.S. Senate,Jim Rogers,DEM,570105,5,0,8,13,
Osage,Superintendent of Public Instruction,John Cox,DEM,570106,0,0,1,1,
Osage,Superintendent of Public Instruction,Freda Deskin,DEM,570106,0,0,6,6,
Osage,U.S. Senate,Connie Johnson,DEM,570106,0,0,5,5,
Osage,U.S. Senate,Jim Rogers,DEM,570106,0,0,2,2,
Osage,Superintendent of Public Instruction,John Cox,DEM,570107,3,6,59,68,
Osage,Superintendent of Public Instruction,Freda Deskin,DEM,570107,1,2,18,21,
Osage,U.S. Senate,Connie Johnson,DEM,570107,1,4,33,38,
Osage,U.S. Senate,Jim Rogers,DEM,570107,2,4,43,49,
Osage,Superintendent of Public Instruction,John Cox,DEM,570108,1,1,23,25,
Osage,Superintendent of Public Instruction,Freda Deskin,DEM,570108,2,1,9,12,
Osage,U.S. Senate,Connie Johnson,DEM,570108,3,2,24,29,
Osage,U.S. Senate,Jim Rogers,DEM,570108,0,0,8,8,
Osage,Superintendent of Public Instruction,John Cox,DEM,570109,1,0,17,18,
Osage,Superintendent of Public Instruction,Freda Deskin,DEM,570109,0,0,11,11,
Osage,U.S. Senate,Connie Johnson,DEM,570109,0,0,15,15,
Osage,U.S. Senate,Jim Rogers,DEM,570109,1,0,13,14,
Osage,Superintendent of Public Instruction,John Cox,DEM,570110,6,0,56,62,
Osage,Superintendent of Public Instruction,Freda Deskin,DEM,570110,1,1,10,12,
Osage,U.S. Senate,Connie Johnson,DEM,570110,3,0,14,17,
Osage,U.S. Senate,Jim Rogers,DEM,570110,4,1,50,55,
Osage,Superintendent of Public Instruction,John Cox,DEM,570111,0,0,14,14,
Osage,Superintendent of Public Instruction,Freda Deskin,DEM,570111,0,0,2,2,
Osage,U.S. Senate,Connie Johnson,DEM,570111,0,0,7,7,
Osage,U.S. Senate,Jim Rogers,DEM,570111,0,0,9,9,
Osage,Superintendent of Public Instruction,John Cox,DEM,570112,3,0,15,18,
Osage,Superintendent of Public Instruction,Freda Deskin,DEM,570112,2,0,1,3,
Osage,U.S. Senate,Connie Johnson,DEM,570112,2,0,3,5,
Osage,U.S. Senate,Jim Rogers,DEM,570112,3,0,12,15,
Osage,Superintendent of Public Instruction,John Cox,DEM,570113,0,0,6,6,
Osage,Superintendent of Public Instruction,Freda Deskin,DEM,570113,0,0,8,8,
Osage,U.S. Senate,Connie Johnson,DEM,570113,0,0,8,8,
Osage,U.S. Senate,Jim Rogers,DEM,570113,0,0,6,6,
Osage,Superintendent of Public Instruction,John Cox,DEM,570201,7,0,26,33,
Osage,Superintendent of Public Instruction,Freda Deskin,DEM,570201,2,0,8,10,
Osage,U.S. Senate,Connie Johnson,DEM,570201,4,0,19,23,
Osage,U.S. Senate,Jim Rogers,DEM,570201,5,0,14,19,
Osage,Superintendent of Public Instruction,John Cox,DEM,570202,14,0,98,112,
Osage,Superintendent of Public Instruction,Freda Deskin,DEM,570202,16,1,49,66,
Osage,U.S. Senate,Connie Johnson,DEM,570202,28,2,139,169,
Osage,U.S. Senate,Jim Rogers,DEM,570202,2,0,8,10,
Osage,Superintendent of Public Instruction,John Cox,DEM,570203,1,0,32,33,
Osage,Superintendent of Public Instruction,Freda Deskin,DEM,570203,4,0,7,11,
Osage,U.S. Senate,Connie Johnson,DEM,570203,3,0,18,21,
Osage,U.S. Senate,Jim Rogers,DEM,570203,3,0,20,23,
Osage,Superintendent of Public Instruction,John Cox,DEM,570204,2,1,22,25,
Osage,Superintendent of Public Instruction,Freda Deskin,DEM,570204,0,0,7,7,
Osage,U.S. Senate,Connie Johnson,DEM,570204,1,1,14,16,
Osage,U.S. Senate,Jim Rogers,DEM,570204,1,0,15,16,
Osage,Superintendent of Public Instruction,John Cox,DEM,570205,0,0,3,3,
Osage,Superintendent of Public Instruction,Freda Deskin,DEM,570205,1,0,4,5,
Osage,U.S. Senate,Connie Johnson,DEM,570205,1,0,3,4,
Osage,U.S. Senate,Jim Rogers,DEM,570205,0,0,4,4,
Osage,Superintendent of Public Instruction,John Cox,DEM,570301,5,0,32,37,
Osage,Superintendent of Public Instruction,Freda Deskin,DEM,570301,1,0,23,24,
Osage,U.S. Senate,Connie Johnson,DEM,570301,4,0,21,25,
Osage,U.S. Senate,Jim Rogers,DEM,570301,2,0,34,36,
Osage,Superintendent of Public Instruction,John Cox,DEM,570302,2,0,7,9,
Osage,Superintendent of Public Instruction,Freda Deskin,DEM,570302,0,0,4,4,
Osage,U.S. Senate,Connie Johnson,DEM,570302,0,0,6,6,
Osage,U.S. Senate,Jim Rogers,DEM,570302,2,0,4,6,
Osage,Superintendent of Public Instruction,John Cox,DEM,570303,0,0,6,6,
Osage,Superintendent of Public Instruction,Freda Deskin,DEM,570303,0,0,1,1,
Osage,U.S. Senate,Connie Johnson,DEM,570303,0,0,5,5,
Osage,U.S. Senate,Jim Rogers,DEM,570303,0,0,2,2,
Osage,Superintendent of Public Instruction,John Cox,DEM,570305,3,0,20,23,
Osage,Superintendent of Public Instruction,Freda Deskin,DEM,570305,4,0,6,10,
Osage,U.S. Senate,Connie Johnson,DEM,570305,5,0,5,10,
Osage,U.S. Senate,Jim Rogers,DEM,570305,2,0,21,23,
Osage,Superintendent of Public Instruction,John Cox,DEM,570306,0,0,9,9,
Osage,Superintendent of Public Instruction,Freda Deskin,DEM,570306,0,0,4,4,
Osage,U.S. Senate,Connie Johnson,DEM,570306,0,0,4,4,
Osage,U.S. Senate,Jim Rogers,DEM,570306,0,0,9,9,
Osage,Superintendent of Public Instruction,John Cox,DEM,570307,4,0,39,43,
Osage,Superintendent of Public Instruction,Freda Deskin,DEM,570307,0,0,12,12,
Osage,U.S. Senate,Connie Johnson,DEM,570307,2,0,23,25,
Osage,U.S. Senate,Jim Rogers,DEM,570307,2,0,28,30,
Osage,Superintendent of Public Instruction,John Cox,DEM,570308,2,0,27,29,
Osage,Superintendent of Public Instruction,Freda Deskin,DEM,570308,0,0,13,13,
Osage,U.S. Senate,Connie Johnson,DEM,570308,1,0,25,26,
Osage,U.S. Senate,Jim Rogers,DEM,570308,1,0,14,15,
Osage,Superintendent of Public Instruction,John Cox,DEM,570309,3,0,9,12,
Osage,Superintendent of Public Instruction,Freda Deskin,DEM,570309,1,0,3,4,
Osage,U.S. Senate,Connie Johnson,DEM,570309,3,0,5,8,
Osage,U.S. Senate,Jim Rogers,DEM,570309,1,0,7,8,
Osage,Superintendent of Public Instruction,John Cox,DEM,570310,5,0,66,71,
Osage,Superintendent of Public Instruction,Freda Deskin,DEM,570310,6,1,29,36,
Osage,U.S. Senate,Connie Johnson,DEM,570310,8,1,85,94,
Osage,U.S. Senate,Jim Rogers,DEM,570310,3,0,10,13,
Osage,Superintendent of Public Instruction,John Cox,DEM,570311,0,0,1,1,
Osage,Superintendent of Public Instruction,Freda Deskin,DEM,570311,0,0,1,1,
Osage,U.S. Senate,Connie Johnson,DEM,570311,0,0,2,2,
Osage,U.S. Senate,Jim Rogers,DEM,570311,0,0,0,0,
Osage,Superintendent of Public Instruction,John Cox,DEM,570312,0,0,11,11,
Osage,Superintendent of Public Instruction,Freda Deskin,DEM,570312,1,0,5,6,
Osage,U.S. Senate,Connie Johnson,DEM,570312,1,0,15,16,
Osage,U.S. Senate,Jim Rogers,DEM,570312,0,0,1,1,
Ottawa,Superintendent of Public Instruction,John Cox,DEM,580002,1,1,10,12,
Ottawa,Superintendent of Public Instruction,Freda Deskin,DEM,580002,1,1,3,5,
Ottawa,U.S. Senate,Connie Johnson,DEM,580002,0,2,3,5,
Ottawa,U.S. Senate,Jim Rogers,DEM,580002,2,0,10,12,
Ottawa,Superintendent of Public Instruction,John Cox,DEM,580003,0,1,21,22,
Ottawa,Superintendent of Public Instruction,Freda Deskin,DEM,580003,1,0,7,8,
Ottawa,U.S. Senate,Connie Johnson,DEM,580003,1,1,17,19,
Ottawa,U.S. Senate,Jim Rogers,DEM,580003,0,0,11,11,
Ottawa,Superintendent of Public Instruction,John Cox,DEM,580004,0,0,19,19,
Ottawa,Superintendent of Public Instruction,Freda Deskin,DEM,580004,0,0,2,2,
Ottawa,U.S. Senate,Connie Johnson,DEM,580004,0,0,12,12,
Ottawa,U.S. Senate,Jim Rogers,DEM,580004,0,0,9,9,
Ottawa,Superintendent of Public Instruction,John Cox,DEM,580005,0,2,11,13,
Ottawa,Superintendent of Public Instruction,Freda Deskin,DEM,580005,0,0,6,6,
Ottawa,U.S. Senate,Connie Johnson,DEM,580005,0,0,9,9,
Ottawa,U.S. Senate,Jim Rogers,DEM,580005,0,2,8,10,
Ottawa,Superintendent of Public Instruction,John Cox,DEM,580007,2,2,32,36,
Ottawa,Superintendent of Public Instruction,Freda Deskin,DEM,580007,0,0,3,3,
Ottawa,U.S. Senate,Connie Johnson,DEM,580007,2,2,16,20,
Ottawa,U.S. Senate,Jim Rogers,DEM,580007,0,0,18,18,
Ottawa,Superintendent of Public Instruction,John Cox,DEM,580008,1,2,5,8,
Ottawa,Superintendent of Public Instruction,Freda Deskin,DEM,580008,0,0,7,7,
Ottawa,U.S. Senate,Connie Johnson,DEM,580008,1,0,5,6,
Ottawa,U.S. Senate,Jim Rogers,DEM,580008,0,2,5,7,
Ottawa,Superintendent of Public Instruction,John Cox,DEM,580009,0,1,13,14,
Ottawa,Superintendent of Public Instruction,Freda Deskin,DEM,580009,1,0,2,3,
Ottawa,U.S. Senate,Connie Johnson,DEM,580009,1,0,10,11,
Ottawa,U.S. Senate,Jim Rogers,DEM,580009,0,0,4,4,
Ottawa,Superintendent of Public Instruction,John Cox,DEM,580011,2,0,13,15,
Ottawa,Superintendent of Public Instruction,Freda Deskin,DEM,580011,3,0,8,11,
Ottawa,U.S. Senate,Connie Johnson,DEM,580011,1,0,8,9,
Ottawa,U.S. Senate,Jim Rogers,DEM,580011,4,0,13,17,
Ottawa,Superintendent of Public Instruction,John Cox,DEM,580012,0,2,14,16,
Ottawa,Superintendent of Public Instruction,Freda Deskin,DEM,580012,3,0,1,4,
Ottawa,U.S. Senate,Connie Johnson,DEM,580012,0,2,7,9,
Ottawa,U.S. Senate,Jim Rogers,DEM,580012,3,0,8,11,
Ottawa,Superintendent of Public Instruction,John Cox,DEM,580014,0,3,28,31,
Ottawa,Superintendent of Public Instruction,Freda Deskin,DEM,580014,0,0,10,10,
Ottawa,U.S. Senate,Connie Johnson,DEM,580014,0,2,21,23,
Ottawa,U.S. Senate,Jim Rogers,DEM,580014,0,1,17,18,
Ottawa,Superintendent of Public Instruction,John Cox,DEM,580023,0,0,11,11,
Ottawa,Superintendent of Public Instruction,Freda Deskin,DEM,580023,0,0,4,4,
Ottawa,U.S. Senate,Connie Johnson,DEM,580023,0,0,7,7,
Ottawa,U.S. Senate,Jim Rogers,DEM,580023,0,0,8,8,
Ottawa,Superintendent of Public Instruction,John Cox,DEM,580024,0,0,9,9,
Ottawa,Superintendent of Public Instruction,Freda Deskin,DEM,580024,0,0,2,2,
Ottawa,U.S. Senate,Connie Johnson,DEM,580024,0,0,5,5,
Ottawa,U.S. Senate,Jim Rogers,DEM,580024,0,0,7,7,
Ottawa,Superintendent of Public Instruction,John Cox,DEM,580025,0,0,20,20,
Ottawa,Superintendent of Public Instruction,Freda Deskin,DEM,580025,0,0,3,3,
Ottawa,U.S. Senate,Connie Johnson,DEM,580025,0,0,12,12,
Ottawa,U.S. Senate,Jim Rogers,DEM,580025,0,0,11,11,
Ottawa,Superintendent of Public Instruction,John Cox,DEM,580026,0,0,9,9,
Ottawa,Superintendent of Public Instruction,Freda Deskin,DEM,580026,0,0,4,4,
Ottawa,U.S. Senate,Connie Johnson,DEM,580026,0,0,10,10,
Ottawa,U.S. Senate,Jim Rogers,DEM,580026,0,0,3,3,
Ottawa,Superintendent of Public Instruction,John Cox,DEM,580028,2,1,32,35,
Ottawa,Superintendent of Public Instruction,Freda Deskin,DEM,580028,0,1,12,13,
Ottawa,U.S. Senate,Connie Johnson,DEM,580028,0,0,24,24,
Ottawa,U.S. Senate,Jim Rogers,DEM,580028,2,1,20,23,
Ottawa,Superintendent of Public Instruction,John Cox,DEM,580031,2,1,23,26,
Ottawa,Superintendent of Public Instruction,Freda Deskin,DEM,580031,1,0,3,4,
Ottawa,U.S. Senate,Connie Johnson,DEM,580031,2,0,19,21,
Ottawa,U.S. Senate,Jim Rogers,DEM,580031,1,1,6,8,
Ottawa,Superintendent of Public Instruction,John Cox,DEM,580034,0,1,16,17,
Ottawa,Superintendent of Public Instruction,Freda Deskin,DEM,580034,0,0,4,4,
Ottawa,U.S. Senate,Connie Johnson,DEM,580034,0,0,9,9,
Ottawa,U.S. Senate,Jim Rogers,DEM,580034,0,1,11,12,
Pawnee,Superintendent of Public Instruction,John Cox,DEM,590104,0,5,25,30,
Pawnee,Superintendent of Public Instruction,Freda Deskin,DEM,590104,0,3,13,16,
Pawnee,U.S. Senate,Connie Johnson,DEM,590104,0,4,11,15,
Pawnee,U.S. Senate,Jim Rogers,DEM,590104,0,4,27,31,
Pawnee,Superintendent of Public Instruction,John Cox,DEM,590111,0,0,6,6,
Pawnee,Superintendent of Public Instruction,Freda Deskin,DEM,590111,0,0,11,11,
Pawnee,U.S. Senate,Connie Johnson,DEM,590111,0,0,9,9,
Pawnee,U.S. Senate,Jim Rogers,DEM,590111,0,0,8,8,
Pawnee,Superintendent of Public Instruction,John Cox,DEM,590112,1,0,8,9,
Pawnee,Superintendent of Public Instruction,Freda Deskin,DEM,590112,0,0,5,5,
Pawnee,U.S. Senate,Connie Johnson,DEM,590112,0,0,6,6,
Pawnee,U.S. Senate,Jim Rogers,DEM,590112,1,0,7,8,
Pawnee,Superintendent of Public Instruction,John Cox,DEM,590118,1,0,28,29,
Pawnee,Superintendent of Public Instruction,Freda Deskin,DEM,590118,0,0,3,3,
Pawnee,U.S. Senate,Connie Johnson,DEM,590118,0,0,20,20,
Pawnee,U.S. Senate,Jim Rogers,DEM,590118,1,0,11,12,
Pawnee,Superintendent of Public Instruction,John Cox,DEM,590202,0,2,20,22,
Pawnee,Superintendent of Public Instruction,Freda Deskin,DEM,590202,2,4,18,24,
Pawnee,U.S. Senate,Connie Johnson,DEM,590202,0,6,23,29,
Pawnee,U.S. Senate,Jim Rogers,DEM,590202,2,0,13,15,
Pawnee,Superintendent of Public Instruction,John Cox,DEM,590215,0,0,10,10,
Pawnee,Superintendent of Public Instruction,Freda Deskin,DEM,590215,0,0,2,2,
Pawnee,U.S. Senate,Connie Johnson,DEM,590215,0,0,6,6,
Pawnee,U.S. Senate,Jim Rogers,DEM,590215,0,0,6,6,
Pawnee,Superintendent of Public Instruction,John Cox,DEM,590217,0,1,22,23,
Pawnee,Superintendent of Public Instruction,Freda Deskin,DEM,590217,1,2,8,11,
Pawnee,U.S. Senate,Connie Johnson,DEM,590217,1,1,15,17,
Pawnee,U.S. Senate,Jim Rogers,DEM,590217,0,1,14,15,
Pawnee,Superintendent of Public Instruction,John Cox,DEM,590307,1,0,13,14,
Pawnee,Superintendent of Public Instruction,Freda Deskin,DEM,590307,1,0,9,10,
Pawnee,U.S. Senate,Connie Johnson,DEM,590307,0,0,12,12,
Pawnee,U.S. Senate,Jim Rogers,DEM,590307,2,0,10,12,
Pawnee,Superintendent of Public Instruction,John Cox,DEM,590309,0,0,3,3,
Pawnee,Superintendent of Public Instruction,Freda Deskin,DEM,590309,0,0,3,3,
Pawnee,U.S. Senate,Connie Johnson,DEM,590309,0,0,3,3,
Pawnee,U.S. Senate,Jim Rogers,DEM,590309,0,0,3,3,
Pawnee,Superintendent of Public Instruction,John Cox,DEM,590314,0,2,15,17,
Pawnee,Superintendent of Public Instruction,Freda Deskin,DEM,590314,0,0,11,11,
Pawnee,U.S. Senate,Connie Johnson,DEM,590314,0,2,17,19,
Pawnee,U.S. Senate,Jim Rogers,DEM,590314,0,0,9,9,
Payne,Superintendent of Public Instruction,John Cox,DEM,600001,0,0,10,10,
Payne,Superintendent of Public Instruction,Freda Deskin,DEM,600001,1,0,9,10,
Payne,U.S. Senate,Connie Johnson,DEM,600001,0,0,12,12,
Payne,U.S. Senate,Jim Rogers,DEM,600001,1,0,7,8,
Payne,Superintendent of Public Instruction,John Cox,DEM,600002,2,2,18,22,
Payne,Superintendent of Public Instruction,Freda Deskin,DEM,600002,1,1,27,29,
Payne,U.S. Senate,Connie Johnson,DEM,600002,1,2,31,34,
Payne,U.S. Senate,Jim Rogers,DEM,600002,2,1,14,17,
Payne,Superintendent of Public Instruction,John Cox,DEM,600003,0,2,17,19,
Payne,Superintendent of Public Instruction,Freda Deskin,DEM,600003,2,1,9,12,
Payne,U.S. Senate,Connie Johnson,DEM,600003,1,1,18,20,
Payne,U.S. Senate,Jim Rogers,DEM,600003,1,2,8,11,
Payne,Superintendent of Public Instruction,John Cox,DEM,600004,0,1,37,38,
Payne,Superintendent of Public Instruction,Freda Deskin,DEM,600004,0,3,30,33,
Payne,U.S. Senate,Connie Johnson,DEM,600004,0,2,50,52,
Payne,U.S. Senate,Jim Rogers,DEM,600004,0,2,16,18,
Payne,Superintendent of Public Instruction,John Cox,DEM,600005,0,0,5,5,
Payne,Superintendent of Public Instruction,Freda Deskin,DEM,600005,0,0,3,3,
Payne,U.S. Senate,Connie Johnson,DEM,600005,0,0,7,7,
Payne,U.S. Senate,Jim Rogers,DEM,600005,0,0,1,1,
Payne,Superintendent of Public Instruction,John Cox,DEM,600006,0,3,36,39,
Payne,Superintendent of Public Instruction,Freda Deskin,DEM,600006,1,2,18,21,
Payne,U.S. Senate,Connie Johnson,DEM,600006,0,4,41,45,
Payne,U.S. Senate,Jim Rogers,DEM,600006,1,1,13,15,
Payne,Superintendent of Public Instruction,John Cox,DEM,600007,1,0,3,4,
Payne,Superintendent of Public Instruction,Freda Deskin,DEM,600007,1,0,9,10,
Payne,U.S. Senate,Connie Johnson,DEM,600007,2,0,10,12,
Payne,U.S. Senate,Jim Rogers,DEM,600007,0,0,2,2,
Payne,Superintendent of Public Instruction,John Cox,DEM,600008,2,0,23,25,
Payne,Superintendent of Public Instruction,Freda Deskin,DEM,600008,2,0,22,24,
Payne,U.S. Senate,Connie Johnson,DEM,600008,2,0,36,38,
Payne,U.S. Senate,Jim Rogers,DEM,600008,2,0,7,9,
Payne,Superintendent of Public Instruction,John Cox,DEM,600009,1,3,37,41,
Payne,Superintendent of Public Instruction,Freda Deskin,DEM,600009,1,0,43,44,
Payne,U.S. Senate,Connie Johnson,DEM,600009,2,2,56,60,
Payne,U.S. Senate,Jim Rogers,DEM,600009,0,1,22,23,
Payne,Superintendent of Public Instruction,John Cox,DEM,600010,1,0,14,15,
Payne,Superintendent of Public Instruction,Freda Deskin,DEM,600010,0,2,10,12,
Payne,U.S. Senate,Connie Johnson,DEM,600010,0,2,17,19,
Payne,U.S. Senate,Jim Rogers,DEM,600010,1,0,7,8,
Payne,Superintendent of Public Instruction,John Cox,DEM,600011,0,1,14,15,
Payne,Superintendent of Public Instruction,Freda Deskin,DEM,600011,0,0,6,6,
Payne,U.S. Senate,Connie Johnson,DEM,600011,0,1,14,15,
Payne,U.S. Senate,Jim Rogers,DEM,600011,0,0,6,6,
Payne,Superintendent of Public Instruction,John Cox,DEM,600012,1,0,2,3,
Payne,Superintendent of Public Instruction,Freda Deskin,DEM,600012,0,1,10,11,
Payne,U.S. Senate,Connie Johnson,DEM,600012,1,0,12,13,
Payne,U.S. Senate,Jim Rogers,DEM,600012,0,1,0,1,
Payne,Superintendent of Public Instruction,John Cox,DEM,600013,1,4,50,55,
Payne,Superintendent of Public Instruction,Freda Deskin,DEM,600013,1,4,23,28,
Payne,U.S. Senate,Connie Johnson,DEM,600013,1,8,50,59,
Payne,U.S. Senate,Jim Rogers,DEM,600013,1,1,21,23,
Payne,Superintendent of Public Instruction,John Cox,DEM,600014,0,0,1,1,
Payne,Superintendent of Public Instruction,Freda Deskin,DEM,600014,0,0,0,0,
Payne,U.S. Senate,Connie Johnson,DEM,600014,0,0,1,1,
Payne,U.S. Senate,Jim Rogers,DEM,600014,0,0,0,0,
Payne,Superintendent of Public Instruction,John Cox,DEM,600015,1,2,33,36,
Payne,Superintendent of Public Instruction,Freda Deskin,DEM,600015,0,0,25,25,
Payne,U.S. Senate,Connie Johnson,DEM,600015,0,2,48,50,
Payne,U.S. Senate,Jim Rogers,DEM,600015,1,0,12,13,
Payne,Superintendent of Public Instruction,John Cox,DEM,600016,1,9,57,67,
Payne,Superintendent of Public Instruction,Freda Deskin,DEM,600016,0,1,45,46,
Payne,U.S. Senate,Connie Johnson,DEM,600016,0,9,76,85,
Payne,U.S. Senate,Jim Rogers,DEM,600016,1,1,24,26,
Payne,Superintendent of Public Instruction,John Cox,DEM,600101,1,0,18,19,
Payne,Superintendent of Public Instruction,Freda Deskin,DEM,600101,2,0,9,11,
Payne,U.S. Senate,Connie Johnson,DEM,600101,3,0,15,18,
Payne,U.S. Senate,Jim Rogers,DEM,600101,0,0,12,12,
Payne,Superintendent of Public Instruction,John Cox,DEM,600102,4,2,23,29,
Payne,Superintendent of Public Instruction,Freda Deskin,DEM,600102,0,1,7,8,
Payne,U.S. Senate,Connie Johnson,DEM,600102,3,2,22,27,
Payne,U.S. Senate,Jim Rogers,DEM,600102,1,1,8,10,
Payne,Superintendent of Public Instruction,John Cox,DEM,600103,0,0,34,34,
Payne,Superintendent of Public Instruction,Freda Deskin,DEM,600103,0,0,12,12,
Payne,U.S. Senate,Connie Johnson,DEM,600103,0,0,32,32,
Payne,U.S. Senate,Jim Rogers,DEM,600103,0,0,14,14,
Payne,Superintendent of Public Instruction,John Cox,DEM,600104,0,0,28,28,
Payne,Superintendent of Public Instruction,Freda Deskin,DEM,600104,1,0,7,8,
Payne,U.S. Senate,Connie Johnson,DEM,600104,1,0,16,17,
Payne,U.S. Senate,Jim Rogers,DEM,600104,0,0,19,19,
Payne,Superintendent of Public Instruction,John Cox,DEM,600201,1,1,33,35,
Payne,Superintendent of Public Instruction,Freda Deskin,DEM,600201,3,0,13,16,
Payne,U.S. Senate,Connie Johnson,DEM,600201,2,0,16,18,
Payne,U.S. Senate,Jim Rogers,DEM,600201,2,1,30,33,
Payne,Superintendent of Public Instruction,John Cox,DEM,600301,3,1,54,58,
Payne,Superintendent of Public Instruction,Freda Deskin,DEM,600301,0,2,34,36,
Payne,U.S. Senate,Connie Johnson,DEM,600301,3,2,52,57,
Payne,U.S. Senate,Jim Rogers,DEM,600301,0,1,34,35,
Payne,Superintendent of Public Instruction,John Cox,DEM,600401,5,3,53,61,
Payne,Superintendent of Public Instruction,Freda Deskin,DEM,600401,1,1,27,29,
Payne,U.S. Senate,Connie Johnson,DEM,600401,7,4,48,59,
Payne,U.S. Senate,Jim Rogers,DEM,600401,0,0,31,31,
Payne,Superintendent of Public Instruction,John Cox,DEM,600402,0,0,21,21,
Payne,Superintendent of Public Instruction,Freda Deskin,DEM,600402,1,0,15,16,
Payne,U.S. Senate,Connie Johnson,DEM,600402,1,0,22,23,
Payne,U.S. Senate,Jim Rogers,DEM,600402,0,0,13,13,
Payne,Superintendent of Public Instruction,John Cox,DEM,600403,2,3,29,34,
Payne,Superintendent of Public Instruction,Freda Deskin,DEM,600403,0,1,10,11,
Payne,U.S. Senate,Connie Johnson,DEM,600403,1,3,25,29,
Payne,U.S. Senate,Jim Rogers,DEM,600403,1,1,14,16,
Payne,Superintendent of Public Instruction,John Cox,DEM,600404,0,0,1,1,
Payne,Superintendent of Public Instruction,Freda Deskin,DEM,600404,0,0,0,0,
Payne,U.S. Senate,Connie Johnson,DEM,600404,0,0,0,0,
Payne,U.S. Senate,Jim Rogers,DEM,600404,0,0,0,0,
Payne,Superintendent of Public Instruction,John Cox,DEM,600405,3,5,35,43,
Payne,Superintendent of Public Instruction,Freda Deskin,DEM,600405,1,0,13,14,
Payne,U.S. Senate,Connie Johnson,DEM,600405,3,0,17,20,
Payne,U.S. Senate,Jim Rogers,DEM,600405,1,5,31,37,
Payne,Superintendent of Public Instruction,John Cox,DEM,600406,1,1,57,59,
Payne,Superintendent of Public Instruction,Freda Deskin,DEM,600406,0,1,41,42,
Payne,U.S. Senate,Connie Johnson,DEM,600406,1,1,42,44,
Payne,U.S. Senate,Jim Rogers,DEM,600406,0,1,55,56,
Payne,Superintendent of Public Instruction,John Cox,DEM,600407,1,2,24,27,
Payne,Superintendent of Public Instruction,Freda Deskin,DEM,600407,1,2,14,17,
Payne,U.S. Senate,Connie Johnson,DEM,600407,2,3,20,25,
Payne,U.S. Senate,Jim Rogers,DEM,600407,0,1,18,19,
Payne,Superintendent of Public Instruction,John Cox,DEM,600408,1,0,17,18,
Payne,Superintendent of Public Instruction,Freda Deskin,DEM,600408,0,0,7,7,
Payne,U.S. Senate,Connie Johnson,DEM,600408,0,0,17,17,
Payne,U.S. Senate,Jim Rogers,DEM,600408,1,0,7,8,
Payne,Superintendent of Public Instruction,John Cox,DEM,600409,0,0,27,27,
Payne,Superintendent of Public Instruction,Freda Deskin,DEM,600409,1,2,10,13,
Payne,U.S. Senate,Connie Johnson,DEM,600409,1,2,20,23,
Payne,U.S. Senate,Jim Rogers,DEM,600409,0,0,17,17,
Pittsburg,Superintendent of Public Instruction,John Cox,DEM,610001,0,0,10,10,
Pittsburg,Superintendent of Public Instruction,Freda Deskin,DEM,610001,0,1,4,5,
Pittsburg,U.S. Senate,Connie Johnson,DEM,610001,0,0,6,6,
Pittsburg,U.S. Senate,Jim Rogers,DEM,610001,0,1,8,9,
Pittsburg,Superintendent of Public Instruction,John Cox,DEM,610003,0,3,52,55,
Pittsburg,Superintendent of Public Instruction,Freda Deskin,DEM,610003,0,0,17,17,
Pittsburg,U.S. Senate,Connie Johnson,DEM,610003,0,2,31,33,
Pittsburg,U.S. Senate,Jim Rogers,DEM,610003,0,1,35,36,
Pittsburg,Superintendent of Public Instruction,John Cox,DEM,610004,1,6,101,108,
Pittsburg,Superintendent of Public Instruction,Freda Deskin,DEM,610004,0,2,24,26,
Pittsburg,U.S. Senate,Connie Johnson,DEM,610004,0,6,58,64,
Pittsburg,U.S. Senate,Jim Rogers,DEM,610004,1,3,68,72,
Pittsburg,Superintendent of Public Instruction,John Cox,DEM,610005,0,2,51,53,
Pittsburg,Superintendent of Public Instruction,Freda Deskin,DEM,610005,1,1,15,17,
Pittsburg,U.S. Senate,Connie Johnson,DEM,610005,1,0,27,28,
Pittsburg,U.S. Senate,Jim Rogers,DEM,610005,0,3,35,38,
Pittsburg,Superintendent of Public Instruction,John Cox,DEM,610006,0,5,57,62,
Pittsburg,Superintendent of Public Instruction,Freda Deskin,DEM,610006,1,0,18,19,
Pittsburg,U.S. Senate,Connie Johnson,DEM,610006,0,3,38,41,
Pittsburg,U.S. Senate,Jim Rogers,DEM,610006,1,2,37,40,
Pittsburg,Superintendent of Public Instruction,John Cox,DEM,610007,0,0,87,87,
Pittsburg,Superintendent of Public Instruction,Freda Deskin,DEM,610007,0,2,15,17,
Pittsburg,U.S. Senate,Connie Johnson,DEM,610007,0,1,49,50,
Pittsburg,U.S. Senate,Jim Rogers,DEM,610007,0,1,44,45,
Pittsburg,Superintendent of Public Instruction,John Cox,DEM,610008,0,3,30,33,
Pittsburg,Superintendent of Public Instruction,Freda Deskin,DEM,610008,0,0,7,7,
Pittsburg,U.S. Senate,Connie Johnson,DEM,610008,0,2,19,21,
Pittsburg,U.S. Senate,Jim Rogers,DEM,610008,0,1,15,16,
Pittsburg,Superintendent of Public Instruction,John Cox,DEM,610011,4,6,79,89,
Pittsburg,Superintendent of Public Instruction,Freda Deskin,DEM,610011,2,3,28,33,
Pittsburg,U.S. Senate,Connie Johnson,DEM,610011,1,3,52,56,
Pittsburg,U.S. Senate,Jim Rogers,DEM,610011,4,6,55,65,
Pittsburg,Superintendent of Public Instruction,John Cox,DEM,610014,0,9,80,89,
Pittsburg,Superintendent of Public Instruction,Freda Deskin,DEM,610014,0,5,17,22,
Pittsburg,U.S. Senate,Connie Johnson,DEM,610014,0,5,37,42,
Pittsburg,U.S. Senate,Jim Rogers,DEM,610014,0,9,56,65,
Pittsburg,Superintendent of Public Instruction,John Cox,DEM,610015,0,0,11,11,
Pittsburg,Superintendent of Public Instruction,Freda Deskin,DEM,610015,0,0,12,12,
Pittsburg,U.S. Senate,Connie Johnson,DEM,610015,0,0,12,12,
Pittsburg,U.S. Senate,Jim Rogers,DEM,610015,0,0,10,10,
Pittsburg,Superintendent of Public Instruction,John Cox,DEM,610019,0,0,18,18,
Pittsburg,Superintendent of Public Instruction,Freda Deskin,DEM,610019,0,0,8,8,
Pittsburg,U.S. Senate,Connie Johnson,DEM,610019,0,0,4,4,
Pittsburg,U.S. Senate,Jim Rogers,DEM,610019,0,0,22,22,
Pittsburg,Superintendent of Public Instruction,John Cox,DEM,610020,0,1,17,18,
Pittsburg,Superintendent of Public Instruction,Freda Deskin,DEM,610020,0,0,0,0,
Pittsburg,U.S. Senate,Connie Johnson,DEM,610020,0,1,1,2,
Pittsburg,U.S. Senate,Jim Rogers,DEM,610020,0,0,15,15,
Pittsburg,Superintendent of Public Instruction,John Cox,DEM,610021,2,7,49,58,
Pittsburg,Superintendent of Public Instruction,Freda Deskin,DEM,610021,1,2,6,9,
Pittsburg,U.S. Senate,Connie Johnson,DEM,610021,1,6,14,21,
Pittsburg,U.S. Senate,Jim Rogers,DEM,610021,2,2,41,45,
Pittsburg,Superintendent of Public Instruction,John Cox,DEM,610023,0,0,10,10,
Pittsburg,Superintendent of Public Instruction,Freda Deskin,DEM,610023,0,0,4,4,
Pittsburg,U.S. Senate,Connie Johnson,DEM,610023,0,0,4,4,
Pittsburg,U.S. Senate,Jim Rogers,DEM,610023,0,0,10,10,
Pittsburg,Superintendent of Public Instruction,John Cox,DEM,610026,0,1,30,31,
Pittsburg,Superintendent of Public Instruction,Freda Deskin,DEM,610026,0,1,7,8,
Pittsburg,U.S. Senate,Connie Johnson,DEM,610026,0,0,15,15,
Pittsburg,U.S. Senate,Jim Rogers,DEM,610026,0,2,22,24,
Pittsburg,Superintendent of Public Instruction,John Cox,DEM,610027,0,0,26,26,
Pittsburg,Superintendent of Public Instruction,Freda Deskin,DEM,610027,0,1,13,14,
Pittsburg,U.S. Senate,Connie Johnson,DEM,610027,0,1,22,23,
Pittsburg,U.S. Senate,Jim Rogers,DEM,610027,0,0,17,17,
Pittsburg,Superintendent of Public Instruction,John Cox,DEM,610028,0,0,12,12,
Pittsburg,Superintendent of Public Instruction,Freda Deskin,DEM,610028,0,0,5,5,
Pittsburg,U.S. Senate,Connie Johnson,DEM,610028,0,0,4,4,
Pittsburg,U.S. Senate,Jim Rogers,DEM,610028,0,0,13,13,
Pittsburg,Superintendent of Public Instruction,John Cox,DEM,610029,1,2,19,22,
Pittsburg,Superintendent of Public Instruction,Freda Deskin,DEM,610029,0,0,9,9,
Pittsburg,U.S. Senate,Connie Johnson,DEM,610029,1,1,15,17,
Pittsburg,U.S. Senate,Jim Rogers,DEM,610029,0,1,13,14,
Pittsburg,Superintendent of Public Instruction,John Cox,DEM,610030,0,1,20,21,
Pittsburg,Superintendent of Public Instruction,Freda Deskin,DEM,610030,0,0,5,5,
Pittsburg,U.S. Senate,Connie Johnson,DEM,610030,0,0,12,12,
Pittsburg,U.S. Senate,Jim Rogers,DEM,610030,0,1,12,13,
Pittsburg,Superintendent of Public Instruction,John Cox,DEM,610031,0,0,13,13,
Pittsburg,Superintendent of Public Instruction,Freda Deskin,DEM,610031,2,0,8,10,
Pittsburg,U.S. Senate,Connie Johnson,DEM,610031,2,0,4,6,
Pittsburg,U.S. Senate,Jim Rogers,DEM,610031,0,0,17,17,
Pittsburg,Superintendent of Public Instruction,John Cox,DEM,610032,0,14,82,96,
Pittsburg,Superintendent of Public Instruction,Freda Deskin,DEM,610032,3,4,18,25,
Pittsburg,U.S. Senate,Connie Johnson,DEM,610032,2,12,39,53,
Pittsburg,U.S. Senate,Jim Rogers,DEM,610032,1,5,56,62,
Pittsburg,Superintendent of Public Instruction,John Cox,DEM,610033,0,1,30,31,
Pittsburg,Superintendent of Public Instruction,Freda Deskin,DEM,610033,0,0,5,5,
Pittsburg,U.S. Senate,Connie Johnson,DEM,610033,0,0,11,11,
Pittsburg,U.S. Senate,Jim Rogers,DEM,610033,0,1,24,25,
Pittsburg,Superintendent of Public Instruction,John Cox,DEM,610034,3,1,84,88,
Pittsburg,Superintendent of Public Instruction,Freda Deskin,DEM,610034,0,1,13,14,
Pittsburg,U.S. Senate,Connie Johnson,DEM,610034,0,0,35,35,
Pittsburg,U.S. Senate,Jim Rogers,DEM,610034,3,2,59,64,
Pittsburg,Superintendent of Public Instruction,John Cox,DEM,610035,2,1,52,55,
Pittsburg,Superintendent of Public Instruction,Freda Deskin,DEM,610035,1,0,13,14,
Pittsburg,U.S. Senate,Connie Johnson,DEM,610035,1,1,27,29,
Pittsburg,U.S. Senate,Jim Rogers,DEM,610035,2,0,36,38,
Pittsburg,Superintendent of Public Instruction,John Cox,DEM,610036,2,3,16,21,
Pittsburg,Superintendent of Public Instruction,Freda Deskin,DEM,610036,0,1,2,3,
Pittsburg,U.S. Senate,Connie Johnson,DEM,610036,0,1,3,4,
Pittsburg,U.S. Senate,Jim Rogers,DEM,610036,2,3,15,20,
Pittsburg,Superintendent of Public Instruction,John Cox,DEM,610037,2,1,63,66,
Pittsburg,Superintendent of Public Instruction,Freda Deskin,DEM,610037,1,0,17,18,
Pittsburg,U.S. Senate,Connie Johnson,DEM,610037,3,1,23,27,
Pittsburg,U.S. Senate,Jim Rogers,DEM,610037,0,0,54,54,
Pittsburg,Superintendent of Public Instruction,John Cox,DEM,610038,0,0,10,10,
Pittsburg,Superintendent of Public Instruction,Freda Deskin,DEM,610038,0,0,1,1,
Pittsburg,U.S. Senate,Connie Johnson,DEM,610038,0,0,3,3,
Pittsburg,U.S. Senate,Jim Rogers,DEM,610038,0,0,8,8,
Pittsburg,Superintendent of Public Instruction,John Cox,DEM,610039,0,1,48,49,
Pittsburg,Superintendent of Public Instruction,Freda Deskin,DEM,610039,0,0,8,8,
Pittsburg,U.S. Senate,Connie Johnson,DEM,610039,0,1,12,13,
Pittsburg,U.S. Senate,Jim Rogers,DEM,610039,0,0,41,41,
Pittsburg,Superintendent of Public Instruction,John Cox,DEM,610040,2,1,32,35,
Pittsburg,Superintendent of Public Instruction,Freda Deskin,DEM,610040,0,0,7,7,
Pittsburg,U.S. Senate,Connie Johnson,DEM,610040,1,0,11,12,
Pittsburg,U.S. Senate,Jim Rogers,DEM,610040,1,1,27,29,
Pittsburg,Superintendent of Public Instruction,John Cox,DEM,610041,0,5,147,152,
Pittsburg,Superintendent of Public Instruction,Freda Deskin,DEM,610041,0,2,60,62,
Pittsburg,U.S. Senate,Connie Johnson,DEM,610041,0,5,81,86,
Pittsburg,U.S. Senate,Jim Rogers,DEM,610041,0,2,123,125,
Pittsburg,Superintendent of Public Instruction,John Cox,DEM,610042,0,11,54,65,
Pittsburg,Superintendent of Public Instruction,Freda Deskin,DEM,610042,0,1,20,21,
Pittsburg,U.S. Senate,Connie Johnson,DEM,610042,0,8,36,44,
Pittsburg,U.S. Senate,Jim Rogers,DEM,610042,0,4,36,40,
Pittsburg,Superintendent of Public Instruction,John Cox,DEM,610043,0,0,30,30,
Pittsburg,Superintendent of Public Instruction,Freda Deskin,DEM,610043,0,0,6,6,
Pittsburg,U.S. Senate,Connie Johnson,DEM,610043,0,0,14,14,
Pittsburg,U.S. Senate,Jim Rogers,DEM,610043,0,0,19,19,
Pittsburg,Superintendent of Public Instruction,John Cox,DEM,610044,0,0,71,71,
Pittsburg,Superintendent of Public Instruction,Freda Deskin,DEM,610044,0,0,12,12,
Pittsburg,U.S. Senate,Connie Johnson,DEM,610044,0,0,26,26,
Pittsburg,U.S. Senate,Jim Rogers,DEM,610044,0,0,57,57,
Pittsburg,Superintendent of Public Instruction,John Cox,DEM,610045,0,0,4,4,
Pittsburg,Superintendent of Public Instruction,Freda Deskin,DEM,610045,0,0,0,0,
Pittsburg,U.S. Senate,Connie Johnson,DEM,610045,0,0,0,0,
Pittsburg,U.S. Senate,Jim Rogers,DEM,610045,0,0,4,4,
Pittsburg,Superintendent of Public Instruction,John Cox,DEM,610046,0,0,16,16,
Pittsburg,Superintendent of Public Instruction,Freda Deskin,DEM,610046,0,1,3,4,
Pittsburg,U.S. Senate,Connie Johnson,DEM,610046,0,1,11,12,
Pittsburg,U.S. Senate,Jim Rogers,DEM,610046,0,0,8,8,
Pittsburg,Superintendent of Public Instruction,John Cox,DEM,610047,0,5,60,65,
Pittsburg,Superintendent of Public Instruction,Freda Deskin,DEM,610047,0,0,7,7,
Pittsburg,U.S. Senate,Connie Johnson,DEM,610047,0,4,15,19,
Pittsburg,U.S. Senate,Jim Rogers,DEM,610047,0,0,51,51,
Pittsburg,Superintendent of Public Instruction,John Cox,DEM,610048,0,2,5,7,
Pittsburg,Superintendent of Public Instruction,Freda Deskin,DEM,610048,0,0,6,6,
Pittsburg,U.S. Senate,Connie Johnson,DEM,610048,0,0,7,7,
Pittsburg,U.S. Senate,Jim Rogers,DEM,610048,0,2,4,6,
Pittsburg,Superintendent of Public Instruction,John Cox,DEM,610049,0,4,34,38,
Pittsburg,Superintendent of Public Instruction,Freda Deskin,DEM,610049,0,0,6,6,
Pittsburg,U.S. Senate,Connie Johnson,DEM,610049,0,0,8,8,
Pittsburg,U.S. Senate,Jim Rogers,DEM,610049,0,3,30,33,
Pittsburg,Superintendent of Public Instruction,John Cox,DEM,610051,1,0,24,25,
Pittsburg,Superintendent of Public Instruction,Freda Deskin,DEM,610051,0,0,5,5,
Pittsburg,U.S. Senate,Connie Johnson,DEM,610051,0,0,9,9,
Pittsburg,U.S. Senate,Jim Rogers,DEM,610051,1,0,20,21,
Pittsburg,Superintendent of Public Instruction,John Cox,DEM,610052,0,0,2,2,
Pittsburg,Superintendent of Public Instruction,Freda Deskin,DEM,610052,0,0,0,0,
Pittsburg,U.S. Senate,Connie Johnson,DEM,610052,0,0,2,2,
Pittsburg,U.S. Senate,Jim Rogers,DEM,610052,0,0,0,0,
Pittsburg,Superintendent of Public Instruction,John Cox,DEM,610053,0,0,8,8,
Pittsburg,Superintendent of Public Instruction,Freda Deskin,DEM,610053,0,0,1,1,
Pittsburg,U.S. Senate,Connie Johnson,DEM,610053,0,0,2,2,
Pittsburg,U.S. Senate,Jim Rogers,DEM,610053,0,0,6,6,
Pontotoc,Superintendent of Public Instruction,John Cox,DEM,620013,1,6,36,43,
Pontotoc,Superintendent of Public Instruction,Freda Deskin,DEM,620013,3,5,36,44,
Pontotoc,U.S. Senate,Connie Johnson,DEM,620013,3,7,44,54,
Pontotoc,U.S. Senate,Jim Rogers,DEM,620013,1,4,24,29,
Pontotoc,Superintendent of Public Instruction,John Cox,DEM,620016,1,5,27,33,
Pontotoc,Superintendent of Public Instruction,Freda Deskin,DEM,620016,9,3,27,39,
Pontotoc,U.S. Senate,Connie Johnson,DEM,620016,6,3,23,32,
Pontotoc,U.S. Senate,Jim Rogers,DEM,620016,2,5,30,37,
Pontotoc,Superintendent of Public Instruction,John Cox,DEM,620022,0,1,13,14,
Pontotoc,Superintendent of Public Instruction,Freda Deskin,DEM,620022,7,1,20,28,
Pontotoc,U.S. Senate,Connie Johnson,DEM,620022,7,2,21,30,
Pontotoc,U.S. Senate,Jim Rogers,DEM,620022,0,0,12,12,
Pontotoc,Superintendent of Public Instruction,John Cox,DEM,620025,1,2,34,37,
Pontotoc,Superintendent of Public Instruction,Freda Deskin,DEM,620025,2,0,23,25,
Pontotoc,U.S. Senate,Connie Johnson,DEM,620025,2,1,28,31,
Pontotoc,U.S. Senate,Jim Rogers,DEM,620025,1,0,29,30,
Pontotoc,Superintendent of Public Instruction,John Cox,DEM,620031,3,2,14,19,
Pontotoc,Superintendent of Public Instruction,Freda Deskin,DEM,620031,8,0,12,20,
Pontotoc,U.S. Senate,Connie Johnson,DEM,620031,8,1,11,20,
Pontotoc,U.S. Senate,Jim Rogers,DEM,620031,3,1,14,18,
Pontotoc,Superintendent of Public Instruction,John Cox,DEM,620051,3,1,17,21,
Pontotoc,Superintendent of Public Instruction,Freda Deskin,DEM,620051,2,0,13,15,
Pontotoc,U.S. Senate,Connie Johnson,DEM,620051,3,1,9,13,
Pontotoc,U.S. Senate,Jim Rogers,DEM,620051,2,0,21,23,
Pontotoc,Superintendent of Public Instruction,John Cox,DEM,620052,1,1,10,12,
Pontotoc,Superintendent of Public Instruction,Freda Deskin,DEM,620052,1,0,15,16,
Pontotoc,U.S. Senate,Connie Johnson,DEM,620052,0,0,13,13,
Pontotoc,U.S. Senate,Jim Rogers,DEM,620052,2,1,12,15,
Pontotoc,Superintendent of Public Instruction,John Cox,DEM,620053,1,5,27,33,
Pontotoc,Superintendent of Public Instruction,Freda Deskin,DEM,620053,2,3,35,40,
Pontotoc,U.S. Senate,Connie Johnson,DEM,620053,3,5,38,46,
Pontotoc,U.S. Senate,Jim Rogers,DEM,620053,0,3,22,25,
Pontotoc,Superintendent of Public Instruction,John Cox,DEM,620054,0,0,4,4,
Pontotoc,Superintendent of Public Instruction,Freda Deskin,DEM,620054,0,0,2,2,
Pontotoc,U.S. Senate,Connie Johnson,DEM,620054,0,0,3,3,
Pontotoc,U.S. Senate,Jim Rogers,DEM,620054,0,0,3,3,
Pontotoc,Superintendent of Public Instruction,John Cox,DEM,620055,1,2,5,8,
Pontotoc,Superintendent of Public Instruction,Freda Deskin,DEM,620055,1,0,5,6,
Pontotoc,U.S. Senate,Connie Johnson,DEM,620055,2,0,5,7,
Pontotoc,U.S. Senate,Jim Rogers,DEM,620055,0,2,4,6,
Pontotoc,Superintendent of Public Instruction,John Cox,DEM,620056,0,0,15,15,
Pontotoc,Superintendent of Public Instruction,Freda Deskin,DEM,620056,0,1,9,10,
Pontotoc,U.S. Senate,Connie Johnson,DEM,620056,0,1,7,8,
Pontotoc,U.S. Senate,Jim Rogers,DEM,620056,0,0,17,17,
Pontotoc,Superintendent of Public Instruction,John Cox,DEM,620058,1,1,25,27,
Pontotoc,Superintendent of Public Instruction,Freda Deskin,DEM,620058,0,0,13,13,
Pontotoc,U.S. Senate,Connie Johnson,DEM,620058,1,1,9,11,
Pontotoc,U.S. Senate,Jim Rogers,DEM,620058,0,0,27,27,
Pontotoc,Superintendent of Public Instruction,John Cox,DEM,620059,0,3,15,18,
Pontotoc,Superintendent of Public Instruction,Freda Deskin,DEM,620059,0,0,7,7,
Pontotoc,U.S. Senate,Connie Johnson,DEM,620059,0,0,4,4,
Pontotoc,U.S. Senate,Jim Rogers,DEM,620059,0,3,15,18,
Pontotoc,Superintendent of Public Instruction,John Cox,DEM,620060,0,1,21,22,
Pontotoc,Superintendent of Public Instruction,Freda Deskin,DEM,620060,0,1,21,22,
Pontotoc,U.S. Senate,Connie Johnson,DEM,620060,0,2,16,18,
Pontotoc,U.S. Senate,Jim Rogers,DEM,620060,0,0,26,26,
Pontotoc,Superintendent of Public Instruction,John Cox,DEM,620061,0,1,14,15,
Pontotoc,Superintendent of Public Instruction,Freda Deskin,DEM,620061,0,0,1,1,
Pontotoc,U.S. Senate,Connie Johnson,DEM,620061,0,1,3,4,
Pontotoc,U.S. Senate,Jim Rogers,DEM,620061,0,0,11,11,
Pontotoc,Superintendent of Public Instruction,John Cox,DEM,620062,2,0,14,16,
Pontotoc,Superintendent of Public Instruction,Freda Deskin,DEM,620062,1,1,12,14,
Pontotoc,U.S. Senate,Connie Johnson,DEM,620062,2,1,14,17,
Pontotoc,U.S. Senate,Jim Rogers,DEM,620062,1,0,12,13,
Pontotoc,Superintendent of Public Instruction,John Cox,DEM,620063,0,1,19,20,
Pontotoc,Superintendent of Public Instruction,Freda Deskin,DEM,620063,0,1,9,10,
Pontotoc,U.S. Senate,Connie Johnson,DEM,620063,0,2,8,10,
Pontotoc,U.S. Senate,Jim Rogers,DEM,620063,0,0,19,19,
Pontotoc,Superintendent of Public Instruction,John Cox,DEM,620064,1,1,25,27,
Pontotoc,Superintendent of Public Instruction,Freda Deskin,DEM,620064,0,0,6,6,
Pontotoc,U.S. Senate,Connie Johnson,DEM,620064,0,1,12,13,
Pontotoc,U.S. Senate,Jim Rogers,DEM,620064,1,0,19,20,
Pontotoc,Superintendent of Public Instruction,John Cox,DEM,620065,2,0,12,14,
Pontotoc,Superintendent of Public Instruction,Freda Deskin,DEM,620065,0,0,10,10,
Pontotoc,U.S. Senate,Connie Johnson,DEM,620065,0,0,7,7,
Pontotoc,U.S. Senate,Jim Rogers,DEM,620065,2,0,15,17,
Pontotoc,Superintendent of Public Instruction,John Cox,DEM,620066,0,0,20,20,
Pontotoc,Superintendent of Public Instruction,Freda Deskin,DEM,620066,1,1,9,11,
Pontotoc,U.S. Senate,Connie Johnson,DEM,620066,1,0,7,8,
Pontotoc,U.S. Senate,Jim Rogers,DEM,620066,0,1,21,22,
Pontotoc,Superintendent of Public Instruction,John Cox,DEM,620067,0,1,20,21,
Pontotoc,Superintendent of Public Instruction,Freda Deskin,DEM,620067,0,0,11,11,
Pontotoc,U.S. Senate,Connie Johnson,DEM,620067,0,0,10,10,
Pontotoc,U.S. Senate,Jim Rogers,DEM,620067,0,1,21,22,
Pottawatomie,Superintendent of Public Instruction,John Cox,DEM,630001,0,0,15,15,
Pottawatomie,Superintendent of Public Instruction,Freda Deskin,DEM,630001,0,0,7,7,
Pottawatomie,U.S. Senate,Connie Johnson,DEM,630001,0,0,8,8,
Pottawatomie,U.S. Senate,Jim Rogers,DEM,630001,0,0,14,14,
Pottawatomie,U.S. House,Tom Guild,DEM,630001,0,0,14,14,05
Pottawatomie,U.S. House,Al Mcaffrey,DEM,630001,0,0,8,8,05
Pottawatomie,U.S. House,Steve Russell,REP,630001,2,3,12,17,05
Pottawatomie,U.S. House,Patrice Douglas,REP,630001,0,2,2,4,05
Pottawatomie,Superintendent of Public Instruction,John Cox,DEM,630002,0,0,11,11,
Pottawatomie,Superintendent of Public Instruction,Freda Deskin,DEM,630002,3,1,12,16,
Pottawatomie,U.S. Senate,Connie Johnson,DEM,630002,1,0,13,14,
Pottawatomie,U.S. Senate,Jim Rogers,DEM,630002,2,1,10,13,
Pottawatomie,U.S. House,Tom Guild,DEM,630002,1,0,9,10,05
Pottawatomie,U.S. House,Al Mcaffrey,DEM,630002,2,1,14,17,05
Pottawatomie,U.S. House,Steve Russell,REP,630002,0,0,14,14,05
Pottawatomie,U.S. House,Patrice Douglas,REP,630002,0,0,18,18,05
Pottawatomie,Superintendent of Public Instruction,John Cox,DEM,630003,1,3,29,33,
Pottawatomie,Superintendent of Public Instruction,Freda Deskin,DEM,630003,3,1,22,26,
Pottawatomie,U.S. Senate,Connie Johnson,DEM,630003,4,4,34,42,
Pottawatomie,U.S. Senate,Jim Rogers,DEM,630003,0,0,16,16,
Pottawatomie,U.S. House,Tom Guild,DEM,630003,2,3,24,29,05
Pottawatomie,U.S. House,Al Mcaffrey,DEM,630003,2,1,27,30,05
Pottawatomie,U.S. House,Steve Russell,REP,630003,3,1,26,30,05
Pottawatomie,U.S. House,Patrice Douglas,REP,630003,1,1,25,27,05
Pottawatomie,Superintendent of Public Instruction,John Cox,DEM,630006,5,1,22,28,
Pottawatomie,Superintendent of Public Instruction,Freda Deskin,DEM,630006,2,0,16,18,
Pottawatomie,U.S. Senate,Connie Johnson,DEM,630006,7,1,24,32,
Pottawatomie,U.S. Senate,Jim Rogers,DEM,630006,1,0,14,15,
Pottawatomie,U.S. House,Tom Guild,DEM,630006,5,0,17,22,05
Pottawatomie,U.S. House,Al Mcaffrey,DEM,630006,3,1,21,25,05
Pottawatomie,U.S. House,Steve Russell,REP,630006,2,1,30,33,05
Pottawatomie,U.S. House,Patrice Douglas,REP,630006,2,0,11,13,05
Pottawatomie,Superintendent of Public Instruction,John Cox,DEM,630007,1,1,25,27,
Pottawatomie,Superintendent of Public Instruction,Freda Deskin,DEM,630007,3,1,33,37,
Pottawatomie,U.S. Senate,Connie Johnson,DEM,630007,2,2,36,40,
Pottawatomie,U.S. Senate,Jim Rogers,DEM,630007,2,0,20,22,
Pottawatomie,U.S. House,Tom Guild,DEM,630007,2,1,26,29,05
Pottawatomie,U.S. House,Al Mcaffrey,DEM,630007,2,1,32,35,05
Pottawatomie,U.S. House,Steve Russell,REP,630007,2,1,46,49,05
Pottawatomie,U.S. House,Patrice Douglas,REP,630007,0,0,24,24,05
Pottawatomie,Superintendent of Public Instruction,John Cox,DEM,630009,1,2,32,35,
Pottawatomie,Superintendent of Public Instruction,Freda Deskin,DEM,630009,1,1,23,25,
Pottawatomie,U.S. Senate,Connie Johnson,DEM,630009,2,1,33,36,
Pottawatomie,U.S. Senate,Jim Rogers,DEM,630009,0,2,24,26,
Pottawatomie,U.S. House,Tom Guild,DEM,630009,2,1,35,38,05
Pottawatomie,U.S. House,Al Mcaffrey,DEM,630009,0,1,21,22,05
Pottawatomie,U.S. House,Steve Russell,REP,630009,1,5,47,53,05
Pottawatomie,U.S. House,Patrice Douglas,REP,630009,4,7,20,31,05
Pottawatomie,Superintendent of Public Instruction,John Cox,DEM,630011,2,3,55,60,
Pottawatomie,Superintendent of Public Instruction,Freda Deskin,DEM,630011,2,2,40,44,
Pottawatomie,U.S. Senate,Connie Johnson,DEM,630011,3,4,69,76,
Pottawatomie,U.S. Senate,Jim Rogers,DEM,630011,1,1,27,29,
Pottawatomie,U.S. House,Tom Guild,DEM,630011,2,3,47,52,05
Pottawatomie,U.S. House,Al Mcaffrey,DEM,630011,2,2,48,52,05
Pottawatomie,U.S. House,Steve Russell,REP,630011,5,3,103,111,05
Pottawatomie,U.S. House,Patrice Douglas,REP,630011,2,0,66,68,05
Pottawatomie,Superintendent of Public Instruction,John Cox,DEM,630012,1,4,40,45,
Pottawatomie,Superintendent of Public Instruction,Freda Deskin,DEM,630012,2,0,22,24,
Pottawatomie,U.S. Senate,Connie Johnson,DEM,630012,2,2,43,47,
Pottawatomie,U.S. Senate,Jim Rogers,DEM,630012,1,2,16,19,
Pottawatomie,U.S. House,Tom Guild,DEM,630012,1,1,27,29,05
Pottawatomie,U.S. House,Al Mcaffrey,DEM,630012,2,3,33,38,05
Pottawatomie,U.S. House,Steve Russell,REP,630012,1,5,38,44,05
Pottawatomie,U.S. House,Patrice Douglas,REP,630012,3,1,39,43,05
Pottawatomie,Superintendent of Public Instruction,John Cox,DEM,630013,3,0,53,56,
Pottawatomie,Superintendent of Public Instruction,Freda Deskin,DEM,630013,2,2,40,44,
Pottawatomie,U.S. Senate,Connie Johnson,DEM,630013,1,2,60,63,
Pottawatomie,U.S. Senate,Jim Rogers,DEM,630013,4,0,30,34,
Pottawatomie,U.S. House,Tom Guild,DEM,630013,3,1,48,52,05
Pottawatomie,U.S. House,Al Mcaffrey,DEM,630013,2,1,42,45,05
Pottawatomie,U.S. House,Steve Russell,REP,630013,3,5,79,87,05
Pottawatomie,U.S. House,Patrice Douglas,REP,630013,0,4,51,55,05
Pottawatomie,Superintendent of Public Instruction,John Cox,DEM,630015,1,2,36,39,
Pottawatomie,Superintendent of Public Instruction,Freda Deskin,DEM,630015,1,0,34,35,
Pottawatomie,U.S. Senate,Connie Johnson,DEM,630015,1,1,45,47,
Pottawatomie,U.S. Senate,Jim Rogers,DEM,630015,1,1,24,26,
Pottawatomie,U.S. House,Tom Guild,DEM,630015,1,1,35,37,05
Pottawatomie,U.S. House,Al Mcaffrey,DEM,630015,1,1,34,36,05
Pottawatomie,U.S. House,Steve Russell,REP,630015,1,5,60,66,05
Pottawatomie,U.S. House,Patrice Douglas,REP,630015,0,3,31,34,05
Pottawatomie,Superintendent of Public Instruction,John Cox,DEM,630018,0,2,34,36,
Pottawatomie,Superintendent of Public Instruction,Freda Deskin,DEM,630018,1,1,34,36,
Pottawatomie,U.S. Senate,Connie Johnson,DEM,630018,1,2,43,46,
Pottawatomie,U.S. Senate,Jim Rogers,DEM,630018,0,1,24,25,
Pottawatomie,U.S. House,Tom Guild,DEM,630018,0,0,41,41,05
Pottawatomie,U.S. House,Al Mcaffrey,DEM,630018,1,3,27,31,05
Pottawatomie,U.S. House,Steve Russell,REP,630018,1,2,48,51,05
Pottawatomie,U.S. House,Patrice Douglas,REP,630018,1,2,42,45,05
Pottawatomie,Superintendent of Public Instruction,John Cox,DEM,630021,0,0,14,14,
Pottawatomie,Superintendent of Public Instruction,Freda Deskin,DEM,630021,0,0,10,10,
Pottawatomie,U.S. Senate,Connie Johnson,DEM,630021,0,0,12,12,
Pottawatomie,U.S. Senate,Jim Rogers,DEM,630021,0,0,12,12,
Pottawatomie,U.S. House,Tom Guild,DEM,630021,0,0,16,16,05
Pottawatomie,U.S. House,Al Mcaffrey,DEM,630021,0,0,8,8,05
Pottawatomie,U.S. House,Steve Russell,REP,630021,2,1,37,40,05
Pottawatomie,U.S. House,Patrice Douglas,REP,630021,0,0,20,20,05
Pottawatomie,Superintendent of Public Instruction,John Cox,DEM,630022,3,3,48,54,
Pottawatomie,Superintendent of Public Instruction,Freda Deskin,DEM,630022,2,0,23,25,
Pottawatomie,U.S. Senate,Connie Johnson,DEM,630022,0,1,32,33,
Pottawatomie,U.S. Senate,Jim Rogers,DEM,630022,5,2,37,44,
Pottawatomie,U.S. House,Tom Guild,DEM,630022,2,1,44,47,05
Pottawatomie,U.S. House,Al Mcaffrey,DEM,630022,3,2,27,32,05
Pottawatomie,U.S. House,Steve Russell,REP,630022,3,0,88,91,05
Pottawatomie,U.S. House,Patrice Douglas,REP,630022,0,2,38,40,05
Pottawatomie,Superintendent of Public Instruction,John Cox,DEM,630024,2,1,42,45,
Pottawatomie,Superintendent of Public Instruction,Freda Deskin,DEM,630024,1,0,23,24,
Pottawatomie,U.S. Senate,Connie Johnson,DEM,630024,1,0,33,34,
Pottawatomie,U.S. Senate,Jim Rogers,DEM,630024,2,1,32,35,
Pottawatomie,U.S. House,Tom Guild,DEM,630024,1,1,41,43,05
Pottawatomie,U.S. House,Al Mcaffrey,DEM,630024,2,0,23,25,05
Pottawatomie,U.S. House,Steve Russell,REP,630024,3,0,61,64,05
Pottawatomie,U.S. House,Patrice Douglas,REP,630024,3,0,44,47,05
Pottawatomie,Superintendent of Public Instruction,John Cox,DEM,630025,0,0,20,20,
Pottawatomie,Superintendent of Public Instruction,Freda Deskin,DEM,630025,2,0,14,16,
Pottawatomie,U.S. Senate,Connie Johnson,DEM,630025,2,0,16,18,
Pottawatomie,U.S. Senate,Jim Rogers,DEM,630025,0,0,16,16,
Pottawatomie,U.S. House,Tom Guild,DEM,630025,0,0,17,17,05
Pottawatomie,U.S. House,Al Mcaffrey,DEM,630025,2,0,18,20,05
Pottawatomie,U.S. House,Steve Russell,REP,630025,2,0,34,36,05
Pottawatomie,U.S. House,Patrice Douglas,REP,630025,1,0,18,19,05
Pottawatomie,Superintendent of Public Instruction,John Cox,DEM,630026,2,0,59,61,
Pottawatomie,Superintendent of Public Instruction,Freda Deskin,DEM,630026,1,2,14,17,
Pottawatomie,U.S. Senate,Connie Johnson,DEM,630026,1,2,35,38,
Pottawatomie,U.S. Senate,Jim Rogers,DEM,630026,2,0,35,37,
Pottawatomie,U.S. House,Tom Guild,DEM,630026,1,1,45,47,05
Pottawatomie,U.S. House,Al Mcaffrey,DEM,630026,2,1,24,27,05
Pottawatomie,U.S. House,Steve Russell,REP,630026,4,5,66,75,05
Pottawatomie,U.S. House,Patrice Douglas,REP,630026,0,0,30,30,05
Pottawatomie,Superintendent of Public Instruction,John Cox,DEM,630027,0,1,16,17,
Pottawatomie,Superintendent of Public Instruction,Freda Deskin,DEM,630027,0,0,22,22,
Pottawatomie,U.S. Senate,Connie Johnson,DEM,630027,0,1,27,28,
Pottawatomie,U.S. Senate,Jim Rogers,DEM,630027,0,0,10,10,
Pottawatomie,U.S. House,Tom Guild,DEM,630027,0,1,12,13,05
Pottawatomie,U.S. House,Al Mcaffrey,DEM,630027,0,0,26,26,05
Pottawatomie,U.S. House,Steve Russell,REP,630027,0,1,48,49,05
Pottawatomie,U.S. House,Patrice Douglas,REP,630027,0,0,23,23,05
Pottawatomie,Superintendent of Public Instruction,John Cox,DEM,630029,1,4,73,78,
Pottawatomie,Superintendent of Public Instruction,Freda Deskin,DEM,630029,1,0,32,33,
Pottawatomie,U.S. Senate,Connie Johnson,DEM,630029,0,2,53,55,
Pottawatomie,U.S. Senate,Jim Rogers,DEM,630029,2,2,48,52,
Pottawatomie,U.S. House,Tom Guild,DEM,630029,2,2,62,66,05
Pottawatomie,U.S. House,Al Mcaffrey,DEM,630029,0,2,41,43,05
Pottawatomie,U.S. House,Steve Russell,REP,630029,0,3,77,80,05
Pottawatomie,U.S. House,Patrice Douglas,REP,630029,2,2,36,40,05
Pottawatomie,Superintendent of Public Instruction,John Cox,DEM,630030,6,2,85,93,
Pottawatomie,Superintendent of Public Instruction,Freda Deskin,DEM,630030,3,0,67,70,
Pottawatomie,U.S. Senate,Connie Johnson,DEM,630030,7,2,97,106,
Pottawatomie,U.S. Senate,Jim Rogers,DEM,630030,2,0,50,52,
Pottawatomie,U.S. House,Tom Guild,DEM,630030,4,0,103,107,05
Pottawatomie,U.S. House,Al Mcaffrey,DEM,630030,5,2,47,54,05
Pottawatomie,U.S. House,Steve Russell,REP,630030,3,0,101,104,05
Pottawatomie,U.S. House,Patrice Douglas,REP,630030,0,5,47,52,05
Pottawatomie,Superintendent of Public Instruction,John Cox,DEM,630031,2,5,61,68,
Pottawatomie,Superintendent of Public Instruction,Freda Deskin,DEM,630031,1,3,51,55,
Pottawatomie,U.S. Senate,Connie Johnson,DEM,630031,1,5,61,67,
Pottawatomie,U.S. Senate,Jim Rogers,DEM,630031,2,3,50,55,
Pottawatomie,U.S. House,Tom Guild,DEM,630031,1,6,61,68,05
Pottawatomie,U.S. House,Al Mcaffrey,DEM,630031,2,2,50,54,05
Pottawatomie,U.S. House,Steve Russell,REP,630031,5,3,86,94,05
Pottawatomie,U.S. House,Patrice Douglas,REP,630031,4,0,50,54,05
Pottawatomie,Superintendent of Public Instruction,John Cox,DEM,630033,0,1,24,25,
Pottawatomie,Superintendent of Public Instruction,Freda Deskin,DEM,630033,2,0,14,16,
Pottawatomie,U.S. Senate,Connie Johnson,DEM,630033,2,1,17,20,
Pottawatomie,U.S. Senate,Jim Rogers,DEM,630033,0,0,21,21,
Pottawatomie,U.S. House,Tom Guild,DEM,630033,2,1,28,31,05
Pottawatomie,U.S. House,Al Mcaffrey,DEM,630033,0,0,10,10,05
Pottawatomie,U.S. House,Steve Russell,REP,630033,1,0,12,13,05
Pottawatomie,U.S. House,Patrice Douglas,REP,630033,0,0,4,4,05
Pottawatomie,Superintendent of Public Instruction,John Cox,DEM,630037,0,0,11,11,
Pottawatomie,Superintendent of Public Instruction,Freda Deskin,DEM,630037,1,0,10,11,
Pottawatomie,U.S. Senate,Connie Johnson,DEM,630037,1,0,11,12,
Pottawatomie,U.S. Senate,Jim Rogers,DEM,630037,0,0,10,10,
Pottawatomie,U.S. House,Tom Guild,DEM,630037,0,0,9,9,05
Pottawatomie,U.S. House,Al Mcaffrey,DEM,630037,1,0,12,13,05
Pottawatomie,U.S. House,Steve Russell,REP,630037,0,0,24,24,05
Pottawatomie,U.S. House,Patrice Douglas,REP,630037,2,0,10,12,05
Pottawatomie,Superintendent of Public Instruction,John Cox,DEM,630038,1,0,22,23,
Pottawatomie,Superintendent of Public Instruction,Freda Deskin,DEM,630038,0,0,12,12,
Pottawatomie,U.S. Senate,Connie Johnson,DEM,630038,1,0,25,26,
Pottawatomie,U.S. Senate,Jim Rogers,DEM,630038,0,0,9,9,
Pottawatomie,U.S. House,Tom Guild,DEM,630038,0,0,24,24,05
Pottawatomie,U.S. House,Al Mcaffrey,DEM,630038,1,0,9,10,05
Pottawatomie,U.S. House,Steve Russell,REP,630038,1,0,9,10,05
Pottawatomie,U.S. House,Patrice Douglas,REP,630038,0,0,15,15,05
Pottawatomie,Superintendent of Public Instruction,John Cox,DEM,630040,1,0,26,27,
Pottawatomie,Superintendent of Public Instruction,Freda Deskin,DEM,630040,2,0,6,8,
Pottawatomie,U.S. Senate,Connie Johnson,DEM,630040,2,0,6,8,
Pottawatomie,U.S. Senate,Jim Rogers,DEM,630040,1,0,26,27,
Pottawatomie,U.S. House,Tom Guild,DEM,630040,0,0,20,20,05
Pottawatomie,U.S. House,Al Mcaffrey,DEM,630040,3,0,12,15,05
Pottawatomie,U.S. House,Steve Russell,REP,630040,3,0,20,23,05
Pottawatomie,U.S. House,Patrice Douglas,REP,630040,0,0,8,8,05
Pottawatomie,Superintendent of Public Instruction,John Cox,DEM,630041,0,0,39,39,
Pottawatomie,Superintendent of Public Instruction,Freda Deskin,DEM,630041,0,0,26,26,
Pottawatomie,U.S. Senate,Connie Johnson,DEM,630041,0,0,23,23,
Pottawatomie,U.S. Senate,Jim Rogers,DEM,630041,0,0,38,38,
Pottawatomie,U.S. House,Tom Guild,DEM,630041,0,0,43,43,05
Pottawatomie,U.S. House,Al Mcaffrey,DEM,630041,0,0,19,19,05
Pottawatomie,U.S. House,Steve Russell,REP,630041,0,0,31,31,05
Pottawatomie,U.S. House,Patrice Douglas,REP,630041,1,1,26,28,05
Pottawatomie,Superintendent of Public Instruction,John Cox,DEM,630042,0,0,18,18,
Pottawatomie,Superintendent of Public Instruction,Freda Deskin,DEM,630042,1,0,20,21,
Pottawatomie,U.S. Senate,Connie Johnson,DEM,630042,0,0,10,10,
Pottawatomie,U.S. Senate,Jim Rogers,DEM,630042,1,0,28,29,
Pottawatomie,U.S. House,Tom Guild,DEM,630042,1,0,17,18,05
Pottawatomie,U.S. House,Al Mcaffrey,DEM,630042,0,0,21,21,05
Pottawatomie,U.S. House,Steve Russell,REP,630042,0,0,26,26,05
Pottawatomie,U.S. House,Patrice Douglas,REP,630042,2,0,5,7,05
Pushmataha,Superintendent of Public Instruction,John Cox,DEM,640001,1,3,21,25,
Pushmataha,Superintendent of Public Instruction,Freda Deskin,DEM,640001,1,0,4,5,
Pushmataha,U.S. Senate,Connie Johnson,DEM,640001,1,2,7,10,
Pushmataha,U.S. Senate,Jim Rogers,DEM,640001,1,0,15,16,
Pushmataha,Superintendent of Public Instruction,John Cox,DEM,640002,0,3,43,46,
Pushmataha,Superintendent of Public Instruction,Freda Deskin,DEM,640002,0,1,20,21,
Pushmataha,U.S. Senate,Connie Johnson,DEM,640002,0,1,27,28,
Pushmataha,U.S. Senate,Jim Rogers,DEM,640002,0,2,33,35,
Pushmataha,Superintendent of Public Instruction,John Cox,DEM,640003,0,1,12,13,
Pushmataha,Superintendent of Public Instruction,Freda Deskin,DEM,640003,1,1,7,9,
Pushmataha,U.S. Senate,Connie Johnson,DEM,640003,1,1,8,10,
Pushmataha,U.S. Senate,Jim Rogers,DEM,640003,0,1,9,10,
Pushmataha,Superintendent of Public Instruction,John Cox,DEM,640004,1,3,26,30,
Pushmataha,Superintendent of Public Instruction,Freda Deskin,DEM,640004,0,4,6,10,
Pushmataha,U.S. Senate,Connie Johnson,DEM,640004,0,3,7,10,
Pushmataha,U.S. Senate,Jim Rogers,DEM,640004,0,4,23,27,
Pushmataha,Superintendent of Public Instruction,John Cox,DEM,640005,0,0,12,12,
Pushmataha,Superintendent of Public Instruction,Freda Deskin,DEM,640005,0,0,3,3,
Pushmataha,U.S. Senate,Connie Johnson,DEM,640005,0,0,4,4,
Pushmataha,U.S. Senate,Jim Rogers,DEM,640005,0,0,11,11,
Pushmataha,Superintendent of Public Instruction,John Cox,DEM,640007,0,1,18,19,
Pushmataha,Superintendent of Public Instruction,Freda Deskin,DEM,640007,0,1,1,2,
Pushmataha,U.S. Senate,Connie Johnson,DEM,640007,0,0,2,2,
Pushmataha,U.S. Senate,Jim Rogers,DEM,640007,0,2,14,16,
Pushmataha,Superintendent of Public Instruction,John Cox,DEM,640008,0,0,8,8,
Pushmataha,Superintendent of Public Instruction,Freda Deskin,DEM,640008,0,0,2,2,
Pushmataha,U.S. Senate,Connie Johnson,DEM,640008,0,0,1,1,
Pushmataha,U.S. Senate,Jim Rogers,DEM,640008,0,0,9,9,
Pushmataha,Superintendent of Public Instruction,John Cox,DEM,640009,3,0,95,98,
Pushmataha,Superintendent of Public Instruction,Freda Deskin,DEM,640009,2,0,27,29,
Pushmataha,U.S. Senate,Connie Johnson,DEM,640009,1,0,22,23,
Pushmataha,U.S. Senate,Jim Rogers,DEM,640009,3,0,88,91,
Pushmataha,Superintendent of Public Instruction,John Cox,DEM,640010,0,0,13,13,
Pushmataha,Superintendent of Public Instruction,Freda Deskin,DEM,640010,0,0,1,1,
Pushmataha,U.S. Senate,Connie Johnson,DEM,640010,0,0,8,8,
Pushmataha,U.S. Senate,Jim Rogers,DEM,640010,0,0,5,5,
Pushmataha,Superintendent of Public Instruction,John Cox,DEM,640011,0,0,49,49,
Pushmataha,Superintendent of Public Instruction,Freda Deskin,DEM,640011,2,1,8,11,
Pushmataha,U.S. Senate,Connie Johnson,DEM,640011,2,0,13,15,
Pushmataha,U.S. Senate,Jim Rogers,DEM,640011,0,1,37,38,
Pushmataha,Superintendent of Public Instruction,John Cox,DEM,640012,0,0,10,10,
Pushmataha,Superintendent of Public Instruction,Freda Deskin,DEM,640012,0,0,1,1,
Pushmataha,U.S. Senate,Connie Johnson,DEM,640012,0,0,6,6,
Pushmataha,U.S. Senate,Jim Rogers,DEM,640012,0,0,5,5,
Pushmataha,Superintendent of Public Instruction,John Cox,DEM,640013,0,0,8,8,
Pushmataha,Superintendent of Public Instruction,Freda Deskin,DEM,640013,0,0,5,5,
Pushmataha,U.S. Senate,Connie Johnson,DEM,640013,0,0,4,4,
Pushmataha,U.S. Senate,Jim Rogers,DEM,640013,0,0,8,8,
Pushmataha,Superintendent of Public Instruction,John Cox,DEM,640014,0,0,5,5,
Pushmataha,Superintendent of Public Instruction,Freda Deskin,DEM,640014,0,1,3,4,
Pushmataha,U.S. Senate,Connie Johnson,DEM,640014,0,1,2,3,
Pushmataha,U.S. Senate,Jim Rogers,DEM,640014,0,0,6,6,
Pushmataha,Superintendent of Public Instruction,John Cox,DEM,640015,6,0,178,184,
Pushmataha,Superintendent of Public Instruction,Freda Deskin,DEM,640015,2,1,66,69,
Pushmataha,U.S. Senate,Connie Johnson,DEM,640015,2,1,75,78,
Pushmataha,U.S. Senate,Jim Rogers,DEM,640015,6,0,156,162,
Pushmataha,Superintendent of Public Instruction,John Cox,DEM,640016,1,0,38,39,
Pushmataha,Superintendent of Public Instruction,Freda Deskin,DEM,640016,0,0,11,11,
Pushmataha,U.S. Senate,Connie Johnson,DEM,640016,0,0,12,12,
Pushmataha,U.S. Senate,Jim Rogers,DEM,640016,1,0,36,37,
Pushmataha,Superintendent of Public Instruction,John Cox,DEM,640017,1,0,50,51,
Pushmataha,Superintendent of Public Instruction,Freda Deskin,DEM,640017,0,0,32,32,
Pushmataha,U.S. Senate,Connie Johnson,DEM,640017,0,0,38,38,
Pushmataha,U.S. Senate,Jim Rogers,DEM,640017,1,0,46,47,
Roger Mills,Superintendent of Public Instruction,John Cox,DEM,650101,1,0,10,11,
Roger Mills,Superintendent of Public Instruction,Freda Deskin,DEM,650101,0,0,1,1,
Roger Mills,U.S. Senate,Connie Johnson,DEM,650101,1,0,5,6,
Roger Mills,U.S. Senate,Jim Rogers,DEM,650101,0,0,6,6,
Roger Mills,Superintendent of Public Instruction,John Cox,DEM,650102,1,2,7,10,
Roger Mills,Superintendent of Public Instruction,Freda Deskin,DEM,650102,0,2,4,6,
Roger Mills,U.S. Senate,Connie Johnson,DEM,650102,0,3,5,8,
Roger Mills,U.S. Senate,Jim Rogers,DEM,650102,1,1,4,6,
Roger Mills,Superintendent of Public Instruction,John Cox,DEM,650103,2,2,17,21,
Roger Mills,Superintendent of Public Instruction,Freda Deskin,DEM,650103,0,1,5,6,
Roger Mills,U.S. Senate,Connie Johnson,DEM,650103,1,1,11,13,
Roger Mills,U.S. Senate,Jim Rogers,DEM,650103,1,2,10,13,
Roger Mills,Superintendent of Public Instruction,John Cox,DEM,650201,1,3,14,18,
Roger Mills,Superintendent of Public Instruction,Freda Deskin,DEM,650201,0,0,8,8,
Roger Mills,U.S. Senate,Connie Johnson,DEM,650201,0,0,12,12,
Roger Mills,U.S. Senate,Jim Rogers,DEM,650201,1,3,10,14,
Roger Mills,Superintendent of Public Instruction,John Cox,DEM,650202,0,7,9,16,
Roger Mills,Superintendent of Public Instruction,Freda Deskin,DEM,650202,1,0,1,2,
Roger Mills,U.S. Senate,Connie Johnson,DEM,650202,0,3,3,6,
Roger Mills,U.S. Senate,Jim Rogers,DEM,650202,1,4,7,12,
Roger Mills,Superintendent of Public Instruction,John Cox,DEM,650203,0,1,8,9,
Roger Mills,Superintendent of Public Instruction,Freda Deskin,DEM,650203,1,0,2,3,
Roger Mills,U.S. Senate,Connie Johnson,DEM,650203,0,1,4,5,
Roger Mills,U.S. Senate,Jim Rogers,DEM,650203,1,0,6,7,
Roger Mills,Superintendent of Public Instruction,John Cox,DEM,650301,0,0,3,3,
Roger Mills,Superintendent of Public Instruction,Freda Deskin,DEM,650301,0,0,1,1,
Roger Mills,U.S. Senate,Connie Johnson,DEM,650301,0,0,2,2,
Roger Mills,U.S. Senate,Jim Rogers,DEM,650301,0,0,2,2,
Roger Mills,Superintendent of Public Instruction,John Cox,DEM,650302,1,1,8,10,
Roger Mills,Superintendent of Public Instruction,Freda Deskin,DEM,650302,0,0,0,0,
Roger Mills,U.S. Senate,Connie Johnson,DEM,650302,1,0,4,5,
Roger Mills,U.S. Senate,Jim Rogers,DEM,650302,0,1,4,5,
Roger Mills,Superintendent of Public Instruction,John Cox,DEM,650303,0,3,7,10,
Roger Mills,Superintendent of Public Instruction,Freda Deskin,DEM,650303,0,0,4,4,
Roger Mills,U.S. Senate,Connie Johnson,DEM,650303,0,1,5,6,
Roger Mills,U.S. Senate,Jim Rogers,DEM,650303,0,2,5,7,
Rogers,Superintendent of Public Instruction,John Cox,DEM,660001,5,1,56,62,
Rogers,Superintendent of Public Instruction,Freda Deskin,DEM,660001,3,1,12,16,
Rogers,U.S. Senate,Connie Johnson,DEM,660001,4,2,38,44,
Rogers,U.S. Senate,Jim Rogers,DEM,660001,4,0,28,32,
Rogers,Superintendent of Public Instruction,John Cox,DEM,660002,1,6,17,24,
Rogers,Superintendent of Public Instruction,Freda Deskin,DEM,660002,0,0,6,6,
Rogers,U.S. Senate,Connie Johnson,DEM,660002,1,4,12,17,
Rogers,U.S. Senate,Jim Rogers,DEM,660002,0,2,11,13,
Rogers,Superintendent of Public Instruction,John Cox,DEM,660003,1,3,25,29,
Rogers,Superintendent of Public Instruction,Freda Deskin,DEM,660003,0,1,4,5,
Rogers,U.S. Senate,Connie Johnson,DEM,660003,0,0,13,13,
Rogers,U.S. Senate,Jim Rogers,DEM,660003,1,4,14,19,
Rogers,Superintendent of Public Instruction,John Cox,DEM,660004,3,2,57,62,
Rogers,Superintendent of Public Instruction,Freda Deskin,DEM,660004,1,0,12,13,
Rogers,U.S. Senate,Connie Johnson,DEM,660004,3,1,27,31,
Rogers,U.S. Senate,Jim Rogers,DEM,660004,1,1,41,43,
Rogers,Superintendent of Public Instruction,John Cox,DEM,660005,0,1,25,26,
Rogers,Superintendent of Public Instruction,Freda Deskin,DEM,660005,0,0,4,4,
Rogers,U.S. Senate,Connie Johnson,DEM,660005,0,1,17,18,
Rogers,U.S. Senate,Jim Rogers,DEM,660005,0,0,12,12,
Rogers,Superintendent of Public Instruction,John Cox,DEM,660006,1,0,11,12,
Rogers,Superintendent of Public Instruction,Freda Deskin,DEM,660006,1,0,7,8,
Rogers,U.S. Senate,Connie Johnson,DEM,660006,0,0,14,14,
Rogers,U.S. Senate,Jim Rogers,DEM,660006,2,0,4,6,
Rogers,Superintendent of Public Instruction,John Cox,DEM,660007,0,2,40,42,
Rogers,Superintendent of Public Instruction,Freda Deskin,DEM,660007,0,2,3,5,
Rogers,U.S. Senate,Connie Johnson,DEM,660007,0,2,20,22,
Rogers,U.S. Senate,Jim Rogers,DEM,660007,0,2,23,25,
Rogers,Superintendent of Public Instruction,John Cox,DEM,660008,7,3,36,46,
Rogers,Superintendent of Public Instruction,Freda Deskin,DEM,660008,2,0,10,12,
Rogers,U.S. Senate,Connie Johnson,DEM,660008,5,3,27,35,
Rogers,U.S. Senate,Jim Rogers,DEM,660008,4,0,17,21,
Rogers,Superintendent of Public Instruction,John Cox,DEM,660009,0,0,20,20,
Rogers,Superintendent of Public Instruction,Freda Deskin,DEM,660009,0,0,4,4,
Rogers,U.S. Senate,Connie Johnson,DEM,660009,0,0,10,10,
Rogers,U.S. Senate,Jim Rogers,DEM,660009,0,0,13,13,
Rogers,Superintendent of Public Instruction,John Cox,DEM,660010,4,0,26,30,
Rogers,Superintendent of Public Instruction,Freda Deskin,DEM,660010,2,0,11,13,
Rogers,U.S. Senate,Connie Johnson,DEM,660010,6,0,29,35,
Rogers,U.S. Senate,Jim Rogers,DEM,660010,0,0,9,9,
Rogers,Superintendent of Public Instruction,John Cox,DEM,660011,0,0,62,62,
Rogers,Superintendent of Public Instruction,Freda Deskin,DEM,660011,0,0,14,14,
Rogers,U.S. Senate,Connie Johnson,DEM,660011,0,0,34,34,
Rogers,U.S. Senate,Jim Rogers,DEM,660011,0,0,44,44,
Rogers,Superintendent of Public Instruction,John Cox,DEM,660012,0,0,21,21,
Rogers,Superintendent of Public Instruction,Freda Deskin,DEM,660012,0,0,5,5,
Rogers,U.S. Senate,Connie Johnson,DEM,660012,0,0,5,5,
Rogers,U.S. Senate,Jim Rogers,DEM,660012,0,0,21,21,
Rogers,Superintendent of Public Instruction,John Cox,DEM,660013,0,2,27,29,
Rogers,Superintendent of Public Instruction,Freda Deskin,DEM,660013,1,1,7,9,
Rogers,U.S. Senate,Connie Johnson,DEM,660013,1,3,15,19,
Rogers,U.S. Senate,Jim Rogers,DEM,660013,0,0,18,18,
Rogers,Superintendent of Public Instruction,John Cox,DEM,660014,0,1,22,23,
Rogers,Superintendent of Public Instruction,Freda Deskin,DEM,660014,1,0,5,6,
Rogers,U.S. Senate,Connie Johnson,DEM,660014,0,1,17,18,
Rogers,U.S. Senate,Jim Rogers,DEM,660014,1,0,9,10,
Rogers,Superintendent of Public Instruction,John Cox,DEM,660015,0,0,46,46,
Rogers,Superintendent of Public Instruction,Freda Deskin,DEM,660015,1,0,12,13,
Rogers,U.S. Senate,Connie Johnson,DEM,660015,1,0,33,34,
Rogers,U.S. Senate,Jim Rogers,DEM,660015,0,0,25,25,
Rogers,Superintendent of Public Instruction,John Cox,DEM,660017,1,1,24,26,
Rogers,Superintendent of Public Instruction,Freda Deskin,DEM,660017,0,1,2,3,
Rogers,U.S. Senate,Connie Johnson,DEM,660017,0,0,8,8,
Rogers,U.S. Senate,Jim Rogers,DEM,660017,1,2,17,20,
Rogers,Superintendent of Public Instruction,John Cox,DEM,660018,1,4,49,54,
Rogers,Superintendent of Public Instruction,Freda Deskin,DEM,660018,3,0,7,10,
Rogers,U.S. Senate,Connie Johnson,DEM,660018,4,4,19,27,
Rogers,U.S. Senate,Jim Rogers,DEM,660018,0,0,37,37,
Rogers,Superintendent of Public Instruction,John Cox,DEM,660019,0,2,21,23,
Rogers,Superintendent of Public Instruction,Freda Deskin,DEM,660019,2,0,6,8,
Rogers,U.S. Senate,Connie Johnson,DEM,660019,2,2,10,14,
Rogers,U.S. Senate,Jim Rogers,DEM,660019,0,0,16,16,
Rogers,Superintendent of Public Instruction,John Cox,DEM,660020,0,5,42,47,
Rogers,Superintendent of Public Instruction,Freda Deskin,DEM,660020,0,0,16,16,
Rogers,U.S. Senate,Connie Johnson,DEM,660020,0,2,28,30,
Rogers,U.S. Senate,Jim Rogers,DEM,660020,0,3,27,30,
Rogers,Superintendent of Public Instruction,John Cox,DEM,660021,0,0,0,0,
Rogers,Superintendent of Public Instruction,Freda Deskin,DEM,660021,2,0,1,3,
Rogers,U.S. Senate,Connie Johnson,DEM,660021,2,0,1,3,
Rogers,U.S. Senate,Jim Rogers,DEM,660021,0,0,0,0,
Rogers,Superintendent of Public Instruction,John Cox,DEM,660022,0,4,35,39,
Rogers,Superintendent of Public Instruction,Freda Deskin,DEM,660022,0,2,7,9,
Rogers,U.S. Senate,Connie Johnson,DEM,660022,0,5,23,28,
Rogers,U.S. Senate,Jim Rogers,DEM,660022,0,1,20,21,
Rogers,Superintendent of Public Instruction,John Cox,DEM,660023,2,2,80,84,
Rogers,Superintendent of Public Instruction,Freda Deskin,DEM,660023,1,0,20,21,
Rogers,U.S. Senate,Connie Johnson,DEM,660023,1,1,33,35,
Rogers,U.S. Senate,Jim Rogers,DEM,660023,2,1,66,69,
Rogers,Superintendent of Public Instruction,John Cox,DEM,660024,0,1,10,11,
Rogers,Superintendent of Public Instruction,Freda Deskin,DEM,660024,0,0,4,4,
Rogers,U.S. Senate,Connie Johnson,DEM,660024,0,0,6,6,
Rogers,U.S. Senate,Jim Rogers,DEM,660024,0,1,8,9,
Rogers,Superintendent of Public Instruction,John Cox,DEM,660025,0,0,12,12,
Rogers,Superintendent of Public Instruction,Freda Deskin,DEM,660025,0,0,3,3,
Rogers,U.S. Senate,Connie Johnson,DEM,660025,0,0,7,7,
Rogers,U.S. Senate,Jim Rogers,DEM,660025,0,0,7,7,
Rogers,Superintendent of Public Instruction,John Cox,DEM,660026,2,0,22,24,
Rogers,Superintendent of Public Instruction,Freda Deskin,DEM,660026,1,0,13,14,
Rogers,U.S. Senate,Connie Johnson,DEM,660026,1,0,17,18,
Rogers,U.S. Senate,Jim Rogers,DEM,660026,3,0,17,20,
Rogers,Superintendent of Public Instruction,John Cox,DEM,660027,0,1,23,24,
Rogers,Superintendent of Public Instruction,Freda Deskin,DEM,660027,0,0,11,11,
Rogers,U.S. Senate,Connie Johnson,DEM,660027,0,1,21,22,
Rogers,U.S. Senate,Jim Rogers,DEM,660027,0,0,12,12,
Rogers,Superintendent of Public Instruction,John Cox,DEM,660029,0,0,12,12,
Rogers,Superintendent of Public Instruction,Freda Deskin,DEM,660029,0,0,8,8,
Rogers,U.S. Senate,Connie Johnson,DEM,660029,0,0,9,9,
Rogers,U.S. Senate,Jim Rogers,DEM,660029,0,0,11,11,
Rogers,Superintendent of Public Instruction,John Cox,DEM,660030,1,0,30,31,
Rogers,Superintendent of Public Instruction,Freda Deskin,DEM,660030,2,0,2,4,
Rogers,U.S. Senate,Connie Johnson,DEM,660030,3,0,21,24,
Rogers,U.S. Senate,Jim Rogers,DEM,660030,0,0,11,11,
Rogers,Superintendent of Public Instruction,John Cox,DEM,660031,1,2,19,22,
Rogers,Superintendent of Public Instruction,Freda Deskin,DEM,660031,0,0,12,12,
Rogers,U.S. Senate,Connie Johnson,DEM,660031,1,1,19,21,
Rogers,U.S. Senate,Jim Rogers,DEM,660031,0,1,12,13,
Rogers,Superintendent of Public Instruction,John Cox,DEM,660032,3,0,3,6,
Rogers,Superintendent of Public Instruction,Freda Deskin,DEM,660032,0,0,0,0,
Rogers,U.S. Senate,Connie Johnson,DEM,660032,2,0,1,3,
Rogers,U.S. Senate,Jim Rogers,DEM,660032,1,0,2,3,
Rogers,Superintendent of Public Instruction,John Cox,DEM,660033,0,0,10,10,
Rogers,Superintendent of Public Instruction,Freda Deskin,DEM,660033,0,0,4,4,
Rogers,U.S. Senate,Connie Johnson,DEM,660033,0,0,8,8,
Rogers,U.S. Senate,Jim Rogers,DEM,660033,0,0,6,6,
Rogers,Superintendent of Public Instruction,John Cox,DEM,660110,2,0,24,26,
Rogers,Superintendent of Public Instruction,Freda Deskin,DEM,660110,0,0,12,12,
Rogers,U.S. Senate,Connie Johnson,DEM,660110,2,0,16,18,
Rogers,U.S. Senate,Jim Rogers,DEM,660110,0,0,19,19,
Rogers,Superintendent of Public Instruction,John Cox,DEM,660116,0,0,18,18,
Rogers,Superintendent of Public Instruction,Freda Deskin,DEM,660116,0,0,10,10,
Rogers,U.S. Senate,Connie Johnson,DEM,660116,0,0,15,15,
Rogers,U.S. Senate,Jim Rogers,DEM,660116,0,0,13,13,
Rogers,Superintendent of Public Instruction,John Cox,DEM,660120,2,0,21,23,
Rogers,Superintendent of Public Instruction,Freda Deskin,DEM,660120,1,0,7,8,
Rogers,U.S. Senate,Connie Johnson,DEM,660120,2,0,16,18,
Rogers,U.S. Senate,Jim Rogers,DEM,660120,1,0,11,12,
Rogers,Superintendent of Public Instruction,John Cox,DEM,660128,0,0,22,22,
Rogers,Superintendent of Public Instruction,Freda Deskin,DEM,660128,0,1,16,17,
Rogers,U.S. Senate,Connie Johnson,DEM,660128,0,1,16,17,
Rogers,U.S. Senate,Jim Rogers,DEM,660128,0,0,20,20,
Rogers,Superintendent of Public Instruction,John Cox,DEM,660130,2,0,41,43,
Rogers,Superintendent of Public Instruction,Freda Deskin,DEM,660130,0,1,12,13,
Rogers,U.S. Senate,Connie Johnson,DEM,660130,2,1,40,43,
Rogers,U.S. Senate,Jim Rogers,DEM,660130,0,0,12,12,
Seminole,Superintendent of Public Instruction,John Cox,DEM,670010,2,5,60,67,
Seminole,Superintendent of Public Instruction,Freda Deskin,DEM,670010,1,0,40,41,
Seminole,U.S. Senate,Connie Johnson,DEM,670010,2,3,63,68,
Seminole,U.S. Senate,Jim Rogers,DEM,670010,1,2,36,39,
Seminole,U.S. House,Tom Guild,DEM,670010,0,2,56,58,05
Seminole,U.S. House,Al Mcaffrey,DEM,670010,3,2,43,48,05
Seminole,U.S. House,Steve Russell,REP,670010,1,2,29,32,05
Seminole,U.S. House,Patrice Douglas,REP,670010,1,1,12,14,05
Seminole,Superintendent of Public Instruction,John Cox,DEM,670012,2,1,11,14,
Seminole,Superintendent of Public Instruction,Freda Deskin,DEM,670012,0,0,5,5,
Seminole,U.S. Senate,Connie Johnson,DEM,670012,2,1,5,8,
Seminole,U.S. Senate,Jim Rogers,DEM,670012,0,0,11,11,
Seminole,U.S. House,Tom Guild,DEM,670012,2,1,9,12,05
Seminole,U.S. House,Al Mcaffrey,DEM,670012,0,0,7,7,05
Seminole,U.S. House,Steve Russell,REP,670012,1,0,11,12,05
Seminole,U.S. House,Patrice Douglas,REP,670012,1,0,1,2,05
Seminole,Superintendent of Public Instruction,John Cox,DEM,670014,2,1,115,118,
Seminole,Superintendent of Public Instruction,Freda Deskin,DEM,670014,0,0,50,50,
Seminole,U.S. Senate,Connie Johnson,DEM,670014,0,1,70,71,
Seminole,U.S. Senate,Jim Rogers,DEM,670014,2,0,88,90,
Seminole,U.S. House,Tom Guild,DEM,670014,2,1,96,99,05
Seminole,U.S. House,Al Mcaffrey,DEM,670014,0,0,63,63,05
Seminole,U.S. House,Steve Russell,REP,670014,5,1,37,43,05
Seminole,U.S. House,Patrice Douglas,REP,670014,0,0,17,17,05
Seminole,Superintendent of Public Instruction,John Cox,DEM,670015,1,1,80,82,
Seminole,Superintendent of Public Instruction,Freda Deskin,DEM,670015,1,0,44,45,
Seminole,U.S. Senate,Connie Johnson,DEM,670015,1,0,41,42,
Seminole,U.S. Senate,Jim Rogers,DEM,670015,0,1,77,78,
Seminole,U.S. House,Tom Guild,DEM,670015,0,1,84,85,05
Seminole,U.S. House,Al Mcaffrey,DEM,670015,1,0,36,37,05
Seminole,U.S. House,Steve Russell,REP,670015,0,1,8,9,05
Seminole,U.S. House,Patrice Douglas,REP,670015,0,0,13,13,05
Seminole,Superintendent of Public Instruction,John Cox,DEM,670020,2,0,37,39,
Seminole,Superintendent of Public Instruction,Freda Deskin,DEM,670020,0,0,16,16,
Seminole,U.S. Senate,Connie Johnson,DEM,670020,0,0,17,17,
Seminole,U.S. Senate,Jim Rogers,DEM,670020,2,0,34,36,
Seminole,U.S. House,Tom Guild,DEM,670020,2,0,32,34,05
Seminole,U.S. House,Al Mcaffrey,DEM,670020,0,0,21,21,05
Seminole,U.S. House,Steve Russell,REP,670020,0,0,17,17,05
Seminole,U.S. House,Patrice Douglas,REP,670020,0,0,16,16,05
Seminole,Superintendent of Public Instruction,John Cox,DEM,670022,1,0,33,34,
Seminole,Superintendent of Public Instruction,Freda Deskin,DEM,670022,2,2,21,25,
Seminole,U.S. Senate,Connie Johnson,DEM,670022,2,1,31,34,
Seminole,U.S. Senate,Jim Rogers,DEM,670022,1,1,23,25,
Seminole,U.S. House,Tom Guild,DEM,670022,2,1,25,28,05
Seminole,U.S. House,Al Mcaffrey,DEM,670022,1,1,29,31,05
Seminole,U.S. House,Steve Russell,REP,670022,3,0,30,33,05
Seminole,U.S. House,Patrice Douglas,REP,670022,3,0,16,19,05
Seminole,Superintendent of Public Instruction,John Cox,DEM,670023,6,1,41,48,
Seminole,Superintendent of Public Instruction,Freda Deskin,DEM,670023,2,3,21,26,
Seminole,U.S. Senate,Connie Johnson,DEM,670023,5,2,40,47,
Seminole,U.S. Senate,Jim Rogers,DEM,670023,3,2,22,27,
Seminole,U.S. House,Tom Guild,DEM,670023,5,0,32,37,05
Seminole,U.S. House,Al Mcaffrey,DEM,670023,3,4,29,36,05
Seminole,U.S. House,Steve Russell,REP,670023,2,0,35,37,05
Seminole,U.S. House,Patrice Douglas,REP,670023,1,0,18,19,05
Seminole,Superintendent of Public Instruction,John Cox,DEM,670024,0,0,40,40,
Seminole,Superintendent of Public Instruction,Freda Deskin,DEM,670024,0,0,11,11,
Seminole,U.S. Senate,Connie Johnson,DEM,670024,0,0,16,16,
Seminole,U.S. Senate,Jim Rogers,DEM,670024,0,0,34,34,
Seminole,U.S. House,Tom Guild,DEM,670024,0,0,29,29,05
Seminole,U.S. House,Al Mcaffrey,DEM,670024,0,0,21,21,05
Seminole,U.S. House,Steve Russell,REP,670024,0,1,18,19,05
Seminole,U.S. House,Patrice Douglas,REP,670024,0,0,12,12,05
Seminole,Superintendent of Public Instruction,John Cox,DEM,670025,0,0,13,13,
Seminole,Superintendent of Public Instruction,Freda Deskin,DEM,670025,0,0,2,2,
Seminole,U.S. Senate,Connie Johnson,DEM,670025,0,0,8,8,
Seminole,U.S. Senate,Jim Rogers,DEM,670025,0,0,7,7,
Seminole,U.S. House,Tom Guild,DEM,670025,0,0,5,5,05
Seminole,U.S. House,Al Mcaffrey,DEM,670025,0,0,10,10,05
Seminole,U.S. House,Steve Russell,REP,670025,0,0,5,5,05
Seminole,U.S. House,Patrice Douglas,REP,670025,0,0,4,4,05
Seminole,Superintendent of Public Instruction,John Cox,DEM,670030,0,0,16,16,
Seminole,Superintendent of Public Instruction,Freda Deskin,DEM,670030,0,0,13,13,
Seminole,U.S. Senate,Connie Johnson,DEM,670030,0,0,9,9,
Seminole,U.S. Senate,Jim Rogers,DEM,670030,0,0,20,20,
Seminole,U.S. House,Tom Guild,DEM,670030,0,0,19,19,05
Seminole,U.S. House,Al Mcaffrey,DEM,670030,0,0,10,10,05
Seminole,U.S. House,Steve Russell,REP,670030,0,0,7,7,05
Seminole,U.S. House,Patrice Douglas,REP,670030,0,0,6,6,05
Seminole,Superintendent of Public Instruction,John Cox,DEM,670032,2,5,32,39,
Seminole,Superintendent of Public Instruction,Freda Deskin,DEM,670032,0,3,11,14,
Seminole,U.S. Senate,Connie Johnson,DEM,670032,1,4,21,26,
Seminole,U.S. Senate,Jim Rogers,DEM,670032,1,4,22,27,
Seminole,U.S. House,Tom Guild,DEM,670032,0,4,26,30,05
Seminole,U.S. House,Al Mcaffrey,DEM,670032,2,4,17,23,05
Seminole,U.S. House,Steve Russell,REP,670032,1,6,12,19,05
Seminole,U.S. House,Patrice Douglas,REP,670032,0,2,11,13,05
Seminole,Superintendent of Public Instruction,John Cox,DEM,670033,0,1,2,3,
Seminole,Superintendent of Public Instruction,Freda Deskin,DEM,670033,0,0,1,1,
Seminole,U.S. Senate,Connie Johnson,DEM,670033,0,1,2,3,
Seminole,U.S. Senate,Jim Rogers,DEM,670033,0,0,1,1,
Seminole,U.S. House,Tom Guild,DEM,670033,0,1,2,3,05
Seminole,U.S. House,Al Mcaffrey,DEM,670033,0,0,1,1,05
Seminole,U.S. House,Steve Russell,REP,670033,0,0,3,3,05
Seminole,U.S. House,Patrice Douglas,REP,670033,0,0,3,3,05
Seminole,Superintendent of Public Instruction,John Cox,DEM,670034,2,6,65,73,
Seminole,Superintendent of Public Instruction,Freda Deskin,DEM,670034,1,5,26,32,
Seminole,U.S. Senate,Connie Johnson,DEM,670034,1,8,48,57,
Seminole,U.S. Senate,Jim Rogers,DEM,670034,2,2,43,47,
Seminole,U.S. House,Tom Guild,DEM,670034,1,7,41,49,05
Seminole,U.S. House,Al Mcaffrey,DEM,670034,2,4,47,53,05
Seminole,U.S. House,Steve Russell,REP,670034,0,1,14,15,05
Seminole,U.S. House,Patrice Douglas,REP,670034,0,0,13,13,05
Seminole,Superintendent of Public Instruction,John Cox,DEM,670035,0,1,6,7,
Seminole,Superintendent of Public Instruction,Freda Deskin,DEM,670035,0,0,5,5,
Seminole,U.S. Senate,Connie Johnson,DEM,670035,0,0,5,5,
Seminole,U.S. Senate,Jim Rogers,DEM,670035,0,1,6,7,
Seminole,U.S. House,Tom Guild,DEM,670035,0,1,6,7,05
Seminole,U.S. House,Al Mcaffrey,DEM,670035,0,0,5,5,05
Seminole,U.S. House,Steve Russell,REP,670035,0,0,13,13,05
Seminole,U.S. House,Patrice Douglas,REP,670035,0,0,6,6,05
Sequoyah,Superintendent of Public Instruction,John Cox,DEM,680101,2,4,73,79,
Sequoyah,Superintendent of Public Instruction,Freda Deskin,DEM,680101,2,0,6,8,
Sequoyah,U.S. Senate,Connie Johnson,DEM,680101,4,0,22,26,
Sequoyah,U.S. Senate,Jim Rogers,DEM,680101,0,4,52,56,
Sequoyah,Superintendent of Public Instruction,John Cox,DEM,680102,0,1,24,25,
Sequoyah,Superintendent of Public Instruction,Freda Deskin,DEM,680102,0,0,4,4,
Sequoyah,U.S. Senate,Connie Johnson,DEM,680102,0,0,6,6,
Sequoyah,U.S. Senate,Jim Rogers,DEM,680102,0,1,21,22,
Sequoyah,Superintendent of Public Instruction,John Cox,DEM,680103,0,0,35,35,
Sequoyah,Superintendent of Public Instruction,Freda Deskin,DEM,680103,0,0,10,10,
Sequoyah,U.S. Senate,Connie Johnson,DEM,680103,0,0,14,14,
Sequoyah,U.S. Senate,Jim Rogers,DEM,680103,0,0,31,31,
Sequoyah,Superintendent of Public Instruction,John Cox,DEM,680104,2,1,24,27,
Sequoyah,Superintendent of Public Instruction,Freda Deskin,DEM,680104,0,1,4,5,
Sequoyah,U.S. Senate,Connie Johnson,DEM,680104,0,1,5,6,
Sequoyah,U.S. Senate,Jim Rogers,DEM,680104,2,1,22,25,
Sequoyah,Superintendent of Public Instruction,John Cox,DEM,680105,0,1,13,14,
Sequoyah,Superintendent of Public Instruction,Freda Deskin,DEM,680105,0,1,3,4,
Sequoyah,U.S. Senate,Connie Johnson,DEM,680105,0,1,3,4,
Sequoyah,U.S. Senate,Jim Rogers,DEM,680105,0,1,12,13,
Sequoyah,Superintendent of Public Instruction,John Cox,DEM,680106,0,1,29,30,
Sequoyah,Superintendent of Public Instruction,Freda Deskin,DEM,680106,0,0,0,0,
Sequoyah,U.S. Senate,Connie Johnson,DEM,680106,0,0,6,6,
Sequoyah,U.S. Senate,Jim Rogers,DEM,680106,0,1,20,21,
Sequoyah,Superintendent of Public Instruction,John Cox,DEM,680201,0,0,6,6,
Sequoyah,Superintendent of Public Instruction,Freda Deskin,DEM,680201,0,0,1,1,
Sequoyah,U.S. Senate,Connie Johnson,DEM,680201,0,0,1,1,
Sequoyah,U.S. Senate,Jim Rogers,DEM,680201,0,0,6,6,
Sequoyah,Superintendent of Public Instruction,John Cox,DEM,680202,0,0,17,17,
Sequoyah,Superintendent of Public Instruction,Freda Deskin,DEM,680202,0,0,3,3,
Sequoyah,U.S. Senate,Connie Johnson,DEM,680202,0,0,11,11,
Sequoyah,U.S. Senate,Jim Rogers,DEM,680202,0,0,9,9,
Sequoyah,Superintendent of Public Instruction,John Cox,DEM,680203,0,0,14,14,
Sequoyah,Superintendent of Public Instruction,Freda Deskin,DEM,680203,0,0,1,1,
Sequoyah,U.S. Senate,Connie Johnson,DEM,680203,0,0,5,5,
Sequoyah,U.S. Senate,Jim Rogers,DEM,680203,0,0,10,10,
Sequoyah,Superintendent of Public Instruction,John Cox,DEM,680204,0,0,5,5,
Sequoyah,Superintendent of Public Instruction,Freda Deskin,DEM,680204,0,0,0,0,
Sequoyah,U.S. Senate,Connie Johnson,DEM,680204,0,0,0,0,
Sequoyah,U.S. Senate,Jim Rogers,DEM,680204,0,0,6,6,
Sequoyah,Superintendent of Public Instruction,John Cox,DEM,680205,2,0,20,22,
Sequoyah,Superintendent of Public Instruction,Freda Deskin,DEM,680205,2,0,12,14,
Sequoyah,U.S. Senate,Connie Johnson,DEM,680205,2,0,16,18,
Sequoyah,U.S. Senate,Jim Rogers,DEM,680205,2,0,16,18,
Sequoyah,Superintendent of Public Instruction,John Cox,DEM,680206,0,2,18,20,
Sequoyah,Superintendent of Public Instruction,Freda Deskin,DEM,680206,0,0,9,9,
Sequoyah,U.S. Senate,Connie Johnson,DEM,680206,0,1,13,14,
Sequoyah,U.S. Senate,Jim Rogers,DEM,680206,0,1,13,14,
Sequoyah,Superintendent of Public Instruction,John Cox,DEM,680207,1,2,26,29,
Sequoyah,Superintendent of Public Instruction,Freda Deskin,DEM,680207,0,0,5,5,
Sequoyah,U.S. Senate,Connie Johnson,DEM,680207,1,0,10,11,
Sequoyah,U.S. Senate,Jim Rogers,DEM,680207,0,2,21,23,
Sequoyah,Superintendent of Public Instruction,John Cox,DEM,680208,2,3,26,31,
Sequoyah,Superintendent of Public Instruction,Freda Deskin,DEM,680208,0,0,12,12,
Sequoyah,U.S. Senate,Connie Johnson,DEM,680208,1,2,21,24,
Sequoyah,U.S. Senate,Jim Rogers,DEM,680208,1,1,16,18,
Sequoyah,Superintendent of Public Instruction,John Cox,DEM,680209,2,0,48,50,
Sequoyah,Superintendent of Public Instruction,Freda Deskin,DEM,680209,2,0,9,11,
Sequoyah,U.S. Senate,Connie Johnson,DEM,680209,0,0,26,26,
Sequoyah,U.S. Senate,Jim Rogers,DEM,680209,4,0,28,32,
Sequoyah,Superintendent of Public Instruction,John Cox,DEM,680210,0,0,28,28,
Sequoyah,Superintendent of Public Instruction,Freda Deskin,DEM,680210,0,0,8,8,
Sequoyah,U.S. Senate,Connie Johnson,DEM,680210,0,0,13,13,
Sequoyah,U.S. Senate,Jim Rogers,DEM,680210,0,0,21,21,
Sequoyah,Superintendent of Public Instruction,John Cox,DEM,680301,5,2,35,42,
Sequoyah,Superintendent of Public Instruction,Freda Deskin,DEM,680301,7,2,13,22,
Sequoyah,U.S. Senate,Connie Johnson,DEM,680301,6,3,16,25,
Sequoyah,U.S. Senate,Jim Rogers,DEM,680301,6,1,31,38,
Sequoyah,Superintendent of Public Instruction,John Cox,DEM,680302,1,0,13,14,
Sequoyah,Superintendent of Public Instruction,Freda Deskin,DEM,680302,0,0,3,3,
Sequoyah,U.S. Senate,Connie Johnson,DEM,680302,1,0,6,7,
Sequoyah,U.S. Senate,Jim Rogers,DEM,680302,0,0,10,10,
Sequoyah,Superintendent of Public Instruction,John Cox,DEM,680303,1,4,63,68,
Sequoyah,Superintendent of Public Instruction,Freda Deskin,DEM,680303,0,1,8,9,
Sequoyah,U.S. Senate,Connie Johnson,DEM,680303,0,2,27,29,
Sequoyah,U.S. Senate,Jim Rogers,DEM,680303,1,3,43,47,
Sequoyah,Superintendent of Public Instruction,John Cox,DEM,680304,0,2,16,18,
Sequoyah,Superintendent of Public Instruction,Freda Deskin,DEM,680304,1,0,9,10,
Sequoyah,U.S. Senate,Connie Johnson,DEM,680304,1,1,13,15,
Sequoyah,U.S. Senate,Jim Rogers,DEM,680304,0,1,12,13,
Sequoyah,Superintendent of Public Instruction,John Cox,DEM,680305,0,2,13,15,
Sequoyah,Superintendent of Public Instruction,Freda Deskin,DEM,680305,1,0,1,2,
Sequoyah,U.S. Senate,Connie Johnson,DEM,680305,1,2,7,10,
Sequoyah,U.S. Senate,Jim Rogers,DEM,680305,0,0,8,8,
Sequoyah,Superintendent of Public Instruction,John Cox,DEM,680306,0,0,24,24,
Sequoyah,Superintendent of Public Instruction,Freda Deskin,DEM,680306,0,1,6,7,
Sequoyah,U.S. Senate,Connie Johnson,DEM,680306,0,0,9,9,
Sequoyah,U.S. Senate,Jim Rogers,DEM,680306,0,1,20,21,
Sequoyah,Superintendent of Public Instruction,John Cox,DEM,680307,1,2,12,15,
Sequoyah,Superintendent of Public Instruction,Freda Deskin,DEM,680307,0,0,2,2,
Sequoyah,U.S. Senate,Connie Johnson,DEM,680307,0,0,7,7,
Sequoyah,U.S. Senate,Jim Rogers,DEM,680307,1,2,6,9,
Sequoyah,Superintendent of Public Instruction,John Cox,DEM,680308,2,0,11,13,
Sequoyah,Superintendent of Public Instruction,Freda Deskin,DEM,680308,0,0,2,2,
Sequoyah,U.S. Senate,Connie Johnson,DEM,680308,2,0,6,8,
Sequoyah,U.S. Senate,Jim Rogers,DEM,680308,0,0,7,7,
Sequoyah,Superintendent of Public Instruction,John Cox,DEM,680309,1,0,20,21,
Sequoyah,Superintendent of Public Instruction,Freda Deskin,DEM,680309,0,0,1,1,
Sequoyah,U.S. Senate,Connie Johnson,DEM,680309,1,0,4,5,
Sequoyah,U.S. Senate,Jim Rogers,DEM,680309,0,0,17,17,
Sequoyah,Superintendent of Public Instruction,John Cox,DEM,680310,0,0,18,18,
Sequoyah,Superintendent of Public Instruction,Freda Deskin,DEM,680310,0,1,4,5,
Sequoyah,U.S. Senate,Connie Johnson,DEM,680310,0,1,6,7,
Sequoyah,U.S. Senate,Jim Rogers,DEM,680310,0,0,14,14,
Stephens,Superintendent of Public Instruction,John Cox,DEM,690001,0,1,19,20,
Stephens,Superintendent of Public Instruction,Freda Deskin,DEM,690001,0,2,5,7,
Stephens,U.S. Senate,Connie Johnson,DEM,690001,0,0,15,15,
Stephens,U.S. Senate,Jim Rogers,DEM,690001,0,3,9,12,
Stephens,Superintendent of Public Instruction,John Cox,DEM,690003,1,1,22,24,
Stephens,Superintendent of Public Instruction,Freda Deskin,DEM,690003,2,0,6,8,
Stephens,U.S. Senate,Connie Johnson,DEM,690003,3,0,23,26,
Stephens,U.S. Senate,Jim Rogers,DEM,690003,0,1,5,6,
Stephens,Superintendent of Public Instruction,John Cox,DEM,690004,0,2,24,26,
Stephens,Superintendent of Public Instruction,Freda Deskin,DEM,690004,0,2,11,13,
Stephens,U.S. Senate,Connie Johnson,DEM,690004,0,2,22,24,
Stephens,U.S. Senate,Jim Rogers,DEM,690004,0,2,11,13,
Stephens,Superintendent of Public Instruction,John Cox,DEM,690008,1,2,19,22,
Stephens,Superintendent of Public Instruction,Freda Deskin,DEM,690008,1,2,22,25,
Stephens,U.S. Senate,Connie Johnson,DEM,690008,2,3,27,32,
Stephens,U.S. Senate,Jim Rogers,DEM,690008,0,1,14,15,
Stephens,Superintendent of Public Instruction,John Cox,DEM,690012,1,0,18,19,
Stephens,Superintendent of Public Instruction,Freda Deskin,DEM,690012,0,2,10,12,
Stephens,U.S. Senate,Connie Johnson,DEM,690012,1,1,19,21,
Stephens,U.S. Senate,Jim Rogers,DEM,690012,0,1,8,9,
Stephens,Superintendent of Public Instruction,John Cox,DEM,690013,1,1,8,10,
Stephens,Superintendent of Public Instruction,Freda Deskin,DEM,690013,0,0,5,5,
Stephens,U.S. Senate,Connie Johnson,DEM,690013,0,0,8,8,
Stephens,U.S. Senate,Jim Rogers,DEM,690013,1,1,5,7,
Stephens,Superintendent of Public Instruction,John Cox,DEM,690014,1,4,18,23,
Stephens,Superintendent of Public Instruction,Freda Deskin,DEM,690014,0,2,7,9,
Stephens,U.S. Senate,Connie Johnson,DEM,690014,0,4,15,19,
Stephens,U.S. Senate,Jim Rogers,DEM,690014,1,2,9,12,
Stephens,Superintendent of Public Instruction,John Cox,DEM,690015,0,0,4,4,
Stephens,Superintendent of Public Instruction,Freda Deskin,DEM,690015,0,0,0,0,
Stephens,U.S. Senate,Connie Johnson,DEM,690015,0,0,1,1,
Stephens,U.S. Senate,Jim Rogers,DEM,690015,0,0,3,3,
Stephens,Superintendent of Public Instruction,John Cox,DEM,690016,1,6,39,46,
Stephens,Superintendent of Public Instruction,Freda Deskin,DEM,690016,1,0,14,15,
Stephens,U.S. Senate,Connie Johnson,DEM,690016,1,5,31,37,
Stephens,U.S. Senate,Jim Rogers,DEM,690016,1,1,22,24,
Stephens,Superintendent of Public Instruction,John Cox,DEM,690019,0,3,31,34,
Stephens,Superintendent of Public Instruction,Freda Deskin,DEM,690019,2,1,18,21,
Stephens,U.S. Senate,Connie Johnson,DEM,690019,1,1,23,25,
Stephens,U.S. Senate,Jim Rogers,DEM,690019,1,3,20,24,
Stephens,Superintendent of Public Instruction,John Cox,DEM,690032,1,2,24,27,
Stephens,Superintendent of Public Instruction,Freda Deskin,DEM,690032,2,1,16,19,
Stephens,U.S. Senate,Connie Johnson,DEM,690032,1,1,23,25,
Stephens,U.S. Senate,Jim Rogers,DEM,690032,2,2,17,21,
Stephens,Superintendent of Public Instruction,John Cox,DEM,690033,3,2,48,53,
Stephens,Superintendent of Public Instruction,Freda Deskin,DEM,690033,1,3,8,12,
Stephens,U.S. Senate,Connie Johnson,DEM,690033,2,3,30,35,
Stephens,U.S. Senate,Jim Rogers,DEM,690033,2,2,26,30,
Stephens,Superintendent of Public Instruction,John Cox,DEM,690041,0,1,26,27,
Stephens,Superintendent of Public Instruction,Freda Deskin,DEM,690041,0,1,14,15,
Stephens,U.S. Senate,Connie Johnson,DEM,690041,0,2,20,22,
Stephens,U.S. Senate,Jim Rogers,DEM,690041,0,0,20,20,
Stephens,Superintendent of Public Instruction,John Cox,DEM,690049,0,0,8,8,
Stephens,Superintendent of Public Instruction,Freda Deskin,DEM,690049,0,0,3,3,
Stephens,U.S. Senate,Connie Johnson,DEM,690049,0,0,6,6,
Stephens,U.S. Senate,Jim Rogers,DEM,690049,0,0,5,5,
Stephens,Superintendent of Public Instruction,John Cox,DEM,690050,1,1,25,27,
Stephens,Superintendent of Public Instruction,Freda Deskin,DEM,690050,0,3,14,17,
Stephens,U.S. Senate,Connie Johnson,DEM,690050,0,4,23,27,
Stephens,U.S. Senate,Jim Rogers,DEM,690050,1,0,15,16,
Stephens,Superintendent of Public Instruction,John Cox,DEM,690051,0,0,15,15,
Stephens,Superintendent of Public Instruction,Freda Deskin,DEM,690051,0,0,8,8,
Stephens,U.S. Senate,Connie Johnson,DEM,690051,0,0,8,8,
Stephens,U.S. Senate,Jim Rogers,DEM,690051,0,0,15,15,
Stephens,State House,Scott Hayes,REP,690051,0,0,5,5,65
Stephens,State House,Scooter Park,REP,690051,0,0,17,17,65
Stephens,Superintendent of Public Instruction,John Cox,DEM,690052,0,2,0,2,
Stephens,Superintendent of Public Instruction,Freda Deskin,DEM,690052,0,1,2,3,
Stephens,U.S. Senate,Connie Johnson,DEM,690052,0,3,2,5,
Stephens,U.S. Senate,Jim Rogers,DEM,690052,0,0,0,0,
Stephens,Superintendent of Public Instruction,John Cox,DEM,690053,1,0,13,14,
Stephens,Superintendent of Public Instruction,Freda Deskin,DEM,690053,0,1,3,4,
Stephens,U.S. Senate,Connie Johnson,DEM,690053,1,0,6,7,
Stephens,U.S. Senate,Jim Rogers,DEM,690053,0,1,10,11,
Stephens,Superintendent of Public Instruction,John Cox,DEM,690054,0,0,8,8,
Stephens,Superintendent of Public Instruction,Freda Deskin,DEM,690054,0,0,3,3,
Stephens,U.S. Senate,Connie Johnson,DEM,690054,0,0,8,8,
Stephens,U.S. Senate,Jim Rogers,DEM,690054,0,0,3,3,
Stephens,Superintendent of Public Instruction,John Cox,DEM,690055,0,3,9,12,
Stephens,Superintendent of Public Instruction,Freda Deskin,DEM,690055,0,0,8,8,
Stephens,U.S. Senate,Connie Johnson,DEM,690055,0,3,7,10,
Stephens,U.S. Senate,Jim Rogers,DEM,690055,0,0,10,10,
Stephens,Superintendent of Public Instruction,John Cox,DEM,690056,0,0,12,12,
Stephens,Superintendent of Public Instruction,Freda Deskin,DEM,690056,0,0,5,5,
Stephens,U.S. Senate,Connie Johnson,DEM,690056,0,0,8,8,
Stephens,U.S. Senate,Jim Rogers,DEM,690056,0,0,8,8,
Stephens,Superintendent of Public Instruction,John Cox,DEM,690057,0,1,20,21,
Stephens,Superintendent of Public Instruction,Freda Deskin,DEM,690057,0,0,4,4,
Stephens,U.S. Senate,Connie Johnson,DEM,690057,0,0,11,11,
Stephens,U.S. Senate,Jim Rogers,DEM,690057,0,1,12,13,
Stephens,Superintendent of Public Instruction,John Cox,DEM,690058,0,1,19,20,
Stephens,Superintendent of Public Instruction,Freda Deskin,DEM,690058,0,0,6,6,
Stephens,U.S. Senate,Connie Johnson,DEM,690058,0,0,11,11,
Stephens,U.S. Senate,Jim Rogers,DEM,690058,0,1,15,16,
Stephens,Superintendent of Public Instruction,John Cox,DEM,690059,1,0,2,3,
Stephens,Superintendent of Public Instruction,Freda Deskin,DEM,690059,0,1,6,7,
Stephens,U.S. Senate,Connie Johnson,DEM,690059,0,1,5,6,
Stephens,U.S. Senate,Jim Rogers,DEM,690059,1,0,3,4,
Stephens,Superintendent of Public Instruction,John Cox,DEM,690060,0,0,0,0,
Stephens,Superintendent of Public Instruction,Freda Deskin,DEM,690060,0,0,0,0,
Stephens,U.S. Senate,Connie Johnson,DEM,690060,0,0,0,0,
Stephens,U.S. Senate,Jim Rogers,DEM,690060,0,0,0,0,
Stephens,State House,Scott Hayes,REP,690060,0,0,0,0,65
Stephens,State House,Scooter Park,REP,690060,0,2,2,4,65
Stephens,Superintendent of Public Instruction,John Cox,DEM,690061,0,1,18,19,
Stephens,Superintendent of Public Instruction,Freda Deskin,DEM,690061,0,1,3,4,
Stephens,U.S. Senate,Connie Johnson,DEM,690061,0,1,13,14,
Stephens,U.S. Senate,Jim Rogers,DEM,690061,0,1,8,9,
Stephens,Superintendent of Public Instruction,John Cox,DEM,690062,0,0,22,22,
Stephens,Superintendent of Public Instruction,Freda Deskin,DEM,690062,0,0,7,7,
Stephens,U.S. Senate,Connie Johnson,DEM,690062,0,0,18,18,
Stephens,U.S. Senate,Jim Rogers,DEM,690062,0,0,10,10,
Stephens,Superintendent of Public Instruction,John Cox,DEM,690063,0,0,6,6,
Stephens,Superintendent of Public Instruction,Freda Deskin,DEM,690063,0,0,2,2,
Stephens,U.S. Senate,Connie Johnson,DEM,690063,0,0,5,5,
Stephens,U.S. Senate,Jim Rogers,DEM,690063,0,0,3,3,
Stephens,State House,Scott Hayes,REP,690063,0,0,5,5,65
Stephens,State House,Scooter Park,REP,690063,1,2,12,15,65
Texas,Superintendent of Public Instruction,John Cox,DEM,700101,1,0,15,16,
Texas,Superintendent of Public Instruction,Freda Deskin,DEM,700101,2,0,10,12,
Texas,U.S. Senate,Connie Johnson,DEM,700101,2,0,10,12,
Texas,U.S. Senate,Jim Rogers,DEM,700101,1,0,15,16,
Texas,State House,Casey Murdock,REP,700101,6,4,102,112,61
Texas,State House,Kenny Bob Tapp,REP,700101,6,1,106,113,61
Texas,Superintendent of Public Instruction,John Cox,DEM,700102,0,3,4,7,
Texas,Superintendent of Public Instruction,Freda Deskin,DEM,700102,0,1,3,4,
Texas,U.S. Senate,Connie Johnson,DEM,700102,0,1,0,1,
Texas,U.S. Senate,Jim Rogers,DEM,700102,0,3,7,10,
Texas,State House,Casey Murdock,REP,700102,0,1,20,21,61
Texas,State House,Kenny Bob Tapp,REP,700102,0,4,9,13,61
Texas,Superintendent of Public Instruction,John Cox,DEM,700104,1,0,14,15,
Texas,Superintendent of Public Instruction,Freda Deskin,DEM,700104,0,0,10,10,
Texas,U.S. Senate,Connie Johnson,DEM,700104,0,0,7,7,
Texas,U.S. Senate,Jim Rogers,DEM,700104,1,0,17,18,
Texas,State House,Casey Murdock,REP,700104,4,0,43,47,61
Texas,State House,Kenny Bob Tapp,REP,700104,7,0,23,30,61
Texas,Superintendent of Public Instruction,John Cox,DEM,700107,0,0,8,8,
Texas,Superintendent of Public Instruction,Freda Deskin,DEM,700107,0,0,3,3,
Texas,U.S. Senate,Connie Johnson,DEM,700107,0,0,3,3,
Texas,U.S. Senate,Jim Rogers,DEM,700107,0,0,8,8,
Texas,State House,Casey Murdock,REP,700107,2,4,28,34,61
Texas,State House,Kenny Bob Tapp,REP,700107,0,0,14,14,61
Texas,Superintendent of Public Instruction,John Cox,DEM,700201,1,3,11,15,
Texas,Superintendent of Public Instruction,Freda Deskin,DEM,700201,0,0,6,6,
Texas,U.S. Senate,Connie Johnson,DEM,700201,0,1,7,8,
Texas,U.S. Senate,Jim Rogers,DEM,700201,1,2,9,12,
Texas,State House,Casey Murdock,REP,700201,2,15,90,107,61
Texas,State House,Kenny Bob Tapp,REP,700201,3,1,54,58,61
Texas,Superintendent of Public Instruction,John Cox,DEM,700202,0,0,2,2,
Texas,Superintendent of Public Instruction,Freda Deskin,DEM,700202,0,0,1,1,
Texas,U.S. Senate,Connie Johnson,DEM,700202,0,0,1,1,
Texas,U.S. Senate,Jim Rogers,DEM,700202,0,0,2,2,
Texas,State House,Casey Murdock,REP,700202,0,9,27,36,61
Texas,State House,Kenny Bob Tapp,REP,700202,0,0,22,22,61
Texas,Superintendent of Public Instruction,John Cox,DEM,700205,0,2,13,15,
Texas,Superintendent of Public Instruction,Freda Deskin,DEM,700205,0,2,9,11,
Texas,U.S. Senate,Connie Johnson,DEM,700205,0,3,16,19,
Texas,U.S. Senate,Jim Rogers,DEM,700205,0,1,6,7,
Texas,State House,Casey Murdock,REP,700205,9,15,99,123,61
Texas,State House,Kenny Bob Tapp,REP,700205,0,6,57,63,61
Texas,Superintendent of Public Instruction,John Cox,DEM,700302,0,0,2,2,
Texas,Superintendent of Public Instruction,Freda Deskin,DEM,700302,0,0,4,4,
Texas,U.S. Senate,Connie Johnson,DEM,700302,0,0,3,3,
Texas,U.S. Senate,Jim Rogers,DEM,700302,0,0,3,3,
Texas,State House,Casey Murdock,REP,700302,3,6,16,25,61
Texas,State House,Kenny Bob Tapp,REP,700302,0,0,3,3,61
Texas,Superintendent of Public Instruction,John Cox,DEM,700303,1,0,5,6,
Texas,Superintendent of Public Instruction,Freda Deskin,DEM,700303,1,0,10,11,
Texas,U.S. Senate,Connie Johnson,DEM,700303,0,0,7,7,
Texas,U.S. Senate,Jim Rogers,DEM,700303,2,0,8,10,
Texas,State House,Casey Murdock,REP,700303,3,1,53,57,61
Texas,State House,Kenny Bob Tapp,REP,700303,1,1,20,22,61
Texas,Superintendent of Public Instruction,John Cox,DEM,700304,0,1,11,12,
Texas,Superintendent of Public Instruction,Freda Deskin,DEM,700304,0,0,12,12,
Texas,U.S. Senate,Connie Johnson,DEM,700304,0,1,14,15,
Texas,U.S. Senate,Jim Rogers,DEM,700304,0,0,9,9,
Texas,State House,Casey Murdock,REP,700304,0,2,30,32,61
Texas,State House,Kenny Bob Tapp,REP,700304,1,0,11,12,61
Texas,Superintendent of Public Instruction,John Cox,DEM,700305,1,0,9,10,
Texas,Superintendent of Public Instruction,Freda Deskin,DEM,700305,0,0,16,16,
Texas,U.S. Senate,Connie Johnson,DEM,700305,0,0,9,9,
Texas,U.S. Senate,Jim Rogers,DEM,700305,1,0,15,16,
Texas,State House,Casey Murdock,REP,700305,0,15,113,128,61
Texas,State House,Kenny Bob Tapp,REP,700305,1,3,41,45,61
Tillman,Superintendent of Public Instruction,John Cox,DEM,710001,1,3,10,14,
Tillman,Superintendent of Public Instruction,Freda Deskin,DEM,710001,0,7,6,13,
Tillman,U.S. Senate,Connie Johnson,DEM,710001,0,4,9,13,
Tillman,U.S. Senate,Jim Rogers,DEM,710001,1,6,7,14,
Tillman,Superintendent of Public Instruction,John Cox,DEM,710002,0,1,6,7,
Tillman,Superintendent of Public Instruction,Freda Deskin,DEM,710002,0,4,3,7,
Tillman,U.S. Senate,Connie Johnson,DEM,710002,0,3,2,5,
Tillman,U.S. Senate,Jim Rogers,DEM,710002,0,2,5,7,
Tillman,Superintendent of Public Instruction,John Cox,DEM,710003,0,1,1,2,
Tillman,Superintendent of Public Instruction,Freda Deskin,DEM,710003,0,1,3,4,
Tillman,U.S. Senate,Connie Johnson,DEM,710003,0,2,3,5,
Tillman,U.S. Senate,Jim Rogers,DEM,710003,0,0,1,1,
Tillman,Superintendent of Public Instruction,John Cox,DEM,710004,0,0,4,4,
Tillman,Superintendent of Public Instruction,Freda Deskin,DEM,710004,0,1,4,5,
Tillman,U.S. Senate,Connie Johnson,DEM,710004,0,0,5,5,
Tillman,U.S. Senate,Jim Rogers,DEM,710004,0,1,3,4,
Tillman,Superintendent of Public Instruction,John Cox,DEM,710006,0,0,9,9,
Tillman,Superintendent of Public Instruction,Freda Deskin,DEM,710006,0,0,1,1,
Tillman,U.S. Senate,Connie Johnson,DEM,710006,0,0,2,2,
Tillman,U.S. Senate,Jim Rogers,DEM,710006,0,0,8,8,
Tillman,Superintendent of Public Instruction,John Cox,DEM,710007,0,0,14,14,
Tillman,Superintendent of Public Instruction,Freda Deskin,DEM,710007,0,0,10,10,
Tillman,U.S. Senate,Connie Johnson,DEM,710007,0,0,14,14,
Tillman,U.S. Senate,Jim Rogers,DEM,710007,0,0,10,10,
Tillman,Superintendent of Public Instruction,John Cox,DEM,710009,0,0,13,13,
Tillman,Superintendent of Public Instruction,Freda Deskin,DEM,710009,0,1,2,3,
Tillman,U.S. Senate,Connie Johnson,DEM,710009,0,1,13,14,
Tillman,U.S. Senate,Jim Rogers,DEM,710009,0,0,3,3,
Tillman,Superintendent of Public Instruction,John Cox,DEM,710010,2,1,55,58,
Tillman,Superintendent of Public Instruction,Freda Deskin,DEM,710010,0,0,29,29,
Tillman,U.S. Senate,Connie Johnson,DEM,710010,0,0,31,31,
Tillman,U.S. Senate,Jim Rogers,DEM,710010,2,1,50,53,
Tillman,Superintendent of Public Instruction,John Cox,DEM,710012,0,1,4,5,
Tillman,Superintendent of Public Instruction,Freda Deskin,DEM,710012,1,0,9,10,
Tillman,U.S. Senate,Connie Johnson,DEM,710012,1,0,10,11,
Tillman,U.S. Senate,Jim Rogers,DEM,710012,0,1,4,5,
Tulsa,Superintendent of Public Instruction,John Cox,DEM,720001,0,0,39,39,
Tulsa,Superintendent of Public Instruction,Freda Deskin,DEM,720001,0,0,21,21,
Tulsa,U.S. Senate,Connie Johnson,DEM,720001,0,0,51,51,
Tulsa,U.S. Senate,Jim Rogers,DEM,720001,0,0,9,9,
Tulsa,Superintendent of Public Instruction,John Cox,DEM,720002,0,0,22,22,
Tulsa,Superintendent of Public Instruction,Freda Deskin,DEM,720002,0,0,20,20,
Tulsa,U.S. Senate,Connie Johnson,DEM,720002,0,0,36,36,
Tulsa,U.S. Senate,Jim Rogers,DEM,720002,0,0,6,6,
Tulsa,Superintendent of Public Instruction,John Cox,DEM,720003,0,0,12,12,
Tulsa,Superintendent of Public Instruction,Freda Deskin,DEM,720003,0,0,7,7,
Tulsa,U.S. Senate,Connie Johnson,DEM,720003,0,0,11,11,
Tulsa,U.S. Senate,Jim Rogers,DEM,720003,0,0,8,8,
Tulsa,Superintendent of Public Instruction,John Cox,DEM,720004,0,0,60,60,
Tulsa,Superintendent of Public Instruction,Freda Deskin,DEM,720004,0,0,36,36,
Tulsa,U.S. Senate,Connie Johnson,DEM,720004,0,0,81,81,
Tulsa,U.S. Senate,Jim Rogers,DEM,720004,0,0,14,14,
Tulsa,Superintendent of Public Instruction,John Cox,DEM,720005,0,0,23,23,
Tulsa,Superintendent of Public Instruction,Freda Deskin,DEM,720005,0,0,11,11,
Tulsa,U.S. Senate,Connie Johnson,DEM,720005,0,0,26,26,
Tulsa,U.S. Senate,Jim Rogers,DEM,720005,0,0,8,8,
Tulsa,Superintendent of Public Instruction,John Cox,DEM,720006,0,0,68,68,
Tulsa,Superintendent of Public Instruction,Freda Deskin,DEM,720006,0,0,39,39,
Tulsa,U.S. Senate,Connie Johnson,DEM,720006,0,0,97,97,
Tulsa,U.S. Senate,Jim Rogers,DEM,720006,0,0,11,11,
Tulsa,Superintendent of Public Instruction,John Cox,DEM,720007,0,0,43,43,
Tulsa,Superintendent of Public Instruction,Freda Deskin,DEM,720007,0,0,18,18,
Tulsa,U.S. Senate,Connie Johnson,DEM,720007,0,0,61,61,
Tulsa,U.S. Senate,Jim Rogers,DEM,720007,0,0,2,2,
Tulsa,Superintendent of Public Instruction,John Cox,DEM,720008,0,0,27,27,
Tulsa,Superintendent of Public Instruction,Freda Deskin,DEM,720008,0,0,18,18,
Tulsa,U.S. Senate,Connie Johnson,DEM,720008,0,0,37,37,
Tulsa,U.S. Senate,Jim Rogers,DEM,720008,0,0,8,8,
Tulsa,Superintendent of Public Instruction,John Cox,DEM,720009,0,0,9,9,
Tulsa,Superintendent of Public Instruction,Freda Deskin,DEM,720009,0,0,4,4,
Tulsa,U.S. Senate,Connie Johnson,DEM,720009,0,0,9,9,
Tulsa,U.S. Senate,Jim Rogers,DEM,720009,0,0,4,4,
Tulsa,Superintendent of Public Instruction,John Cox,DEM,720010,0,0,29,29,
Tulsa,Superintendent of Public Instruction,Freda Deskin,DEM,720010,0,0,32,32,
Tulsa,U.S. Senate,Connie Johnson,DEM,720010,0,0,60,60,
Tulsa,U.S. Senate,Jim Rogers,DEM,720010,0,0,4,4,
Tulsa,Superintendent of Public Instruction,John Cox,DEM,720011,0,0,14,14,
Tulsa,Superintendent of Public Instruction,Freda Deskin,DEM,720011,0,0,8,8,
Tulsa,U.S. Senate,Connie Johnson,DEM,720011,0,0,13,13,
Tulsa,U.S. Senate,Jim Rogers,DEM,720011,0,0,9,9,
Tulsa,Superintendent of Public Instruction,John Cox,DEM,720012,0,0,9,9,
Tulsa,Superintendent of Public Instruction,Freda Deskin,DEM,720012,0,0,13,13,
Tulsa,U.S. Senate,Connie Johnson,DEM,720012,0,0,15,15,
Tulsa,U.S. Senate,Jim Rogers,DEM,720012,0,0,7,7,
Tulsa,Superintendent of Public Instruction,John Cox,DEM,720013,0,0,49,49,
Tulsa,Superintendent of Public Instruction,Freda Deskin,DEM,720013,0,0,36,36,
Tulsa,U.S. Senate,Connie Johnson,DEM,720013,0,0,82,82,
Tulsa,U.S. Senate,Jim Rogers,DEM,720013,0,0,4,4,
Tulsa,Superintendent of Public Instruction,John Cox,DEM,720014,0,0,41,41,
Tulsa,Superintendent of Public Instruction,Freda Deskin,DEM,720014,0,0,15,15,
Tulsa,U.S. Senate,Connie Johnson,DEM,720014,0,0,52,52,
Tulsa,U.S. Senate,Jim Rogers,DEM,720014,0,0,3,3,
Tulsa,Superintendent of Public Instruction,John Cox,DEM,720015,0,0,15,15,
Tulsa,Superintendent of Public Instruction,Freda Deskin,DEM,720015,0,0,17,17,
Tulsa,U.S. Senate,Connie Johnson,DEM,720015,0,0,27,27,
Tulsa,U.S. Senate,Jim Rogers,DEM,720015,0,0,5,5,
Tulsa,Superintendent of Public Instruction,John Cox,DEM,720016,0,0,4,4,
Tulsa,Superintendent of Public Instruction,Freda Deskin,DEM,720016,0,0,6,6,
Tulsa,U.S. Senate,Connie Johnson,DEM,720016,0,0,9,9,
Tulsa,U.S. Senate,Jim Rogers,DEM,720016,0,0,1,1,
Tulsa,Superintendent of Public Instruction,John Cox,DEM,720017,0,0,10,10,
Tulsa,Superintendent of Public Instruction,Freda Deskin,DEM,720017,0,0,6,6,
Tulsa,U.S. Senate,Connie Johnson,DEM,720017,0,0,8,8,
Tulsa,U.S. Senate,Jim Rogers,DEM,720017,0,0,8,8,
Tulsa,Superintendent of Public Instruction,John Cox,DEM,720018,0,0,9,9,
Tulsa,Superintendent of Public Instruction,Freda Deskin,DEM,720018,0,0,11,11,
Tulsa,U.S. Senate,Connie Johnson,DEM,720018,0,0,11,11,
Tulsa,U.S. Senate,Jim Rogers,DEM,720018,0,0,8,8,
Tulsa,Superintendent of Public Instruction,John Cox,DEM,720019,0,0,8,8,
Tulsa,Superintendent of Public Instruction,Freda Deskin,DEM,720019,0,0,7,7,
Tulsa,U.S. Senate,Connie Johnson,DEM,720019,0,0,11,11,
Tulsa,U.S. Senate,Jim Rogers,DEM,720019,0,0,5,5,
Tulsa,Superintendent of Public Instruction,John Cox,DEM,720020,0,0,12,12,
Tulsa,Superintendent of Public Instruction,Freda Deskin,DEM,720020,0,0,9,9,
Tulsa,U.S. Senate,Connie Johnson,DEM,720020,0,0,18,18,
Tulsa,U.S. Senate,Jim Rogers,DEM,720020,0,0,3,3,
Tulsa,Superintendent of Public Instruction,John Cox,DEM,720021,0,0,1,1,
Tulsa,Superintendent of Public Instruction,Freda Deskin,DEM,720021,0,0,0,0,
Tulsa,U.S. Senate,Connie Johnson,DEM,720021,0,0,0,0,
Tulsa,U.S. Senate,Jim Rogers,DEM,720021,0,0,1,1,
Tulsa,Superintendent of Public Instruction,John Cox,DEM,720022,0,0,17,17,
Tulsa,Superintendent of Public Instruction,Freda Deskin,DEM,720022,0,0,14,14,
Tulsa,U.S. Senate,Connie Johnson,DEM,720022,0,0,19,19,
Tulsa,U.S. Senate,Jim Rogers,DEM,720022,0,0,12,12,
Tulsa,Superintendent of Public Instruction,John Cox,DEM,720023,0,0,8,8,
Tulsa,Superintendent of Public Instruction,Freda Deskin,DEM,720023,0,0,1,1,
Tulsa,U.S. Senate,Connie Johnson,DEM,720023,0,0,3,3,
Tulsa,U.S. Senate,Jim Rogers,DEM,720023,0,0,6,6,
Tulsa,Superintendent of Public Instruction,John Cox,DEM,720024,0,0,23,23,
Tulsa,Superintendent of Public Instruction,Freda Deskin,DEM,720024,0,0,12,12,
Tulsa,U.S. Senate,Connie Johnson,DEM,720024,0,0,24,24,
Tulsa,U.S. Senate,Jim Rogers,DEM,720024,0,0,11,11,
Tulsa,Superintendent of Public Instruction,John Cox,DEM,720025,0,0,14,14,
Tulsa,Superintendent of Public Instruction,Freda Deskin,DEM,720025,0,0,5,5,
Tulsa,U.S. Senate,Connie Johnson,DEM,720025,0,0,11,11,
Tulsa,U.S. Senate,Jim Rogers,DEM,720025,0,0,8,8,
Tulsa,Superintendent of Public Instruction,John Cox,DEM,720026,0,0,11,11,
Tulsa,Superintendent of Public Instruction,Freda Deskin,DEM,720026,0,0,8,8,
Tulsa,U.S. Senate,Connie Johnson,DEM,720026,0,0,11,11,
Tulsa,U.S. Senate,Jim Rogers,DEM,720026,0,0,8,8,
Tulsa,Superintendent of Public Instruction,John Cox,DEM,720027,0,0,13,13,
Tulsa,Superintendent of Public Instruction,Freda Deskin,DEM,720027,0,0,2,2,
Tulsa,U.S. Senate,Connie Johnson,DEM,720027,0,0,9,9,
Tulsa,U.S. Senate,Jim Rogers,DEM,720027,0,0,6,6,
Tulsa,Superintendent of Public Instruction,John Cox,DEM,720028,0,0,18,18,
Tulsa,Superintendent of Public Instruction,Freda Deskin,DEM,720028,0,0,14,14,
Tulsa,U.S. Senate,Connie Johnson,DEM,720028,0,0,17,17,
Tulsa,U.S. Senate,Jim Rogers,DEM,720028,0,0,15,15,
Tulsa,Superintendent of Public Instruction,John Cox,DEM,720029,0,0,19,19,
Tulsa,Superintendent of Public Instruction,Freda Deskin,DEM,720029,0,0,10,10,
Tulsa,U.S. Senate,Connie Johnson,DEM,720029,0,0,17,17,
Tulsa,U.S. Senate,Jim Rogers,DEM,720029,0,0,12,12,
Tulsa,Superintendent of Public Instruction,John Cox,DEM,720030,0,0,8,8,
Tulsa,Superintendent of Public Instruction,Freda Deskin,DEM,720030,0,0,20,20,
Tulsa,U.S. Senate,Connie Johnson,DEM,720030,0,0,24,24,
Tulsa,U.S. Senate,Jim Rogers,DEM,720030,0,0,4,4,
Tulsa,Superintendent of Public Instruction,John Cox,DEM,720031,0,0,7,7,
Tulsa,Superintendent of Public Instruction,Freda Deskin,DEM,720031,0,0,4,4,
Tulsa,U.S. Senate,Connie Johnson,DEM,720031,0,0,8,8,
Tulsa,U.S. Senate,Jim Rogers,DEM,720031,0,0,4,4,
Tulsa,Superintendent of Public Instruction,John Cox,DEM,720032,0,0,13,13,
Tulsa,Superintendent of Public Instruction,Freda Deskin,DEM,720032,0,0,14,14,
Tulsa,U.S. Senate,Connie Johnson,DEM,720032,0,0,24,24,
Tulsa,U.S. Senate,Jim Rogers,DEM,720032,0,0,3,3,
Tulsa,Superintendent of Public Instruction,John Cox,DEM,720033,0,0,5,5,
Tulsa,Superintendent of Public Instruction,Freda Deskin,DEM,720033,0,0,6,6,
Tulsa,U.S. Senate,Connie Johnson,DEM,720033,0,0,12,12,
Tulsa,U.S. Senate,Jim Rogers,DEM,720033,0,0,0,0,
Tulsa,Superintendent of Public Instruction,John Cox,DEM,720034,0,0,9,9,
Tulsa,Superintendent of Public Instruction,Freda Deskin,DEM,720034,0,0,9,9,
Tulsa,U.S. Senate,Connie Johnson,DEM,720034,0,0,17,17,
Tulsa,U.S. Senate,Jim Rogers,DEM,720034,0,0,1,1,
Tulsa,Superintendent of Public Instruction,John Cox,DEM,720035,0,0,37,37,
Tulsa,Superintendent of Public Instruction,Freda Deskin,DEM,720035,0,0,22,22,
Tulsa,U.S. Senate,Connie Johnson,DEM,720035,0,0,43,43,
Tulsa,U.S. Senate,Jim Rogers,DEM,720035,0,0,16,16,
Tulsa,Superintendent of Public Instruction,John Cox,DEM,720036,0,0,35,35,
Tulsa,Superintendent of Public Instruction,Freda Deskin,DEM,720036,0,0,19,19,
Tulsa,U.S. Senate,Connie Johnson,DEM,720036,0,0,44,44,
Tulsa,U.S. Senate,Jim Rogers,DEM,720036,0,0,10,10,
Tulsa,Superintendent of Public Instruction,John Cox,DEM,720037,0,0,10,10,
Tulsa,Superintendent of Public Instruction,Freda Deskin,DEM,720037,0,0,8,8,
Tulsa,U.S. Senate,Connie Johnson,DEM,720037,0,0,13,13,
Tulsa,U.S. Senate,Jim Rogers,DEM,720037,0,0,4,4,
Tulsa,Superintendent of Public Instruction,John Cox,DEM,720038,0,0,10,10,
Tulsa,Superintendent of Public Instruction,Freda Deskin,DEM,720038,0,0,7,7,
Tulsa,U.S. Senate,Connie Johnson,DEM,720038,0,0,10,10,
Tulsa,U.S. Senate,Jim Rogers,DEM,720038,0,0,6,6,
Tulsa,Superintendent of Public Instruction,John Cox,DEM,720039,0,0,25,25,
Tulsa,Superintendent of Public Instruction,Freda Deskin,DEM,720039,0,0,19,19,
Tulsa,U.S. Senate,Connie Johnson,DEM,720039,0,0,31,31,
Tulsa,U.S. Senate,Jim Rogers,DEM,720039,0,0,13,13,
Tulsa,Superintendent of Public Instruction,John Cox,DEM,720040,0,0,8,8,
Tulsa,Superintendent of Public Instruction,Freda Deskin,DEM,720040,0,0,3,3,
Tulsa,U.S. Senate,Connie Johnson,DEM,720040,0,0,9,9,
Tulsa,U.S. Senate,Jim Rogers,DEM,720040,0,0,2,2,
Tulsa,Superintendent of Public Instruction,John Cox,DEM,720041,0,0,9,9,
Tulsa,Superintendent of Public Instruction,Freda Deskin,DEM,720041,0,0,6,6,
Tulsa,U.S. Senate,Connie Johnson,DEM,720041,0,0,9,9,
Tulsa,U.S. Senate,Jim Rogers,DEM,720041,0,0,6,6,
Tulsa,Superintendent of Public Instruction,John Cox,DEM,720042,0,0,7,7,
Tulsa,Superintendent of Public Instruction,Freda Deskin,DEM,720042,0,0,7,7,
Tulsa,U.S. Senate,Connie Johnson,DEM,720042,0,0,8,8,
Tulsa,U.S. Senate,Jim Rogers,DEM,720042,0,0,6,6,
Tulsa,Superintendent of Public Instruction,John Cox,DEM,720043,0,0,16,16,
Tulsa,Superintendent of Public Instruction,Freda Deskin,DEM,720043,0,0,4,4,
Tulsa,U.S. Senate,Connie Johnson,DEM,720043,0,0,11,11,
Tulsa,U.S. Senate,Jim Rogers,DEM,720043,0,0,9,9,
Tulsa,Superintendent of Public Instruction,John Cox,DEM,720044,0,0,15,15,
Tulsa,Superintendent of Public Instruction,Freda Deskin,DEM,720044,0,0,5,5,
Tulsa,U.S. Senate,Connie Johnson,DEM,720044,0,0,15,15,
Tulsa,U.S. Senate,Jim Rogers,DEM,720044,0,0,5,5,
Tulsa,Superintendent of Public Instruction,John Cox,DEM,720045,0,0,0,0,
Tulsa,Superintendent of Public Instruction,Freda Deskin,DEM,720045,0,0,0,0,
Tulsa,U.S. Senate,Connie Johnson,DEM,720045,0,0,0,0,
Tulsa,U.S. Senate,Jim Rogers,DEM,720045,0,0,0,0,
Tulsa,Superintendent of Public Instruction,John Cox,DEM,720046,0,0,38,38,
Tulsa,Superintendent of Public Instruction,Freda Deskin,DEM,720046,0,0,48,48,
Tulsa,U.S. Senate,Connie Johnson,DEM,720046,0,0,74,74,
Tulsa,U.S. Senate,Jim Rogers,DEM,720046,0,0,11,11,
Tulsa,Superintendent of Public Instruction,John Cox,DEM,720047,0,0,3,3,
Tulsa,Superintendent of Public Instruction,Freda Deskin,DEM,720047,0,0,4,4,
Tulsa,U.S. Senate,Connie Johnson,DEM,720047,0,0,5,5,
Tulsa,U.S. Senate,Jim Rogers,DEM,720047,0,0,2,2,
Tulsa,Superintendent of Public Instruction,John Cox,DEM,720048,0,0,29,29,
Tulsa,Superintendent of Public Instruction,Freda Deskin,DEM,720048,0,0,33,33,
Tulsa,U.S. Senate,Connie Johnson,DEM,720048,0,0,51,51,
Tulsa,U.S. Senate,Jim Rogers,DEM,720048,0,0,10,10,
Tulsa,Superintendent of Public Instruction,John Cox,DEM,720049,0,0,7,7,
Tulsa,Superintendent of Public Instruction,Freda Deskin,DEM,720049,0,0,14,14,
Tulsa,U.S. Senate,Connie Johnson,DEM,720049,0,0,17,17,
Tulsa,U.S. Senate,Jim Rogers,DEM,720049,0,0,4,4,
Tulsa,Superintendent of Public Instruction,John Cox,DEM,720050,0,0,13,13,
Tulsa,Superintendent of Public Instruction,Freda Deskin,DEM,720050,0,0,17,17,
Tulsa,U.S. Senate,Connie Johnson,DEM,720050,0,0,23,23,
Tulsa,U.S. Senate,Jim Rogers,DEM,720050,0,0,8,8,
Tulsa,Superintendent of Public Instruction,John Cox,DEM,720051,0,0,21,21,
Tulsa,Superintendent of Public Instruction,Freda Deskin,DEM,720051,0,0,22,22,
Tulsa,U.S. Senate,Connie Johnson,DEM,720051,0,0,36,36,
Tulsa,U.S. Senate,Jim Rogers,DEM,720051,0,0,7,7,
Tulsa,Superintendent of Public Instruction,John Cox,DEM,720052,0,0,47,47,
Tulsa,Superintendent of Public Instruction,Freda Deskin,DEM,720052,0,0,47,47,
Tulsa,U.S. Senate,Connie Johnson,DEM,720052,0,0,83,83,
Tulsa,U.S. Senate,Jim Rogers,DEM,720052,0,0,11,11,
Tulsa,Superintendent of Public Instruction,John Cox,DEM,720053,0,0,24,24,
Tulsa,Superintendent of Public Instruction,Freda Deskin,DEM,720053,0,0,18,18,
Tulsa,U.S. Senate,Connie Johnson,DEM,720053,0,0,33,33,
Tulsa,U.S. Senate,Jim Rogers,DEM,720053,0,0,10,10,
Tulsa,Superintendent of Public Instruction,John Cox,DEM,720054,0,0,41,41,
Tulsa,Superintendent of Public Instruction,Freda Deskin,DEM,720054,0,0,32,32,
Tulsa,U.S. Senate,Connie Johnson,DEM,720054,0,0,60,60,
Tulsa,U.S. Senate,Jim Rogers,DEM,720054,0,0,14,14,
Tulsa,Superintendent of Public Instruction,John Cox,DEM,720055,0,0,11,11,
Tulsa,Superintendent of Public Instruction,Freda Deskin,DEM,720055,0,0,10,10,
Tulsa,U.S. Senate,Connie Johnson,DEM,720055,0,0,14,14,
Tulsa,U.S. Senate,Jim Rogers,DEM,720055,0,0,6,6,
Tulsa,Superintendent of Public Instruction,John Cox,DEM,720056,0,0,16,16,
Tulsa,Superintendent of Public Instruction,Freda Deskin,DEM,720056,0,0,19,19,
Tulsa,U.S. Senate,Connie Johnson,DEM,720056,0,0,27,27,
Tulsa,U.S. Senate,Jim Rogers,DEM,720056,0,0,7,7,
Tulsa,Superintendent of Public Instruction,John Cox,DEM,720057,0,0,4,4,
Tulsa,Superintendent of Public Instruction,Freda Deskin,DEM,720057,0,0,7,7,
Tulsa,U.S. Senate,Connie Johnson,DEM,720057,0,0,10,10,
Tulsa,U.S. Senate,Jim Rogers,DEM,720057,0,0,1,1,
Tulsa,Superintendent of Public Instruction,John Cox,DEM,720058,0,0,19,19,
Tulsa,Superintendent of Public Instruction,Freda Deskin,DEM,720058,0,0,11,11,
Tulsa,U.S. Senate,Connie Johnson,DEM,720058,0,0,25,25,
Tulsa,U.S. Senate,Jim Rogers,DEM,720058,0,0,5,5,
Tulsa,Superintendent of Public Instruction,John Cox,DEM,720059,0,0,14,14,
Tulsa,Superintendent of Public Instruction,Freda Deskin,DEM,720059,0,0,10,10,
Tulsa,U.S. Senate,Connie Johnson,DEM,720059,0,0,18,18,
Tulsa,U.S. Senate,Jim Rogers,DEM,720059,0,0,5,5,
Tulsa,Superintendent of Public Instruction,John Cox,DEM,720060,0,0,14,14,
Tulsa,Superintendent of Public Instruction,Freda Deskin,DEM,720060,0,0,12,12,
Tulsa,U.S. Senate,Connie Johnson,DEM,720060,0,0,15,15,
Tulsa,U.S. Senate,Jim Rogers,DEM,720060,0,0,11,11,
Tulsa,Superintendent of Public Instruction,John Cox,DEM,720061,0,0,19,19,
Tulsa,Superintendent of Public Instruction,Freda Deskin,DEM,720061,0,0,10,10,
Tulsa,U.S. Senate,Connie Johnson,DEM,720061,0,0,22,22,
Tulsa,U.S. Senate,Jim Rogers,DEM,720061,0,0,6,6,
Tulsa,Superintendent of Public Instruction,John Cox,DEM,720062,0,0,47,47,
Tulsa,Superintendent of Public Instruction,Freda Deskin,DEM,720062,0,0,61,61,
Tulsa,U.S. Senate,Connie Johnson,DEM,720062,0,0,97,97,
Tulsa,U.S. Senate,Jim Rogers,DEM,720062,0,0,13,13,
Tulsa,Superintendent of Public Instruction,John Cox,DEM,720063,0,0,14,14,
Tulsa,Superintendent of Public Instruction,Freda Deskin,DEM,720063,0,0,16,16,
Tulsa,U.S. Senate,Connie Johnson,DEM,720063,0,0,23,23,
Tulsa,U.S. Senate,Jim Rogers,DEM,720063,0,0,7,7,
Tulsa,Superintendent of Public Instruction,John Cox,DEM,720064,0,0,14,14,
Tulsa,Superintendent of Public Instruction,Freda Deskin,DEM,720064,0,0,17,17,
Tulsa,U.S. Senate,Connie Johnson,DEM,720064,0,0,30,30,
Tulsa,U.S. Senate,Jim Rogers,DEM,720064,0,0,1,1,
Tulsa,Superintendent of Public Instruction,John Cox,DEM,720065,0,0,22,22,
Tulsa,Superintendent of Public Instruction,Freda Deskin,DEM,720065,0,0,28,28,
Tulsa,U.S. Senate,Connie Johnson,DEM,720065,0,0,41,41,
Tulsa,U.S. Senate,Jim Rogers,DEM,720065,0,0,9,9,
Tulsa,Superintendent of Public Instruction,John Cox,DEM,720066,0,0,28,28,
Tulsa,Superintendent of Public Instruction,Freda Deskin,DEM,720066,0,0,37,37,
Tulsa,U.S. Senate,Connie Johnson,DEM,720066,0,0,57,57,
Tulsa,U.S. Senate,Jim Rogers,DEM,720066,0,0,8,8,
Tulsa,Superintendent of Public Instruction,John Cox,DEM,720067,0,0,10,10,
Tulsa,Superintendent of Public Instruction,Freda Deskin,DEM,720067,0,0,16,16,
Tulsa,U.S. Senate,Connie Johnson,DEM,720067,0,0,24,24,
Tulsa,U.S. Senate,Jim Rogers,DEM,720067,0,0,1,1,
Tulsa,Superintendent of Public Instruction,John Cox,DEM,720068,0,0,19,19,
Tulsa,Superintendent of Public Instruction,Freda Deskin,DEM,720068,0,0,15,15,
Tulsa,U.S. Senate,Connie Johnson,DEM,720068,0,0,27,27,
Tulsa,U.S. Senate,Jim Rogers,DEM,720068,0,0,7,7,
Tulsa,Superintendent of Public Instruction,John Cox,DEM,720069,0,0,23,23,
Tulsa,Superintendent of Public Instruction,Freda Deskin,DEM,720069,0,0,36,36,
Tulsa,U.S. Senate,Connie Johnson,DEM,720069,0,0,44,44,
Tulsa,U.S. Senate,Jim Rogers,DEM,720069,0,0,13,13,
Tulsa,Superintendent of Public Instruction,John Cox,DEM,720070,0,0,8,8,
Tulsa,Superintendent of Public Instruction,Freda Deskin,DEM,720070,0,0,8,8,
Tulsa,U.S. Senate,Connie Johnson,DEM,720070,0,0,9,9,
Tulsa,U.S. Senate,Jim Rogers,DEM,720070,0,0,8,8,
Tulsa,Superintendent of Public Instruction,John Cox,DEM,720071,0,0,27,27,
Tulsa,Superintendent of Public Instruction,Freda Deskin,DEM,720071,0,0,48,48,
Tulsa,U.S. Senate,Connie Johnson,DEM,720071,0,0,67,67,
Tulsa,U.S. Senate,Jim Rogers,DEM,720071,0,0,7,7,
Tulsa,Superintendent of Public Instruction,John Cox,DEM,720072,0,0,18,18,
Tulsa,Superintendent of Public Instruction,Freda Deskin,DEM,720072,0,0,26,26,
Tulsa,U.S. Senate,Connie Johnson,DEM,720072,0,0,35,35,
Tulsa,U.S. Senate,Jim Rogers,DEM,720072,0,0,7,7,
Tulsa,Superintendent of Public Instruction,John Cox,DEM,720073,0,0,14,14,
Tulsa,Superintendent of Public Instruction,Freda Deskin,DEM,720073,0,0,27,27,
Tulsa,U.S. Senate,Connie Johnson,DEM,720073,0,0,34,34,
Tulsa,U.S. Senate,Jim Rogers,DEM,720073,0,0,7,7,
Tulsa,Superintendent of Public Instruction,John Cox,DEM,720074,0,0,27,27,
Tulsa,Superintendent of Public Instruction,Freda Deskin,DEM,720074,0,0,31,31,
Tulsa,U.S. Senate,Connie Johnson,DEM,720074,0,0,42,42,
Tulsa,U.S. Senate,Jim Rogers,DEM,720074,0,0,13,13,
Tulsa,Superintendent of Public Instruction,John Cox,DEM,720075,0,0,13,13,
Tulsa,Superintendent of Public Instruction,Freda Deskin,DEM,720075,0,0,27,27,
Tulsa,U.S. Senate,Connie Johnson,DEM,720075,0,0,34,34,
Tulsa,U.S. Senate,Jim Rogers,DEM,720075,0,0,7,7,
Tulsa,Superintendent of Public Instruction,John Cox,DEM,720076,0,0,26,26,
Tulsa,Superintendent of Public Instruction,Freda Deskin,DEM,720076,0,0,19,19,
Tulsa,U.S. Senate,Connie Johnson,DEM,720076,0,0,33,33,
Tulsa,U.S. Senate,Jim Rogers,DEM,720076,0,0,10,10,
Tulsa,Superintendent of Public Instruction,John Cox,DEM,720077,0,0,26,26,
Tulsa,Superintendent of Public Instruction,Freda Deskin,DEM,720077,0,0,29,29,
Tulsa,U.S. Senate,Connie Johnson,DEM,720077,0,0,43,43,
Tulsa,U.S. Senate,Jim Rogers,DEM,720077,0,0,13,13,
Tulsa,Superintendent of Public Instruction,John Cox,DEM,720078,0,0,22,22,
Tulsa,Superintendent of Public Instruction,Freda Deskin,DEM,720078,0,0,30,30,
Tulsa,U.S. Senate,Connie Johnson,DEM,720078,0,0,44,44,
Tulsa,U.S. Senate,Jim Rogers,DEM,720078,0,0,8,8,
Tulsa,Superintendent of Public Instruction,John Cox,DEM,720079,0,0,39,39,
Tulsa,Superintendent of Public Instruction,Freda Deskin,DEM,720079,0,0,31,31,
Tulsa,U.S. Senate,Connie Johnson,DEM,720079,0,0,49,49,
Tulsa,U.S. Senate,Jim Rogers,DEM,720079,0,0,21,21,
Tulsa,Superintendent of Public Instruction,John Cox,DEM,720080,0,0,4,4,
Tulsa,Superintendent of Public Instruction,Freda Deskin,DEM,720080,0,0,4,4,
Tulsa,U.S. Senate,Connie Johnson,DEM,720080,0,0,6,6,
Tulsa,U.S. Senate,Jim Rogers,DEM,720080,0,0,1,1,
Tulsa,Superintendent of Public Instruction,John Cox,DEM,720081,0,0,36,36,
Tulsa,Superintendent of Public Instruction,Freda Deskin,DEM,720081,0,0,52,52,
Tulsa,U.S. Senate,Connie Johnson,DEM,720081,0,0,72,72,
Tulsa,U.S. Senate,Jim Rogers,DEM,720081,0,0,16,16,
Tulsa,Superintendent of Public Instruction,John Cox,DEM,720082,0,0,21,21,
Tulsa,Superintendent of Public Instruction,Freda Deskin,DEM,720082,0,0,12,12,
Tulsa,U.S. Senate,Connie Johnson,DEM,720082,0,0,25,25,
Tulsa,U.S. Senate,Jim Rogers,DEM,720082,0,0,7,7,
Tulsa,Superintendent of Public Instruction,John Cox,DEM,720083,0,0,18,18,
Tulsa,Superintendent of Public Instruction,Freda Deskin,DEM,720083,0,0,11,11,
Tulsa,U.S. Senate,Connie Johnson,DEM,720083,0,0,22,22,
Tulsa,U.S. Senate,Jim Rogers,DEM,720083,0,0,6,6,
Tulsa,Superintendent of Public Instruction,John Cox,DEM,720084,0,0,12,12,
Tulsa,Superintendent of Public Instruction,Freda Deskin,DEM,720084,0,0,23,23,
Tulsa,U.S. Senate,Connie Johnson,DEM,720084,0,0,29,29,
Tulsa,U.S. Senate,Jim Rogers,DEM,720084,0,0,7,7,
Tulsa,Superintendent of Public Instruction,John Cox,DEM,720085,0,0,15,15,
Tulsa,Superintendent of Public Instruction,Freda Deskin,DEM,720085,0,0,8,8,
Tulsa,U.S. Senate,Connie Johnson,DEM,720085,0,0,21,21,
Tulsa,U.S. Senate,Jim Rogers,DEM,720085,0,0,2,2,
Tulsa,Superintendent of Public Instruction,John Cox,DEM,720086,0,0,20,20,
Tulsa,Superintendent of Public Instruction,Freda Deskin,DEM,720086,0,0,13,13,
Tulsa,U.S. Senate,Connie Johnson,DEM,720086,0,0,22,22,
Tulsa,U.S. Senate,Jim Rogers,DEM,720086,0,0,11,11,
Tulsa,Superintendent of Public Instruction,John Cox,DEM,720087,0,0,28,28,
Tulsa,Superintendent of Public Instruction,Freda Deskin,DEM,720087,0,0,13,13,
Tulsa,U.S. Senate,Connie Johnson,DEM,720087,0,0,28,28,
Tulsa,U.S. Senate,Jim Rogers,DEM,720087,0,0,12,12,
Tulsa,Superintendent of Public Instruction,John Cox,DEM,720088,0,0,6,6,
Tulsa,Superintendent of Public Instruction,Freda Deskin,DEM,720088,0,0,4,4,
Tulsa,U.S. Senate,Connie Johnson,DEM,720088,0,0,9,9,
Tulsa,U.S. Senate,Jim Rogers,DEM,720088,0,0,1,1,
Tulsa,Superintendent of Public Instruction,John Cox,DEM,720089,0,0,15,15,
Tulsa,Superintendent of Public Instruction,Freda Deskin,DEM,720089,0,0,7,7,
Tulsa,U.S. Senate,Connie Johnson,DEM,720089,0,0,17,17,
Tulsa,U.S. Senate,Jim Rogers,DEM,720089,0,0,5,5,
Tulsa,Superintendent of Public Instruction,John Cox,DEM,720090,0,0,1,1,
Tulsa,Superintendent of Public Instruction,Freda Deskin,DEM,720090,0,0,3,3,
Tulsa,U.S. Senate,Connie Johnson,DEM,720090,0,0,1,1,
Tulsa,U.S. Senate,Jim Rogers,DEM,720090,0,0,3,3,
Tulsa,Superintendent of Public Instruction,John Cox,DEM,720091,0,0,6,6,
Tulsa,Superintendent of Public Instruction,Freda Deskin,DEM,720091,0,0,14,14,
Tulsa,U.S. Senate,Connie Johnson,DEM,720091,0,0,19,19,
Tulsa,U.S. Senate,Jim Rogers,DEM,720091,0,0,1,1,
Tulsa,Superintendent of Public Instruction,John Cox,DEM,720092,0,0,16,16,
Tulsa,Superintendent of Public Instruction,Freda Deskin,DEM,720092,0,0,9,9,
Tulsa,U.S. Senate,Connie Johnson,DEM,720092,0,0,21,21,
Tulsa,U.S. Senate,Jim Rogers,DEM,720092,0,0,4,4,
Tulsa,Superintendent of Public Instruction,John Cox,DEM,720093,0,0,13,13,
Tulsa,Superintendent of Public Instruction,Freda Deskin,DEM,720093,0,0,6,6,
Tulsa,U.S. Senate,Connie Johnson,DEM,720093,0,0,12,12,
Tulsa,U.S. Senate,Jim Rogers,DEM,720093,0,0,7,7,
Tulsa,Superintendent of Public Instruction,John Cox,DEM,720094,0,0,22,22,
Tulsa,Superintendent of Public Instruction,Freda Deskin,DEM,720094,0,0,10,10,
Tulsa,U.S. Senate,Connie Johnson,DEM,720094,0,0,21,21,
Tulsa,U.S. Senate,Jim Rogers,DEM,720094,0,0,11,11,
Tulsa,Superintendent of Public Instruction,John Cox,DEM,720095,0,0,16,16,
Tulsa,Superintendent of Public Instruction,Freda Deskin,DEM,720095,0,0,15,15,
Tulsa,U.S. Senate,Connie Johnson,DEM,720095,0,0,24,24,
Tulsa,U.S. Senate,Jim Rogers,DEM,720095,0,0,7,7,
Tulsa,Superintendent of Public Instruction,John Cox,DEM,720096,0,0,21,21,
Tulsa,Superintendent of Public Instruction,Freda Deskin,DEM,720096,0,0,8,8,
Tulsa,U.S. Senate,Connie Johnson,DEM,720096,0,0,22,22,
Tulsa,U.S. Senate,Jim Rogers,DEM,720096,0,0,7,7,
Tulsa,Superintendent of Public Instruction,John Cox,DEM,720097,0,0,17,17,
Tulsa,Superintendent of Public Instruction,Freda Deskin,DEM,720097,0,0,20,20,
Tulsa,U.S. Senate,Connie Johnson,DEM,720097,0,0,28,28,
Tulsa,U.S. Senate,Jim Rogers,DEM,720097,0,0,8,8,
Tulsa,Superintendent of Public Instruction,John Cox,DEM,720098,0,0,21,21,
Tulsa,Superintendent of Public Instruction,Freda Deskin,DEM,720098,0,0,9,9,
Tulsa,U.S. Senate,Connie Johnson,DEM,720098,0,0,20,20,
Tulsa,U.S. Senate,Jim Rogers,DEM,720098,0,0,11,11,
Tulsa,Superintendent of Public Instruction,John Cox,DEM,720099,0,0,6,6,
Tulsa,Superintendent of Public Instruction,Freda Deskin,DEM,720099,0,0,9,9,
Tulsa,U.S. Senate,Connie Johnson,DEM,720099,0,0,11,11,
Tulsa,U.S. Senate,Jim Rogers,DEM,720099,0,0,3,3,
Tulsa,Superintendent of Public Instruction,John Cox,DEM,720100,0,0,2,2,
Tulsa,Superintendent of Public Instruction,Freda Deskin,DEM,720100,0,0,4,4,
Tulsa,U.S. Senate,Connie Johnson,DEM,720100,0,0,5,5,
Tulsa,U.S. Senate,Jim Rogers,DEM,720100,0,0,1,1,
Tulsa,Superintendent of Public Instruction,John Cox,DEM,720101,0,0,18,18,
Tulsa,Superintendent of Public Instruction,Freda Deskin,DEM,720101,0,0,12,12,
Tulsa,U.S. Senate,Connie Johnson,DEM,720101,0,0,22,22,
Tulsa,U.S. Senate,Jim Rogers,DEM,720101,0,0,8,8,
Tulsa,Superintendent of Public Instruction,John Cox,DEM,720102,0,0,18,18,
Tulsa,Superintendent of Public Instruction,Freda Deskin,DEM,720102,0,0,15,15,
Tulsa,U.S. Senate,Connie Johnson,DEM,720102,0,0,23,23,
Tulsa,U.S. Senate,Jim Rogers,DEM,720102,0,0,10,10,
Tulsa,Superintendent of Public Instruction,John Cox,DEM,720103,0,0,8,8,
Tulsa,Superintendent of Public Instruction,Freda Deskin,DEM,720103,0,0,4,4,
Tulsa,U.S. Senate,Connie Johnson,DEM,720103,0,0,7,7,
Tulsa,U.S. Senate,Jim Rogers,DEM,720103,0,0,5,5,
Tulsa,Superintendent of Public Instruction,John Cox,DEM,720104,0,0,8,8,
Tulsa,Superintendent of Public Instruction,Freda Deskin,DEM,720104,0,0,9,9,
Tulsa,U.S. Senate,Connie Johnson,DEM,720104,0,0,11,11,
Tulsa,U.S. Senate,Jim Rogers,DEM,720104,0,0,6,6,
Tulsa,Superintendent of Public Instruction,John Cox,DEM,720105,0,0,9,9,
Tulsa,Superintendent of Public Instruction,Freda Deskin,DEM,720105,0,0,10,10,
Tulsa,U.S. Senate,Connie Johnson,DEM,720105,0,0,18,18,
Tulsa,U.S. Senate,Jim Rogers,DEM,720105,0,0,1,1,
Tulsa,Superintendent of Public Instruction,John Cox,DEM,720106,0,0,9,9,
Tulsa,Superintendent of Public Instruction,Freda Deskin,DEM,720106,0,0,5,5,
Tulsa,U.S. Senate,Connie Johnson,DEM,720106,0,0,8,8,
Tulsa,U.S. Senate,Jim Rogers,DEM,720106,0,0,6,6,
Tulsa,Superintendent of Public Instruction,John Cox,DEM,720107,0,0,28,28,
Tulsa,Superintendent of Public Instruction,Freda Deskin,DEM,720107,0,0,29,29,
Tulsa,U.S. Senate,Connie Johnson,DEM,720107,0,0,43,43,
Tulsa,U.S. Senate,Jim Rogers,DEM,720107,0,0,15,15,
Tulsa,Superintendent of Public Instruction,John Cox,DEM,720108,0,0,18,18,
Tulsa,Superintendent of Public Instruction,Freda Deskin,DEM,720108,0,0,16,16,
Tulsa,U.S. Senate,Connie Johnson,DEM,720108,0,0,24,24,
Tulsa,U.S. Senate,Jim Rogers,DEM,720108,0,0,10,10,
Tulsa,Superintendent of Public Instruction,John Cox,DEM,720109,0,0,14,14,
Tulsa,Superintendent of Public Instruction,Freda Deskin,DEM,720109,0,0,18,18,
Tulsa,U.S. Senate,Connie Johnson,DEM,720109,0,0,27,27,
Tulsa,U.S. Senate,Jim Rogers,DEM,720109,0,0,4,4,
Tulsa,Superintendent of Public Instruction,John Cox,DEM,720110,0,0,13,13,
Tulsa,Superintendent of Public Instruction,Freda Deskin,DEM,720110,0,0,13,13,
Tulsa,U.S. Senate,Connie Johnson,DEM,720110,0,0,18,18,
Tulsa,U.S. Senate,Jim Rogers,DEM,720110,0,0,8,8,
Tulsa,Superintendent of Public Instruction,John Cox,DEM,720111,0,0,14,14,
Tulsa,Superintendent of Public Instruction,Freda Deskin,DEM,720111,0,0,20,20,
Tulsa,U.S. Senate,Connie Johnson,DEM,720111,0,0,24,24,
Tulsa,U.S. Senate,Jim Rogers,DEM,720111,0,0,10,10,
Tulsa,Superintendent of Public Instruction,John Cox,DEM,720112,0,0,5,5,
Tulsa,Superintendent of Public Instruction,Freda Deskin,DEM,720112,0,0,7,7,
Tulsa,U.S. Senate,Connie Johnson,DEM,720112,0,0,11,11,
Tulsa,U.S. Senate,Jim Rogers,DEM,720112,0,0,1,1,
Tulsa,Superintendent of Public Instruction,John Cox,DEM,720113,0,0,12,12,
Tulsa,Superintendent of Public Instruction,Freda Deskin,DEM,720113,0,0,9,9,
Tulsa,U.S. Senate,Connie Johnson,DEM,720113,0,0,12,12,
Tulsa,U.S. Senate,Jim Rogers,DEM,720113,0,0,6,6,
Tulsa,State House,Melissa Abdo,REP,720113,0,0,37,37,69
Tulsa,State House,Chuck Strohm,REP,720113,0,0,45,45,69
Tulsa,Superintendent of Public Instruction,John Cox,DEM,720114,0,0,11,11,
Tulsa,Superintendent of Public Instruction,Freda Deskin,DEM,720114,0,0,11,11,
Tulsa,U.S. Senate,Connie Johnson,DEM,720114,0,0,11,11,
Tulsa,U.S. Senate,Jim Rogers,DEM,720114,0,0,9,9,
Tulsa,Superintendent of Public Instruction,John Cox,DEM,720115,0,0,8,8,
Tulsa,Superintendent of Public Instruction,Freda Deskin,DEM,720115,0,0,12,12,
Tulsa,U.S. Senate,Connie Johnson,DEM,720115,0,0,18,18,
Tulsa,U.S. Senate,Jim Rogers,DEM,720115,0,0,2,2,
Tulsa,Superintendent of Public Instruction,John Cox,DEM,720116,0,0,21,21,
Tulsa,Superintendent of Public Instruction,Freda Deskin,DEM,720116,0,0,21,21,
Tulsa,U.S. Senate,Connie Johnson,DEM,720116,0,0,31,31,
Tulsa,U.S. Senate,Jim Rogers,DEM,720116,0,0,10,10,
Tulsa,State House,Melissa Abdo,REP,720116,0,0,100,100,69
Tulsa,State House,Chuck Strohm,REP,720116,0,0,111,111,69
Tulsa,Superintendent of Public Instruction,John Cox,DEM,720117,0,0,31,31,
Tulsa,Superintendent of Public Instruction,Freda Deskin,DEM,720117,0,0,34,34,
Tulsa,U.S. Senate,Connie Johnson,DEM,720117,0,0,56,56,
Tulsa,U.S. Senate,Jim Rogers,DEM,720117,0,0,10,10,
Tulsa,Superintendent of Public Instruction,John Cox,DEM,720118,0,0,11,11,
Tulsa,Superintendent of Public Instruction,Freda Deskin,DEM,720118,0,0,10,10,
Tulsa,U.S. Senate,Connie Johnson,DEM,720118,0,0,17,17,
Tulsa,U.S. Senate,Jim Rogers,DEM,720118,0,0,3,3,
Tulsa,Superintendent of Public Instruction,John Cox,DEM,720119,0,0,7,7,
Tulsa,Superintendent of Public Instruction,Freda Deskin,DEM,720119,0,0,20,20,
Tulsa,U.S. Senate,Connie Johnson,DEM,720119,0,0,23,23,
Tulsa,U.S. Senate,Jim Rogers,DEM,720119,0,0,4,4,
Tulsa,State House,Melissa Abdo,REP,720119,0,0,75,75,69
Tulsa,State House,Chuck Strohm,REP,720119,0,0,76,76,69
Tulsa,Superintendent of Public Instruction,John Cox,DEM,720120,0,0,8,8,
Tulsa,Superintendent of Public Instruction,Freda Deskin,DEM,720120,0,0,7,7,
Tulsa,U.S. Senate,Connie Johnson,DEM,720120,0,0,12,12,
Tulsa,U.S. Senate,Jim Rogers,DEM,720120,0,0,3,3,
Tulsa,Superintendent of Public Instruction,John Cox,DEM,720121,0,0,34,34,
Tulsa,Superintendent of Public Instruction,Freda Deskin,DEM,720121,0,0,33,33,
Tulsa,U.S. Senate,Connie Johnson,DEM,720121,0,0,55,55,
Tulsa,U.S. Senate,Jim Rogers,DEM,720121,0,0,12,12,
Tulsa,Superintendent of Public Instruction,John Cox,DEM,720122,0,0,8,8,
Tulsa,Superintendent of Public Instruction,Freda Deskin,DEM,720122,0,0,5,5,
Tulsa,U.S. Senate,Connie Johnson,DEM,720122,0,0,12,12,
Tulsa,U.S. Senate,Jim Rogers,DEM,720122,0,0,1,1,
Tulsa,Superintendent of Public Instruction,John Cox,DEM,720123,0,0,23,23,
Tulsa,Superintendent of Public Instruction,Freda Deskin,DEM,720123,0,0,20,20,
Tulsa,U.S. Senate,Connie Johnson,DEM,720123,0,0,35,35,
Tulsa,U.S. Senate,Jim Rogers,DEM,720123,0,0,9,9,
Tulsa,Superintendent of Public Instruction,John Cox,DEM,720124,0,0,20,20,
Tulsa,Superintendent of Public Instruction,Freda Deskin,DEM,720124,0,0,18,18,
Tulsa,U.S. Senate,Connie Johnson,DEM,720124,0,0,33,33,
Tulsa,U.S. Senate,Jim Rogers,DEM,720124,0,0,5,5,
Tulsa,Superintendent of Public Instruction,John Cox,DEM,720125,0,0,16,16,
Tulsa,Superintendent of Public Instruction,Freda Deskin,DEM,720125,0,0,18,18,
Tulsa,U.S. Senate,Connie Johnson,DEM,720125,0,0,28,28,
Tulsa,U.S. Senate,Jim Rogers,DEM,720125,0,0,6,6,
Tulsa,Superintendent of Public Instruction,John Cox,DEM,720126,0,0,10,10,
Tulsa,Superintendent of Public Instruction,Freda Deskin,DEM,720126,0,0,25,25,
Tulsa,U.S. Senate,Connie Johnson,DEM,720126,0,0,29,29,
Tulsa,U.S. Senate,Jim Rogers,DEM,720126,0,0,5,5,
Tulsa,Superintendent of Public Instruction,John Cox,DEM,720127,0,0,6,6,
Tulsa,Superintendent of Public Instruction,Freda Deskin,DEM,720127,0,0,5,5,
Tulsa,U.S. Senate,Connie Johnson,DEM,720127,0,0,7,7,
Tulsa,U.S. Senate,Jim Rogers,DEM,720127,0,0,4,4,
Tulsa,Superintendent of Public Instruction,John Cox,DEM,720128,0,0,13,13,
Tulsa,Superintendent of Public Instruction,Freda Deskin,DEM,720128,0,0,15,15,
Tulsa,U.S. Senate,Connie Johnson,DEM,720128,0,0,24,24,
Tulsa,U.S. Senate,Jim Rogers,DEM,720128,0,0,4,4,
Tulsa,Superintendent of Public Instruction,John Cox,DEM,720129,0,0,28,28,
Tulsa,Superintendent of Public Instruction,Freda Deskin,DEM,720129,0,0,14,14,
Tulsa,U.S. Senate,Connie Johnson,DEM,720129,0,0,37,37,
Tulsa,U.S. Senate,Jim Rogers,DEM,720129,0,0,4,4,
Tulsa,Superintendent of Public Instruction,John Cox,DEM,720130,0,0,28,28,
Tulsa,Superintendent of Public Instruction,Freda Deskin,DEM,720130,0,0,8,8,
Tulsa,U.S. Senate,Connie Johnson,DEM,720130,0,0,29,29,
Tulsa,U.S. Senate,Jim Rogers,DEM,720130,0,0,7,7,
Tulsa,Superintendent of Public Instruction,John Cox,DEM,720131,0,0,4,4,
Tulsa,Superintendent of Public Instruction,Freda Deskin,DEM,720131,0,0,2,2,
Tulsa,U.S. Senate,Connie Johnson,DEM,720131,0,0,6,6,
Tulsa,U.S. Senate,Jim Rogers,DEM,720131,0,0,0,0,
Tulsa,Superintendent of Public Instruction,John Cox,DEM,720132,0,0,23,23,
Tulsa,Superintendent of Public Instruction,Freda Deskin,DEM,720132,0,0,15,15,
Tulsa,U.S. Senate,Connie Johnson,DEM,720132,0,0,31,31,
Tulsa,U.S. Senate,Jim Rogers,DEM,720132,0,0,7,7,
Tulsa,Superintendent of Public Instruction,John Cox,DEM,720133,0,0,17,17,
Tulsa,Superintendent of Public Instruction,Freda Deskin,DEM,720133,0,0,5,5,
Tulsa,U.S. Senate,Connie Johnson,DEM,720133,0,0,17,17,
Tulsa,U.S. Senate,Jim Rogers,DEM,720133,0,0,5,5,
Tulsa,Superintendent of Public Instruction,John Cox,DEM,720134,0,0,12,12,
Tulsa,Superintendent of Public Instruction,Freda Deskin,DEM,720134,0,0,19,19,
Tulsa,U.S. Senate,Connie Johnson,DEM,720134,0,0,25,25,
Tulsa,U.S. Senate,Jim Rogers,DEM,720134,0,0,6,6,
Tulsa,Superintendent of Public Instruction,John Cox,DEM,720135,0,0,32,32,
Tulsa,Superintendent of Public Instruction,Freda Deskin,DEM,720135,0,0,16,16,
Tulsa,U.S. Senate,Connie Johnson,DEM,720135,0,0,33,33,
Tulsa,U.S. Senate,Jim Rogers,DEM,720135,0,0,14,14,
Tulsa,Superintendent of Public Instruction,John Cox,DEM,720136,0,0,10,10,
Tulsa,Superintendent of Public Instruction,Freda Deskin,DEM,720136,0,0,7,7,
Tulsa,U.S. Senate,Connie Johnson,DEM,720136,0,0,14,14,
Tulsa,U.S. Senate,Jim Rogers,DEM,720136,0,0,3,3,
Tulsa,Superintendent of Public Instruction,John Cox,DEM,720137,0,0,3,3,
Tulsa,Superintendent of Public Instruction,Freda Deskin,DEM,720137,0,0,10,10,
Tulsa,U.S. Senate,Connie Johnson,DEM,720137,0,0,13,13,
Tulsa,U.S. Senate,Jim Rogers,DEM,720137,0,0,0,0,
Tulsa,Superintendent of Public Instruction,John Cox,DEM,720138,0,0,4,4,
Tulsa,Superintendent of Public Instruction,Freda Deskin,DEM,720138,0,0,4,4,
Tulsa,U.S. Senate,Connie Johnson,DEM,720138,0,0,8,8,
Tulsa,U.S. Senate,Jim Rogers,DEM,720138,0,0,0,0,
Tulsa,Superintendent of Public Instruction,John Cox,DEM,720139,0,0,18,18,
Tulsa,Superintendent of Public Instruction,Freda Deskin,DEM,720139,0,0,14,14,
Tulsa,U.S. Senate,Connie Johnson,DEM,720139,0,0,22,22,
Tulsa,U.S. Senate,Jim Rogers,DEM,720139,0,0,9,9,
Tulsa,Superintendent of Public Instruction,John Cox,DEM,720140,0,0,13,13,
Tulsa,Superintendent of Public Instruction,Freda Deskin,DEM,720140,0,0,6,6,
Tulsa,U.S. Senate,Connie Johnson,DEM,720140,0,0,14,14,
Tulsa,U.S. Senate,Jim Rogers,DEM,720140,0,0,6,6,
Tulsa,Superintendent of Public Instruction,John Cox,DEM,720141,0,0,35,35,
Tulsa,Superintendent of Public Instruction,Freda Deskin,DEM,720141,0,0,16,16,
Tulsa,U.S. Senate,Connie Johnson,DEM,720141,0,0,33,33,
Tulsa,U.S. Senate,Jim Rogers,DEM,720141,0,0,17,17,
Tulsa,Superintendent of Public Instruction,John Cox,DEM,720142,0,0,18,18,
Tulsa,Superintendent of Public Instruction,Freda Deskin,DEM,720142,0,0,7,7,
Tulsa,U.S. Senate,Connie Johnson,DEM,720142,0,0,15,15,
Tulsa,U.S. Senate,Jim Rogers,DEM,720142,0,0,10,10,
Tulsa,Superintendent of Public Instruction,John Cox,DEM,720143,0,0,14,14,
Tulsa,Superintendent of Public Instruction,Freda Deskin,DEM,720143,0,0,7,7,
Tulsa,U.S. Senate,Connie Johnson,DEM,720143,0,0,9,9,
Tulsa,U.S. Senate,Jim Rogers,DEM,720143,0,0,12,12,
Tulsa,Superintendent of Public Instruction,John Cox,DEM,720144,0,0,24,24,
Tulsa,Superintendent of Public Instruction,Freda Deskin,DEM,720144,0,0,25,25,
Tulsa,U.S. Senate,Connie Johnson,DEM,720144,0,0,33,33,
Tulsa,U.S. Senate,Jim Rogers,DEM,720144,0,0,15,15,
Tulsa,Superintendent of Public Instruction,John Cox,DEM,720145,0,0,12,12,
Tulsa,Superintendent of Public Instruction,Freda Deskin,DEM,720145,0,0,9,9,
Tulsa,U.S. Senate,Connie Johnson,DEM,720145,0,0,15,15,
Tulsa,U.S. Senate,Jim Rogers,DEM,720145,0,0,5,5,
Tulsa,Superintendent of Public Instruction,John Cox,DEM,720146,0,0,15,15,
Tulsa,Superintendent of Public Instruction,Freda Deskin,DEM,720146,0,0,10,10,
Tulsa,U.S. Senate,Connie Johnson,DEM,720146,0,0,18,18,
Tulsa,U.S. Senate,Jim Rogers,DEM,720146,0,0,7,7,
Tulsa,Superintendent of Public Instruction,John Cox,DEM,720147,0,0,2,2,
Tulsa,Superintendent of Public Instruction,Freda Deskin,DEM,720147,0,0,11,11,
Tulsa,U.S. Senate,Connie Johnson,DEM,720147,0,0,13,13,
Tulsa,U.S. Senate,Jim Rogers,DEM,720147,0,0,0,0,
Tulsa,Superintendent of Public Instruction,John Cox,DEM,720148,0,0,12,12,
Tulsa,Superintendent of Public Instruction,Freda Deskin,DEM,720148,0,0,6,6,
Tulsa,U.S. Senate,Connie Johnson,DEM,720148,0,0,10,10,
Tulsa,U.S. Senate,Jim Rogers,DEM,720148,0,0,8,8,
Tulsa,Superintendent of Public Instruction,John Cox,DEM,720149,0,0,7,7,
Tulsa,Superintendent of Public Instruction,Freda Deskin,DEM,720149,0,0,16,16,
Tulsa,U.S. Senate,Connie Johnson,DEM,720149,0,0,13,13,
Tulsa,U.S. Senate,Jim Rogers,DEM,720149,0,0,9,9,
Tulsa,Superintendent of Public Instruction,John Cox,DEM,720150,0,0,29,29,
Tulsa,Superintendent of Public Instruction,Freda Deskin,DEM,720150,0,0,16,16,
Tulsa,U.S. Senate,Connie Johnson,DEM,720150,0,0,34,34,
Tulsa,U.S. Senate,Jim Rogers,DEM,720150,0,0,11,11,
Tulsa,Superintendent of Public Instruction,John Cox,DEM,720151,0,0,5,5,
Tulsa,Superintendent of Public Instruction,Freda Deskin,DEM,720151,0,0,2,2,
Tulsa,U.S. Senate,Connie Johnson,DEM,720151,0,0,5,5,
Tulsa,U.S. Senate,Jim Rogers,DEM,720151,0,0,2,2,
Tulsa,Superintendent of Public Instruction,John Cox,DEM,720152,0,0,4,4,
Tulsa,Superintendent of Public Instruction,Freda Deskin,DEM,720152,0,0,7,7,
Tulsa,U.S. Senate,Connie Johnson,DEM,720152,0,0,8,8,
Tulsa,U.S. Senate,Jim Rogers,DEM,720152,0,0,1,1,
Tulsa,Superintendent of Public Instruction,John Cox,DEM,720153,0,0,16,16,
Tulsa,Superintendent of Public Instruction,Freda Deskin,DEM,720153,0,0,10,10,
Tulsa,U.S. Senate,Connie Johnson,DEM,720153,0,0,21,21,
Tulsa,U.S. Senate,Jim Rogers,DEM,720153,0,0,5,5,
Tulsa,Superintendent of Public Instruction,John Cox,DEM,720154,0,0,13,13,
Tulsa,Superintendent of Public Instruction,Freda Deskin,DEM,720154,0,0,8,8,
Tulsa,U.S. Senate,Connie Johnson,DEM,720154,0,0,16,16,
Tulsa,U.S. Senate,Jim Rogers,DEM,720154,0,0,3,3,
Tulsa,Superintendent of Public Instruction,John Cox,DEM,720155,0,0,18,18,
Tulsa,Superintendent of Public Instruction,Freda Deskin,DEM,720155,0,0,11,11,
Tulsa,U.S. Senate,Connie Johnson,DEM,720155,0,0,22,22,
Tulsa,U.S. Senate,Jim Rogers,DEM,720155,0,0,6,6,
Tulsa,Superintendent of Public Instruction,John Cox,DEM,720156,0,0,3,3,
Tulsa,Superintendent of Public Instruction,Freda Deskin,DEM,720156,0,0,2,2,
Tulsa,U.S. Senate,Connie Johnson,DEM,720156,0,0,5,5,
Tulsa,U.S. Senate,Jim Rogers,DEM,720156,0,0,0,0,
Tulsa,Superintendent of Public Instruction,John Cox,DEM,720157,0,0,7,7,
Tulsa,Superintendent of Public Instruction,Freda Deskin,DEM,720157,0,0,16,16,
Tulsa,U.S. Senate,Connie Johnson,DEM,720157,0,0,18,18,
Tulsa,U.S. Senate,Jim Rogers,DEM,720157,0,0,5,5,
Tulsa,State House,Melissa Abdo,REP,720157,0,0,148,148,69
Tulsa,State House,Chuck Strohm,REP,720157,0,0,171,171,69
Tulsa,Superintendent of Public Instruction,John Cox,DEM,720158,0,0,6,6,
Tulsa,Superintendent of Public Instruction,Freda Deskin,DEM,720158,0,0,5,5,
Tulsa,U.S. Senate,Connie Johnson,DEM,720158,0,0,8,8,
Tulsa,U.S. Senate,Jim Rogers,DEM,720158,0,0,3,3,
Tulsa,Superintendent of Public Instruction,John Cox,DEM,720159,0,0,8,8,
Tulsa,Superintendent of Public Instruction,Freda Deskin,DEM,720159,0,0,7,7,
Tulsa,U.S. Senate,Connie Johnson,DEM,720159,0,0,13,13,
Tulsa,U.S. Senate,Jim Rogers,DEM,720159,0,0,2,2,
Tulsa,Superintendent of Public Instruction,John Cox,DEM,720160,0,0,31,31,
Tulsa,Superintendent of Public Instruction,Freda Deskin,DEM,720160,0,0,31,31,
Tulsa,U.S. Senate,Connie Johnson,DEM,720160,0,0,54,54,
Tulsa,U.S. Senate,Jim Rogers,DEM,720160,0,0,7,7,
Tulsa,Superintendent of Public Instruction,John Cox,DEM,720161,0,0,4,4,
Tulsa,Superintendent of Public Instruction,Freda Deskin,DEM,720161,0,0,10,10,
Tulsa,U.S. Senate,Connie Johnson,DEM,720161,0,0,10,10,
Tulsa,U.S. Senate,Jim Rogers,DEM,720161,0,0,4,4,
Tulsa,Superintendent of Public Instruction,John Cox,DEM,720162,0,0,2,2,
Tulsa,Superintendent of Public Instruction,Freda Deskin,DEM,720162,0,0,0,0,
Tulsa,U.S. Senate,Connie Johnson,DEM,720162,0,0,1,1,
Tulsa,U.S. Senate,Jim Rogers,DEM,720162,0,0,1,1,
Tulsa,State House,Melissa Abdo,REP,720162,0,0,7,7,69
Tulsa,State House,Chuck Strohm,REP,720162,0,0,6,6,69
Tulsa,Superintendent of Public Instruction,John Cox,DEM,720163,0,0,20,20,
Tulsa,Superintendent of Public Instruction,Freda Deskin,DEM,720163,0,0,21,21,
Tulsa,U.S. Senate,Connie Johnson,DEM,720163,0,0,36,36,
Tulsa,U.S. Senate,Jim Rogers,DEM,720163,0,0,5,5,
Tulsa,Superintendent of Public Instruction,John Cox,DEM,720164,0,0,7,7,
Tulsa,Superintendent of Public Instruction,Freda Deskin,DEM,720164,0,0,8,8,
Tulsa,U.S. Senate,Connie Johnson,DEM,720164,0,0,9,9,
Tulsa,U.S. Senate,Jim Rogers,DEM,720164,0,0,5,5,
Tulsa,Superintendent of Public Instruction,John Cox,DEM,720165,0,0,6,6,
Tulsa,Superintendent of Public Instruction,Freda Deskin,DEM,720165,0,0,11,11,
Tulsa,U.S. Senate,Connie Johnson,DEM,720165,0,0,14,14,
Tulsa,U.S. Senate,Jim Rogers,DEM,720165,0,0,3,3,
Tulsa,Superintendent of Public Instruction,John Cox,DEM,720166,0,0,15,15,
Tulsa,Superintendent of Public Instruction,Freda Deskin,DEM,720166,0,0,25,25,
Tulsa,U.S. Senate,Connie Johnson,DEM,720166,0,0,30,30,
Tulsa,U.S. Senate,Jim Rogers,DEM,720166,0,0,9,9,
Tulsa,Superintendent of Public Instruction,John Cox,DEM,720167,0,0,9,9,
Tulsa,Superintendent of Public Instruction,Freda Deskin,DEM,720167,0,0,8,8,
Tulsa,U.S. Senate,Connie Johnson,DEM,720167,0,0,13,13,
Tulsa,U.S. Senate,Jim Rogers,DEM,720167,0,0,3,3,
Tulsa,State House,Melissa Abdo,REP,720167,0,0,127,127,69
Tulsa,State House,Chuck Strohm,REP,720167,0,0,78,78,69
Tulsa,Superintendent of Public Instruction,John Cox,DEM,720168,0,0,12,12,
Tulsa,Superintendent of Public Instruction,Freda Deskin,DEM,720168,0,0,15,15,
Tulsa,U.S. Senate,Connie Johnson,DEM,720168,0,0,19,19,
Tulsa,U.S. Senate,Jim Rogers,DEM,720168,0,0,8,8,
Tulsa,Superintendent of Public Instruction,John Cox,DEM,720169,0,0,17,17,
Tulsa,Superintendent of Public Instruction,Freda Deskin,DEM,720169,0,0,15,15,
Tulsa,U.S. Senate,Connie Johnson,DEM,720169,0,0,22,22,
Tulsa,U.S. Senate,Jim Rogers,DEM,720169,0,0,10,10,
Tulsa,Superintendent of Public Instruction,John Cox,DEM,720170,0,0,3,3,
Tulsa,Superintendent of Public Instruction,Freda Deskin,DEM,720170,0,0,5,5,
Tulsa,U.S. Senate,Connie Johnson,DEM,720170,0,0,7,7,
Tulsa,U.S. Senate,Jim Rogers,DEM,720170,0,0,1,1,
Tulsa,Superintendent of Public Instruction,John Cox,DEM,720171,0,0,9,9,
Tulsa,Superintendent of Public Instruction,Freda Deskin,DEM,720171,0,0,11,11,
Tulsa,U.S. Senate,Connie Johnson,DEM,720171,0,0,17,17,
Tulsa,U.S. Senate,Jim Rogers,DEM,720171,0,0,3,3,
Tulsa,State House,Melissa Abdo,REP,720171,0,0,45,45,69
Tulsa,State House,Chuck Strohm,REP,720171,0,0,46,46,69
Tulsa,Superintendent of Public Instruction,John Cox,DEM,720172,0,0,20,20,
Tulsa,Superintendent of Public Instruction,Freda Deskin,DEM,720172,0,0,14,14,
Tulsa,U.S. Senate,Connie Johnson,DEM,720172,0,0,26,26,
Tulsa,U.S. Senate,Jim Rogers,DEM,720172,0,0,9,9,
Tulsa,Superintendent of Public Instruction,John Cox,DEM,720173,0,0,19,19,
Tulsa,Superintendent of Public Instruction,Freda Deskin,DEM,720173,0,0,14,14,
Tulsa,U.S. Senate,Connie Johnson,DEM,720173,0,0,28,28,
Tulsa,U.S. Senate,Jim Rogers,DEM,720173,0,0,6,6,
Tulsa,State House,Melissa Abdo,REP,720173,0,0,112,112,69
Tulsa,State House,Chuck Strohm,REP,720173,0,0,131,131,69
Tulsa,Superintendent of Public Instruction,John Cox,DEM,720174,0,0,0,0,
Tulsa,Superintendent of Public Instruction,Freda Deskin,DEM,720174,0,0,0,0,
Tulsa,U.S. Senate,Connie Johnson,DEM,720174,0,0,0,0,
Tulsa,U.S. Senate,Jim Rogers,DEM,720174,0,0,0,0,
Tulsa,Superintendent of Public Instruction,John Cox,DEM,720175,0,0,0,0,
Tulsa,Superintendent of Public Instruction,Freda Deskin,DEM,720175,0,0,0,0,
Tulsa,U.S. Senate,Connie Johnson,DEM,720175,0,0,0,0,
Tulsa,U.S. Senate,Jim Rogers,DEM,720175,0,0,0,0,
Tulsa,Superintendent of Public Instruction,John Cox,DEM,720176,0,0,0,0,
Tulsa,Superintendent of Public Instruction,Freda Deskin,DEM,720176,0,0,0,0,
Tulsa,U.S. Senate,Connie Johnson,DEM,720176,0,0,0,0,
Tulsa,U.S. Senate,Jim Rogers,DEM,720176,0,0,0,0,
Tulsa,Superintendent of Public Instruction,John Cox,DEM,720351,0,0,18,18,
Tulsa,Superintendent of Public Instruction,Freda Deskin,DEM,720351,0,0,7,7,
Tulsa,U.S. Senate,Connie Johnson,DEM,720351,0,0,14,14,
Tulsa,U.S. Senate,Jim Rogers,DEM,720351,0,0,9,9,
Tulsa,State House,Melissa Abdo,REP,720351,0,0,78,78,69
Tulsa,State House,Chuck Strohm,REP,720351,0,0,91,91,69
Tulsa,Superintendent of Public Instruction,John Cox,DEM,720352,0,0,5,5,
Tulsa,Superintendent of Public Instruction,Freda Deskin,DEM,720352,0,0,11,11,
Tulsa,U.S. Senate,Connie Johnson,DEM,720352,0,0,13,13,
Tulsa,U.S. Senate,Jim Rogers,DEM,720352,0,0,3,3,
Tulsa,Superintendent of Public Instruction,John Cox,DEM,720353,0,0,1,1,
Tulsa,Superintendent of Public Instruction,Freda Deskin,DEM,720353,0,0,3,3,
Tulsa,U.S. Senate,Connie Johnson,DEM,720353,0,0,4,4,
Tulsa,U.S. Senate,Jim Rogers,DEM,720353,0,0,0,0,
Tulsa,Superintendent of Public Instruction,John Cox,DEM,720354,0,0,2,2,
Tulsa,Superintendent of Public Instruction,Freda Deskin,DEM,720354,0,0,1,1,
Tulsa,U.S. Senate,Connie Johnson,DEM,720354,0,0,3,3,
Tulsa,U.S. Senate,Jim Rogers,DEM,720354,0,0,0,0,
Tulsa,Superintendent of Public Instruction,John Cox,DEM,720355,0,0,3,3,
Tulsa,Superintendent of Public Instruction,Freda Deskin,DEM,720355,0,0,0,0,
Tulsa,U.S. Senate,Connie Johnson,DEM,720355,0,0,1,1,
Tulsa,U.S. Senate,Jim Rogers,DEM,720355,0,0,1,1,
Tulsa,Superintendent of Public Instruction,John Cox,DEM,720356,0,0,1,1,
Tulsa,Superintendent of Public Instruction,Freda Deskin,DEM,720356,0,0,0,0,
Tulsa,U.S. Senate,Connie Johnson,DEM,720356,0,0,0,0,
Tulsa,U.S. Senate,Jim Rogers,DEM,720356,0,0,0,0,
Tulsa,Superintendent of Public Instruction,John Cox,DEM,720400,0,0,12,12,
Tulsa,Superintendent of Public Instruction,Freda Deskin,DEM,720400,0,0,11,11,
Tulsa,U.S. Senate,Connie Johnson,DEM,720400,0,0,16,16,
Tulsa,U.S. Senate,Jim Rogers,DEM,720400,0,0,7,7,
Tulsa,State House,Melissa Abdo,REP,720400,0,0,66,66,69
Tulsa,State House,Chuck Strohm,REP,720400,0,0,97,97,69
Tulsa,Superintendent of Public Instruction,John Cox,DEM,720401,0,0,13,13,
Tulsa,Superintendent of Public Instruction,Freda Deskin,DEM,720401,0,0,11,11,
Tulsa,U.S. Senate,Connie Johnson,DEM,720401,0,0,19,19,
Tulsa,U.S. Senate,Jim Rogers,DEM,720401,0,0,5,5,
Tulsa,Superintendent of Public Instruction,John Cox,DEM,720402,0,0,11,11,
Tulsa,Superintendent of Public Instruction,Freda Deskin,DEM,720402,0,0,0,0,
Tulsa,U.S. Senate,Connie Johnson,DEM,720402,0,0,2,2,
Tulsa,U.S. Senate,Jim Rogers,DEM,720402,0,0,9,9,
Tulsa,State House,Melissa Abdo,REP,720402,0,0,11,11,69
Tulsa,State House,Chuck Strohm,REP,720402,0,0,53,53,69
Tulsa,Superintendent of Public Instruction,John Cox,DEM,720403,0,0,45,45,
Tulsa,Superintendent of Public Instruction,Freda Deskin,DEM,720403,0,0,46,46,
Tulsa,U.S. Senate,Connie Johnson,DEM,720403,0,0,55,55,
Tulsa,U.S. Senate,Jim Rogers,DEM,720403,0,0,36,36,
Tulsa,Superintendent of Public Instruction,John Cox,DEM,720404,0,0,27,27,
Tulsa,Superintendent of Public Instruction,Freda Deskin,DEM,720404,0,0,13,13,
Tulsa,U.S. Senate,Connie Johnson,DEM,720404,0,0,22,22,
Tulsa,U.S. Senate,Jim Rogers,DEM,720404,0,0,17,17,
Tulsa,Superintendent of Public Instruction,John Cox,DEM,720405,0,0,0,0,
Tulsa,Superintendent of Public Instruction,Freda Deskin,DEM,720405,0,0,1,1,
Tulsa,U.S. Senate,Connie Johnson,DEM,720405,0,0,1,1,
Tulsa,U.S. Senate,Jim Rogers,DEM,720405,0,0,0,0,
Tulsa,Superintendent of Public Instruction,John Cox,DEM,720406,0,0,8,8,
Tulsa,Superintendent of Public Instruction,Freda Deskin,DEM,720406,0,0,9,9,
Tulsa,U.S. Senate,Connie Johnson,DEM,720406,0,0,13,13,
Tulsa,U.S. Senate,Jim Rogers,DEM,720406,0,0,4,4,
Tulsa,Superintendent of Public Instruction,John Cox,DEM,720407,0,0,18,18,
Tulsa,Superintendent of Public Instruction,Freda Deskin,DEM,720407,0,0,9,9,
Tulsa,U.S. Senate,Connie Johnson,DEM,720407,0,0,18,18,
Tulsa,U.S. Senate,Jim Rogers,DEM,720407,0,0,9,9,
Tulsa,Superintendent of Public Instruction,John Cox,DEM,720408,0,0,27,27,
Tulsa,Superintendent of Public Instruction,Freda Deskin,DEM,720408,0,0,17,17,
Tulsa,U.S. Senate,Connie Johnson,DEM,720408,0,0,37,37,
Tulsa,U.S. Senate,Jim Rogers,DEM,720408,0,0,7,7,
Tulsa,Superintendent of Public Instruction,John Cox,DEM,720409,0,0,13,13,
Tulsa,Superintendent of Public Instruction,Freda Deskin,DEM,720409,0,0,10,10,
Tulsa,U.S. Senate,Connie Johnson,DEM,720409,0,0,18,18,
Tulsa,U.S. Senate,Jim Rogers,DEM,720409,0,0,5,5,
Tulsa,Superintendent of Public Instruction,John Cox,DEM,720410,0,0,1,1,
Tulsa,Superintendent of Public Instruction,Freda Deskin,DEM,720410,0,0,6,6,
Tulsa,U.S. Senate,Connie Johnson,DEM,720410,0,0,6,6,
Tulsa,U.S. Senate,Jim Rogers,DEM,720410,0,0,2,2,
Tulsa,Superintendent of Public Instruction,John Cox,DEM,720411,0,0,10,10,
Tulsa,Superintendent of Public Instruction,Freda Deskin,DEM,720411,0,0,3,3,
Tulsa,U.S. Senate,Connie Johnson,DEM,720411,0,0,10,10,
Tulsa,U.S. Senate,Jim Rogers,DEM,720411,0,0,3,3,
Tulsa,Superintendent of Public Instruction,John Cox,DEM,720451,0,0,15,15,
Tulsa,Superintendent of Public Instruction,Freda Deskin,DEM,720451,0,0,7,7,
Tulsa,U.S. Senate,Connie Johnson,DEM,720451,0,0,16,16,
Tulsa,U.S. Senate,Jim Rogers,DEM,720451,0,0,6,6,
Tulsa,Superintendent of Public Instruction,John Cox,DEM,720452,0,0,69,69,
Tulsa,Superintendent of Public Instruction,Freda Deskin,DEM,720452,0,0,43,43,
Tulsa,U.S. Senate,Connie Johnson,DEM,720452,0,0,64,64,
Tulsa,U.S. Senate,Jim Rogers,DEM,720452,0,0,44,44,
Tulsa,Superintendent of Public Instruction,John Cox,DEM,720453,0,0,20,20,
Tulsa,Superintendent of Public Instruction,Freda Deskin,DEM,720453,0,0,19,19,
Tulsa,U.S. Senate,Connie Johnson,DEM,720453,0,0,22,22,
Tulsa,U.S. Senate,Jim Rogers,DEM,720453,0,0,16,16,
Tulsa,Superintendent of Public Instruction,John Cox,DEM,720454,0,0,22,22,
Tulsa,Superintendent of Public Instruction,Freda Deskin,DEM,720454,0,0,24,24,
Tulsa,U.S. Senate,Connie Johnson,DEM,720454,0,0,38,38,
Tulsa,U.S. Senate,Jim Rogers,DEM,720454,0,0,8,8,
Tulsa,Superintendent of Public Instruction,John Cox,DEM,720455,0,0,21,21,
Tulsa,Superintendent of Public Instruction,Freda Deskin,DEM,720455,0,0,20,20,
Tulsa,U.S. Senate,Connie Johnson,DEM,720455,0,0,29,29,
Tulsa,U.S. Senate,Jim Rogers,DEM,720455,0,0,12,12,
Tulsa,Superintendent of Public Instruction,John Cox,DEM,720456,0,0,22,22,
Tulsa,Superintendent of Public Instruction,Freda Deskin,DEM,720456,0,0,17,17,
Tulsa,U.S. Senate,Connie Johnson,DEM,720456,0,0,24,24,
Tulsa,U.S. Senate,Jim Rogers,DEM,720456,0,0,15,15,
Tulsa,Superintendent of Public Instruction,John Cox,DEM,720457,0,0,0,0,
Tulsa,Superintendent of Public Instruction,Freda Deskin,DEM,720457,0,0,0,0,
Tulsa,U.S. Senate,Connie Johnson,DEM,720457,0,0,0,0,
Tulsa,U.S. Senate,Jim Rogers,DEM,720457,0,0,0,0,
Tulsa,Superintendent of Public Instruction,John Cox,DEM,720458,0,0,42,42,
Tulsa,Superintendent of Public Instruction,Freda Deskin,DEM,720458,0,0,29,29,
Tulsa,U.S. Senate,Connie Johnson,DEM,720458,0,0,53,53,
Tulsa,U.S. Senate,Jim Rogers,DEM,720458,0,0,18,18,
Tulsa,Superintendent of Public Instruction,John Cox,DEM,720459,0,0,13,13,
Tulsa,Superintendent of Public Instruction,Freda Deskin,DEM,720459,0,0,13,13,
Tulsa,U.S. Senate,Connie Johnson,DEM,720459,0,0,17,17,
Tulsa,U.S. Senate,Jim Rogers,DEM,720459,0,0,9,9,
Tulsa,Superintendent of Public Instruction,John Cox,DEM,720460,0,0,8,8,
Tulsa,Superintendent of Public Instruction,Freda Deskin,DEM,720460,0,0,3,3,
Tulsa,U.S. Senate,Connie Johnson,DEM,720460,0,0,7,7,
Tulsa,U.S. Senate,Jim Rogers,DEM,720460,0,0,4,4,
Tulsa,Superintendent of Public Instruction,John Cox,DEM,720461,0,0,16,16,
Tulsa,Superintendent of Public Instruction,Freda Deskin,DEM,720461,0,0,14,14,
Tulsa,U.S. Senate,Connie Johnson,DEM,720461,0,0,21,21,
Tulsa,U.S. Senate,Jim Rogers,DEM,720461,0,0,9,9,
Tulsa,Superintendent of Public Instruction,John Cox,DEM,720462,0,0,37,37,
Tulsa,Superintendent of Public Instruction,Freda Deskin,DEM,720462,0,0,37,37,
Tulsa,U.S. Senate,Connie Johnson,DEM,720462,0,0,44,44,
Tulsa,U.S. Senate,Jim Rogers,DEM,720462,0,0,29,29,
Tulsa,Superintendent of Public Instruction,John Cox,DEM,720463,0,0,16,16,
Tulsa,Superintendent of Public Instruction,Freda Deskin,DEM,720463,0,0,4,4,
Tulsa,U.S. Senate,Connie Johnson,DEM,720463,0,0,13,13,
Tulsa,U.S. Senate,Jim Rogers,DEM,720463,0,0,7,7,
Tulsa,Superintendent of Public Instruction,John Cox,DEM,720464,0,0,54,54,
Tulsa,Superintendent of Public Instruction,Freda Deskin,DEM,720464,0,0,36,36,
Tulsa,U.S. Senate,Connie Johnson,DEM,720464,0,0,58,58,
Tulsa,U.S. Senate,Jim Rogers,DEM,720464,0,0,29,29,
Tulsa,Superintendent of Public Instruction,John Cox,DEM,720465,0,0,24,24,
Tulsa,Superintendent of Public Instruction,Freda Deskin,DEM,720465,0,0,15,15,
Tulsa,U.S. Senate,Connie Johnson,DEM,720465,0,0,29,29,
Tulsa,U.S. Senate,Jim Rogers,DEM,720465,0,0,10,10,
Tulsa,Superintendent of Public Instruction,John Cox,DEM,720466,0,0,35,35,
Tulsa,Superintendent of Public Instruction,Freda Deskin,DEM,720466,0,0,28,28,
Tulsa,U.S. Senate,Connie Johnson,DEM,720466,0,0,41,41,
Tulsa,U.S. Senate,Jim Rogers,DEM,720466,0,0,22,22,
Tulsa,Superintendent of Public Instruction,John Cox,DEM,720467,0,0,0,0,
Tulsa,Superintendent of Public Instruction,Freda Deskin,DEM,720467,0,0,1,1,
Tulsa,U.S. Senate,Connie Johnson,DEM,720467,0,0,1,1,
Tulsa,U.S. Senate,Jim Rogers,DEM,720467,0,0,0,0,
Tulsa,Superintendent of Public Instruction,John Cox,DEM,720468,0,0,26,26,
Tulsa,Superintendent of Public Instruction,Freda Deskin,DEM,720468,0,0,18,18,
Tulsa,U.S. Senate,Connie Johnson,DEM,720468,0,0,29,29,
Tulsa,U.S. Senate,Jim Rogers,DEM,720468,0,0,14,14,
Tulsa,Superintendent of Public Instruction,John Cox,DEM,720469,0,0,15,15,
Tulsa,Superintendent of Public Instruction,Freda Deskin,DEM,720469,0,0,8,8,
Tulsa,U.S. Senate,Connie Johnson,DEM,720469,0,0,16,16,
Tulsa,U.S. Senate,Jim Rogers,DEM,720469,0,0,8,8,
Tulsa,Superintendent of Public Instruction,John Cox,DEM,720470,0,0,24,24,
Tulsa,Superintendent of Public Instruction,Freda Deskin,DEM,720470,0,0,19,19,
Tulsa,U.S. Senate,Connie Johnson,DEM,720470,0,0,33,33,
Tulsa,U.S. Senate,Jim Rogers,DEM,720470,0,0,11,11,
Tulsa,Superintendent of Public Instruction,John Cox,DEM,720471,0,0,6,6,
Tulsa,Superintendent of Public Instruction,Freda Deskin,DEM,720471,0,0,7,7,
Tulsa,U.S. Senate,Connie Johnson,DEM,720471,0,0,10,10,
Tulsa,U.S. Senate,Jim Rogers,DEM,720471,0,0,3,3,
Tulsa,Superintendent of Public Instruction,John Cox,DEM,720472,0,0,17,17,
Tulsa,Superintendent of Public Instruction,Freda Deskin,DEM,720472,0,0,6,6,
Tulsa,U.S. Senate,Connie Johnson,DEM,720472,0,0,16,16,
Tulsa,U.S. Senate,Jim Rogers,DEM,720472,0,0,6,6,
Tulsa,Superintendent of Public Instruction,John Cox,DEM,720473,0,0,18,18,
Tulsa,Superintendent of Public Instruction,Freda Deskin,DEM,720473,0,0,14,14,
Tulsa,U.S. Senate,Connie Johnson,DEM,720473,0,0,21,21,
Tulsa,U.S. Senate,Jim Rogers,DEM,720473,0,0,10,10,
Tulsa,Superintendent of Public Instruction,John Cox,DEM,720474,0,0,36,36,
Tulsa,Superintendent of Public Instruction,Freda Deskin,DEM,720474,0,0,25,25,
Tulsa,U.S. Senate,Connie Johnson,DEM,720474,0,0,49,49,
Tulsa,U.S. Senate,Jim Rogers,DEM,720474,0,0,12,12,
Tulsa,Superintendent of Public Instruction,John Cox,DEM,720475,0,0,33,33,
Tulsa,Superintendent of Public Instruction,Freda Deskin,DEM,720475,0,0,19,19,
Tulsa,U.S. Senate,Connie Johnson,DEM,720475,0,0,35,35,
Tulsa,U.S. Senate,Jim Rogers,DEM,720475,0,0,15,15,
Tulsa,Superintendent of Public Instruction,John Cox,DEM,720476,0,0,14,14,
Tulsa,Superintendent of Public Instruction,Freda Deskin,DEM,720476,0,0,14,14,
Tulsa,U.S. Senate,Connie Johnson,DEM,720476,0,0,16,16,
Tulsa,U.S. Senate,Jim Rogers,DEM,720476,0,0,12,12,
Tulsa,Superintendent of Public Instruction,John Cox,DEM,720501,0,0,11,11,
Tulsa,Superintendent of Public Instruction,Freda Deskin,DEM,720501,0,0,5,5,
Tulsa,U.S. Senate,Connie Johnson,DEM,720501,0,0,10,10,
Tulsa,U.S. Senate,Jim Rogers,DEM,720501,0,0,6,6,
Tulsa,Superintendent of Public Instruction,John Cox,DEM,720502,0,0,31,31,
Tulsa,Superintendent of Public Instruction,Freda Deskin,DEM,720502,0,0,10,10,
Tulsa,U.S. Senate,Connie Johnson,DEM,720502,0,0,26,26,
Tulsa,U.S. Senate,Jim Rogers,DEM,720502,0,0,15,15,
Tulsa,Superintendent of Public Instruction,John Cox,DEM,720503,0,0,36,36,
Tulsa,Superintendent of Public Instruction,Freda Deskin,DEM,720503,0,0,8,8,
Tulsa,U.S. Senate,Connie Johnson,DEM,720503,0,0,22,22,
Tulsa,U.S. Senate,Jim Rogers,DEM,720503,0,0,21,21,
Tulsa,Superintendent of Public Instruction,John Cox,DEM,720504,0,0,46,46,
Tulsa,Superintendent of Public Instruction,Freda Deskin,DEM,720504,0,0,8,8,
Tulsa,U.S. Senate,Connie Johnson,DEM,720504,0,0,24,24,
Tulsa,U.S. Senate,Jim Rogers,DEM,720504,0,0,26,26,
Tulsa,Superintendent of Public Instruction,John Cox,DEM,720551,0,0,13,13,
Tulsa,Superintendent of Public Instruction,Freda Deskin,DEM,720551,0,0,3,3,
Tulsa,U.S. Senate,Connie Johnson,DEM,720551,0,0,9,9,
Tulsa,U.S. Senate,Jim Rogers,DEM,720551,0,0,7,7,
Tulsa,Superintendent of Public Instruction,John Cox,DEM,720552,0,0,15,15,
Tulsa,Superintendent of Public Instruction,Freda Deskin,DEM,720552,0,0,6,6,
Tulsa,U.S. Senate,Connie Johnson,DEM,720552,0,0,12,12,
Tulsa,U.S. Senate,Jim Rogers,DEM,720552,0,0,7,7,
Tulsa,Superintendent of Public Instruction,John Cox,DEM,720553,0,0,9,9,
Tulsa,Superintendent of Public Instruction,Freda Deskin,DEM,720553,0,0,8,8,
Tulsa,U.S. Senate,Connie Johnson,DEM,720553,0,0,10,10,
Tulsa,U.S. Senate,Jim Rogers,DEM,720553,0,0,7,7,
Tulsa,Superintendent of Public Instruction,John Cox,DEM,720700,0,0,16,16,
Tulsa,Superintendent of Public Instruction,Freda Deskin,DEM,720700,0,0,15,15,
Tulsa,U.S. Senate,Connie Johnson,DEM,720700,0,0,25,25,
Tulsa,U.S. Senate,Jim Rogers,DEM,720700,0,0,4,4,
Tulsa,State House,Melissa Abdo,REP,720700,0,0,131,131,69
Tulsa,State House,Chuck Strohm,REP,720700,0,0,149,149,69
Tulsa,Superintendent of Public Instruction,John Cox,DEM,720701,0,0,23,23,
Tulsa,Superintendent of Public Instruction,Freda Deskin,DEM,720701,0,0,12,12,
Tulsa,U.S. Senate,Connie Johnson,DEM,720701,0,0,26,26,
Tulsa,U.S. Senate,Jim Rogers,DEM,720701,0,0,10,10,
Tulsa,Superintendent of Public Instruction,John Cox,DEM,720702,0,0,24,24,
Tulsa,Superintendent of Public Instruction,Freda Deskin,DEM,720702,0,0,11,11,
Tulsa,U.S. Senate,Connie Johnson,DEM,720702,0,0,23,23,
Tulsa,U.S. Senate,Jim Rogers,DEM,720702,0,0,11,11,
Tulsa,State House,Melissa Abdo,REP,720702,0,0,65,65,69
Tulsa,State House,Chuck Strohm,REP,720702,0,0,72,72,69
Tulsa,Superintendent of Public Instruction,John Cox,DEM,720703,0,0,17,17,
Tulsa,Superintendent of Public Instruction,Freda Deskin,DEM,720703,0,0,12,12,
Tulsa,U.S. Senate,Connie Johnson,DEM,720703,0,0,22,22,
Tulsa,U.S. Senate,Jim Rogers,DEM,720703,0,0,7,7,
Tulsa,Superintendent of Public Instruction,John Cox,DEM,720704,0,0,21,21,
Tulsa,Superintendent of Public Instruction,Freda Deskin,DEM,720704,0,0,12,12,
Tulsa,U.S. Senate,Connie Johnson,DEM,720704,0,0,26,26,
Tulsa,U.S. Senate,Jim Rogers,DEM,720704,0,0,7,7,
Tulsa,State House,Melissa Abdo,REP,720704,0,0,71,71,69
Tulsa,State House,Chuck Strohm,REP,720704,0,0,95,95,69
Tulsa,Superintendent of Public Instruction,John Cox,DEM,720705,0,0,15,15,
Tulsa,Superintendent of Public Instruction,Freda Deskin,DEM,720705,0,0,9,9,
Tulsa,U.S. Senate,Connie Johnson,DEM,720705,0,0,12,12,
Tulsa,U.S. Senate,Jim Rogers,DEM,720705,0,0,12,12,
Tulsa,Superintendent of Public Instruction,John Cox,DEM,720706,0,0,19,19,
Tulsa,Superintendent of Public Instruction,Freda Deskin,DEM,720706,0,0,13,13,
Tulsa,U.S. Senate,Connie Johnson,DEM,720706,0,0,15,15,
Tulsa,U.S. Senate,Jim Rogers,DEM,720706,0,0,15,15,
Tulsa,Superintendent of Public Instruction,John Cox,DEM,720707,0,0,14,14,
Tulsa,Superintendent of Public Instruction,Freda Deskin,DEM,720707,0,0,3,3,
Tulsa,U.S. Senate,Connie Johnson,DEM,720707,0,0,13,13,
Tulsa,U.S. Senate,Jim Rogers,DEM,720707,0,0,4,4,
Tulsa,Superintendent of Public Instruction,John Cox,DEM,720708,0,0,15,15,
Tulsa,Superintendent of Public Instruction,Freda Deskin,DEM,720708,0,0,5,5,
Tulsa,U.S. Senate,Connie Johnson,DEM,720708,0,0,13,13,
Tulsa,U.S. Senate,Jim Rogers,DEM,720708,0,0,7,7,
Tulsa,Superintendent of Public Instruction,John Cox,DEM,720709,0,0,24,24,
Tulsa,Superintendent of Public Instruction,Freda Deskin,DEM,720709,0,0,15,15,
Tulsa,U.S. Senate,Connie Johnson,DEM,720709,0,0,24,24,
Tulsa,U.S. Senate,Jim Rogers,DEM,720709,0,0,14,14,
Tulsa,State House,Melissa Abdo,REP,720709,0,0,68,68,69
Tulsa,State House,Chuck Strohm,REP,720709,0,0,77,77,69
Tulsa,Superintendent of Public Instruction,John Cox,DEM,720710,0,0,11,11,
Tulsa,Superintendent of Public Instruction,Freda Deskin,DEM,720710,0,0,2,2,
Tulsa,U.S. Senate,Connie Johnson,DEM,720710,0,0,7,7,
Tulsa,U.S. Senate,Jim Rogers,DEM,720710,0,0,6,6,
Tulsa,Superintendent of Public Instruction,John Cox,DEM,720750,0,0,21,21,
Tulsa,Superintendent of Public Instruction,Freda Deskin,DEM,720750,0,0,17,17,
Tulsa,U.S. Senate,Connie Johnson,DEM,720750,0,0,21,21,
Tulsa,U.S. Senate,Jim Rogers,DEM,720750,0,0,17,17,
Tulsa,Superintendent of Public Instruction,John Cox,DEM,720751,0,0,20,20,
Tulsa,Superintendent of Public Instruction,Freda Deskin,DEM,720751,0,0,10,10,
Tulsa,U.S. Senate,Connie Johnson,DEM,720751,0,0,20,20,
Tulsa,U.S. Senate,Jim Rogers,DEM,720751,0,0,10,10,
Tulsa,Superintendent of Public Instruction,John Cox,DEM,720752,0,0,22,22,
Tulsa,Superintendent of Public Instruction,Freda Deskin,DEM,720752,0,0,10,10,
Tulsa,U.S. Senate,Connie Johnson,DEM,720752,0,0,18,18,
Tulsa,U.S. Senate,Jim Rogers,DEM,720752,0,0,12,12,
Tulsa,Superintendent of Public Instruction,John Cox,DEM,720753,0,0,31,31,
Tulsa,Superintendent of Public Instruction,Freda Deskin,DEM,720753,0,0,7,7,
Tulsa,U.S. Senate,Connie Johnson,DEM,720753,0,0,21,21,
Tulsa,U.S. Senate,Jim Rogers,DEM,720753,0,0,16,16,
Tulsa,Superintendent of Public Instruction,John Cox,DEM,720754,0,0,28,28,
Tulsa,Superintendent of Public Instruction,Freda Deskin,DEM,720754,0,0,9,9,
Tulsa,U.S. Senate,Connie Johnson,DEM,720754,0,0,28,28,
Tulsa,U.S. Senate,Jim Rogers,DEM,720754,0,0,8,8,
Tulsa,Superintendent of Public Instruction,John Cox,DEM,720755,0,0,49,49,
Tulsa,Superintendent of Public Instruction,Freda Deskin,DEM,720755,0,0,10,10,
Tulsa,U.S. Senate,Connie Johnson,DEM,720755,0,0,38,38,
Tulsa,U.S. Senate,Jim Rogers,DEM,720755,0,0,19,19,
Tulsa,Superintendent of Public Instruction,John Cox,DEM,720756,0,0,3,3,
Tulsa,Superintendent of Public Instruction,Freda Deskin,DEM,720756,0,0,0,0,
Tulsa,U.S. Senate,Connie Johnson,DEM,720756,0,0,0,0,
Tulsa,U.S. Senate,Jim Rogers,DEM,720756,0,0,3,3,
Tulsa,Superintendent of Public Instruction,John Cox,DEM,720757,0,0,26,26,
Tulsa,Superintendent of Public Instruction,Freda Deskin,DEM,720757,0,0,4,4,
Tulsa,U.S. Senate,Connie Johnson,DEM,720757,0,0,14,14,
Tulsa,U.S. Senate,Jim Rogers,DEM,720757,0,0,16,16,
Tulsa,Superintendent of Public Instruction,John Cox,DEM,720758,0,0,4,4,
Tulsa,Superintendent of Public Instruction,Freda Deskin,DEM,720758,0,0,2,2,
Tulsa,U.S. Senate,Connie Johnson,DEM,720758,0,0,2,2,
Tulsa,U.S. Senate,Jim Rogers,DEM,720758,0,0,3,3,
Tulsa,Superintendent of Public Instruction,John Cox,DEM,720759,0,0,12,12,
Tulsa,Superintendent of Public Instruction,Freda Deskin,DEM,720759,0,0,7,7,
Tulsa,U.S. Senate,Connie Johnson,DEM,720759,0,0,9,9,
Tulsa,U.S. Senate,Jim Rogers,DEM,720759,0,0,8,8,
Tulsa,Superintendent of Public Instruction,John Cox,DEM,720760,0,0,12,12,
Tulsa,Superintendent of Public Instruction,Freda Deskin,DEM,720760,0,0,1,1,
Tulsa,U.S. Senate,Connie Johnson,DEM,720760,0,0,6,6,
Tulsa,U.S. Senate,Jim Rogers,DEM,720760,0,0,6,6,
Tulsa,Superintendent of Public Instruction,John Cox,DEM,720801,0,0,13,13,
Tulsa,Superintendent of Public Instruction,Freda Deskin,DEM,720801,0,0,10,10,
Tulsa,U.S. Senate,Connie Johnson,DEM,720801,0,0,15,15,
Tulsa,U.S. Senate,Jim Rogers,DEM,720801,0,0,8,8,
Tulsa,Superintendent of Public Instruction,John Cox,DEM,720802,0,0,8,8,
Tulsa,Superintendent of Public Instruction,Freda Deskin,DEM,720802,0,0,5,5,
Tulsa,U.S. Senate,Connie Johnson,DEM,720802,0,0,6,6,
Tulsa,U.S. Senate,Jim Rogers,DEM,720802,0,0,6,6,
Tulsa,Superintendent of Public Instruction,John Cox,DEM,720851,0,0,25,25,
Tulsa,Superintendent of Public Instruction,Freda Deskin,DEM,720851,0,0,19,19,
Tulsa,U.S. Senate,Connie Johnson,DEM,720851,0,0,34,34,
Tulsa,U.S. Senate,Jim Rogers,DEM,720851,0,0,10,10,
Tulsa,Superintendent of Public Instruction,John Cox,DEM,720852,0,0,19,19,
Tulsa,Superintendent of Public Instruction,Freda Deskin,DEM,720852,0,0,10,10,
Tulsa,U.S. Senate,Connie Johnson,DEM,720852,0,0,19,19,
Tulsa,U.S. Senate,Jim Rogers,DEM,720852,0,0,11,11,
Tulsa,Superintendent of Public Instruction,John Cox,DEM,720853,0,0,18,18,
Tulsa,Superintendent of Public Instruction,Freda Deskin,DEM,720853,0,0,5,5,
Tulsa,U.S. Senate,Connie Johnson,DEM,720853,0,0,10,10,
Tulsa,U.S. Senate,Jim Rogers,DEM,720853,0,0,13,13,
Tulsa,Superintendent of Public Instruction,John Cox,DEM,720854,0,0,23,23,
Tulsa,Superintendent of Public Instruction,Freda Deskin,DEM,720854,0,0,8,8,
Tulsa,U.S. Senate,Connie Johnson,DEM,720854,0,0,18,18,
Tulsa,U.S. Senate,Jim Rogers,DEM,720854,0,0,13,13,
Tulsa,Superintendent of Public Instruction,John Cox,DEM,720855,0,0,34,34,
Tulsa,Superintendent of Public Instruction,Freda Deskin,DEM,720855,0,0,23,23,
Tulsa,U.S. Senate,Connie Johnson,DEM,720855,0,0,34,34,
Tulsa,U.S. Senate,Jim Rogers,DEM,720855,0,0,20,20,
Tulsa,Superintendent of Public Instruction,John Cox,DEM,720856,0,0,20,20,
Tulsa,Superintendent of Public Instruction,Freda Deskin,DEM,720856,0,0,15,15,
Tulsa,U.S. Senate,Connie Johnson,DEM,720856,0,0,29,29,
Tulsa,U.S. Senate,Jim Rogers,DEM,720856,0,0,5,5,
Tulsa,Superintendent of Public Instruction,John Cox,DEM,720857,0,0,31,31,
Tulsa,Superintendent of Public Instruction,Freda Deskin,DEM,720857,0,0,11,11,
Tulsa,U.S. Senate,Connie Johnson,DEM,720857,0,0,23,23,
Tulsa,U.S. Senate,Jim Rogers,DEM,720857,0,0,18,18,
Tulsa,Superintendent of Public Instruction,John Cox,DEM,720858,0,0,16,16,
Tulsa,Superintendent of Public Instruction,Freda Deskin,DEM,720858,0,0,7,7,
Tulsa,U.S. Senate,Connie Johnson,DEM,720858,0,0,12,12,
Tulsa,U.S. Senate,Jim Rogers,DEM,720858,0,0,11,11,
Tulsa,State House,James Leewright,REP,720858,0,0,35,35,29
Tulsa,State House,Dani Thompson-Fields,REP,720858,0,0,13,13,29
Tulsa,Superintendent of Public Instruction,John Cox,DEM,720880,0,0,21,21,
Tulsa,Superintendent of Public Instruction,Freda Deskin,DEM,720880,0,0,5,5,
Tulsa,U.S. Senate,Connie Johnson,DEM,720880,0,0,12,12,
Tulsa,U.S. Senate,Jim Rogers,DEM,720880,0,0,14,14,
Tulsa,State House,James Leewright,REP,720880,0,0,60,60,29
Tulsa,State House,Dani Thompson-Fields,REP,720880,0,0,51,51,29
Tulsa,Superintendent of Public Instruction,John Cox,DEM,720881,0,0,25,25,
Tulsa,Superintendent of Public Instruction,Freda Deskin,DEM,720881,0,0,5,5,
Tulsa,U.S. Senate,Connie Johnson,DEM,720881,0,0,21,21,
Tulsa,U.S. Senate,Jim Rogers,DEM,720881,0,0,8,8,
Tulsa,Superintendent of Public Instruction,John Cox,DEM,720900,0,0,27,27,
Tulsa,Superintendent of Public Instruction,Freda Deskin,DEM,720900,0,0,13,13,
Tulsa,U.S. Senate,Connie Johnson,DEM,720900,0,0,25,25,
Tulsa,U.S. Senate,Jim Rogers,DEM,720900,0,0,16,16,
Tulsa,Superintendent of Public Instruction,John Cox,DEM,729999,328,141,0,469,
Tulsa,Superintendent of Public Instruction,Freda Deskin,DEM,729999,378,114,0,492,
Tulsa,U.S. Senate,Connie Johnson,DEM,729999,501,211,0,712,
Tulsa,U.S. Senate,Jim Rogers,DEM,729999,201,41,0,242,
Tulsa,State House,James Leewright,REP,729999,4,4,0,8,29
Tulsa,State House,Dani Thompson-Fields,REP,729999,4,3,0,7,29
Tulsa,State House,Melissa Abdo,REP,729999,84,34,0,118,69
Tulsa,State House,Chuck Strohm,REP,729999,59,21,0,80,69
Wagoner,Superintendent of Public Instruction,John Cox,DEM,730101,1,0,17,18,
Wagoner,Superintendent of Public Instruction,Freda Deskin,DEM,730101,0,0,7,7,
Wagoner,U.S. Senate,Connie Johnson,DEM,730101,0,0,11,11,
Wagoner,U.S. Senate,Jim Rogers,DEM,730101,1,0,13,14,
Wagoner,Superintendent of Public Instruction,John Cox,DEM,730102,0,0,9,9,
Wagoner,Superintendent of Public Instruction,Freda Deskin,DEM,730102,0,0,5,5,
Wagoner,U.S. Senate,Connie Johnson,DEM,730102,0,0,11,11,
Wagoner,U.S. Senate,Jim Rogers,DEM,730102,0,0,3,3,
Wagoner,Superintendent of Public Instruction,John Cox,DEM,730103,0,0,23,23,
Wagoner,Superintendent of Public Instruction,Freda Deskin,DEM,730103,0,0,15,15,
Wagoner,U.S. Senate,Connie Johnson,DEM,730103,0,0,22,22,
Wagoner,U.S. Senate,Jim Rogers,DEM,730103,0,0,15,15,
Wagoner,Superintendent of Public Instruction,John Cox,DEM,730104,0,0,0,0,
Wagoner,Superintendent of Public Instruction,Freda Deskin,DEM,730104,0,0,0,0,
Wagoner,U.S. Senate,Connie Johnson,DEM,730104,0,0,0,0,
Wagoner,U.S. Senate,Jim Rogers,DEM,730104,0,0,0,0,
Wagoner,Superintendent of Public Instruction,John Cox,DEM,730105,0,0,0,0,
Wagoner,Superintendent of Public Instruction,Freda Deskin,DEM,730105,0,0,0,0,
Wagoner,U.S. Senate,Connie Johnson,DEM,730105,0,0,0,0,
Wagoner,U.S. Senate,Jim Rogers,DEM,730105,0,0,0,0,
Wagoner,Superintendent of Public Instruction,John Cox,DEM,730106,0,0,21,21,
Wagoner,Superintendent of Public Instruction,Freda Deskin,DEM,730106,1,0,20,21,
Wagoner,U.S. Senate,Connie Johnson,DEM,730106,1,0,29,30,
Wagoner,U.S. Senate,Jim Rogers,DEM,730106,0,0,11,11,
Wagoner,Superintendent of Public Instruction,John Cox,DEM,730107,1,0,28,29,
Wagoner,Superintendent of Public Instruction,Freda Deskin,DEM,730107,3,0,17,20,
Wagoner,U.S. Senate,Connie Johnson,DEM,730107,2,0,29,31,
Wagoner,U.S. Senate,Jim Rogers,DEM,730107,2,0,16,18,
Wagoner,Superintendent of Public Instruction,John Cox,DEM,730108,0,0,17,17,
Wagoner,Superintendent of Public Instruction,Freda Deskin,DEM,730108,0,0,9,9,
Wagoner,U.S. Senate,Connie Johnson,DEM,730108,0,0,17,17,
Wagoner,U.S. Senate,Jim Rogers,DEM,730108,0,0,9,9,
Wagoner,Superintendent of Public Instruction,John Cox,DEM,730109,0,0,10,10,
Wagoner,Superintendent of Public Instruction,Freda Deskin,DEM,730109,0,0,11,11,
Wagoner,U.S. Senate,Connie Johnson,DEM,730109,0,0,13,13,
Wagoner,U.S. Senate,Jim Rogers,DEM,730109,0,0,8,8,
Wagoner,Superintendent of Public Instruction,John Cox,DEM,730201,0,0,14,14,
Wagoner,Superintendent of Public Instruction,Freda Deskin,DEM,730201,0,0,6,6,
Wagoner,U.S. Senate,Connie Johnson,DEM,730201,0,0,10,10,
Wagoner,U.S. Senate,Jim Rogers,DEM,730201,0,0,10,10,
Wagoner,Superintendent of Public Instruction,John Cox,DEM,730202,1,0,0,1,
Wagoner,Superintendent of Public Instruction,Freda Deskin,DEM,730202,1,0,0,1,
Wagoner,U.S. Senate,Connie Johnson,DEM,730202,2,0,0,2,
Wagoner,U.S. Senate,Jim Rogers,DEM,730202,0,0,0,0,
Wagoner,Superintendent of Public Instruction,John Cox,DEM,730203,1,3,71,75,
Wagoner,Superintendent of Public Instruction,Freda Deskin,DEM,730203,2,0,18,20,
Wagoner,U.S. Senate,Connie Johnson,DEM,730203,0,1,37,38,
Wagoner,U.S. Senate,Jim Rogers,DEM,730203,3,2,51,56,
Wagoner,Superintendent of Public Instruction,John Cox,DEM,730204,0,0,28,28,
Wagoner,Superintendent of Public Instruction,Freda Deskin,DEM,730204,0,1,13,14,
Wagoner,U.S. Senate,Connie Johnson,DEM,730204,0,0,17,17,
Wagoner,U.S. Senate,Jim Rogers,DEM,730204,0,1,24,25,
Wagoner,Superintendent of Public Instruction,John Cox,DEM,730205,1,0,4,5,
Wagoner,Superintendent of Public Instruction,Freda Deskin,DEM,730205,1,0,1,2,
Wagoner,U.S. Senate,Connie Johnson,DEM,730205,1,0,3,4,
Wagoner,U.S. Senate,Jim Rogers,DEM,730205,1,0,2,3,
Wagoner,Superintendent of Public Instruction,John Cox,DEM,730206,0,0,9,9,
Wagoner,Superintendent of Public Instruction,Freda Deskin,DEM,730206,0,0,0,0,
Wagoner,U.S. Senate,Connie Johnson,DEM,730206,0,0,3,3,
Wagoner,U.S. Senate,Jim Rogers,DEM,730206,0,0,6,6,
Wagoner,Superintendent of Public Instruction,John Cox,DEM,730207,0,0,26,26,
Wagoner,Superintendent of Public Instruction,Freda Deskin,DEM,730207,0,1,16,17,
Wagoner,U.S. Senate,Connie Johnson,DEM,730207,0,1,25,26,
Wagoner,U.S. Senate,Jim Rogers,DEM,730207,0,0,17,17,
Wagoner,Superintendent of Public Instruction,John Cox,DEM,730208,0,7,88,95,
Wagoner,Superintendent of Public Instruction,Freda Deskin,DEM,730208,0,3,35,38,
Wagoner,U.S. Senate,Connie Johnson,DEM,730208,0,7,62,69,
Wagoner,U.S. Senate,Jim Rogers,DEM,730208,0,3,58,61,
Wagoner,Superintendent of Public Instruction,John Cox,DEM,730209,0,0,22,22,
Wagoner,Superintendent of Public Instruction,Freda Deskin,DEM,730209,0,0,6,6,
Wagoner,U.S. Senate,Connie Johnson,DEM,730209,0,0,15,15,
Wagoner,U.S. Senate,Jim Rogers,DEM,730209,0,0,12,12,
Wagoner,Superintendent of Public Instruction,John Cox,DEM,730210,0,3,147,150,
Wagoner,Superintendent of Public Instruction,Freda Deskin,DEM,730210,0,0,58,58,
Wagoner,U.S. Senate,Connie Johnson,DEM,730210,0,0,72,72,
Wagoner,U.S. Senate,Jim Rogers,DEM,730210,0,3,127,130,
Wagoner,Superintendent of Public Instruction,John Cox,DEM,730301,1,0,12,13,
Wagoner,Superintendent of Public Instruction,Freda Deskin,DEM,730301,1,0,12,13,
Wagoner,U.S. Senate,Connie Johnson,DEM,730301,1,0,14,15,
Wagoner,U.S. Senate,Jim Rogers,DEM,730301,1,0,10,11,
Wagoner,Superintendent of Public Instruction,John Cox,DEM,730302,1,0,20,21,
Wagoner,Superintendent of Public Instruction,Freda Deskin,DEM,730302,2,0,18,20,
Wagoner,U.S. Senate,Connie Johnson,DEM,730302,2,0,25,27,
Wagoner,U.S. Senate,Jim Rogers,DEM,730302,1,0,13,14,
Wagoner,Superintendent of Public Instruction,John Cox,DEM,730303,0,0,6,6,
Wagoner,Superintendent of Public Instruction,Freda Deskin,DEM,730303,0,0,2,2,
Wagoner,U.S. Senate,Connie Johnson,DEM,730303,0,0,4,4,
Wagoner,U.S. Senate,Jim Rogers,DEM,730303,0,0,4,4,
Wagoner,Superintendent of Public Instruction,John Cox,DEM,730304,4,0,12,16,
Wagoner,Superintendent of Public Instruction,Freda Deskin,DEM,730304,0,0,12,12,
Wagoner,U.S. Senate,Connie Johnson,DEM,730304,4,0,16,20,
Wagoner,U.S. Senate,Jim Rogers,DEM,730304,0,0,9,9,
Wagoner,Superintendent of Public Instruction,John Cox,DEM,730305,0,0,0,0,
Wagoner,Superintendent of Public Instruction,Freda Deskin,DEM,730305,0,0,1,1,
Wagoner,U.S. Senate,Connie Johnson,DEM,730305,0,0,0,0,
Wagoner,U.S. Senate,Jim Rogers,DEM,730305,0,0,1,1,
Wagoner,Superintendent of Public Instruction,John Cox,DEM,730306,0,0,26,26,
Wagoner,Superintendent of Public Instruction,Freda Deskin,DEM,730306,0,0,15,15,
Wagoner,U.S. Senate,Connie Johnson,DEM,730306,0,0,27,27,
Wagoner,U.S. Senate,Jim Rogers,DEM,730306,0,0,13,13,
Wagoner,Superintendent of Public Instruction,John Cox,DEM,730307,0,0,10,10,
Wagoner,Superintendent of Public Instruction,Freda Deskin,DEM,730307,0,0,8,8,
Wagoner,U.S. Senate,Connie Johnson,DEM,730307,0,0,7,7,
Wagoner,U.S. Senate,Jim Rogers,DEM,730307,0,0,10,10,
Wagoner,Superintendent of Public Instruction,John Cox,DEM,730308,4,1,6,11,
Wagoner,Superintendent of Public Instruction,Freda Deskin,DEM,730308,0,0,8,8,
Wagoner,U.S. Senate,Connie Johnson,DEM,730308,0,1,9,10,
Wagoner,U.S. Senate,Jim Rogers,DEM,730308,4,0,4,8,
Wagoner,Superintendent of Public Instruction,John Cox,DEM,730309,3,0,13,16,
Wagoner,Superintendent of Public Instruction,Freda Deskin,DEM,730309,3,0,9,12,
Wagoner,U.S. Senate,Connie Johnson,DEM,730309,5,0,16,21,
Wagoner,U.S. Senate,Jim Rogers,DEM,730309,1,0,6,7,
Wagoner,Superintendent of Public Instruction,John Cox,DEM,730310,0,0,6,6,
Wagoner,Superintendent of Public Instruction,Freda Deskin,DEM,730310,1,0,2,3,
Wagoner,U.S. Senate,Connie Johnson,DEM,730310,0,0,4,4,
Wagoner,U.S. Senate,Jim Rogers,DEM,730310,0,0,5,5,
Wagoner,Superintendent of Public Instruction,John Cox,DEM,730311,0,0,13,13,
Wagoner,Superintendent of Public Instruction,Freda Deskin,DEM,730311,0,0,1,1,
Wagoner,U.S. Senate,Connie Johnson,DEM,730311,0,0,9,9,
Wagoner,U.S. Senate,Jim Rogers,DEM,730311,0,0,5,5,
Wagoner,Superintendent of Public Instruction,John Cox,DEM,730312,1,0,27,28,
Wagoner,Superintendent of Public Instruction,Freda Deskin,DEM,730312,0,0,11,11,
Wagoner,U.S. Senate,Connie Johnson,DEM,730312,1,0,15,16,
Wagoner,U.S. Senate,Jim Rogers,DEM,730312,0,0,22,22,
Wagoner,Superintendent of Public Instruction,John Cox,DEM,730313,0,0,17,17,
Wagoner,Superintendent of Public Instruction,Freda Deskin,DEM,730313,0,0,10,10,
Wagoner,U.S. Senate,Connie Johnson,DEM,730313,0,0,11,11,
Wagoner,U.S. Senate,Jim Rogers,DEM,730313,0,0,16,16,
Washington,Superintendent of Public Instruction,John Cox,DEM,740011,0,0,8,8,
Washington,Superintendent of Public Instruction,Freda Deskin,DEM,740011,1,0,11,12,
Washington,U.S. Senate,Connie Johnson,DEM,740011,1,0,11,12,
Washington,U.S. Senate,Jim Rogers,DEM,740011,0,0,8,8,
Washington,Superintendent of Public Instruction,John Cox,DEM,740012,0,0,4,4,
Washington,Superintendent of Public Instruction,Freda Deskin,DEM,740012,0,0,2,2,
Washington,U.S. Senate,Connie Johnson,DEM,740012,0,0,5,5,
Washington,U.S. Senate,Jim Rogers,DEM,740012,0,0,1,1,
Washington,Superintendent of Public Instruction,John Cox,DEM,740013,0,0,19,19,
Washington,Superintendent of Public Instruction,Freda Deskin,DEM,740013,0,0,12,12,
Washington,U.S. Senate,Connie Johnson,DEM,740013,0,0,20,20,
Washington,U.S. Senate,Jim Rogers,DEM,740013,0,0,11,11,
Washington,Superintendent of Public Instruction,John Cox,DEM,740015,0,0,22,22,
Washington,Superintendent of Public Instruction,Freda Deskin,DEM,740015,0,0,12,12,
Washington,U.S. Senate,Connie Johnson,DEM,740015,0,0,19,19,
Washington,U.S. Senate,Jim Rogers,DEM,740015,0,0,15,15,
Washington,Superintendent of Public Instruction,John Cox,DEM,740022,2,0,33,35,
Washington,Superintendent of Public Instruction,Freda Deskin,DEM,740022,4,1,19,24,
Washington,U.S. Senate,Connie Johnson,DEM,740022,5,1,39,45,
Washington,U.S. Senate,Jim Rogers,DEM,740022,1,0,12,13,
Washington,Superintendent of Public Instruction,John Cox,DEM,740027,0,0,9,9,
Washington,Superintendent of Public Instruction,Freda Deskin,DEM,740027,0,2,4,6,
Washington,U.S. Senate,Connie Johnson,DEM,740027,0,2,11,13,
Washington,U.S. Senate,Jim Rogers,DEM,740027,0,0,2,2,
Washington,Superintendent of Public Instruction,John Cox,DEM,740028,0,2,38,40,
Washington,Superintendent of Public Instruction,Freda Deskin,DEM,740028,1,0,23,24,
Washington,U.S. Senate,Connie Johnson,DEM,740028,1,1,39,41,
Washington,U.S. Senate,Jim Rogers,DEM,740028,0,1,22,23,
Washington,Superintendent of Public Instruction,John Cox,DEM,740031,0,2,16,18,
Washington,Superintendent of Public Instruction,Freda Deskin,DEM,740031,2,0,31,33,
Washington,U.S. Senate,Connie Johnson,DEM,740031,2,1,43,46,
Washington,U.S. Senate,Jim Rogers,DEM,740031,0,1,4,5,
Washington,Superintendent of Public Instruction,John Cox,DEM,740033,0,1,13,14,
Washington,Superintendent of Public Instruction,Freda Deskin,DEM,740033,1,1,6,8,
Washington,U.S. Senate,Connie Johnson,DEM,740033,1,1,13,15,
Washington,U.S. Senate,Jim Rogers,DEM,740033,0,1,6,7,
Washington,Superintendent of Public Instruction,John Cox,DEM,740046,1,1,16,18,
Washington,Superintendent of Public Instruction,Freda Deskin,DEM,740046,0,0,11,11,
Washington,U.S. Senate,Connie Johnson,DEM,740046,1,0,14,15,
Washington,U.S. Senate,Jim Rogers,DEM,740046,0,1,13,14,
Washington,Superintendent of Public Instruction,John Cox,DEM,740048,2,1,10,13,
Washington,Superintendent of Public Instruction,Freda Deskin,DEM,740048,4,0,9,13,
Washington,U.S. Senate,Connie Johnson,DEM,740048,3,0,13,16,
Washington,U.S. Senate,Jim Rogers,DEM,740048,3,1,6,10,
Washington,Superintendent of Public Instruction,John Cox,DEM,740051,0,0,20,20,
Washington,Superintendent of Public Instruction,Freda Deskin,DEM,740051,0,0,10,10,
Washington,U.S. Senate,Connie Johnson,DEM,740051,0,0,22,22,
Washington,U.S. Senate,Jim Rogers,DEM,740051,0,0,8,8,
Washington,Superintendent of Public Instruction,John Cox,DEM,740054,1,0,32,33,
Washington,Superintendent of Public Instruction,Freda Deskin,DEM,740054,2,0,15,17,
Washington,U.S. Senate,Connie Johnson,DEM,740054,3,0,34,37,
Washington,U.S. Senate,Jim Rogers,DEM,740054,0,0,13,13,
Washington,Superintendent of Public Instruction,John Cox,DEM,740062,0,2,23,25,
Washington,Superintendent of Public Instruction,Freda Deskin,DEM,740062,0,1,9,10,
Washington,U.S. Senate,Connie Johnson,DEM,740062,0,2,17,19,
Washington,U.S. Senate,Jim Rogers,DEM,740062,0,1,15,16,
Washington,Superintendent of Public Instruction,John Cox,DEM,740071,0,0,8,8,
Washington,Superintendent of Public Instruction,Freda Deskin,DEM,740071,0,0,6,6,
Washington,U.S. Senate,Connie Johnson,DEM,740071,0,0,6,6,
Washington,U.S. Senate,Jim Rogers,DEM,740071,0,0,8,8,
Washington,Superintendent of Public Instruction,John Cox,DEM,740073,0,0,9,9,
Washington,Superintendent of Public Instruction,Freda Deskin,DEM,740073,0,0,1,1,
Washington,U.S. Senate,Connie Johnson,DEM,740073,0,0,4,4,
Washington,U.S. Senate,Jim Rogers,DEM,740073,0,0,6,6,
Washington,Superintendent of Public Instruction,John Cox,DEM,740074,2,0,8,10,
Washington,Superintendent of Public Instruction,Freda Deskin,DEM,740074,0,0,3,3,
Washington,U.S. Senate,Connie Johnson,DEM,740074,0,0,7,7,
Washington,U.S. Senate,Jim Rogers,DEM,740074,2,0,4,6,
Washington,Superintendent of Public Instruction,John Cox,DEM,740075,0,0,6,6,
Washington,Superintendent of Public Instruction,Freda Deskin,DEM,740075,0,0,6,6,
Washington,U.S. Senate,Connie Johnson,DEM,740075,0,0,9,9,
Washington,U.S. Senate,Jim Rogers,DEM,740075,0,0,3,3,
Washington,Superintendent of Public Instruction,John Cox,DEM,740076,1,0,12,13,
Washington,Superintendent of Public Instruction,Freda Deskin,DEM,740076,0,0,5,5,
Washington,U.S. Senate,Connie Johnson,DEM,740076,0,0,3,3,
Washington,U.S. Senate,Jim Rogers,DEM,740076,1,0,13,14,
Washington,Superintendent of Public Instruction,John Cox,DEM,740077,0,0,11,11,
Washington,Superintendent of Public Instruction,Freda Deskin,DEM,740077,0,0,3,3,
Washington,U.S. Senate,Connie Johnson,DEM,740077,0,0,12,12,
Washington,U.S. Senate,Jim Rogers,DEM,740077,0,0,2,2,
Washington,Superintendent of Public Instruction,John Cox,DEM,740078,3,0,19,22,
Washington,Superintendent of Public Instruction,Freda Deskin,DEM,740078,0,0,5,5,
Washington,U.S. Senate,Connie Johnson,DEM,740078,2,0,12,14,
Washington,U.S. Senate,Jim Rogers,DEM,740078,1,0,11,12,
Washington,Superintendent of Public Instruction,John Cox,DEM,740079,0,0,22,22,
Washington,Superintendent of Public Instruction,Freda Deskin,DEM,740079,0,0,6,6,
Washington,U.S. Senate,Connie Johnson,DEM,740079,0,0,6,6,
Washington,U.S. Senate,Jim Rogers,DEM,740079,0,0,21,21,
Washington,Superintendent of Public Instruction,John Cox,DEM,740711,0,0,1,1,
Washington,Superintendent of Public Instruction,Freda Deskin,DEM,740711,0,0,1,1,
Washington,U.S. Senate,Connie Johnson,DEM,740711,0,0,1,1,
Washington,U.S. Senate,Jim Rogers,DEM,740711,0,0,1,1,
Washita,Superintendent of Public Instruction,John Cox,DEM,750003,0,0,6,6,
Washita,Superintendent of Public Instruction,Freda Deskin,DEM,750003,5,0,2,7,
Washita,U.S. Senate,Connie Johnson,DEM,750003,3,0,3,6,
Washita,U.S. Senate,Jim Rogers,DEM,750003,2,0,5,7,
Washita,Superintendent of Public Instruction,John Cox,DEM,750004,7,9,170,186,
Washita,Superintendent of Public Instruction,Freda Deskin,DEM,750004,6,3,71,80,
Washita,U.S. Senate,Connie Johnson,DEM,750004,7,1,121,129,
Washita,U.S. Senate,Jim Rogers,DEM,750004,6,10,112,128,
Washita,Superintendent of Public Instruction,John Cox,DEM,750007,0,3,30,33,
Washita,Superintendent of Public Instruction,Freda Deskin,DEM,750007,0,1,10,11,
Washita,U.S. Senate,Connie Johnson,DEM,750007,0,1,14,15,
Washita,U.S. Senate,Jim Rogers,DEM,750007,0,3,25,28,
Washita,Superintendent of Public Instruction,John Cox,DEM,750009,0,0,15,15,
Washita,Superintendent of Public Instruction,Freda Deskin,DEM,750009,0,0,4,4,
Washita,U.S. Senate,Connie Johnson,DEM,750009,0,0,5,5,
Washita,U.S. Senate,Jim Rogers,DEM,750009,0,0,14,14,
Washita,Superintendent of Public Instruction,John Cox,DEM,750012,0,0,20,20,
Washita,Superintendent of Public Instruction,Freda Deskin,DEM,750012,0,0,6,6,
Washita,U.S. Senate,Connie Johnson,DEM,750012,0,0,7,7,
Washita,U.S. Senate,Jim Rogers,DEM,750012,0,0,19,19,
Washita,Superintendent of Public Instruction,John Cox,DEM,750014,1,0,34,35,
Washita,Superintendent of Public Instruction,Freda Deskin,DEM,750014,0,0,2,2,
Washita,U.S. Senate,Connie Johnson,DEM,750014,1,0,14,15,
Washita,U.S. Senate,Jim Rogers,DEM,750014,0,0,22,22,
Washita,Superintendent of Public Instruction,John Cox,DEM,750016,1,0,15,16,
Washita,Superintendent of Public Instruction,Freda Deskin,DEM,750016,1,0,4,5,
Washita,U.S. Senate,Connie Johnson,DEM,750016,1,0,12,13,
Washita,U.S. Senate,Jim Rogers,DEM,750016,1,0,7,8,
Washita,Superintendent of Public Instruction,John Cox,DEM,750017,0,0,16,16,
Washita,Superintendent of Public Instruction,Freda Deskin,DEM,750017,0,0,4,4,
Washita,U.S. Senate,Connie Johnson,DEM,750017,0,0,5,5,
Washita,U.S. Senate,Jim Rogers,DEM,750017,0,1,15,16,
Washita,Superintendent of Public Instruction,John Cox,DEM,750018,1,1,11,13,
Washita,Superintendent of Public Instruction,Freda Deskin,DEM,750018,0,0,12,12,
Washita,U.S. Senate,Connie Johnson,DEM,750018,1,0,7,8,
Washita,U.S. Senate,Jim Rogers,DEM,750018,0,1,15,16,
Washita,Superintendent of Public Instruction,John Cox,DEM,750019,1,1,28,30,
Washita,Superintendent of Public Instruction,Freda Deskin,DEM,750019,0,0,7,7,
Washita,U.S. Senate,Connie Johnson,DEM,750019,1,0,18,19,
Washita,U.S. Senate,Jim Rogers,DEM,750019,0,1,15,16,
Washita,Superintendent of Public Instruction,John Cox,DEM,750020,0,1,26,27,
Washita,Superintendent of Public Instruction,Freda Deskin,DEM,750020,4,0,16,20,
Washita,U.S. Senate,Connie Johnson,DEM,750020,4,0,21,25,
Washita,U.S. Senate,Jim Rogers,DEM,750020,0,0,19,19,
Washita,Superintendent of Public Instruction,John Cox,DEM,750030,0,4,82,86,
Washita,Superintendent of Public Instruction,Freda Deskin,DEM,750030,0,1,43,44,
Washita,U.S. Senate,Connie Johnson,DEM,750030,1,1,45,47,
Washita,U.S. Senate,Jim Rogers,DEM,750030,0,4,75,79,
Woods,Superintendent of Public Instruction,John Cox,DEM,760001,1,2,33,36,
Woods,Superintendent of Public Instruction,Freda Deskin,DEM,760001,2,3,7,12,
Woods,U.S. Senate,Connie Johnson,DEM,760001,1,3,31,35,
Woods,U.S. Senate,Jim Rogers,DEM,760001,2,1,8,11,
Woods,Superintendent of Public Instruction,John Cox,DEM,760002,0,0,10,10,
Woods,Superintendent of Public Instruction,Freda Deskin,DEM,760002,0,0,5,5,
Woods,U.S. Senate,Connie Johnson,DEM,760002,0,0,7,7,
Woods,U.S. Senate,Jim Rogers,DEM,760002,0,0,7,7,
Woods,Superintendent of Public Instruction,John Cox,DEM,760003,1,1,11,13,
Woods,Superintendent of Public Instruction,Freda Deskin,DEM,760003,1,1,5,7,
Woods,U.S. Senate,Connie Johnson,DEM,760003,0,2,9,11,
Woods,U.S. Senate,Jim Rogers,DEM,760003,2,0,6,8,
Woods,Superintendent of Public Instruction,John Cox,DEM,760004,1,0,6,7,
Woods,Superintendent of Public Instruction,Freda Deskin,DEM,760004,0,0,1,1,
Woods,U.S. Senate,Connie Johnson,DEM,760004,0,0,3,3,
Woods,U.S. Senate,Jim Rogers,DEM,760004,1,0,4,5,
Woods,Superintendent of Public Instruction,John Cox,DEM,760005,3,7,31,41,
Woods,Superintendent of Public Instruction,Freda Deskin,DEM,760005,2,0,4,6,
Woods,U.S. Senate,Connie Johnson,DEM,760005,0,1,20,21,
Woods,U.S. Senate,Jim Rogers,DEM,760005,5,6,15,26,
Woods,Superintendent of Public Instruction,John Cox,DEM,760007,0,0,6,6,
Woods,Superintendent of Public Instruction,Freda Deskin,DEM,760007,0,0,3,3,
Woods,U.S. Senate,Connie Johnson,DEM,760007,0,0,6,6,
Woods,U.S. Senate,Jim Rogers,DEM,760007,0,0,3,3,
Woods,Superintendent of Public Instruction,John Cox,DEM,760008,0,0,5,5,
Woods,Superintendent of Public Instruction,Freda Deskin,DEM,760008,0,0,2,2,
Woods,U.S. Senate,Connie Johnson,DEM,760008,0,0,4,4,
Woods,U.S. Senate,Jim Rogers,DEM,760008,0,0,3,3,
Woodward,Superintendent of Public Instruction,John Cox,DEM,770101,1,3,5,9,
Woodward,Superintendent of Public Instruction,Freda Deskin,DEM,770101,0,0,1,1,
Woodward,U.S. Senate,Connie Johnson,DEM,770101,0,1,5,6,
Woodward,U.S. Senate,Jim Rogers,DEM,770101,1,2,1,4,
Woodward,Superintendent of Public Instruction,John Cox,DEM,770102,0,1,1,2,
Woodward,Superintendent of Public Instruction,Freda Deskin,DEM,770102,0,0,3,3,
Woodward,U.S. Senate,Connie Johnson,DEM,770102,0,1,2,3,
Woodward,U.S. Senate,Jim Rogers,DEM,770102,0,0,2,2,
Woodward,Superintendent of Public Instruction,John Cox,DEM,770104,0,0,0,0,
Woodward,Superintendent of Public Instruction,Freda Deskin,DEM,770104,0,0,0,0,
Woodward,U.S. Senate,Connie Johnson,DEM,770104,0,0,0,0,
Woodward,U.S. Senate,Jim Rogers,DEM,770104,0,0,0,0,
Woodward,Superintendent of Public Instruction,John Cox,DEM,770105,3,0,17,20,
Woodward,Superintendent of Public Instruction,Freda Deskin,DEM,770105,4,0,7,11,
Woodward,U.S. Senate,Connie Johnson,DEM,770105,4,0,16,20,
Woodward,U.S. Senate,Jim Rogers,DEM,770105,3,0,8,11,
Woodward,Superintendent of Public Instruction,John Cox,DEM,770106,1,0,2,3,
Woodward,Superintendent of Public Instruction,Freda Deskin,DEM,770106,0,0,1,1,
Woodward,U.S. Senate,Connie Johnson,DEM,770106,0,0,3,3,
Woodward,U.S. Senate,Jim Rogers,DEM,770106,1,0,0,1,
Woodward,Superintendent of Public Instruction,John Cox,DEM,770201,0,2,14,16,
Woodward,Superintendent of Public Instruction,Freda Deskin,DEM,770201,1,0,4,5,
Woodward,U.S. Senate,Connie Johnson,DEM,770201,1,1,15,17,
Woodward,U.S. Senate,Jim Rogers,DEM,770201,0,1,3,4,
Woodward,Superintendent of Public Instruction,John Cox,DEM,770202,3,3,24,30,
Woodward,Superintendent of Public Instruction,Freda Deskin,DEM,770202,2,1,16,19,
Woodward,U.S. Senate,Connie Johnson,DEM,770202,3,1,23,27,
Woodward,U.S. Senate,Jim Rogers,DEM,770202,2,3,16,21,
Woodward,Superintendent of Public Instruction,John Cox,DEM,770203,0,2,11,13,
Woodward,Superintendent of Public Instruction,Freda Deskin,DEM,770203,0,1,5,6,
Woodward,U.S. Senate,Connie Johnson,DEM,770203,0,3,6,9,
Woodward,U.S. Senate,Jim Rogers,DEM,770203,0,0,9,9,
Woodward,Superintendent of Public Instruction,John Cox,DEM,770204,0,1,4,5,
Woodward,Superintendent of Public Instruction,Freda Deskin,DEM,770204,0,0,3,3,
Woodward,U.S. Senate,Connie Johnson,DEM,770204,0,0,0,0,
Woodward,U.S. Senate,Jim Rogers,DEM,770204,0,1,7,8,
Woodward,Superintendent of Public Instruction,John Cox,DEM,770301,0,0,4,4,
Woodward,Superintendent of Public Instruction,Freda Deskin,DEM,770301,0,1,4,5,
Woodward,U.S. Senate,Connie Johnson,DEM,770301,0,1,5,6,
Woodward,U.S. Senate,Jim Rogers,DEM,770301,0,0,3,3,
Woodward,Superintendent of Public Instruction,John Cox,DEM,770302,0,1,3,4,
Woodward,Superintendent of Public Instruction,Freda Deskin,DEM,770302,0,0,2,2,
Woodward,U.S. Senate,Connie Johnson,DEM,770302,0,1,1,2,
Woodward,U.S. Senate,Jim Rogers,DEM,770302,0,0,4,4,
Woodward,Superintendent of Public Instruction,John Cox,DEM,770303,0,0,0,0,
Woodward,Superintendent of Public Instruction,Freda Deskin,DEM,770303,0,0,0,0,
Woodward,U.S. Senate,Connie Johnson,DEM,770303,0,0,0,0,
Woodward,U.S. Senate,Jim Rogers,DEM,770303,0,0,0,0,
Woodward,Superintendent of Public Instruction,John Cox,DEM,770304,0,0,0,0,
Woodward,Superintendent of Public Instruction,Freda Deskin,DEM,770304,0,0,2,2,
Woodward,U.S. Senate,Connie Johnson,DEM,770304,0,0,1,1,
Woodward,U.S. Senate,Jim Rogers,DEM,770304,0,0,1,1,
Woodward,Superintendent of Public Instruction,John Cox,DEM,770306,0,2,15,17,
Woodward,Superintendent of Public Instruction,Freda Deskin,DEM,770306,0,2,7,9,
Woodward,U.S. Senate,Connie Johnson,DEM,770306,0,2,14,16,
Woodward,U.S. Senate,Jim Rogers,DEM,770306,0,2,8,10,
Woodward,Superintendent of Public Instruction,John Cox,DEM,770307,0,0,6,6,
Woodward,Superintendent of Public Instruction,Freda Deskin,DEM,770307,0,0,2,2,
Woodward,U.S. Senate,Connie Johnson,DEM,770307,0,0,2,2,
Woodward,U.S. Senate,Jim Rogers,DEM,770307,0,0,6,6,
Woodward,State House,Casey Murdock,REP,770307,0,0,8,8,61
Woodward,State House,Kenny Bob Tapp,REP,770307,0,0,12,12,61
